,Season,Start,End,Length,Msng,Tmax,Tmin,TempSc,Sfall,Sdepth,SnowSc,AWSSI,Events,RAWSSI,Location
0,1950-1951,1950-11-24,1951-02-28,97,0,3,88,91,4,1,5,96,3,17,AL - Birmingham
1,1951-1952,1951-12-01,1952-02-29,91,0,0,38,38,0,0,0,38,0,0,AL - Birmingham
2,1952-1953,1952-12-01,1953-02-28,90,0,0,34,34,0,0,0,34,0,0,AL - Birmingham
3,1953-1954,1953-12-01,1954-02-28,90,0,1,52,53,0,0,0,53,0,0,AL - Birmingham
4,1954-1955,1954-12-01,1955-02-28,90,0,1,61,62,0,0,0,62,0,0,AL - Birmingham
5,1955-1956,1955-12-01,1956-02-29,91,0,0,49,49,0,0,0,49,0,0,AL - Birmingham
6,1956-1957,1956-12-01,1957-03-08,98,0,0,27,27,1,0,1,28,1,2,AL - Birmingham
7,1957-1958,1957-12-01,1958-02-28,90,0,5,101,106,4,3,7,113,2,8,AL - Birmingham
8,1958-1959,1958-12-01,1959-02-28,90,0,1,74,75,4,1,5,80,1,5,AL - Birmingham
9,1959-1960,1959-12-01,1960-02-29,91,0,0,49,49,3,2,5,54,1,4,AL - Birmingham
10,1960-1961,1960-12-01,1961-02-28,90,0,2,73,75,0,0,0,75,0,0,AL - Birmingham
11,1961-1962,1961-12-01,1962-02-28,90,0,7,57,64,5,13,18,82,2,17,AL - Birmingham
12,1962-1963,1962-12-01,1963-02-28,90,0,9,119,128,2,0,2,130,2,4,AL - Birmingham
13,1963-1964,1963-12-01,1964-02-29,91,0,1,93,94,13,10,23,117,2,17,AL - Birmingham
14,1964-1965,1964-12-01,1965-02-28,90,1,2,72,74,0,0,0,74,0,0,AL - Birmingham
15,1965-1966,1965-12-01,1966-02-28,90,0,3,86,89,2,2,4,93,1,8,AL - Birmingham
16,1966-1967,1966-12-01,1967-02-28,90,0,2,71,73,1,0,1,74,1,2,AL - Birmingham
17,1967-1968,1967-12-01,1968-02-29,91,0,1,71,72,3,1,4,76,2,8,AL - Birmingham
18,1968-1969,1968-12-01,1969-02-28,90,0,1,81,82,0,0,0,82,0,0,AL - Birmingham
19,1969-1970,1969-12-01,1970-02-28,90,0,6,88,94,5,0,5,99,4,8,AL - Birmingham
20,1970-1971,1970-12-01,1971-02-28,90,0,3,77,80,3,1,4,84,3,11,AL - Birmingham
21,1971-1972,1971-12-01,1972-02-29,91,0,2,42,44,0,0,0,44,0,0,AL - Birmingham
22,1972-1973,1972-12-01,1973-02-28,90,0,2,71,73,0,0,0,73,0,0,AL - Birmingham
23,1973-1974,1973-12-01,1974-02-28,90,0,1,39,40,0,0,0,40,0,0,AL - Birmingham
24,1974-1975,1974-12-01,1975-02-28,90,0,0,37,37,1,0,1,38,1,2,AL - Birmingham
25,1975-1976,1975-12-01,1976-02-29,91,0,2,75,77,0,0,0,77,0,0,AL - Birmingham
26,1976-1977,1976-11-29,1977-02-28,92,0,10,141,151,3,1,4,155,2,13,AL - Birmingham
27,1977-1978,1977-12-01,1978-02-28,90,0,11,109,120,3,3,6,126,2,7,AL - Birmingham
28,1978-1979,1978-12-01,1979-02-28,90,0,1,84,85,0,0,0,85,0,0,AL - Birmingham
29,1979-1980,1979-12-01,1980-03-02,93,0,3,69,72,1,0,1,73,1,6,AL - Birmingham
30,1980-1981,1980-12-01,1981-02-28,90,0,0,90,90,0,0,0,90,0,0,AL - Birmingham
31,1981-1982,1981-12-01,1982-02-28,90,0,5,85,90,10,2,12,102,3,18,AL - Birmingham
32,1982-1983,1982-12-01,1983-03-24,114,6,0,54,54,2,1,3,57,1,3,AL - Birmingham
33,1983-1984,1983-12-01,1984-03-10,101,0,9,112,121,3,0,3,124,1,4,AL - Birmingham
34,1984-1985,1984-12-01,1985-02-28,90,0,5,96,101,1,0,1,102,1,2,AL - Birmingham
35,1985-1986,1985-12-01,1986-02-28,90,0,4,93,97,0,0,0,97,0,0,AL - Birmingham
36,1986-1987,1986-12-01,1987-04-03,124,0,0,69,69,10,7,17,86,2,12,AL - Birmingham
37,1987-1988,1987-12-01,1988-02-29,91,0,3,79,82,2,1,3,85,1,3,AL - Birmingham
38,1988-1989,1988-12-01,1989-02-28,90,0,0,49,49,0,0,0,49,0,0,AL - Birmingham
39,1989-1990,1989-12-01,1990-02-28,90,0,8,65,73,1,0,1,74,1,1,AL - Birmingham
40,1990-1991,1990-12-01,1991-02-28,90,0,1,46,47,0,0,0,47,0,0,AL - Birmingham
41,1991-1992,1991-12-01,1992-02-29,91,0,0,52,52,6,5,11,63,1,7,AL - Birmingham
42,1992-1993,1992-12-01,1993-03-16,106,0,1,55,56,17,20,37,93,2,23,AL - Birmingham
43,1993-1994,1993-12-01,1994-02-28,90,0,2,76,78,0,0,0,78,0,0,AL - Birmingham
44,1994-1995,1994-12-01,1995-02-28,90,0,0,50,50,2,0,2,52,2,6,AL - Birmingham
45,1995-1996,1995-12-01,1996-03-08,99,0,10,104,114,3,2,5,119,3,16,AL - Birmingham
46,1996-1997,1996-12-01,1997-02-28,90,0,3,58,61,0,0,0,61,0,0,AL - Birmingham
47,1997-1998,1997-12-01,1998-02-28,90,0,0,37,37,3,0,3,40,2,5,AL - Birmingham
48,1998-1999,1998-12-01,1999-02-28,90,0,3,39,42,0,0,0,42,0,0,AL - Birmingham
49,1999-2000,1999-12-01,2000-02-29,91,0,0,55,55,4,3,7,62,1,5,AL - Birmingham
50,2000-2001,2000-12-01,2001-02-28,90,0,2,86,88,0,0,0,88,0,0,AL - Birmingham
51,2001-2002,2001-12-01,2002-02-28,90,0,0,51,51,0,0,0,51,0,0,AL - Birmingham
52,2002-2003,2002-12-01,2003-02-28,90,0,2,66,68,0,0,0,68,0,0,AL - Birmingham
53,2003-2004,2003-12-01,2004-02-29,91,0,0,61,61,0,0,0,61,0,0,AL - Birmingham
54,2004-2005,2004-12-01,2005-02-28,90,0,1,49,50,0,0,0,50,0,0,AL - Birmingham
55,2005-2006,2005-12-01,2006-02-28,90,0,0,44,44,0,0,0,44,0,0,AL - Birmingham
56,2006-2007,2006-12-01,2007-02-28,90,0,0,50,50,0,0,0,50,0,0,AL - Birmingham
57,2007-2008,2007-12-01,2008-03-08,99,0,1,49,50,1,0,1,51,1,2,AL - Birmingham
58,2008-2009,2008-12-01,2009-03-01,91,0,1,64,65,3,0,3,68,1,4,AL - Birmingham
59,2009-2010,2009-12-01,2010-02-28,90,0,3,86,89,2,0,2,91,1,4,AL - Birmingham
60,2010-2011,2010-12-01,2011-02-28,90,0,3,78,81,4,2,6,87,2,8,AL - Birmingham
61,2011-2012,2011-12-01,2012-02-29,91,0,0,32,32,0,0,0,32,0,0,AL - Birmingham
62,2012-2013,2012-12-01,2013-02-28,90,0,0,29,29,3,0,3,32,1,3,AL - Birmingham
63,2013-2014,2013-12-01,2014-02-28,90,0,6,91,97,7,4,11,108,2,13,AL - Birmingham
64,2014-2015,2014-12-01,2015-03-05,95,0,1,73,74,2,0,2,76,2,5,AL - Birmingham
65,2015-2016,2015-12-01,2016-02-29,91,0,0,36,36,0,0,0,36,0,0,AL - Birmingham
66,2016-2017,2016-12-01,2017-02-28,90,0,1,29,30,1,0,1,31,1,3,AL - Birmingham
67,2017-2018,2017-12-01,2018-02-28,90,0,3,63,66,6,2,8,74,1,7,AL - Birmingham
68,2018-2019,2018-12-01,2019-02-28,90,0,0,23,23,0,0,0,23,0,0,AL - Birmingham
69,2019-2020,2019-12-01,2020-02-29,91,0,0,23,23,0,0,0,23,0,0,AL - Birmingham
0,1950-1951,1950-11-24,1951-03-14,111,2,11,110,121,6,5,11,132,3,16,AL - Huntsville
1,1951-1952,1951-12-01,1952-02-29,91,0,1,49,50,0,0,0,50,0,0,AL - Huntsville
2,1952-1953,1952-12-01,1953-02-28,90,0,0,47,47,0,0,0,47,0,0,AL - Huntsville
3,1953-1954,1953-12-01,1954-02-28,90,0,3,64,67,0,0,0,67,0,0,AL - Huntsville
4,1954-1955,1954-12-01,1955-02-28,90,3,2,85,87,0,0,0,87,0,0,AL - Huntsville
5,1955-1956,1955-11-28,1956-02-29,94,1,1,89,90,0,0,0,90,0,0,AL - Huntsville
6,1956-1957,1956-12-01,1957-02-28,90,0,2,44,46,0,0,0,46,0,0,AL - Huntsville
8,1958-1959,1958-12-01,1959-02-28,90,0,6,103,109,1,1,2,111,1,3,AL - Huntsville
9,1959-1960,1959-12-01,1960-03-15,106,0,3,91,94,17,17,34,128,7,28,AL - Huntsville
10,1960-1961,1960-12-01,1961-02-28,90,0,4,103,107,1,0,1,108,1,2,AL - Huntsville
11,1961-1962,1961-12-01,1962-02-28,90,0,8,75,83,9,13,22,105,4,27,AL - Huntsville
12,1962-1963,1962-12-01,1963-02-28,90,0,13,149,162,9,5,14,176,5,25,AL - Huntsville
13,1963-1964,1963-12-01,1964-02-29,91,0,6,111,117,36,26,62,179,7,54,AL - Huntsville
14,1964-1965,1964-12-01,1965-03-07,97,0,6,99,105,10,2,12,117,7,26,AL - Huntsville
15,1965-1966,1965-12-01,1966-02-28,90,0,6,94,100,12,17,29,129,3,23,AL - Huntsville
16,1966-1967,1966-11-02,1967-02-28,119,0,3,100,103,9,7,16,119,3,13,AL - Huntsville
17,1967-1968,1967-12-01,1968-03-23,114,0,5,133,138,16,8,24,162,9,32,AL - Huntsville
18,1968-1969,1968-12-01,1969-02-28,90,0,4,87,91,1,0,1,92,1,2,AL - Huntsville
19,1969-1970,1969-11-14,1970-02-28,107,0,12,122,134,10,3,13,147,8,28,AL - Huntsville
20,1970-1971,1970-11-24,1971-02-28,97,0,6,80,86,10,1,11,97,7,21,AL - Huntsville
21,1971-1972,1971-12-01,1972-02-29,91,0,2,50,52,1,0,1,53,1,3,AL - Huntsville
22,1972-1973,1972-12-01,1973-02-28,90,0,4,67,71,1,0,1,72,1,2,AL - Huntsville
23,1973-1974,1973-12-01,1974-02-28,90,0,1,43,44,1,0,1,45,1,2,AL - Huntsville
24,1974-1975,1974-11-14,1975-02-28,107,0,1,66,67,8,6,14,81,4,11,AL - Huntsville
25,1975-1976,1975-12-01,1976-02-29,91,0,5,87,92,2,0,2,94,2,9,AL - Huntsville
26,1976-1977,1976-11-28,1977-02-28,93,0,14,163,177,3,0,3,180,3,19,AL - Huntsville
27,1977-1978,1977-12-01,1978-02-28,90,0,20,140,160,5,5,10,170,3,13,AL - Huntsville
28,1978-1979,1978-12-01,1979-02-28,90,0,7,108,115,10,3,13,128,8,24,AL - Huntsville
29,1979-1980,1979-12-01,1980-03-02,93,0,8,101,109,8,3,11,120,5,20,AL - Huntsville
30,1980-1981,1980-12-01,1981-02-28,90,0,6,120,126,1,0,1,127,1,5,AL - Huntsville
31,1981-1982,1981-12-01,1982-03-07,97,0,10,102,112,6,11,17,129,3,17,AL - Huntsville
32,1982-1983,1982-12-01,1983-02-28,90,0,0,60,60,0,0,0,60,0,0,AL - Huntsville
33,1983-1984,1983-12-01,1984-02-29,91,0,20,123,143,5,2,7,150,3,9,AL - Huntsville
34,1984-1985,1984-12-01,1985-02-28,90,0,13,110,123,12,15,27,150,4,29,AL - Huntsville
35,1985-1986,1985-12-01,1986-02-28,90,0,8,119,127,2,1,3,130,2,6,AL - Huntsville
36,1986-1987,1986-12-01,1987-02-28,90,0,2,57,59,3,1,4,63,2,5,AL - Huntsville
37,1987-1988,1987-12-01,1988-02-29,91,0,7,99,106,15,28,43,149,3,23,AL - Huntsville
38,1988-1989,1988-12-01,1989-02-28,90,0,3,56,59,3,0,3,62,3,9,AL - Huntsville
39,1989-1990,1989-12-01,1990-02-28,90,0,13,77,90,1,0,1,91,1,3,AL - Huntsville
40,1990-1991,1990-12-01,1991-02-28,90,0,1,50,51,0,0,0,51,0,0,AL - Huntsville
41,1991-1992,1991-12-01,1992-02-29,91,0,1,52,53,1,0,1,54,1,2,AL - Huntsville
42,1992-1993,1992-12-01,1993-03-15,105,0,2,63,65,9,11,20,85,2,13,AL - Huntsville
43,1993-1994,1993-12-01,1994-02-28,90,0,7,94,101,1,0,1,102,1,4,AL - Huntsville
44,1994-1995,1994-12-01,1995-02-28,90,0,2,68,70,3,0,3,73,2,6,AL - Huntsville
52,2002-2003,2002-12-01,2003-02-28,90,0,3,90,93,2,0,2,95,2,9,AL - Huntsville
53,2003-2004,2003-12-01,2004-02-29,91,5,0,75,75,0,0,0,75,0,0,AL - Huntsville
54,2004-2005,2004-12-01,2005-02-28,90,0,2,65,67,0,0,0,67,0,0,AL - Huntsville
55,2005-2006,2005-12-01,2006-02-28,90,0,0,59,59,2,0,2,61,2,3,AL - Huntsville
56,2006-2007,2006-12-01,2007-02-28,90,0,0,71,71,2,1,3,74,1,3,AL - Huntsville
57,2007-2008,2007-12-01,2008-03-07,98,0,2,66,68,2,0,2,70,2,3,AL - Huntsville
58,2008-2009,2008-12-01,2009-03-01,91,0,5,71,76,2,0,2,78,2,3,AL - Huntsville
59,2009-2010,2009-12-01,2010-03-02,92,0,7,93,100,8,1,9,109,7,15,AL - Huntsville
60,2010-2011,2010-12-01,2011-02-28,90,0,5,89,94,20,36,56,150,6,30,AL - Huntsville
61,2011-2012,2011-12-01,2012-02-29,91,0,0,41,41,0,0,0,41,0,0,AL - Huntsville
62,2012-2013,2012-12-01,2013-02-28,90,0,0,34,34,1,0,1,35,1,1,AL - Huntsville
63,2013-2014,2013-12-01,2014-02-28,90,0,9,112,121,7,11,18,139,3,9,AL - Huntsville
64,2014-2015,2014-12-01,2015-03-06,96,1,3,72,75,16,10,26,101,4,22,AL - Huntsville
65,2015-2016,2015-12-01,2016-02-29,91,0,0,49,49,1,0,1,50,1,2,AL - Huntsville
66,2016-2017,2016-12-01,2017-02-28,90,0,2,36,38,0,0,0,38,0,0,AL - Huntsville
67,2017-2018,2017-12-01,2018-02-28,90,0,6,85,91,1,0,1,92,1,5,AL - Huntsville
68,2018-2019,2018-12-01,2019-02-28,90,0,0,29,29,0,0,0,29,0,0,AL - Huntsville
69,2019-2020,2019-12-01,2020-02-29,91,0,1,30,31,1,1,2,33,1,2,AL - Huntsville
0,1950-1951,1950-12-01,1951-02-28,90,0,1,28,29,0,0,0,29,0,0,AL - Mobile
1,1951-1952,1951-12-01,1952-02-29,91,0,0,8,8,0,0,0,8,0,0,AL - Mobile
2,1952-1953,1952-12-01,1953-02-28,90,0,0,8,8,0,0,0,8,0,0,AL - Mobile
3,1953-1954,1953-12-01,1954-03-06,96,0,0,13,13,2,1,3,16,1,2,AL - Mobile
4,1954-1955,1954-12-01,1955-02-28,90,0,0,17,17,4,0,4,21,1,5,AL - Mobile
5,1955-1956,1955-12-01,1956-02-29,91,0,0,17,17,0,0,0,17,0,0,AL - Mobile
6,1956-1957,1956-12-01,1957-02-28,90,0,0,5,5,0,0,0,5,0,0,AL - Mobile
7,1957-1958,1957-12-01,1958-02-28,90,0,0,42,42,2,1,3,45,1,4,AL - Mobile
8,1958-1959,1958-12-01,1959-02-28,90,0,0,24,24,0,0,0,24,0,0,AL - Mobile
9,1959-1960,1959-12-01,1960-02-29,91,0,0,19,19,0,0,0,19,0,0,AL - Mobile
10,1960-1961,1960-12-01,1961-02-28,90,0,0,29,29,0,0,0,29,0,0,AL - Mobile
11,1961-1962,1961-12-01,1962-02-28,90,0,3,31,34,0,0,0,34,0,0,AL - Mobile
12,1962-1963,1962-12-01,1963-02-28,90,0,3,45,48,0,0,0,48,0,0,AL - Mobile
13,1963-1964,1963-12-01,1964-02-29,91,0,0,29,29,4,2,6,35,1,5,AL - Mobile
14,1964-1965,1964-12-01,1965-02-28,90,0,0,24,24,0,0,0,24,0,0,AL - Mobile
15,1965-1966,1965-12-01,1966-02-28,90,0,1,20,21,0,0,0,21,0,0,AL - Mobile
16,1966-1967,1966-12-01,1967-02-28,90,0,0,10,10,0,0,0,10,0,0,AL - Mobile
17,1967-1968,1967-12-01,1968-02-29,91,0,0,25,25,2,0,2,27,1,2,AL - Mobile
18,1968-1969,1968-12-01,1969-02-28,90,0,0,19,19,0,0,0,19,0,0,AL - Mobile
19,1969-1970,1969-12-01,1970-02-28,90,0,1,26,27,0,0,0,27,0,0,AL - Mobile
20,1970-1971,1970-12-01,1971-02-28,90,0,0,15,15,0,0,0,15,0,0,AL - Mobile
21,1971-1972,1971-12-01,1972-02-29,91,0,0,12,12,0,0,0,12,0,0,AL - Mobile
22,1972-1973,1972-12-01,1973-02-28,90,0,0,21,21,4,4,8,29,1,5,AL - Mobile
23,1973-1974,1973-12-01,1974-02-28,90,0,0,12,12,0,0,0,12,0,0,AL - Mobile
24,1974-1975,1974-12-01,1975-02-28,90,0,0,11,11,0,0,0,11,0,0,AL - Mobile
25,1975-1976,1975-12-01,1976-02-29,91,0,0,21,21,0,0,0,21,0,0,AL - Mobile
26,1976-1977,1976-12-01,1977-02-28,90,0,1,47,48,3,1,4,52,2,7,AL - Mobile
27,1977-1978,1977-12-01,1978-02-28,90,0,0,45,45,1,0,1,46,1,2,AL - Mobile
28,1978-1979,1978-12-01,1979-02-28,90,0,0,32,32,0,0,0,32,0,0,AL - Mobile
29,1979-1980,1979-12-01,1980-02-29,91,0,0,23,23,0,0,0,23,0,0,AL - Mobile
30,1980-1981,1980-12-01,1981-02-28,90,0,0,34,34,0,0,0,34,0,0,AL - Mobile
31,1981-1982,1981-12-01,1982-02-28,90,0,1,39,40,0,0,0,40,0,0,AL - Mobile
32,1982-1983,1982-12-01,1983-02-28,90,0,0,17,17,0,0,0,17,0,0,AL - Mobile
33,1983-1984,1983-12-01,1984-02-29,91,0,3,46,49,0,0,0,49,0,0,AL - Mobile
34,1984-1985,1984-12-01,1985-02-28,90,0,1,47,48,0,0,0,48,0,0,AL - Mobile
35,1985-1986,1985-12-01,1986-02-28,90,0,0,30,30,0,0,0,30,0,0,AL - Mobile
36,1986-1987,1986-12-01,1987-02-28,90,0,0,14,14,0,0,0,14,0,0,AL - Mobile
37,1987-1988,1987-12-01,1988-02-29,91,0,0,30,30,2,1,3,33,1,2,AL - Mobile
38,1988-1989,1988-12-01,1989-02-28,90,0,0,16,16,0,0,0,16,0,0,AL - Mobile
39,1989-1990,1989-12-01,1990-02-28,90,0,3,30,33,0,0,0,33,0,0,AL - Mobile
40,1990-1991,1990-12-01,1991-02-28,90,0,0,11,11,0,0,0,11,0,0,AL - Mobile
41,1991-1992,1991-12-01,1992-02-29,91,0,0,13,13,0,0,0,13,0,0,AL - Mobile
42,1992-1993,1992-12-01,1993-03-13,103,0,0,4,4,4,2,6,10,2,5,AL - Mobile
43,1993-1994,1993-12-01,1994-02-28,90,0,0,22,22,0,0,0,22,0,0,AL - Mobile
44,1994-1995,1994-12-01,1995-02-28,90,0,0,14,14,0,0,0,14,0,0,AL - Mobile
45,1995-1996,1995-12-01,1996-02-29,91,14,1,53,54,0,0,0,54,0,0,AL - Mobile
46,1996-1997,1996-12-01,1997-02-28,90,14,0,21,21,2,0,2,23,1,3,AL - Mobile
47,1997-1998,1997-12-01,1998-02-28,90,15,0,9,9,1,0,1,10,1,1,AL - Mobile
48,1998-1999,1998-12-01,1999-02-28,90,12,0,14,14,0,0,0,14,0,0,AL - Mobile
49,1999-2000,1999-12-01,2000-02-29,91,0,0,18,18,0,0,0,18,0,0,AL - Mobile
50,2000-2001,2000-12-01,2001-02-28,90,0,0,39,39,0,0,0,39,0,0,AL - Mobile
51,2001-2002,2001-12-01,2002-02-28,90,0,0,26,26,0,0,0,26,0,0,AL - Mobile
52,2002-2003,2002-12-01,2003-02-28,90,0,0,26,26,0,0,0,26,0,0,AL - Mobile
53,2003-2004,2003-12-01,2004-02-29,91,0,0,22,22,0,0,0,22,0,0,AL - Mobile
54,2004-2005,2004-12-01,2005-02-28,90,0,0,16,16,0,0,0,16,0,0,AL - Mobile
55,2005-2006,2005-12-01,2006-02-28,90,0,0,18,18,0,0,0,18,0,0,AL - Mobile
56,2006-2007,2006-12-01,2007-02-28,90,0,0,26,26,0,0,0,26,0,0,AL - Mobile
57,2007-2008,2007-12-01,2008-02-29,91,0,0,17,17,0,0,0,17,0,0,AL - Mobile
58,2008-2009,2008-12-01,2009-02-28,90,0,0,19,19,0,0,0,19,0,0,AL - Mobile
59,2009-2010,2009-12-01,2010-02-28,90,0,0,46,46,1,0,1,47,1,2,AL - Mobile
60,2010-2011,2010-12-01,2011-02-28,90,0,0,41,41,0,0,0,41,0,0,AL - Mobile
61,2011-2012,2011-12-01,2012-02-29,91,0,0,11,11,0,0,0,11,0,0,AL - Mobile
62,2012-2013,2012-12-01,2013-02-28,90,0,0,4,4,0,0,0,4,0,0,AL - Mobile
63,2013-2014,2013-12-01,2014-02-28,90,0,1,43,44,2,2,4,48,1,4,AL - Mobile
64,2014-2015,2014-12-01,2015-02-28,90,0,0,23,23,0,0,0,23,0,0,AL - Mobile
65,2015-2016,2015-12-01,2016-02-29,91,0,0,14,14,0,0,0,14,0,0,AL - Mobile
66,2016-2017,2016-12-01,2017-02-28,90,0,0,8,8,0,0,0,8,0,0,AL - Mobile
67,2017-2018,2017-12-01,2018-02-28,90,2,0,30,30,3,0,3,33,2,6,AL - Mobile
68,2018-2019,2018-12-01,2019-02-28,90,0,0,6,6,0,0,0,6,0,0,AL - Mobile
69,2019-2020,2019-12-01,2020-02-29,91,0,0,15,15,0,0,0,15,0,0,AL - Mobile
0,1950-1951,1950-11-25,1951-02-28,96,0,2,66,68,0,0,0,68,0,0,AL - Montgomery
1,1951-1952,1951-12-01,1952-02-29,91,0,0,24,24,0,0,0,24,0,0,AL - Montgomery
2,1952-1953,1952-12-01,1953-02-28,90,0,0,20,20,0,0,0,20,0,0,AL - Montgomery
3,1953-1954,1953-12-01,1954-02-28,90,0,0,26,26,0,0,0,26,0,0,AL - Montgomery
4,1954-1955,1954-12-01,1955-02-28,90,0,0,43,43,0,0,0,43,0,0,AL - Montgomery
5,1955-1956,1955-12-01,1956-02-29,91,0,0,36,36,0,0,0,36,0,0,AL - Montgomery
6,1956-1957,1956-12-01,1957-02-28,90,0,0,17,17,0,0,0,17,0,0,AL - Montgomery
7,1957-1958,1957-12-01,1958-02-28,90,0,1,70,71,0,0,0,71,0,0,AL - Montgomery
8,1958-1959,1958-12-01,1959-02-28,90,0,0,41,41,0,0,0,41,0,0,AL - Montgomery
9,1959-1960,1959-12-01,1960-02-29,91,0,0,27,27,0,0,0,27,0,0,AL - Montgomery
10,1960-1961,1960-12-01,1961-02-28,90,0,0,61,61,0,0,0,61,0,0,AL - Montgomery
11,1961-1962,1961-12-01,1962-02-28,90,0,3,34,37,2,1,3,40,1,3,AL - Montgomery
12,1962-1963,1962-12-01,1963-02-28,90,0,5,83,88,0,0,0,88,0,0,AL - Montgomery
13,1963-1964,1963-12-01,1964-02-29,91,0,1,54,55,2,1,3,58,1,2,AL - Montgomery
14,1964-1965,1964-12-01,1965-02-28,90,0,0,43,43,0,0,0,43,0,0,AL - Montgomery
15,1965-1966,1965-12-01,1966-02-28,90,0,1,50,51,0,0,0,51,0,0,AL - Montgomery
16,1966-1967,1966-12-01,1967-02-28,90,0,0,28,28,0,0,0,28,0,0,AL - Montgomery
17,1967-1968,1967-12-01,1968-02-29,91,0,1,39,40,0,0,0,40,0,0,AL - Montgomery
18,1968-1969,1968-12-01,1969-02-28,90,0,0,47,47,0,0,0,47,0,0,AL - Montgomery
19,1969-1970,1969-12-01,1970-02-28,90,0,3,68,71,0,0,0,71,0,0,AL - Montgomery
20,1970-1971,1970-12-01,1971-02-28,90,0,0,43,43,0,0,0,43,0,0,AL - Montgomery
21,1971-1972,1971-12-01,1972-02-29,91,0,0,24,24,0,0,0,24,0,0,AL - Montgomery
22,1972-1973,1972-12-01,1973-02-28,90,0,0,37,37,4,2,6,43,1,5,AL - Montgomery
23,1973-1974,1973-12-01,1974-02-28,90,0,0,27,27,0,0,0,27,0,0,AL - Montgomery
24,1974-1975,1974-12-01,1975-02-28,90,0,0,18,18,0,0,0,18,0,0,AL - Montgomery
25,1975-1976,1975-12-01,1976-02-29,91,0,0,52,52,0,0,0,52,0,0,AL - Montgomery
26,1976-1977,1976-12-01,1977-02-28,90,0,3,87,90,9,6,15,105,3,17,AL - Montgomery
27,1977-1978,1977-12-01,1978-02-28,90,0,0,55,55,0,0,0,55,0,0,AL - Montgomery
28,1978-1979,1978-12-01,1979-02-28,90,0,0,44,44,0,0,0,44,0,0,AL - Montgomery
29,1979-1980,1979-12-01,1980-02-29,91,0,0,32,32,0,0,0,32,0,0,AL - Montgomery
30,1980-1981,1980-12-01,1981-02-28,90,0,0,49,49,0,0,0,49,0,0,AL - Montgomery
31,1981-1982,1981-12-01,1982-02-28,90,0,2,47,49,1,0,1,50,1,5,AL - Montgomery
32,1982-1983,1982-12-01,1983-02-28,90,0,0,29,29,0,0,0,29,0,0,AL - Montgomery
33,1983-1984,1983-12-01,1984-02-29,91,0,4,61,65,0,0,0,65,0,0,AL - Montgomery
34,1984-1985,1984-12-01,1985-02-28,90,0,2,57,59,0,0,0,59,0,0,AL - Montgomery
35,1985-1986,1985-12-01,1986-02-28,90,0,0,62,62,0,0,0,62,0,0,AL - Montgomery
36,1986-1987,1986-12-01,1987-04-03,124,0,0,33,33,1,1,2,35,1,1,AL - Montgomery
37,1987-1988,1987-12-01,1988-02-29,91,0,0,58,58,0,0,0,58,0,0,AL - Montgomery
38,1988-1989,1988-12-01,1989-02-28,90,0,0,35,35,0,0,0,35,0,0,AL - Montgomery
39,1989-1990,1989-12-01,1990-02-28,90,0,5,48,53,0,0,0,53,0,0,AL - Montgomery
40,1990-1991,1990-12-01,1991-02-28,90,0,0,29,29,0,0,0,29,0,0,AL - Montgomery
41,1991-1992,1991-12-01,1992-02-29,91,0,0,33,33,0,0,0,33,0,0,AL - Montgomery
42,1992-1993,1992-12-01,1993-03-14,104,0,0,25,25,4,7,11,36,1,5,AL - Montgomery
43,1993-1994,1993-12-01,1994-02-28,90,0,0,44,44,2,1,3,47,1,2,AL - Montgomery
44,1994-1995,1994-12-01,1995-02-28,90,0,0,22,22,0,0,0,22,0,0,AL - Montgomery
45,1995-1996,1995-12-01,1996-02-29,91,4,3,72,75,0,0,0,75,0,0,AL - Montgomery
54,2004-2005,2004-12-01,2005-02-28,90,0,0,36,36,0,0,0,36,0,0,AL - Montgomery
55,2005-2006,2005-12-01,2006-02-28,90,18,0,39,39,0,0,0,39,0,0,AL - Montgomery
56,2006-2007,2006-12-01,2007-02-28,90,1,0,44,44,0,0,0,44,0,0,AL - Montgomery
57,2007-2008,2007-12-01,2008-02-29,91,4,0,40,40,0,0,0,40,0,0,AL - Montgomery
58,2008-2009,2008-12-01,2009-02-28,90,0,0,42,42,0,0,0,42,0,0,AL - Montgomery
59,2009-2010,2009-12-01,2010-02-28,90,0,1,69,70,4,1,5,75,1,5,AL - Montgomery
60,2010-2011,2010-12-01,2011-02-28,90,0,0,70,70,0,0,0,70,0,0,AL - Montgomery
61,2011-2012,2011-12-01,2012-02-29,91,0,0,26,26,0,0,0,26,0,0,AL - Montgomery
62,2012-2013,2012-12-01,2013-02-28,90,0,0,17,17,0,0,0,17,0,0,AL - Montgomery
63,2013-2014,2013-12-01,2014-02-28,90,2,2,66,68,1,0,1,69,1,3,AL - Montgomery
64,2014-2015,2014-12-01,2015-02-28,90,2,0,47,47,0,0,0,47,0,0,AL - Montgomery
65,2015-2016,2015-12-01,2016-02-29,91,7,0,25,25,0,0,0,25,0,0,AL - Montgomery
66,2016-2017,2016-12-01,2017-02-28,90,9,0,14,14,0,0,0,14,0,0,AL - Montgomery
67,2017-2018,2017-12-01,2018-02-28,90,8,1,50,51,0,0,0,51,0,0,AL - Montgomery
68,2018-2019,2018-12-01,2019-02-28,90,6,0,20,20,0,0,0,20,0,0,AL - Montgomery
0,1950-1951,1950-11-24,1951-03-13,110,0,12,107,119,12,12,24,143,4,26,AL - Muscle Shoals
1,1951-1952,1951-12-01,1952-02-29,91,2,3,41,44,0,0,0,44,0,0,AL - Muscle Shoals
2,1952-1953,1952-11-30,1953-02-28,91,2,2,29,31,0,0,0,31,0,0,AL - Muscle Shoals
3,1953-1954,1953-12-01,1954-02-28,90,0,3,50,53,3,2,5,58,1,4,AL - Muscle Shoals
4,1954-1955,1954-12-01,1955-03-26,116,0,3,75,78,4,2,6,84,2,7,AL - Muscle Shoals
5,1955-1956,1955-12-01,1956-02-29,91,0,0,58,58,3,1,4,62,1,4,AL - Muscle Shoals
6,1956-1957,1956-12-01,1957-02-28,90,1,2,33,35,0,0,0,35,0,0,AL - Muscle Shoals
7,1957-1958,1957-12-01,1958-02-28,90,2,11,109,120,4,8,12,132,2,8,AL - Muscle Shoals
8,1958-1959,1958-12-01,1959-02-28,90,0,7,92,99,2,1,3,102,1,5,AL - Muscle Shoals
9,1959-1960,1959-12-01,1960-03-14,105,0,5,76,81,24,19,43,124,5,30,AL - Muscle Shoals
10,1960-1961,1960-12-01,1961-02-28,90,2,5,118,123,0,0,0,123,0,0,AL - Muscle Shoals
11,1961-1962,1961-12-01,1962-02-28,90,2,11,89,100,0,12,12,112,0,0,AL - Muscle Shoals
12,1962-1963,1962-12-01,1963-02-28,90,2,15,173,188,2,1,3,191,2,11,AL - Muscle Shoals
13,1963-1964,1963-12-01,1964-02-29,91,3,4,121,125,24,28,52,177,4,33,AL - Muscle Shoals
14,1964-1965,1964-12-01,1965-03-05,95,4,5,96,101,4,0,4,105,3,11,AL - Muscle Shoals
15,1965-1966,1965-12-01,1966-02-28,90,0,7,90,97,16,15,31,128,3,26,AL - Muscle Shoals
16,1966-1967,1966-12-01,1967-02-28,90,0,1,71,72,2,0,2,74,1,3,AL - Muscle Shoals
17,1967-1968,1967-12-01,1968-03-24,115,0,6,115,121,29,25,54,175,8,45,AL - Muscle Shoals
18,1968-1969,1968-12-01,1969-02-28,90,0,1,82,83,4,2,6,89,2,6,AL - Muscle Shoals
19,1969-1970,1969-11-14,1970-02-28,107,0,10,97,107,5,1,6,113,4,16,AL - Muscle Shoals
20,1970-1971,1970-11-24,1971-02-28,97,0,7,92,99,4,1,5,104,2,12,AL - Muscle Shoals
21,1971-1972,1971-12-01,1972-02-29,91,0,3,49,52,0,0,0,52,0,0,AL - Muscle Shoals
22,1972-1973,1972-12-01,1973-02-28,90,0,8,87,95,0,0,0,95,0,0,AL - Muscle Shoals
23,1973-1974,1973-12-01,1974-02-28,90,0,2,55,57,0,0,0,57,0,0,AL - Muscle Shoals
24,1974-1975,1974-12-01,1975-02-28,90,0,1,65,66,3,3,6,72,2,6,AL - Muscle Shoals
25,1975-1976,1975-12-01,1976-02-29,91,0,4,91,95,0,0,0,95,0,0,AL - Muscle Shoals
26,1976-1977,1976-11-29,1977-02-28,92,0,18,174,192,2,2,4,196,2,18,AL - Muscle Shoals
27,1977-1978,1977-12-01,1978-02-28,90,0,19,147,166,10,12,22,188,4,20,AL - Muscle Shoals
28,1978-1979,1978-12-01,1979-02-28,90,0,10,111,121,11,5,16,137,6,18,AL - Muscle Shoals
29,1979-1980,1979-12-01,1980-03-02,93,0,7,82,89,4,2,6,95,2,10,AL - Muscle Shoals
30,1980-1981,1980-12-01,1981-02-28,90,0,7,109,116,0,0,0,116,0,0,AL - Muscle Shoals
31,1981-1982,1981-12-01,1982-02-28,90,0,14,100,114,3,10,13,127,1,8,AL - Muscle Shoals
32,1982-1983,1982-12-01,1983-02-28,90,0,1,55,56,2,1,3,59,2,6,AL - Muscle Shoals
33,1983-1984,1983-12-01,1984-02-29,91,0,15,113,128,7,4,11,139,5,14,AL - Muscle Shoals
34,1984-1985,1984-12-01,1985-02-28,90,0,11,110,121,17,35,52,173,6,41,AL - Muscle Shoals
35,1985-1986,1985-12-01,1986-02-28,90,0,7,114,121,1,1,2,123,1,3,AL - Muscle Shoals
36,1986-1987,1986-12-01,1987-04-02,123,0,1,60,61,1,0,1,62,1,1,AL - Muscle Shoals
37,1987-1988,1987-12-01,1988-02-29,91,3,7,94,101,4,25,29,130,2,10,AL - Muscle Shoals
38,1988-1989,1988-12-01,1989-02-28,90,0,1,58,59,2,0,2,61,1,2,AL - Muscle Shoals
39,1989-1990,1989-12-01,1990-02-28,90,0,12,81,93,4,5,9,102,2,13,AL - Muscle Shoals
40,1990-1991,1990-12-01,1991-03-08,98,1,1,57,58,2,1,3,61,1,2,AL - Muscle Shoals
41,1991-1992,1991-12-01,1992-02-29,91,0,1,40,41,0,0,0,41,0,0,AL - Muscle Shoals
42,1992-1993,1992-12-01,1993-03-13,103,0,2,51,53,6,4,10,63,2,10,AL - Muscle Shoals
43,1993-1994,1993-12-01,1994-02-28,90,0,4,81,85,0,0,0,85,0,0,AL - Muscle Shoals
44,1994-1995,1994-12-01,1995-02-28,90,0,1,58,59,2,1,3,62,1,5,AL - Muscle Shoals
52,2002-2003,2002-12-01,2003-02-28,90,0,5,87,92,3,0,3,95,2,10,AL - Muscle Shoals
53,2003-2004,2003-12-01,2004-02-29,91,5,0,77,77,0,0,0,77,0,0,AL - Muscle Shoals
54,2004-2005,2004-12-01,2005-02-28,90,4,1,57,58,0,0,0,58,0,0,AL - Muscle Shoals
55,2005-2006,2005-12-01,2006-02-28,90,0,1,65,66,3,0,3,69,3,7,AL - Muscle Shoals
56,2006-2007,2006-12-01,2007-02-28,90,8,0,71,71,1,0,1,72,1,3,AL - Muscle Shoals
57,2007-2008,2007-12-01,2008-03-08,99,13,2,75,77,2,1,3,80,2,4,AL - Muscle Shoals
58,2008-2009,2008-12-01,2009-03-01,91,10,3,88,91,2,1,3,94,1,3,AL - Muscle Shoals
59,2009-2010,2009-12-01,2010-02-28,90,0,6,105,111,7,0,7,118,4,14,AL - Muscle Shoals
60,2010-2011,2010-12-01,2011-02-28,90,2,4,100,104,22,31,53,157,7,32,AL - Muscle Shoals
61,2011-2012,2011-12-01,2012-02-29,91,0,0,43,43,1,0,1,44,1,2,AL - Muscle Shoals
62,2012-2013,2012-12-01,2013-02-28,90,0,0,38,38,0,0,0,38,0,0,AL - Muscle Shoals
63,2013-2014,2013-12-01,2014-02-28,90,1,8,105,113,2,2,4,117,2,4,AL - Muscle Shoals
64,2014-2015,2014-12-01,2015-03-05,95,6,4,76,80,5,4,9,89,2,8,AL - Muscle Shoals
65,2015-2016,2015-12-01,2016-02-29,91,6,1,52,53,0,0,0,53,0,0,AL - Muscle Shoals
66,2016-2017,2016-12-01,2017-02-28,90,5,3,43,46,0,0,0,46,0,0,AL - Muscle Shoals
67,2017-2018,2017-12-01,2018-02-28,90,0,6,88,94,1,1,2,96,1,5,AL - Muscle Shoals
68,2018-2019,2018-12-01,2019-02-28,90,7,0,32,32,0,0,0,32,0,0,AL - Muscle Shoals
0,1950-1951,1950-11-25,1951-02-28,96,0,3,86,89,1,1,2,91,1,5,AL - Tuscaloosa
1,1951-1952,1951-12-01,1952-02-29,91,0,0,37,37,0,0,0,37,0,0,AL - Tuscaloosa
2,1952-1953,1952-12-01,1953-02-28,90,0,0,44,44,0,0,0,44,0,0,AL - Tuscaloosa
3,1953-1954,1953-12-01,1954-02-28,90,0,0,49,49,0,0,0,49,0,0,AL - Tuscaloosa
4,1954-1955,1954-12-01,1955-02-28,90,0,0,63,63,0,0,0,63,0,0,AL - Tuscaloosa
5,1955-1956,1955-12-01,1956-02-29,91,0,0,50,50,0,0,0,50,0,0,AL - Tuscaloosa
6,1956-1957,1956-12-01,1957-02-28,90,0,0,29,29,0,0,0,29,0,0,AL - Tuscaloosa
7,1957-1958,1957-12-01,1958-02-28,90,0,3,94,97,0,0,0,97,0,0,AL - Tuscaloosa
8,1958-1959,1958-12-01,1959-02-28,90,0,1,76,77,0,0,0,77,0,0,AL - Tuscaloosa
9,1959-1960,1959-12-01,1960-02-29,91,14,0,53,53,10,5,15,68,1,11,AL - Tuscaloosa
10,1960-1961,1960-12-01,1961-02-28,90,2,1,74,75,0,0,0,75,0,0,AL - Tuscaloosa
12,1962-1963,1962-12-01,1963-02-28,90,0,7,116,123,0,0,0,123,0,0,AL - Tuscaloosa
13,1963-1964,1963-12-01,1964-02-29,91,0,1,101,102,3,9,12,114,1,4,AL - Tuscaloosa
14,1964-1965,1964-12-01,1965-02-28,90,0,0,59,59,0,0,0,59,0,0,AL - Tuscaloosa
15,1965-1966,1965-12-01,1966-02-28,90,0,2,68,70,2,0,2,72,1,7,AL - Tuscaloosa
16,1966-1967,1966-12-01,1967-02-28,90,0,0,58,58,0,0,0,58,0,0,AL - Tuscaloosa
17,1967-1968,1967-12-01,1968-02-29,91,0,1,61,62,2,0,2,64,2,5,AL - Tuscaloosa
18,1968-1969,1968-12-01,1969-02-28,90,0,0,81,81,0,0,0,81,0,0,AL - Tuscaloosa
19,1969-1970,1969-12-01,1970-02-28,90,0,4,79,83,0,0,0,83,0,0,AL - Tuscaloosa
20,1970-1971,1970-12-01,1971-02-28,90,0,1,62,63,2,0,2,65,1,4,AL - Tuscaloosa
21,1971-1972,1971-12-01,1972-02-29,91,0,0,35,35,0,0,0,35,0,0,AL - Tuscaloosa
22,1972-1973,1972-12-01,1973-02-28,90,0,0,51,51,0,0,0,51,0,0,AL - Tuscaloosa
23,1973-1974,1973-12-01,1974-02-28,90,0,0,43,43,0,0,0,43,0,0,AL - Tuscaloosa
24,1974-1975,1974-12-01,1975-02-28,90,0,0,34,34,0,0,0,34,0,0,AL - Tuscaloosa
25,1975-1976,1975-12-01,1976-02-29,91,0,2,71,73,0,0,0,73,0,0,AL - Tuscaloosa
26,1976-1977,1976-12-01,1977-02-28,90,0,5,122,127,6,6,12,139,1,12,AL - Tuscaloosa
27,1977-1978,1977-12-01,1978-02-28,90,0,6,112,118,2,1,3,121,1,3,AL - Tuscaloosa
28,1978-1979,1978-12-01,1979-02-28,90,0,0,63,63,0,0,0,63,0,0,AL - Tuscaloosa
29,1979-1980,1979-12-01,1980-03-02,93,0,1,48,49,2,1,3,52,1,6,AL - Tuscaloosa
30,1980-1981,1980-12-01,1981-02-28,90,0,0,79,79,0,0,0,79,0,0,AL - Tuscaloosa
31,1981-1982,1981-12-01,1982-02-28,90,0,4,73,77,4,3,7,84,1,8,AL - Tuscaloosa
32,1982-1983,1982-12-01,1983-02-28,90,0,0,29,29,0,0,0,29,0,0,AL - Tuscaloosa
33,1983-1984,1983-12-01,1984-02-29,91,0,6,87,93,2,0,2,95,1,3,AL - Tuscaloosa
34,1984-1985,1984-12-01,1985-02-28,90,0,3,89,92,1,1,2,94,1,7,AL - Tuscaloosa
35,1985-1986,1985-12-01,1986-02-28,90,0,3,82,85,0,0,0,85,0,0,AL - Tuscaloosa
36,1986-1987,1986-12-01,1987-02-28,90,0,0,47,47,0,0,0,47,0,0,AL - Tuscaloosa
37,1987-1988,1987-12-01,1988-02-29,91,0,1,75,76,0,0,0,76,0,0,AL - Tuscaloosa
38,1988-1989,1988-12-01,1989-02-28,90,0,0,43,43,0,0,0,43,0,0,AL - Tuscaloosa
39,1989-1990,1989-12-01,1990-02-28,90,0,6,55,61,0,0,0,61,0,0,AL - Tuscaloosa
40,1990-1991,1990-12-01,1991-02-28,90,0,0,42,42,0,0,0,42,0,0,AL - Tuscaloosa
41,1991-1992,1991-12-01,1992-02-29,91,2,0,42,42,0,0,0,42,0,0,AL - Tuscaloosa
42,1992-1993,1992-12-01,1993-03-13,103,1,0,37,37,5,0,5,42,2,8,AL - Tuscaloosa
43,1993-1994,1993-12-01,1994-02-28,90,2,1,66,67,0,0,0,67,0,0,AL - Tuscaloosa
56,2006-2007,2006-12-01,2007-02-28,90,7,0,56,56,0,0,0,56,0,0,AL - Tuscaloosa
58,2008-2009,2008-12-01,2009-02-28,90,13,0,56,56,0,0,0,56,0,0,AL - Tuscaloosa
59,2009-2010,2009-12-01,2010-02-28,90,16,1,65,66,2,0,2,68,1,3,AL - Tuscaloosa
60,2010-2011,2010-12-01,2011-02-28,90,0,3,77,80,0,0,0,80,0,0,AL - Tuscaloosa
61,2011-2012,2011-12-01,2012-02-29,91,1,0,35,35,0,0,0,35,0,0,AL - Tuscaloosa
62,2012-2013,2012-12-01,2013-02-28,90,0,0,29,29,1,0,1,30,1,1,AL - Tuscaloosa
63,2013-2014,2013-12-01,2014-02-28,90,1,3,80,83,2,0,2,85,2,5,AL - Tuscaloosa
64,2014-2015,2014-12-01,2015-02-28,90,2,1,56,57,0,0,0,57,0,0,AL - Tuscaloosa
65,2015-2016,2015-12-01,2016-02-29,91,4,0,43,43,0,0,0,43,0,0,AL - Tuscaloosa
66,2016-2017,2016-12-01,2017-02-28,90,13,0,30,30,0,0,0,30,0,0,AL - Tuscaloosa
67,2017-2018,2017-12-01,2018-02-28,90,13,2,59,61,0,0,0,61,0,0,AL - Tuscaloosa
68,2018-2019,2018-12-01,2019-02-28,90,5,0,24,24,0,0,0,24,0,0,AL - Tuscaloosa
69,2019-2020,2019-12-01,2020-02-29,91,9,0,22,22,0,0,0,22,0,0,AL - Tuscaloosa
0,1950-1951,1950-10-22,1951-04-13,174,2,373,988,1361,88,893,981,2342,31,262,AK - Anchorage
1,1951-1952,1951-10-04,1952-05-06,216,0,297,885,1182,104,701,805,1987,43,303,AK - Anchorage
2,1952-1953,1952-10-19,1953-04-15,179,3,230,677,907,85,422,507,1414,41,245,AK - Anchorage
3,1953-1954,1953-10-27,1954-04-14,170,0,291,819,1110,74,745,819,1929,41,273,AK - Anchorage
4,1954-1955,1954-10-19,1955-05-06,200,0,267,741,1008,193,1018,1211,2219,63,487,AK - Anchorage
5,1955-1956,1955-10-11,1956-04-27,200,0,427,1016,1443,193,1528,1721,3164,64,520,AK - Anchorage
6,1956-1957,1956-10-13,1957-04-05,175,0,337,817,1154,108,697,805,1959,48,391,AK - Anchorage
7,1957-1958,1957-11-08,1958-04-23,167,0,193,562,755,53,456,509,1264,32,196,AK - Anchorage
8,1958-1959,1958-10-03,1959-04-26,206,0,319,825,1144,141,1188,1329,2473,48,345,AK - Anchorage
9,1959-1960,1959-10-11,1960-04-20,193,0,203,656,859,131,1140,1271,2130,62,349,AK - Anchorage
10,1960-1961,1960-10-22,1961-04-22,183,0,207,591,798,63,361,424,1222,36,236,AK - Anchorage
11,1961-1962,1961-10-07,1962-04-28,204,0,364,862,1226,112,696,808,2034,51,342,AK - Anchorage
12,1962-1963,1962-10-28,1963-05-09,194,0,226,603,829,124,447,571,1400,42,290,AK - Anchorage
13,1963-1964,1963-10-25,1964-05-22,211,2,288,734,1022,98,469,567,1589,51,283,AK - Anchorage
14,1964-1965,1964-10-16,1965-05-02,199,0,356,777,1133,120,920,1040,2173,45,290,AK - Anchorage
15,1965-1966,1965-09-29,1966-04-18,202,0,327,842,1169,142,1283,1425,2594,56,388,AK - Anchorage
16,1966-1967,1966-10-17,1967-04-14,180,0,331,825,1156,114,1061,1175,2331,52,322,AK - Anchorage
17,1967-1968,1967-10-25,1968-04-28,187,0,241,563,804,116,526,642,1446,53,297,AK - Anchorage
18,1968-1969,1968-09-29,1969-04-12,196,0,334,752,1086,90,1160,1250,2336,39,277,AK - Anchorage
19,1969-1970,1969-10-28,1970-04-11,166,0,174,429,603,68,312,380,983,35,213,AK - Anchorage
20,1970-1971,1970-10-15,1971-04-30,198,0,376,801,1177,90,629,719,1896,47,273,AK - Anchorage
21,1971-1972,1971-10-04,1972-05-05,215,0,382,900,1282,118,1131,1249,2531,63,444,AK - Anchorage
22,1972-1973,1972-09-28,1973-04-30,215,0,360,798,1158,79,914,993,2151,47,312,AK - Anchorage
23,1973-1974,1973-10-08,1974-04-24,199,3,332,798,1130,93,675,768,1898,46,311,AK - Anchorage
24,1974-1975,1974-10-04,1975-05-04,213,0,289,700,989,134,1058,1192,2181,71,426,AK - Anchorage
25,1975-1976,1975-10-27,1976-04-26,183,0,354,735,1089,99,604,703,1792,52,345,AK - Anchorage
26,1976-1977,1976-10-25,1977-04-30,188,0,96,349,445,108,442,550,995,56,281,AK - Anchorage
27,1977-1978,1977-09-29,1978-04-09,193,0,223,586,809,108,1036,1144,1953,39,241,AK - Anchorage
28,1978-1979,1978-10-21,1979-04-14,176,0,160,527,687,138,1038,1176,1863,54,291,AK - Anchorage
29,1979-1980,1979-10-27,1980-04-12,169,0,214,518,732,103,387,490,1222,50,319,AK - Anchorage
30,1980-1981,1980-10-07,1981-04-02,178,0,208,476,684,52,173,225,909,30,120,AK - Anchorage
31,1981-1982,1981-09-24,1982-05-11,230,0,314,741,1055,76,508,584,1639,43,260,AK - Anchorage
32,1982-1983,1982-10-07,1983-04-19,195,0,255,580,835,101,497,598,1433,37,254,AK - Anchorage
33,1983-1984,1983-10-09,1984-04-22,197,0,196,521,717,121,1002,1123,1840,52,314,AK - Anchorage
34,1984-1985,1984-10-20,1985-05-08,201,3,216,621,837,93,732,825,1662,45,266,AK - Anchorage
35,1985-1986,1985-10-18,1986-05-10,205,0,215,597,812,67,196,263,1075,27,164,AK - Anchorage
36,1986-1987,1986-10-30,1987-04-16,169,0,136,416,552,69,460,529,1081,43,183,AK - Anchorage
37,1987-1988,1987-10-29,1988-04-18,173,0,171,474,645,126,1186,1312,1957,64,362,AK - Anchorage
38,1988-1989,1988-10-06,1989-05-17,224,0,273,734,1007,100,721,821,1828,59,391,AK - Anchorage
39,1989-1990,1989-10-16,1990-04-11,178,0,299,684,983,153,1079,1232,2215,67,484,AK - Anchorage
40,1990-1991,1990-10-13,1991-04-15,185,0,313,726,1039,99,903,1002,2041,50,355,AK - Anchorage
41,1991-1992,1991-10-13,1992-05-05,206,0,222,609,831,150,1510,1660,2491,53,383,AK - Anchorage
42,1992-1993,1992-09-30,1993-04-12,195,0,230,605,835,120,846,966,1801,58,373,AK - Anchorage
43,1993-1994,1993-10-17,1994-04-17,183,0,193,515,708,102,554,656,1364,48,256,AK - Anchorage
44,1994-1995,1994-10-08,1995-04-16,191,0,292,723,1015,177,1500,1677,2692,56,449,AK - Anchorage
45,1995-1996,1995-10-14,1996-04-10,180,0,291,655,946,105,483,588,1534,38,279,AK - Anchorage
46,1996-1997,1996-09-21,1997-04-13,205,0,264,641,905,108,1234,1342,2247,43,266,AK - Anchorage
47,1997-1998,1997-10-14,1998-04-28,197,3,192,539,731,93,1081,1174,1905,55,349,AK - Anchorage
48,1998-1999,1998-10-17,1999-05-01,197,0,333,731,1064,144,1225,1369,2433,58,470,AK - Anchorage
49,1999-2000,1999-10-13,2000-04-17,188,0,241,577,818,132,1166,1298,2116,53,394,AK - Anchorage
50,2000-2001,2000-10-12,2001-05-05,206,0,109,397,506,103,628,731,1237,49,233,AK - Anchorage
51,2001-2002,2001-10-11,2002-05-03,205,0,269,696,965,119,1377,1496,2461,45,287,AK - Anchorage
52,2002-2003,2002-11-10,2003-04-16,158,0,118,334,452,62,346,408,860,31,189,AK - Anchorage
53,2003-2004,2003-11-10,2004-04-22,165,1,258,605,863,165,1387,1552,2415,54,397,AK - Anchorage
54,2004-2005,2004-09-25,2005-04-18,206,0,170,449,619,116,590,706,1325,42,224,AK - Anchorage
55,2005-2006,2005-10-27,2006-05-08,194,0,272,601,873,107,885,992,1865,53,401,AK - Anchorage
56,2006-2007,2006-10-26,2007-04-13,170,0,308,705,1013,123,1166,1289,2302,44,385,AK - Anchorage
57,2007-2008,2007-10-23,2008-04-29,190,0,232,539,771,160,794,954,1725,55,432,AK - Anchorage
58,2008-2009,2008-10-06,2009-04-13,190,0,313,693,1006,141,1006,1147,2153,64,455,AK - Anchorage
59,2009-2010,2009-11-01,2010-04-22,173,0,195,491,686,111,1075,1186,1872,41,305,AK - Anchorage
60,2010-2011,2010-11-02,2011-04-12,162,0,235,591,826,92,942,1034,1860,40,245,AK - Anchorage
61,2011-2012,2011-10-30,2012-04-24,178,0,307,674,981,192,1512,1704,2685,73,608,AK - Anchorage
62,2012-2013,2012-09-29,2013-05-18,232,0,223,615,838,139,1133,1272,2110,57,328,AK - Anchorage
63,2013-2014,2013-11-07,2014-04-13,158,0,179,482,661,97,870,967,1628,42,281,AK - Anchorage
64,2014-2015,2014-10-19,2015-04-21,185,0,131,386,517,39,400,439,956,23,103,AK - Anchorage
65,2015-2016,2015-09-29,2016-03-22,176,0,118,347,465,58,234,292,757,26,141,AK - Anchorage
66,2016-2017,2016-10-20,2017-04-17,180,0,258,636,894,118,1072,1190,2084,44,355,AK - Anchorage
67,2017-2018,2017-10-20,2018-04-14,177,0,171,486,657,84,897,981,1638,33,216,AK - Anchorage
68,2018-2019,2018-10-29,2019-04-24,178,0,131,381,512,94,799,893,1405,46,241,AK - Anchorage
69,2019-2020,2019-10-16,2020-04-19,187,2,234,560,794,127,913,1040,1834,50,359,AK - Anchorage
0,1950-1951,1950-09-26,1951-05-19,236,6,1088,1790,2878,163,2280,2443,5321,59,760,AK - Bettles
1,1951-1952,1951-10-01,1952-05-26,239,3,1008,1941,2949,150,2600,2750,5699,76,951,AK - Bettles
2,1952-1953,1952-09-18,1953-04-29,224,0,929,1741,2670,113,1488,1601,4271,58,595,AK - Bettles
3,1953-1954,1953-09-29,1954-05-08,222,1,1140,1928,3068,76,1180,1256,4324,43,606,AK - Bettles
4,1954-1955,1954-10-05,1955-05-17,225,5,1126,1942,3068,143,1896,2039,5107,44,605,AK - Bettles
5,1955-1956,1955-10-02,1956-05-22,234,0,1296,2198,3494,112,2362,2474,5968,49,693,AK - Bettles
6,1956-1957,1956-09-23,1957-05-19,239,1,1218,2092,3310,113,1939,2052,5362,40,482,AK - Bettles
7,1957-1958,1957-09-27,1958-05-14,230,1,846,1653,2499,100,1764,1864,4363,65,648,AK - Bettles
8,1958-1959,1958-10-02,1959-05-17,228,3,1136,2052,3188,84,2152,2236,5424,43,495,AK - Bettles
9,1959-1960,1959-10-05,1960-05-11,220,1,924,1769,2693,122,1743,1865,4558,55,744,AK - Bettles
10,1960-1961,1960-09-21,1961-05-05,227,0,903,1709,2612,72,860,932,3544,51,493,AK - Bettles
11,1961-1962,1961-10-03,1962-05-21,231,2,1081,1958,3039,96,2007,2103,5142,45,499,AK - Bettles
12,1962-1963,1962-10-10,1963-05-15,218,3,952,1706,2658,128,2436,2564,5222,42,431,AK - Bettles
13,1963-1964,1963-10-08,1964-05-30,236,0,1174,2045,3219,130,2362,2492,5711,51,589,AK - Bettles
14,1964-1965,1964-10-15,1965-05-24,222,3,1089,1909,2998,176,2371,2547,5545,77,896,AK - Bettles
15,1965-1966,1965-09-22,1966-05-17,238,0,1225,2057,3282,99,1945,2044,5326,60,790,AK - Bettles
16,1966-1967,1966-10-08,1967-05-20,225,8,1082,1912,2994,116,1868,1984,4978,67,719,AK - Bettles
17,1967-1968,1967-10-02,1968-05-26,238,0,962,1908,2870,155,2602,2757,5627,67,792,AK - Bettles
18,1968-1969,1968-09-26,1969-05-16,233,0,1116,1967,3083,65,1598,1663,4746,43,537,AK - Bettles
19,1969-1970,1969-08-09,1970-05-09,274,0,832,1581,2413,117,1107,1224,3637,56,580,AK - Bettles
20,1970-1971,1970-09-21,1971-05-21,243,0,1354,2391,3745,190,2292,2482,6227,59,995,AK - Bettles
21,1971-1972,1971-09-29,1972-05-20,235,3,1292,2298,3590,143,2729,2872,6462,61,753,AK - Bettles
22,1972-1973,1972-09-27,1973-05-13,229,0,1007,1842,2849,195,2567,2762,5611,65,808,AK - Bettles
23,1973-1974,1973-09-24,1974-05-06,225,8,1121,2030,3151,84,1612,1696,4847,44,554,AK - Bettles
24,1974-1975,1974-09-29,1975-05-05,219,0,1133,1980,3113,107,1390,1497,4610,55,740,AK - Bettles
25,1975-1976,1975-10-05,1976-05-03,212,0,1193,2007,3200,105,1606,1711,4911,56,691,AK - Bettles
26,1976-1977,1976-10-01,1977-05-10,222,0,815,1523,2338,148,1841,1989,4327,62,662,AK - Bettles
27,1977-1978,1977-10-05,1978-05-04,212,0,923,1622,2545,125,1572,1697,4242,55,631,AK - Bettles
28,1978-1979,1978-09-23,1979-05-05,225,0,953,1792,2745,135,1870,2005,4750,68,742,AK - Bettles
29,1979-1980,1979-09-14,1980-05-06,236,0,870,1648,2518,159,1578,1737,4255,85,851,AK - Bettles
30,1980-1981,1980-09-01,1981-05-08,250,0,779,1562,2341,149,1817,1966,4307,82,765,AK - Bettles
31,1981-1982,1981-09-22,1982-05-21,242,3,992,1766,2758,130,1698,1828,4586,76,765,AK - Bettles
32,1982-1983,1982-10-02,1983-05-01,212,3,959,1716,2675,99,1545,1644,4319,66,670,AK - Bettles
33,1983-1984,1983-09-23,1984-05-18,239,0,1109,1930,3039,160,1618,1778,4817,73,959,AK - Bettles
34,1984-1985,1984-09-30,1985-05-20,233,3,938,1696,2634,132,1513,1645,4279,71,771,AK - Bettles
35,1985-1986,1985-09-18,1986-05-21,246,15,871,1679,2550,74,1421,1495,4045,49,460,AK - Bettles
36,1986-1987,1986-09-23,1987-05-02,222,0,823,1660,2483,99,1435,1534,4017,63,780,AK - Bettles
37,1987-1988,1987-09-18,1988-05-03,229,0,793,1448,2241,174,2201,2375,4616,84,922,AK - Bettles
38,1988-1989,1988-09-29,1989-05-15,229,3,1006,1787,2793,158,1900,2058,4851,79,875,AK - Bettles
39,1989-1990,1989-10-09,1990-05-09,213,3,1117,1918,3035,129,1570,1699,4734,63,777,AK - Bettles
40,1990-1991,1990-09-25,1991-05-05,223,2,1055,1878,2933,200,2109,2309,5242,99,1366,AK - Bettles
41,1991-1992,1991-10-06,1992-05-19,227,0,920,1846,2766,102,1297,1399,4165,64,778,AK - Bettles
42,1992-1993,1992-09-09,1993-05-13,247,0,893,1757,2650,258,2469,2727,5377,76,879,AK - Bettles
43,1993-1994,1993-09-17,1994-05-29,255,0,842,1597,2439,168,2036,2204,4643,83,836,AK - Bettles
44,1994-1995,1994-09-19,1995-04-28,222,3,1003,1846,2849,137,2468,2605,5454,62,866,AK - Bettles
45,1995-1996,1995-10-11,1996-05-20,223,3,1076,1929,3005,91,1675,1766,4771,45,477,AK - Bettles
46,1996-1997,1996-09-11,1997-05-04,236,0,970,1777,2747,122,2363,2485,5232,67,786,AK - Bettles
48,1998-1999,1998-09-29,1999-05-11,225,0,970,1838,2808,114,1469,1583,4391,75,1016,AK - Bettles
49,1999-2000,1999-09-25,2000-05-20,239,0,944,1828,2772,148,1759,1907,4679,71,882,AK - Bettles
50,2000-2001,2000-09-16,2001-05-25,252,6,670,1502,2172,174,1971,2145,4317,99,1006,AK - Bettles
51,2001-2002,2001-09-30,2002-05-17,230,0,845,1708,2553,158,1807,1965,4518,88,1036,AK - Bettles
52,2002-2003,2002-09-19,2003-05-23,247,3,657,1412,2069,146,1877,2023,4092,61,507,AK - Bettles
53,2003-2004,2003-09-10,2004-05-09,243,3,880,1830,2710,146,1707,1853,4563,65,890,AK - Bettles
54,2004-2005,2004-09-15,2005-05-10,238,3,864,1740,2604,205,2289,2494,5098,88,981,AK - Bettles
55,2005-2006,2005-09-30,2006-05-12,225,8,977,1812,2789,138,1711,1849,4638,74,879,AK - Bettles
56,2006-2007,2006-10-02,2007-04-23,204,0,928,1742,2670,79,1175,1254,3924,58,775,AK - Bettles
57,2007-2008,2007-09-26,2008-05-12,230,0,895,1691,2586,153,1656,1809,4395,92,992,AK - Bettles
58,2008-2009,2008-09-30,2009-05-11,224,4,1054,1978,3032,178,2047,2225,5257,88,1224,AK - Bettles
59,2009-2010,2009-09-22,2010-05-10,231,0,957,1810,2767,109,1296,1405,4172,50,644,AK - Bettles
60,2010-2011,2010-09-27,2011-05-14,230,2,974,1947,2921,154,1808,1962,4883,66,785,AK - Bettles
61,2011-2012,2011-09-28,2012-05-11,227,0,1087,1947,3034,149,1846,1995,5029,78,1051,AK - Bettles
62,2012-2013,2012-09-27,2013-05-22,238,0,1005,1995,3000,97,1288,1385,4385,56,739,AK - Bettles
63,2013-2014,2013-09-18,2014-05-07,232,0,756,1625,2381,151,1698,1849,4230,78,821,AK - Bettles
64,2014-2015,2014-09-21,2015-05-03,225,0,724,1608,2332,129,1414,1543,3875,72,712,AK - Bettles
65,2015-2016,2015-09-18,2016-05-01,227,0,600,1358,1958,163,1772,1935,3893,72,728,AK - Bettles
66,2016-2017,2016-09-13,2017-05-07,237,3,928,1859,2787,133,1469,1602,4389,69,908,AK - Bettles
67,2017-2018,2017-09-30,2018-05-13,226,0,725,1519,2244,180,2146,2326,4570,92,942,AK - Bettles
68,2018-2019,2018-10-11,2019-05-20,222,2,627,1344,1971,232,2198,2430,4401,85,891,AK - Bettles
69,2019-2020,2019-09-17,2020-05-11,238,4,1035,1958,2993,183,1913,2096,5089,80,952,AK - Bettles
30,1980-1981,1980-10-09,1981-04-27,201,8,96,386,482,95,776,871,1353,25,143,AK - Cannery Creek
32,1982-1983,1982-10-25,1983-05-17,205,8,67,408,475,125,2523,2648,3123,34,193,AK - Cannery Creek
34,1984-1985,1984-11-02,1985-06-01,212,6,78,427,505,241,2052,2293,2798,52,341,AK - Cannery Creek
35,1985-1986,1985-10-25,1986-05-21,209,7,76,481,557,182,1876,2058,2615,41,289,AK - Cannery Creek
37,1987-1988,1987-10-30,1988-05-25,209,13,50,266,316,215,2442,2657,2973,70,308,AK - Cannery Creek
38,1988-1989,1988-10-27,1989-05-08,194,13,147,465,612,164,2026,2190,2802,45,294,AK - Cannery Creek
39,1989-1990,1989-10-23,1990-05-26,216,8,116,421,537,286,2513,2799,3336,54,408,AK - Cannery Creek
40,1990-1991,1990-10-13,1991-05-30,230,11,152,495,647,325,2597,2922,3569,72,504,AK - Cannery Creek
41,1991-1992,1991-11-13,1992-06-06,207,12,72,340,412,302,2585,2887,3299,64,434,AK - Cannery Creek
42,1992-1993,1992-10-12,1993-05-13,214,13,117,393,510,238,2116,2354,2864,62,368,AK - Cannery Creek
43,1993-1994,1993-11-03,1994-05-15,194,15,80,302,382,158,1636,1794,2176,58,267,AK - Cannery Creek
44,1994-1995,1994-10-23,1995-05-19,209,19,129,478,607,277,2473,2750,3357,62,458,AK - Cannery Creek
46,1996-1997,1996-11-08,1997-05-07,181,18,82,317,399,129,1482,1611,2010,43,208,AK - Cannery Creek
47,1997-1998,1997-11-21,1998-05-08,169,18,63,244,307,97,1355,1452,1759,35,160,AK - Cannery Creek
48,1998-1999,1998-11-17,1999-05-29,194,14,135,418,553,291,2456,2747,3300,66,436,AK - Cannery Creek
49,1999-2000,1999-10-27,2000-05-27,214,14,88,355,443,351,2697,3048,3491,79,527,AK - Cannery Creek
51,2001-2002,2001-10-20,2002-05-21,214,7,82,459,541,235,2308,2543,3084,62,360,AK - Cannery Creek
52,2002-2003,2002-11-19,2003-04-21,154,1,22,209,231,86,947,1033,1264,29,140,AK - Cannery Creek
53,2003-2004,2003-11-10,2004-05-13,186,5,102,370,472,215,2183,2398,2870,58,332,AK - Cannery Creek
55,2005-2006,2005-11-02,2006-05-15,195,10,77,389,466,170,1502,1672,2138,51,313,AK - Cannery Creek
56,2006-2007,2006-10-29,2007-05-23,207,12,141,532,673,240,2349,2589,3262,59,397,AK - Cannery Creek
57,2007-2008,2007-10-20,2008-05-27,221,17,113,394,507,216,2173,2389,2896,68,360,AK - Cannery Creek
59,2009-2010,2009-11-01,2010-05-24,205,3,61,303,364,237,2446,2683,3047,70,388,AK - Cannery Creek
60,2010-2011,2010-10-30,2011-05-09,192,0,119,432,551,153,1655,1808,2359,40,231,AK - Cannery Creek
61,2011-2012,2011-10-31,2012-06-18,232,17,131,431,562,475,3041,3516,4078,100,754,AK - Cannery Creek
64,2014-2015,2014-11-27,2015-04-13,138,0,41,204,245,50,146,196,441,25,97,AK - Cannery Creek
65,2015-2016,2015-11-09,2016-04-13,157,2,39,197,236,80,996,1076,1312,36,150,AK - Cannery Creek
66,2016-2017,2016-10-18,2017-04-30,195,11,120,419,539,161,1759,1920,2459,50,261,AK - Cannery Creek
69,2019-2020,2019-11-22,2020-05-11,172,12,90,382,472,185,1721,1906,2378,43,286,AK - Cannery Creek
0,1950-1951,1950-10-10,1951-04-29,202,7,747,1427,2174,110,1481,1591,3765,48,520,AK - Denali NP
2,1952-1953,1952-09-29,1953-04-20,204,0,496,1160,1656,68,1026,1094,2750,34,346,AK - Denali NP
3,1953-1954,1953-09-28,1954-04-27,212,3,645,1395,2040,80,1108,1188,3228,47,532,AK - Denali NP
4,1954-1955,1954-10-11,1955-06-12,245,17,550,1283,1833,132,1163,1295,3128,56,715,AK - Denali NP
5,1955-1956,1955-09-17,1956-05-09,236,4,868,1624,2492,153,1709,1862,4354,71,917,AK - Denali NP
6,1956-1957,1956-09-19,1957-05-05,229,1,648,1428,2076,149,1605,1754,3830,78,762,AK - Denali NP
7,1957-1958,1957-09-19,1958-05-04,228,0,502,1205,1707,137,1062,1199,2906,60,586,AK - Denali NP
9,1959-1960,1959-10-03,1960-05-10,221,0,496,1272,1768,100,1088,1188,2956,67,730,AK - Denali NP
10,1960-1961,1960-09-06,1961-04-24,231,1,514,1260,1774,83,782,865,2639,47,419,AK - Denali NP
11,1961-1962,1961-09-24,1962-05-19,238,0,684,1494,2178,195,1865,2060,4238,76,792,AK - Denali NP
12,1962-1963,1962-09-12,1963-05-13,244,9,506,1204,1710,116,1360,1476,3186,51,482,AK - Denali NP
14,1964-1965,1964-10-14,1965-05-04,203,3,690,1372,2062,90,1250,1340,3402,40,443,AK - Denali NP
15,1965-1966,1965-10-05,1966-05-14,222,7,636,1503,2139,170,2118,2288,4427,39,461,AK - Denali NP
16,1966-1967,1966-10-08,1967-05-20,225,9,546,1436,1982,218,1775,1993,3975,59,624,AK - Denali NP
17,1967-1968,1967-10-17,1968-05-13,210,16,543,1350,1893,151,1522,1673,3566,42,508,AK - Denali NP
19,1969-1970,1969-10-21,1970-05-30,222,14,479,1264,1743,65,825,890,2633,34,389,AK - Denali NP
20,1970-1971,1970-09-08,1971-05-23,258,19,863,1901,2764,255,2742,2997,5761,70,905,AK - Denali NP
21,1971-1972,1971-09-27,1972-05-14,231,1,789,1801,2590,144,1897,2041,4631,58,669,AK - Denali NP
22,1972-1973,1972-09-16,1973-06-02,260,4,630,1461,2091,106,1260,1366,3457,60,651,AK - Denali NP
23,1973-1974,1973-08-13,1974-04-25,256,7,761,1573,2334,94,1005,1099,3433,64,792,AK - Denali NP
27,1977-1978,1977-09-29,1978-04-30,214,15,583,1335,1918,111,1516,1627,3545,44,558,AK - Denali NP
28,1978-1979,1978-09-20,1979-04-28,221,2,517,1368,1885,128,1251,1379,3264,52,501,AK - Denali NP
29,1979-1980,1979-09-17,1980-06-19,277,1,519,1276,1795,121,1309,1430,3225,47,573,AK - Denali NP
30,1980-1981,1980-09-02,1981-04-27,238,5,479,1126,1605,106,946,1052,2657,45,503,AK - Denali NP
32,1982-1983,1982-09-30,1983-05-17,230,11,578,1408,1986,111,1621,1732,3718,56,600,AK - Denali NP
33,1983-1984,1983-09-05,1984-05-07,246,5,623,1312,1935,101,1142,1243,3178,52,602,AK - Denali NP
34,1984-1985,1984-08-26,1985-05-23,271,20,533,1314,1847,219,1933,2152,3999,60,612,AK - Denali NP
35,1985-1986,1985-10-03,1986-05-11,221,4,558,1255,1813,63,810,873,2686,38,443,AK - Denali NP
37,1987-1988,1987-09-21,1988-04-30,223,19,447,1103,1550,81,1066,1147,2697,53,555,AK - Denali NP
39,1989-1990,1989-10-08,1990-05-03,208,6,664,1375,2039,139,1613,1752,3791,65,795,AK - Denali NP
40,1990-1991,1990-09-30,1991-05-12,225,5,645,1417,2062,233,2364,2597,4659,84,1123,AK - Denali NP
41,1991-1992,1991-10-07,1992-05-25,232,2,621,1378,1999,199,2003,2202,4201,79,928,AK - Denali NP
42,1992-1993,1992-09-12,1993-05-10,241,12,536,1310,1846,233,3011,3244,5090,76,855,AK - Denali NP
43,1993-1994,1993-09-17,1994-05-03,229,6,518,1227,1745,170,1616,1786,3531,68,618,AK - Denali NP
44,1994-1995,1994-10-08,1995-05-22,227,6,601,1240,1841,112,1623,1735,3576,60,612,AK - Denali NP
46,1996-1997,1996-09-11,1997-06-02,265,11,669,1422,2091,116,1873,1989,4080,55,585,AK - Denali NP
47,1997-1998,1997-10-04,1998-05-09,218,3,500,1151,1651,112,1641,1753,3404,55,571,AK - Denali NP
48,1998-1999,1998-10-07,1999-05-10,216,3,712,1416,2128,77,1136,1213,3341,48,599,AK - Denali NP
49,1999-2000,1999-09-25,2000-05-21,240,2,611,1348,1959,170,1912,2082,4041,59,649,AK - Denali NP
50,2000-2001,2000-09-28,2001-05-14,229,2,278,943,1221,100,1328,1428,2649,59,429,AK - Denali NP
51,2001-2002,2001-10-11,2002-05-15,217,2,557,1295,1852,109,1281,1390,3242,64,550,AK - Denali NP
53,2003-2004,2003-07-17,2004-05-02,291,11,535,1240,1775,114,1288,1402,3177,62,729,AK - Denali NP
54,2004-2005,2004-09-05,2005-05-02,240,11,358,1096,1454,149,1450,1599,3053,70,560,AK - Denali NP
55,2005-2006,2005-09-29,2006-05-11,225,14,637,1289,1926,99,1330,1429,3355,54,607,AK - Denali NP
56,2006-2007,2006-10-06,2007-05-13,220,12,658,1394,2052,73,970,1043,3095,58,757,AK - Denali NP
58,2008-2009,2008-09-28,2009-05-03,218,3,727,1485,2212,113,1433,1546,3758,70,774,AK - Denali NP
59,2009-2010,2009-09-27,2010-04-29,215,4,528,1200,1728,76,1091,1167,2895,50,624,AK - Denali NP
60,2010-2011,2010-09-27,2011-05-12,228,9,582,1399,1981,131,1379,1510,3491,67,752,AK - Denali NP
61,2011-2012,2011-09-29,2012-05-15,230,2,733,1487,2220,122,1545,1667,3887,75,890,AK - Denali NP
62,2012-2013,2012-09-24,2013-05-25,244,13,698,1536,2234,131,1520,1651,3885,69,761,AK - Denali NP
63,2013-2014,2013-09-18,2014-05-05,230,6,449,1139,1588,94,1291,1385,2973,52,510,AK - Denali NP
64,2014-2015,2014-09-29,2015-04-30,214,0,430,1086,1516,74,1093,1167,2683,40,318,AK - Denali NP
65,2015-2016,2015-08-29,2016-05-17,263,0,350,969,1319,133,1723,1856,3175,53,460,AK - Denali NP
66,2016-2017,2016-10-16,2017-05-25,222,0,621,1331,1952,110,1181,1291,3243,54,697,AK - Denali NP
67,2017-2018,2017-09-29,2018-05-17,231,8,414,1073,1487,175,1773,1948,3435,81,714,AK - Denali NP
68,2018-2019,2018-10-08,2019-04-24,199,0,351,898,1249,78,725,803,2052,54,475,AK - Denali NP
69,2019-2020,2019-10-02,2020-05-11,223,3,658,1353,2011,161,1739,1900,3911,77,901,AK - Denali NP
0,1950-1951,1950-10-09,1951-04-25,199,0,982,1832,2814,101,1613,1714,4528,57,715,AK - Fairbanks
1,1951-1952,1951-10-01,1952-05-08,221,3,787,1719,2506,95,1378,1473,3979,62,758,AK - Fairbanks
2,1952-1953,1952-09-28,1953-04-15,200,0,721,1565,2286,45,846,891,3177,33,394,AK - Fairbanks
3,1953-1954,1953-10-02,1954-04-18,199,0,844,1773,2617,67,808,875,3492,39,565,AK - Fairbanks
4,1954-1955,1954-10-17,1955-04-29,195,0,805,1676,2481,105,1148,1253,3734,64,950,AK - Fairbanks
5,1955-1956,1955-10-06,1956-04-28,206,0,1031,1952,2983,130,1591,1721,4704,72,1068,AK - Fairbanks
6,1956-1957,1956-10-02,1957-05-02,213,0,879,1776,2655,126,1423,1549,4204,75,882,AK - Fairbanks
7,1957-1958,1957-09-25,1958-05-03,221,0,652,1453,2105,69,878,947,3052,45,397,AK - Fairbanks
8,1958-1959,1958-09-30,1959-05-03,216,3,905,1888,2793,98,1569,1667,4460,53,695,AK - Fairbanks
9,1959-1960,1959-10-05,1960-04-30,209,3,703,1557,2260,108,1251,1359,3619,59,717,AK - Fairbanks
10,1960-1961,1960-10-06,1961-04-25,202,0,699,1588,2287,73,1032,1105,3392,45,505,AK - Fairbanks
11,1961-1962,1961-10-04,1962-05-09,218,0,874,1729,2603,158,1624,1782,4385,84,884,AK - Fairbanks
12,1962-1963,1962-09-13,1963-05-03,233,3,732,1527,2259,115,1119,1234,3493,65,654,AK - Fairbanks
13,1963-1964,1963-10-09,1964-05-14,219,0,891,1832,2723,98,1082,1180,3903,65,680,AK - Fairbanks
14,1964-1965,1964-10-02,1965-05-04,215,0,980,1883,2863,92,1111,1203,4066,61,865,AK - Fairbanks
15,1965-1966,1965-10-01,1966-05-19,231,0,1110,2083,3193,187,1705,1892,5085,72,1039,AK - Fairbanks
16,1966-1967,1966-10-07,1967-05-04,210,0,945,1796,2741,160,1641,1801,4542,79,957,AK - Fairbanks
17,1967-1968,1967-10-02,1968-05-11,223,0,761,1557,2318,127,1448,1575,3893,73,885,AK - Fairbanks
18,1968-1969,1968-09-23,1969-04-18,208,0,981,1876,2857,101,1303,1404,4261,58,707,AK - Fairbanks
19,1969-1970,1969-10-20,1970-04-24,187,0,656,1367,2023,62,786,848,2871,45,580,AK - Fairbanks
20,1970-1971,1970-09-21,1971-05-08,230,0,1031,1910,2941,212,2275,2487,5428,88,1225,AK - Fairbanks
21,1971-1972,1971-09-29,1972-05-02,217,0,1006,1892,2898,150,1521,1671,4569,89,1013,AK - Fairbanks
22,1972-1973,1972-09-16,1973-04-27,224,0,776,1528,2304,125,1233,1358,3662,65,674,AK - Fairbanks
23,1973-1974,1973-09-23,1974-04-24,214,0,968,1753,2721,92,1160,1252,3973,62,832,AK - Fairbanks
24,1974-1975,1974-09-29,1975-04-27,211,0,849,1673,2522,149,1736,1885,4407,77,941,AK - Fairbanks
25,1975-1976,1975-10-07,1976-04-17,194,0,996,1806,2802,96,1131,1227,4029,62,709,AK - Fairbanks
26,1976-1977,1976-10-07,1977-04-27,203,3,569,1216,1785,96,1185,1281,3066,49,487,AK - Fairbanks
27,1977-1978,1977-09-29,1978-05-27,241,0,815,1510,2325,82,1288,1370,3695,51,597,AK - Fairbanks
28,1978-1979,1978-09-20,1979-04-26,219,0,801,1585,2386,110,1464,1574,3960,69,670,AK - Fairbanks
29,1979-1980,1979-10-18,1980-04-12,178,0,582,1240,1822,83,889,972,2794,62,785,AK - Fairbanks
30,1980-1981,1980-09-02,1981-04-15,226,0,598,1250,1848,76,995,1071,2919,52,441,AK - Fairbanks
31,1981-1982,1981-09-26,1982-05-02,219,0,783,1523,2306,113,1140,1253,3559,71,796,AK - Fairbanks
32,1982-1983,1982-09-30,1983-05-04,217,0,716,1416,2132,115,1640,1755,3887,68,694,AK - Fairbanks
33,1983-1984,1983-09-24,1984-04-28,218,3,767,1475,2242,113,1212,1325,3567,70,804,AK - Fairbanks
34,1984-1985,1984-10-07,1985-05-09,215,0,691,1504,2195,152,1730,1882,4077,72,769,AK - Fairbanks
35,1985-1986,1985-09-21,1986-04-23,215,0,720,1492,2212,63,1105,1168,3380,44,590,AK - Fairbanks
36,1986-1987,1986-10-04,1987-04-12,191,0,600,1276,1876,69,1005,1074,2950,45,503,AK - Fairbanks
37,1987-1988,1987-10-25,1988-05-01,190,0,641,1221,1862,75,1062,1137,2999,58,679,AK - Fairbanks
38,1988-1989,1988-09-29,1989-05-09,223,0,825,1633,2458,121,1546,1667,4125,79,1002,AK - Fairbanks
39,1989-1990,1989-09-20,1990-04-20,213,0,915,1663,2578,120,1631,1751,4329,63,795,AK - Fairbanks
40,1990-1991,1990-09-29,1991-05-06,220,0,806,1576,2382,219,2355,2574,4956,87,1141,AK - Fairbanks
41,1991-1992,1991-10-11,1992-05-17,220,0,738,1605,2343,159,1664,1823,4166,92,1186,AK - Fairbanks
42,1992-1993,1992-09-11,1993-04-23,225,0,653,1490,2143,202,2348,2550,4693,88,972,AK - Fairbanks
43,1993-1994,1993-09-17,1994-04-22,218,0,656,1425,2081,102,1277,1379,3460,57,535,AK - Fairbanks
44,1994-1995,1994-10-08,1995-04-18,193,0,830,1650,2480,135,1633,1768,4248,78,1019,AK - Fairbanks
45,1995-1996,1995-10-12,1996-04-23,195,0,866,1674,2540,87,1095,1182,3722,41,484,AK - Fairbanks
46,1996-1997,1996-09-21,1997-04-24,216,0,868,1748,2616,108,1562,1670,4286,57,737,AK - Fairbanks
47,1997-1998,1997-10-03,1998-05-03,213,3,712,1446,2158,80,1204,1284,3442,55,695,AK - Fairbanks
48,1998-1999,1998-10-14,1999-05-01,200,3,923,1758,2681,67,1001,1068,3749,56,938,AK - Fairbanks
49,1999-2000,1999-09-25,2000-04-26,215,3,805,1598,2403,112,1458,1570,3973,59,759,AK - Fairbanks
50,2000-2001,2000-09-29,2001-05-11,225,0,495,1283,1778,93,1224,1317,3095,55,495,AK - Fairbanks
51,2001-2002,2001-09-30,2002-05-02,215,0,733,1588,2321,91,998,1089,3410,61,722,AK - Fairbanks
52,2002-2003,2002-10-08,2003-04-18,193,0,510,1136,1646,65,984,1049,2695,35,336,AK - Fairbanks
53,2003-2004,2003-09-25,2004-04-17,206,0,789,1573,2362,101,1246,1347,3709,63,828,AK - Fairbanks
54,2004-2005,2004-09-26,2005-04-24,211,0,663,1460,2123,124,1486,1610,3733,72,687,AK - Fairbanks
55,2005-2006,2005-09-28,2006-04-27,212,0,866,1625,2491,93,1131,1224,3715,61,743,AK - Fairbanks
56,2006-2007,2006-09-29,2007-04-15,199,0,881,1705,2586,67,1007,1074,3660,58,864,AK - Fairbanks
57,2007-2008,2007-10-06,2008-05-01,209,0,721,1515,2236,100,1230,1330,3566,64,748,AK - Fairbanks
58,2008-2009,2008-09-27,2009-04-29,215,0,893,1753,2646,126,1499,1625,4271,77,1042,AK - Fairbanks
59,2009-2010,2009-09-26,2010-05-05,222,0,747,1479,2226,45,962,1007,3233,33,454,AK - Fairbanks
60,2010-2011,2010-10-07,2011-04-26,202,0,770,1678,2448,91,1310,1401,3849,44,525,AK - Fairbanks
61,2011-2012,2011-10-13,2012-05-01,202,0,907,1720,2627,107,1289,1396,4023,75,1169,AK - Fairbanks
62,2012-2013,2012-10-12,2013-05-17,218,0,921,1850,2771,111,1516,1627,4398,61,748,AK - Fairbanks
63,2013-2014,2013-09-18,2014-04-21,216,0,583,1379,1962,81,1306,1387,3349,46,543,AK - Fairbanks
64,2014-2015,2014-09-30,2015-04-17,200,0,600,1308,1908,70,1045,1115,3023,41,434,AK - Fairbanks
65,2015-2016,2015-09-25,2016-04-08,197,0,494,1114,1608,91,1093,1184,2792,44,424,AK - Fairbanks
66,2016-2017,2016-10-16,2017-04-26,193,0,792,1616,2408,125,1276,1401,3809,56,787,AK - Fairbanks
67,2017-2018,2017-10-09,2018-05-03,207,0,582,1276,1858,133,1426,1559,3417,65,613,AK - Fairbanks
68,2018-2019,2018-10-20,2019-04-24,187,0,535,1123,1658,97,1002,1099,2757,57,622,AK - Fairbanks
69,2019-2020,2019-10-05,2020-04-24,203,0,828,1615,2443,133,1431,1564,4007,68,893,AK - Fairbanks
0,1950-1951,1950-11-04,1951-03-26,143,0,174,449,623,136,478,614,1237,52,296,AK - Juneau
1,1951-1952,1951-11-13,1952-04-08,148,0,132,403,535,154,541,695,1230,65,373,AK - Juneau
2,1952-1953,1952-11-28,1953-03-31,124,0,82,217,299,70,67,137,436,40,186,AK - Juneau
3,1953-1954,1953-11-02,1954-04-11,161,0,106,350,456,96,146,242,698,38,191,AK - Juneau
4,1954-1955,1954-11-12,1955-04-23,163,0,63,246,309,134,204,338,647,56,273,AK - Juneau
5,1955-1956,1955-10-28,1956-04-15,171,0,197,550,747,223,738,961,1708,64,410,AK - Juneau
6,1956-1957,1956-10-24,1957-04-05,164,0,101,358,459,178,344,522,981,47,314,AK - Juneau
7,1957-1958,1957-11-23,1958-03-20,118,1,39,189,228,120,155,275,503,45,219,AK - Juneau
8,1958-1959,1958-10-07,1959-04-20,196,0,94,323,417,186,337,523,940,67,375,AK - Juneau
9,1959-1960,1959-11-04,1960-04-09,158,0,30,184,214,105,123,228,442,49,189,AK - Juneau
10,1960-1961,1960-11-11,1961-04-17,158,0,32,174,206,129,121,250,456,53,214,AK - Juneau
11,1961-1962,1961-10-31,1962-04-10,162,0,89,357,446,164,352,516,962,57,357,AK - Juneau
12,1962-1963,1962-11-15,1963-04-17,154,0,66,242,308,202,311,513,821,46,327,AK - Juneau
13,1963-1964,1963-11-15,1964-05-12,180,0,65,243,308,149,192,341,649,63,267,AK - Juneau
14,1964-1965,1964-11-06,1965-05-13,189,0,155,444,599,267,550,817,1416,57,520,AK - Juneau
15,1965-1966,1965-10-19,1966-04-14,178,0,150,484,634,210,582,792,1426,55,375,AK - Juneau
16,1966-1967,1966-10-22,1967-04-15,176,0,108,433,541,180,277,457,998,63,343,AK - Juneau
17,1967-1968,1967-11-13,1968-04-19,159,0,106,347,453,129,182,311,764,44,258,AK - Juneau
18,1968-1969,1968-11-13,1969-03-26,134,0,185,507,692,168,809,977,1669,60,343,AK - Juneau
19,1969-1970,1969-11-11,1970-04-07,148,0,65,213,278,64,77,141,419,31,178,AK - Juneau
20,1970-1971,1970-10-19,1971-04-15,179,0,182,482,664,244,564,808,1472,72,555,AK - Juneau
21,1971-1972,1971-10-25,1972-04-28,187,0,191,535,726,254,1114,1368,2094,86,522,AK - Juneau
22,1972-1973,1972-10-29,1973-04-05,159,0,108,354,462,187,470,657,1119,54,387,AK - Juneau
23,1973-1974,1973-11-06,1974-04-03,149,0,140,480,620,168,543,711,1331,54,343,AK - Juneau
24,1974-1975,1974-10-02,1975-04-20,201,0,81,301,382,151,235,386,768,57,266,AK - Juneau
25,1975-1976,1975-10-30,1976-04-06,160,0,102,315,417,259,672,931,1348,78,494,AK - Juneau
26,1976-1977,1976-10-28,1977-03-25,149,0,7,48,55,72,67,139,194,31,93,AK - Juneau
27,1977-1978,1977-11-06,1978-04-09,155,0,113,331,444,79,229,308,752,33,161,AK - Juneau
28,1978-1979,1978-11-10,1979-03-27,138,0,154,400,554,126,508,634,1188,50,296,AK - Juneau
29,1979-1980,1979-11-25,1980-03-18,115,0,85,256,341,136,288,424,765,32,243,AK - Juneau
30,1980-1981,1980-11-20,1981-04-16,148,0,52,172,224,92,140,232,456,25,171,AK - Juneau
31,1981-1982,1981-11-19,1982-04-17,150,0,150,377,527,167,737,904,1431,36,302,AK - Juneau
32,1982-1983,1982-10-27,1983-03-09,134,0,41,187,228,102,153,255,483,26,168,AK - Juneau
33,1983-1984,1983-11-08,1984-03-17,131,4,70,208,278,93,204,297,575,21,150,AK - Juneau
35,1985-1986,1985-10-26,1986-04-23,180,0,78,266,344,101,131,232,576,42,166,AK - Juneau
36,1986-1987,1986-11-07,1987-03-12,126,0,47,150,197,51,135,186,383,20,99,AK - Juneau
37,1987-1988,1987-11-05,1988-04-10,158,0,32,140,172,49,49,98,270,34,88,AK - Juneau
38,1988-1989,1988-11-12,1989-03-30,139,0,78,287,365,112,375,487,852,53,229,AK - Juneau
39,1989-1990,1989-10-27,1990-03-20,145,0,71,211,282,169,343,512,794,56,334,AK - Juneau
40,1990-1991,1990-11-06,1991-04-01,147,0,91,296,387,195,842,1037,1424,65,370,AK - Juneau
41,1991-1992,1991-10-29,1992-03-30,154,0,21,117,138,137,239,376,514,47,197,AK - Juneau
42,1992-1993,1992-10-18,1993-03-25,159,0,56,277,333,149,512,661,994,46,263,AK - Juneau
43,1993-1994,1993-11-17,1994-03-25,129,0,83,214,297,188,547,735,1032,53,316,AK - Juneau
44,1994-1995,1994-11-02,1995-03-30,149,0,75,299,374,206,619,825,1199,60,355,AK - Juneau
45,1995-1996,1995-11-09,1996-04-01,145,0,133,355,488,125,432,557,1045,40,254,AK - Juneau
46,1996-1997,1996-10-19,1997-04-18,182,0,77,261,338,93,169,262,600,49,166,AK - Juneau
47,1997-1998,1997-10-13,1998-03-26,165,0,43,169,212,59,166,225,437,27,102,AK - Juneau
48,1998-1999,1998-11-11,1999-04-07,148,0,65,248,313,178,754,932,1245,59,313,AK - Juneau
49,1999-2000,1999-11-24,2000-02-29,98,0,39,136,175,65,111,176,351,34,122,AK - Juneau
50,2000-2001,2000-10-02,2001-03-31,181,0,31,181,212,45,98,143,355,22,77,AK - Juneau
51,2001-2002,2001-10-26,2002-03-18,144,0,61,242,303,125,221,346,649,44,224,AK - Juneau
52,2002-2003,2002-11-23,2003-03-31,129,0,50,175,225,78,115,193,418,24,134,AK - Juneau
53,2003-2004,2003-11-13,2004-04-01,141,0,55,206,261,131,127,258,519,47,225,AK - Juneau
54,2004-2005,2004-11-02,2005-04-03,153,0,52,200,252,118,216,334,586,39,208,AK - Juneau
55,2005-2006,2005-11-03,2006-04-30,179,0,63,267,330,84,126,210,540,44,177,AK - Juneau
56,2006-2007,2006-11-03,2007-04-07,156,0,101,314,415,253,662,915,1330,65,432,AK - Juneau
57,2007-2008,2007-11-05,2008-04-20,168,0,79,256,335,156,202,358,693,57,290,AK - Juneau
58,2008-2009,2008-10-24,2009-04-04,163,0,104,342,446,258,518,776,1222,71,449,AK - Juneau
59,2009-2010,2009-10-31,2010-04-09,161,0,35,180,215,99,101,200,415,42,163,AK - Juneau
60,2010-2011,2010-11-17,2011-04-11,146,0,103,321,424,118,304,422,846,45,260,AK - Juneau
61,2011-2012,2011-11-04,2012-03-26,144,0,47,192,239,180,251,431,670,60,277,AK - Juneau
62,2012-2013,2012-10-28,2013-04-28,183,0,71,275,346,121,243,364,710,54,253,AK - Juneau
63,2013-2014,2013-11-16,2014-04-09,145,0,57,254,311,139,223,362,673,42,223,AK - Juneau
64,2014-2015,2014-11-28,2015-03-15,108,0,31,121,152,73,121,194,346,22,130,AK - Juneau
65,2015-2016,2015-11-14,2016-02-29,108,0,16,87,103,56,51,107,210,22,84,AK - Juneau
66,2016-2017,2016-10-15,2017-03-28,165,0,74,293,367,98,220,318,685,37,180,AK - Juneau
67,2017-2018,2017-11-10,2018-03-28,139,0,81,307,388,111,330,441,829,42,230,AK - Juneau
68,2018-2019,2018-11-01,2019-04-23,174,2,40,228,268,74,269,343,611,28,136,AK - Juneau
69,2019-2020,2019-11-10,2020-03-30,142,2,46,161,207,107,180,287,494,48,178,AK - Juneau
0,1950-1951,1950-10-30,1951-05-01,184,1,56,201,257,260,1694,1954,2211,54,350,AK - Little Port Walter
1,1951-1952,1951-11-16,1952-04-19,156,0,39,175,214,261,1300,1561,1775,55,367,AK - Little Port Walter
2,1952-1953,1952-12-01,1953-04-02,123,1,34,104,138,113,202,315,453,24,151,AK - Little Port Walter
3,1953-1954,1953-11-01,1954-04-30,181,0,36,157,193,191,564,755,948,44,252,AK - Little Port Walter
4,1954-1955,1954-12-01,1955-04-27,148,3,18,128,146,152,626,778,924,33,198,AK - Little Port Walter
5,1955-1956,1955-11-05,1956-04-27,175,1,77,232,309,274,1474,1748,2057,63,374,AK - Little Port Walter
6,1956-1957,1956-11-01,1957-04-26,177,2,30,138,168,176,627,803,971,34,230,AK - Little Port Walter
7,1957-1958,1957-12-01,1958-03-12,102,0,4,61,65,111,270,381,446,27,145,AK - Little Port Walter
8,1958-1959,1958-11-12,1959-04-09,149,2,26,101,127,187,867,1054,1181,50,256,AK - Little Port Walter
9,1959-1960,1959-10-08,1960-04-02,178,5,3,81,84,132,275,407,491,39,170,AK - Little Port Walter
10,1960-1961,1960-11-19,1961-03-16,118,1,2,65,67,85,172,257,324,29,112,AK - Little Port Walter
11,1961-1962,1961-11-04,1962-03-29,146,4,29,136,165,173,410,583,748,42,261,AK - Little Port Walter
12,1962-1963,1962-11-27,1963-04-16,141,0,18,92,110,119,245,364,474,27,168,AK - Little Port Walter
14,1964-1965,1964-11-25,1965-05-09,166,18,73,196,269,262,1211,1473,1742,32,342,AK - Little Port Walter
15,1965-1966,1965-11-24,1966-04-13,141,15,38,170,208,128,778,906,1114,23,161,AK - Little Port Walter
20,1970-1971,1970-11-25,1971-05-12,169,19,55,188,243,311,1825,2136,2379,45,406,AK - Little Port Walter
21,1971-1972,1971-10-25,1972-05-24,213,10,60,247,307,291,2177,2468,2775,52,400,AK - Little Port Walter
22,1972-1973,1972-11-04,1973-04-18,166,12,14,136,150,225,1548,1773,1923,47,283,AK - Little Port Walter
23,1973-1974,1973-10-20,1974-05-02,195,15,42,181,223,341,1978,2319,2542,53,427,AK - Little Port Walter
25,1975-1976,1975-11-05,1976-04-17,165,1,19,142,161,273,908,1181,1342,52,351,AK - Little Port Walter
27,1977-1978,1977-11-09,1978-03-14,126,2,34,134,168,110,465,575,743,21,147,AK - Little Port Walter
28,1978-1979,1978-11-11,1979-04-15,156,0,48,170,218,213,1465,1678,1896,38,283,AK - Little Port Walter
29,1979-1980,1979-12-01,1980-03-30,121,1,26,118,144,161,469,630,774,35,233,AK - Little Port Walter
30,1980-1981,1980-12-01,1981-03-07,97,5,17,54,71,73,305,378,449,13,89,AK - Little Port Walter
31,1981-1982,1981-12-01,1982-04-29,150,7,49,160,209,165,1092,1257,1466,39,246,AK - Little Port Walter
32,1982-1983,1982-11-19,1983-02-28,102,1,7,54,61,75,135,210,271,18,97,AK - Little Port Walter
33,1983-1984,1983-12-01,1984-02-29,91,2,5,57,62,47,190,237,299,17,63,AK - Little Port Walter
34,1984-1985,1984-11-01,1985-04-30,181,16,14,119,133,140,310,450,583,35,179,AK - Little Port Walter
35,1985-1986,1985-11-02,1986-04-08,158,10,21,128,149,59,117,176,325,19,81,AK - Little Port Walter
36,1986-1987,1986-11-08,1987-04-18,162,7,9,62,71,41,48,89,160,13,54,AK - Little Port Walter
37,1987-1988,1987-11-17,1988-02-29,105,15,5,61,66,45,146,191,257,14,64,AK - Little Port Walter
39,1989-1990,1989-11-11,1990-03-24,134,2,14,106,120,187,602,789,909,36,241,AK - Little Port Walter
40,1990-1991,1990-11-06,1991-04-11,157,13,20,180,200,213,818,1031,1231,47,283,AK - Little Port Walter
41,1991-1992,1991-10-28,1992-02-29,125,11,3,55,58,47,52,99,157,9,58,AK - Little Port Walter
42,1992-1993,1992-10-17,1993-03-24,159,3,11,148,159,143,758,901,1060,37,200,AK - Little Port Walter
43,1993-1994,1993-11-15,1994-04-13,150,14,20,117,137,132,381,513,650,35,180,AK - Little Port Walter
44,1994-1995,1994-11-12,1995-03-30,139,8,8,139,147,138,611,749,896,37,180,AK - Little Port Walter
45,1995-1996,1995-11-07,1996-03-14,129,10,35,151,186,205,549,754,940,39,273,AK - Little Port Walter
46,1996-1997,1996-11-05,1997-04-01,148,9,29,145,174,134,425,559,733,33,176,AK - Little Port Walter
47,1997-1998,1997-12-01,1998-03-10,100,9,15,65,80,56,193,249,329,19,85,AK - Little Port Walter
51,2001-2002,2001-10-26,2002-04-22,179,12,17,182,199,266,1009,1275,1474,48,337,AK - Little Port Walter
52,2002-2003,2002-12-01,2003-03-31,121,4,9,83,92,69,118,187,279,13,84,AK - Little Port Walter
53,2003-2004,2003-12-01,2004-03-31,122,4,16,100,116,92,181,273,389,28,145,AK - Little Port Walter
55,2005-2006,2005-11-05,2006-04-30,177,1,15,144,159,118,339,457,616,33,168,AK - Little Port Walter
56,2006-2007,2006-11-04,2007-04-27,175,10,31,169,200,366,1235,1601,1801,69,461,AK - Little Port Walter
57,2007-2008,2007-10-31,2008-04-17,170,5,37,162,199,215,718,933,1132,46,301,AK - Little Port Walter
58,2008-2009,2008-11-14,2009-05-04,172,4,27,187,214,343,1805,2148,2362,65,444,AK - Little Port Walter
59,2009-2010,2009-11-12,2010-04-09,149,0,6,83,89,73,91,164,253,24,100,AK - Little Port Walter
60,2010-2011,2010-11-23,2011-04-11,140,13,29,113,142,137,349,486,628,32,182,AK - Little Port Walter
61,2011-2012,2011-11-04,2012-03-30,148,0,14,137,151,224,462,686,837,54,290,AK - Little Port Walter
63,2013-2014,2013-11-16,2014-04-09,145,0,17,100,117,88,216,304,421,28,123,AK - Little Port Walter
64,2014-2015,2014-11-29,2015-03-11,103,0,7,37,44,21,28,49,93,6,36,AK - Little Port Walter
66,2016-2017,2016-12-01,2017-03-31,121,13,15,120,135,111,309,420,555,29,151,AK - Little Port Walter
67,2017-2018,2017-11-13,2018-03-27,135,19,19,146,165,115,403,518,683,35,175,AK - Little Port Walter
68,2018-2019,2018-12-01,2019-04-25,146,9,9,106,115,49,144,193,308,19,77,AK - Little Port Walter
69,2019-2020,2019-12-01,2020-04-09,131,2,21,112,133,179,301,480,613,31,228,AK - Little Port Walter
0,1950-1951,1950-10-10,1951-05-01,204,0,1180,2120,3300,65,886,951,4251,45,605,AK - Northway
1,1951-1952,1951-09-29,1952-04-27,212,0,1051,2047,3098,75,1374,1449,4547,53,910,AK - Northway
2,1952-1953,1952-10-18,1953-04-20,185,0,973,1801,2774,50,1052,1102,3876,37,557,AK - Northway
3,1953-1954,1953-09-27,1954-04-30,216,0,1097,2087,3184,70,1027,1097,4281,53,713,AK - Northway
4,1954-1955,1954-10-10,1955-05-03,206,0,926,1794,2720,80,1218,1298,4018,59,795,AK - Northway
5,1955-1956,1955-10-06,1956-04-30,208,0,1297,2281,3578,112,1786,1898,5476,67,1348,AK - Northway
6,1956-1957,1956-09-20,1957-05-06,229,0,1088,2109,3197,111,2081,2192,5389,74,1004,AK - Northway
7,1957-1958,1957-10-11,1958-04-26,198,0,832,1670,2502,58,1051,1109,3611,38,553,AK - Northway
8,1958-1959,1958-09-20,1959-04-28,221,0,1199,2190,3389,48,1160,1208,4597,37,538,AK - Northway
9,1959-1960,1959-10-07,1960-04-25,202,0,925,1825,2750,49,1245,1294,4044,30,454,AK - Northway
10,1960-1961,1960-10-04,1961-05-13,222,0,958,1825,2783,66,1375,1441,4224,44,557,AK - Northway
11,1961-1962,1961-09-04,1962-05-17,256,3,1051,1975,3026,71,1156,1227,4253,52,621,AK - Northway
12,1962-1963,1962-08-30,1963-04-27,241,0,821,1641,2462,58,1072,1130,3592,46,503,AK - Northway
13,1963-1964,1963-10-09,1964-05-22,227,2,1046,1946,2992,59,1090,1149,4141,46,449,AK - Northway
14,1964-1965,1964-09-16,1965-05-07,234,0,1096,1987,3083,41,642,683,3766,35,475,AK - Northway
15,1965-1966,1965-09-27,1966-05-23,239,12,1186,2218,3404,66,1385,1451,4855,44,679,AK - Northway
16,1966-1967,1966-10-07,1967-05-16,222,0,1069,2092,3161,78,1432,1510,4671,45,546,AK - Northway
17,1967-1968,1967-10-03,1968-05-01,212,0,841,1692,2533,57,1114,1171,3704,41,473,AK - Northway
18,1968-1969,1968-09-20,1969-04-25,218,0,1135,2070,3205,48,993,1041,4246,36,518,AK - Northway
19,1969-1970,1969-08-10,1970-05-05,269,0,883,1695,2578,49,877,926,3504,30,434,AK - Northway
20,1970-1971,1970-09-07,1971-05-10,246,0,1112,2114,3226,55,1218,1273,4499,43,493,AK - Northway
21,1971-1972,1971-10-04,1972-05-09,219,0,1229,2335,3564,100,1881,1981,5545,37,676,AK - Northway
22,1972-1973,1972-09-18,1973-05-07,232,0,1014,1947,2961,57,1207,1264,4225,34,444,AK - Northway
23,1973-1974,1973-10-07,1974-04-24,200,0,1233,2208,3441,45,1442,1487,4928,32,500,AK - Northway
24,1974-1975,1974-08-22,1975-04-23,245,0,1005,1909,2914,49,1212,1261,4175,34,449,AK - Northway
25,1975-1976,1975-09-26,1976-04-26,214,0,1096,2086,3182,46,1012,1058,4240,27,365,AK - Northway
26,1976-1977,1976-10-11,1977-04-28,200,0,712,1491,2203,50,1129,1179,3382,35,412,AK - Northway
27,1977-1978,1977-09-22,1978-04-16,207,0,1017,1906,2923,54,1075,1129,4052,33,505,AK - Northway
28,1978-1979,1978-09-24,1979-04-26,215,0,1044,1981,3025,76,1358,1434,4459,47,629,AK - Northway
29,1979-1980,1979-10-19,1980-04-22,187,3,828,1732,2560,46,738,784,3344,34,496,AK - Northway
30,1980-1981,1980-09-01,1981-04-20,232,0,842,1734,2576,34,677,711,3287,30,440,AK - Northway
31,1981-1982,1981-09-25,1982-05-07,225,0,1068,2028,3096,88,1442,1530,4626,58,743,AK - Northway
32,1982-1983,1982-10-02,1983-04-25,206,0,991,1840,2831,90,1548,1638,4469,61,847,AK - Northway
33,1983-1984,1983-09-02,1984-05-11,253,3,902,1711,2613,67,851,918,3531,51,644,AK - Northway
34,1984-1985,1984-08-26,1985-04-30,248,0,844,1843,2687,95,1304,1399,4086,64,870,AK - Northway
35,1985-1986,1985-09-22,1986-05-17,238,6,917,1855,2772,87,1130,1217,3989,57,772,AK - Northway
36,1986-1987,1986-09-23,1987-04-21,211,3,793,1680,2473,68,863,931,3404,45,573,AK - Northway
37,1987-1988,1987-09-08,1988-04-30,236,0,852,1764,2616,83,1286,1369,3985,55,693,AK - Northway
38,1988-1989,1988-09-28,1989-05-23,238,0,1024,1936,2960,100,1497,1597,4557,64,930,AK - Northway
39,1989-1990,1989-10-09,1990-04-23,197,0,1008,1854,2862,76,1546,1622,4484,50,713,AK - Northway
40,1990-1991,1990-10-01,1991-04-20,202,0,943,1905,2848,86,1309,1395,4243,63,899,AK - Northway
41,1991-1992,1991-10-07,1992-05-18,225,0,845,1812,2657,74,1338,1412,4069,49,686,AK - Northway
42,1992-1993,1992-09-10,1993-04-20,223,6,807,1777,2584,87,1438,1525,4109,52,538,AK - Northway
43,1993-1994,1993-09-25,1994-04-19,207,0,851,1690,2541,70,1135,1205,3746,43,622,AK - Northway
44,1994-1995,1994-10-08,1995-05-16,221,4,931,1803,2734,85,1409,1494,4228,57,695,AK - Northway
45,1995-1996,1995-10-09,1996-04-22,197,0,1018,1920,2938,62,1027,1089,4027,42,572,AK - Northway
46,1996-1997,1996-09-22,1997-04-27,218,0,1177,2237,3414,74,1414,1488,4902,46,662,AK - Northway
47,1997-1998,1997-10-06,1998-05-04,211,0,826,1638,2464,74,1245,1319,3783,48,602,AK - Northway
48,1998-1999,1998-09-30,1999-05-07,220,2,1066,2012,3078,64,868,932,4010,43,692,AK - Northway
50,2000-2001,2000-09-26,2001-04-24,211,6,755,1543,2298,65,1148,1213,3511,41,437,AK - Northway
60,2010-2011,2010-09-26,2011-05-13,230,4,938,1937,2875,106,1400,1506,4381,57,803,AK - Northway
61,2011-2012,2011-10-09,2012-05-08,213,3,932,1744,2676,88,1232,1320,3996,66,919,AK - Northway
62,2012-2013,2012-10-01,2013-05-19,231,0,1075,2003,3078,139,1439,1578,4656,79,1072,AK - Northway
63,2013-2014,2013-09-19,2014-04-24,218,0,799,1722,2521,90,1080,1170,3691,49,582,AK - Northway
64,2014-2015,2014-09-03,2015-04-20,230,0,811,1573,2384,60,955,1015,3399,48,521,AK - Northway
65,2015-2016,2015-10-03,2016-05-17,228,0,654,1288,1942,69,791,860,2802,48,559,AK - Northway
66,2016-2017,2016-10-15,2017-04-14,182,0,910,1801,2711,58,639,697,3408,37,608,AK - Northway
67,2017-2018,2017-10-13,2018-05-01,201,0,856,1692,2548,57,871,928,3476,43,492,AK - Northway
68,2018-2019,2018-10-15,2019-04-03,171,0,747,1378,2125,50,815,865,2990,32,390,AK - Northway
69,2019-2020,2019-10-05,2020-04-24,203,4,912,1773,2685,80,1242,1322,4007,44,690,AK - Northway
0,1950-1951,1950-10-09,1951-04-30,204,5,1047,1805,2852,73,1831,1904,4756,54,691,AK - Tanana
1,1951-1952,1951-10-01,1952-05-19,232,3,931,1754,2685,111,2114,2225,4910,67,835,AK - Tanana
2,1952-1953,1952-09-28,1953-04-22,207,4,926,1705,2631,58,1420,1478,4109,41,548,AK - Tanana
3,1953-1954,1953-10-02,1954-05-01,212,0,925,1751,2676,85,1506,1591,4267,47,639,AK - Tanana
4,1954-1955,1954-10-07,1955-05-10,216,1,968,1811,2779,160,1435,1595,4374,47,764,AK - Tanana
5,1955-1956,1955-10-06,1956-05-03,211,0,1168,2116,3284,99,1779,1878,5162,61,855,AK - Tanana
6,1956-1957,1956-09-29,1957-04-29,213,5,1062,1889,2951,79,1323,1402,4353,55,720,AK - Tanana
7,1957-1958,1957-09-29,1958-04-23,207,0,799,1426,2225,41,657,698,2923,34,339,AK - Tanana
8,1958-1959,1958-09-30,1959-05-02,215,0,966,1947,2913,82,1581,1663,4576,45,557,AK - Tanana
9,1959-1960,1959-09-24,1960-04-28,218,0,851,1610,2461,84,1401,1485,3946,50,640,AK - Tanana
10,1960-1961,1960-09-22,1961-04-26,217,0,862,1611,2473,68,1075,1143,3616,52,609,AK - Tanana
11,1961-1962,1961-10-03,1962-05-09,219,3,972,1842,2814,92,1874,1966,4780,62,685,AK - Tanana
12,1962-1963,1962-10-11,1963-05-08,210,13,846,1643,2489,101,1787,1888,4377,51,502,AK - Tanana
13,1963-1964,1963-10-10,1964-05-20,224,10,942,1877,2819,68,1015,1083,3902,51,554,AK - Tanana
14,1964-1965,1964-10-16,1965-05-04,201,3,962,1709,2671,71,1460,1531,4202,56,684,AK - Tanana
16,1966-1967,1966-10-20,1967-05-06,199,3,895,1671,2566,105,1621,1726,4292,75,815,AK - Tanana
17,1967-1968,1967-10-16,1968-05-12,210,5,880,1725,2605,77,1700,1777,4382,43,494,AK - Tanana
18,1968-1969,1968-09-28,1969-04-23,208,0,1053,1860,2913,78,1272,1350,4263,36,542,AK - Tanana
19,1969-1970,1969-10-20,1970-04-25,188,0,793,1331,2124,37,696,733,2857,25,262,AK - Tanana
20,1970-1971,1970-09-23,1971-05-10,230,6,1130,2063,3193,114,2026,2140,5333,59,857,AK - Tanana
21,1971-1972,1971-09-29,1972-02-29,154,4,935,1446,2381,71,1155,1226,3607,50,529,AK - Tanana
23,1973-1974,1973-09-25,1974-04-25,213,0,1044,1958,3002,52,1063,1115,4117,45,588,AK - Tanana
25,1975-1976,1975-09-27,1976-05-10,227,3,1068,1986,3054,74,1460,1534,4588,44,488,AK - Tanana
26,1976-1977,1976-10-07,1977-05-06,212,4,683,1448,2131,92,1712,1804,3935,58,555,AK - Tanana
28,1978-1979,1978-09-24,1979-04-30,219,3,842,1707,2549,117,2372,2489,5038,54,590,AK - Tanana
29,1979-1980,1979-10-16,1980-04-27,195,0,807,1508,2315,68,1436,1504,3819,41,463,AK - Tanana
30,1980-1981,1980-09-03,1981-04-23,233,0,703,1418,2121,58,1125,1183,3304,38,363,AK - Tanana
31,1981-1982,1981-09-26,1982-05-09,226,3,886,1663,2549,89,1692,1781,4330,60,580,AK - Tanana
32,1982-1983,1982-10-01,1983-04-21,203,3,897,1565,2462,65,1607,1672,4134,51,601,AK - Tanana
33,1983-1984,1983-09-23,1984-05-13,234,14,947,1755,2702,88,1563,1651,4353,61,767,AK - Tanana
34,1984-1985,1984-10-04,1985-05-19,228,3,805,1627,2432,128,1804,1932,4364,58,722,AK - Tanana
35,1985-1986,1985-09-21,1986-05-04,226,6,778,1681,2459,57,1584,1641,4100,34,410,AK - Tanana
36,1986-1987,1986-09-30,1987-04-27,210,0,746,1533,2279,59,1431,1490,3769,32,396,AK - Tanana
37,1987-1988,1987-09-08,1988-05-01,237,0,725,1444,2169,66,1436,1502,3671,43,522,AK - Tanana
38,1988-1989,1988-10-02,1989-04-30,211,14,865,1661,2526,86,1773,1859,4385,54,577,AK - Tanana
39,1989-1990,1989-10-13,1990-04-26,196,3,975,1731,2706,87,1762,1849,4555,53,660,AK - Tanana
40,1990-1991,1990-09-26,1991-05-02,219,2,859,1653,2512,109,1772,1881,4393,72,894,AK - Tanana
41,1991-1992,1991-10-06,1992-05-17,225,0,868,1638,2506,67,1301,1368,3874,56,606,AK - Tanana
42,1992-1993,1992-09-11,1993-05-09,241,0,764,1562,2326,119,2048,2167,4493,76,798,AK - Tanana
43,1993-1994,1993-09-29,1994-04-27,211,4,739,1353,2092,72,1388,1460,3552,62,593,AK - Tanana
45,1995-1996,1995-10-08,1996-04-28,204,4,900,1704,2604,81,1060,1141,3745,36,433,AK - Tanana
46,1996-1997,1996-09-25,1997-04-27,215,2,856,1705,2561,99,1273,1372,3933,45,512,AK - Tanana
47,1997-1998,1997-10-03,1998-04-28,208,9,669,1280,1949,68,1002,1070,3019,48,592,AK - Tanana
48,1998-1999,1998-10-07,1999-04-25,201,2,894,1623,2517,84,1020,1104,3621,52,680,AK - Tanana
60,2010-2011,2010-09-30,2011-05-07,220,3,869,1679,2548,92,1298,1390,3938,53,638,AK - Tanana
61,2011-2012,2011-10-14,2012-05-03,203,1,993,1882,2875,114,1501,1615,4490,59,904,AK - Tanana
62,2012-2013,2012-10-13,2013-05-10,210,2,921,1856,2777,78,1163,1241,4018,48,623,AK - Tanana
63,2013-2014,2013-10-25,2014-04-24,182,6,667,1380,2047,61,942,1003,3050,42,514,AK - Tanana
64,2014-2015,2014-09-29,2015-04-21,205,0,623,1337,1960,52,940,992,2952,43,345,AK - Tanana
65,2015-2016,2015-09-25,2016-04-23,212,0,545,1234,1779,95,1376,1471,3250,43,390,AK - Tanana
66,2016-2017,2016-10-18,2017-05-01,196,3,832,1769,2601,93,1162,1255,3856,53,813,AK - Tanana
67,2017-2018,2017-10-17,2018-05-10,206,0,600,1281,1881,125,1445,1570,3451,58,526,AK - Tanana
68,2018-2019,2018-10-27,2019-05-09,195,4,593,1172,1765,102,1231,1333,3098,56,518,AK - Tanana
69,2019-2020,2019-10-06,2020-05-11,219,0,889,1819,2708,162,1791,1953,4661,73,923,AK - Tanana
0,1950-1951,1950-09-03,1951-06-16,287,2,1471,2130,3601,49,1306,1355,4956,42,409,AK - Utquagvik (Barrow)
1,1951-1952,1951-09-06,1952-06-19,288,0,1464,2187,3651,71,1489,1560,5211,62,569,AK - Utquagvik (Barrow)
2,1952-1953,1952-07-29,1953-06-15,322,2,1493,2141,3634,54,1027,1081,4715,52,625,AK - Utquagvik (Barrow)
3,1953-1954,1953-08-14,1954-06-14,305,0,1585,2390,3975,79,1536,1615,5590,73,902,AK - Utquagvik (Barrow)
4,1954-1955,1954-09-18,1955-06-21,277,3,1621,2275,3896,37,1476,1513,5409,33,395,AK - Utquagvik (Barrow)
5,1955-1956,1955-07-19,1956-06-23,341,0,1789,2666,4455,57,1287,1344,5799,52,650,AK - Utquagvik (Barrow)
6,1956-1957,1956-07-18,1957-06-24,342,0,1523,2290,3813,76,1574,1650,5463,73,970,AK - Utquagvik (Barrow)
7,1957-1958,1957-07-08,1958-06-16,344,0,1630,2187,3817,82,1123,1205,5022,68,604,AK - Utquagvik (Barrow)
8,1958-1959,1958-09-16,1959-06-11,269,0,1491,2206,3697,97,1612,1709,5406,79,755,AK - Utquagvik (Barrow)
9,1959-1960,1959-07-03,1960-06-18,352,0,1634,2428,4062,100,1481,1581,5643,92,1035,AK - Utquagvik (Barrow)
10,1960-1961,1960-08-20,1961-06-19,304,0,1760,2380,4140,66,1641,1707,5847,60,693,AK - Utquagvik (Barrow)
11,1961-1962,1961-07-08,1962-06-17,345,1,1322,2128,3450,136,1855,1991,5441,107,1110,AK - Utquagvik (Barrow)
12,1962-1963,1962-07-04,1963-06-09,341,8,1387,2149,3536,120,1576,1696,5232,91,897,AK - Utquagvik (Barrow)
13,1963-1964,1963-07-04,1964-06-30,363,0,1798,2550,4348,79,1319,1398,5746,67,731,AK - Utquagvik (Barrow)
14,1964-1965,1964-07-04,1965-06-22,354,0,1755,2488,4243,97,1458,1555,5798,81,824,AK - Utquagvik (Barrow)
15,1965-1966,1965-08-28,1966-06-12,289,0,1598,2414,4012,95,1709,1804,5816,74,786,AK - Utquagvik (Barrow)
16,1966-1967,1966-08-16,1967-06-28,317,0,1345,1971,3316,86,1265,1351,4667,78,636,AK - Utquagvik (Barrow)
17,1967-1968,1967-07-05,1968-06-30,362,0,1535,2294,3829,91,1677,1768,5597,83,960,AK - Utquagvik (Barrow)
18,1968-1969,1968-07-01,1969-06-12,347,0,1489,2118,3607,83,1365,1448,5055,71,695,AK - Utquagvik (Barrow)
19,1969-1970,1969-07-18,1970-06-18,336,0,1598,2221,3819,52,986,1038,4857,48,488,AK - Utquagvik (Barrow)
20,1970-1971,1970-09-01,1971-06-13,286,0,1829,2546,4375,50,1252,1302,5677,44,514,AK - Utquagvik (Barrow)
21,1971-1972,1971-08-09,1972-06-21,318,0,1607,2352,3959,57,1081,1138,5097,50,499,AK - Utquagvik (Barrow)
22,1972-1973,1972-08-30,1973-06-22,297,0,1460,2108,3568,107,1214,1321,4889,76,615,AK - Utquagvik (Barrow)
23,1973-1974,1973-07-06,1974-06-11,341,0,1550,2219,3769,85,1175,1260,5029,73,637,AK - Utquagvik (Barrow)
24,1974-1975,1974-09-10,1975-06-14,278,0,1787,2418,4205,67,1019,1086,5291,62,846,AK - Utquagvik (Barrow)
25,1975-1976,1975-07-25,1976-06-29,341,0,1903,2589,4492,57,908,965,5457,53,588,AK - Utquagvik (Barrow)
26,1976-1977,1976-09-03,1977-06-01,272,0,1619,2152,3771,78,1179,1257,5028,73,918,AK - Utquagvik (Barrow)
27,1977-1978,1977-07-04,1978-06-26,358,0,1366,1970,3336,63,889,952,4288,61,675,AK - Utquagvik (Barrow)
28,1978-1979,1978-08-05,1979-06-26,326,0,1485,2223,3708,53,996,1049,4757,48,408,AK - Utquagvik (Barrow)
29,1979-1980,1979-07-07,1980-06-04,334,0,1442,1935,3377,55,1295,1350,4727,52,458,AK - Utquagvik (Barrow)
30,1980-1981,1980-08-03,1981-06-26,328,0,1431,2093,3524,82,1427,1509,5033,73,767,AK - Utquagvik (Barrow)
31,1981-1982,1981-08-14,1982-06-11,302,0,1410,2014,3424,92,1366,1458,4882,86,795,AK - Utquagvik (Barrow)
32,1982-1983,1982-07-22,1983-06-23,337,0,1651,2193,3844,60,981,1041,4885,56,475,AK - Utquagvik (Barrow)
33,1983-1984,1983-07-13,1984-06-06,330,0,1741,2469,4210,89,1610,1699,5909,86,988,AK - Utquagvik (Barrow)
34,1984-1985,1984-08-23,1985-06-17,299,0,1531,2094,3625,60,834,894,4519,56,610,AK - Utquagvik (Barrow)
35,1985-1986,1985-08-11,1986-06-10,304,3,1479,2156,3635,69,1318,1387,5022,65,694,AK - Utquagvik (Barrow)
36,1986-1987,1986-08-22,1987-06-12,295,3,1482,2117,3599,74,1300,1374,4973,68,761,AK - Utquagvik (Barrow)
37,1987-1988,1987-08-30,1988-06-07,283,6,1367,2109,3476,70,1093,1163,4639,58,508,AK - Utquagvik (Barrow)
38,1988-1989,1988-08-25,1989-06-11,291,0,1419,2299,3718,66,1066,1132,4850,58,533,AK - Utquagvik (Barrow)
39,1989-1990,1989-09-18,1990-06-10,266,0,1556,2234,3790,51,718,769,4559,47,585,AK - Utquagvik (Barrow)
40,1990-1991,1990-07-07,1991-06-17,346,0,1506,2292,3798,84,1125,1209,5007,70,630,AK - Utquagvik (Barrow)
41,1991-1992,1991-08-05,1992-06-09,310,0,1577,2296,3873,90,1239,1329,5202,84,899,AK - Utquagvik (Barrow)
42,1992-1993,1992-08-03,1993-06-22,324,3,1333,2128,3461,108,1459,1567,5028,93,972,AK - Utquagvik (Barrow)
43,1993-1994,1993-08-03,1994-06-23,325,3,1335,1967,3302,102,1317,1419,4721,89,776,AK - Utquagvik (Barrow)
44,1994-1995,1994-08-24,1995-06-03,284,0,1531,2328,3859,74,1208,1282,5141,64,809,AK - Utquagvik (Barrow)
45,1995-1996,1995-08-05,1996-06-27,328,0,1228,2022,3250,71,1227,1298,4548,56,521,AK - Utquagvik (Barrow)
46,1996-1997,1996-08-09,1997-06-13,309,0,1389,2116,3505,76,1128,1204,4709,66,673,AK - Utquagvik (Barrow)
47,1997-1998,1997-09-23,1998-05-23,243,0,1221,1745,2966,90,1643,1733,4699,73,700,AK - Utquagvik (Barrow)
48,1998-1999,1998-09-28,1999-06-20,266,0,1305,1938,3243,88,1229,1317,4560,79,816,AK - Utquagvik (Barrow)
49,1999-2000,1999-08-28,2000-06-14,292,0,1510,2175,3685,119,1231,1350,5035,104,1215,AK - Utquagvik (Barrow)
50,2000-2001,2000-07-25,2001-06-19,330,0,1357,1969,3326,113,1398,1511,4837,92,807,AK - Utquagvik (Barrow)
51,2001-2002,2001-07-06,2002-06-28,358,3,1385,2134,3519,99,1225,1324,4843,80,874,AK - Utquagvik (Barrow)
52,2002-2003,2002-07-01,2003-06-14,349,0,1220,1813,3033,115,1265,1380,4413,99,891,AK - Utquagvik (Barrow)
53,2003-2004,2003-07-15,2004-06-03,325,1,1395,2037,3432,107,1282,1389,4821,82,899,AK - Utquagvik (Barrow)
54,2004-2005,2004-07-09,2005-06-22,349,0,1283,1856,3139,106,1246,1352,4491,96,910,AK - Utquagvik (Barrow)
55,2005-2006,2005-08-30,2006-06-06,281,3,1347,1964,3311,113,1505,1618,4929,90,1155,AK - Utquagvik (Barrow)
56,2006-2007,2006-08-16,2007-06-05,294,6,1280,1860,3140,103,1320,1423,4563,82,874,AK - Utquagvik (Barrow)
57,2007-2008,2007-09-29,2008-06-04,250,3,1215,1850,3065,111,1533,1644,4709,95,904,AK - Utquagvik (Barrow)
58,2008-2009,2008-07-30,2009-05-31,306,0,1247,1902,3149,153,1688,1841,4990,121,1368,AK - Utquagvik (Barrow)
59,2009-2010,2009-08-31,2010-06-14,288,0,1241,1887,3128,133,1504,1637,4765,112,1343,AK - Utquagvik (Barrow)
60,2010-2011,2010-09-22,2011-06-15,267,3,1141,1824,2965,141,1226,1367,4332,109,1113,AK - Utquagvik (Barrow)
61,2011-2012,2011-07-01,2012-06-07,343,0,1492,2112,3604,150,1479,1629,5233,117,1318,AK - Utquagvik (Barrow)
62,2012-2013,2012-07-21,2013-06-25,340,0,1264,1813,3077,156,1076,1232,4309,136,1403,AK - Utquagvik (Barrow)
63,2013-2014,2013-08-20,2014-06-14,299,0,1074,1721,2795,143,1040,1183,3978,131,1123,AK - Utquagvik (Barrow)
64,2014-2015,2014-07-23,2015-06-05,318,0,1165,1717,2882,133,1025,1158,4040,108,1077,AK - Utquagvik (Barrow)
65,2015-2016,2015-08-18,2016-06-16,304,0,1129,1602,2731,109,926,1035,3766,97,870,AK - Utquagvik (Barrow)
66,2016-2017,2016-08-03,2017-06-16,318,0,911,1575,2486,113,1005,1118,3604,100,908,AK - Utquagvik (Barrow)
67,2017-2018,2017-08-29,2018-06-13,289,1,847,1445,2292,90,1183,1273,3565,77,616,AK - Utquagvik (Barrow)
68,2018-2019,2018-07-07,2019-06-07,336,14,923,1534,2457,95,1087,1182,3639,71,677,AK - Utquagvik (Barrow)
0,1950-1951,1950-12-01,1951-05-16,167,0,11,400,411,105,149,254,665,22,164,AZ - Flagstaff
1,1951-1952,1951-11-22,1952-04-11,142,0,34,469,503,144,519,663,1166,30,229,AZ - Flagstaff
2,1952-1953,1952-11-15,1953-05-16,183,0,14,497,511,89,237,326,837,28,157,AZ - Flagstaff
3,1953-1954,1953-11-18,1954-05-01,165,0,11,456,467,121,271,392,859,23,188,AZ - Flagstaff
4,1954-1955,1954-11-02,1955-05-02,182,0,33,583,616,100,390,490,1106,27,191,AZ - Flagstaff
5,1955-1956,1955-11-14,1956-04-15,154,0,12,422,434,59,128,187,621,20,118,AZ - Flagstaff
6,1956-1957,1956-10-29,1957-05-15,199,0,13,433,446,79,195,274,720,28,139,AZ - Flagstaff
7,1957-1958,1957-10-22,1958-04-10,171,0,5,405,410,106,158,264,674,37,182,AZ - Flagstaff
8,1958-1959,1958-10-30,1959-03-24,146,0,9,414,423,75,139,214,637,13,112,AZ - Flagstaff
9,1959-1960,1959-10-01,1960-05-05,218,0,21,527,548,109,340,449,997,28,171,AZ - Flagstaff
10,1960-1961,1960-10-15,1961-05-13,211,0,8,469,477,79,115,194,671,25,130,AZ - Flagstaff
11,1961-1962,1961-10-08,1962-05-28,233,0,23,588,611,176,502,678,1289,46,310,AZ - Flagstaff
12,1962-1963,1962-11-15,1963-04-27,164,0,20,450,470,67,114,181,651,25,134,AZ - Flagstaff
13,1963-1964,1963-11-07,1964-05-07,183,0,18,562,580,120,183,303,883,31,207,AZ - Flagstaff
14,1964-1965,1964-11-10,1965-05-25,197,0,18,488,506,229,349,578,1084,48,352,AZ - Flagstaff
15,1965-1966,1965-09-19,1966-04-20,214,0,23,527,550,116,355,471,1021,35,226,AZ - Flagstaff
16,1966-1967,1966-11-08,1967-04-22,166,0,11,415,426,85,126,211,637,16,133,AZ - Flagstaff
17,1967-1968,1967-11-22,1968-05-13,174,0,23,444,467,208,644,852,1319,40,304,AZ - Flagstaff
18,1968-1969,1968-11-13,1969-05-05,174,0,41,485,526,180,437,617,1143,41,329,AZ - Flagstaff
19,1969-1970,1969-10-20,1970-04-29,192,0,9,428,437,136,106,242,679,36,211,AZ - Flagstaff
20,1970-1971,1970-11-30,1971-05-29,181,0,33,441,474,79,240,319,793,28,170,AZ - Flagstaff
21,1971-1972,1971-10-16,1972-04-14,182,0,24,562,586,68,116,184,770,20,123,AZ - Flagstaff
22,1972-1973,1972-10-20,1973-05-06,199,0,47,630,677,292,883,1175,1852,72,506,AZ - Flagstaff
23,1973-1974,1973-11-18,1974-04-02,136,0,18,344,362,101,289,390,752,28,175,AZ - Flagstaff
24,1974-1975,1974-10-27,1975-05-21,207,0,31,546,577,199,355,554,1131,60,371,AZ - Flagstaff
25,1975-1976,1975-11-27,1976-05-08,164,0,14,385,399,178,338,516,915,35,262,AZ - Flagstaff
26,1976-1977,1976-11-26,1977-05-13,169,0,10,475,485,102,195,297,782,25,165,AZ - Flagstaff
27,1977-1978,1977-11-06,1978-05-01,177,0,5,325,330,162,279,441,771,44,220,AZ - Flagstaff
28,1978-1979,1978-11-03,1979-05-09,188,0,45,565,610,199,617,816,1426,50,350,AZ - Flagstaff
29,1979-1980,1979-10-21,1980-04-24,187,0,10,434,444,248,408,656,1100,43,313,AZ - Flagstaff
30,1980-1981,1980-10-15,1981-04-19,187,0,1,269,270,124,121,245,515,34,160,AZ - Flagstaff
31,1981-1982,1981-11-27,1982-05-12,167,7,12,344,356,174,385,559,915,42,262,AZ - Flagstaff
32,1982-1983,1982-11-08,1983-05-01,175,0,9,411,420,198,445,643,1063,52,311,AZ - Flagstaff
33,1983-1984,1983-11-18,1984-04-29,164,0,2,389,391,50,89,139,530,26,97,AZ - Flagstaff
39,1989-1990,1989-12-01,1990-05-29,180,0,12,415,427,159,316,475,902,33,246,AZ - Flagstaff
40,1990-1991,1990-11-02,1991-04-01,151,0,17,425,442,174,261,435,877,32,257,AZ - Flagstaff
41,1991-1992,1991-10-27,1992-04-02,159,0,8,366,374,218,394,612,986,48,315,AZ - Flagstaff
42,1992-1993,1992-10-24,1993-05-04,193,0,8,393,401,198,414,612,1013,45,273,AZ - Flagstaff
43,1993-1994,1993-11-11,1994-04-28,169,0,5,388,393,154,270,424,817,34,216,AZ - Flagstaff
47,1997-1998,1997-11-12,1998-05-14,184,0,20,447,467,193,373,566,1033,42,294,AZ - Flagstaff
48,1998-1999,1998-10-16,1999-05-01,198,1,14,416,430,106,113,219,649,26,175,AZ - Flagstaff
49,1999-2000,1999-12-01,2000-04-01,123,2,6,309,315,103,109,212,527,25,163,AZ - Flagstaff
50,2000-2001,2000-10-28,2001-04-22,177,11,12,425,437,179,363,542,979,38,279,AZ - Flagstaff
51,2001-2002,2001-11-26,2002-03-25,120,0,12,379,391,55,98,153,544,11,103,AZ - Flagstaff
52,2002-2003,2002-10-27,2003-04-16,172,1,7,355,362,79,167,246,608,20,137,AZ - Flagstaff
53,2003-2004,2003-12-01,2004-03-06,97,0,14,289,303,68,84,152,455,17,115,AZ - Flagstaff
54,2004-2005,2004-10-21,2005-04-28,190,0,10,346,356,180,407,587,943,41,253,AZ - Flagstaff
55,2005-2006,2005-11-27,2006-04-06,131,0,6,377,383,61,47,108,491,15,101,AZ - Flagstaff
56,2006-2007,2006-11-28,2007-05-05,159,0,20,378,398,76,166,242,640,33,175,AZ - Flagstaff
57,2007-2008,2007-12-01,2008-05-23,175,0,19,445,464,138,476,614,1078,30,213,AZ - Flagstaff
58,2008-2009,2008-11-09,2009-04-16,159,0,9,352,361,122,441,563,924,26,190,AZ - Flagstaff
59,2009-2010,2009-10-28,2010-05-02,187,0,17,484,501,184,839,1023,1524,35,263,AZ - Flagstaff
60,2010-2011,2010-11-21,2011-05-19,180,8,20,388,408,125,262,387,795,23,174,AZ - Flagstaff
61,2011-2012,2011-11-05,2012-04-26,174,0,14,391,405,140,266,406,811,25,205,AZ - Flagstaff
62,2012-2013,2012-11-09,2013-04-09,152,0,31,446,477,97,321,418,895,23,177,AZ - Flagstaff
63,2013-2014,2013-10-10,2014-05-08,211,0,7,400,407,63,151,214,621,21,107,AZ - Flagstaff
64,2014-2015,2014-12-01,2015-05-15,166,0,8,266,274,92,118,210,484,21,133,AZ - Flagstaff
65,2015-2016,2015-11-04,2016-05-01,180,0,18,446,464,106,369,475,939,23,160,AZ - Flagstaff
66,2016-2017,2016-11-27,2017-05-18,173,0,17,289,306,134,243,377,683,26,192,AZ - Flagstaff
67,2017-2018,2017-12-01,2018-05-02,153,0,4,311,315,52,66,118,433,15,85,AZ - Flagstaff
68,2018-2019,2018-10-07,2019-05-23,229,0,20,442,462,161,260,421,883,37,260,AZ - Flagstaff
69,2019-2020,2019-11-20,2020-04-09,142,5,10,329,339,97,225,322,661,23,147,AZ - Flagstaff
0,1950-1951,1950-12-01,1951-02-28,90,0,0,7,7,0,0,0,7,0,0,AZ - Grand Canyon (Phantom Ranch)
1,1951-1952,1951-12-01,1952-02-29,91,0,0,22,22,0,0,0,22,0,0,AZ - Grand Canyon (Phantom Ranch)
2,1952-1953,1952-12-01,1953-02-28,90,0,0,15,15,0,0,0,15,0,0,AZ - Grand Canyon (Phantom Ranch)
4,1954-1955,1954-12-01,1955-02-28,90,16,0,35,35,0,0,0,35,0,0,AZ - Grand Canyon (Phantom Ranch)
5,1955-1956,1955-12-01,1956-02-29,91,12,0,3,3,0,0,0,3,0,0,AZ - Grand Canyon (Phantom Ranch)
7,1957-1958,1957-12-01,1958-02-28,90,16,0,1,1,0,0,0,1,0,0,AZ - Grand Canyon (Phantom Ranch)
10,1960-1961,1960-12-01,1961-02-28,90,3,0,25,25,3,2,5,30,1,4,AZ - Grand Canyon (Phantom Ranch)
11,1961-1962,1961-12-01,1962-02-28,90,3,0,36,36,0,0,0,36,0,0,AZ - Grand Canyon (Phantom Ranch)
12,1962-1963,1962-12-01,1963-02-28,90,2,0,29,29,0,0,0,29,0,0,AZ - Grand Canyon (Phantom Ranch)
13,1963-1964,1963-12-01,1964-02-29,91,0,0,55,55,0,0,0,55,0,0,AZ - Grand Canyon (Phantom Ranch)
16,1966-1967,1966-12-01,1967-02-28,90,0,0,14,14,0,0,0,14,0,0,AZ - Grand Canyon (Phantom Ranch)
18,1968-1969,1968-12-01,1969-02-28,90,20,0,23,23,0,0,0,23,0,0,AZ - Grand Canyon (Phantom Ranch)
22,1972-1973,1972-12-01,1973-02-28,90,0,0,12,12,3,0,3,15,1,4,AZ - Grand Canyon (Phantom Ranch)
24,1974-1975,1974-12-01,1975-02-28,90,4,0,12,12,0,0,0,12,0,0,AZ - Grand Canyon (Phantom Ranch)
25,1975-1976,1975-12-01,1976-02-29,91,0,0,12,12,0,0,0,12,0,0,AZ - Grand Canyon (Phantom Ranch)
26,1976-1977,1976-12-01,1977-02-28,90,0,0,15,15,0,0,0,15,0,0,AZ - Grand Canyon (Phantom Ranch)
27,1977-1978,1977-12-01,1978-02-28,90,4,0,0,0,0,0,0,0,0,0,AZ - Grand Canyon (Phantom Ranch)
28,1978-1979,1978-12-01,1979-02-28,90,1,0,36,36,2,1,3,39,1,3,AZ - Grand Canyon (Phantom Ranch)
29,1979-1980,1979-12-01,1980-02-29,91,0,0,0,0,0,0,0,0,0,0,AZ - Grand Canyon (Phantom Ranch)
30,1980-1981,1980-12-01,1981-02-28,90,0,0,2,2,0,0,0,2,0,0,AZ - Grand Canyon (Phantom Ranch)
31,1981-1982,1981-12-01,1982-02-28,90,3,0,6,6,0,0,0,6,0,0,AZ - Grand Canyon (Phantom Ranch)
32,1982-1983,1982-12-01,1983-02-28,90,3,0,6,6,0,0,0,6,0,0,AZ - Grand Canyon (Phantom Ranch)
35,1985-1986,1985-12-01,1986-02-28,90,0,0,11,11,0,0,0,11,0,0,AZ - Grand Canyon (Phantom Ranch)
36,1986-1987,1986-12-01,1987-02-28,90,4,0,28,28,0,0,0,28,0,0,AZ - Grand Canyon (Phantom Ranch)
37,1987-1988,1987-12-01,1988-02-29,91,4,0,15,15,1,1,2,17,1,2,AZ - Grand Canyon (Phantom Ranch)
38,1988-1989,1988-12-01,1989-02-28,90,6,1,28,29,0,0,0,29,0,0,AZ - Grand Canyon (Phantom Ranch)
39,1989-1990,1989-12-01,1990-02-28,90,3,0,10,10,0,0,0,10,0,0,AZ - Grand Canyon (Phantom Ranch)
40,1990-1991,1990-12-01,1991-02-28,90,2,0,25,25,0,0,0,25,0,0,AZ - Grand Canyon (Phantom Ranch)
41,1991-1992,1991-12-01,1992-02-29,91,0,0,4,4,0,0,0,4,0,0,AZ - Grand Canyon (Phantom Ranch)
42,1992-1993,1992-12-01,1993-02-28,90,0,0,13,13,0,0,0,13,0,0,AZ - Grand Canyon (Phantom Ranch)
43,1993-1994,1993-12-01,1994-02-28,90,2,0,5,5,0,0,0,5,0,0,AZ - Grand Canyon (Phantom Ranch)
44,1994-1995,1994-12-01,1995-02-28,90,5,0,1,1,0,0,0,1,0,0,AZ - Grand Canyon (Phantom Ranch)
45,1995-1996,1995-12-01,1996-02-29,91,11,0,3,3,0,0,0,3,0,0,AZ - Grand Canyon (Phantom Ranch)
46,1996-1997,1996-12-01,1997-02-28,90,2,0,4,4,0,0,0,4,0,0,AZ - Grand Canyon (Phantom Ranch)
47,1997-1998,1997-12-01,1998-02-28,90,5,0,8,8,0,0,0,8,0,0,AZ - Grand Canyon (Phantom Ranch)
48,1998-1999,1998-12-01,1999-02-28,90,16,0,23,23,0,0,0,23,0,0,AZ - Grand Canyon (Phantom Ranch)
49,1999-2000,1999-12-01,2000-02-29,91,2,0,12,12,0,0,0,12,0,0,AZ - Grand Canyon (Phantom Ranch)
50,2000-2001,2000-12-01,2001-02-28,90,17,0,10,10,0,0,0,10,0,0,AZ - Grand Canyon (Phantom Ranch)
51,2001-2002,2001-12-01,2002-02-28,90,11,0,23,23,0,0,0,23,0,0,AZ - Grand Canyon (Phantom Ranch)
52,2002-2003,2002-12-01,2003-02-28,90,16,0,9,9,0,0,0,9,0,0,AZ - Grand Canyon (Phantom Ranch)
53,2003-2004,2003-12-01,2004-02-29,91,7,0,15,15,0,0,0,15,0,0,AZ - Grand Canyon (Phantom Ranch)
54,2004-2005,2004-12-01,2005-02-28,90,11,0,6,6,0,0,0,6,0,0,AZ - Grand Canyon (Phantom Ranch)
57,2007-2008,2007-12-01,2008-02-29,91,6,0,21,21,0,0,0,21,0,0,AZ - Grand Canyon (Phantom Ranch)
59,2009-2010,2009-12-01,2010-02-28,90,12,0,14,14,0,0,0,14,0,0,AZ - Grand Canyon (Phantom Ranch)
62,2012-2013,2012-12-01,2013-02-28,90,4,0,27,27,0,0,0,27,0,0,AZ - Grand Canyon (Phantom Ranch)
63,2013-2014,2013-12-01,2014-02-28,90,0,0,31,31,0,0,0,31,0,0,AZ - Grand Canyon (Phantom Ranch)
64,2014-2015,2014-12-01,2015-02-28,90,0,0,12,12,2,1,3,15,2,4,AZ - Grand Canyon (Phantom Ranch)
65,2015-2016,2015-12-01,2016-02-29,91,0,0,23,23,0,0,0,23,0,0,AZ - Grand Canyon (Phantom Ranch)
66,2016-2017,2016-12-01,2017-02-28,90,0,0,11,11,0,0,0,11,0,0,AZ - Grand Canyon (Phantom Ranch)
67,2017-2018,2017-12-01,2018-02-28,90,0,0,11,11,0,0,0,11,0,0,AZ - Grand Canyon (Phantom Ranch)
68,2018-2019,2018-12-01,2019-02-28,90,0,0,16,16,1,0,1,17,1,2,AZ - Grand Canyon (Phantom Ranch)
69,2019-2020,2019-11-29,2020-02-29,93,5,0,20,20,1,0,1,21,1,2,AZ - Grand Canyon (Phantom Ranch)
0,1950-1951,1950-12-01,1951-05-14,165,7,9,448,457,165,233,398,855,20,212,AZ - Mc Nary
3,1953-1954,1953-11-19,1954-05-01,164,18,8,400,408,105,139,244,652,17,161,AZ - Mc Nary
4,1954-1955,1954-11-03,1955-03-22,140,1,20,463,483,80,172,252,735,19,165,AZ - Mc Nary
5,1955-1956,1955-11-15,1956-04-15,153,10,13,411,424,116,275,391,815,23,182,AZ - Mc Nary
6,1956-1957,1956-10-29,1957-04-24,178,5,4,394,398,75,102,177,575,18,125,AZ - Mc Nary
11,1961-1962,1961-10-29,1962-03-26,149,18,21,399,420,266,587,853,1273,42,390,AZ - Mc Nary
12,1962-1963,1962-12-01,1963-03-20,110,3,14,301,315,117,199,316,631,18,177,AZ - Mc Nary
13,1963-1964,1963-11-08,1964-04-29,174,9,22,497,519,127,179,306,825,22,194,AZ - Mc Nary
14,1964-1965,1964-11-14,1965-04-13,151,2,20,354,374,218,382,600,974,32,292,AZ - Mc Nary
15,1965-1966,1965-12-01,1966-03-05,95,1,21,324,345,176,304,480,825,27,267,AZ - Mc Nary
16,1966-1967,1966-12-01,1967-04-13,134,6,8,324,332,49,46,95,427,11,98,AZ - Mc Nary
17,1967-1968,1967-11-29,1968-04-23,147,2,11,348,359,155,577,732,1091,21,210,AZ - Mc Nary
18,1968-1969,1968-11-13,1969-05-08,177,2,16,438,454,170,349,519,973,29,280,AZ - Mc Nary
19,1969-1970,1969-12-01,1970-05-01,152,1,9,344,353,85,113,198,551,22,144,AZ - Mc Nary
20,1970-1971,1970-12-01,1971-04-22,143,0,20,345,365,84,188,272,637,16,136,AZ - Mc Nary
21,1971-1972,1971-10-17,1972-04-14,181,0,8,387,395,121,200,321,716,20,168,AZ - Mc Nary
22,1972-1973,1972-10-30,1973-04-21,174,7,16,470,486,284,519,803,1289,56,436,AZ - Mc Nary
23,1973-1974,1973-11-19,1974-04-03,136,3,15,344,359,147,281,428,787,30,239,AZ - Mc Nary
24,1974-1975,1974-10-29,1975-04-18,172,7,19,414,433,239,366,605,1038,44,373,AZ - Mc Nary
25,1975-1976,1975-11-02,1976-04-20,171,15,7,396,403,150,217,367,770,26,234,AZ - Mc Nary
26,1976-1977,1976-11-13,1977-05-14,183,17,12,428,440,125,212,337,777,21,184,AZ - Mc Nary
27,1977-1978,1977-11-08,1978-05-06,180,14,7,277,284,116,233,349,633,29,176,AZ - Mc Nary
31,1981-1982,1981-11-29,1982-04-02,125,11,6,260,266,110,364,474,740,20,144,AZ - Mc Nary
38,1988-1989,1988-11-15,1989-03-28,134,4,18,340,358,88,220,308,666,31,184,AZ - Mc Nary
39,1989-1990,1989-11-29,1990-05-29,182,1,18,365,383,82,208,290,673,30,179,AZ - Mc Nary
40,1990-1991,1990-11-03,1991-04-14,163,1,14,370,384,150,436,586,970,35,253,AZ - Mc Nary
41,1991-1992,1991-10-28,1992-04-02,158,3,12,337,349,141,404,545,894,38,220,AZ - Mc Nary
42,1992-1993,1992-11-11,1993-04-07,148,5,18,303,321,142,436,578,899,42,254,AZ - Mc Nary
43,1993-1994,1993-11-13,1994-04-29,168,2,10,316,326,89,246,335,661,27,143,AZ - Mc Nary
44,1994-1995,1994-10-16,1995-05-17,214,6,8,313,321,110,276,386,707,32,179,AZ - Mc Nary
45,1995-1996,1995-11-02,1996-04-05,156,2,4,265,269,51,150,201,470,20,110,AZ - Mc Nary
46,1996-1997,1996-10-26,1997-04-12,169,0,19,325,344,146,440,586,930,33,235,AZ - Mc Nary
47,1997-1998,1997-10-25,1998-04-17,175,7,22,354,376,147,395,542,918,54,284,AZ - Mc Nary
48,1998-1999,1998-11-29,1999-05-02,155,7,9,266,275,65,111,176,451,21,113,AZ - Mc Nary
49,1999-2000,1999-12-01,2000-04-02,124,5,10,235,245,41,70,111,356,15,78,AZ - Mc Nary
50,2000-2001,2000-10-28,2001-05-05,190,5,14,344,358,134,317,451,809,39,227,AZ - Mc Nary
51,2001-2002,2001-11-23,2002-04-08,137,0,10,313,323,53,110,163,486,20,111,AZ - Mc Nary
52,2002-2003,2002-12-01,2003-04-23,144,8,9,244,253,113,258,371,624,30,179,AZ - Mc Nary
53,2003-2004,2003-12-01,2004-04-12,134,1,14,253,267,75,175,250,517,31,151,AZ - Mc Nary
54,2004-2005,2004-10-22,2005-04-11,172,0,12,273,285,108,189,297,582,40,182,AZ - Mc Nary
55,2005-2006,2005-11-28,2006-04-28,152,1,6,265,271,77,124,201,472,16,122,AZ - Mc Nary
56,2006-2007,2006-11-28,2007-03-30,123,3,19,305,324,78,240,318,642,28,165,AZ - Mc Nary
57,2007-2008,2007-12-01,2008-05-25,177,6,16,339,355,110,480,590,945,30,200,AZ - Mc Nary
58,2008-2009,2008-11-10,2009-04-12,154,8,12,299,311,122,485,607,918,35,202,AZ - Mc Nary
59,2009-2010,2009-10-28,2010-05-03,188,2,14,418,432,168,772,940,1372,42,261,AZ - Mc Nary
61,2011-2012,2011-10-07,2012-04-16,193,0,14,347,361,126,326,452,813,34,207,AZ - Mc Nary
62,2012-2013,2012-11-10,2013-04-18,160,2,28,396,424,98,351,449,873,29,203,AZ - Mc Nary
63,2013-2014,2013-11-05,2014-04-03,150,0,6,259,265,32,41,73,338,14,65,AZ - Mc Nary
64,2014-2015,2014-11-16,2015-05-16,182,0,7,261,268,39,41,80,348,20,89,AZ - Mc Nary
65,2015-2016,2015-10-30,2016-05-01,185,2,18,368,386,80,293,373,759,28,158,AZ - Mc Nary
66,2016-2017,2016-11-28,2017-04-29,153,0,11,221,232,65,157,222,454,22,112,AZ - Mc Nary
67,2017-2018,2017-12-01,2018-05-02,153,0,3,224,227,34,47,81,308,15,68,AZ - Mc Nary
68,2018-2019,2018-10-08,2019-05-24,229,0,18,345,363,129,287,416,779,38,232,AZ - Mc Nary
69,2019-2020,2019-11-21,2020-04-14,146,0,12,257,269,91,215,306,575,27,148,AZ - Mc Nary
0,1950-1951,1950-12-01,1951-03-03,93,0,1,91,92,36,19,55,147,10,52,AZ - Payson
1,1951-1952,1951-12-01,1952-03-17,108,0,0,136,136,28,11,39,175,12,44,AZ - Payson
2,1952-1953,1952-11-16,1953-03-02,107,0,0,197,197,44,35,79,276,8,52,AZ - Payson
3,1953-1954,1953-11-18,1954-03-25,128,0,0,226,226,36,14,50,276,7,45,AZ - Payson
4,1954-1955,1954-12-01,1955-02-28,90,0,0,233,233,18,19,37,270,5,28,AZ - Payson
5,1955-1956,1955-12-01,1956-02-29,91,0,0,172,172,10,7,17,189,1,11,AZ - Payson
6,1956-1957,1956-12-01,1957-02-28,90,0,0,110,110,14,8,22,132,4,18,AZ - Payson
7,1957-1958,1957-12-01,1958-03-12,102,0,0,154,154,5,2,7,161,3,10,AZ - Payson
8,1958-1959,1958-11-16,1959-02-28,105,0,0,188,188,12,8,20,208,3,19,AZ - Payson
12,1962-1963,1962-12-01,1963-03-18,108,2,1,166,167,25,0,25,192,6,32,AZ - Payson
13,1963-1964,1963-11-21,1964-04-03,135,1,0,286,286,16,0,16,302,4,20,AZ - Payson
14,1964-1965,1964-11-15,1965-04-04,141,0,0,191,191,50,31,81,272,10,69,AZ - Payson
16,1966-1967,1966-11-09,1967-04-12,155,7,0,226,226,23,3,26,252,7,37,AZ - Payson
17,1967-1968,1967-11-29,1968-04-22,146,0,1,192,193,123,293,416,609,15,153,AZ - Payson
18,1968-1969,1968-12-01,1969-03-14,104,1,0,193,193,54,52,106,299,12,72,AZ - Payson
19,1969-1970,1969-12-01,1970-03-11,101,1,0,161,161,4,3,7,168,1,5,AZ - Payson
20,1970-1971,1970-12-01,1971-04-18,139,1,4,223,227,21,26,47,274,6,32,AZ - Payson
21,1971-1972,1971-10-29,1972-02-29,124,0,0,222,222,23,30,53,275,5,31,AZ - Payson
23,1973-1974,1973-11-19,1974-02-28,102,2,0,178,178,27,12,39,217,8,36,AZ - Payson
24,1974-1975,1974-12-01,1975-04-18,139,7,0,232,232,88,35,123,355,20,126,AZ - Payson
25,1975-1976,1975-11-28,1976-04-17,142,0,0,199,199,46,36,82,281,8,56,AZ - Payson
26,1976-1977,1976-12-01,1977-04-03,124,0,0,226,226,34,24,58,284,9,50,AZ - Payson
27,1977-1978,1977-12-01,1978-04-08,129,0,0,113,113,24,6,30,143,7,31,AZ - Payson
28,1978-1979,1978-11-15,1979-03-22,128,1,2,209,211,74,91,165,376,16,101,AZ - Payson
29,1979-1980,1979-12-01,1980-03-31,122,16,0,126,126,10,0,10,136,3,13,AZ - Payson
30,1980-1981,1980-12-01,1981-03-06,96,0,0,115,115,13,7,20,135,3,15,AZ - Payson
35,1985-1986,1985-11-13,1986-03-18,126,7,0,126,126,55,39,94,220,10,68,AZ - Payson
37,1987-1988,1987-12-01,1988-02-29,91,19,2,131,133,42,47,89,222,5,55,AZ - Payson
38,1988-1989,1988-11-26,1989-03-26,121,11,0,232,232,28,11,39,271,7,39,AZ - Payson
41,1991-1992,1991-11-30,1992-03-09,101,14,0,109,109,44,51,95,204,6,52,AZ - Payson
45,1995-1996,1995-12-01,1996-02-29,91,20,0,111,111,22,14,36,147,4,32,AZ - Payson
49,1999-2000,1999-12-01,2000-02-29,91,20,0,126,126,6,7,13,139,1,8,AZ - Payson
53,2003-2004,2003-12-01,2004-02-29,91,18,0,130,130,3,0,3,133,1,4,AZ - Payson
54,2004-2005,2004-12-01,2005-02-28,90,16,0,73,73,21,10,31,104,5,26,AZ - Payson
62,2012-2013,2012-11-11,2013-03-09,119,0,0,195,195,45,23,68,263,11,61,AZ - Payson
63,2013-2014,2013-12-01,2014-02-28,90,0,0,135,135,4,0,4,139,2,6,AZ - Payson
64,2014-2015,2014-12-01,2015-02-28,90,0,0,98,98,16,21,37,135,2,19,AZ - Payson
65,2015-2016,2015-11-16,2016-02-29,106,0,0,168,168,46,34,80,248,13,68,AZ - Payson
66,2016-2017,2016-11-28,2017-02-28,93,0,0,91,91,16,5,21,112,4,19,AZ - Payson
67,2017-2018,2017-12-01,2018-02-28,90,0,0,126,126,6,4,10,136,3,13,AZ - Payson
68,2018-2019,2018-12-01,2019-03-13,103,0,1,138,139,62,63,125,264,8,81,AZ - Payson
69,2019-2020,2019-11-29,2020-02-29,93,5,0,124,124,18,7,25,149,6,25,AZ - Payson
0,1950-1951,1950-12-01,1951-02-28,90,0,0,3,3,0,0,0,3,0,0,AZ - Phoenix
1,1951-1952,1951-12-01,1952-02-29,91,0,0,9,9,0,0,0,9,0,0,AZ - Phoenix
2,1952-1953,1952-12-01,1953-02-28,90,0,0,1,1,0,0,0,1,0,0,AZ - Phoenix
3,1953-1954,1953-12-01,1954-02-28,90,0,0,17,17,0,0,0,17,0,0,AZ - Phoenix
4,1954-1955,1954-12-01,1955-02-28,90,0,0,20,20,0,0,0,20,0,0,AZ - Phoenix
5,1955-1956,1955-12-01,1956-02-29,91,0,0,4,4,0,0,0,4,0,0,AZ - Phoenix
6,1956-1957,1956-12-01,1957-02-28,90,0,0,3,3,0,0,0,3,0,0,AZ - Phoenix
7,1957-1958,1957-12-01,1958-02-28,90,0,0,2,2,0,0,0,2,0,0,AZ - Phoenix
8,1958-1959,1958-12-01,1959-02-28,90,0,0,2,2,0,0,0,2,0,0,AZ - Phoenix
9,1959-1960,1959-12-01,1960-02-29,91,0,0,10,10,0,0,0,10,0,0,AZ - Phoenix
10,1960-1961,1960-12-01,1961-02-28,90,0,0,10,10,0,0,0,10,0,0,AZ - Phoenix
11,1961-1962,1961-12-01,1962-02-28,90,0,0,9,9,0,0,0,9,0,0,AZ - Phoenix
12,1962-1963,1962-12-01,1963-02-28,90,0,0,14,14,0,0,0,14,0,0,AZ - Phoenix
13,1963-1964,1963-12-01,1964-02-29,91,0,0,42,42,0,0,0,42,0,0,AZ - Phoenix
14,1964-1965,1964-12-01,1965-02-28,90,0,0,7,7,0,0,0,7,0,0,AZ - Phoenix
15,1965-1966,1965-12-01,1966-02-28,90,0,0,18,18,0,0,0,18,0,0,AZ - Phoenix
16,1966-1967,1966-12-01,1967-02-28,90,0,0,23,23,0,0,0,23,0,0,AZ - Phoenix
17,1967-1968,1967-12-01,1968-02-29,91,0,0,10,10,0,0,0,10,0,0,AZ - Phoenix
18,1968-1969,1968-12-01,1969-02-28,90,0,0,13,13,0,0,0,13,0,0,AZ - Phoenix
19,1969-1970,1969-12-01,1970-02-28,90,0,0,11,11,0,0,0,11,0,0,AZ - Phoenix
20,1970-1971,1970-12-01,1971-02-28,90,0,0,15,15,0,0,0,15,0,0,AZ - Phoenix
21,1971-1972,1971-12-01,1972-02-29,91,0,0,16,16,0,0,0,16,0,0,AZ - Phoenix
22,1972-1973,1972-12-01,1973-02-28,90,0,0,5,5,0,0,0,5,0,0,AZ - Phoenix
23,1973-1974,1973-12-01,1974-02-28,90,0,0,2,2,0,0,0,2,0,0,AZ - Phoenix
24,1974-1975,1974-12-01,1975-02-28,90,0,0,11,11,0,0,0,11,0,0,AZ - Phoenix
25,1975-1976,1975-12-01,1976-02-29,91,0,0,4,4,0,0,0,4,0,0,AZ - Phoenix
26,1976-1977,1976-12-01,1977-02-28,90,0,0,4,4,0,0,0,4,0,0,AZ - Phoenix
27,1977-1978,1977-12-01,1978-02-28,90,0,0,0,0,0,0,0,0,0,0,AZ - Phoenix
28,1978-1979,1978-12-01,1979-02-28,90,0,0,7,7,0,0,0,7,0,0,AZ - Phoenix
29,1979-1980,1979-12-01,1980-02-29,91,0,0,0,0,0,0,0,0,0,0,AZ - Phoenix
30,1980-1981,1980-12-01,1981-02-28,90,0,0,0,0,0,0,0,0,0,0,AZ - Phoenix
31,1981-1982,1981-12-01,1982-02-28,90,0,0,0,0,0,0,0,0,0,0,AZ - Phoenix
32,1982-1983,1982-12-01,1983-02-28,90,0,0,0,0,0,0,0,0,0,0,AZ - Phoenix
33,1983-1984,1983-12-01,1984-02-29,91,0,0,0,0,0,0,0,0,0,0,AZ - Phoenix
34,1984-1985,1984-12-01,1985-02-28,90,0,0,3,3,0,0,0,3,0,0,AZ - Phoenix
35,1985-1986,1985-12-01,1986-02-28,90,0,0,0,0,1,0,1,1,1,1,AZ - Phoenix
36,1986-1987,1986-12-01,1987-02-28,90,0,0,3,3,0,0,0,3,0,0,AZ - Phoenix
37,1987-1988,1987-12-01,1988-02-29,91,0,0,2,2,0,0,0,2,0,0,AZ - Phoenix
38,1988-1989,1988-12-01,1989-02-28,90,0,0,4,4,0,0,0,4,0,0,AZ - Phoenix
39,1989-1990,1989-12-01,1990-02-28,90,0,0,2,2,0,0,0,2,0,0,AZ - Phoenix
40,1990-1991,1990-12-01,1991-02-28,90,0,0,2,2,2,0,2,4,2,2,AZ - Phoenix
41,1991-1992,1991-12-01,1992-02-29,91,0,0,0,0,0,0,0,0,0,0,AZ - Phoenix
42,1992-1993,1992-12-01,1993-02-28,90,0,0,0,0,0,0,0,0,0,0,AZ - Phoenix
43,1993-1994,1993-12-01,1994-02-28,90,0,0,0,0,0,0,0,0,0,0,AZ - Phoenix
44,1994-1995,1994-12-01,1995-02-28,90,0,0,0,0,0,0,0,0,0,0,AZ - Phoenix
45,1995-1996,1995-12-01,1996-02-29,91,0,0,0,0,0,0,0,0,0,0,AZ - Phoenix
46,1996-1997,1996-12-01,1997-02-28,90,0,0,0,0,0,0,0,0,0,0,AZ - Phoenix
47,1997-1998,1997-12-01,1998-02-28,90,0,0,0,0,0,0,0,0,0,0,AZ - Phoenix
48,1998-1999,1998-12-01,1999-02-28,90,0,0,1,1,0,0,0,1,0,0,AZ - Phoenix
49,1999-2000,1999-12-01,2000-02-29,91,0,0,1,1,0,0,0,1,0,0,AZ - Phoenix
50,2000-2001,2000-12-01,2001-02-28,90,0,0,0,0,0,0,0,0,0,0,AZ - Phoenix
51,2001-2002,2001-12-01,2002-02-28,90,0,0,0,0,0,0,0,0,0,0,AZ - Phoenix
52,2002-2003,2002-12-01,2003-02-28,90,0,0,0,0,0,0,0,0,0,0,AZ - Phoenix
53,2003-2004,2003-12-01,2004-02-29,91,0,0,2,2,0,0,0,2,0,0,AZ - Phoenix
54,2004-2005,2004-12-01,2005-02-28,90,0,0,0,0,0,0,0,0,0,0,AZ - Phoenix
55,2005-2006,2005-12-01,2006-02-28,90,1,0,0,0,0,0,0,0,0,0,AZ - Phoenix
56,2006-2007,2006-12-01,2007-02-28,90,12,0,2,2,0,0,0,2,0,0,AZ - Phoenix
57,2007-2008,2007-12-01,2008-02-29,91,8,0,0,0,0,0,0,0,0,0,AZ - Phoenix
58,2008-2009,2008-12-01,2009-02-28,90,8,0,0,0,0,0,0,0,0,0,AZ - Phoenix
59,2009-2010,2009-12-01,2010-02-28,90,5,0,0,0,0,0,0,0,0,0,AZ - Phoenix
60,2010-2011,2010-12-01,2011-02-28,90,4,0,5,5,0,0,0,5,0,0,AZ - Phoenix
61,2011-2012,2011-12-01,2012-02-29,91,8,0,0,0,0,0,0,0,0,0,AZ - Phoenix
62,2012-2013,2012-12-01,2013-02-28,90,0,0,4,4,0,0,0,4,0,0,AZ - Phoenix
63,2013-2014,2013-12-01,2014-02-28,90,0,0,0,0,0,0,0,0,0,0,AZ - Phoenix
64,2014-2015,2014-12-01,2015-02-28,90,1,0,1,1,0,0,0,1,0,0,AZ - Phoenix
65,2015-2016,2015-12-01,2016-02-29,91,4,0,0,0,0,0,0,0,0,0,AZ - Phoenix
66,2016-2017,2016-12-01,2017-02-28,90,7,0,0,0,0,0,0,0,0,0,AZ - Phoenix
67,2017-2018,2017-12-01,2018-02-28,90,0,0,0,0,0,0,0,0,0,0,AZ - Phoenix
68,2018-2019,2018-12-01,2019-02-28,90,4,0,1,1,0,0,0,1,0,0,AZ - Phoenix
1,1951-1952,1951-11-24,1952-03-17,115,3,0,220,220,66,36,102,322,14,88,AZ - Prescott
2,1952-1953,1952-11-16,1953-03-02,107,0,0,215,215,31,23,54,269,7,39,AZ - Prescott
3,1953-1954,1953-12-01,1954-03-25,115,2,0,217,217,40,19,59,276,7,49,AZ - Prescott
4,1954-1955,1954-12-01,1955-02-28,90,2,3,228,231,29,39,68,299,8,45,AZ - Prescott
5,1955-1956,1955-12-01,1956-02-29,91,1,0,145,145,12,1,13,158,6,22,AZ - Prescott
6,1956-1957,1956-12-01,1957-02-28,90,1,1,140,141,12,32,44,185,3,19,AZ - Prescott
7,1957-1958,1957-11-16,1958-02-28,105,18,0,186,186,4,0,4,190,2,5,AZ - Prescott
8,1958-1959,1958-11-16,1959-02-28,105,19,1,195,196,14,0,14,210,2,16,AZ - Prescott
12,1962-1963,1962-12-01,1963-04-17,138,2,2,212,214,17,11,28,242,4,21,AZ - Prescott
13,1963-1964,1963-12-01,1964-04-03,125,7,0,300,300,32,23,55,355,6,43,AZ - Prescott
14,1964-1965,1964-11-15,1965-04-12,149,5,3,257,260,49,37,86,346,10,65,AZ - Prescott
15,1965-1966,1965-12-01,1966-03-03,93,6,1,202,203,39,18,57,260,11,54,AZ - Prescott
16,1966-1967,1966-11-09,1967-04-13,156,0,1,284,285,23,17,40,325,8,47,AZ - Prescott
17,1967-1968,1967-12-01,1968-04-22,144,6,5,260,265,75,334,409,674,16,108,AZ - Prescott
18,1968-1969,1968-11-16,1969-03-14,119,2,3,241,244,56,70,126,370,15,88,AZ - Prescott
19,1969-1970,1969-12-01,1970-04-29,150,0,0,226,226,16,5,21,247,9,32,AZ - Prescott
20,1970-1971,1970-12-01,1971-04-19,140,0,7,232,239,23,20,43,282,12,47,AZ - Prescott
21,1971-1972,1971-10-17,1972-02-29,136,0,1,263,264,22,29,51,315,10,49,AZ - Prescott
22,1972-1973,1972-10-31,1973-05-06,188,0,1,294,295,93,75,168,463,35,145,AZ - Prescott
23,1973-1974,1973-11-19,1974-03-10,112,0,1,225,226,43,38,81,307,15,71,AZ - Prescott
24,1974-1975,1974-10-30,1975-04-18,171,0,1,289,290,41,26,67,357,23,89,AZ - Prescott
25,1975-1976,1975-11-28,1976-04-17,142,1,3,228,231,35,46,81,312,11,53,AZ - Prescott
26,1976-1977,1976-12-01,1977-04-04,125,0,0,257,257,36,32,68,325,11,57,AZ - Prescott
27,1977-1978,1977-12-01,1978-05-01,152,0,0,138,138,42,23,65,203,15,61,AZ - Prescott
28,1978-1979,1978-11-12,1979-04-03,143,0,7,283,290,75,113,188,478,23,115,AZ - Prescott
29,1979-1980,1979-11-20,1980-04-24,157,0,0,190,190,25,12,37,227,10,36,AZ - Prescott
30,1980-1981,1980-10-15,1981-04-03,171,0,0,212,212,29,15,44,256,8,37,AZ - Prescott
31,1981-1982,1981-12-01,1982-04-02,123,0,1,190,191,44,39,83,274,13,74,AZ - Prescott
32,1982-1983,1982-11-11,1983-02-28,110,0,2,174,176,24,25,49,225,9,45,AZ - Prescott
36,1986-1987,1986-12-01,1987-03-24,114,10,4,185,189,67,83,150,339,11,88,AZ - Prescott
37,1987-1988,1987-12-01,1988-04-22,144,5,6,204,210,30,70,100,310,8,56,AZ - Prescott
38,1988-1989,1988-11-25,1989-02-28,96,12,1,193,194,5,0,5,199,3,11,AZ - Prescott
41,1991-1992,1991-11-30,1992-03-09,101,11,1,144,145,20,22,42,187,3,23,AZ - Prescott
42,1992-1993,1992-12-01,1993-02-28,90,4,1,128,129,5,0,5,134,3,10,AZ - Prescott
43,1993-1994,1993-11-14,1994-04-27,165,20,0,199,199,10,1,11,210,3,14,AZ - Prescott
45,1995-1996,1995-12-01,1996-03-13,104,16,1,138,139,4,6,10,149,2,7,AZ - Prescott
56,2006-2007,2006-11-30,2007-02-28,91,20,1,142,143,4,0,4,147,3,8,AZ - Prescott
57,2007-2008,2007-12-01,2008-02-29,91,11,0,175,175,1,3,4,179,1,2,AZ - Prescott
58,2008-2009,2008-12-01,2009-02-28,90,2,0,155,155,0,0,0,155,0,0,AZ - Prescott
61,2011-2012,2011-11-05,2012-04-14,162,0,0,247,247,31,25,56,303,12,50,AZ - Prescott
62,2012-2013,2012-12-01,2013-03-09,99,0,3,221,224,17,14,31,255,10,37,AZ - Prescott
63,2013-2014,2013-12-01,2014-04-03,124,0,0,173,173,2,1,3,176,2,7,AZ - Prescott
64,2014-2015,2014-12-01,2015-02-28,90,0,1,109,110,8,4,12,122,3,13,AZ - Prescott
65,2015-2016,2015-11-05,2016-04-26,174,0,1,232,233,18,10,28,261,13,38,AZ - Prescott
66,2016-2017,2016-12-01,2017-02-28,90,0,0,114,114,18,18,36,150,7,29,AZ - Prescott
67,2017-2018,2017-12-01,2018-03-01,91,4,0,147,147,8,2,10,157,5,19,AZ - Prescott
68,2018-2019,2018-12-01,2019-03-14,104,0,3,182,185,45,46,91,276,9,71,AZ - Prescott
69,2019-2020,2019-11-22,2020-03-19,119,5,1,177,178,21,13,34,212,7,31,AZ - Prescott
0,1950-1951,1950-12-01,1951-02-28,90,0,0,12,12,4,0,4,16,2,6,AZ - Tucson
1,1951-1952,1951-12-01,1952-03-09,100,0,0,18,18,4,0,4,22,1,4,AZ - Tucson
2,1952-1953,1952-12-01,1953-02-28,90,0,0,22,22,1,0,1,23,1,1,AZ - Tucson
3,1953-1954,1953-12-01,1954-02-28,90,0,0,21,21,0,0,0,21,0,0,AZ - Tucson
4,1954-1955,1954-12-01,1955-02-28,90,0,0,44,44,0,0,0,44,0,0,AZ - Tucson
5,1955-1956,1955-12-01,1956-04-02,124,0,0,13,13,4,0,4,17,2,4,AZ - Tucson
6,1956-1957,1956-12-01,1957-02-28,90,0,0,6,6,0,0,0,6,0,0,AZ - Tucson
7,1957-1958,1957-12-01,1958-02-28,90,0,0,9,9,0,0,0,9,0,0,AZ - Tucson
8,1958-1959,1958-11-16,1959-02-28,105,0,0,19,19,9,1,10,29,1,10,AZ - Tucson
9,1959-1960,1959-12-01,1960-02-29,91,0,0,33,33,3,0,3,36,2,5,AZ - Tucson
10,1960-1961,1960-12-01,1961-02-28,90,0,0,13,13,0,0,0,13,0,0,AZ - Tucson
11,1961-1962,1961-12-01,1962-02-28,90,0,0,12,12,0,0,0,12,0,0,AZ - Tucson
12,1962-1963,1962-12-01,1963-02-28,90,0,0,14,14,0,0,0,14,0,0,AZ - Tucson
13,1963-1964,1963-12-01,1964-04-04,126,1,0,42,42,9,4,13,55,3,10,AZ - Tucson
14,1964-1965,1964-11-15,1965-02-28,106,0,0,19,19,6,4,10,29,3,8,AZ - Tucson
15,1965-1966,1965-12-01,1966-02-28,90,0,0,22,22,3,0,3,25,2,4,AZ - Tucson
16,1966-1967,1966-12-01,1967-02-28,90,0,0,23,23,0,0,0,23,0,0,AZ - Tucson
17,1967-1968,1967-12-01,1968-02-29,91,0,0,10,10,2,0,2,12,1,2,AZ - Tucson
18,1968-1969,1968-12-01,1969-02-28,90,0,0,17,17,2,0,2,19,2,3,AZ - Tucson
19,1969-1970,1969-12-01,1970-02-28,90,0,0,18,18,0,0,0,18,0,0,AZ - Tucson
20,1970-1971,1970-12-01,1971-02-28,90,0,0,28,28,0,0,0,28,0,0,AZ - Tucson
21,1971-1972,1971-12-01,1972-02-29,91,0,0,24,24,9,7,16,40,1,10,AZ - Tucson
22,1972-1973,1972-12-01,1973-02-28,90,0,0,18,18,0,0,0,18,0,0,AZ - Tucson
23,1973-1974,1973-12-01,1974-02-28,90,0,0,19,19,1,0,1,20,1,2,AZ - Tucson
24,1974-1975,1974-12-01,1975-03-11,101,0,0,28,28,1,0,1,29,1,1,AZ - Tucson
25,1975-1976,1975-12-01,1976-04-16,138,0,0,17,17,7,3,10,27,2,7,AZ - Tucson
26,1976-1977,1976-12-01,1977-02-28,90,0,0,8,8,0,0,0,8,0,0,AZ - Tucson
27,1977-1978,1977-12-01,1978-02-28,90,0,0,5,5,0,0,0,5,0,0,AZ - Tucson
28,1978-1979,1978-12-01,1979-02-28,90,0,0,18,18,2,1,3,21,1,3,AZ - Tucson
29,1979-1980,1979-12-01,1980-02-29,91,0,0,2,2,0,0,0,2,0,0,AZ - Tucson
30,1980-1981,1980-12-01,1981-02-28,90,0,0,3,3,0,0,0,3,0,0,AZ - Tucson
31,1981-1982,1981-12-01,1982-02-28,90,0,0,9,9,0,0,0,9,0,0,AZ - Tucson
32,1982-1983,1982-12-01,1983-02-28,90,0,0,8,8,0,0,0,8,0,0,AZ - Tucson
33,1983-1984,1983-12-01,1984-02-29,91,0,0,10,10,0,0,0,10,0,0,AZ - Tucson
34,1984-1985,1984-12-01,1985-02-28,90,0,0,8,8,4,0,4,12,2,5,AZ - Tucson
35,1985-1986,1985-12-01,1986-02-28,90,0,0,10,10,0,0,0,10,0,0,AZ - Tucson
36,1986-1987,1986-12-01,1987-02-28,90,0,0,14,14,7,1,8,22,2,8,AZ - Tucson
37,1987-1988,1987-12-01,1988-02-29,91,0,0,15,15,5,2,7,22,2,7,AZ - Tucson
38,1988-1989,1988-12-01,1989-02-28,90,0,0,22,22,0,0,0,22,0,0,AZ - Tucson
39,1989-1990,1989-12-01,1990-02-28,90,0,0,21,21,8,0,8,29,5,10,AZ - Tucson
40,1990-1991,1990-12-01,1991-03-16,106,0,0,10,10,2,0,2,12,2,3,AZ - Tucson
41,1991-1992,1991-12-01,1992-02-29,91,0,0,6,6,0,0,0,6,0,0,AZ - Tucson
42,1992-1993,1992-12-01,1993-02-28,90,0,0,6,6,0,0,0,6,0,0,AZ - Tucson
43,1993-1994,1993-12-01,1994-02-28,90,0,0,13,13,0,0,0,13,0,0,AZ - Tucson
44,1994-1995,1994-12-01,1995-02-28,90,0,0,2,2,0,0,0,2,0,0,AZ - Tucson
45,1995-1996,1995-12-01,1996-02-29,91,0,0,5,5,0,0,0,5,0,0,AZ - Tucson
46,1996-1997,1996-12-01,1997-02-28,90,0,0,13,13,0,0,0,13,0,0,AZ - Tucson
47,1997-1998,1997-12-01,1998-02-28,90,0,0,11,11,0,0,0,11,0,0,AZ - Tucson
48,1998-1999,1998-12-01,1999-02-28,90,0,0,19,19,0,0,0,19,0,0,AZ - Tucson
49,1999-2000,1999-12-01,2000-02-29,91,0,0,14,14,0,0,0,14,0,0,AZ - Tucson
50,2000-2001,2000-12-01,2001-02-28,90,0,0,8,8,0,0,0,8,0,0,AZ - Tucson
51,2001-2002,2001-12-01,2002-02-28,90,0,0,22,22,1,0,1,23,1,2,AZ - Tucson
52,2002-2003,2002-12-01,2003-02-28,90,0,0,7,7,0,0,0,7,0,0,AZ - Tucson
53,2003-2004,2003-12-01,2004-02-29,91,0,0,16,16,0,0,0,16,0,0,AZ - Tucson
54,2004-2005,2004-12-01,2005-02-28,90,0,0,6,6,0,0,0,6,0,0,AZ - Tucson
55,2005-2006,2005-12-01,2006-02-28,90,0,0,8,8,0,0,0,8,0,0,AZ - Tucson
56,2006-2007,2006-12-01,2007-02-28,90,0,0,20,20,0,0,0,20,0,0,AZ - Tucson
57,2007-2008,2007-12-01,2008-02-29,91,0,0,18,18,0,0,0,18,0,0,AZ - Tucson
58,2008-2009,2008-12-01,2009-02-28,90,0,0,6,6,0,0,0,6,0,0,AZ - Tucson
59,2009-2010,2009-12-01,2010-02-28,90,0,0,5,5,0,0,0,5,0,0,AZ - Tucson
60,2010-2011,2010-12-01,2011-02-28,90,0,0,20,20,0,0,0,20,0,0,AZ - Tucson
61,2011-2012,2011-12-01,2012-02-29,91,0,0,11,11,0,0,0,11,0,0,AZ - Tucson
62,2012-2013,2012-12-01,2013-02-28,90,0,0,28,28,3,0,3,31,1,3,AZ - Tucson
63,2013-2014,2013-12-01,2014-02-28,90,0,0,2,2,0,0,0,2,0,0,AZ - Tucson
64,2014-2015,2014-12-01,2015-02-28,90,0,0,9,9,0,0,0,9,0,0,AZ - Tucson
65,2015-2016,2015-12-01,2016-02-29,91,0,0,14,14,0,0,0,14,0,0,AZ - Tucson
66,2016-2017,2016-12-01,2017-02-28,90,0,0,6,6,0,0,0,6,0,0,AZ - Tucson
67,2017-2018,2017-12-01,2018-02-28,90,0,0,4,4,0,0,0,4,0,0,AZ - Tucson
68,2018-2019,2018-12-01,2019-02-28,90,0,0,14,14,3,0,3,17,2,4,AZ - Tucson
69,2019-2020,2019-12-01,2020-02-29,91,0,0,8,8,0,0,0,8,0,0,AZ - Tucson
0,1950-1951,1950-11-24,1951-03-13,110,0,29,209,238,17,26,43,281,8,54,AR - Fayetteville
1,1951-1952,1951-11-01,1952-02-29,121,1,10,153,163,15,7,22,185,8,31,AR - Fayetteville
2,1952-1953,1952-11-28,1953-02-28,93,0,5,121,126,6,5,11,137,4,18,AR - Fayetteville
3,1953-1954,1953-12-01,1954-03-03,93,0,12,152,164,10,16,26,190,2,24,AR - Fayetteville
4,1954-1955,1954-12-01,1955-03-26,116,0,3,152,155,15,11,26,181,5,27,AR - Fayetteville
5,1955-1956,1955-11-28,1956-02-29,94,0,8,151,159,12,14,26,185,5,23,AR - Fayetteville
6,1956-1957,1956-12-01,1957-04-13,134,0,9,121,130,2,1,3,133,1,4,AR - Fayetteville
7,1957-1958,1957-12-01,1958-03-13,103,0,14,165,179,13,7,20,199,7,28,AR - Fayetteville
8,1958-1959,1958-11-28,1959-02-28,93,0,15,186,201,22,27,49,250,6,50,AR - Fayetteville
10,1960-1961,1960-12-01,1961-02-28,90,0,11,159,170,14,17,31,201,5,30,AR - Fayetteville
11,1961-1962,1961-12-01,1962-02-28,90,0,18,151,169,5,9,14,183,4,29,AR - Fayetteville
12,1962-1963,1962-12-01,1963-02-28,90,3,16,210,226,2,0,2,228,2,8,AR - Fayetteville
13,1963-1964,1963-12-01,1964-03-10,101,0,12,228,240,15,13,28,268,4,30,AR - Fayetteville
14,1964-1965,1964-11-21,1965-03-26,126,0,15,215,230,19,12,31,261,8,36,AR - Fayetteville
15,1965-1966,1965-12-01,1966-02-28,90,0,14,161,175,20,15,35,210,7,47,AR - Fayetteville
16,1966-1967,1966-12-01,1967-03-08,98,0,5,191,196,23,20,43,239,5,45,AR - Fayetteville
17,1967-1968,1967-12-01,1968-03-14,105,0,11,184,195,25,19,44,239,6,39,AR - Fayetteville
18,1968-1969,1968-12-01,1969-03-10,100,0,6,158,164,5,7,12,176,3,9,AR - Fayetteville
19,1969-1970,1969-11-14,1970-03-16,123,0,25,224,249,34,58,92,341,8,66,AR - Fayetteville
20,1970-1971,1970-11-23,1971-04-06,135,0,14,192,206,9,17,26,232,3,13,AR - Fayetteville
21,1971-1972,1971-11-22,1972-02-29,100,0,7,121,128,14,4,18,146,7,27,AR - Fayetteville
22,1972-1973,1972-11-21,1973-02-28,100,1,20,176,196,9,14,23,219,5,28,AR - Fayetteville
23,1973-1974,1973-12-01,1974-03-21,111,0,15,143,158,9,6,15,173,5,29,AR - Fayetteville
24,1974-1975,1974-11-30,1975-03-29,120,0,11,136,147,14,16,30,177,4,29,AR - Fayetteville
25,1975-1976,1975-11-24,1976-02-29,98,0,9,151,160,12,9,21,181,2,17,AR - Fayetteville
26,1976-1977,1976-11-11,1977-02-28,110,2,20,269,289,33,58,91,380,7,62,AR - Fayetteville
27,1977-1978,1977-12-01,1978-03-08,98,0,41,231,272,35,58,93,365,11,77,AR - Fayetteville
28,1978-1979,1978-12-01,1979-02-28,90,0,35,238,273,28,47,75,348,10,59,AR - Fayetteville
29,1979-1980,1979-11-29,1980-03-01,94,0,13,137,150,12,27,39,189,3,17,AR - Fayetteville
30,1980-1981,1980-11-17,1981-02-28,104,0,8,179,187,14,3,17,204,4,17,AR - Fayetteville
31,1981-1982,1981-12-01,1982-02-28,90,10,21,179,200,11,17,28,228,3,23,AR - Fayetteville
32,1982-1983,1982-12-01,1983-02-28,90,4,4,93,97,3,1,4,101,2,4,AR - Fayetteville
33,1983-1984,1983-11-28,1984-02-29,94,7,55,221,276,13,30,43,319,5,50,AR - Fayetteville
34,1984-1985,1984-12-01,1985-02-28,90,14,27,183,210,17,27,44,254,6,41,AR - Fayetteville
35,1985-1986,1985-12-01,1986-02-28,90,11,14,163,177,11,12,23,200,3,21,AR - Fayetteville
36,1986-1987,1986-11-13,1987-02-28,108,0,6,103,109,4,1,5,114,2,9,AR - Fayetteville
37,1987-1988,1987-12-01,1988-03-19,110,9,15,186,201,16,31,47,248,5,33,AR - Fayetteville
38,1988-1989,1988-12-01,1989-03-10,100,2,19,148,167,20,21,41,208,6,41,AR - Fayetteville
39,1989-1990,1989-12-01,1990-02-28,90,0,19,153,172,5,4,9,181,2,9,AR - Fayetteville
40,1990-1991,1990-12-01,1991-02-28,90,2,15,126,141,13,16,29,170,5,31,AR - Fayetteville
41,1991-1992,1991-11-02,1992-02-29,120,0,1,101,102,7,5,12,114,3,12,AR - Fayetteville
42,1992-1993,1992-12-01,1993-02-28,90,8,5,112,117,1,17,18,135,1,2,AR - Fayetteville
43,1993-1994,1993-10-29,1994-03-10,133,5,13,171,184,10,12,22,206,7,27,AR - Fayetteville
44,1994-1995,1994-12-01,1995-03-03,93,4,4,92,96,10,9,19,115,8,26,AR - Fayetteville
45,1995-1996,1995-11-10,1996-03-27,139,0,27,214,241,26,38,64,305,11,51,AR - Fayetteville
46,1996-1997,1996-11-24,1997-02-28,97,0,19,150,169,20,22,42,211,9,45,AR - Fayetteville
59,2009-2010,2009-12-01,2010-03-21,111,9,18,179,197,49,0,49,246,4,58,AR - Fayetteville
60,2010-2011,2010-12-01,2011-02-28,90,0,20,192,212,26,46,72,284,4,46,AR - Fayetteville
61,2011-2012,2011-12-01,2012-02-29,91,0,3,97,100,3,1,4,104,3,7,AR - Fayetteville
62,2012-2013,2012-12-01,2013-02-28,90,0,3,136,139,4,0,4,143,3,8,AR - Fayetteville
63,2013-2014,2013-12-01,2014-03-16,106,0,24,240,264,25,38,63,327,7,56,AR - Fayetteville
64,2014-2015,2014-11-17,2015-03-05,109,0,12,170,182,11,7,18,200,6,38,AR - Fayetteville
65,2015-2016,2015-12-01,2016-02-29,91,0,2,113,115,0,0,0,115,0,0,AR - Fayetteville
66,2016-2017,2016-12-01,2017-03-11,101,0,8,121,129,3,1,4,133,3,17,AR - Fayetteville
67,2017-2018,2017-12-01,2018-02-28,90,0,17,160,177,1,0,1,178,1,2,AR - Fayetteville
68,2018-2019,2018-11-12,2019-03-04,113,0,4,153,157,5,0,5,162,5,22,AR - Fayetteville
69,2019-2020,2019-11-11,2020-02-29,111,0,2,95,97,3,0,3,100,3,8,AR - Fayetteville
0,1950-1951,1950-12-01,1951-02-28,90,0,19,124,143,6,7,13,156,4,32,AR - Fort Smith
1,1951-1952,1951-11-02,1952-02-29,120,0,2,90,92,8,3,11,103,3,12,AR - Fort Smith
2,1952-1953,1952-11-28,1953-02-28,93,0,2,78,80,6,6,12,92,3,14,AR - Fort Smith
3,1953-1954,1953-12-01,1954-02-28,90,0,5,97,102,7,17,24,126,2,14,AR - Fort Smith
4,1954-1955,1954-12-01,1955-02-28,90,0,1,76,77,7,1,8,85,1,8,AR - Fort Smith
5,1955-1956,1955-11-30,1956-02-29,92,0,5,88,93,8,7,15,108,5,16,AR - Fort Smith
6,1956-1957,1956-12-01,1957-02-28,90,0,2,50,52,0,0,0,52,0,0,AR - Fort Smith
7,1957-1958,1957-12-01,1958-03-12,102,0,5,96,101,11,7,18,119,5,18,AR - Fort Smith
8,1958-1959,1958-11-28,1959-02-28,93,0,10,118,128,13,14,27,155,7,29,AR - Fort Smith
9,1959-1960,1959-12-01,1960-03-14,105,0,8,108,116,27,19,46,162,8,42,AR - Fort Smith
10,1960-1961,1960-12-01,1961-02-28,90,0,7,115,122,12,1,13,135,5,24,AR - Fort Smith
11,1961-1962,1961-12-01,1962-02-28,90,0,14,109,123,5,13,18,141,3,15,AR - Fort Smith
12,1962-1963,1962-12-01,1963-02-28,90,0,13,146,159,0,0,0,159,0,0,AR - Fort Smith
13,1963-1964,1963-12-01,1964-02-29,91,0,6,154,160,8,9,17,177,3,20,AR - Fort Smith
14,1964-1965,1964-12-01,1965-03-19,109,0,3,123,126,1,0,1,127,1,2,AR - Fort Smith
15,1965-1966,1965-12-01,1966-02-28,90,0,8,114,122,11,15,26,148,5,23,AR - Fort Smith
16,1966-1967,1966-12-01,1967-03-07,97,0,2,143,145,9,3,12,157,3,16,AR - Fort Smith
17,1967-1968,1967-12-01,1968-03-12,103,0,7,105,112,17,2,19,131,8,30,AR - Fort Smith
18,1968-1969,1968-12-01,1969-02-28,90,0,2,92,94,6,1,7,101,3,6,AR - Fort Smith
19,1969-1970,1969-12-01,1970-03-12,102,0,13,120,133,12,19,31,164,7,35,AR - Fort Smith
20,1970-1971,1970-12-01,1971-03-25,115,0,3,111,114,4,1,5,119,3,6,AR - Fort Smith
21,1971-1972,1971-11-22,1972-02-29,100,0,5,88,93,11,2,13,106,7,21,AR - Fort Smith
22,1972-1973,1972-11-21,1973-02-28,100,0,9,134,143,10,16,26,169,6,22,AR - Fort Smith
23,1973-1974,1973-12-01,1974-02-28,90,0,6,100,106,3,4,7,113,2,9,AR - Fort Smith
24,1974-1975,1974-11-29,1975-03-29,121,0,2,99,101,15,8,23,124,7,23,AR - Fort Smith
25,1975-1976,1975-11-26,1976-02-29,96,0,4,128,132,13,4,17,149,3,18,AR - Fort Smith
26,1976-1977,1976-11-13,1977-02-28,108,0,14,203,217,25,52,77,294,8,45,AR - Fort Smith
27,1977-1978,1977-12-01,1978-03-08,98,0,22,174,196,33,46,79,275,13,64,AR - Fort Smith
28,1978-1979,1978-12-01,1979-02-28,90,0,27,176,203,26,56,82,285,14,66,AR - Fort Smith
29,1979-1980,1979-12-01,1980-03-01,92,0,7,105,112,6,3,9,121,5,16,AR - Fort Smith
30,1980-1981,1980-11-26,1981-02-28,95,0,5,113,118,5,0,5,123,2,6,AR - Fort Smith
31,1981-1982,1981-12-01,1982-03-06,96,0,11,136,147,19,10,29,176,8,41,AR - Fort Smith
32,1982-1983,1982-12-01,1983-02-28,90,0,2,66,68,2,1,3,71,2,7,AR - Fort Smith
33,1983-1984,1983-12-01,1984-03-10,101,0,33,169,202,9,2,11,213,7,30,AR - Fort Smith
34,1984-1985,1984-12-01,1985-02-28,90,0,16,124,140,26,34,60,200,11,61,AR - Fort Smith
35,1985-1986,1985-12-01,1986-02-28,90,0,7,132,139,12,3,15,154,6,24,AR - Fort Smith
36,1986-1987,1986-12-01,1987-03-30,120,0,0,67,67,5,1,6,73,3,7,AR - Fort Smith
37,1987-1988,1987-12-01,1988-03-17,108,0,9,125,134,22,35,57,191,6,39,AR - Fort Smith
38,1988-1989,1988-12-01,1989-03-07,97,0,9,102,111,9,5,14,125,6,27,AR - Fort Smith
39,1989-1990,1989-12-01,1990-02-28,90,0,11,123,134,1,0,1,135,1,3,AR - Fort Smith
40,1990-1991,1990-12-01,1991-02-28,90,0,9,97,106,7,10,17,123,4,24,AR - Fort Smith
41,1991-1992,1991-12-01,1992-02-29,91,0,0,47,47,0,0,0,47,0,0,AR - Fort Smith
42,1992-1993,1992-12-01,1993-02-28,90,0,3,64,67,0,0,0,67,0,0,AR - Fort Smith
43,1993-1994,1993-11-25,1994-03-09,105,0,5,92,97,8,8,16,113,4,15,AR - Fort Smith
44,1994-1995,1994-12-01,1995-03-02,92,2,1,68,69,11,2,13,82,7,18,AR - Fort Smith
45,1995-1996,1995-12-01,1996-03-08,99,1,14,132,146,1,1,2,148,1,2,AR - Fort Smith
46,1996-1997,1996-12-01,1997-02-28,90,0,9,87,96,4,3,7,103,1,5,AR - Fort Smith
47,1997-1998,1997-12-01,1998-02-28,90,0,0,39,39,0,0,0,39,0,0,AR - Fort Smith
48,1998-1999,1998-12-01,1999-03-14,104,0,5,76,81,2,0,2,83,2,6,AR - Fort Smith
49,1999-2000,1999-12-01,2000-02-29,91,1,3,61,64,14,17,31,95,1,16,AR - Fort Smith
50,2000-2001,2000-12-01,2001-02-28,90,0,10,116,126,7,3,10,136,3,13,AR - Fort Smith
51,2001-2002,2001-12-01,2002-03-03,93,12,4,88,92,0,0,0,92,0,0,AR - Fort Smith
53,2003-2004,2003-12-01,2004-02-29,91,14,3,82,85,0,0,0,85,0,0,AR - Fort Smith
54,2004-2005,2004-12-01,2005-02-28,90,8,2,62,64,2,2,4,68,1,4,AR - Fort Smith
55,2005-2006,2005-12-01,2006-02-28,90,16,2,81,83,0,0,0,83,0,0,AR - Fort Smith
56,2006-2007,2006-12-01,2007-02-28,90,14,5,74,79,3,2,5,84,3,14,AR - Fort Smith
59,2009-2010,2009-12-01,2010-03-21,111,0,8,112,120,26,18,44,164,5,29,AR - Fort Smith
60,2010-2011,2010-12-01,2011-02-28,90,0,10,108,118,17,2,19,137,5,31,AR - Fort Smith
61,2011-2012,2011-12-01,2012-02-29,91,0,0,43,43,3,2,5,48,1,4,AR - Fort Smith
62,2012-2013,2012-12-01,2013-02-28,90,1,1,63,64,12,8,20,84,2,14,AR - Fort Smith
63,2013-2014,2013-12-01,2014-03-03,93,0,11,133,144,17,20,37,181,6,34,AR - Fort Smith
64,2014-2015,2014-12-01,2015-03-05,95,0,4,94,98,11,7,18,116,6,27,AR - Fort Smith
65,2015-2016,2015-12-01,2016-02-29,91,0,1,57,58,0,0,0,58,0,0,AR - Fort Smith
66,2016-2017,2016-12-01,2017-02-28,90,0,4,58,62,3,3,6,68,1,10,AR - Fort Smith
67,2017-2018,2017-12-01,2018-02-28,90,0,9,95,104,0,0,0,104,0,0,AR - Fort Smith
68,2018-2019,2018-12-01,2019-02-28,90,0,0,45,45,2,0,2,47,1,3,AR - Fort Smith
69,2019-2020,2019-12-01,2020-02-29,91,0,0,49,49,1,0,1,50,1,2,AR - Fort Smith
0,1950-1951,1950-12-01,1951-03-12,102,0,14,92,106,9,10,19,125,5,31,AR - Little Rock
1,1951-1952,1951-11-02,1952-02-29,120,0,2,55,57,2,0,2,59,2,3,AR - Little Rock
2,1952-1953,1952-11-28,1953-02-28,93,0,0,29,29,2,0,2,31,1,3,AR - Little Rock
3,1953-1954,1953-12-01,1954-02-28,90,0,3,53,56,6,6,12,68,3,11,AR - Little Rock
4,1954-1955,1954-12-01,1955-02-28,90,0,1,52,53,3,0,3,56,3,5,AR - Little Rock
5,1955-1956,1955-12-01,1956-02-29,91,0,3,48,51,6,3,9,60,4,11,AR - Little Rock
6,1956-1957,1956-12-01,1957-02-28,90,0,1,32,33,0,0,0,33,0,0,AR - Little Rock
7,1957-1958,1957-11-22,1958-02-28,99,0,3,66,69,7,1,8,77,2,8,AR - Little Rock
8,1958-1959,1958-11-27,1959-02-28,94,0,7,87,94,8,12,20,114,4,15,AR - Little Rock
9,1959-1960,1959-12-01,1960-03-25,116,0,3,70,73,36,27,63,136,10,47,AR - Little Rock
10,1960-1961,1960-12-01,1961-02-28,90,0,6,110,116,9,1,10,126,1,10,AR - Little Rock
11,1961-1962,1961-12-01,1962-02-28,90,0,11,85,96,9,16,25,121,2,16,AR - Little Rock
12,1962-1963,1962-12-01,1963-02-28,90,0,10,143,153,6,0,6,159,5,21,AR - Little Rock
13,1963-1964,1963-12-01,1964-02-29,91,0,5,135,140,13,15,28,168,1,18,AR - Little Rock
14,1964-1965,1964-12-01,1965-03-20,110,0,5,90,95,10,6,16,111,5,22,AR - Little Rock
15,1965-1966,1965-12-01,1966-02-28,90,0,7,91,98,33,29,62,160,10,59,AR - Little Rock
16,1966-1967,1966-12-01,1967-02-28,90,0,3,89,92,3,3,6,98,2,8,AR - Little Rock
17,1967-1968,1967-12-01,1968-02-29,91,0,12,92,104,11,3,14,118,5,23,AR - Little Rock
18,1968-1969,1968-12-01,1969-02-28,90,0,1,63,64,3,0,3,67,1,3,AR - Little Rock
19,1969-1970,1969-12-01,1970-02-28,90,0,10,103,113,7,4,11,124,4,19,AR - Little Rock
20,1970-1971,1970-12-01,1971-03-25,115,0,5,74,79,12,5,17,96,5,18,AR - Little Rock
21,1971-1972,1971-11-22,1972-02-29,100,0,3,52,55,10,3,13,68,5,15,AR - Little Rock
22,1972-1973,1972-12-01,1973-02-28,90,0,9,76,85,5,6,11,96,3,11,AR - Little Rock
23,1973-1974,1973-12-01,1974-02-28,90,0,5,65,70,1,0,1,71,1,4,AR - Little Rock
24,1974-1975,1974-12-01,1975-03-14,104,0,1,61,62,6,4,10,72,3,11,AR - Little Rock
25,1975-1976,1975-11-26,1976-02-29,96,0,4,87,91,3,0,3,94,2,6,AR - Little Rock
26,1976-1977,1976-11-14,1977-02-28,107,0,8,124,132,7,6,13,145,3,16,AR - Little Rock
27,1977-1978,1977-12-01,1978-02-28,90,0,16,115,131,21,27,48,179,10,42,AR - Little Rock
28,1978-1979,1978-12-01,1979-02-28,90,0,15,115,130,16,18,34,164,6,23,AR - Little Rock
29,1979-1980,1979-12-01,1980-02-29,91,0,6,57,63,2,1,3,66,2,5,AR - Little Rock
30,1980-1981,1980-11-26,1981-02-28,95,0,6,89,95,2,1,3,98,1,2,AR - Little Rock
31,1981-1982,1981-12-01,1982-02-28,90,0,13,92,105,16,14,30,135,3,20,AR - Little Rock
32,1982-1983,1982-12-01,1983-02-28,90,0,0,48,48,0,0,0,48,0,0,AR - Little Rock
33,1983-1984,1983-12-01,1984-03-10,101,0,31,135,166,14,6,20,186,8,43,AR - Little Rock
34,1984-1985,1984-12-01,1985-02-28,90,0,14,95,109,17,17,34,143,5,34,AR - Little Rock
35,1985-1986,1985-12-01,1986-02-28,90,0,4,92,96,2,0,2,98,1,5,AR - Little Rock
36,1986-1987,1986-11-14,1987-03-30,137,0,1,52,53,3,0,3,56,2,4,AR - Little Rock
37,1987-1988,1987-12-01,1988-02-29,91,0,11,91,102,22,30,52,154,4,36,AR - Little Rock
38,1988-1989,1988-12-01,1989-03-05,95,0,5,59,64,5,0,5,69,2,7,AR - Little Rock
39,1989-1990,1989-12-01,1990-02-28,90,0,11,74,85,0,0,0,85,0,0,AR - Little Rock
40,1990-1991,1990-12-01,1991-02-28,90,0,6,60,66,0,0,0,66,0,0,AR - Little Rock
41,1991-1992,1991-12-01,1992-02-29,91,0,0,29,29,0,0,0,29,0,0,AR - Little Rock
42,1992-1993,1992-12-01,1993-02-28,90,0,0,44,44,0,0,0,44,0,0,AR - Little Rock
43,1993-1994,1993-12-01,1994-02-28,90,0,4,76,80,2,2,4,84,2,6,AR - Little Rock
44,1994-1995,1994-12-01,1995-03-03,93,0,1,43,44,12,5,17,61,3,15,AR - Little Rock
45,1995-1996,1995-11-28,1996-02-29,94,0,9,93,102,3,1,4,106,3,10,AR - Little Rock
46,1996-1997,1996-12-01,1997-02-28,90,0,6,60,66,6,6,12,78,1,7,AR - Little Rock
47,1997-1998,1997-12-01,1998-02-28,90,0,0,22,22,0,0,0,22,0,0,AR - Little Rock
48,1998-1999,1998-12-01,1999-02-28,90,0,5,57,62,0,0,0,62,0,0,AR - Little Rock
49,1999-2000,1999-12-01,2000-02-29,91,0,2,50,52,11,16,27,79,2,15,AR - Little Rock
50,2000-2001,2000-12-01,2001-02-28,90,0,12,96,108,1,2,3,111,1,3,AR - Little Rock
51,2001-2002,2001-12-01,2002-03-03,93,0,1,69,70,6,8,14,84,2,8,AR - Little Rock
52,2002-2003,2002-12-01,2003-02-28,90,0,4,80,84,9,11,20,104,6,17,AR - Little Rock
53,2003-2004,2003-12-01,2004-02-29,91,1,1,61,62,3,2,5,67,1,3,AR - Little Rock
54,2004-2005,2004-12-01,2005-02-28,90,0,2,50,52,4,6,10,62,1,6,AR - Little Rock
55,2005-2006,2005-12-01,2006-02-28,90,0,1,49,50,2,3,5,55,2,6,AR - Little Rock
56,2006-2007,2006-12-01,2007-02-28,90,0,3,61,64,4,1,5,69,3,10,AR - Little Rock
57,2007-2008,2007-12-01,2008-03-08,99,0,1,67,68,5,2,7,75,3,7,AR - Little Rock
58,2008-2009,2008-12-01,2009-02-28,90,0,4,70,74,1,0,1,75,1,2,AR - Little Rock
59,2009-2010,2009-12-01,2010-02-28,90,0,5,89,94,12,17,29,123,2,14,AR - Little Rock
60,2010-2011,2010-12-01,2011-02-28,90,0,8,81,89,20,24,44,133,6,33,AR - Little Rock
61,2011-2012,2011-12-01,2012-02-29,91,0,0,33,33,4,2,6,39,3,6,AR - Little Rock
62,2012-2013,2012-12-01,2013-02-28,90,0,1,49,50,16,21,37,87,3,22,AR - Little Rock
63,2013-2014,2013-12-01,2014-03-17,107,0,10,117,127,13,12,25,152,9,33,AR - Little Rock
64,2014-2015,2014-11-13,2015-03-07,115,0,4,82,86,17,14,31,117,8,31,AR - Little Rock
65,2015-2016,2015-12-01,2016-02-29,91,0,0,34,34,8,8,16,50,2,10,AR - Little Rock
66,2016-2017,2016-12-01,2017-02-28,90,0,3,46,49,1,0,1,50,1,5,AR - Little Rock
67,2017-2018,2017-12-01,2018-02-28,90,0,9,88,97,3,3,6,103,2,12,AR - Little Rock
68,2018-2019,2018-11-14,2019-02-28,107,0,0,54,54,1,0,1,55,1,2,AR - Little Rock
69,2019-2020,2019-12-01,2020-02-29,91,0,0,37,37,0,0,0,37,0,0,AR - Little Rock
0,1950-1951,1950-12-01,1951-02-28,90,5,12,109,121,6,4,10,131,1,14,AR - Nashville
1,1951-1952,1951-12-01,1952-02-29,91,3,0,57,57,0,0,0,57,0,0,AR - Nashville
2,1952-1953,1952-12-01,1953-02-28,90,3,1,63,64,0,0,0,64,0,0,AR - Nashville
3,1953-1954,1953-12-01,1954-02-28,90,7,2,82,84,1,0,1,85,1,4,AR - Nashville
4,1954-1955,1954-12-01,1955-02-28,90,0,0,72,72,0,0,0,72,0,0,AR - Nashville
5,1955-1956,1955-12-01,1956-02-29,91,0,0,78,78,5,7,12,90,2,8,AR - Nashville
6,1956-1957,1956-12-01,1957-02-28,90,1,2,41,43,0,0,0,43,0,0,AR - Nashville
7,1957-1958,1957-12-01,1958-02-28,90,2,1,92,93,2,2,4,97,1,3,AR - Nashville
8,1958-1959,1958-12-01,1959-02-28,90,0,5,109,114,3,4,7,121,1,5,AR - Nashville
9,1959-1960,1959-12-01,1960-03-06,97,0,5,100,105,17,15,32,137,7,28,AR - Nashville
10,1960-1961,1960-12-01,1961-02-28,90,0,4,106,110,2,1,3,113,2,7,AR - Nashville
11,1961-1962,1961-12-01,1962-02-28,90,1,8,95,103,6,15,21,124,2,20,AR - Nashville
12,1962-1963,1962-12-01,1963-02-28,90,2,11,137,148,0,0,0,148,0,0,AR - Nashville
13,1963-1964,1963-12-01,1964-02-29,91,0,7,137,144,7,11,18,162,3,19,AR - Nashville
14,1964-1965,1964-12-01,1965-03-20,110,2,2,116,118,7,5,12,130,3,20,AR - Nashville
15,1965-1966,1965-12-01,1966-02-28,90,2,5,109,114,16,16,32,146,5,31,AR - Nashville
16,1966-1967,1966-12-01,1967-02-28,90,0,3,133,136,0,0,0,136,0,0,AR - Nashville
17,1967-1968,1967-12-01,1968-02-29,91,0,5,84,89,6,3,9,98,4,15,AR - Nashville
18,1968-1969,1968-12-01,1969-02-28,90,0,0,68,68,0,0,0,68,0,0,AR - Nashville
19,1969-1970,1969-12-01,1970-02-28,90,0,3,88,91,3,2,5,96,1,5,AR - Nashville
20,1970-1971,1970-12-01,1971-03-03,93,0,1,77,78,2,2,4,82,2,7,AR - Nashville
21,1971-1972,1971-11-23,1972-02-29,99,0,2,67,69,1,1,2,71,1,2,AR - Nashville
22,1972-1973,1972-12-01,1973-02-28,90,0,3,90,93,2,5,7,100,2,6,AR - Nashville
23,1973-1974,1973-12-01,1974-02-28,90,2,3,70,73,0,0,0,73,0,0,AR - Nashville
24,1974-1975,1974-12-01,1975-02-28,90,0,1,72,73,3,2,5,78,2,6,AR - Nashville
25,1975-1976,1975-12-01,1976-02-29,91,0,2,64,66,2,1,3,69,1,3,AR - Nashville
26,1976-1977,1976-11-14,1977-02-28,107,0,5,116,121,7,6,13,134,3,14,AR - Nashville
27,1977-1978,1977-12-01,1978-02-28,90,0,4,122,126,15,32,47,173,6,27,AR - Nashville
28,1978-1979,1978-12-01,1979-02-28,90,0,6,116,122,11,13,24,146,5,20,AR - Nashville
29,1979-1980,1979-12-01,1980-04-13,135,10,4,80,84,7,8,15,99,2,11,AR - Nashville
30,1980-1981,1980-11-27,1981-02-28,94,0,3,83,86,2,1,3,89,2,3,AR - Nashville
31,1981-1982,1981-12-01,1982-02-28,90,16,8,94,102,6,13,19,121,3,11,AR - Nashville
32,1982-1983,1982-12-01,1983-02-28,90,14,0,50,50,2,2,4,54,1,3,AR - Nashville
34,1984-1985,1984-12-01,1985-02-28,90,17,10,95,105,14,20,34,139,4,32,AR - Nashville
35,1985-1986,1985-12-01,1986-02-28,90,1,3,84,87,0,0,0,87,0,0,AR - Nashville
36,1986-1987,1986-12-01,1987-03-30,120,19,0,44,44,3,0,3,47,1,4,AR - Nashville
37,1987-1988,1987-12-01,1988-02-29,91,2,5,90,95,11,24,35,130,3,20,AR - Nashville
38,1988-1989,1988-12-01,1989-03-06,96,1,7,72,79,0,0,0,79,0,0,AR - Nashville
39,1989-1990,1989-12-01,1990-02-28,90,0,10,86,96,1,0,1,97,1,2,AR - Nashville
40,1990-1991,1990-12-01,1991-02-28,90,1,5,67,72,2,2,4,76,2,12,AR - Nashville
41,1991-1992,1991-12-01,1992-02-29,91,2,0,37,37,4,7,11,48,1,5,AR - Nashville
42,1992-1993,1992-12-01,1993-02-28,90,6,0,39,39,0,0,0,39,0,0,AR - Nashville
43,1993-1994,1993-12-01,1994-02-28,90,2,2,71,73,1,0,1,74,1,3,AR - Nashville
44,1994-1995,1994-12-01,1995-02-28,90,1,2,50,52,5,7,12,64,2,10,AR - Nashville
45,1995-1996,1995-12-01,1996-02-29,91,1,5,124,129,3,3,6,135,1,6,AR - Nashville
46,1996-1997,1996-12-01,1997-02-28,90,0,5,78,83,2,1,3,86,1,3,AR - Nashville
47,1997-1998,1997-12-01,1998-02-28,90,1,0,50,50,0,0,0,50,0,0,AR - Nashville
48,1998-1999,1998-12-01,1999-02-28,90,0,4,68,72,0,0,0,72,0,0,AR - Nashville
49,1999-2000,1999-12-01,2000-02-29,91,0,2,80,82,20,33,53,135,2,24,AR - Nashville
50,2000-2001,2000-12-01,2001-02-28,90,6,4,100,104,6,13,19,123,3,12,AR - Nashville
51,2001-2002,2001-12-01,2002-02-28,90,0,0,93,93,7,7,14,107,1,8,AR - Nashville
52,2002-2003,2002-12-01,2003-02-28,90,9,1,85,86,5,2,7,93,3,6,AR - Nashville
53,2003-2004,2003-12-01,2004-02-29,91,4,0,82,82,4,4,8,90,1,5,AR - Nashville
54,2004-2005,2004-12-01,2005-02-28,90,0,0,68,68,2,1,3,71,1,5,AR - Nashville
55,2005-2006,2005-12-01,2006-02-28,90,0,2,101,103,1,0,1,104,1,1,AR - Nashville
56,2006-2007,2006-12-01,2007-02-28,90,6,2,87,89,2,1,3,92,1,3,AR - Nashville
57,2007-2008,2007-12-01,2008-03-04,95,2,0,80,80,2,1,3,83,1,3,AR - Nashville
58,2008-2009,2008-12-01,2009-02-28,90,14,0,61,61,0,0,0,61,0,0,AR - Nashville
59,2009-2010,2009-12-01,2010-03-21,111,0,1,99,100,3,1,4,104,3,5,AR - Nashville
60,2010-2011,2010-12-01,2011-02-28,90,0,5,96,101,18,21,39,140,4,30,AR - Nashville
61,2011-2012,2011-12-01,2012-02-29,91,3,0,49,49,3,2,5,54,1,5,AR - Nashville
62,2012-2013,2012-12-01,2013-02-28,90,0,0,58,58,9,4,13,71,1,10,AR - Nashville
63,2013-2014,2013-12-01,2014-03-04,94,1,3,107,110,2,2,4,114,1,3,AR - Nashville
64,2014-2015,2014-12-01,2015-03-05,95,6,2,69,71,11,5,16,87,3,15,AR - Nashville
65,2015-2016,2015-12-01,2016-02-29,91,1,0,60,60,0,0,0,60,0,0,AR - Nashville
66,2016-2017,2016-12-01,2017-02-28,90,0,1,48,49,2,1,3,52,1,8,AR - Nashville
67,2017-2018,2017-12-01,2018-02-28,90,0,5,76,81,3,2,5,86,1,5,AR - Nashville
68,2018-2019,2018-12-01,2019-02-28,90,0,0,44,44,0,0,0,44,0,0,AR - Nashville
69,2019-2020,2019-12-01,2020-02-29,91,0,0,47,47,0,0,0,47,0,0,AR - Nashville
0,1950-1951,1950-11-24,1951-03-14,111,0,14,168,182,19,18,37,219,10,60,AR - Pocahontas
1,1951-1952,1951-11-02,1952-02-29,120,1,1,123,124,9,4,13,137,2,11,AR - Pocahontas
2,1952-1953,1952-11-29,1953-02-28,92,0,0,98,98,2,1,3,101,1,4,AR - Pocahontas
3,1953-1954,1953-11-07,1954-02-28,114,1,2,119,121,6,2,8,129,3,11,AR - Pocahontas
4,1954-1955,1954-12-01,1955-02-28,90,2,2,104,106,6,0,6,112,2,8,AR - Pocahontas
5,1955-1956,1955-12-01,1956-02-29,91,6,3,107,110,7,0,7,117,1,8,AR - Pocahontas
6,1956-1957,1956-12-01,1957-02-28,90,0,4,71,75,1,0,1,76,1,3,AR - Pocahontas
7,1957-1958,1957-12-01,1958-03-17,107,10,5,156,161,7,0,7,168,1,8,AR - Pocahontas
8,1958-1959,1958-12-01,1959-02-28,90,0,8,135,143,7,5,12,155,1,12,AR - Pocahontas
10,1960-1961,1960-12-01,1961-02-28,90,14,6,143,149,9,0,9,158,3,18,AR - Pocahontas
11,1961-1962,1961-12-01,1962-03-01,91,17,10,112,122,0,0,0,122,0,0,AR - Pocahontas
12,1962-1963,1962-12-01,1963-02-28,90,18,12,213,225,0,4,4,229,0,0,AR - Pocahontas
13,1963-1964,1963-12-01,1964-02-29,91,5,13,165,178,8,8,16,194,2,15,AR - Pocahontas
14,1964-1965,1964-12-01,1965-03-05,95,1,9,129,138,15,0,15,153,4,24,AR - Pocahontas
15,1965-1966,1965-12-01,1966-02-28,90,13,12,116,128,18,0,18,146,5,35,AR - Pocahontas
16,1966-1967,1966-12-01,1967-03-06,96,5,7,138,145,28,4,32,177,5,39,AR - Pocahontas
17,1967-1968,1967-12-01,1968-02-29,91,0,11,127,138,12,5,17,155,6,29,AR - Pocahontas
18,1968-1969,1968-12-01,1969-02-28,90,0,4,114,118,3,0,3,121,1,4,AR - Pocahontas
20,1970-1971,1970-12-01,1971-02-28,90,0,8,121,129,4,0,4,133,2,6,AR - Pocahontas
21,1971-1972,1971-11-23,1972-02-29,99,0,5,91,96,3,2,5,101,1,4,AR - Pocahontas
22,1972-1973,1972-12-01,1973-02-28,90,0,13,111,124,10,24,34,158,3,17,AR - Pocahontas
23,1973-1974,1973-12-01,1974-02-28,90,0,12,98,110,6,8,14,124,3,14,AR - Pocahontas
24,1974-1975,1974-12-01,1975-03-14,104,0,0,98,98,7,0,7,105,2,10,AR - Pocahontas
25,1975-1976,1975-11-26,1976-02-29,96,0,5,109,114,10,10,20,134,5,18,AR - Pocahontas
26,1976-1977,1976-11-11,1977-02-28,110,0,25,232,257,37,105,142,399,9,75,AR - Pocahontas
27,1977-1978,1977-12-01,1978-03-04,94,2,28,189,217,36,105,141,358,13,69,AR - Pocahontas
28,1978-1979,1978-12-01,1979-03-01,91,2,20,179,199,39,85,124,323,16,72,AR - Pocahontas
29,1979-1980,1979-12-01,1980-03-01,92,4,10,119,129,27,40,67,196,7,43,AR - Pocahontas
30,1980-1981,1980-11-26,1981-02-28,95,5,7,132,139,10,8,18,157,3,13,AR - Pocahontas
37,1987-1988,1987-12-01,1988-02-29,91,14,12,118,130,11,0,11,141,2,25,AR - Pocahontas
38,1988-1989,1988-12-01,1989-03-06,96,7,9,105,114,10,0,10,124,3,16,AR - Pocahontas
39,1989-1990,1989-12-01,1990-03-01,91,10,18,112,130,4,0,4,134,1,5,AR - Pocahontas
40,1990-1991,1990-12-01,1991-02-28,90,7,13,89,102,9,0,9,111,2,15,AR - Pocahontas
41,1991-1992,1991-12-01,1992-02-29,91,1,1,54,55,0,0,0,55,0,0,AR - Pocahontas
42,1992-1993,1992-12-01,1993-02-28,90,18,3,86,89,19,0,19,108,3,24,AR - Pocahontas
44,1994-1995,1994-12-01,1995-02-28,90,4,3,79,82,0,0,0,82,0,0,AR - Pocahontas
46,1996-1997,1996-12-01,1997-02-28,90,16,22,97,119,20,11,31,150,4,25,AR - Pocahontas
47,1997-1998,1997-12-01,1998-03-13,103,3,2,93,95,4,0,4,99,2,6,AR - Pocahontas
48,1998-1999,1998-12-01,1999-02-28,90,2,19,109,128,0,0,0,128,0,0,AR - Pocahontas
49,1999-2000,1999-12-01,2000-02-29,91,5,3,93,96,9,12,21,117,2,15,AR - Pocahontas
50,2000-2001,2000-12-01,2001-02-28,90,18,21,159,180,12,17,29,209,9,43,AR - Pocahontas
51,2001-2002,2001-12-01,2002-03-04,94,3,4,100,104,4,3,7,111,2,6,AR - Pocahontas
52,2002-2003,2002-12-01,2003-02-28,90,6,14,137,151,28,33,61,212,11,58,AR - Pocahontas
53,2003-2004,2003-12-01,2004-02-29,91,0,7,126,133,3,8,11,144,1,5,AR - Pocahontas
54,2004-2005,2004-12-01,2005-02-28,90,2,9,96,105,6,13,19,124,2,13,AR - Pocahontas
55,2005-2006,2005-12-01,2006-02-28,90,7,8,106,114,7,11,18,132,3,17,AR - Pocahontas
56,2006-2007,2006-12-01,2007-02-28,90,1,10,117,127,3,5,8,135,1,9,AR - Pocahontas
57,2007-2008,2007-12-01,2008-03-08,99,3,9,131,140,12,6,18,158,3,16,AR - Pocahontas
58,2008-2009,2008-12-01,2009-03-03,93,4,12,139,151,8,10,18,169,2,12,AR - Pocahontas
59,2009-2010,2009-12-01,2010-02-28,90,0,16,162,178,28,52,80,258,5,44,AR - Pocahontas
60,2010-2011,2010-12-01,2011-02-28,90,6,16,144,160,21,26,47,207,6,40,AR - Pocahontas
61,2011-2012,2011-11-29,2012-02-29,93,12,1,76,77,10,4,14,91,3,13,AR - Pocahontas
62,2012-2013,2012-12-01,2013-03-23,113,9,9,122,131,26,43,69,200,4,34,AR - Pocahontas
63,2013-2014,2013-11-25,2014-03-09,105,11,33,224,257,16,56,72,329,3,27,AR - Pocahontas
64,2014-2015,2014-11-17,2015-03-08,112,6,18,176,194,18,34,52,246,5,33,AR - Pocahontas
65,2015-2016,2015-12-01,2016-02-29,91,0,6,91,97,11,19,30,127,2,17,AR - Pocahontas
66,2016-2017,2016-12-01,2017-03-13,103,0,5,101,106,6,3,9,115,2,8,AR - Pocahontas
67,2017-2018,2017-12-01,2018-04-07,128,0,16,164,180,3,2,5,185,2,9,AR - Pocahontas
68,2018-2019,2018-11-15,2019-03-05,111,0,4,138,142,9,13,22,164,2,15,AR - Pocahontas
69,2019-2020,2019-11-12,2020-02-29,110,2,3,112,115,2,1,3,118,1,6,AR - Pocahontas
0,1950-1951,1950-12-01,1951-02-28,90,0,0,8,8,0,0,0,8,0,0,CA - Bakersfield
1,1951-1952,1951-12-01,1952-02-29,91,0,0,18,18,0,0,0,18,0,0,CA - Bakersfield
2,1952-1953,1952-12-01,1953-02-28,90,0,0,6,6,0,0,0,6,0,0,CA - Bakersfield
3,1953-1954,1953-12-01,1954-02-28,90,0,0,11,11,0,0,0,11,0,0,CA - Bakersfield
4,1954-1955,1954-12-01,1955-02-28,90,0,0,19,19,0,0,0,19,0,0,CA - Bakersfield
5,1955-1956,1955-12-01,1956-02-29,91,0,0,7,7,0,0,0,7,0,0,CA - Bakersfield
6,1956-1957,1956-12-01,1957-02-28,90,0,0,24,24,0,0,0,24,0,0,CA - Bakersfield
7,1957-1958,1957-12-01,1958-02-28,90,0,0,4,4,0,0,0,4,0,0,CA - Bakersfield
8,1958-1959,1958-12-01,1959-02-28,90,0,0,3,3,0,0,0,3,0,0,CA - Bakersfield
9,1959-1960,1959-12-01,1960-02-29,91,0,0,13,13,0,0,0,13,0,0,CA - Bakersfield
10,1960-1961,1960-12-01,1961-02-28,90,0,0,22,22,0,0,0,22,0,0,CA - Bakersfield
11,1961-1962,1961-12-01,1962-02-28,90,0,0,27,27,0,0,0,27,0,0,CA - Bakersfield
12,1962-1963,1962-12-01,1963-02-28,90,0,0,32,32,0,0,0,32,0,0,CA - Bakersfield
13,1963-1964,1963-12-01,1964-02-29,91,0,0,18,18,0,0,0,18,0,0,CA - Bakersfield
14,1964-1965,1964-12-01,1965-02-28,90,0,0,11,11,0,0,0,11,0,0,CA - Bakersfield
15,1965-1966,1965-12-01,1966-02-28,90,0,0,16,16,0,0,0,16,0,0,CA - Bakersfield
16,1966-1967,1966-12-01,1967-02-28,90,0,0,14,14,0,0,0,14,0,0,CA - Bakersfield
17,1967-1968,1967-12-01,1968-02-29,91,0,0,4,4,0,0,0,4,0,0,CA - Bakersfield
18,1968-1969,1968-12-01,1969-02-28,90,0,0,8,8,0,0,0,8,0,0,CA - Bakersfield
19,1969-1970,1969-12-01,1970-02-28,90,0,0,9,9,0,0,0,9,0,0,CA - Bakersfield
20,1970-1971,1970-12-01,1971-02-28,90,0,0,9,9,0,0,0,9,0,0,CA - Bakersfield
21,1971-1972,1971-12-01,1972-02-29,91,0,0,22,22,0,0,0,22,0,0,CA - Bakersfield
22,1972-1973,1972-12-01,1973-02-28,90,0,0,16,16,0,0,0,16,0,0,CA - Bakersfield
23,1973-1974,1973-12-01,1974-03-08,98,0,0,3,3,2,0,2,5,1,2,CA - Bakersfield
24,1974-1975,1974-12-01,1975-02-28,90,0,0,11,11,0,0,0,11,0,0,CA - Bakersfield
25,1975-1976,1975-12-01,1976-02-29,91,0,0,7,7,0,0,0,7,0,0,CA - Bakersfield
26,1976-1977,1976-12-01,1977-02-28,90,0,0,3,3,0,0,0,3,0,0,CA - Bakersfield
27,1977-1978,1977-12-01,1978-02-28,90,0,0,1,1,0,0,0,1,0,0,CA - Bakersfield
28,1978-1979,1978-12-01,1979-02-28,90,0,0,7,7,0,0,0,7,0,0,CA - Bakersfield
29,1979-1980,1979-12-01,1980-02-29,91,0,0,0,0,0,0,0,0,0,0,CA - Bakersfield
30,1980-1981,1980-12-01,1981-02-28,90,0,0,7,7,0,0,0,7,0,0,CA - Bakersfield
31,1981-1982,1981-12-01,1982-02-28,90,0,0,4,4,0,0,0,4,0,0,CA - Bakersfield
32,1982-1983,1982-12-01,1983-02-28,90,0,0,14,14,0,0,0,14,0,0,CA - Bakersfield
33,1983-1984,1983-12-01,1984-02-29,91,0,0,2,2,0,0,0,2,0,0,CA - Bakersfield
34,1984-1985,1984-12-01,1985-02-28,90,0,0,16,16,0,0,0,16,0,0,CA - Bakersfield
35,1985-1986,1985-12-01,1986-02-28,90,0,0,7,7,0,0,0,7,0,0,CA - Bakersfield
36,1986-1987,1986-12-01,1987-02-28,90,0,0,11,11,0,0,0,11,0,0,CA - Bakersfield
37,1987-1988,1987-12-01,1988-02-29,91,0,0,19,19,0,0,0,19,0,0,CA - Bakersfield
38,1988-1989,1988-12-01,1989-02-28,90,0,0,25,25,0,0,0,25,0,0,CA - Bakersfield
39,1989-1990,1989-12-01,1990-02-28,90,0,0,31,31,0,0,0,31,0,0,CA - Bakersfield
40,1990-1991,1990-12-01,1991-02-28,90,0,0,26,26,0,0,0,26,0,0,CA - Bakersfield
41,1991-1992,1991-12-01,1992-02-29,91,0,0,13,13,0,0,0,13,0,0,CA - Bakersfield
42,1992-1993,1992-12-01,1993-02-28,90,0,0,12,12,0,0,0,12,0,0,CA - Bakersfield
43,1993-1994,1993-12-01,1994-02-28,90,0,0,4,4,0,0,0,4,0,0,CA - Bakersfield
44,1994-1995,1994-12-01,1995-02-28,90,0,0,5,5,0,0,0,5,0,0,CA - Bakersfield
45,1995-1996,1995-12-01,1996-02-29,91,0,0,2,2,0,0,0,2,0,0,CA - Bakersfield
46,1996-1997,1996-12-01,1997-02-28,90,0,0,4,4,0,0,0,4,0,0,CA - Bakersfield
47,1997-1998,1997-12-01,1998-02-28,90,0,0,13,13,0,0,0,13,0,0,CA - Bakersfield
48,1998-1999,1998-12-01,1999-02-28,90,0,0,37,37,4,3,7,44,1,5,CA - Bakersfield
49,1999-2000,1999-12-01,2000-02-29,91,0,0,10,10,0,0,0,10,0,0,CA - Bakersfield
50,2000-2001,2000-12-01,2001-02-28,90,0,0,13,13,0,0,0,13,0,0,CA - Bakersfield
51,2001-2002,2001-12-01,2002-02-28,90,0,0,15,15,0,0,0,15,0,0,CA - Bakersfield
52,2002-2003,2002-12-01,2003-02-28,90,0,0,2,2,0,0,0,2,0,0,CA - Bakersfield
53,2003-2004,2003-12-01,2004-02-29,91,0,0,2,2,0,0,0,2,0,0,CA - Bakersfield
54,2004-2005,2004-12-01,2005-02-28,90,0,0,13,13,0,0,0,13,0,0,CA - Bakersfield
55,2005-2006,2005-12-01,2006-02-28,90,0,0,2,2,0,0,0,2,0,0,CA - Bakersfield
56,2006-2007,2006-12-01,2007-02-28,90,0,0,31,31,0,0,0,31,0,0,CA - Bakersfield
57,2007-2008,2007-12-01,2008-02-29,91,0,0,12,12,0,0,0,12,0,0,CA - Bakersfield
58,2008-2009,2008-12-01,2009-02-28,90,0,0,4,4,0,0,0,4,0,0,CA - Bakersfield
59,2009-2010,2009-12-01,2010-02-28,90,0,0,3,3,0,0,0,3,0,0,CA - Bakersfield
60,2010-2011,2010-12-01,2011-02-28,90,0,0,5,5,0,0,0,5,0,0,CA - Bakersfield
61,2011-2012,2011-12-01,2012-02-29,91,0,0,22,22,0,0,0,22,0,0,CA - Bakersfield
62,2012-2013,2012-12-01,2013-02-28,90,0,0,19,19,0,0,0,19,0,0,CA - Bakersfield
63,2013-2014,2013-12-01,2014-02-28,90,0,0,8,8,0,0,0,8,0,0,CA - Bakersfield
64,2014-2015,2014-12-01,2015-02-28,90,0,0,4,4,0,0,0,4,0,0,CA - Bakersfield
65,2015-2016,2015-12-01,2016-02-29,91,0,0,7,7,0,0,0,7,0,0,CA - Bakersfield
66,2016-2017,2016-12-01,2017-02-28,90,0,0,3,3,0,0,0,3,0,0,CA - Bakersfield
67,2017-2018,2017-12-01,2018-02-28,90,0,0,5,5,0,0,0,5,0,0,CA - Bakersfield
68,2018-2019,2018-12-01,2019-02-28,90,0,0,7,7,0,0,0,7,0,0,CA - Bakersfield
69,2019-2020,2019-12-01,2020-02-29,91,0,0,3,3,0,0,0,3,0,0,CA - Bakersfield
0,1950-1951,1950-12-01,1951-02-28,90,0,0,135,135,3,4,7,142,1,6,CA - Bishop
1,1951-1952,1951-12-01,1952-03-17,108,0,1,224,225,47,70,117,342,11,68,CA - Bishop
2,1952-1953,1952-12-01,1953-02-28,90,0,0,155,155,2,0,2,157,1,4,CA - Bishop
3,1953-1954,1953-12-01,1954-02-28,90,0,0,179,179,0,0,0,179,0,0,CA - Bishop
4,1954-1955,1954-12-01,1955-02-28,90,0,0,273,273,32,86,118,391,5,47,CA - Bishop
5,1955-1956,1955-12-01,1956-04-13,135,0,0,231,231,18,5,23,254,4,22,CA - Bishop
6,1956-1957,1956-12-01,1957-02-28,90,0,1,185,186,0,0,0,186,0,0,CA - Bishop
7,1957-1958,1957-10-20,1958-04-03,166,0,0,225,225,5,2,7,232,4,9,CA - Bishop
8,1958-1959,1958-12-01,1959-02-28,90,0,0,152,152,6,2,8,160,4,13,CA - Bishop
9,1959-1960,1959-12-01,1960-02-29,91,0,0,197,197,2,1,3,200,2,8,CA - Bishop
10,1960-1961,1960-12-01,1961-02-28,90,0,0,163,163,0,0,0,163,0,0,CA - Bishop
11,1961-1962,1961-12-01,1962-03-09,99,0,4,175,179,5,1,6,185,5,23,CA - Bishop
12,1962-1963,1962-12-01,1963-03-17,107,0,0,204,204,4,2,6,210,3,9,CA - Bishop
13,1963-1964,1963-12-01,1964-05-05,157,0,0,250,250,11,17,28,278,4,18,CA - Bishop
14,1964-1965,1964-11-16,1965-04-09,145,0,0,203,203,10,6,16,219,6,22,CA - Bishop
15,1965-1966,1965-12-01,1966-02-28,90,0,0,190,190,0,0,0,190,0,0,CA - Bishop
16,1966-1967,1966-12-01,1967-04-22,143,0,0,163,163,16,19,35,198,6,22,CA - Bishop
17,1967-1968,1967-12-01,1968-02-29,91,0,3,185,188,19,34,53,241,4,36,CA - Bishop
18,1968-1969,1968-12-01,1969-03-18,108,0,1,284,285,82,280,362,647,15,119,CA - Bishop
19,1969-1970,1969-12-01,1970-03-30,120,0,0,180,180,7,1,8,188,2,9,CA - Bishop
20,1970-1971,1970-12-01,1971-04-17,138,0,0,206,206,6,1,7,213,5,12,CA - Bishop
21,1971-1972,1971-12-01,1972-02-29,91,0,0,204,204,2,3,5,209,1,3,CA - Bishop
22,1972-1973,1972-12-01,1973-03-11,101,0,2,195,197,11,16,27,224,5,19,CA - Bishop
23,1973-1974,1973-12-01,1974-03-03,93,0,8,182,190,22,81,103,293,7,40,CA - Bishop
24,1974-1975,1974-12-01,1975-02-28,90,0,0,170,170,0,0,0,170,0,0,CA - Bishop
25,1975-1976,1975-11-28,1976-03-02,96,0,1,187,188,31,33,64,252,5,44,CA - Bishop
26,1976-1977,1976-12-01,1977-03-30,120,0,0,212,212,5,0,5,217,3,11,CA - Bishop
27,1977-1978,1977-12-01,1978-02-28,90,0,0,91,91,11,5,16,107,8,21,CA - Bishop
28,1978-1979,1978-10-30,1979-03-19,141,0,3,236,239,16,14,30,269,9,36,CA - Bishop
29,1979-1980,1979-12-01,1980-05-11,163,1,0,197,197,11,0,11,208,4,15,CA - Bishop
30,1980-1981,1980-12-01,1981-04-02,123,0,0,163,163,14,12,26,189,4,19,CA - Bishop
31,1981-1982,1981-11-27,1982-03-29,123,0,4,199,203,39,58,97,300,7,52,CA - Bishop
32,1982-1983,1982-11-09,1983-03-24,136,0,0,183,183,17,5,22,205,5,25,CA - Bishop
33,1983-1984,1983-11-24,1984-02-29,98,0,0,149,149,2,0,2,151,1,4,CA - Bishop
34,1984-1985,1984-11-27,1985-03-07,101,0,1,216,217,15,57,72,289,7,40,CA - Bishop
35,1985-1986,1985-11-11,1986-02-28,110,0,0,188,188,3,2,5,193,2,5,CA - Bishop
36,1986-1987,1986-12-01,1987-02-28,90,0,2,186,188,3,1,4,192,3,9,CA - Bishop
37,1987-1988,1987-12-01,1988-05-05,157,0,2,225,227,23,13,36,263,8,40,CA - Bishop
38,1988-1989,1988-12-01,1989-02-28,90,10,5,218,223,1,25,26,249,1,3,CA - Bishop
39,1989-1990,1989-12-01,1990-02-28,90,0,1,186,187,1,0,1,188,1,2,CA - Bishop
40,1990-1991,1990-12-01,1991-03-19,109,1,3,257,260,1,0,1,261,1,2,CA - Bishop
41,1991-1992,1991-12-01,1992-02-29,91,5,0,140,140,3,1,4,144,3,7,CA - Bishop
42,1992-1993,1992-12-01,1993-02-28,90,2,0,198,198,37,51,88,286,10,59,CA - Bishop
43,1993-1994,1993-12-01,1994-03-25,115,8,0,224,224,3,0,3,227,3,7,CA - Bishop
44,1994-1995,1994-12-01,1995-02-28,90,0,0,142,142,20,27,47,189,2,21,CA - Bishop
45,1995-1996,1995-12-01,1996-02-29,91,6,0,130,130,0,0,0,130,0,0,CA - Bishop
46,1996-1997,1996-12-01,1997-02-28,90,0,1,123,124,2,1,3,127,1,3,CA - Bishop
48,1998-1999,1998-12-01,1999-04-07,128,3,1,221,222,19,12,31,253,4,24,CA - Bishop
49,1999-2000,1999-12-01,2000-02-29,91,1,0,157,157,0,0,0,157,0,0,CA - Bishop
50,2000-2001,2000-12-01,2001-02-28,90,0,0,187,187,17,25,42,229,3,24,CA - Bishop
51,2001-2002,2001-11-29,2002-02-28,92,0,0,185,185,4,2,6,191,1,8,CA - Bishop
52,2002-2003,2002-12-01,2003-02-28,90,0,0,126,126,1,0,1,127,1,2,CA - Bishop
53,2003-2004,2003-12-01,2004-02-29,91,0,0,174,174,0,0,0,174,0,0,CA - Bishop
56,2006-2007,2006-12-01,2007-02-28,90,3,1,195,196,2,0,2,198,1,3,CA - Bishop
60,2010-2011,2010-12-01,2011-04-09,130,0,1,158,159,5,2,7,166,4,11,CA - Bishop
61,2011-2012,2011-12-01,2012-02-29,91,0,0,205,205,7,5,12,217,2,10,CA - Bishop
62,2012-2013,2012-12-01,2013-02-28,90,0,0,195,195,4,12,16,211,2,10,CA - Bishop
63,2013-2014,2013-12-01,2014-04-01,122,0,0,180,180,2,0,2,182,2,6,CA - Bishop
64,2014-2015,2014-12-01,2015-02-28,90,0,0,104,104,0,0,0,104,0,0,CA - Bishop
65,2015-2016,2015-12-01,2016-02-29,91,0,0,170,170,3,2,5,175,1,4,CA - Bishop
66,2016-2017,2016-12-01,2017-02-28,90,1,0,128,128,12,5,17,145,4,15,CA - Bishop
67,2017-2018,2017-12-01,2018-02-28,90,0,0,162,162,1,0,1,163,1,4,CA - Bishop
68,2018-2019,2018-12-01,2019-02-28,90,0,0,136,136,2,0,2,138,2,3,CA - Bishop
69,2019-2020,2019-11-27,2020-02-29,95,0,3,165,168,10,8,18,186,3,19,CA - Bishop
5,1955-1956,1955-11-14,1956-05-07,176,4,1,166,167,269,410,679,846,38,327,CA - Cherry Valley Dam
6,1956-1957,1956-10-24,1957-05-19,208,1,3,128,131,119,221,340,471,20,156,CA - Cherry Valley Dam
7,1957-1958,1957-12-01,1958-04-13,134,0,0,105,105,209,296,505,610,37,248,CA - Cherry Valley Dam
8,1958-1959,1958-11-15,1959-05-02,169,1,2,102,104,104,169,273,377,16,130,CA - Cherry Valley Dam
9,1959-1960,1959-12-01,1960-04-29,151,3,0,175,175,140,224,364,539,23,186,CA - Cherry Valley Dam
10,1960-1961,1960-11-13,1961-05-12,181,10,0,200,200,99,107,206,406,21,138,CA - Cherry Valley Dam
12,1962-1963,1962-12-01,1963-04-26,147,14,0,116,116,124,100,224,340,17,147,CA - Cherry Valley Dam
14,1964-1965,1964-11-10,1965-04-17,159,14,2,163,165,213,496,709,874,26,251,CA - Cherry Valley Dam
15,1965-1966,1965-11-26,1966-03-04,99,0,2,165,167,135,437,572,739,24,189,CA - Cherry Valley Dam
16,1966-1967,1966-12-01,1967-06-01,183,19,0,174,174,326,468,794,968,34,379,CA - Cherry Valley Dam
17,1967-1968,1967-11-28,1968-05-14,169,18,6,147,153,178,329,507,660,24,221,CA - Cherry Valley Dam
23,1973-1974,1973-11-16,1974-04-27,163,11,3,151,154,191,265,456,610,29,241,CA - Cherry Valley Dam
26,1976-1977,1976-12-01,1977-05-12,163,14,0,110,110,41,106,147,257,13,63,CA - Cherry Valley Dam
29,1979-1980,1979-12-01,1980-05-11,163,8,0,94,94,78,155,233,327,16,96,CA - Cherry Valley Dam
30,1980-1981,1980-12-01,1981-04-19,140,8,1,79,80,89,210,299,379,15,106,CA - Cherry Valley Dam
31,1981-1982,1981-10-29,1982-04-10,164,6,4,151,155,259,752,1011,1166,34,323,CA - Cherry Valley Dam
32,1982-1983,1982-11-08,1983-05-05,179,17,1,152,153,232,567,799,952,44,286,CA - Cherry Valley Dam
33,1983-1984,1983-11-13,1984-04-19,159,16,1,110,111,78,111,189,300,16,99,CA - Cherry Valley Dam
35,1985-1986,1985-10-20,1986-03-18,150,19,0,93,93,80,118,198,291,18,102,CA - Cherry Valley Dam
36,1986-1987,1986-11-28,1987-03-24,117,6,1,115,116,71,157,228,344,16,97,CA - Cherry Valley Dam
38,1988-1989,1988-11-14,1989-04-25,163,18,15,192,207,190,717,907,1114,31,268,CA - Cherry Valley Dam
39,1989-1990,1989-11-26,1990-03-15,110,15,4,124,128,142,368,510,638,18,182,CA - Cherry Valley Dam
40,1990-1991,1990-11-26,1991-05-18,174,4,9,175,184,193,413,606,790,20,241,CA - Cherry Valley Dam
41,1991-1992,1991-12-01,1992-03-16,107,11,1,64,65,92,263,355,420,15,110,CA - Cherry Valley Dam
42,1992-1993,1992-12-01,1993-03-28,118,13,6,124,130,186,865,1051,1181,29,231,CA - Cherry Valley Dam
43,1993-1994,1993-11-12,1994-04-27,167,9,2,113,115,136,395,531,646,18,163,CA - Cherry Valley Dam
44,1994-1995,1994-11-10,1995-05-13,185,12,3,128,131,244,731,975,1106,34,285,CA - Cherry Valley Dam
45,1995-1996,1995-12-01,1996-03-29,120,3,4,76,80,113,316,429,509,21,156,CA - Cherry Valley Dam
47,1997-1998,1997-11-16,1998-05-29,195,6,0,136,136,235,574,809,945,42,286,CA - Cherry Valley Dam
48,1998-1999,1998-11-07,1999-06-03,209,9,5,130,135,208,301,509,644,28,255,CA - Cherry Valley Dam
49,1999-2000,1999-12-01,2000-04-18,140,4,1,71,72,104,215,319,391,18,125,CA - Cherry Valley Dam
50,2000-2001,2000-10-29,2001-04-23,177,15,2,125,127,181,587,768,895,24,217,CA - Cherry Valley Dam
51,2001-2002,2001-11-25,2002-05-21,178,2,2,128,130,159,518,677,807,32,205,CA - Cherry Valley Dam
52,2002-2003,2002-12-01,2003-05-09,160,6,0,81,81,138,332,470,551,20,163,CA - Cherry Valley Dam
53,2003-2004,2003-11-01,2004-04-17,169,1,2,114,116,149,603,752,868,28,182,CA - Cherry Valley Dam
54,2004-2005,2004-10-21,2005-04-10,172,3,0,92,92,192,527,719,811,32,228,CA - Cherry Valley Dam
55,2005-2006,2005-12-01,2006-04-17,138,16,4,120,124,170,400,570,694,31,223,CA - Cherry Valley Dam
56,2006-2007,2006-11-27,2007-05-04,159,12,3,103,106,107,194,301,407,20,132,CA - Cherry Valley Dam
57,2007-2008,2007-12-01,2008-03-26,117,4,2,105,107,168,937,1105,1212,26,208,CA - Cherry Valley Dam
58,2008-2009,2008-12-01,2009-04-10,131,9,8,111,119,195,554,749,868,28,243,CA - Cherry Valley Dam
64,2014-2015,2014-12-01,2015-04-25,146,0,0,36,36,24,19,43,79,5,29,CA - Cherry Valley Dam
66,2016-2017,2016-11-27,2017-03-08,102,16,1,78,79,131,411,542,621,19,159,CA - Cherry Valley Dam
67,2017-2018,2017-11-27,2018-04-16,141,12,0,82,82,121,243,364,446,19,153,CA - Cherry Valley Dam
68,2018-2019,2018-11-30,2019-05-27,179,0,6,121,127,218,554,772,899,27,267,CA - Cherry Valley Dam
69,2019-2020,2019-11-27,2020-04-08,134,2,1,90,91,112,150,262,353,20,138,CA - Cherry Valley Dam
0,1950-1951,1950-12-01,1951-02-28,90,0,0,5,5,0,0,0,5,0,0,CA - Death Valley
1,1951-1952,1951-12-01,1952-02-29,91,0,0,15,15,0,0,0,15,0,0,CA - Death Valley
2,1952-1953,1952-12-01,1953-02-28,90,0,0,2,2,0,0,0,2,0,0,CA - Death Valley
3,1953-1954,1953-12-01,1954-02-28,90,0,0,12,12,0,0,0,12,0,0,CA - Death Valley
4,1954-1955,1954-12-01,1955-02-28,90,2,0,11,11,0,0,0,11,0,0,CA - Death Valley
5,1955-1956,1955-12-01,1956-02-29,91,1,0,9,9,0,0,0,9,0,0,CA - Death Valley
6,1956-1957,1956-12-01,1957-02-28,90,4,0,11,11,0,0,0,11,0,0,CA - Death Valley
8,1958-1959,1958-12-01,1959-02-28,90,0,0,2,2,0,0,0,2,0,0,CA - Death Valley
9,1959-1960,1959-12-01,1960-02-29,91,0,0,5,5,0,0,0,5,0,0,CA - Death Valley
10,1960-1961,1960-12-01,1961-02-28,90,0,0,9,9,0,0,0,9,0,0,CA - Death Valley
11,1961-1962,1961-12-01,1962-02-28,90,0,0,13,13,0,0,0,13,0,0,CA - Death Valley
12,1962-1963,1962-12-01,1963-02-28,90,0,0,22,22,0,0,0,22,0,0,CA - Death Valley
13,1963-1964,1963-12-01,1964-02-29,91,0,0,15,15,0,0,0,15,0,0,CA - Death Valley
14,1964-1965,1964-12-01,1965-02-28,90,0,0,11,11,0,0,0,11,0,0,CA - Death Valley
15,1965-1966,1965-12-01,1966-02-28,90,4,0,16,16,0,0,0,16,0,0,CA - Death Valley
16,1966-1967,1966-12-01,1967-02-28,90,2,0,8,8,0,0,0,8,0,0,CA - Death Valley
17,1967-1968,1967-12-01,1968-02-29,91,0,0,15,15,0,0,0,15,0,0,CA - Death Valley
18,1968-1969,1968-12-01,1969-02-28,90,0,0,18,18,0,0,0,18,0,0,CA - Death Valley
19,1969-1970,1969-12-01,1970-02-28,90,1,0,7,7,0,0,0,7,0,0,CA - Death Valley
20,1970-1971,1970-12-01,1971-02-28,90,0,0,5,5,0,0,0,5,0,0,CA - Death Valley
21,1971-1972,1971-12-01,1972-02-29,91,0,0,18,18,0,0,0,18,0,0,CA - Death Valley
22,1972-1973,1972-12-01,1973-02-28,90,1,0,21,21,0,0,0,21,0,0,CA - Death Valley
23,1973-1974,1973-12-01,1974-02-28,90,0,0,4,4,0,0,0,4,0,0,CA - Death Valley
24,1974-1975,1974-12-01,1975-02-28,90,0,0,4,4,0,0,0,4,0,0,CA - Death Valley
25,1975-1976,1975-12-01,1976-02-29,91,0,0,5,5,0,0,0,5,0,0,CA - Death Valley
26,1976-1977,1976-12-01,1977-02-28,90,0,0,16,16,0,0,0,16,0,0,CA - Death Valley
27,1977-1978,1977-12-01,1978-02-28,90,0,0,0,0,0,0,0,0,0,0,CA - Death Valley
28,1978-1979,1978-12-01,1979-02-28,90,0,0,9,9,0,0,0,9,0,0,CA - Death Valley
29,1979-1980,1979-12-01,1980-02-29,91,1,0,3,3,0,0,0,3,0,0,CA - Death Valley
30,1980-1981,1980-12-01,1981-02-28,90,0,0,1,1,0,0,0,1,0,0,CA - Death Valley
31,1981-1982,1981-12-01,1982-02-28,90,0,0,4,4,0,0,0,4,0,0,CA - Death Valley
32,1982-1983,1982-12-01,1983-02-28,90,2,0,15,15,0,0,0,15,0,0,CA - Death Valley
33,1983-1984,1983-12-01,1984-02-29,91,0,0,2,2,0,0,0,2,0,0,CA - Death Valley
34,1984-1985,1984-12-01,1985-02-28,90,0,0,14,14,0,0,0,14,0,0,CA - Death Valley
35,1985-1986,1985-12-01,1986-02-28,90,5,0,6,6,0,0,0,6,0,0,CA - Death Valley
36,1986-1987,1986-12-01,1987-02-28,90,2,0,1,1,0,0,0,1,0,0,CA - Death Valley
38,1988-1989,1988-12-01,1989-02-28,90,0,0,20,20,0,0,0,20,0,0,CA - Death Valley
39,1989-1990,1989-12-01,1990-02-28,90,0,0,25,25,0,0,0,25,0,0,CA - Death Valley
40,1990-1991,1990-12-01,1991-02-28,90,2,0,39,39,0,0,0,39,0,0,CA - Death Valley
41,1991-1992,1991-12-01,1992-02-29,91,0,0,6,6,0,0,0,6,0,0,CA - Death Valley
42,1992-1993,1992-12-01,1993-02-28,90,0,0,14,14,0,0,0,14,0,0,CA - Death Valley
43,1993-1994,1993-12-01,1994-02-28,90,0,0,12,12,0,0,0,12,0,0,CA - Death Valley
44,1994-1995,1994-12-01,1995-02-28,90,0,0,14,14,0,0,0,14,0,0,CA - Death Valley
45,1995-1996,1995-12-01,1996-02-29,91,0,0,6,6,0,0,0,6,0,0,CA - Death Valley
46,1996-1997,1996-12-01,1997-02-28,90,0,0,18,18,0,0,0,18,0,0,CA - Death Valley
47,1997-1998,1997-12-01,1998-02-28,90,0,0,13,13,0,0,0,13,0,0,CA - Death Valley
48,1998-1999,1998-12-01,1999-02-28,90,0,0,13,13,0,0,0,13,0,0,CA - Death Valley
49,1999-2000,1999-12-01,2000-02-29,91,0,0,15,15,0,0,0,15,0,0,CA - Death Valley
50,2000-2001,2000-12-01,2001-02-28,90,0,0,14,14,0,0,0,14,0,0,CA - Death Valley
51,2001-2002,2001-12-01,2002-02-28,90,3,0,13,13,0,0,0,13,0,0,CA - Death Valley
52,2002-2003,2002-12-01,2003-02-28,90,0,0,1,1,0,0,0,1,0,0,CA - Death Valley
53,2003-2004,2003-12-01,2004-02-29,91,0,0,4,4,0,0,0,4,0,0,CA - Death Valley
54,2004-2005,2004-12-01,2005-02-28,90,0,0,2,2,0,0,0,2,0,0,CA - Death Valley
55,2005-2006,2005-12-01,2006-02-28,90,0,0,4,4,0,0,0,4,0,0,CA - Death Valley
56,2006-2007,2006-12-01,2007-02-28,90,0,0,12,12,0,0,0,12,0,0,CA - Death Valley
57,2007-2008,2007-12-01,2008-02-29,91,0,0,6,6,0,0,0,6,0,0,CA - Death Valley
58,2008-2009,2008-12-01,2009-02-28,90,1,0,7,7,0,0,0,7,0,0,CA - Death Valley
59,2009-2010,2009-12-01,2010-02-28,90,0,0,11,11,0,0,0,11,0,0,CA - Death Valley
60,2010-2011,2010-12-01,2011-02-28,90,0,0,4,4,0,0,0,4,0,0,CA - Death Valley
61,2011-2012,2011-12-01,2012-02-29,91,0,0,8,8,0,0,0,8,0,0,CA - Death Valley
62,2012-2013,2012-12-01,2013-02-28,90,0,0,5,5,0,0,0,5,0,0,CA - Death Valley
63,2013-2014,2013-12-01,2014-02-28,90,0,0,8,8,0,0,0,8,0,0,CA - Death Valley
64,2014-2015,2014-12-01,2015-02-28,90,0,0,5,5,0,0,0,5,0,0,CA - Death Valley
65,2015-2016,2015-12-01,2016-02-29,91,0,0,10,10,0,0,0,10,0,0,CA - Death Valley
66,2016-2017,2016-12-01,2017-02-28,90,0,0,4,4,0,0,0,4,0,0,CA - Death Valley
67,2017-2018,2017-12-01,2018-02-28,90,0,0,0,0,0,0,0,0,0,0,CA - Death Valley
68,2018-2019,2018-12-01,2019-02-28,90,0,0,2,2,0,0,0,2,0,0,CA - Death Valley
69,2019-2020,2019-12-01,2020-02-29,91,0,0,1,1,0,0,0,1,0,0,CA - Death Valley
0,1950-1951,1950-12-01,1951-02-28,90,0,0,2,2,0,0,0,2,0,0,CA - Eureka
1,1951-1952,1951-12-01,1952-02-29,91,0,0,5,5,3,0,3,8,2,3,CA - Eureka
2,1952-1953,1952-12-01,1953-02-28,90,0,0,0,0,0,0,0,0,0,0,CA - Eureka
3,1953-1954,1953-12-01,1954-02-28,90,0,0,1,1,0,0,0,1,0,0,CA - Eureka
4,1954-1955,1954-12-01,1955-02-28,90,0,0,7,7,1,0,1,8,1,1,CA - Eureka
5,1955-1956,1955-12-01,1956-02-29,91,0,0,6,6,0,0,0,6,0,0,CA - Eureka
6,1956-1957,1956-12-01,1957-02-28,90,0,0,9,9,0,0,0,9,0,0,CA - Eureka
7,1957-1958,1957-12-01,1958-02-28,90,0,0,0,0,0,0,0,0,0,0,CA - Eureka
8,1958-1959,1958-12-01,1959-02-28,90,0,0,0,0,0,0,0,0,0,0,CA - Eureka
9,1959-1960,1959-12-01,1960-02-29,91,0,0,6,6,0,0,0,6,0,0,CA - Eureka
10,1960-1961,1960-12-01,1961-02-28,90,0,0,0,0,0,0,0,0,0,0,CA - Eureka
11,1961-1962,1961-12-01,1962-02-28,90,0,0,7,7,1,0,1,8,1,2,CA - Eureka
12,1962-1963,1962-12-01,1963-02-28,90,0,0,3,3,0,0,0,3,0,0,CA - Eureka
13,1963-1964,1963-12-01,1964-02-29,91,0,0,0,0,0,0,0,0,0,0,CA - Eureka
14,1964-1965,1964-12-01,1965-02-28,90,0,0,3,3,1,0,1,4,1,2,CA - Eureka
15,1965-1966,1965-12-01,1966-03-02,92,0,0,6,6,2,1,3,9,2,3,CA - Eureka
16,1966-1967,1966-12-01,1967-02-28,90,0,0,2,2,0,0,0,2,0,0,CA - Eureka
17,1967-1968,1967-12-01,1968-02-29,91,0,0,5,5,0,0,0,5,0,0,CA - Eureka
18,1968-1969,1968-12-01,1969-02-28,90,0,0,5,5,1,0,1,6,1,1,CA - Eureka
19,1969-1970,1969-12-01,1970-02-28,90,0,0,0,0,0,0,0,0,0,0,CA - Eureka
20,1970-1971,1970-12-01,1971-02-28,90,0,0,5,5,0,0,0,5,0,0,CA - Eureka
21,1971-1972,1971-12-01,1972-02-29,91,0,0,8,8,2,0,2,10,2,4,CA - Eureka
22,1972-1973,1972-12-01,1973-02-28,90,0,0,11,11,2,0,2,13,1,3,CA - Eureka
23,1973-1974,1973-12-01,1974-02-28,90,0,0,5,5,0,0,0,5,0,0,CA - Eureka
24,1974-1975,1974-12-01,1975-02-28,90,0,0,9,9,0,0,0,9,0,0,CA - Eureka
25,1975-1976,1975-12-01,1976-03-01,92,0,0,6,6,1,0,1,7,1,2,CA - Eureka
26,1976-1977,1976-12-01,1977-02-28,90,0,0,1,1,0,0,0,1,0,0,CA - Eureka
27,1977-1978,1977-11-19,1978-02-28,102,0,0,2,2,1,0,1,3,1,2,CA - Eureka
28,1978-1979,1978-12-01,1979-02-28,90,0,0,16,16,0,0,0,16,0,0,CA - Eureka
29,1979-1980,1979-12-01,1980-02-29,91,0,0,3,3,0,0,0,3,0,0,CA - Eureka
30,1980-1981,1980-12-01,1981-02-28,90,0,0,1,1,0,0,0,1,0,0,CA - Eureka
31,1981-1982,1981-12-01,1982-02-28,90,0,0,4,4,0,0,0,4,0,0,CA - Eureka
32,1982-1983,1982-12-01,1983-02-28,90,0,0,1,1,0,0,0,1,0,0,CA - Eureka
33,1983-1984,1983-12-01,1984-02-29,91,0,0,3,3,2,0,2,5,1,3,CA - Eureka
34,1984-1985,1984-12-01,1985-02-28,90,0,0,2,2,0,0,0,2,0,0,CA - Eureka
35,1985-1986,1985-12-01,1986-02-28,90,0,0,1,1,0,0,0,1,0,0,CA - Eureka
36,1986-1987,1986-12-01,1987-02-28,90,0,0,2,2,0,0,0,2,0,0,CA - Eureka
37,1987-1988,1987-12-01,1988-02-29,91,0,0,2,2,0,0,0,2,0,0,CA - Eureka
38,1988-1989,1988-12-01,1989-02-28,90,0,0,8,8,5,1,6,14,2,7,CA - Eureka
39,1989-1990,1989-12-01,1990-02-28,90,0,0,4,4,2,0,2,6,1,2,CA - Eureka
40,1990-1991,1990-12-01,1991-02-28,90,0,0,13,13,0,0,0,13,0,0,CA - Eureka
41,1991-1992,1991-12-01,1992-02-29,91,0,0,1,1,0,0,0,1,0,0,CA - Eureka
42,1992-1993,1992-12-01,1993-02-28,90,0,0,2,2,0,0,0,2,0,0,CA - Eureka
43,1993-1994,1993-12-01,1994-02-28,90,0,0,0,0,0,0,0,0,0,0,CA - Eureka
44,1994-1995,1994-12-01,1995-02-28,90,0,0,6,6,0,0,0,6,0,0,CA - Eureka
45,1995-1996,1995-12-01,1996-02-29,91,0,0,2,2,0,0,0,2,0,0,CA - Eureka
46,1996-1997,1996-12-01,1997-02-28,90,0,0,6,6,0,0,0,6,0,0,CA - Eureka
47,1997-1998,1997-12-01,1998-02-28,90,0,0,4,4,0,0,0,4,0,0,CA - Eureka
48,1998-1999,1998-12-01,1999-03-30,120,0,0,17,17,1,0,1,18,1,1,CA - Eureka
49,1999-2000,1999-12-01,2000-02-29,91,0,0,0,0,0,0,0,0,0,0,CA - Eureka
50,2000-2001,2000-12-01,2001-02-28,90,0,0,10,10,0,0,0,10,0,0,CA - Eureka
51,2001-2002,2001-12-01,2002-02-28,90,0,0,7,7,2,0,2,9,2,2,CA - Eureka
52,2002-2003,2002-12-01,2003-04-02,123,0,0,2,2,1,0,1,3,1,1,CA - Eureka
53,2003-2004,2003-12-01,2004-02-29,91,0,0,2,2,0,0,0,2,0,0,CA - Eureka
54,2004-2005,2004-12-01,2005-02-28,90,0,0,3,3,0,0,0,3,0,0,CA - Eureka
55,2005-2006,2005-12-01,2006-02-28,90,0,0,8,8,0,0,0,8,0,0,CA - Eureka
56,2006-2007,2006-12-01,2007-02-28,90,0,0,12,12,0,0,0,12,0,0,CA - Eureka
57,2007-2008,2007-12-01,2008-02-29,91,0,0,14,14,0,0,0,14,0,0,CA - Eureka
58,2008-2009,2008-12-01,2009-02-28,90,0,0,5,5,0,0,0,5,0,0,CA - Eureka
59,2009-2010,2009-12-01,2010-02-28,90,0,0,6,6,0,0,0,6,0,0,CA - Eureka
60,2010-2011,2010-12-01,2011-02-28,90,0,0,7,7,0,0,0,7,0,0,CA - Eureka
61,2011-2012,2011-12-01,2012-02-29,91,0,0,7,7,0,0,0,7,0,0,CA - Eureka
62,2012-2013,2012-12-01,2013-02-28,90,0,0,18,18,0,0,0,18,0,0,CA - Eureka
63,2013-2014,2013-12-01,2014-02-28,90,0,0,13,13,0,0,0,13,0,0,CA - Eureka
64,2014-2015,2014-12-01,2015-02-28,90,0,0,3,3,0,0,0,3,0,0,CA - Eureka
65,2015-2016,2015-12-01,2016-02-29,91,0,0,5,5,0,0,0,5,0,0,CA - Eureka
66,2016-2017,2016-12-01,2017-02-28,90,0,0,9,9,0,0,0,9,0,0,CA - Eureka
67,2017-2018,2017-12-01,2018-02-28,90,0,0,6,6,0,0,0,6,0,0,CA - Eureka
68,2018-2019,2018-12-01,2019-02-28,90,0,0,8,8,1,0,1,9,1,2,CA - Eureka
69,2019-2020,2019-12-01,2020-02-29,91,0,0,3,3,0,0,0,3,0,0,CA - Eureka
0,1950-1951,1950-12-01,1951-02-28,90,15,0,9,9,0,0,0,9,0,0,CA - Fairfield
1,1951-1952,1951-12-01,1952-02-29,91,4,0,23,23,0,0,0,23,0,0,CA - Fairfield
3,1953-1954,1953-12-01,1954-02-28,90,8,0,24,24,0,0,0,24,0,0,CA - Fairfield
5,1955-1956,1955-12-01,1956-02-29,91,2,0,18,18,0,0,0,18,0,0,CA - Fairfield
7,1957-1958,1957-12-01,1958-02-28,90,20,0,8,8,0,0,0,8,0,0,CA - Fairfield
8,1958-1959,1958-12-01,1959-02-28,90,1,0,4,4,0,0,0,4,0,0,CA - Fairfield
9,1959-1960,1959-12-01,1960-02-29,91,1,0,22,22,0,0,0,22,0,0,CA - Fairfield
10,1960-1961,1960-12-01,1961-02-28,90,0,0,17,17,0,0,0,17,0,0,CA - Fairfield
11,1961-1962,1961-12-01,1962-02-28,90,0,0,28,28,0,0,0,28,0,0,CA - Fairfield
12,1962-1963,1962-12-01,1963-02-28,90,1,0,28,28,0,0,0,28,0,0,CA - Fairfield
14,1964-1965,1964-12-01,1965-02-28,90,0,0,6,6,0,0,0,6,0,0,CA - Fairfield
15,1965-1966,1965-12-01,1966-02-28,90,0,0,25,25,0,0,0,25,0,0,CA - Fairfield
16,1966-1967,1966-12-01,1967-02-28,90,0,0,15,15,0,0,0,15,0,0,CA - Fairfield
17,1967-1968,1967-12-01,1968-02-29,91,3,0,28,28,0,0,0,28,0,0,CA - Fairfield
18,1968-1969,1968-12-01,1969-02-28,90,1,0,19,19,0,0,0,19,0,0,CA - Fairfield
19,1969-1970,1969-12-01,1970-02-28,90,0,0,13,13,0,0,0,13,0,0,CA - Fairfield
20,1970-1971,1970-12-01,1971-02-28,90,1,0,15,15,0,0,0,15,0,0,CA - Fairfield
21,1971-1972,1971-12-01,1972-02-29,91,0,0,33,33,0,0,0,33,0,0,CA - Fairfield
22,1972-1973,1972-12-01,1973-02-28,90,0,1,29,30,0,0,0,30,0,0,CA - Fairfield
23,1973-1974,1973-12-01,1974-02-28,90,0,0,8,8,0,0,0,8,0,0,CA - Fairfield
24,1974-1975,1974-12-01,1975-02-28,90,0,0,25,25,0,0,0,25,0,0,CA - Fairfield
25,1975-1976,1975-12-01,1976-02-29,91,0,0,26,26,0,0,0,26,0,0,CA - Fairfield
26,1976-1977,1976-12-01,1977-02-28,90,0,0,39,39,0,0,0,39,0,0,CA - Fairfield
27,1977-1978,1977-12-01,1978-02-28,90,1,0,0,0,0,0,0,0,0,0,CA - Fairfield
28,1978-1979,1978-12-01,1979-02-28,90,0,0,29,29,0,0,0,29,0,0,CA - Fairfield
29,1979-1980,1979-12-01,1980-02-29,91,1,0,15,15,0,0,0,15,0,0,CA - Fairfield
30,1980-1981,1980-12-01,1981-02-28,90,2,0,27,27,0,0,0,27,0,0,CA - Fairfield
31,1981-1982,1981-12-01,1982-02-28,90,7,0,17,17,0,0,0,17,0,0,CA - Fairfield
32,1982-1983,1982-12-01,1983-02-28,90,3,0,11,11,0,0,0,11,0,0,CA - Fairfield
33,1983-1984,1983-12-01,1984-02-29,91,3,0,12,12,0,0,0,12,0,0,CA - Fairfield
34,1984-1985,1984-12-01,1985-02-28,90,6,0,52,52,0,0,0,52,0,0,CA - Fairfield
35,1985-1986,1985-12-01,1986-02-28,90,4,0,44,44,0,0,0,44,0,0,CA - Fairfield
36,1986-1987,1986-12-01,1987-02-28,90,3,0,11,11,0,0,0,11,0,0,CA - Fairfield
37,1987-1988,1987-12-01,1988-02-29,91,9,0,6,6,0,0,0,6,0,0,CA - Fairfield
38,1988-1989,1988-12-01,1989-02-28,90,9,0,18,18,2,0,2,20,1,3,CA - Fairfield
39,1989-1990,1989-12-01,1990-02-28,90,5,0,17,17,0,0,0,17,0,0,CA - Fairfield
40,1990-1991,1990-12-01,1991-02-28,90,3,0,28,28,0,0,0,28,0,0,CA - Fairfield
41,1991-1992,1991-12-01,1992-02-29,91,3,0,7,7,0,0,0,7,0,0,CA - Fairfield
42,1992-1993,1992-12-01,1993-02-28,90,9,0,12,12,0,0,0,12,0,0,CA - Fairfield
43,1993-1994,1993-12-01,1994-02-28,90,11,0,11,11,0,0,0,11,0,0,CA - Fairfield
44,1994-1995,1994-12-01,1995-02-28,90,19,0,1,1,0,0,0,1,0,0,CA - Fairfield
45,1995-1996,1995-12-01,1996-02-29,91,14,0,0,0,0,0,0,0,0,0,CA - Fairfield
46,1996-1997,1996-12-01,1997-02-28,90,6,0,4,4,0,0,0,4,0,0,CA - Fairfield
47,1997-1998,1997-12-01,1998-02-28,90,14,0,4,4,0,0,0,4,0,0,CA - Fairfield
48,1998-1999,1998-12-01,1999-02-28,90,3,0,28,28,0,0,0,28,0,0,CA - Fairfield
49,1999-2000,1999-12-01,2000-02-29,91,5,0,1,1,0,0,0,1,0,0,CA - Fairfield
50,2000-2001,2000-12-01,2001-02-28,90,6,0,5,5,0,0,0,5,0,0,CA - Fairfield
51,2001-2002,2001-12-01,2002-02-28,90,9,0,5,5,0,0,0,5,0,0,CA - Fairfield
52,2002-2003,2002-12-01,2003-02-28,90,17,0,0,0,0,0,0,0,0,0,CA - Fairfield
53,2003-2004,2003-12-01,2004-02-29,91,8,0,8,8,0,0,0,8,0,0,CA - Fairfield
54,2004-2005,2004-12-01,2005-02-28,90,8,0,6,6,0,0,0,6,0,0,CA - Fairfield
55,2005-2006,2005-12-01,2006-02-28,90,0,0,3,3,0,0,0,3,0,0,CA - Fairfield
56,2006-2007,2006-12-01,2007-02-28,90,0,0,27,27,0,0,0,27,0,0,CA - Fairfield
57,2007-2008,2007-12-01,2008-02-29,91,0,0,4,4,0,0,0,4,0,0,CA - Fairfield
58,2008-2009,2008-12-01,2009-02-28,90,0,0,5,5,0,0,0,5,0,0,CA - Fairfield
59,2009-2010,2009-12-01,2010-02-28,90,0,0,6,6,0,0,0,6,0,0,CA - Fairfield
66,2016-2017,2016-12-01,2017-02-28,90,4,0,6,6,0,0,0,6,0,0,CA - Fairfield
67,2017-2018,2017-12-01,2018-02-28,90,4,0,6,6,0,0,0,6,0,0,CA - Fairfield
68,2018-2019,2018-12-01,2019-02-28,90,0,0,4,4,0,0,0,4,0,0,CA - Fairfield
69,2019-2020,2019-12-01,2020-02-29,91,0,0,0,0,0,0,0,0,0,0,CA - Fairfield
0,1950-1951,1950-12-01,1951-02-28,90,0,0,16,16,0,0,0,16,0,0,CA - Fresno
1,1951-1952,1951-12-01,1952-02-29,91,0,0,26,26,0,0,0,26,0,0,CA - Fresno
2,1952-1953,1952-12-01,1953-02-28,90,0,0,14,14,0,0,0,14,0,0,CA - Fresno
3,1953-1954,1953-12-01,1954-02-28,90,0,0,23,23,0,0,0,23,0,0,CA - Fresno
4,1954-1955,1954-12-01,1955-02-28,90,0,0,34,34,0,0,0,34,0,0,CA - Fresno
5,1955-1956,1955-12-01,1956-02-29,91,0,0,15,15,0,0,0,15,0,0,CA - Fresno
6,1956-1957,1956-12-01,1957-02-28,90,0,0,33,33,1,0,1,34,1,2,CA - Fresno
7,1957-1958,1957-12-01,1958-02-28,90,0,0,10,10,0,0,0,10,0,0,CA - Fresno
8,1958-1959,1958-12-01,1959-02-28,90,0,0,12,12,0,0,0,12,0,0,CA - Fresno
9,1959-1960,1959-12-01,1960-02-29,91,0,0,32,32,0,0,0,32,0,0,CA - Fresno
10,1960-1961,1960-12-01,1961-02-28,90,0,0,24,24,0,0,0,24,0,0,CA - Fresno
11,1961-1962,1961-12-01,1962-02-28,90,0,0,25,25,3,0,3,28,2,4,CA - Fresno
12,1962-1963,1962-12-01,1963-02-28,90,0,0,44,44,0,0,0,44,0,0,CA - Fresno
13,1963-1964,1963-12-01,1964-02-29,91,0,0,31,31,0,0,0,31,0,0,CA - Fresno
14,1964-1965,1964-12-01,1965-02-28,90,0,0,14,14,0,0,0,14,0,0,CA - Fresno
15,1965-1966,1965-12-01,1966-02-28,90,0,0,40,40,0,0,0,40,0,0,CA - Fresno
16,1966-1967,1966-12-01,1967-02-28,90,0,0,16,16,0,0,0,16,0,0,CA - Fresno
17,1967-1968,1967-12-01,1968-02-29,91,0,0,24,24,0,0,0,24,0,0,CA - Fresno
18,1968-1969,1968-12-01,1969-02-28,90,0,0,19,19,2,1,3,22,1,3,CA - Fresno
19,1969-1970,1969-12-01,1970-02-28,90,0,0,29,29,0,0,0,29,0,0,CA - Fresno
20,1970-1971,1970-12-01,1971-02-28,90,0,0,20,20,0,0,0,20,0,0,CA - Fresno
21,1971-1972,1971-12-01,1972-02-29,91,0,0,28,28,0,0,0,28,0,0,CA - Fresno
22,1972-1973,1972-12-01,1973-02-28,90,0,2,28,30,0,0,0,30,0,0,CA - Fresno
23,1973-1974,1973-12-01,1974-02-28,90,0,0,5,5,0,0,0,5,0,0,CA - Fresno
24,1974-1975,1974-12-01,1975-02-28,90,0,0,27,27,0,0,0,27,0,0,CA - Fresno
25,1975-1976,1975-12-01,1976-02-29,91,0,0,41,41,0,0,0,41,0,0,CA - Fresno
26,1976-1977,1976-12-01,1977-02-28,90,0,0,25,25,0,0,0,25,0,0,CA - Fresno
27,1977-1978,1977-12-01,1978-02-28,90,0,0,0,0,0,0,0,0,0,0,CA - Fresno
28,1978-1979,1978-12-01,1979-02-28,90,0,0,19,19,0,0,0,19,0,0,CA - Fresno
29,1979-1980,1979-12-01,1980-02-29,91,0,0,14,14,0,0,0,14,0,0,CA - Fresno
30,1980-1981,1980-12-01,1981-02-28,90,0,0,12,12,0,0,0,12,0,0,CA - Fresno
31,1981-1982,1981-12-01,1982-02-28,90,0,0,17,17,0,0,0,17,0,0,CA - Fresno
32,1982-1983,1982-12-01,1983-02-28,90,0,0,4,4,0,0,0,4,0,0,CA - Fresno
33,1983-1984,1983-12-01,1984-02-29,91,0,0,0,0,0,0,0,0,0,0,CA - Fresno
34,1984-1985,1984-12-01,1985-02-28,90,0,0,12,12,0,0,0,12,0,0,CA - Fresno
35,1985-1986,1985-12-01,1986-02-28,90,0,0,4,4,0,0,0,4,0,0,CA - Fresno
36,1986-1987,1986-12-01,1987-02-28,90,0,0,9,9,0,0,0,9,0,0,CA - Fresno
37,1987-1988,1987-12-01,1988-02-29,91,0,0,32,32,0,0,0,32,0,0,CA - Fresno
38,1988-1989,1988-12-01,1989-02-28,90,0,0,34,34,0,0,0,34,0,0,CA - Fresno
39,1989-1990,1989-12-01,1990-02-28,90,0,0,35,35,0,0,0,35,0,0,CA - Fresno
40,1990-1991,1990-12-01,1991-02-28,90,0,0,46,46,0,0,0,46,0,0,CA - Fresno
41,1991-1992,1991-12-01,1992-02-29,91,0,0,11,11,0,0,0,11,0,0,CA - Fresno
42,1992-1993,1992-12-01,1993-02-28,90,0,0,13,13,0,0,0,13,0,0,CA - Fresno
43,1993-1994,1993-12-01,1994-02-28,90,0,0,13,13,0,0,0,13,0,0,CA - Fresno
44,1994-1995,1994-12-01,1995-02-28,90,0,0,6,6,0,0,0,6,0,0,CA - Fresno
45,1995-1996,1995-12-01,1996-02-29,91,0,0,4,4,0,0,0,4,0,0,CA - Fresno
46,1996-1997,1996-12-01,1997-02-28,90,0,0,5,5,0,0,0,5,0,0,CA - Fresno
47,1997-1998,1997-12-01,1998-02-28,90,0,0,11,11,0,0,0,11,0,0,CA - Fresno
48,1998-1999,1998-12-01,1999-02-28,90,0,0,29,29,1,0,1,30,1,2,CA - Fresno
49,1999-2000,1999-12-01,2000-02-29,91,0,0,14,14,0,0,0,14,0,0,CA - Fresno
50,2000-2001,2000-12-01,2001-02-28,90,0,0,17,17,0,0,0,17,0,0,CA - Fresno
51,2001-2002,2001-12-01,2002-02-28,90,0,0,17,17,0,0,0,17,0,0,CA - Fresno
52,2002-2003,2002-12-01,2003-02-28,90,0,0,1,1,0,0,0,1,0,0,CA - Fresno
53,2003-2004,2003-12-01,2004-02-29,91,0,0,5,5,0,0,0,5,0,0,CA - Fresno
54,2004-2005,2004-12-01,2005-02-28,90,0,0,6,6,0,0,0,6,0,0,CA - Fresno
55,2005-2006,2005-12-01,2006-02-28,90,0,0,2,2,0,0,0,2,0,0,CA - Fresno
56,2006-2007,2006-12-01,2007-02-28,90,0,0,30,30,0,0,0,30,0,0,CA - Fresno
57,2007-2008,2007-12-01,2008-02-29,91,0,0,12,12,0,0,0,12,0,0,CA - Fresno
58,2008-2009,2008-12-01,2009-02-28,90,0,0,9,9,0,0,0,9,0,0,CA - Fresno
59,2009-2010,2009-12-01,2010-02-28,90,0,0,5,5,0,0,0,5,0,0,CA - Fresno
60,2010-2011,2010-12-01,2011-02-28,90,0,0,3,3,0,0,0,3,0,0,CA - Fresno
61,2011-2012,2011-12-01,2012-02-29,91,0,0,21,21,0,0,0,21,0,0,CA - Fresno
62,2012-2013,2012-12-01,2013-02-28,90,0,0,10,10,0,0,0,10,0,0,CA - Fresno
63,2013-2014,2013-12-01,2014-02-28,90,0,0,10,10,0,0,0,10,0,0,CA - Fresno
64,2014-2015,2014-12-01,2015-02-28,90,0,0,8,8,0,0,0,8,0,0,CA - Fresno
65,2015-2016,2015-12-01,2016-02-29,91,0,0,11,11,0,0,0,11,0,0,CA - Fresno
66,2016-2017,2016-12-01,2017-02-28,90,0,0,11,11,0,0,0,11,0,0,CA - Fresno
67,2017-2018,2017-12-01,2018-02-28,90,0,0,6,6,0,0,0,6,0,0,CA - Fresno
68,2018-2019,2018-12-01,2019-02-28,90,0,0,1,1,0,0,0,1,0,0,CA - Fresno
69,2019-2020,2019-12-01,2020-02-29,91,0,0,1,1,0,0,0,1,0,0,CA - Fresno
0,1950-1951,1950-12-01,1951-02-28,90,0,0,19,19,0,0,0,19,0,0,CA - Orland
1,1951-1952,1951-12-01,1952-02-29,91,0,0,27,27,0,0,0,27,0,0,CA - Orland
2,1952-1953,1952-12-01,1953-02-28,90,0,0,7,7,0,0,0,7,0,0,CA - Orland
3,1953-1954,1953-12-01,1954-02-28,90,0,0,24,24,0,0,0,24,0,0,CA - Orland
4,1954-1955,1954-12-01,1955-02-28,90,0,0,40,40,0,0,0,40,0,0,CA - Orland
5,1955-1956,1955-12-01,1956-02-29,91,1,0,22,22,0,0,0,22,0,0,CA - Orland
6,1956-1957,1956-12-01,1957-02-28,90,1,0,59,59,0,0,0,59,0,0,CA - Orland
7,1957-1958,1957-12-01,1958-02-28,90,6,0,10,10,0,0,0,10,0,0,CA - Orland
8,1958-1959,1958-12-01,1959-02-28,90,0,0,12,12,0,0,0,12,0,0,CA - Orland
9,1959-1960,1959-12-01,1960-02-29,91,0,0,39,39,0,0,0,39,0,0,CA - Orland
10,1960-1961,1960-12-01,1961-02-28,90,0,0,20,20,0,0,0,20,0,0,CA - Orland
11,1961-1962,1961-12-01,1962-02-28,90,0,0,32,32,0,0,0,32,0,0,CA - Orland
12,1962-1963,1962-12-01,1963-02-28,90,1,0,34,34,0,0,0,34,0,0,CA - Orland
13,1963-1964,1963-12-01,1964-02-29,91,1,0,23,23,0,0,0,23,0,0,CA - Orland
14,1964-1965,1964-12-01,1965-02-28,90,0,0,18,18,3,0,3,21,1,3,CA - Orland
15,1965-1966,1965-12-01,1966-02-28,90,0,0,53,53,0,0,0,53,0,0,CA - Orland
16,1966-1967,1966-12-01,1967-02-28,90,0,0,20,20,0,0,0,20,0,0,CA - Orland
17,1967-1968,1967-12-01,1968-02-29,91,0,1,42,43,0,0,0,43,0,0,CA - Orland
18,1968-1969,1968-12-01,1969-02-28,90,0,0,32,32,0,0,0,32,0,0,CA - Orland
19,1969-1970,1969-12-01,1970-02-28,90,0,0,15,15,0,0,0,15,0,0,CA - Orland
20,1970-1971,1970-12-01,1971-02-28,90,1,0,18,18,0,0,0,18,0,0,CA - Orland
21,1971-1972,1971-12-01,1972-02-29,91,0,0,38,38,0,0,0,38,0,0,CA - Orland
22,1972-1973,1972-12-01,1973-02-28,90,3,1,39,40,10,2,12,52,2,13,CA - Orland
23,1973-1974,1973-12-01,1974-02-28,90,0,0,19,19,0,0,0,19,0,0,CA - Orland
24,1974-1975,1974-12-01,1975-02-28,90,0,0,33,33,0,0,0,33,0,0,CA - Orland
25,1975-1976,1975-12-01,1976-03-03,94,0,0,45,45,6,0,6,51,1,7,CA - Orland
26,1976-1977,1976-12-01,1977-02-28,90,6,0,30,30,0,0,0,30,0,0,CA - Orland
27,1977-1978,1977-12-01,1978-02-28,90,0,0,3,3,0,0,0,3,0,0,CA - Orland
28,1978-1979,1978-12-01,1979-02-28,90,0,0,35,35,0,0,0,35,0,0,CA - Orland
29,1979-1980,1979-12-01,1980-02-29,91,0,0,17,17,0,0,0,17,0,0,CA - Orland
30,1980-1981,1980-12-01,1981-02-28,90,0,0,12,12,0,0,0,12,0,0,CA - Orland
31,1981-1982,1981-12-01,1982-02-28,90,4,0,23,23,0,0,0,23,0,0,CA - Orland
32,1982-1983,1982-12-01,1983-02-28,90,0,0,26,26,0,0,0,26,0,0,CA - Orland
33,1983-1984,1983-12-01,1984-02-29,91,6,0,14,14,0,0,0,14,0,0,CA - Orland
34,1984-1985,1984-12-01,1985-02-28,90,7,0,23,23,0,0,0,23,0,0,CA - Orland
35,1985-1986,1985-12-01,1986-02-28,90,1,0,28,28,0,0,0,28,0,0,CA - Orland
36,1986-1987,1986-12-01,1987-02-28,90,3,0,18,18,0,0,0,18,0,0,CA - Orland
37,1987-1988,1987-12-01,1988-02-29,91,1,0,27,27,0,0,0,27,0,0,CA - Orland
39,1989-1990,1989-12-01,1990-02-28,90,0,0,50,50,0,0,0,50,0,0,CA - Orland
40,1990-1991,1990-12-01,1991-02-28,90,5,1,47,48,0,0,0,48,0,0,CA - Orland
41,1991-1992,1991-12-01,1992-02-29,91,4,0,18,18,0,0,0,18,0,0,CA - Orland
42,1992-1993,1992-12-01,1993-02-28,90,0,0,23,23,0,0,0,23,0,0,CA - Orland
43,1993-1994,1993-12-01,1994-02-28,90,9,0,15,15,0,0,0,15,0,0,CA - Orland
44,1994-1995,1994-12-01,1995-02-28,90,6,0,10,10,0,0,0,10,0,0,CA - Orland
45,1995-1996,1995-12-01,1996-02-29,91,15,0,7,7,0,0,0,7,0,0,CA - Orland
46,1996-1997,1996-12-01,1997-02-28,90,11,0,8,8,0,0,0,8,0,0,CA - Orland
47,1997-1998,1997-12-01,1998-02-28,90,12,0,8,8,0,0,0,8,0,0,CA - Orland
48,1998-1999,1998-12-01,1999-02-28,90,8,0,38,38,0,0,0,38,0,0,CA - Orland
49,1999-2000,1999-12-01,2000-02-29,91,11,0,7,7,0,0,0,7,0,0,CA - Orland
50,2000-2001,2000-12-01,2001-02-28,90,3,0,11,11,0,0,0,11,0,0,CA - Orland
51,2001-2002,2001-12-01,2002-02-28,90,3,0,14,14,0,0,0,14,0,0,CA - Orland
52,2002-2003,2002-12-01,2003-02-28,90,4,0,3,3,0,0,0,3,0,0,CA - Orland
53,2003-2004,2003-12-01,2004-02-29,91,2,0,7,7,0,0,0,7,0,0,CA - Orland
54,2004-2005,2004-12-01,2005-02-28,90,1,0,7,7,0,0,0,7,0,0,CA - Orland
55,2005-2006,2005-12-01,2006-02-28,90,4,0,10,10,0,0,0,10,0,0,CA - Orland
56,2006-2007,2006-12-01,2007-02-28,90,6,0,22,22,0,0,0,22,0,0,CA - Orland
57,2007-2008,2007-12-01,2008-02-29,91,4,0,9,9,0,0,0,9,0,0,CA - Orland
58,2008-2009,2008-12-01,2009-02-28,90,4,0,16,16,0,0,0,16,0,0,CA - Orland
59,2009-2010,2009-12-01,2010-02-28,90,1,0,16,16,0,0,0,16,0,0,CA - Orland
65,2015-2016,2015-12-01,2016-02-29,91,0,0,5,5,0,0,0,5,0,0,CA - Orland
66,2016-2017,2016-12-01,2017-02-28,90,0,0,26,26,0,0,0,26,0,0,CA - Orland
67,2017-2018,2017-12-01,2018-02-28,90,0,0,17,17,0,0,0,17,0,0,CA - Orland
68,2018-2019,2018-12-01,2019-02-28,90,0,0,15,15,0,0,0,15,0,0,CA - Orland
69,2019-2020,2019-12-01,2020-02-29,91,0,0,5,5,0,0,0,5,0,0,CA - Orland
0,1950-1951,1950-10-27,1951-05-14,200,7,21,337,358,218,785,1003,1361,40,328,CA - Tahoe City
1,1951-1952,1951-10-24,1952-05-11,201,3,58,497,555,735,2316,3051,3606,67,971,CA - Tahoe City
2,1952-1953,1952-09-11,1953-05-25,257,18,26,429,455,368,1811,2179,2634,49,483,CA - Tahoe City
3,1953-1954,1953-10-19,1954-06-05,230,0,17,373,390,215,988,1203,1593,32,281,CA - Tahoe City
4,1954-1955,1954-11-16,1955-05-15,181,0,39,442,481,214,1133,1347,1828,32,301,CA - Tahoe City
5,1955-1956,1955-11-14,1956-05-12,181,17,38,380,418,371,1801,2172,2590,50,514,CA - Tahoe City
6,1956-1957,1956-10-23,1957-05-20,210,4,36,378,414,230,904,1134,1548,40,321,CA - Tahoe City
7,1957-1958,1957-10-20,1958-05-09,202,4,23,362,385,394,1686,2080,2465,49,496,CA - Tahoe City
8,1958-1959,1958-11-10,1959-05-22,194,13,15,294,309,166,492,658,967,27,231,CA - Tahoe City
9,1959-1960,1959-12-01,1960-05-24,176,1,22,348,370,210,803,1013,1383,34,291,CA - Tahoe City
11,1961-1962,1961-11-16,1962-05-16,182,0,37,394,431,326,1371,1697,2128,45,470,CA - Tahoe City
12,1962-1963,1962-10-14,1963-06-10,240,4,13,318,331,213,452,665,996,34,283,CA - Tahoe City
13,1963-1964,1963-11-04,1964-05-08,187,5,23,374,397,303,1201,1504,1901,47,416,CA - Tahoe City
14,1964-1965,1964-11-01,1965-05-07,188,4,27,314,341,358,1339,1697,2038,46,453,CA - Tahoe City
15,1965-1966,1965-11-18,1966-04-12,146,1,26,341,367,284,1505,1789,2156,38,392,CA - Tahoe City
17,1967-1968,1967-11-28,1968-05-14,169,3,20,330,350,316,1451,1767,2117,34,410,CA - Tahoe City
18,1968-1969,1968-11-12,1969-04-30,170,8,27,371,398,434,1761,2195,2593,55,589,CA - Tahoe City
19,1969-1970,1969-10-15,1970-05-10,208,17,4,322,326,157,560,717,1043,35,220,CA - Tahoe City
22,1972-1973,1972-10-18,1973-05-05,200,8,32,455,487,245,1080,1325,1812,56,380,CA - Tahoe City
23,1973-1974,1973-11-14,1974-05-18,186,2,21,345,366,257,749,1006,1372,52,380,CA - Tahoe City
24,1974-1975,1974-11-01,1975-05-21,202,12,27,403,430,324,1491,1815,2245,52,452,CA - Tahoe City
25,1975-1976,1975-10-10,1976-04-16,190,1,22,412,434,126,240,366,800,31,207,CA - Tahoe City
27,1977-1978,1977-11-05,1978-05-24,201,12,5,293,298,241,1094,1335,1633,44,315,CA - Tahoe City
28,1978-1979,1978-11-01,1979-05-10,191,2,22,454,476,268,1134,1402,1878,44,373,CA - Tahoe City
29,1979-1980,1979-10-20,1980-05-11,205,6,3,343,346,265,1075,1340,1686,42,342,CA - Tahoe City
30,1980-1981,1980-10-14,1981-04-02,171,0,4,268,272,119,394,513,785,22,157,CA - Tahoe City
31,1981-1982,1981-10-28,1982-06-05,221,6,16,397,413,367,1642,2009,2422,48,482,CA - Tahoe City
32,1982-1983,1982-09-16,1983-05-19,246,13,9,378,387,323,2318,2641,3028,58,422,CA - Tahoe City
33,1983-1984,1983-11-14,1984-04-27,166,16,4,284,288,227,1137,1364,1652,42,321,CA - Tahoe City
34,1984-1985,1984-10-17,1985-06-02,229,15,17,394,411,264,1557,1821,2232,37,351,CA - Tahoe City
35,1985-1986,1985-10-09,1986-05-07,211,3,10,319,329,252,1312,1564,1893,42,325,CA - Tahoe City
36,1986-1987,1986-09-25,1987-03-29,186,18,5,327,332,98,587,685,1017,23,147,CA - Tahoe City
37,1987-1988,1987-11-21,1988-06-07,200,9,9,334,343,141,635,776,1119,30,204,CA - Tahoe City
38,1988-1989,1988-11-14,1989-05-23,191,11,15,396,411,287,1462,1749,2160,44,407,CA - Tahoe City
39,1989-1990,1989-10-03,1990-04-30,210,10,5,366,371,210,816,1026,1397,30,288,CA - Tahoe City
40,1990-1991,1990-12-01,1991-05-17,168,13,15,356,371,120,518,638,1009,18,151,CA - Tahoe City
41,1991-1992,1991-11-30,1992-03-16,108,8,2,213,215,87,398,485,700,13,108,CA - Tahoe City
42,1992-1993,1992-12-01,1993-04-18,139,7,24,329,353,298,1695,1993,2346,45,408,CA - Tahoe City
44,1994-1995,1994-11-10,1995-06-16,219,11,13,386,399,483,2152,2635,3034,59,613,CA - Tahoe City
45,1995-1996,1995-12-01,1996-05-16,168,11,11,243,254,356,1139,1495,1749,41,459,CA - Tahoe City
46,1996-1997,1996-10-26,1997-04-09,166,16,10,251,261,251,870,1121,1382,28,297,CA - Tahoe City
47,1997-1998,1997-10-11,1998-05-29,231,20,8,357,365,332,1470,1802,2167,58,439,CA - Tahoe City
48,1998-1999,1998-11-07,1999-05-04,179,9,20,347,367,357,1563,1920,2287,45,468,CA - Tahoe City
49,1999-2000,1999-11-08,2000-05-11,186,11,0,263,263,191,822,1013,1276,35,246,CA - Tahoe City
50,2000-2001,2000-10-10,2001-04-21,194,9,14,341,355,226,729,955,1310,41,316,CA - Tahoe City
51,2001-2002,2001-11-25,2002-05-21,178,7,18,330,348,244,1123,1367,1715,40,335,CA - Tahoe City
52,2002-2003,2002-11-09,2003-05-08,181,12,11,253,264,270,866,1136,1400,33,330,CA - Tahoe City
53,2003-2004,2003-11-01,2004-05-11,193,9,8,310,318,269,1110,1379,1697,36,343,CA - Tahoe City
54,2004-2005,2004-10-20,2005-06-07,231,4,10,346,356,387,1431,1818,2174,49,471,CA - Tahoe City
55,2005-2006,2005-11-26,2006-05-27,183,3,15,333,348,287,873,1160,1508,49,414,CA - Tahoe City
56,2006-2007,2006-11-11,2007-05-04,175,12,18,308,326,169,387,556,882,25,225,CA - Tahoe City
57,2007-2008,2007-09-29,2008-04-23,208,14,24,379,403,246,1273,1519,1922,37,340,CA - Tahoe City
58,2008-2009,2008-11-04,2009-04-25,173,16,28,354,382,241,848,1089,1471,38,363,CA - Tahoe City
63,2013-2014,2013-10-28,2014-05-11,196,1,9,309,318,90,168,258,576,27,141,CA - Tahoe City
64,2014-2015,2014-11-01,2015-05-07,188,0,4,249,253,49,64,113,366,13,68,CA - Tahoe City
65,2015-2016,2015-11-03,2016-04-24,174,0,16,332,348,205,812,1017,1365,44,299,CA - Tahoe City
66,2016-2017,2016-10-03,2017-06-12,253,0,16,371,387,351,1668,2019,2406,54,466,CA - Tahoe City
67,2017-2018,2017-10-20,2018-04-18,181,1,16,303,319,203,494,697,1016,31,301,CA - Tahoe City
68,2018-2019,2018-11-22,2019-05-26,186,1,21,312,333,323,1375,1698,2031,50,430,CA - Tahoe City
69,2019-2020,2019-09-29,2020-06-08,254,3,11,366,377,187,574,761,1138,33,270,CA - Tahoe City
0,1950-1951,1950-11-09,1951-04-10,153,0,25,734,759,30,4,34,793,16,91,CO - Alamosa
1,1951-1952,1951-11-01,1952-05-17,199,0,52,823,875,43,52,95,970,24,131,CO - Alamosa
2,1952-1953,1952-11-03,1953-05-16,195,0,70,863,933,49,88,137,1070,31,176,CO - Alamosa
3,1953-1954,1953-11-05,1954-05-02,179,0,40,728,768,28,68,96,864,17,110,CO - Alamosa
4,1954-1955,1954-11-30,1955-05-18,170,0,40,808,848,28,14,42,890,15,109,CO - Alamosa
5,1955-1956,1955-10-27,1956-04-15,172,0,25,792,817,35,48,83,900,20,120,CO - Alamosa
6,1956-1957,1956-11-01,1957-05-20,201,0,23,760,783,44,37,81,864,22,117,CO - Alamosa
7,1957-1958,1957-11-04,1958-04-30,178,0,34,817,851,57,113,170,1021,30,177,CO - Alamosa
8,1958-1959,1958-10-28,1959-05-05,190,0,26,833,859,59,70,129,988,25,159,CO - Alamosa
9,1959-1960,1959-09-29,1960-04-29,214,0,72,927,999,76,114,190,1189,34,219,CO - Alamosa
10,1960-1961,1960-10-14,1961-05-14,213,2,44,861,905,76,83,159,1064,37,219,CO - Alamosa
11,1961-1962,1961-09-03,1962-04-02,212,0,65,882,947,79,124,203,1150,25,182,CO - Alamosa
12,1962-1963,1962-10-19,1963-04-05,169,0,50,825,875,54,101,155,1030,26,163,CO - Alamosa
13,1963-1964,1963-10-31,1964-04-27,180,1,47,1004,1051,42,43,85,1136,31,205,CO - Alamosa
14,1964-1965,1964-11-03,1965-05-26,205,0,123,949,1072,99,362,461,1533,44,295,CO - Alamosa
15,1965-1966,1965-10-18,1966-04-22,187,0,55,844,899,46,82,128,1027,25,155,CO - Alamosa
16,1966-1967,1966-10-16,1967-05-14,211,0,41,814,855,53,52,105,960,23,158,CO - Alamosa
17,1967-1968,1967-10-29,1968-04-28,183,0,99,933,1032,70,253,323,1355,28,206,CO - Alamosa
18,1968-1969,1968-10-17,1969-05-07,203,0,33,882,915,47,46,93,1008,28,160,CO - Alamosa
19,1969-1970,1969-10-11,1970-05-01,203,1,41,886,927,84,77,161,1088,30,205,CO - Alamosa
20,1970-1971,1970-09-22,1971-05-23,244,0,45,952,997,60,37,97,1094,29,181,CO - Alamosa
21,1971-1972,1971-09-18,1972-03-28,193,0,54,788,842,51,114,165,1007,22,156,CO - Alamosa
22,1972-1973,1972-10-23,1973-05-06,196,0,117,1051,1168,136,248,384,1552,47,360,CO - Alamosa
23,1973-1974,1973-09-26,1974-04-13,200,0,55,905,960,59,83,142,1102,27,222,CO - Alamosa
24,1974-1975,1974-10-29,1975-04-13,167,0,109,918,1027,60,179,239,1266,35,252,CO - Alamosa
25,1975-1976,1975-10-31,1976-04-18,171,0,60,809,869,30,79,109,978,17,91,CO - Alamosa
26,1976-1977,1976-10-26,1977-04-21,178,0,47,976,1023,44,108,152,1175,18,148,CO - Alamosa
27,1977-1978,1977-11-09,1978-05-06,179,0,11,688,699,43,20,63,762,23,109,CO - Alamosa
28,1978-1979,1978-10-22,1979-05-10,201,0,141,1052,1193,67,265,332,1525,36,242,CO - Alamosa
29,1979-1980,1979-10-21,1980-05-15,208,0,39,882,921,63,120,183,1104,33,163,CO - Alamosa
30,1980-1981,1980-10-27,1981-03-30,155,0,3,730,733,19,5,24,757,13,58,CO - Alamosa
31,1981-1982,1981-11-07,1982-05-13,188,0,42,775,817,39,50,89,906,25,131,CO - Alamosa
32,1982-1983,1982-10-11,1983-05-14,216,0,25,790,815,54,48,102,917,34,172,CO - Alamosa
33,1983-1984,1983-11-18,1984-04-29,164,0,144,1043,1187,63,489,552,1739,36,270,CO - Alamosa
34,1984-1985,1984-10-14,1985-05-13,212,0,43,792,835,44,74,118,953,25,127,CO - Alamosa
35,1985-1986,1985-10-31,1986-05-17,199,0,36,712,748,59,113,172,920,23,150,CO - Alamosa
36,1986-1987,1986-10-11,1987-04-13,185,0,38,804,842,72,120,192,1034,36,196,CO - Alamosa
37,1987-1988,1987-11-07,1988-04-17,163,0,110,988,1098,41,267,308,1406,24,160,CO - Alamosa
38,1988-1989,1988-11-15,1989-04-12,149,0,45,797,842,27,32,59,901,22,150,CO - Alamosa
39,1989-1990,1989-12-01,1990-05-03,154,0,28,689,717,52,73,125,842,22,133,CO - Alamosa
40,1990-1991,1990-10-08,1991-05-04,209,0,77,901,978,51,101,152,1130,32,198,CO - Alamosa
41,1991-1992,1991-10-30,1992-05-10,194,0,187,1060,1247,84,623,707,1954,29,224,CO - Alamosa
42,1992-1993,1992-11-11,1993-05-09,180,0,113,917,1030,52,377,429,1459,26,207,CO - Alamosa
43,1993-1994,1993-10-29,1994-04-11,165,0,35,823,858,36,50,86,944,15,108,CO - Alamosa
44,1994-1995,1994-10-16,1995-04-22,189,0,20,711,731,40,60,100,831,11,73,CO - Alamosa
45,1995-1996,1995-11-10,1996-04-28,171,1,21,724,745,24,10,34,779,16,103,CO - Alamosa
46,1996-1997,1996-10-21,1997-04-12,174,0,51,791,842,53,128,181,1023,21,168,CO - Alamosa
47,1997-1998,1997-10-24,1998-04-26,185,0,83,875,958,43,194,237,1195,24,131,CO - Alamosa
48,1998-1999,1998-10-31,1999-05-06,188,0,9,710,719,39,7,46,765,22,93,CO - Alamosa
49,1999-2000,1999-12-01,2000-04-02,124,0,13,586,599,17,15,32,631,10,58,CO - Alamosa
50,2000-2001,2000-11-12,2001-05-05,175,0,35,775,810,39,52,91,901,23,129,CO - Alamosa
51,2001-2002,2001-11-23,2002-03-25,123,0,50,727,777,28,69,97,874,16,116,CO - Alamosa
52,2002-2003,2002-11-04,2003-04-06,154,0,21,714,735,24,16,40,775,15,73,CO - Alamosa
53,2003-2004,2003-11-13,2004-05-01,171,0,61,749,810,40,130,170,980,19,110,CO - Alamosa
54,2004-2005,2004-10-13,2005-04-11,181,0,34,698,732,55,81,136,868,27,152,CO - Alamosa
55,2005-2006,2005-10-10,2006-04-29,202,0,13,840,853,24,15,39,892,14,86,CO - Alamosa
56,2006-2007,2006-10-25,2007-04-24,182,0,80,826,906,50,190,240,1146,22,148,CO - Alamosa
57,2007-2008,2007-11-23,2008-04-17,147,0,135,889,1024,60,296,356,1380,27,246,CO - Alamosa
58,2008-2009,2008-10-14,2009-04-17,186,0,25,786,811,48,91,139,950,25,138,CO - Alamosa
59,2009-2010,2009-10-21,2010-05-02,194,0,38,845,883,48,96,144,1027,27,150,CO - Alamosa
60,2010-2011,2010-10-25,2011-05-01,189,0,38,823,861,20,28,48,909,14,103,CO - Alamosa
61,2011-2012,2011-10-07,2012-05-07,214,1,31,869,900,35,46,81,981,24,143,CO - Alamosa
62,2012-2013,2012-11-11,2013-04-18,159,0,104,978,1082,34,162,196,1278,18,165,CO - Alamosa
65,2015-2016,2015-11-16,2016-05-01,168,0,43,734,777,63,61,124,901,24,165,CO - Alamosa
66,2016-2017,2016-11-27,2017-05-11,166,0,58,606,664,66,203,269,933,30,190,CO - Alamosa
67,2017-2018,2017-11-08,2018-04-20,164,0,4,698,702,17,8,25,727,12,62,CO - Alamosa
68,2018-2019,2018-10-31,2019-05-21,203,0,75,840,915,84,186,270,1185,39,263,CO - Alamosa
69,2019-2020,2019-10-30,2020-03-19,142,0,50,731,781,27,61,88,869,16,105,CO - Alamosa
0,1950-1951,1950-11-08,1951-06-03,208,0,53,437,490,33,27,60,550,24,174,CO - Colorado Springs
1,1951-1952,1951-09-21,1952-05-17,240,0,31,432,463,48,14,62,525,28,138,CO - Colorado Springs
2,1952-1953,1952-11-08,1953-05-13,187,0,32,400,432,42,25,67,499,26,127,CO - Colorado Springs
3,1953-1954,1953-10-23,1954-05-03,193,0,26,330,356,45,25,70,426,30,126,CO - Colorado Springs
4,1954-1955,1954-10-26,1955-04-12,169,1,31,458,489,40,49,89,578,24,142,CO - Colorado Springs
5,1955-1956,1955-11-12,1956-04-28,169,1,33,426,459,56,96,152,611,29,184,CO - Colorado Springs
6,1956-1957,1956-10-24,1957-05-16,205,0,27,437,464,128,109,237,701,39,277,CO - Colorado Springs
7,1957-1958,1957-09-14,1958-04-30,229,0,15,375,390,80,51,131,521,45,198,CO - Colorado Springs
8,1958-1959,1958-10-29,1959-04-21,175,0,33,414,447,82,62,144,591,36,213,CO - Colorado Springs
9,1959-1960,1959-09-28,1960-05-19,235,0,69,504,573,97,117,214,787,38,251,CO - Colorado Springs
10,1960-1961,1960-10-14,1961-05-14,213,0,31,413,444,63,60,123,567,38,168,CO - Colorado Springs
11,1961-1962,1961-09-03,1962-04-30,240,1,94,537,631,69,106,175,806,35,233,CO - Colorado Springs
12,1962-1963,1962-11-15,1963-03-14,120,0,56,321,377,41,35,76,453,23,169,CO - Colorado Springs
13,1963-1964,1963-10-31,1964-04-03,156,0,50,431,481,57,88,145,626,18,134,CO - Colorado Springs
14,1964-1965,1964-11-15,1965-04-27,164,0,64,379,443,61,87,148,591,29,196,CO - Colorado Springs
15,1965-1966,1965-09-20,1966-05-12,235,0,40,386,426,48,44,92,518,27,167,CO - Colorado Springs
16,1966-1967,1966-10-13,1967-04-14,184,0,23,369,392,43,32,75,467,14,96,CO - Colorado Springs
17,1967-1968,1967-11-02,1968-05-16,197,0,47,393,440,53,87,140,580,28,170,CO - Colorado Springs
18,1968-1969,1968-10-16,1969-04-26,193,0,42,400,442,64,61,125,567,30,179,CO - Colorado Springs
19,1969-1970,1969-10-03,1970-04-18,198,0,56,409,465,98,105,203,668,38,211,CO - Colorado Springs
20,1970-1971,1970-09-25,1971-04-22,210,0,52,404,456,51,38,89,545,27,132,CO - Colorado Springs
21,1971-1972,1971-09-16,1972-04-26,224,0,31,380,411,55,48,103,514,26,150,CO - Colorado Springs
22,1972-1973,1972-10-29,1973-05-01,185,0,89,431,520,115,168,283,803,45,317,CO - Colorado Springs
23,1973-1974,1973-10-10,1974-04-15,188,0,47,377,424,58,50,108,532,29,164,CO - Colorado Springs
24,1974-1975,1974-11-03,1975-06-10,220,0,42,426,468,49,36,85,553,35,177,CO - Colorado Springs
25,1975-1976,1975-10-23,1976-04-30,191,0,37,363,400,66,55,121,521,28,165,CO - Colorado Springs
26,1976-1977,1976-10-07,1977-04-04,180,0,33,403,436,61,36,97,533,30,194,CO - Colorado Springs
27,1977-1978,1977-10-31,1978-05-09,191,0,43,372,415,72,39,111,526,37,222,CO - Colorado Springs
28,1978-1979,1978-10-22,1979-05-10,201,0,101,473,574,105,147,252,826,45,305,CO - Colorado Springs
29,1979-1980,1979-10-29,1980-04-30,185,0,48,405,453,108,155,263,716,45,262,CO - Colorado Springs
30,1980-1981,1980-10-27,1981-05-09,195,0,19,292,311,39,19,58,369,29,124,CO - Colorado Springs
31,1981-1982,1981-10-30,1982-05-05,188,0,51,378,429,55,78,133,562,28,180,CO - Colorado Springs
32,1982-1983,1982-10-13,1983-05-13,213,0,43,369,412,63,71,134,546,35,156,CO - Colorado Springs
33,1983-1984,1983-11-08,1984-05-07,182,0,92,464,556,108,140,248,804,46,345,CO - Colorado Springs
34,1984-1985,1984-09-28,1985-04-25,210,0,62,432,494,113,105,218,712,41,268,CO - Colorado Springs
35,1985-1986,1985-09-28,1986-04-04,189,0,55,342,397,51,52,103,500,29,176,CO - Colorado Springs
36,1986-1987,1986-10-12,1987-04-12,183,0,34,363,397,119,164,283,680,33,228,CO - Colorado Springs
37,1987-1988,1987-11-15,1988-05-02,170,0,65,414,479,67,81,148,627,32,218,CO - Colorado Springs
38,1988-1989,1988-11-15,1989-04-30,167,0,63,396,459,61,75,136,595,25,198,CO - Colorado Springs
39,1989-1990,1989-10-16,1990-05-03,200,0,40,361,401,76,66,142,543,35,204,CO - Colorado Springs
40,1990-1991,1990-10-07,1991-05-05,211,0,51,401,452,49,34,83,535,28,144,CO - Colorado Springs
41,1991-1992,1991-10-28,1992-03-22,147,0,27,292,319,65,66,131,450,28,155,CO - Colorado Springs
42,1992-1993,1992-11-02,1993-04-15,165,0,56,392,448,46,25,71,519,25,151,CO - Colorado Springs
43,1993-1994,1993-09-13,1994-04-30,230,0,35,404,439,52,32,84,523,31,165,CO - Colorado Springs
44,1994-1995,1994-10-17,1995-04-26,192,0,36,347,383,66,46,112,495,28,175,CO - Colorado Springs
45,1995-1996,1995-09-21,1996-04-28,221,3,48,447,495,29,14,43,538,19,110,CO - Colorado Springs
47,1997-1998,1997-10-24,1998-04-18,177,0,24,397,421,87,67,154,575,26,150,CO - Colorado Springs
48,1998-1999,1998-10-31,1999-05-01,183,0,35,324,359,59,58,117,476,30,153,CO - Colorado Springs
49,1999-2000,1999-09-28,2000-04-15,201,0,19,294,313,60,70,130,443,23,110,CO - Colorado Springs
50,2000-2001,2000-09-23,2001-05-05,225,0,44,436,480,84,119,203,683,39,194,CO - Colorado Springs
51,2001-2002,2001-09-08,2002-03-25,199,1,28,396,424,29,14,43,467,21,107,CO - Colorado Springs
52,2002-2003,2002-10-22,2003-05-10,201,0,40,341,381,51,31,82,463,37,161,CO - Colorado Springs
53,2003-2004,2003-11-22,2004-04-30,161,0,21,316,337,37,31,68,405,22,96,CO - Colorado Springs
54,2004-2005,2004-10-31,2005-04-29,181,0,28,328,356,52,41,93,449,33,143,CO - Colorado Springs
55,2005-2006,2005-11-05,2006-05-10,187,3,36,391,427,25,22,47,474,14,105,CO - Colorado Springs
56,2006-2007,2006-10-17,2007-04-14,180,0,47,385,432,51,46,97,529,26,170,CO - Colorado Springs
57,2007-2008,2007-11-21,2008-05-01,163,0,39,406,445,53,39,92,537,29,148,CO - Colorado Springs
58,2008-2009,2008-11-27,2009-04-17,142,0,23,323,346,32,18,50,396,24,110,CO - Colorado Springs
59,2009-2010,2009-10-08,2010-04-26,201,0,53,405,458,53,53,106,564,30,154,CO - Colorado Springs
60,2010-2011,2010-11-28,2011-04-27,151,0,42,316,358,23,21,44,402,14,67,CO - Colorado Springs
61,2011-2012,2011-10-25,2012-03-03,131,3,15,292,307,35,52,87,394,17,85,CO - Colorado Springs
62,2012-2013,2012-10-25,2013-05-02,190,3,35,412,447,51,50,101,548,28,165,CO - Colorado Springs
63,2013-2014,2013-10-18,2014-05-11,206,0,60,422,482,53,82,135,617,26,185,CO - Colorado Springs
64,2014-2015,2014-11-10,2015-04-17,159,0,56,344,400,72,121,193,593,33,231,CO - Colorado Springs
65,2015-2016,2015-11-11,2016-05-01,173,0,28,308,336,76,94,170,506,32,169,CO - Colorado Springs
66,2016-2017,2016-12-01,2017-05-18,169,0,33,276,309,41,30,71,380,22,124,CO - Colorado Springs
67,2017-2018,2017-10-09,2018-04-24,198,0,15,342,357,40,22,62,419,25,113,CO - Colorado Springs
68,2018-2019,2018-10-10,2019-05-21,224,0,34,403,437,59,42,101,538,36,179,CO - Colorado Springs
69,2019-2020,2019-10-10,2020-04-16,190,0,31,361,392,79,80,159,551,36,195,CO - Colorado Springs
0,1950-1951,1950-11-02,1951-06-02,213,0,44,386,430,106,103,209,639,39,287,CO - Denver (Stapleton)
1,1951-1952,1951-09-21,1952-04-22,215,0,29,382,411,119,80,199,610,43,251,CO - Denver (Stapleton)
2,1952-1953,1952-10-14,1953-05-12,211,0,27,353,380,102,137,239,619,39,223,CO - Denver (Stapleton)
3,1953-1954,1953-10-23,1954-05-02,192,0,19,296,315,61,82,143,458,30,151,CO - Denver (Stapleton)
4,1954-1955,1954-10-25,1955-04-13,171,0,40,393,433,77,129,206,639,33,217,CO - Denver (Stapleton)
5,1955-1956,1955-09-20,1956-04-23,217,0,36,374,410,67,81,148,558,28,178,CO - Denver (Stapleton)
6,1956-1957,1956-10-24,1957-05-17,206,0,32,348,380,113,90,203,583,40,255,CO - Denver (Stapleton)
7,1957-1958,1957-10-24,1958-04-29,188,0,16,307,323,87,74,161,484,45,198,CO - Denver (Stapleton)
8,1958-1959,1958-10-28,1959-04-20,175,0,37,358,395,140,169,309,704,43,289,CO - Denver (Stapleton)
9,1959-1960,1959-09-28,1960-04-30,216,0,65,415,480,111,179,290,770,41,292,CO - Denver (Stapleton)
10,1960-1961,1960-10-14,1961-05-14,213,0,27,370,397,117,134,251,648,40,228,CO - Denver (Stapleton)
11,1961-1962,1961-09-03,1962-04-30,240,0,105,515,620,117,219,336,956,43,355,CO - Denver (Stapleton)
12,1962-1963,1962-09-08,1963-04-22,227,0,62,428,490,59,58,117,607,29,216,CO - Denver (Stapleton)
13,1963-1964,1963-10-31,1964-05-08,191,0,39,456,495,87,86,173,668,38,244,CO - Denver (Stapleton)
14,1964-1965,1964-11-14,1965-04-11,149,0,44,380,424,87,115,202,626,41,263,CO - Denver (Stapleton)
15,1965-1966,1965-09-20,1966-05-12,235,0,21,415,436,67,94,161,597,32,176,CO - Denver (Stapleton)
16,1966-1967,1966-10-13,1967-05-13,213,0,15,363,378,56,48,104,482,26,129,CO - Denver (Stapleton)
17,1967-1968,1967-10-29,1968-04-27,182,0,28,435,463,92,108,200,663,37,244,CO - Denver (Stapleton)
18,1968-1969,1968-10-08,1969-03-24,168,0,31,401,432,52,74,126,558,28,144,CO - Denver (Stapleton)
19,1969-1970,1969-10-03,1970-04-18,198,0,32,428,460,100,125,225,685,44,222,CO - Denver (Stapleton)
20,1970-1971,1970-09-24,1971-04-22,211,0,34,420,454,87,112,199,653,36,191,CO - Denver (Stapleton)
21,1971-1972,1971-09-16,1972-04-29,227,0,27,398,425,112,89,201,626,33,212,CO - Denver (Stapleton)
22,1972-1973,1972-10-29,1973-05-02,186,0,68,432,500,138,230,368,868,55,307,CO - Denver (Stapleton)
23,1973-1974,1973-10-10,1974-04-29,202,0,47,396,443,133,271,404,847,47,307,CO - Denver (Stapleton)
24,1974-1975,1974-09-12,1975-05-29,260,0,25,413,438,86,58,144,582,41,212,CO - Denver (Stapleton)
25,1975-1976,1975-10-23,1976-04-30,191,0,31,331,362,79,115,194,556,34,197,CO - Denver (Stapleton)
26,1976-1977,1976-10-26,1977-04-03,160,0,16,331,347,55,41,96,443,26,116,CO - Denver (Stapleton)
27,1977-1978,1977-10-31,1978-05-08,190,0,33,337,370,70,48,118,488,29,168,CO - Denver (Stapleton)
28,1978-1979,1978-10-22,1979-05-10,201,0,72,451,523,104,138,242,765,46,273,CO - Denver (Stapleton)
29,1979-1980,1979-10-29,1980-04-24,179,0,43,368,411,127,261,388,799,50,262,CO - Denver (Stapleton)
30,1980-1981,1980-10-27,1981-04-08,164,0,16,235,251,64,71,135,386,25,124,CO - Denver (Stapleton)
31,1981-1982,1981-10-24,1982-04-20,179,0,37,318,355,46,77,123,478,28,135,CO - Denver (Stapleton)
32,1982-1983,1982-10-19,1983-05-18,212,0,34,341,375,116,255,371,746,35,203,CO - Denver (Stapleton)
33,1983-1984,1983-11-08,1984-04-29,174,0,95,443,538,110,222,332,870,42,311,CO - Denver (Stapleton)
34,1984-1985,1984-09-25,1985-04-26,214,0,54,408,462,83,113,196,658,40,239,CO - Denver (Stapleton)
35,1985-1986,1985-09-28,1986-04-17,202,0,52,324,376,95,144,239,615,34,223,CO - Denver (Stapleton)
36,1986-1987,1986-10-10,1987-04-20,193,0,26,319,345,102,110,212,557,41,209,CO - Denver (Stapleton)
37,1987-1988,1987-11-15,1988-05-02,170,0,51,399,450,93,232,325,775,33,233,CO - Denver (Stapleton)
38,1988-1989,1988-11-15,1989-04-30,167,0,57,374,431,73,134,207,638,32,228,CO - Denver (Stapleton)
39,1989-1990,1989-09-12,1990-05-09,240,0,36,326,362,98,124,222,584,41,238,CO - Denver (Stapleton)
40,1990-1991,1990-10-07,1991-04-30,206,0,50,354,404,86,95,181,585,41,244,CO - Denver (Stapleton)
41,1991-1992,1991-10-04,1992-03-31,180,0,16,297,313,110,196,306,619,33,210,CO - Denver (Stapleton)
42,1992-1993,1992-10-29,1993-04-24,178,0,49,412,461,86,207,293,754,36,225,CO - Denver (Stapleton)
43,1993-1994,1993-09-13,1994-04-29,229,0,21,353,374,96,100,196,570,40,203,CO - Denver (Stapleton)
44,1994-1995,1994-09-21,1995-04-11,203,6,31,308,339,55,69,124,463,22,133,CO - Denver (Stapleton)
45,1995-1996,1995-09-20,1996-04-28,222,2,52,403,455,74,44,118,573,35,224,CO - Denver (Stapleton)
46,1996-1997,1996-09-25,1997-05-02,220,0,49,381,430,72,56,128,558,45,225,CO - Denver (Stapleton)
47,1997-1998,1997-10-12,1998-04-20,191,1,20,331,351,106,86,192,543,40,201,CO - Denver (Stapleton)
48,1998-1999,1998-11-07,1999-04-24,169,0,32,281,313,65,68,133,446,25,155,CO - Denver (Stapleton)
49,1999-2000,1999-09-28,2000-04-16,202,2,6,266,272,62,63,125,397,21,110,CO - Denver (Stapleton)
50,2000-2001,2000-09-24,2001-05-21,240,2,40,417,457,81,98,179,636,31,196,CO - Denver (Stapleton)
51,2001-2002,2001-10-05,2002-05-24,232,1,34,378,412,47,57,104,516,27,147,CO - Denver (Stapleton)
52,2002-2003,2002-10-24,2003-05-11,200,1,28,362,390,85,105,190,580,28,174,CO - Denver (Stapleton)
53,2003-2004,2003-10-31,2004-05-01,184,1,24,350,374,50,74,124,498,24,115,CO - Denver (Stapleton)
54,2004-2005,2004-11-01,2005-05-02,183,0,24,306,330,67,63,130,460,35,168,CO - Denver (Stapleton)
55,2005-2006,2005-10-10,2006-05-10,213,1,41,352,393,45,48,93,486,21,128,CO - Denver (Stapleton)
56,2006-2007,2006-10-18,2007-04-14,179,0,54,407,461,104,368,472,933,34,277,CO - Denver (Stapleton)
57,2007-2008,2007-10-22,2008-05-14,206,0,38,421,459,72,130,202,661,41,220,CO - Denver (Stapleton)
58,2008-2009,2008-11-14,2009-04-28,166,0,37,343,380,47,36,83,463,31,161,CO - Denver (Stapleton)
59,2009-2010,2009-10-11,2010-05-12,214,6,48,416,464,72,143,215,679,37,206,CO - Denver (Stapleton)
60,2010-2011,2010-11-10,2011-04-04,146,0,46,363,409,40,71,111,520,20,127,CO - Denver (Stapleton)
61,2011-2012,2011-10-26,2012-04-04,162,0,33,353,386,76,151,227,613,25,176,CO - Denver (Stapleton)
62,2012-2013,2012-10-05,2013-05-02,210,0,42,430,472,80,75,155,627,30,182,CO - Denver (Stapleton)
63,2013-2014,2013-10-18,2014-05-13,208,4,67,397,464,57,77,134,598,34,197,CO - Denver (Stapleton)
64,2014-2015,2014-11-11,2015-05-10,181,3,58,330,388,88,133,221,609,31,226,CO - Denver (Stapleton)
65,2015-2016,2015-11-05,2016-05-02,180,0,33,312,345,104,198,302,647,37,201,CO - Denver (Stapleton)
66,2016-2017,2016-11-18,2017-04-30,164,0,35,314,349,41,65,106,455,18,136,CO - Denver (Stapleton)
67,2017-2018,2017-10-09,2018-04-22,196,0,36,359,395,42,46,88,483,25,127,CO - Denver (Stapleton)
68,2018-2019,2018-10-14,2019-05-21,220,0,43,389,432,67,90,157,589,33,183,CO - Denver (Stapleton)
69,2019-2020,2019-10-11,2020-04-17,190,0,39,359,398,99,165,264,662,35,227,CO - Denver (Stapleton)
14,1964-1965,1964-10-24,1965-05-26,215,0,112,926,1038,239,1077,1316,2354,57,490,CO - Dillon
15,1965-1966,1965-09-20,1966-05-12,235,1,89,1036,1125,144,514,658,1783,43,306,CO - Dillon
16,1966-1967,1966-10-03,1967-05-20,230,0,86,870,956,203,646,849,1805,56,423,CO - Dillon
17,1967-1968,1967-09-19,1968-05-26,251,2,76,1011,1087,184,708,892,1979,49,396,CO - Dillon
18,1968-1969,1968-09-04,1969-06-26,296,0,101,1044,1145,190,517,707,1852,51,414,CO - Dillon
19,1969-1970,1969-10-03,1970-06-11,252,0,111,1045,1156,262,865,1127,2283,53,461,CO - Dillon
20,1970-1971,1970-09-22,1971-06-09,261,2,118,986,1104,235,284,519,1623,69,508,CO - Dillon
21,1971-1972,1971-09-04,1972-05-14,254,5,95,962,1057,159,462,621,1678,46,371,CO - Dillon
22,1972-1973,1972-09-29,1973-06-16,261,2,101,1043,1144,198,540,738,1882,56,411,CO - Dillon
23,1973-1974,1973-09-26,1974-06-09,257,8,99,931,1030,272,615,887,1917,64,554,CO - Dillon
24,1974-1975,1974-10-31,1975-06-10,223,0,108,961,1069,156,479,635,1704,45,372,CO - Dillon
25,1975-1976,1975-10-08,1976-06-24,261,3,78,903,981,164,402,566,1547,45,350,CO - Dillon
26,1976-1977,1976-09-27,1977-05-15,231,1,104,1018,1122,125,227,352,1474,34,288,CO - Dillon
27,1977-1978,1977-09-23,1978-05-13,233,1,94,838,932,222,1065,1287,2219,74,540,CO - Dillon
28,1978-1979,1978-09-20,1979-06-19,273,3,166,1070,1236,207,1034,1241,2477,75,580,CO - Dillon
29,1979-1980,1979-10-16,1980-05-17,215,0,105,999,1104,192,1242,1434,2538,72,505,CO - Dillon
30,1980-1981,1980-10-15,1981-05-18,216,0,50,786,836,102,137,239,1075,43,253,CO - Dillon
31,1981-1982,1981-10-15,1982-05-26,224,1,118,876,994,199,669,868,1862,74,543,CO - Dillon
32,1982-1983,1982-10-06,1983-06-14,252,9,91,995,1086,220,743,963,2049,82,546,CO - Dillon
33,1983-1984,1983-10-03,1984-06-09,251,4,158,1016,1174,247,1250,1497,2671,93,689,CO - Dillon
34,1984-1985,1984-09-25,1985-06-27,276,1,112,991,1103,143,592,735,1838,67,458,CO - Dillon
35,1985-1986,1985-09-22,1986-05-16,237,6,69,841,910,194,732,926,1836,70,485,CO - Dillon
36,1986-1987,1986-09-26,1987-05-04,221,3,89,947,1036,129,434,563,1599,60,382,CO - Dillon
37,1987-1988,1987-10-16,1988-05-21,219,4,141,979,1120,158,761,919,2039,60,467,CO - Dillon
38,1988-1989,1988-11-04,1989-05-15,193,3,109,852,961,147,410,557,1518,47,345,CO - Dillon
39,1989-1990,1989-09-13,1990-05-16,246,1,98,914,1012,132,502,634,1646,56,368,CO - Dillon
40,1990-1991,1990-10-08,1991-05-16,221,2,106,992,1098,158,343,501,1599,57,417,CO - Dillon
41,1991-1992,1991-09-15,1992-06-01,261,1,70,939,1009,149,508,657,1666,63,434,CO - Dillon
42,1992-1993,1992-09-25,1993-06-07,256,6,105,952,1057,190,744,934,1991,78,507,CO - Dillon
43,1993-1994,1993-09-14,1994-05-04,233,6,100,964,1064,128,232,360,1424,62,419,CO - Dillon
44,1994-1995,1994-10-06,1995-05-25,232,6,81,847,928,175,287,462,1390,69,434,CO - Dillon
45,1995-1996,1995-09-30,1996-05-27,241,13,94,916,1010,278,1008,1286,2296,68,565,CO - Dillon
46,1996-1997,1996-09-19,1997-05-02,226,8,104,924,1028,211,855,1066,2094,68,524,CO - Dillon
48,1998-1999,1998-10-04,1999-05-11,220,4,75,828,903,142,329,471,1374,56,363,CO - Dillon
49,1999-2000,1999-10-17,2000-05-18,215,6,61,820,881,146,417,563,1444,54,367,CO - Dillon
50,2000-2001,2000-09-24,2001-05-21,240,8,84,957,1041,154,618,772,1813,53,380,CO - Dillon
51,2001-2002,2001-09-08,2002-05-24,259,7,109,1030,1139,99,183,282,1421,39,298,CO - Dillon
52,2002-2003,2002-10-27,2003-06-07,224,1,97,848,945,201,419,620,1565,63,493,CO - Dillon
53,2003-2004,2003-11-04,2004-05-31,210,2,101,829,930,112,381,493,1423,50,341,CO - Dillon
54,2004-2005,2004-10-13,2005-06-13,244,1,78,889,967,151,307,458,1425,54,354,CO - Dillon
55,2005-2006,2005-10-10,2006-04-29,202,8,132,892,1024,162,843,1005,2029,60,456,CO - Dillon
56,2006-2007,2006-09-21,2007-05-30,252,6,122,940,1062,184,349,533,1595,62,512,CO - Dillon
57,2007-2008,2007-10-14,2008-06-08,239,0,174,1046,1220,212,1061,1273,2493,71,587,CO - Dillon
58,2008-2009,2008-10-22,2009-05-04,195,0,112,821,933,174,656,830,1763,60,478,CO - Dillon
59,2009-2010,2009-10-02,2010-06-13,255,0,120,1087,1207,141,355,496,1703,56,432,CO - Dillon
60,2010-2011,2010-10-13,2011-06-20,251,3,137,982,1119,243,687,930,2049,86,656,CO - Dillon
61,2011-2012,2011-10-09,2012-05-24,229,3,64,939,1003,105,224,329,1332,47,306,CO - Dillon
62,2012-2013,2012-10-17,2013-05-30,226,0,133,1005,1138,202,547,749,1887,68,590,CO - Dillon
63,2013-2014,2013-10-04,2014-05-15,224,4,119,947,1066,277,551,828,1894,76,623,CO - Dillon
64,2014-2015,2014-10-02,2015-05-17,228,4,91,810,901,156,366,522,1423,54,394,CO - Dillon
65,2015-2016,2015-10-23,2016-05-09,200,0,122,892,1014,177,762,939,1953,61,487,CO - Dillon
66,2016-2017,2016-10-06,2017-05-23,230,0,105,790,895,256,699,955,1850,67,574,CO - Dillon
67,2017-2018,2017-10-02,2018-05-05,216,0,58,819,877,202,391,593,1470,60,457,CO - Dillon
68,2018-2019,2018-10-09,2019-06-23,258,0,109,987,1096,227,958,1185,2281,76,555,CO - Dillon
69,2019-2020,2019-10-10,2020-06-09,244,2,124,979,1103,166,698,864,1967,65,476,CO - Dillon
0,1950-1951,1950-11-08,1951-04-21,165,9,47,472,519,56,56,112,631,26,195,CO - Fort Collins
1,1951-1952,1951-10-21,1952-04-09,172,1,40,509,549,69,135,204,753,30,186,CO - Fort Collins
2,1952-1953,1952-10-06,1953-04-18,195,0,26,464,490,68,82,150,640,25,148,CO - Fort Collins
3,1953-1954,1953-11-18,1954-05-02,166,6,17,381,398,36,34,70,468,14,81,CO - Fort Collins
4,1954-1955,1954-10-25,1955-04-12,170,0,43,517,560,73,105,178,738,24,184,CO - Fort Collins
5,1955-1956,1955-11-11,1956-04-24,166,1,55,465,520,94,213,307,827,28,203,CO - Fort Collins
6,1956-1957,1956-11-01,1957-05-16,197,0,36,442,478,83,114,197,675,27,212,CO - Fort Collins
7,1957-1958,1957-10-25,1958-04-29,187,0,19,397,416,54,66,120,536,31,149,CO - Fort Collins
8,1958-1959,1958-10-29,1959-04-14,168,1,45,431,476,101,194,295,771,34,237,CO - Fort Collins
9,1959-1960,1959-09-29,1960-04-29,214,1,66,493,559,64,103,167,726,30,200,CO - Fort Collins
12,1962-1963,1962-11-14,1963-03-15,122,0,63,415,478,68,154,222,700,29,217,CO - Fort Collins
13,1963-1964,1963-12-01,1964-04-07,129,0,32,405,437,69,122,191,628,26,179,CO - Fort Collins
14,1964-1965,1964-11-14,1965-04-18,156,0,48,422,470,69,75,144,614,28,199,CO - Fort Collins
15,1965-1966,1965-12-01,1966-05-12,163,1,36,396,432,39,102,141,573,17,104,CO - Fort Collins
16,1966-1967,1966-10-14,1967-05-13,212,3,17,367,384,53,46,99,483,24,126,CO - Fort Collins
18,1968-1969,1968-11-06,1969-03-14,129,12,37,361,398,51,46,97,495,23,128,CO - Fort Collins
19,1969-1970,1969-10-11,1970-04-22,194,1,31,399,430,75,76,151,581,21,129,CO - Fort Collins
20,1970-1971,1970-10-07,1971-04-04,180,0,40,394,434,76,137,213,647,19,144,CO - Fort Collins
23,1973-1974,1973-11-02,1974-04-13,163,0,43,366,409,78,132,210,619,24,151,CO - Fort Collins
25,1975-1976,1975-10-23,1976-04-27,188,0,37,399,436,80,169,249,685,18,154,CO - Fort Collins
26,1976-1977,1976-10-26,1977-04-03,160,1,16,412,428,41,25,66,494,18,90,CO - Fort Collins
27,1977-1978,1977-11-19,1978-05-07,170,8,45,355,400,87,99,186,586,29,182,CO - Fort Collins
29,1979-1980,1979-10-29,1980-04-11,166,0,50,456,506,154,434,588,1094,42,317,CO - Fort Collins
30,1980-1981,1980-10-27,1981-04-04,160,19,13,307,320,56,45,101,421,17,97,CO - Fort Collins
33,1983-1984,1983-11-08,1984-04-26,171,0,81,449,530,120,236,356,886,38,302,CO - Fort Collins
34,1984-1985,1984-09-25,1985-04-26,214,1,48,443,491,64,156,220,711,30,173,CO - Fort Collins
35,1985-1986,1985-09-28,1986-04-26,211,0,54,378,432,108,319,427,859,37,260,CO - Fort Collins
36,1986-1987,1986-10-11,1987-04-20,192,0,14,366,380,94,109,203,583,38,180,CO - Fort Collins
37,1987-1988,1987-11-15,1988-04-22,160,0,49,416,465,128,210,338,803,36,271,CO - Fort Collins
38,1988-1989,1988-11-15,1989-05-01,168,0,56,425,481,88,246,334,815,32,228,CO - Fort Collins
39,1989-1990,1989-09-12,1990-04-05,206,0,37,358,395,112,184,296,691,36,247,CO - Fort Collins
40,1990-1991,1990-10-07,1991-05-04,210,0,47,417,464,56,95,151,615,24,163,CO - Fort Collins
41,1991-1992,1991-10-28,1992-03-22,147,0,10,309,319,77,98,175,494,23,120,CO - Fort Collins
42,1992-1993,1992-11-02,1993-04-13,163,0,59,406,465,95,284,379,844,36,239,CO - Fort Collins
43,1993-1994,1993-09-13,1994-04-30,230,0,22,394,416,89,89,178,594,41,203,CO - Fort Collins
44,1994-1995,1994-10-17,1995-04-27,193,0,25,339,364,62,84,146,510,31,155,CO - Fort Collins
45,1995-1996,1995-09-20,1996-04-13,207,0,43,394,437,74,85,159,596,28,193,CO - Fort Collins
46,1996-1997,1996-09-27,1997-04-24,210,0,45,368,413,84,102,186,599,36,205,CO - Fort Collins
47,1997-1998,1997-10-24,1998-04-18,177,0,14,321,335,81,79,160,495,26,142,CO - Fort Collins
48,1998-1999,1998-11-07,1999-05-10,185,0,31,270,301,60,71,131,432,28,148,CO - Fort Collins
49,1999-2000,1999-09-28,2000-04-16,202,0,0,259,259,60,41,101,360,21,89,CO - Fort Collins
50,2000-2001,2000-09-23,2001-05-20,240,0,23,394,417,81,62,143,560,34,164,CO - Fort Collins
51,2001-2002,2001-11-08,2002-05-24,198,2,18,384,402,67,75,142,544,27,149,CO - Fort Collins
52,2002-2003,2002-10-23,2003-05-10,200,0,16,321,337,102,122,224,561,30,190,CO - Fort Collins
53,2003-2004,2003-10-31,2004-04-12,165,3,16,306,322,41,85,126,448,17,79,CO - Fort Collins
54,2004-2005,2004-11-14,2005-05-01,169,0,16,282,298,76,123,199,497,26,148,CO - Fort Collins
55,2005-2006,2005-12-01,2006-03-22,112,1,26,264,290,40,41,81,371,18,118,CO - Fort Collins
56,2006-2007,2006-10-17,2007-04-08,174,0,29,378,407,80,440,520,927,26,175,CO - Fort Collins
57,2007-2008,2007-11-21,2008-04-10,142,0,27,348,375,60,192,252,627,25,128,CO - Fort Collins
58,2008-2009,2008-12-01,2009-04-27,148,1,25,294,319,60,66,126,445,23,129,CO - Fort Collins
59,2009-2010,2009-10-09,2010-05-12,216,0,38,386,424,126,289,415,839,35,229,CO - Fort Collins
60,2010-2011,2010-11-11,2011-04-23,164,0,28,327,355,35,45,80,435,17,104,CO - Fort Collins
61,2011-2012,2011-10-26,2012-02-29,127,0,7,287,294,72,128,200,494,16,104,CO - Fort Collins
62,2012-2013,2012-10-25,2013-05-02,190,0,20,391,411,112,111,223,634,31,197,CO - Fort Collins
63,2013-2014,2013-10-18,2014-05-12,207,2,49,393,442,73,155,228,670,32,228,CO - Fort Collins
64,2014-2015,2014-11-11,2015-05-10,181,0,39,321,360,64,140,204,564,30,197,CO - Fort Collins
65,2015-2016,2015-11-11,2016-05-01,173,0,22,295,317,104,276,380,697,28,171,CO - Fort Collins
66,2016-2017,2016-11-17,2017-05-19,184,0,28,287,315,49,78,127,442,21,118,CO - Fort Collins
67,2017-2018,2017-10-09,2018-04-21,195,0,25,321,346,53,60,113,459,25,144,CO - Fort Collins
68,2018-2019,2018-10-10,2019-05-21,224,0,26,383,409,75,56,131,540,29,172,CO - Fort Collins
69,2019-2020,2019-10-10,2020-04-18,192,0,19,354,373,104,215,319,692,38,216,CO - Fort Collins
0,1950-1951,1950-11-10,1951-04-26,168,0,28,282,310,38,54,92,402,17,79,CO - Grand Junction
1,1951-1952,1951-11-14,1952-03-24,132,0,46,310,356,46,12,58,414,38,137,CO - Grand Junction
2,1952-1953,1952-11-16,1953-04-11,147,0,20,275,295,48,20,68,363,28,101,CO - Grand Junction
3,1953-1954,1953-11-18,1954-03-25,128,0,7,236,243,22,9,31,274,14,49,CO - Grand Junction
4,1954-1955,1954-11-29,1955-04-12,135,0,55,361,416,59,81,140,556,27,166,CO - Grand Junction
5,1955-1956,1955-11-14,1956-03-14,122,0,11,222,233,34,14,48,281,18,69,CO - Grand Junction
6,1956-1957,1956-10-24,1957-04-25,184,0,50,354,404,70,299,369,773,32,156,CO - Grand Junction
7,1957-1958,1957-11-14,1958-03-10,117,0,4,202,206,33,16,49,255,22,61,CO - Grand Junction
8,1958-1959,1958-11-16,1959-03-19,124,0,7,228,235,29,13,42,277,19,65,CO - Grand Junction
9,1959-1960,1959-11-04,1960-03-16,134,0,22,274,296,47,44,91,387,30,124,CO - Grand Junction
10,1960-1961,1960-11-15,1961-04-07,144,0,2,272,274,20,4,24,298,12,35,CO - Grand Junction
11,1961-1962,1961-11-02,1962-04-30,180,0,49,351,400,38,123,161,561,26,109,CO - Grand Junction
12,1962-1963,1962-11-18,1963-04-02,136,0,86,356,442,46,186,232,674,18,119,CO - Grand Junction
13,1963-1964,1963-12-01,1964-04-25,147,0,16,360,376,31,72,103,479,19,75,CO - Grand Junction
14,1964-1965,1964-11-13,1965-04-09,148,0,15,256,271,50,65,115,386,24,102,CO - Grand Junction
15,1965-1966,1965-09-18,1966-04-19,214,0,9,279,288,46,62,108,396,26,106,CO - Grand Junction
16,1966-1967,1966-10-13,1967-04-25,195,0,32,284,316,29,110,139,455,16,68,CO - Grand Junction
17,1967-1968,1967-11-29,1968-04-19,143,0,90,392,482,40,238,278,760,26,144,CO - Grand Junction
18,1968-1969,1968-11-13,1969-03-12,120,0,32,314,346,44,76,120,466,27,117,CO - Grand Junction
19,1969-1970,1969-10-11,1970-04-29,201,0,13,266,279,43,12,55,334,26,80,CO - Grand Junction
20,1970-1971,1970-10-07,1971-04-20,196,0,25,340,365,24,23,47,412,18,94,CO - Grand Junction
21,1971-1972,1971-10-29,1972-02-29,124,0,28,299,327,28,80,108,435,17,94,CO - Grand Junction
22,1972-1973,1972-10-29,1973-04-18,172,0,88,447,535,60,294,354,889,35,176,CO - Grand Junction
23,1973-1974,1973-11-19,1974-04-13,146,0,65,400,465,56,281,337,802,27,139,CO - Grand Junction
24,1974-1975,1974-11-03,1975-05-06,185,0,39,362,401,66,94,160,561,31,148,CO - Grand Junction
25,1975-1976,1975-10-23,1976-04-16,177,0,32,387,419,43,88,131,550,23,114,CO - Grand Junction
26,1976-1977,1976-11-27,1977-04-02,127,0,19,372,391,16,11,27,418,12,44,CO - Grand Junction
27,1977-1978,1977-11-19,1978-03-14,116,0,13,173,186,34,46,80,266,20,63,CO - Grand Junction
28,1978-1979,1978-11-14,1979-05-08,176,0,112,462,574,82,414,496,1070,37,229,CO - Grand Junction
29,1979-1980,1979-11-19,1980-04-02,136,0,19,232,251,39,63,102,353,23,72,CO - Grand Junction
30,1980-1981,1980-12-01,1981-03-30,120,0,1,144,145,9,5,14,159,6,18,CO - Grand Junction
31,1981-1982,1981-10-30,1982-03-03,125,0,27,240,267,24,78,102,369,20,59,CO - Grand Junction
32,1982-1983,1982-12-01,1983-04-03,124,0,4,133,137,24,16,40,177,17,38,CO - Grand Junction
33,1983-1984,1983-11-08,1984-04-27,172,0,33,296,329,53,301,354,683,26,91,CO - Grand Junction
34,1984-1985,1984-10-17,1985-04-20,186,0,12,225,237,35,10,45,282,27,66,CO - Grand Junction
35,1985-1986,1985-11-09,1986-04-17,160,0,9,183,192,20,10,30,222,13,40,CO - Grand Junction
36,1986-1987,1986-10-12,1987-04-12,183,0,8,256,264,38,24,62,326,22,77,CO - Grand Junction
37,1987-1988,1987-11-14,1988-03-31,139,0,44,403,447,41,248,289,736,24,108,CO - Grand Junction
38,1988-1989,1988-11-25,1989-03-20,116,0,46,352,398,50,133,183,581,24,106,CO - Grand Junction
39,1989-1990,1989-12-01,1990-04-29,150,0,10,254,264,30,39,69,333,18,74,CO - Grand Junction
40,1990-1991,1990-11-26,1991-04-27,153,0,64,422,486,45,244,289,775,23,110,CO - Grand Junction
41,1991-1992,1991-10-28,1992-02-29,125,0,38,304,342,29,76,105,447,19,69,CO - Grand Junction
42,1992-1993,1992-11-10,1993-04-13,155,0,21,246,267,39,20,59,326,27,88,CO - Grand Junction
43,1993-1994,1993-11-14,1994-03-24,131,0,9,248,257,21,17,38,295,16,51,CO - Grand Junction
44,1994-1995,1994-11-13,1995-03-29,137,0,4,181,185,26,6,32,217,17,51,CO - Grand Junction
45,1995-1996,1995-10-22,1996-03-25,156,0,3,227,230,20,3,23,253,15,44,CO - Grand Junction
46,1996-1997,1996-10-20,1997-04-05,168,0,11,260,271,37,14,51,322,22,70,CO - Grand Junction
47,1997-1998,1997-10-24,1998-04-02,161,0,6,271,277,21,1,22,299,15,44,CO - Grand Junction
48,1998-1999,1998-11-08,1999-04-03,147,0,22,270,292,28,24,52,344,14,64,CO - Grand Junction
49,1999-2000,1999-12-01,2000-03-21,112,0,9,188,197,23,5,28,225,15,47,CO - Grand Junction
50,2000-2001,2000-11-05,2001-03-12,128,0,7,274,281,31,8,39,320,23,61,CO - Grand Junction
51,2001-2002,2001-11-25,2002-03-14,110,0,14,300,314,30,10,40,354,21,78,CO - Grand Junction
52,2002-2003,2002-11-25,2003-05-09,166,0,4,199,203,21,5,26,229,14,45,CO - Grand Junction
53,2003-2004,2003-11-22,2004-02-29,100,0,40,294,334,33,91,124,458,16,78,CO - Grand Junction
54,2004-2005,2004-10-31,2005-03-30,151,0,15,212,227,34,56,90,317,16,66,CO - Grand Junction
55,2005-2006,2005-12-01,2006-03-30,120,0,12,239,251,21,11,32,283,13,39,CO - Grand Junction
56,2006-2007,2006-10-26,2007-04-12,169,0,36,310,346,28,42,70,416,17,80,CO - Grand Junction
57,2007-2008,2007-12-01,2008-05-01,153,0,52,337,389,40,123,163,552,30,136,CO - Grand Junction
58,2008-2009,2008-12-01,2009-04-04,125,0,32,276,308,34,125,159,467,18,96,CO - Grand Junction
59,2009-2010,2009-10-27,2010-04-29,185,0,67,440,507,43,254,297,804,24,102,CO - Grand Junction
60,2010-2011,2010-11-15,2011-04-30,167,0,37,295,332,23,55,78,410,15,64,CO - Grand Junction
61,2011-2012,2011-12-01,2012-03-02,93,0,4,217,221,16,5,21,242,12,36,CO - Grand Junction
62,2012-2013,2012-11-10,2013-04-17,159,0,79,408,487,38,144,182,669,23,133,CO - Grand Junction
63,2013-2014,2013-10-03,2014-02-28,149,0,56,370,426,38,247,285,711,17,103,CO - Grand Junction
64,2014-2015,2014-11-13,2015-04-16,155,0,13,248,261,20,23,43,304,13,47,CO - Grand Junction
65,2015-2016,2015-11-05,2016-03-23,140,0,37,329,366,46,145,191,557,27,128,CO - Grand Junction
66,2016-2017,2016-11-17,2017-02-28,104,0,12,183,195,25,17,42,237,15,54,CO - Grand Junction
67,2017-2018,2017-12-01,2018-03-18,108,0,1,230,231,15,6,21,252,10,38,CO - Grand Junction
68,2018-2019,2018-11-24,2019-02-28,97,0,23,219,242,31,40,71,313,20,83,CO - Grand Junction
69,2019-2020,2019-10-29,2020-03-27,151,0,20,288,308,24,15,39,347,16,58,CO - Grand Junction
0,1950-1951,1950-11-09,1951-03-17,129,9,31,413,444,23,17,40,484,11,79,CO - Lamar
2,1952-1953,1952-11-24,1953-04-11,139,7,17,341,358,16,24,40,398,8,39,CO - Lamar
3,1953-1954,1953-11-19,1954-05-01,164,1,14,350,364,39,51,90,454,14,90,CO - Lamar
4,1954-1955,1954-11-29,1955-03-26,118,3,12,369,381,17,16,33,414,13,77,CO - Lamar
5,1955-1956,1955-10-23,1956-04-09,170,5,29,477,506,40,68,108,614,19,121,CO - Lamar
6,1956-1957,1956-11-01,1957-04-12,163,6,24,396,420,35,8,43,463,18,98,CO - Lamar
7,1957-1958,1957-11-03,1958-03-28,146,0,22,349,371,50,39,89,460,24,116,CO - Lamar
8,1958-1959,1958-11-17,1959-04-11,146,0,31,399,430,47,47,94,524,15,123,CO - Lamar
9,1959-1960,1959-10-30,1960-04-29,183,1,66,485,551,65,194,259,810,18,163,CO - Lamar
10,1960-1961,1960-11-08,1961-04-08,152,0,14,353,367,48,78,126,493,17,84,CO - Lamar
12,1962-1963,1962-11-16,1963-03-13,118,2,39,399,438,33,24,57,495,18,128,CO - Lamar
13,1963-1964,1963-12-01,1964-04-07,129,0,25,424,449,40,46,86,535,23,119,CO - Lamar
14,1964-1965,1964-11-18,1965-03-25,128,0,24,398,422,29,23,52,474,21,106,CO - Lamar
16,1966-1967,1966-12-01,1967-03-07,97,0,17,315,332,18,32,50,382,8,46,CO - Lamar
17,1967-1968,1967-10-29,1968-03-11,135,0,19,325,344,30,24,54,398,15,84,CO - Lamar
18,1968-1969,1968-12-01,1969-03-17,107,0,20,317,337,36,56,92,429,7,59,CO - Lamar
19,1969-1970,1969-10-11,1970-04-30,202,1,13,366,379,41,17,58,437,13,65,CO - Lamar
20,1970-1971,1970-10-07,1971-03-05,150,3,25,317,342,30,31,61,403,11,57,CO - Lamar
21,1971-1972,1971-10-29,1972-03-28,152,0,24,307,331,24,23,47,378,10,62,CO - Lamar
23,1973-1974,1973-11-19,1974-04-03,136,0,49,328,377,41,140,181,558,13,93,CO - Lamar
24,1974-1975,1974-11-30,1975-04-02,124,0,18,319,337,25,43,68,405,9,59,CO - Lamar
25,1975-1976,1975-11-19,1976-03-04,107,0,21,254,275,40,53,93,368,9,78,CO - Lamar
26,1976-1977,1976-10-26,1977-03-11,137,4,21,351,372,28,23,51,423,11,67,CO - Lamar
27,1977-1978,1977-12-01,1978-03-03,93,1,42,302,344,25,59,84,428,12,87,CO - Lamar
28,1978-1979,1978-11-11,1979-04-03,144,0,74,395,469,43,61,104,573,18,138,CO - Lamar
29,1979-1980,1979-10-30,1980-04-07,161,1,33,352,385,90,100,190,575,22,143,CO - Lamar
30,1980-1981,1980-11-13,1981-03-21,129,0,13,283,296,28,24,52,348,11,72,CO - Lamar
31,1981-1982,1981-12-01,1982-03-05,95,0,41,298,339,20,58,78,417,9,71,CO - Lamar
32,1982-1983,1982-12-01,1983-04-13,134,0,15,277,292,33,91,124,416,13,66,CO - Lamar
33,1983-1984,1983-11-26,1984-04-02,129,5,79,371,450,75,122,197,647,21,194,CO - Lamar
34,1984-1985,1984-09-28,1985-03-30,184,16,35,325,360,35,76,111,471,11,79,CO - Lamar
35,1985-1986,1985-09-28,1986-02-28,154,12,29,272,301,22,14,36,337,12,61,CO - Lamar
37,1987-1988,1987-11-15,1988-04-02,140,20,31,444,475,62,79,141,616,16,123,CO - Lamar
38,1988-1989,1988-12-01,1989-03-21,111,8,31,408,439,13,7,20,459,6,67,CO - Lamar
39,1989-1990,1989-12-01,1990-03-25,115,0,30,375,405,62,92,154,559,8,92,CO - Lamar
40,1990-1991,1990-11-03,1991-03-17,135,0,40,403,443,26,25,51,494,7,63,CO - Lamar
41,1991-1992,1991-10-31,1992-02-29,122,2,12,385,397,54,58,112,509,13,102,CO - Lamar
42,1992-1993,1992-11-11,1993-04-04,145,1,63,464,527,88,231,319,846,20,172,CO - Lamar
43,1993-1994,1993-10-29,1994-04-28,182,3,24,474,498,37,38,75,573,11,66,CO - Lamar
44,1994-1995,1994-11-21,1995-04-20,151,3,20,307,327,42,41,83,410,13,86,CO - Lamar
45,1995-1996,1995-09-21,1996-04-14,207,1,37,509,546,28,26,54,600,11,88,CO - Lamar
46,1996-1997,1996-11-17,1997-04-12,147,0,36,420,456,44,45,89,545,13,107,CO - Lamar
47,1997-1998,1997-10-25,1998-03-21,148,0,23,346,369,83,115,198,567,12,115,CO - Lamar
48,1998-1999,1998-12-01,1999-03-19,109,5,23,293,316,43,37,80,396,10,78,CO - Lamar
49,1999-2000,1999-11-23,2000-03-16,115,7,4,301,305,22,16,38,343,6,36,CO - Lamar
50,2000-2001,2000-12-01,2001-03-26,116,4,34,365,399,72,94,166,565,13,126,CO - Lamar
51,2001-2002,2001-11-28,2002-03-09,102,4,19,356,375,25,25,50,425,6,57,CO - Lamar
52,2002-2003,2002-10-30,2003-03-05,127,6,27,333,360,39,37,76,436,8,62,CO - Lamar
53,2003-2004,2003-11-23,2004-02-29,99,0,13,336,349,16,11,27,376,7,40,CO - Lamar
54,2004-2005,2004-11-29,2005-03-26,118,0,21,296,317,29,33,62,379,9,81,CO - Lamar
55,2005-2006,2005-12-01,2006-03-24,114,1,23,329,352,29,32,61,413,5,42,CO - Lamar
56,2006-2007,2006-11-30,2007-04-14,136,0,84,455,539,110,447,557,1096,14,182,CO - Lamar
57,2007-2008,2007-11-24,2008-03-03,101,1,24,370,394,28,28,56,450,11,83,CO - Lamar
58,2008-2009,2008-11-28,2009-04-02,126,11,22,337,359,37,29,66,425,8,71,CO - Lamar
63,2013-2014,2013-11-22,2014-04-14,144,1,69,441,510,58,90,148,658,15,136,CO - Lamar
64,2014-2015,2014-11-11,2015-03-05,115,0,49,340,389,52,65,117,506,13,126,CO - Lamar
65,2015-2016,2015-11-18,2016-03-19,123,0,12,304,316,26,15,41,357,7,45,CO - Lamar
66,2016-2017,2016-12-01,2017-05-01,152,1,32,345,377,42,47,89,466,9,88,CO - Lamar
67,2017-2018,2017-12-01,2018-04-07,128,0,26,394,420,11,7,18,438,4,30,CO - Lamar
68,2018-2019,2018-10-15,2019-03-30,167,0,36,441,477,51,54,105,582,12,111,CO - Lamar
69,2019-2020,2019-10-29,2020-02-29,124,0,13,372,385,28,17,45,430,10,68,CO - Lamar
0,1950-1951,1950-11-09,1951-04-10,153,0,37,412,449,37,23,60,509,22,162,CO - Pueblo
1,1951-1952,1951-10-26,1952-04-09,167,0,20,385,405,53,30,83,488,19,125,CO - Pueblo
2,1952-1953,1952-11-08,1953-05-13,187,1,15,391,406,43,46,89,495,21,105,CO - Pueblo
3,1953-1954,1953-11-18,1954-05-02,166,0,10,303,313,40,37,77,390,20,97,CO - Pueblo
4,1954-1955,1954-11-29,1955-04-12,135,0,18,384,402,24,28,52,454,18,100,CO - Pueblo
5,1955-1956,1955-10-23,1956-04-09,170,0,31,450,481,59,99,158,639,26,187,CO - Pueblo
6,1956-1957,1956-11-01,1957-04-08,159,0,16,365,381,52,30,82,463,23,138,CO - Pueblo
7,1957-1958,1957-10-24,1958-04-29,188,0,9,330,339,47,11,58,397,36,121,CO - Pueblo
8,1958-1959,1958-11-17,1959-04-21,156,1,29,374,403,58,60,118,521,27,161,CO - Pueblo
9,1959-1960,1959-09-29,1960-04-29,214,2,53,477,530,77,136,213,743,33,221,CO - Pueblo
10,1960-1961,1960-11-08,1961-04-25,169,0,15,357,372,46,41,87,459,27,109,CO - Pueblo
11,1961-1962,1961-10-29,1962-04-30,184,1,65,504,569,79,105,184,753,31,231,CO - Pueblo
12,1962-1963,1962-11-16,1963-03-13,118,0,45,375,420,33,59,92,512,21,139,CO - Pueblo
13,1963-1964,1963-12-01,1964-04-04,126,0,22,423,445,42,62,104,549,20,131,CO - Pueblo
14,1964-1965,1964-11-16,1965-03-29,134,0,28,401,429,50,54,104,533,27,169,CO - Pueblo
15,1965-1966,1965-11-26,1966-05-12,168,0,15,402,417,34,35,69,486,24,104,CO - Pueblo
16,1966-1967,1966-10-31,1967-04-13,165,0,10,366,376,16,13,29,405,11,55,CO - Pueblo
17,1967-1968,1967-11-02,1968-04-18,169,0,38,404,442,60,96,156,598,22,134,CO - Pueblo
18,1968-1969,1968-11-06,1969-03-15,130,0,16,313,329,39,48,87,416,22,106,CO - Pueblo
19,1969-1970,1969-10-11,1970-04-30,202,0,13,328,341,49,43,92,433,22,89,CO - Pueblo
20,1970-1971,1970-10-07,1971-04-05,181,1,17,354,371,48,41,89,460,20,91,CO - Pueblo
21,1971-1972,1971-09-17,1972-03-31,197,0,25,401,426,50,41,91,517,19,126,CO - Pueblo
22,1972-1973,1972-10-31,1973-05-02,184,0,60,433,493,81,111,192,685,32,235,CO - Pueblo
23,1973-1974,1973-11-19,1974-04-13,146,0,41,358,399,35,51,86,485,14,84,CO - Pueblo
24,1974-1975,1974-11-03,1975-04-18,167,0,23,396,419,39,26,65,484,24,110,CO - Pueblo
25,1975-1976,1975-11-09,1976-03-29,142,0,27,383,410,38,28,66,476,25,126,CO - Pueblo
26,1976-1977,1976-10-26,1977-03-21,147,1,21,428,449,26,19,45,494,18,105,CO - Pueblo
27,1977-1978,1977-11-20,1978-05-06,168,0,30,368,398,28,10,38,436,21,118,CO - Pueblo
28,1978-1979,1978-11-11,1979-05-09,180,0,78,465,543,50,62,112,655,25,170,CO - Pueblo
29,1979-1980,1979-11-09,1980-04-25,169,0,32,394,426,65,62,127,553,32,163,CO - Pueblo
30,1980-1981,1980-11-14,1981-04-04,142,1,8,266,274,27,15,42,316,12,54,CO - Pueblo
31,1981-1982,1981-11-26,1982-05-05,161,20,33,317,350,34,33,67,417,17,94,CO - Pueblo
32,1982-1983,1982-11-22,1983-04-13,143,0,15,307,322,39,13,52,374,22,86,CO - Pueblo
33,1983-1984,1983-11-08,1984-05-07,182,0,75,463,538,63,115,178,716,31,207,CO - Pueblo
34,1984-1985,1984-09-28,1985-03-30,184,0,40,387,427,57,49,106,533,27,144,CO - Pueblo
35,1985-1986,1985-09-28,1986-04-03,188,0,41,378,419,64,98,162,581,25,174,CO - Pueblo
36,1986-1987,1986-11-01,1987-04-06,157,0,17,382,399,50,66,116,515,22,105,CO - Pueblo
37,1987-1988,1987-11-17,1988-05-02,168,0,49,490,539,97,150,247,786,35,242,CO - Pueblo
38,1988-1989,1988-11-25,1989-04-30,157,0,44,424,468,47,60,107,575,18,128,CO - Pueblo
39,1989-1990,1989-12-01,1990-05-03,154,0,32,339,371,98,75,173,544,29,197,CO - Pueblo
40,1990-1991,1990-10-08,1991-04-30,205,0,40,465,505,44,28,72,577,20,112,CO - Pueblo
41,1991-1992,1991-10-29,1992-03-22,146,1,12,339,351,71,57,128,479,22,135,CO - Pueblo
42,1992-1993,1992-11-02,1993-03-12,131,3,42,433,475,43,52,95,570,20,132,CO - Pueblo
43,1993-1994,1993-10-28,1994-04-30,185,1,15,527,542,87,50,137,679,27,171,CO - Pueblo
44,1994-1995,1994-11-03,1995-04-26,175,0,22,436,458,63,40,103,561,23,130,CO - Pueblo
45,1995-1996,1995-09-20,1996-04-05,199,5,29,581,610,33,16,49,659,20,110,CO - Pueblo
46,1996-1997,1996-09-27,1997-04-24,210,1,37,535,572,49,32,81,653,28,163,CO - Pueblo
47,1997-1998,1997-10-24,1998-04-18,177,1,18,451,469,61,31,92,561,24,109,CO - Pueblo
48,1998-1999,1998-12-01,1999-04-15,136,0,24,343,367,31,30,61,428,15,89,CO - Pueblo
49,1999-2000,1999-10-16,2000-04-02,170,0,4,389,393,27,14,41,434,14,56,CO - Pueblo
50,2000-2001,2000-11-10,2001-05-21,193,0,31,485,516,44,79,123,639,18,115,CO - Pueblo
51,2001-2002,2001-11-27,2002-03-25,119,0,18,473,491,27,22,49,540,15,94,CO - Pueblo
52,2002-2003,2002-10-23,2003-04-07,167,0,16,369,385,35,29,64,449,21,88,CO - Pueblo
53,2003-2004,2003-11-22,2004-04-30,161,0,9,359,368,34,25,59,427,17,69,CO - Pueblo
54,2004-2005,2004-11-10,2005-04-10,152,0,15,360,375,30,13,43,418,20,74,CO - Pueblo
55,2005-2006,2005-12-01,2006-03-22,112,0,20,354,374,28,27,55,429,15,95,CO - Pueblo
56,2006-2007,2006-11-29,2007-04-13,136,0,34,377,411,47,46,93,504,26,170,CO - Pueblo
57,2007-2008,2007-11-21,2008-04-17,149,0,17,463,480,41,33,74,554,26,129,CO - Pueblo
58,2008-2009,2008-11-27,2009-04-18,143,0,20,371,391,22,13,35,426,15,73,CO - Pueblo
59,2009-2010,2009-10-10,2010-03-24,166,0,28,468,496,43,30,73,569,23,122,CO - Pueblo
60,2010-2011,2010-11-28,2011-04-24,148,0,39,412,451,36,54,90,541,18,136,CO - Pueblo
61,2011-2012,2011-10-26,2012-04-03,161,1,13,377,390,46,63,109,499,20,116,CO - Pueblo
62,2012-2013,2012-10-25,2013-05-01,189,0,20,488,508,39,16,55,563,25,122,CO - Pueblo
63,2013-2014,2013-10-18,2014-04-14,179,0,48,422,470,45,35,80,550,22,144,CO - Pueblo
64,2014-2015,2014-11-10,2015-03-05,116,0,41,353,394,64,57,121,515,25,194,CO - Pueblo
65,2015-2016,2015-11-20,2016-04-30,163,0,12,306,318,49,54,103,421,19,100,CO - Pueblo
66,2016-2017,2016-12-01,2017-04-30,151,0,24,282,306,40,40,80,386,13,93,CO - Pueblo
67,2017-2018,2017-11-07,2018-02-28,114,0,13,328,341,25,15,40,381,15,70,CO - Pueblo
68,2018-2019,2018-10-14,2019-03-05,143,1,17,385,402,29,22,51,453,19,115,CO - Pueblo
69,2019-2020,2019-10-10,2020-04-17,191,0,17,410,427,53,49,102,529,29,145,CO - Pueblo
8,1958-1959,1958-11-16,1959-03-31,136,20,64,377,441,94,241,335,776,19,171,CO - Sedgwick
9,1959-1960,1959-10-01,1960-04-17,200,0,92,472,564,99,387,486,1050,24,199,CO - Sedgwick
10,1960-1961,1960-11-04,1961-04-14,162,16,28,352,380,93,89,182,562,23,160,CO - Sedgwick
11,1961-1962,1961-11-02,1962-04-08,158,0,87,478,565,56,86,142,707,23,185,CO - Sedgwick
12,1962-1963,1962-11-15,1963-04-03,140,0,75,370,445,63,170,233,678,16,118,CO - Sedgwick
13,1963-1964,1963-11-22,1964-04-12,143,1,41,402,443,53,71,124,567,19,124,CO - Sedgwick
14,1964-1965,1964-12-01,1965-03-26,116,0,43,397,440,38,64,102,542,15,113,CO - Sedgwick
15,1965-1966,1965-12-01,1966-04-19,140,0,71,383,454,54,274,328,782,16,135,CO - Sedgwick
16,1966-1967,1966-10-14,1967-04-30,199,0,25,370,395,38,34,72,467,12,86,CO - Sedgwick
17,1967-1968,1967-11-02,1968-04-07,158,0,52,411,463,57,182,239,702,17,121,CO - Sedgwick
18,1968-1969,1968-12-01,1969-03-13,103,1,55,357,412,37,97,134,546,16,121,CO - Sedgwick
19,1969-1970,1969-10-05,1970-03-31,178,0,30,388,418,82,66,148,566,16,121,CO - Sedgwick
20,1970-1971,1970-11-08,1971-04-27,171,2,57,403,460,94,180,274,734,21,191,CO - Sedgwick
21,1971-1972,1971-10-29,1972-02-29,124,6,38,348,386,16,23,39,425,5,50,CO - Sedgwick
22,1972-1973,1972-10-30,1973-04-26,179,6,107,452,559,108,277,385,944,18,194,CO - Sedgwick
23,1973-1974,1973-10-11,1974-03-23,164,2,70,365,435,67,213,280,715,19,167,CO - Sedgwick
24,1974-1975,1974-11-29,1975-04-11,134,14,27,378,405,27,56,83,488,7,51,CO - Sedgwick
25,1975-1976,1975-10-24,1976-03-15,144,7,57,352,409,66,182,248,657,15,144,CO - Sedgwick
26,1976-1977,1976-11-12,1977-04-20,160,4,29,410,439,74,124,198,637,11,113,CO - Sedgwick
27,1977-1978,1977-11-09,1978-03-15,127,1,89,440,529,45,166,211,740,15,139,CO - Sedgwick
28,1978-1979,1978-11-11,1979-05-10,181,0,116,529,645,80,320,400,1045,20,188,CO - Sedgwick
29,1979-1980,1979-11-05,1980-04-10,158,1,74,408,482,129,383,512,994,23,241,CO - Sedgwick
30,1980-1981,1980-11-14,1981-04-04,142,3,22,315,337,47,70,117,454,14,105,CO - Sedgwick
31,1981-1982,1981-11-19,1982-04-03,136,5,53,399,452,47,99,146,598,18,168,CO - Sedgwick
32,1982-1983,1982-10-19,1983-04-13,177,1,28,343,371,73,177,250,621,16,124,CO - Sedgwick
33,1983-1984,1983-11-09,1984-04-30,174,7,121,481,602,136,466,602,1204,29,319,CO - Sedgwick
34,1984-1985,1984-09-28,1985-04-06,191,4,66,460,526,45,225,270,796,17,129,CO - Sedgwick
35,1985-1986,1985-09-29,1986-04-05,189,6,100,414,514,103,463,566,1080,19,197,CO - Sedgwick
36,1986-1987,1986-10-11,1987-03-30,171,0,25,330,355,78,93,171,526,23,152,CO - Sedgwick
37,1987-1988,1987-11-16,1988-04-23,160,12,81,416,497,94,336,430,927,21,185,CO - Sedgwick
38,1988-1989,1988-11-27,1989-04-11,136,4,63,409,472,51,84,135,607,16,149,CO - Sedgwick
39,1989-1990,1989-11-15,1990-05-09,176,1,51,375,426,51,148,199,625,15,146,CO - Sedgwick
40,1990-1991,1990-10-08,1991-03-30,174,2,66,392,458,50,75,125,583,15,106,CO - Sedgwick
41,1991-1992,1991-10-29,1992-03-19,143,3,21,279,300,59,162,221,521,13,110,CO - Sedgwick
42,1992-1993,1992-10-29,1993-04-13,167,0,93,479,572,70,258,328,900,20,178,CO - Sedgwick
43,1993-1994,1993-09-14,1994-04-30,229,1,44,411,455,54,115,169,624,17,112,CO - Sedgwick
44,1994-1995,1994-11-04,1995-04-26,174,16,48,346,394,38,91,129,523,12,80,CO - Sedgwick
45,1995-1996,1995-09-21,1996-04-28,221,1,54,457,511,41,35,76,587,13,113,CO - Sedgwick
46,1996-1997,1996-10-31,1997-04-12,164,7,66,423,489,32,31,63,552,13,108,CO - Sedgwick
47,1997-1998,1997-10-25,1998-03-09,136,4,24,284,308,39,57,96,404,11,82,CO - Sedgwick
48,1998-1999,1998-11-03,1999-04-10,159,2,31,290,321,34,46,80,401,14,96,CO - Sedgwick
49,1999-2000,1999-11-23,2000-04-16,146,3,9,230,239,32,51,83,322,9,60,CO - Sedgwick
50,2000-2001,2000-09-24,2001-04-23,212,16,47,395,442,67,100,167,609,17,139,CO - Sedgwick
51,2001-2002,2001-10-05,2002-03-25,172,11,36,377,413,38,96,134,547,9,84,CO - Sedgwick
52,2002-2003,2002-10-23,2003-04-08,168,2,29,342,371,45,71,116,487,16,122,CO - Sedgwick
53,2003-2004,2003-10-31,2004-04-12,165,2,26,355,381,34,68,102,483,10,80,CO - Sedgwick
54,2004-2005,2004-11-02,2005-04-29,179,0,33,300,333,48,89,137,470,12,90,CO - Sedgwick
55,2005-2006,2005-12-01,2006-04-07,128,5,39,278,317,35,57,92,409,10,88,CO - Sedgwick
56,2006-2007,2006-10-18,2007-04-07,172,9,69,397,466,47,372,419,885,10,103,CO - Sedgwick
57,2007-2008,2007-11-21,2008-05-03,165,3,58,478,536,55,185,240,776,19,143,CO - Sedgwick
58,2008-2009,2008-11-11,2009-04-10,151,11,55,423,478,39,60,99,577,14,112,CO - Sedgwick
59,2009-2010,2009-10-10,2010-04-07,180,3,77,459,536,60,113,173,709,19,147,CO - Sedgwick
61,2011-2012,2011-10-26,2012-02-29,127,10,27,363,390,26,88,114,504,9,62,CO - Sedgwick
62,2012-2013,2012-10-06,2013-05-02,209,4,67,458,525,65,158,223,748,22,150,CO - Sedgwick
63,2013-2014,2013-10-18,2014-05-08,203,0,100,501,601,48,124,172,773,23,161,CO - Sedgwick
64,2014-2015,2014-11-04,2015-05-20,198,1,79,434,513,48,153,201,714,20,149,CO - Sedgwick
65,2015-2016,2015-11-11,2016-05-02,174,0,50,356,406,62,220,282,688,17,118,CO - Sedgwick
66,2016-2017,2016-11-18,2017-02-28,103,0,63,334,397,22,48,70,467,10,80,CO - Sedgwick
67,2017-2018,2017-10-09,2018-04-21,195,2,71,458,529,65,129,194,723,24,184,CO - Sedgwick
68,2018-2019,2018-10-10,2019-05-22,225,0,80,492,572,58,84,142,714,26,162,CO - Sedgwick
69,2019-2020,2019-10-11,2020-04-18,191,0,36,423,459,53,85,138,597,30,170,CO - Sedgwick
4,1954-1955,1954-12-01,1955-04-09,130,14,15,327,342,8,38,46,388,2,14,CO - Trinidad
5,1955-1956,1955-12-01,1956-03-15,106,11,11,238,249,4,39,43,292,1,9,CO - Trinidad
6,1956-1957,1956-11-02,1957-04-28,178,10,3,296,299,60,31,91,390,23,108,CO - Trinidad
7,1957-1958,1957-11-16,1958-04-12,148,6,10,310,320,31,55,86,406,11,63,CO - Trinidad
8,1958-1959,1958-11-17,1959-04-21,156,1,14,304,318,82,90,172,490,22,157,CO - Trinidad
11,1961-1962,1961-10-29,1962-03-31,154,9,34,383,417,49,60,109,526,11,79,CO - Trinidad
13,1963-1964,1963-11-25,1964-04-07,135,12,23,374,397,93,117,210,607,22,174,CO - Trinidad
14,1964-1965,1964-11-16,1965-04-27,163,5,20,353,373,82,89,171,544,25,184,CO - Trinidad
15,1965-1966,1965-12-01,1966-04-20,141,0,10,297,307,47,55,102,409,14,95,CO - Trinidad
17,1967-1968,1967-11-02,1968-04-28,179,2,15,320,335,91,131,222,557,27,176,CO - Trinidad
18,1968-1969,1968-11-10,1969-04-17,159,10,18,310,328,38,73,111,439,9,74,CO - Trinidad
20,1970-1971,1970-12-01,1971-04-05,126,7,26,253,279,43,39,82,361,8,79,CO - Trinidad
21,1971-1972,1971-10-29,1972-04-15,170,2,8,268,276,66,78,144,420,18,122,CO - Trinidad
35,1985-1986,1985-10-30,1986-05-17,200,12,25,275,300,58,43,101,401,11,89,CO - Trinidad
38,1988-1989,1988-11-15,1989-04-10,147,9,29,318,347,71,62,133,480,15,139,CO - Trinidad
39,1989-1990,1989-10-18,1990-05-04,199,6,10,313,323,93,88,181,504,20,154,CO - Trinidad
41,1991-1992,1991-10-29,1992-04-01,156,16,14,281,295,61,95,156,451,15,122,CO - Trinidad
48,1998-1999,1998-11-01,1999-04-15,166,17,11,236,247,75,41,116,363,17,133,CO - Trinidad
49,1999-2000,1999-10-17,2000-04-11,178,20,2,306,308,75,56,131,439,11,105,CO - Trinidad
51,2001-2002,2001-11-27,2002-04-09,134,20,10,292,302,40,26,66,368,14,85,CO - Trinidad
55,2005-2006,2005-11-15,2006-03-20,126,15,5,257,262,42,26,68,330,10,64,CO - Trinidad
56,2006-2007,2006-10-26,2007-04-13,170,8,25,379,404,114,296,410,814,20,208,CO - Trinidad
57,2007-2008,2007-10-21,2008-04-17,180,12,14,344,358,83,130,213,571,22,160,CO - Trinidad
58,2008-2009,2008-11-30,2009-04-12,134,18,9,260,269,65,41,106,375,13,100,CO - Trinidad
63,2013-2014,2013-11-22,2014-05-12,172,17,29,356,385,52,20,72,457,20,124,CO - Trinidad
64,2014-2015,2014-11-12,2015-03-25,134,0,30,310,340,78,87,165,505,22,180,CO - Trinidad
65,2015-2016,2015-11-16,2016-05-01,168,0,15,273,288,86,59,145,433,20,134,CO - Trinidad
66,2016-2017,2016-12-01,2017-04-30,151,1,8,224,232,73,83,156,388,12,109,CO - Trinidad
67,2017-2018,2017-10-26,2018-04-13,170,1,4,238,242,28,13,41,283,13,56,CO - Trinidad
68,2018-2019,2018-10-14,2019-04-11,180,0,18,334,352,74,53,127,479,25,174,CO - Trinidad
69,2019-2020,2019-10-23,2020-04-13,174,1,13,359,372,75,108,183,555,18,147,CO - Trinidad
0,1950-1951,1950-12-01,1951-03-22,112,0,24,142,166,20,17,37,203,13,53,CT - Bridgeport
1,1951-1952,1951-11-20,1952-03-16,118,0,17,170,187,35,23,58,245,18,60,CT - Bridgeport
2,1952-1953,1952-12-01,1953-03-08,98,0,6,112,118,13,10,23,141,7,25,CT - Bridgeport
3,1953-1954,1953-11-06,1954-02-28,115,0,17,143,160,26,41,67,227,13,63,CT - Bridgeport
4,1954-1955,1954-12-01,1955-04-04,125,0,22,174,196,19,6,25,221,15,51,CT - Bridgeport
5,1955-1956,1955-11-19,1956-03-25,128,0,27,200,227,51,42,93,320,20,100,CT - Bridgeport
6,1956-1957,1956-12-01,1957-04-04,125,0,22,175,197,30,35,65,262,14,71,CT - Bridgeport
7,1957-1958,1957-12-01,1958-04-11,132,2,32,169,201,70,131,201,402,17,104,CT - Bridgeport
8,1958-1959,1958-11-30,1959-04-12,134,0,39,248,287,22,27,49,336,12,49,CT - Bridgeport
9,1959-1960,1959-11-18,1960-03-22,126,0,16,164,180,33,60,93,273,16,72,CT - Bridgeport
10,1960-1961,1960-12-01,1961-03-19,109,0,51,243,294,66,236,302,596,19,129,CT - Bridgeport
11,1961-1962,1961-11-20,1962-03-21,122,0,33,203,236,40,101,141,377,18,83,CT - Bridgeport
12,1962-1963,1962-11-18,1963-03-21,124,0,51,255,306,45,71,116,422,23,101,CT - Bridgeport
13,1963-1964,1963-12-01,1964-03-12,103,0,34,190,224,58,121,179,403,21,118,CT - Bridgeport
14,1964-1965,1964-12-01,1965-04-02,123,0,38,212,250,60,144,204,454,22,124,CT - Bridgeport
15,1965-1966,1965-12-01,1966-03-13,103,0,22,163,185,33,80,113,298,14,63,CT - Bridgeport
16,1966-1967,1966-12-01,1967-03-25,115,0,35,195,230,87,143,230,460,27,157,CT - Bridgeport
17,1967-1968,1967-11-30,1968-03-13,105,0,38,216,254,31,66,97,351,19,85,CT - Bridgeport
18,1968-1969,1968-11-12,1969-03-07,116,0,27,163,190,44,80,124,314,15,66,CT - Bridgeport
19,1969-1970,1969-12-01,1970-04-02,123,0,35,230,265,50,135,185,450,25,121,CT - Bridgeport
20,1970-1971,1970-12-01,1971-04-07,128,0,35,194,229,43,71,114,343,27,83,CT - Bridgeport
21,1971-1972,1971-12-01,1972-04-08,130,0,21,174,195,36,50,86,281,20,71,CT - Bridgeport
22,1972-1973,1972-11-15,1973-02-28,106,0,31,173,204,16,15,31,235,11,41,CT - Bridgeport
23,1973-1974,1973-12-01,1974-03-30,120,0,25,160,185,52,128,180,365,19,103,CT - Bridgeport
24,1974-1975,1974-11-25,1975-04-04,131,0,9,126,135,29,24,53,188,13,47,CT - Bridgeport
25,1975-1976,1975-12-01,1976-03-17,108,0,28,174,202,42,70,112,314,17,94,CT - Bridgeport
26,1976-1977,1976-11-30,1977-03-23,114,0,52,217,269,41,133,174,443,21,84,CT - Bridgeport
27,1977-1978,1977-11-27,1978-03-19,113,0,61,227,288,77,215,292,580,21,111,CT - Bridgeport
28,1978-1979,1978-11-21,1979-02-28,100,0,49,173,222,26,44,70,292,12,59,CT - Bridgeport
29,1979-1980,1979-12-01,1980-03-31,122,0,30,168,198,14,11,25,223,6,28,CT - Bridgeport
30,1980-1981,1980-11-17,1981-03-17,121,0,47,237,284,18,78,96,380,12,49,CT - Bridgeport
31,1981-1982,1981-12-01,1982-04-09,130,0,38,230,268,33,97,130,398,14,79,CT - Bridgeport
32,1982-1983,1982-12-01,1983-04-19,140,0,21,147,168,32,89,121,289,10,54,CT - Bridgeport
33,1983-1984,1983-12-01,1984-03-30,121,0,43,199,242,32,86,118,360,16,80,CT - Bridgeport
34,1984-1985,1984-12-01,1985-03-04,94,0,26,148,174,30,53,83,257,15,74,CT - Bridgeport
35,1985-1986,1985-11-26,1986-03-21,116,0,33,196,229,30,53,83,312,17,77,CT - Bridgeport
36,1986-1987,1986-11-18,1987-03-13,116,0,17,178,195,33,58,91,286,19,62,CT - Bridgeport
37,1987-1988,1987-10-04,1988-03-15,164,0,31,186,217,36,77,113,330,17,70,CT - Bridgeport
38,1988-1989,1988-12-01,1989-03-24,114,0,22,166,188,24,25,49,237,12,55,CT - Bridgeport
39,1989-1990,1989-11-22,1990-04-07,137,0,36,204,240,48,50,98,338,20,105,CT - Bridgeport
40,1990-1991,1990-12-01,1991-03-30,120,0,12,115,127,35,31,66,193,14,56,CT - Bridgeport
41,1991-1992,1991-12-01,1992-03-25,116,0,15,168,183,27,25,52,235,13,56,CT - Bridgeport
42,1992-1993,1992-12-01,1993-03-21,111,0,18,183,201,44,55,99,300,19,78,CT - Bridgeport
43,1993-1994,1993-12-01,1994-03-19,109,0,63,251,314,79,226,305,619,28,190,CT - Bridgeport
44,1994-1995,1994-12-01,1995-02-28,90,0,20,124,144,15,29,44,188,4,21,CT - Bridgeport
45,1995-1996,1995-11-13,1996-04-10,150,0,49,241,290,109,264,373,663,31,193,CT - Bridgeport
51,2001-2002,2001-12-01,2002-03-20,110,0,2,90,92,15,14,29,121,7,25,CT - Bridgeport
52,2002-2003,2002-11-27,2003-04-08,133,3,48,230,278,90,163,253,531,20,143,CT - Bridgeport
54,2004-2005,2004-11-13,2005-03-24,132,0,26,179,205,79,172,251,456,22,137,CT - Bridgeport
55,2005-2006,2005-11-24,2006-03-06,103,0,13,132,145,51,70,121,266,10,71,CT - Bridgeport
56,2006-2007,2006-12-01,2007-03-22,112,0,27,165,192,21,42,63,255,8,42,CT - Bridgeport
57,2007-2008,2007-12-01,2008-03-01,92,0,6,114,120,30,51,81,201,11,51,CT - Bridgeport
58,2008-2009,2008-11-30,2009-03-07,98,0,33,191,224,62,146,208,432,18,113,CT - Bridgeport
59,2009-2010,2009-12-01,2010-03-05,95,0,24,147,171,57,121,178,349,17,84,CT - Bridgeport
60,2010-2011,2010-11-08,2011-03-24,137,3,26,202,228,93,386,479,707,20,134,CT - Bridgeport
61,2011-2012,2011-10-29,2012-02-29,124,0,4,80,84,21,13,34,118,7,29,CT - Bridgeport
62,2012-2013,2012-11-07,2013-03-19,133,3,17,131,148,93,162,255,403,19,124,CT - Bridgeport
63,2013-2014,2013-11-12,2014-04-16,156,0,46,242,288,82,240,322,610,24,149,CT - Bridgeport
64,2014-2015,2014-11-26,2015-03-30,125,0,48,259,307,87,326,413,720,29,182,CT - Bridgeport
65,2015-2016,2015-12-01,2016-04-04,126,0,14,110,124,40,68,108,232,11,59,CT - Bridgeport
66,2016-2017,2016-12-01,2017-03-22,112,0,11,109,120,56,106,162,282,11,80,CT - Bridgeport
67,2017-2018,2017-12-01,2018-04-03,124,0,33,165,198,67,83,150,348,16,95,CT - Bridgeport
68,2018-2019,2018-11-15,2019-03-10,116,1,17,154,171,34,38,72,243,11,50,CT - Bridgeport
69,2019-2020,2019-12-01,2020-02-29,91,0,6,83,89,16,19,35,124,7,24,CT - Bridgeport
0,1950-1951,1950-12-01,1951-03-22,112,0,25,201,226,48,69,117,343,19,107,CT - Hartford
1,1951-1952,1951-11-03,1952-03-19,138,0,26,242,268,68,152,220,488,27,120,CT - Hartford
2,1952-1953,1952-11-30,1953-03-08,99,0,11,164,175,39,66,105,280,16,71,CT - Hartford
3,1953-1954,1953-11-06,1954-04-01,147,0,32,248,280,39,60,99,379,21,116,CT - Hartford
4,1954-1955,1954-12-01,1955-04-04,125,0,39,241,280,37,40,77,357,21,84,CT - Hartford
5,1955-1956,1955-11-19,1956-04-23,157,0,49,317,366,106,205,311,677,32,185,CT - Hartford
6,1956-1957,1956-11-18,1957-04-12,146,0,39,308,347,68,133,201,548,31,161,CT - Hartford
7,1957-1958,1957-12-01,1958-04-12,133,0,48,266,314,77,199,276,590,25,145,CT - Hartford
8,1958-1959,1958-11-03,1959-03-30,148,0,65,405,470,66,102,168,638,28,151,CT - Hartford
9,1959-1960,1959-11-18,1960-03-26,130,1,38,298,336,67,210,277,613,27,146,CT - Hartford
10,1960-1961,1960-12-01,1961-04-13,134,0,82,442,524,110,472,582,1106,24,221,CT - Hartford
11,1961-1962,1961-11-20,1962-03-16,117,0,53,312,365,60,219,279,644,22,141,CT - Hartford
12,1962-1963,1962-11-18,1963-03-22,125,0,77,398,475,81,351,432,907,33,198,CT - Hartford
13,1963-1964,1963-12-01,1964-03-18,109,0,61,319,380,79,259,338,718,28,184,CT - Hartford
14,1964-1965,1964-12-01,1965-04-19,140,0,64,309,373,80,195,275,648,33,179,CT - Hartford
15,1965-1966,1965-12-01,1966-03-17,107,0,33,213,246,79,162,241,487,27,134,CT - Hartford
16,1966-1967,1966-12-01,1967-04-24,145,0,42,274,316,123,290,413,729,35,212,CT - Hartford
17,1967-1968,1967-11-09,1968-03-24,137,0,63,323,386,55,224,279,665,23,142,CT - Hartford
18,1968-1969,1968-11-10,1969-03-30,141,0,61,322,383,88,317,405,788,30,172,CT - Hartford
19,1969-1970,1969-12-01,1970-04-03,124,0,86,351,437,95,358,453,890,34,230,CT - Hartford
20,1970-1971,1970-12-01,1971-04-24,145,0,77,333,410,101,356,457,867,37,209,CT - Hartford
21,1971-1972,1971-11-24,1972-04-11,140,0,46,296,342,85,153,238,580,31,168,CT - Hartford
22,1972-1973,1972-10-19,1973-04-11,175,0,43,261,304,55,81,136,440,26,111,CT - Hartford
23,1973-1974,1973-12-01,1974-04-10,131,0,47,258,305,50,132,182,487,26,136,CT - Hartford
24,1974-1975,1974-11-25,1975-04-07,134,0,21,252,273,64,113,177,450,28,140,CT - Hartford
25,1975-1976,1975-11-24,1976-03-19,117,0,72,297,369,66,181,247,616,29,199,CT - Hartford
26,1976-1977,1976-11-10,1977-05-09,181,0,76,385,461,78,318,396,857,34,202,CT - Hartford
27,1977-1978,1977-11-23,1978-03-26,124,0,70,331,401,117,458,575,976,31,213,CT - Hartford
28,1978-1979,1978-11-21,1979-04-10,141,0,84,323,407,50,120,170,577,23,139,CT - Hartford
29,1979-1980,1979-10-10,1980-03-25,168,1,41,298,339,26,37,63,402,12,57,CT - Hartford
30,1980-1981,1980-11-17,1981-03-07,111,0,75,342,417,27,70,97,514,16,102,CT - Hartford
31,1981-1982,1981-12-01,1982-04-11,132,0,64,320,384,83,181,264,648,31,180,CT - Hartford
32,1982-1983,1982-12-01,1983-04-20,141,0,40,231,271,66,158,224,495,17,114,CT - Hartford
33,1983-1984,1983-12-01,1984-04-01,123,0,64,319,383,67,137,204,587,30,177,CT - Hartford
34,1984-1985,1984-11-13,1985-04-08,147,0,50,303,353,39,73,112,465,24,125,CT - Hartford
35,1985-1986,1985-11-16,1986-04-06,142,0,42,307,349,37,46,83,432,22,104,CT - Hartford
36,1986-1987,1986-11-11,1987-04-28,169,0,27,308,335,73,242,315,650,22,125,CT - Hartford
37,1987-1988,1987-11-10,1988-03-21,133,0,43,306,349,84,189,273,622,21,128,CT - Hartford
38,1988-1989,1988-12-01,1989-03-24,114,0,34,262,296,25,13,38,334,16,81,CT - Hartford
39,1989-1990,1989-11-23,1990-04-07,136,0,58,297,355,59,138,197,552,23,131,CT - Hartford
40,1990-1991,1990-12-01,1991-03-30,120,0,22,196,218,41,48,89,307,14,75,CT - Hartford
41,1991-1992,1991-11-11,1992-04-16,158,0,30,279,309,39,23,62,371,23,92,CT - Hartford
42,1992-1993,1992-12-01,1993-03-26,116,0,41,280,321,91,207,298,619,28,158,CT - Hartford
43,1993-1994,1993-11-25,1994-03-29,125,0,87,358,445,126,377,503,948,41,308,CT - Hartford
44,1994-1995,1994-11-27,1995-04-08,133,0,29,238,267,33,66,99,366,14,69,CT - Hartford
45,1995-1996,1995-11-13,1996-03-14,123,0,70,330,400,150,374,524,924,36,296,CT - Hartford
50,2000-2001,2000-11-25,2001-03-18,114,12,47,296,343,79,129,208,551,24,134,CT - Hartford
52,2002-2003,2002-11-27,2003-04-08,133,8,71,350,421,112,302,414,835,25,184,CT - Hartford
64,2014-2015,2014-11-26,2015-03-28,123,1,66,361,427,88,480,568,995,28,209,CT - Hartford
65,2015-2016,2015-12-01,2016-04-06,128,1,21,184,205,41,78,119,324,16,84,CT - Hartford
67,2017-2018,2017-12-01,2018-04-16,137,0,53,271,324,84,142,226,550,28,151,CT - Hartford
68,2018-2019,2018-11-15,2019-03-13,119,0,37,263,300,56,146,202,502,20,114,CT - Hartford
69,2019-2020,2019-11-13,2020-04-18,158,0,14,202,216,48,86,134,350,16,80,CT - Hartford
0,1950-1951,1950-11-21,1951-04-18,149,0,87,360,447,127,367,494,941,53,313,CT - Norfolk
1,1951-1952,1951-11-02,1952-04-13,164,4,96,419,515,161,633,794,1309,53,352,CT - Norfolk
2,1952-1953,1952-10-21,1953-04-21,183,0,63,352,415,132,340,472,887,63,314,CT - Norfolk
3,1953-1954,1953-11-07,1954-05-12,187,1,89,381,470,98,252,350,820,47,286,CT - Norfolk
5,1955-1956,1955-11-05,1956-04-29,177,1,134,490,624,264,880,1144,1768,82,564,CT - Norfolk
6,1956-1957,1956-11-10,1957-04-14,156,5,92,418,510,138,390,528,1038,57,346,CT - Norfolk
7,1957-1958,1957-10-28,1958-04-20,175,1,117,413,530,214,1000,1214,1744,60,433,CT - Norfolk
8,1958-1959,1958-10-14,1959-04-13,182,0,134,533,667,148,338,486,1153,60,406,CT - Norfolk
9,1959-1960,1959-11-03,1960-04-10,160,3,117,433,550,178,801,979,1529,64,420,CT - Norfolk
10,1960-1961,1960-10-25,1961-05-27,215,1,156,533,689,225,1153,1378,2067,63,492,CT - Norfolk
12,1962-1963,1962-10-26,1963-05-12,199,1,169,577,746,186,1060,1246,1992,63,480,CT - Norfolk
13,1963-1964,1963-11-03,1964-04-21,171,0,134,471,605,190,800,990,1595,62,478,CT - Norfolk
14,1964-1965,1964-10-21,1965-04-19,181,0,134,497,631,134,479,613,1244,61,403,CT - Norfolk
15,1965-1966,1965-11-02,1966-05-04,184,0,104,440,544,143,609,752,1296,55,359,CT - Norfolk
16,1966-1967,1966-11-06,1967-05-26,202,1,122,487,609,223,819,1042,1651,63,498,CT - Norfolk
17,1967-1968,1967-11-08,1968-03-25,139,0,150,502,652,120,622,742,1394,53,385,CT - Norfolk
18,1968-1969,1968-11-10,1969-04-07,149,0,143,476,619,191,1063,1254,1873,59,435,CT - Norfolk
19,1969-1970,1969-10-24,1970-05-07,196,0,160,575,735,173,905,1078,1813,66,478,CT - Norfolk
20,1970-1971,1970-10-17,1971-04-30,196,0,142,523,665,209,1129,1338,2003,67,479,CT - Norfolk
21,1971-1972,1971-11-09,1972-04-21,165,0,113,479,592,190,591,781,1373,69,440,CT - Norfolk
22,1972-1973,1972-10-19,1973-04-12,176,5,94,389,483,109,409,518,1001,43,242,CT - Norfolk
23,1973-1974,1973-11-06,1974-04-20,166,0,105,425,530,91,290,381,911,39,266,CT - Norfolk
24,1974-1975,1974-10-04,1975-04-27,206,3,86,448,534,155,694,849,1383,56,357,CT - Norfolk
25,1975-1976,1975-11-15,1976-05-20,188,0,127,471,598,140,504,644,1242,56,428,CT - Norfolk
26,1976-1977,1976-10-25,1977-05-11,199,0,172,557,729,190,702,892,1621,57,465,CT - Norfolk
28,1978-1979,1978-11-16,1979-04-15,151,2,160,447,607,138,588,726,1333,54,368,CT - Norfolk
30,1980-1981,1980-11-02,1981-03-27,146,0,147,510,657,115,431,546,1203,49,355,CT - Norfolk
31,1981-1982,1981-10-24,1982-04-15,174,3,143,520,663,141,884,1025,1688,59,425,CT - Norfolk
32,1982-1983,1982-10-17,1983-04-23,189,0,80,371,451,165,462,627,1078,44,312,CT - Norfolk
33,1983-1984,1983-11-18,1984-04-11,146,0,125,442,567,165,568,733,1300,54,398,CT - Norfolk
34,1984-1985,1984-11-13,1985-04-13,152,2,105,402,507,91,312,403,910,39,243,CT - Norfolk
35,1985-1986,1985-11-17,1986-04-24,159,0,121,427,548,102,492,594,1142,51,300,CT - Norfolk
36,1986-1987,1986-11-06,1987-05-01,177,2,99,432,531,159,872,1031,1562,50,320,CT - Norfolk
37,1987-1988,1987-10-04,1988-04-20,200,0,114,483,597,175,720,895,1492,53,380,CT - Norfolk
38,1988-1989,1988-10-27,1989-04-14,170,1,104,426,530,87,155,242,772,43,243,CT - Norfolk
39,1989-1990,1989-11-19,1990-04-07,140,0,124,429,553,121,372,493,1046,48,349,CT - Norfolk
40,1990-1991,1990-11-12,1991-04-14,154,4,67,334,401,99,177,276,677,40,249,CT - Norfolk
41,1991-1992,1991-11-12,1992-04-26,167,1,94,412,506,82,138,220,726,49,281,CT - Norfolk
42,1992-1993,1992-11-09,1993-04-23,166,4,104,443,547,155,750,905,1452,40,307,CT - Norfolk
43,1993-1994,1993-11-02,1994-04-10,160,2,150,514,664,143,912,1055,1719,46,377,CT - Norfolk
44,1994-1995,1994-11-24,1995-04-09,137,1,71,367,438,60,284,344,782,24,156,CT - Norfolk
45,1995-1996,1995-11-09,1996-04-18,162,0,148,495,643,230,802,1032,1675,59,496,CT - Norfolk
46,1996-1997,1996-11-12,1997-04-21,161,2,67,391,458,147,293,440,898,39,273,CT - Norfolk
47,1997-1998,1997-11-13,1998-04-10,149,2,43,309,352,92,432,524,876,34,181,CT - Norfolk
48,1998-1999,1998-11-08,1999-04-12,156,13,56,318,374,72,307,379,753,33,185,CT - Norfolk
49,1999-2000,1999-11-17,2000-04-27,163,4,93,363,456,73,358,431,887,25,166,CT - Norfolk
50,2000-2001,2000-10-30,2001-04-14,167,4,87,396,483,140,964,1104,1587,37,252,CT - Norfolk
53,2003-2004,2003-10-23,2004-04-06,167,2,148,417,565,95,496,591,1156,28,216,CT - Norfolk
54,2004-2005,2004-11-10,2005-04-06,148,9,126,427,553,131,670,801,1354,30,276,CT - Norfolk
55,2005-2006,2005-10-26,2006-04-05,162,3,88,349,437,115,382,497,934,34,256,CT - Norfolk
56,2006-2007,2006-12-01,2007-04-16,137,0,96,358,454,67,287,354,808,31,197,CT - Norfolk
57,2007-2008,2007-11-20,2008-03-31,133,0,77,340,417,120,643,763,1180,43,259,CT - Norfolk
58,2008-2009,2008-10-29,2009-03-28,151,0,121,416,537,114,598,712,1249,38,311,CT - Norfolk
59,2009-2010,2009-10-16,2010-03-26,162,0,98,306,404,107,570,677,1081,38,216,CT - Norfolk
60,2010-2011,2010-11-08,2011-04-23,167,0,122,424,546,145,839,984,1530,46,351,CT - Norfolk
61,2011-2012,2011-10-28,2012-04-01,157,0,44,246,290,76,168,244,534,26,151,CT - Norfolk
62,2012-2013,2012-11-08,2013-04-08,152,3,75,324,399,111,556,667,1066,42,237,CT - Norfolk
63,2013-2014,2013-11-12,2014-04-16,156,0,146,503,649,121,673,794,1443,42,350,CT - Norfolk
64,2014-2015,2014-11-14,2015-04-12,150,0,154,503,657,130,769,899,1556,51,395,CT - Norfolk
65,2015-2016,2015-11-24,2016-04-06,135,0,63,267,330,50,122,172,502,20,123,CT - Norfolk
66,2016-2017,2016-10-28,2017-04-08,163,0,76,338,414,131,446,577,991,46,299,CT - Norfolk
67,2017-2018,2017-11-08,2018-04-20,164,0,113,419,532,161,534,695,1227,57,380,CT - Norfolk
68,2018-2019,2018-11-15,2019-04-06,143,0,100,393,493,89,333,422,915,43,242,CT - Norfolk
69,2019-2020,2019-11-08,2020-05-10,185,0,56,318,374,92,175,267,641,48,209,CT - Norfolk
0,1950-1951,1950-11-25,1951-03-21,117,0,14,106,120,15,8,23,143,8,29,DC - Washington (Reagan)
1,1951-1952,1951-12-01,1952-03-03,94,0,6,64,70,14,5,19,89,6,19,DC - Washington (Reagan)
2,1952-1953,1952-11-29,1953-03-08,100,0,1,57,58,13,8,21,79,8,22,DC - Washington (Reagan)
3,1953-1954,1953-11-06,1954-02-28,115,0,9,84,93,26,34,60,153,7,38,DC - Washington (Reagan)
4,1954-1955,1954-12-01,1955-02-28,90,0,13,104,117,11,5,16,133,7,23,DC - Washington (Reagan)
5,1955-1956,1955-11-19,1956-03-19,122,0,7,112,119,20,10,30,149,12,32,DC - Washington (Reagan)
6,1956-1957,1956-11-24,1957-04-13,141,0,11,86,97,25,20,45,142,15,45,DC - Washington (Reagan)
7,1957-1958,1957-11-23,1958-03-21,119,0,19,113,132,57,56,113,245,15,74,DC - Washington (Reagan)
8,1958-1959,1958-11-30,1959-02-28,91,0,18,126,144,6,3,9,153,3,14,DC - Washington (Reagan)
9,1959-1960,1959-12-01,1960-03-17,108,0,10,90,100,32,55,87,187,9,50,DC - Washington (Reagan)
10,1960-1961,1960-12-01,1961-02-28,90,0,32,153,185,55,170,225,410,10,83,DC - Washington (Reagan)
11,1961-1962,1961-11-19,1962-03-07,109,0,13,121,134,26,22,48,182,18,52,DC - Washington (Reagan)
12,1962-1963,1962-12-01,1963-03-21,111,0,24,167,191,31,71,102,293,12,51,DC - Washington (Reagan)
13,1963-1964,1963-12-01,1964-04-01,123,0,13,140,153,50,77,127,280,14,76,DC - Washington (Reagan)
14,1964-1965,1964-11-30,1965-03-21,112,0,12,132,144,21,25,46,190,10,47,DC - Washington (Reagan)
15,1965-1966,1965-12-01,1966-02-28,90,0,11,109,120,41,73,114,234,8,69,DC - Washington (Reagan)
16,1966-1967,1966-12-01,1967-03-21,111,0,8,114,122,52,70,122,244,14,80,DC - Washington (Reagan)
17,1967-1968,1967-11-30,1968-03-12,104,0,14,148,162,32,35,67,229,12,49,DC - Washington (Reagan)
18,1968-1969,1968-12-01,1969-03-09,99,0,6,106,112,15,5,20,132,8,21,DC - Washington (Reagan)
19,1969-1970,1969-12-01,1970-02-28,90,0,20,135,155,22,21,43,198,11,42,DC - Washington (Reagan)
20,1970-1971,1970-12-01,1971-03-26,116,0,13,114,127,19,18,37,164,9,31,DC - Washington (Reagan)
21,1971-1972,1971-11-24,1972-04-08,137,0,5,95,100,25,10,35,135,10,33,DC - Washington (Reagan)
22,1972-1973,1972-12-01,1973-02-28,90,0,7,86,93,1,0,1,94,1,2,DC - Washington (Reagan)
23,1973-1974,1973-12-01,1974-02-28,90,0,2,50,52,25,29,54,106,6,32,DC - Washington (Reagan)
24,1974-1975,1974-12-01,1975-03-10,100,0,2,55,57,19,10,29,86,8,27,DC - Washington (Reagan)
25,1975-1976,1975-12-01,1976-03-09,100,0,7,84,91,4,1,5,96,4,11,DC - Washington (Reagan)
26,1976-1977,1976-11-12,1977-02-28,109,0,18,187,205,18,60,78,283,10,40,DC - Washington (Reagan)
27,1977-1978,1977-11-27,1978-03-10,104,0,12,145,157,34,60,94,251,15,62,DC - Washington (Reagan)
28,1978-1979,1978-11-26,1979-02-28,95,0,21,116,137,52,103,155,292,14,84,DC - Washington (Reagan)
29,1979-1980,1979-10-10,1980-03-14,157,0,8,85,93,29,36,65,158,12,50,DC - Washington (Reagan)
30,1980-1981,1980-12-01,1981-02-28,90,0,15,100,115,6,4,10,125,4,11,DC - Washington (Reagan)
31,1981-1982,1981-12-01,1982-03-07,97,0,21,128,149,34,86,120,269,16,68,DC - Washington (Reagan)
32,1982-1983,1982-12-01,1983-02-28,90,0,2,58,60,38,63,101,161,4,45,DC - Washington (Reagan)
33,1983-1984,1983-11-25,1984-03-13,110,0,21,123,144,12,25,37,181,7,24,DC - Washington (Reagan)
34,1984-1985,1984-12-01,1985-02-28,90,0,14,105,119,15,14,29,148,9,37,DC - Washington (Reagan)
35,1985-1986,1985-12-01,1986-02-28,90,0,17,107,124,23,28,51,175,14,51,DC - Washington (Reagan)
36,1986-1987,1986-12-01,1987-02-28,90,0,9,79,88,42,91,133,221,7,59,DC - Washington (Reagan)
37,1987-1988,1987-11-11,1988-03-21,132,0,16,121,137,32,70,102,239,7,49,DC - Washington (Reagan)
38,1988-1989,1988-12-01,1989-03-08,98,0,7,82,89,12,2,14,103,9,22,DC - Washington (Reagan)
39,1989-1990,1989-11-22,1990-04-07,137,0,20,120,140,22,68,90,230,12,35,DC - Washington (Reagan)
40,1990-1991,1990-12-01,1991-02-28,90,0,3,56,59,11,8,19,78,4,15,DC - Washington (Reagan)
41,1991-1992,1991-12-01,1992-02-29,91,0,1,73,74,8,9,17,91,3,14,DC - Washington (Reagan)
42,1992-1993,1992-12-01,1993-03-17,107,0,6,90,96,17,20,37,133,5,23,DC - Washington (Reagan)
43,1993-1994,1993-12-01,1994-03-18,108,0,28,144,172,23,38,61,233,15,60,DC - Washington (Reagan)
44,1994-1995,1994-12-01,1995-03-08,98,0,6,80,86,13,23,36,122,4,17,DC - Washington (Reagan)
45,1995-1996,1995-11-11,1996-03-09,120,0,24,142,166,65,130,195,361,16,106,DC - Washington (Reagan)
46,1996-1997,1996-11-14,1997-02-28,107,0,8,67,75,11,6,17,92,7,19,DC - Washington (Reagan)
47,1997-1998,1997-12-01,1998-02-28,90,0,0,29,29,1,0,1,30,1,1,DC - Washington (Reagan)
48,1998-1999,1998-12-01,1999-03-14,104,0,12,73,85,19,12,31,116,6,33,DC - Washington (Reagan)
49,1999-2000,1999-12-01,2000-02-29,91,0,11,74,85,22,72,94,179,6,34,DC - Washington (Reagan)
50,2000-2001,2000-12-01,2001-03-05,95,0,7,101,108,12,9,21,129,6,21,DC - Washington (Reagan)
51,2001-2002,2001-12-01,2002-02-28,90,0,1,46,47,5,2,7,54,3,8,DC - Washington (Reagan)
52,2002-2003,2002-12-01,2003-03-02,92,0,14,107,121,58,101,159,280,19,89,DC - Washington (Reagan)
53,2003-2004,2003-12-01,2004-02-29,91,0,18,110,128,17,42,59,187,8,39,DC - Washington (Reagan)
54,2004-2005,2004-12-01,2005-03-09,99,0,15,99,114,19,18,37,151,11,49,DC - Washington (Reagan)
55,2005-2006,2005-12-01,2006-02-28,90,0,3,62,65,20,16,36,101,7,27,DC - Washington (Reagan)
56,2006-2007,2006-12-01,2007-04-07,128,0,9,109,118,16,17,33,151,11,41,DC - Washington (Reagan)
57,2007-2008,2007-12-01,2008-02-29,91,0,2,51,53,7,6,13,66,3,9,DC - Washington (Reagan)
58,2008-2009,2008-12-01,2009-03-04,94,0,12,112,124,11,11,22,146,4,20,DC - Washington (Reagan)
59,2009-2010,2009-12-01,2010-02-28,90,0,11,89,100,82,170,252,352,13,108,DC - Washington (Reagan)
60,2010-2011,2010-12-01,2011-03-27,117,0,5,96,101,21,24,45,146,13,40,DC - Washington (Reagan)
61,2011-2012,2011-12-01,2012-02-29,91,0,1,34,35,5,1,6,41,5,11,DC - Washington (Reagan)
62,2012-2013,2012-12-01,2013-03-25,115,0,4,52,56,9,1,10,66,8,22,DC - Washington (Reagan)
63,2013-2014,2013-12-01,2014-03-25,115,0,15,125,140,40,51,91,231,16,72,DC - Washington (Reagan)
64,2014-2015,2014-12-01,2015-03-08,98,0,16,109,125,28,40,68,193,14,66,DC - Washington (Reagan)
65,2015-2016,2015-12-01,2016-03-04,95,0,10,71,81,31,51,82,163,8,55,DC - Washington (Reagan)
66,2016-2017,2016-12-01,2017-03-16,106,0,4,54,58,6,5,11,69,4,13,DC - Washington (Reagan)
67,2017-2018,2017-12-01,2018-03-22,112,0,16,100,116,14,6,20,136,8,26,DC - Washington (Reagan)
68,2018-2019,2018-11-15,2019-03-01,107,0,6,57,63,26,29,55,118,11,38,DC - Washington (Reagan)
69,2019-2020,2019-12-01,2020-02-29,91,0,0,42,42,3,0,3,45,3,4,DC - Washington (Reagan)
0,1950-1951,1950-12-01,1951-03-22,112,4,10,143,153,6,3,9,162,4,14,DE - Dover
1,1951-1952,1951-12-01,1952-03-03,94,1,4,86,90,21,16,37,127,5,29,DE - Dover
3,1953-1954,1953-11-06,1954-02-28,115,0,5,109,114,30,57,87,201,6,42,DE - Dover
4,1954-1955,1954-12-01,1955-03-18,108,0,10,125,135,21,14,35,170,11,38,DE - Dover
5,1955-1956,1955-11-19,1956-03-19,122,0,7,139,146,21,16,37,183,7,28,DE - Dover
6,1956-1957,1956-12-01,1957-02-28,90,0,6,99,105,10,10,20,125,5,20,DE - Dover
7,1957-1958,1957-12-01,1958-03-21,111,0,16,154,170,38,66,104,274,10,60,DE - Dover
8,1958-1959,1958-12-01,1959-02-28,90,2,13,171,184,9,7,16,200,3,16,DE - Dover
9,1959-1960,1959-12-01,1960-03-16,107,5,7,119,126,19,47,66,192,5,25,DE - Dover
10,1960-1961,1960-12-01,1961-02-28,90,3,23,202,225,46,219,265,490,11,89,DE - Dover
13,1963-1964,1963-12-01,1964-04-01,123,3,15,157,172,41,73,114,286,9,60,DE - Dover
14,1964-1965,1964-12-01,1965-03-21,111,0,12,142,154,19,30,49,203,8,43,DE - Dover
15,1965-1966,1965-12-01,1966-02-28,90,0,16,130,146,32,75,107,253,7,56,DE - Dover
16,1966-1967,1966-12-01,1967-03-18,108,0,10,148,158,61,99,160,318,11,87,DE - Dover
17,1967-1968,1967-11-30,1968-03-01,93,0,17,163,180,34,37,71,251,11,61,DE - Dover
18,1968-1969,1968-12-01,1969-03-09,99,0,8,139,147,37,43,80,227,6,43,DE - Dover
19,1969-1970,1969-12-01,1970-02-28,90,0,16,166,182,15,25,40,222,6,33,DE - Dover
20,1970-1971,1970-12-01,1971-03-04,94,0,16,123,139,10,9,19,158,4,19,DE - Dover
21,1971-1972,1971-12-01,1972-04-08,130,0,5,113,118,26,7,33,151,7,33,DE - Dover
22,1972-1973,1972-12-01,1973-02-28,90,0,11,93,104,2,2,4,108,1,3,DE - Dover
23,1973-1974,1973-12-01,1974-02-28,90,0,4,90,94,17,18,35,129,5,31,DE - Dover
24,1974-1975,1974-12-01,1975-02-28,90,1,1,76,77,8,4,12,89,3,12,DE - Dover
25,1975-1976,1975-12-01,1976-03-17,108,1,13,126,139,14,10,24,163,6,27,DE - Dover
26,1976-1977,1976-12-01,1977-02-28,90,0,23,197,220,21,15,36,256,8,32,DE - Dover
27,1977-1978,1977-12-01,1978-03-16,106,0,16,202,218,51,58,109,327,12,74,DE - Dover
29,1979-1980,1979-10-10,1980-03-03,146,1,10,144,154,30,20,50,204,9,56,DE - Dover
30,1980-1981,1980-12-01,1981-03-20,110,0,19,181,200,8,1,9,209,6,17,DE - Dover
31,1981-1982,1981-12-01,1982-02-28,90,5,18,141,159,35,60,95,254,10,60,DE - Dover
32,1982-1983,1982-12-01,1983-02-28,90,1,4,83,87,33,56,89,176,5,42,DE - Dover
33,1983-1984,1983-12-01,1984-03-10,101,2,15,145,160,10,18,28,188,4,19,DE - Dover
34,1984-1985,1984-12-01,1985-02-28,90,7,12,118,130,21,16,37,167,6,37,DE - Dover
35,1985-1986,1985-12-01,1986-02-28,90,0,13,137,150,30,35,65,215,10,58,DE - Dover
36,1986-1987,1986-12-01,1987-03-10,100,5,7,122,129,46,108,154,283,5,56,DE - Dover
37,1987-1988,1987-12-01,1988-02-29,91,9,10,122,132,17,45,62,194,4,26,DE - Dover
38,1988-1989,1988-12-01,1989-03-09,99,18,8,108,116,12,17,29,145,3,20,DE - Dover
40,1990-1991,1990-12-01,1991-02-28,90,7,1,75,76,13,12,25,101,2,15,DE - Dover
41,1991-1992,1991-12-01,1992-02-29,91,1,5,103,108,3,1,4,112,2,10,DE - Dover
43,1993-1994,1993-12-01,1994-03-02,92,6,28,151,179,13,29,42,221,8,45,DE - Dover
44,1994-1995,1994-12-01,1995-02-28,90,5,7,88,95,3,4,7,102,1,4,DE - Dover
45,1995-1996,1995-12-01,1996-03-09,100,2,27,150,177,47,109,156,333,9,73,DE - Dover
46,1996-1997,1996-12-01,1997-02-28,90,3,9,80,89,9,10,19,108,4,15,DE - Dover
47,1997-1998,1997-12-01,1998-02-28,90,11,1,48,49,0,0,0,49,0,0,DE - Dover
48,1998-1999,1998-12-01,1999-02-28,90,0,8,88,96,3,3,6,102,2,8,DE - Dover
49,1999-2000,1999-12-01,2000-02-29,91,0,11,109,120,27,70,97,217,5,38,DE - Dover
50,2000-2001,2000-12-01,2001-02-28,90,11,9,127,136,16,13,29,165,6,30,DE - Dover
51,2001-2002,2001-12-01,2002-02-28,90,3,1,64,65,3,6,9,74,1,5,DE - Dover
52,2002-2003,2002-12-01,2003-03-03,93,1,14,148,162,63,147,210,372,10,83,DE - Dover
53,2003-2004,2003-12-01,2004-02-29,91,6,17,120,137,11,30,41,178,4,20,DE - Dover
54,2004-2005,2004-12-01,2005-03-09,99,0,16,128,144,17,38,55,199,4,30,DE - Dover
56,2006-2007,2006-12-01,2007-03-07,97,1,8,108,116,9,3,12,128,5,20,DE - Dover
57,2007-2008,2007-12-01,2008-02-29,91,3,6,85,91,7,5,12,103,5,16,DE - Dover
59,2009-2010,2009-12-01,2010-02-28,90,2,9,126,135,96,164,260,395,19,134,DE - Dover
64,2014-2015,2014-12-01,2015-03-08,98,0,17,166,183,23,34,57,240,6,40,DE - Dover
65,2015-2016,2015-12-01,2016-03-04,95,0,10,95,105,26,38,64,169,7,43,DE - Dover
66,2016-2017,2016-12-01,2017-02-28,90,0,5,67,72,9,11,20,92,3,14,DE - Dover
67,2017-2018,2017-12-01,2018-03-21,111,14,19,127,146,21,18,39,185,7,31,DE - Dover
69,2019-2020,2019-12-01,2020-02-29,91,4,1,68,69,0,0,0,69,0,0,DE - Dover
0,1950-1951,1950-11-26,1951-02-28,95,0,19,159,178,13,4,17,195,11,43,DE - Wilmington
1,1951-1952,1951-12-01,1952-03-04,95,0,9,116,125,23,30,53,178,5,30,DE - Wilmington
2,1952-1953,1952-11-29,1953-03-10,102,0,3,89,92,24,19,43,135,10,37,DE - Wilmington
3,1953-1954,1953-11-06,1954-03-31,146,0,16,160,176,33,58,91,267,8,55,DE - Wilmington
4,1954-1955,1954-12-01,1955-03-18,108,0,16,150,166,22,23,45,211,12,38,DE - Wilmington
5,1955-1956,1955-11-19,1956-03-28,131,0,19,192,211,38,52,90,301,14,60,DE - Wilmington
6,1956-1957,1956-12-01,1957-03-01,91,0,16,125,141,16,17,33,174,12,46,DE - Wilmington
7,1957-1958,1957-12-01,1958-03-24,114,0,32,179,211,70,109,179,390,14,98,DE - Wilmington
8,1958-1959,1958-11-30,1959-04-12,134,0,26,225,251,14,8,22,273,10,33,DE - Wilmington
9,1959-1960,1959-11-18,1960-03-22,126,0,13,166,179,35,55,90,269,18,76,DE - Wilmington
10,1960-1961,1960-12-01,1961-03-22,112,0,40,240,280,66,208,274,554,21,144,DE - Wilmington
11,1961-1962,1961-11-20,1962-03-10,111,0,19,190,209,38,37,75,284,19,79,DE - Wilmington
12,1962-1963,1962-10-26,1963-03-11,137,0,43,253,296,27,53,80,376,13,59,DE - Wilmington
13,1963-1964,1963-12-01,1964-03-30,121,0,27,197,224,54,84,138,362,17,93,DE - Wilmington
14,1964-1965,1964-12-01,1965-04-02,123,0,23,203,226,28,40,68,294,12,51,DE - Wilmington
15,1965-1966,1965-12-01,1966-02-28,90,0,27,163,190,39,86,125,315,13,84,DE - Wilmington
16,1966-1967,1966-12-01,1967-03-23,113,0,20,176,196,67,115,182,378,23,123,DE - Wilmington
17,1967-1968,1967-11-30,1968-03-12,104,0,29,196,225,23,40,63,288,11,47,DE - Wilmington
18,1968-1969,1968-12-01,1969-03-07,97,0,14,148,162,26,22,48,210,12,44,DE - Wilmington
19,1969-1970,1969-11-30,1970-03-29,120,0,35,212,247,27,52,79,326,13,58,DE - Wilmington
20,1970-1971,1970-12-01,1971-04-07,128,0,25,180,205,21,19,40,245,13,46,DE - Wilmington
21,1971-1972,1971-12-01,1972-04-07,129,0,13,149,162,16,22,38,200,9,35,DE - Wilmington
22,1972-1973,1972-12-01,1973-02-28,90,0,9,101,110,3,1,4,114,3,8,DE - Wilmington
23,1973-1974,1973-12-01,1974-02-28,90,0,14,119,133,27,39,66,199,7,41,DE - Wilmington
24,1974-1975,1974-12-01,1975-03-14,104,0,7,105,112,16,7,23,135,10,32,DE - Wilmington
25,1975-1976,1975-12-01,1976-03-17,108,0,18,154,172,22,16,38,210,10,47,DE - Wilmington
26,1976-1977,1976-11-29,1977-02-28,92,0,49,247,296,27,77,104,400,14,73,DE - Wilmington
27,1977-1978,1977-11-27,1978-03-17,111,0,48,265,313,62,182,244,557,20,114,DE - Wilmington
28,1978-1979,1978-11-27,1979-03-11,105,0,49,219,268,61,106,167,435,18,138,DE - Wilmington
29,1979-1980,1979-12-01,1980-03-31,122,0,20,175,195,23,22,45,240,16,62,DE - Wilmington
30,1980-1981,1980-11-17,1981-03-06,110,0,37,215,252,18,36,54,306,13,51,DE - Wilmington
31,1981-1982,1981-12-01,1982-04-09,130,0,29,218,247,38,90,128,375,18,80,DE - Wilmington
32,1982-1983,1982-12-01,1983-04-20,141,0,7,125,132,35,61,96,228,7,48,DE - Wilmington
33,1983-1984,1983-12-01,1984-03-13,104,0,43,244,287,20,51,71,358,10,61,DE - Wilmington
34,1984-1985,1984-12-01,1985-04-09,130,0,16,159,175,23,29,52,227,12,56,DE - Wilmington
35,1985-1986,1985-12-01,1986-03-08,98,0,25,173,198,24,33,57,255,14,58,DE - Wilmington
36,1986-1987,1986-12-01,1987-04-06,127,0,11,154,165,63,105,168,333,17,89,DE - Wilmington
37,1987-1988,1987-11-11,1988-02-29,111,0,23,167,190,24,36,60,250,12,53,DE - Wilmington
38,1988-1989,1988-12-01,1989-03-09,99,0,18,134,152,18,13,31,183,9,37,DE - Wilmington
39,1989-1990,1989-11-22,1990-04-07,137,0,24,172,196,31,42,73,269,18,64,DE - Wilmington
40,1990-1991,1990-12-01,1991-03-30,120,0,7,109,116,20,19,39,155,7,31,DE - Wilmington
41,1991-1992,1991-12-01,1992-03-22,113,0,10,124,134,7,2,9,143,7,23,DE - Wilmington
42,1992-1993,1992-12-01,1993-03-21,111,0,11,147,158,38,48,86,244,13,62,DE - Wilmington
43,1993-1994,1993-12-01,1994-03-18,108,0,41,187,228,27,70,97,325,15,75,DE - Wilmington
44,1994-1995,1994-12-01,1995-02-28,90,0,13,121,134,13,33,46,180,4,22,DE - Wilmington
46,1996-1997,1996-11-28,1997-04-01,125,16,16,130,146,21,14,35,181,8,31,DE - Wilmington
47,1997-1998,1997-12-01,1998-02-28,90,0,0,67,67,0,0,0,67,0,0,DE - Wilmington
48,1998-1999,1998-12-01,1999-03-15,105,3,16,125,141,14,6,20,161,6,33,DE - Wilmington
49,1999-2000,1999-12-01,2000-04-09,131,11,21,133,154,27,74,101,255,7,43,DE - Wilmington
50,2000-2001,2000-12-01,2001-03-26,116,0,18,170,188,18,25,43,231,10,47,DE - Wilmington
51,2001-2002,2001-12-01,2002-02-28,90,0,3,83,86,4,2,6,92,2,9,DE - Wilmington
52,2002-2003,2002-12-01,2003-03-10,100,5,31,182,213,66,147,213,426,18,119,DE - Wilmington
53,2003-2004,2003-12-01,2004-03-19,110,0,35,177,212,30,67,97,309,16,80,DE - Wilmington
54,2004-2005,2004-12-01,2005-03-09,99,0,29,155,184,42,63,105,289,15,92,DE - Wilmington
55,2005-2006,2005-11-23,2006-04-05,134,0,4,132,136,31,33,64,200,10,46,DE - Wilmington
56,2006-2007,2006-12-01,2007-03-19,109,0,19,146,165,24,18,42,207,15,59,DE - Wilmington
57,2007-2008,2007-12-01,2008-02-29,91,0,5,99,104,15,8,23,127,6,26,DE - Wilmington
58,2008-2009,2008-11-21,2009-03-05,105,2,22,158,180,26,21,47,227,12,54,DE - Wilmington
59,2009-2010,2009-12-01,2010-02-28,90,0,19,131,150,100,175,275,425,17,134,DE - Wilmington
60,2010-2011,2010-12-01,2011-02-28,90,0,22,162,184,39,84,123,307,15,81,DE - Wilmington
61,2011-2012,2011-10-29,2012-02-29,124,0,5,92,97,10,6,16,113,6,20,DE - Wilmington
62,2012-2013,2012-12-01,2013-03-25,115,0,10,105,115,13,4,17,132,11,33,DE - Wilmington
63,2013-2014,2013-11-24,2014-03-26,123,0,38,230,268,81,143,224,492,19,136,DE - Wilmington
64,2014-2015,2014-11-26,2015-03-21,116,3,32,204,236,37,53,90,326,16,85,DE - Wilmington
65,2015-2016,2015-12-01,2016-03-04,95,0,13,111,124,37,52,89,213,11,60,DE - Wilmington
66,2016-2017,2016-12-01,2017-03-16,106,0,8,106,114,16,10,26,140,10,37,DE - Wilmington
67,2017-2018,2017-12-01,2018-03-23,113,0,26,164,190,39,40,79,269,13,65,DE - Wilmington
68,2018-2019,2018-11-15,2019-03-06,112,0,13,139,152,28,28,56,208,12,57,DE - Wilmington
69,2019-2020,2019-12-01,2020-02-29,91,0,2,80,82,4,0,4,86,4,8,DE - Wilmington
0,1950-1951,1950-12-01,1951-02-28,90,0,0,14,14,0,0,0,14,0,0,FL - Gainesville
1,1951-1952,1951-12-01,1952-02-29,91,0,0,5,5,0,0,0,5,0,0,FL - Gainesville
2,1952-1953,1952-12-01,1953-02-28,90,0,0,4,4,0,0,0,4,0,0,FL - Gainesville
3,1953-1954,1953-12-01,1954-02-28,90,0,0,5,5,0,0,0,5,0,0,FL - Gainesville
4,1954-1955,1954-12-01,1955-02-28,90,3,0,13,13,0,0,0,13,0,0,FL - Gainesville
5,1955-1956,1955-12-01,1956-02-29,91,0,0,7,7,0,0,0,7,0,0,FL - Gainesville
6,1956-1957,1956-12-01,1957-02-28,90,1,0,4,4,0,0,0,4,0,0,FL - Gainesville
7,1957-1958,1957-12-01,1958-02-28,90,0,0,44,44,0,0,0,44,0,0,FL - Gainesville
8,1958-1959,1958-12-01,1959-02-28,90,0,0,17,17,0,0,0,17,0,0,FL - Gainesville
9,1959-1960,1959-12-01,1960-02-29,91,0,0,22,22,0,0,0,22,0,0,FL - Gainesville
10,1960-1961,1960-12-01,1961-02-28,90,0,0,22,22,0,0,0,22,0,0,FL - Gainesville
11,1961-1962,1961-12-01,1962-02-28,90,0,0,22,22,0,0,0,22,0,0,FL - Gainesville
12,1962-1963,1962-12-01,1963-02-28,90,0,0,33,33,0,0,0,33,0,0,FL - Gainesville
13,1963-1964,1963-12-01,1964-02-29,91,0,0,26,26,0,0,0,26,0,0,FL - Gainesville
14,1964-1965,1964-12-01,1965-02-28,90,0,0,13,13,0,0,0,13,0,0,FL - Gainesville
15,1965-1966,1965-12-01,1966-02-28,90,0,0,19,19,0,0,0,19,0,0,FL - Gainesville
16,1966-1967,1966-12-01,1967-02-28,90,0,0,15,15,0,0,0,15,0,0,FL - Gainesville
17,1967-1968,1967-12-01,1968-02-29,91,0,0,20,20,0,0,0,20,0,0,FL - Gainesville
18,1968-1969,1968-12-01,1969-02-28,90,0,0,18,18,0,0,0,18,0,0,FL - Gainesville
19,1969-1970,1969-12-01,1970-02-28,90,0,0,19,19,0,0,0,19,0,0,FL - Gainesville
20,1970-1971,1970-12-01,1971-02-28,90,0,0,22,22,0,0,0,22,0,0,FL - Gainesville
21,1971-1972,1971-12-01,1972-02-29,91,0,0,6,6,0,0,0,6,0,0,FL - Gainesville
22,1972-1973,1972-12-01,1973-02-28,90,0,0,11,11,0,0,0,11,0,0,FL - Gainesville
23,1973-1974,1973-12-01,1974-02-28,90,0,0,11,11,0,0,0,11,0,0,FL - Gainesville
24,1974-1975,1974-12-01,1975-02-28,90,0,0,8,8,0,0,0,8,0,0,FL - Gainesville
25,1975-1976,1975-12-01,1976-02-29,91,0,0,22,22,0,0,0,22,0,0,FL - Gainesville
26,1976-1977,1976-12-01,1977-02-28,90,0,0,27,27,0,0,0,27,0,0,FL - Gainesville
27,1977-1978,1977-12-01,1978-02-28,90,0,0,26,26,0,0,0,26,0,0,FL - Gainesville
28,1978-1979,1978-12-01,1979-02-28,90,0,0,17,17,0,0,0,17,0,0,FL - Gainesville
29,1979-1980,1979-12-01,1980-02-29,91,0,0,17,17,0,0,0,17,0,0,FL - Gainesville
30,1980-1981,1980-12-01,1981-02-28,90,0,0,26,26,0,0,0,26,0,0,FL - Gainesville
31,1981-1982,1981-12-01,1982-02-28,90,0,0,21,21,0,0,0,21,0,0,FL - Gainesville
32,1982-1983,1982-12-01,1983-02-28,90,0,0,12,12,0,0,0,12,0,0,FL - Gainesville
33,1983-1984,1983-12-01,1984-02-29,91,0,0,14,14,0,0,0,14,0,0,FL - Gainesville
34,1984-1985,1984-12-01,1985-02-28,90,0,1,28,29,0,0,0,29,0,0,FL - Gainesville
35,1985-1986,1985-12-01,1986-02-28,90,0,0,19,19,0,0,0,19,0,0,FL - Gainesville
36,1986-1987,1986-12-01,1987-02-28,90,0,0,9,9,0,0,0,9,0,0,FL - Gainesville
37,1987-1988,1987-12-01,1988-02-29,91,0,0,19,19,0,0,0,19,0,0,FL - Gainesville
38,1988-1989,1988-12-01,1989-02-28,90,0,0,11,11,0,0,0,11,0,0,FL - Gainesville
39,1989-1990,1989-12-01,1990-02-28,90,0,1,21,22,0,0,0,22,0,0,FL - Gainesville
40,1990-1991,1990-12-01,1991-02-28,90,0,0,6,6,0,0,0,6,0,0,FL - Gainesville
41,1991-1992,1991-12-01,1992-02-29,91,0,0,11,11,0,0,0,11,0,0,FL - Gainesville
42,1992-1993,1992-12-01,1993-02-28,90,0,0,3,3,0,0,0,3,0,0,FL - Gainesville
43,1993-1994,1993-12-01,1994-02-28,90,0,0,11,11,0,0,0,11,0,0,FL - Gainesville
44,1994-1995,1994-12-01,1995-02-28,90,0,0,11,11,0,0,0,11,0,0,FL - Gainesville
45,1995-1996,1995-12-01,1996-02-29,91,0,0,26,26,0,0,0,26,0,0,FL - Gainesville
46,1996-1997,1996-12-01,1997-02-28,90,0,0,11,11,0,0,0,11,0,0,FL - Gainesville
47,1997-1998,1997-12-01,1998-02-28,90,0,0,3,3,0,0,0,3,0,0,FL - Gainesville
48,1998-1999,1998-12-01,1999-02-28,90,0,0,16,16,0,0,0,16,0,0,FL - Gainesville
49,1999-2000,1999-12-01,2000-02-29,91,0,0,18,18,0,0,0,18,0,0,FL - Gainesville
50,2000-2001,2000-12-01,2001-02-28,90,0,0,35,35,0,0,0,35,0,0,FL - Gainesville
51,2001-2002,2001-12-01,2002-02-28,90,0,0,16,16,0,0,0,16,0,0,FL - Gainesville
52,2002-2003,2002-12-01,2003-02-28,90,0,0,23,23,0,0,0,23,0,0,FL - Gainesville
53,2003-2004,2003-12-01,2004-02-29,91,0,0,18,18,0,0,0,18,0,0,FL - Gainesville
59,2009-2010,2009-12-01,2010-02-28,90,0,0,35,35,0,0,0,35,0,0,FL - Gainesville
60,2010-2011,2010-12-01,2011-02-28,90,0,0,34,34,0,0,0,34,0,0,FL - Gainesville
61,2011-2012,2011-12-01,2012-02-29,91,0,0,11,11,0,0,0,11,0,0,FL - Gainesville
62,2012-2013,2012-12-01,2013-02-28,90,0,0,9,9,0,0,0,9,0,0,FL - Gainesville
63,2013-2014,2013-12-01,2014-02-28,90,0,0,12,12,0,0,0,12,0,0,FL - Gainesville
64,2014-2015,2014-12-01,2015-02-28,90,1,0,14,14,0,0,0,14,0,0,FL - Gainesville
65,2015-2016,2015-12-01,2016-02-29,91,2,0,12,12,0,0,0,12,0,0,FL - Gainesville
66,2016-2017,2016-12-01,2017-02-28,90,3,0,3,3,0,0,0,3,0,0,FL - Gainesville
67,2017-2018,2017-12-01,2018-02-28,90,0,0,20,20,0,0,0,20,0,0,FL - Gainesville
68,2018-2019,2018-12-01,2019-02-28,90,0,0,4,4,0,0,0,4,0,0,FL - Gainesville
69,2019-2020,2019-12-01,2020-02-29,91,0,0,5,5,0,0,0,5,0,0,FL - Gainesville
0,1950-1951,1950-12-01,1951-02-28,90,0,0,8,8,0,0,0,8,0,0,FL - Jacksonville
1,1951-1952,1951-12-01,1952-02-29,91,0,0,2,2,0,0,0,2,0,0,FL - Jacksonville
2,1952-1953,1952-12-01,1953-02-28,90,0,0,2,2,0,0,0,2,0,0,FL - Jacksonville
3,1953-1954,1953-12-01,1954-02-28,90,0,0,2,2,0,0,0,2,0,0,FL - Jacksonville
4,1954-1955,1954-12-01,1955-02-28,90,0,0,6,6,0,0,0,6,0,0,FL - Jacksonville
5,1955-1956,1955-12-01,1956-02-29,91,0,0,10,10,0,0,0,10,0,0,FL - Jacksonville
6,1956-1957,1956-12-01,1957-02-28,90,0,0,2,2,0,0,0,2,0,0,FL - Jacksonville
7,1957-1958,1957-12-01,1958-02-28,90,0,0,31,31,2,0,2,33,1,3,FL - Jacksonville
8,1958-1959,1958-12-01,1959-02-28,90,0,0,14,14,0,0,0,14,0,0,FL - Jacksonville
9,1959-1960,1959-12-01,1960-02-29,91,0,0,13,13,0,0,0,13,0,0,FL - Jacksonville
10,1960-1961,1960-12-01,1961-02-28,90,0,0,17,17,0,0,0,17,0,0,FL - Jacksonville
11,1961-1962,1961-12-01,1962-02-28,90,0,0,11,11,0,0,0,11,0,0,FL - Jacksonville
12,1962-1963,1962-12-01,1963-02-28,90,0,0,23,23,0,0,0,23,0,0,FL - Jacksonville
13,1963-1964,1963-12-01,1964-02-29,91,0,0,14,14,0,0,0,14,0,0,FL - Jacksonville
14,1964-1965,1964-12-01,1965-02-28,90,0,0,8,8,0,0,0,8,0,0,FL - Jacksonville
15,1965-1966,1965-12-01,1966-02-28,90,0,0,15,15,0,0,0,15,0,0,FL - Jacksonville
16,1966-1967,1966-12-01,1967-02-28,90,0,0,7,7,0,0,0,7,0,0,FL - Jacksonville
17,1967-1968,1967-12-01,1968-02-29,91,0,0,8,8,0,0,0,8,0,0,FL - Jacksonville
18,1968-1969,1968-12-01,1969-02-28,90,0,0,7,7,0,0,0,7,0,0,FL - Jacksonville
19,1969-1970,1969-12-01,1970-02-28,90,0,0,21,21,0,0,0,21,0,0,FL - Jacksonville
20,1970-1971,1970-12-01,1971-02-28,90,0,0,21,21,0,0,0,21,0,0,FL - Jacksonville
21,1971-1972,1971-12-01,1972-02-29,91,0,0,4,4,0,0,0,4,0,0,FL - Jacksonville
22,1972-1973,1972-12-01,1973-02-28,90,0,0,11,11,0,0,0,11,0,0,FL - Jacksonville
23,1973-1974,1973-12-01,1974-02-28,90,0,0,14,14,0,0,0,14,0,0,FL - Jacksonville
24,1974-1975,1974-12-01,1975-02-28,90,0,0,10,10,0,0,0,10,0,0,FL - Jacksonville
25,1975-1976,1975-12-01,1976-02-29,91,0,0,32,32,0,0,0,32,0,0,FL - Jacksonville
26,1976-1977,1976-12-01,1977-02-28,90,0,0,37,37,0,0,0,37,0,0,FL - Jacksonville
27,1977-1978,1977-12-01,1978-02-28,90,0,0,31,31,0,0,0,31,0,0,FL - Jacksonville
28,1978-1979,1978-12-01,1979-02-28,90,0,0,33,33,0,0,0,33,0,0,FL - Jacksonville
29,1979-1980,1979-12-01,1980-02-29,91,0,0,15,15,0,0,0,15,0,0,FL - Jacksonville
30,1980-1981,1980-12-01,1981-02-28,90,0,0,33,33,0,0,0,33,0,0,FL - Jacksonville
31,1981-1982,1981-12-01,1982-02-28,90,0,0,25,25,0,0,0,25,0,0,FL - Jacksonville
32,1982-1983,1982-12-01,1983-02-28,90,0,0,15,15,0,0,0,15,0,0,FL - Jacksonville
33,1983-1984,1983-12-01,1984-02-29,91,0,1,28,29,0,0,0,29,0,0,FL - Jacksonville
34,1984-1985,1984-12-01,1985-02-28,90,0,1,38,39,0,0,0,39,0,0,FL - Jacksonville
35,1985-1986,1985-12-01,1986-03-01,91,0,0,22,22,1,0,1,23,1,1,FL - Jacksonville
36,1986-1987,1986-12-01,1987-02-28,90,0,0,11,11,0,0,0,11,0,0,FL - Jacksonville
37,1987-1988,1987-12-01,1988-02-29,91,0,0,20,20,0,0,0,20,0,0,FL - Jacksonville
38,1988-1989,1988-12-01,1989-02-28,90,0,0,17,17,0,0,0,17,0,0,FL - Jacksonville
39,1989-1990,1989-12-01,1990-02-28,90,0,0,16,16,1,1,2,18,1,3,FL - Jacksonville
40,1990-1991,1990-12-01,1991-02-28,90,0,0,10,10,0,0,0,10,0,0,FL - Jacksonville
41,1991-1992,1991-12-01,1992-02-29,91,0,0,11,11,0,0,0,11,0,0,FL - Jacksonville
42,1992-1993,1992-12-01,1993-02-28,90,0,0,4,4,0,0,0,4,0,0,FL - Jacksonville
43,1993-1994,1993-12-01,1994-02-28,90,0,0,15,15,0,0,0,15,0,0,FL - Jacksonville
44,1994-1995,1994-12-01,1995-02-28,90,0,0,8,8,0,0,0,8,0,0,FL - Jacksonville
45,1995-1996,1995-12-01,1996-02-29,91,0,0,26,26,0,0,0,26,0,0,FL - Jacksonville
46,1996-1997,1996-12-01,1997-02-28,90,0,0,10,10,0,0,0,10,0,0,FL - Jacksonville
47,1997-1998,1997-12-01,1998-02-28,90,0,0,4,4,0,0,0,4,0,0,FL - Jacksonville
48,1998-1999,1998-12-01,1999-02-28,90,0,0,15,15,0,0,0,15,0,0,FL - Jacksonville
49,1999-2000,1999-12-01,2000-02-29,91,0,0,19,19,0,0,0,19,0,0,FL - Jacksonville
50,2000-2001,2000-12-01,2001-02-28,90,0,0,34,34,0,0,0,34,0,0,FL - Jacksonville
51,2001-2002,2001-12-01,2002-02-28,90,0,0,9,9,0,0,0,9,0,0,FL - Jacksonville
52,2002-2003,2002-12-01,2003-02-28,90,0,0,19,19,0,0,0,19,0,0,FL - Jacksonville
53,2003-2004,2003-12-01,2004-02-29,91,0,0,22,22,0,0,0,22,0,0,FL - Jacksonville
54,2004-2005,2004-12-01,2005-02-28,90,0,0,13,13,0,0,0,13,0,0,FL - Jacksonville
55,2005-2006,2005-12-01,2006-02-28,90,0,0,9,9,0,0,0,9,0,0,FL - Jacksonville
56,2006-2007,2006-12-01,2007-02-28,90,5,0,10,10,0,0,0,10,0,0,FL - Jacksonville
57,2007-2008,2007-12-01,2008-02-29,91,5,0,11,11,0,0,0,11,0,0,FL - Jacksonville
58,2008-2009,2008-12-01,2009-02-28,90,3,0,25,25,0,0,0,25,0,0,FL - Jacksonville
59,2009-2010,2009-12-01,2010-02-28,90,0,0,28,28,0,0,0,28,0,0,FL - Jacksonville
60,2010-2011,2010-12-01,2011-02-28,90,0,0,37,37,0,0,0,37,0,0,FL - Jacksonville
61,2011-2012,2011-12-01,2012-02-29,91,0,0,12,12,0,0,0,12,0,0,FL - Jacksonville
62,2012-2013,2012-12-01,2013-02-28,90,0,0,11,11,0,0,0,11,0,0,FL - Jacksonville
63,2013-2014,2013-12-01,2014-02-28,90,0,0,10,10,0,0,0,10,0,0,FL - Jacksonville
64,2014-2015,2014-12-01,2015-02-28,90,3,0,11,11,0,0,0,11,0,0,FL - Jacksonville
65,2015-2016,2015-12-01,2016-02-29,91,3,0,12,12,0,0,0,12,0,0,FL - Jacksonville
66,2016-2017,2016-12-01,2017-02-28,90,2,0,4,4,0,0,0,4,0,0,FL - Jacksonville
67,2017-2018,2017-12-01,2018-02-28,90,0,0,12,12,0,0,0,12,0,0,FL - Jacksonville
68,2018-2019,2018-12-01,2019-02-28,90,0,0,4,4,0,0,0,4,0,0,FL - Jacksonville
69,2019-2020,2019-12-01,2020-02-29,91,0,0,3,3,0,0,0,3,0,0,FL - Jacksonville
0,1950-1951,1950-12-01,1951-02-28,90,0,0,0,0,0,0,0,0,0,0,FL - Melbourne
1,1951-1952,1951-12-01,1952-02-29,91,0,0,0,0,0,0,0,0,0,0,FL - Melbourne
2,1952-1953,1952-12-01,1953-02-28,90,0,0,0,0,0,0,0,0,0,0,FL - Melbourne
3,1953-1954,1953-12-01,1954-02-28,90,1,0,0,0,0,0,0,0,0,0,FL - Melbourne
4,1954-1955,1954-12-01,1955-02-28,90,0,0,1,1,0,0,0,1,0,0,FL - Melbourne
5,1955-1956,1955-12-01,1956-02-29,91,4,0,0,0,0,0,0,0,0,0,FL - Melbourne
7,1957-1958,1957-12-01,1958-02-28,90,1,0,5,5,0,0,0,5,0,0,FL - Melbourne
8,1958-1959,1958-12-01,1959-02-28,90,0,0,1,1,0,0,0,1,0,0,FL - Melbourne
10,1960-1961,1960-12-01,1961-02-28,90,1,0,3,3,0,0,0,3,0,0,FL - Melbourne
11,1961-1962,1961-12-01,1962-02-28,90,1,0,2,2,0,0,0,2,0,0,FL - Melbourne
12,1962-1963,1962-12-01,1963-02-28,90,0,0,4,4,0,0,0,4,0,0,FL - Melbourne
13,1963-1964,1963-12-01,1964-02-29,91,0,0,1,1,0,0,0,1,0,0,FL - Melbourne
14,1964-1965,1964-12-01,1965-02-28,90,0,0,3,3,0,0,0,3,0,0,FL - Melbourne
15,1965-1966,1965-12-01,1966-02-28,90,0,0,6,6,0,0,0,6,0,0,FL - Melbourne
16,1966-1967,1966-12-01,1967-02-28,90,0,0,3,3,0,0,0,3,0,0,FL - Melbourne
17,1967-1968,1967-12-01,1968-02-29,91,0,0,0,0,0,0,0,0,0,0,FL - Melbourne
18,1968-1969,1968-12-01,1969-02-28,90,0,0,2,2,0,0,0,2,0,0,FL - Melbourne
19,1969-1970,1969-12-01,1970-02-28,90,0,0,6,6,0,0,0,6,0,0,FL - Melbourne
20,1970-1971,1970-12-01,1971-02-28,90,0,0,4,4,0,0,0,4,0,0,FL - Melbourne
21,1971-1972,1971-12-01,1972-02-29,91,0,0,0,0,0,0,0,0,0,0,FL - Melbourne
22,1972-1973,1972-12-01,1973-02-28,90,0,0,2,2,0,0,0,2,0,0,FL - Melbourne
23,1973-1974,1973-12-01,1974-02-28,90,0,0,1,1,0,0,0,1,0,0,FL - Melbourne
24,1974-1975,1974-12-01,1975-02-28,90,0,0,1,1,0,0,0,1,0,0,FL - Melbourne
25,1975-1976,1975-12-01,1976-02-29,91,0,0,1,1,0,0,0,1,0,0,FL - Melbourne
26,1976-1977,1976-12-01,1977-02-28,90,0,0,10,10,0,0,0,10,0,0,FL - Melbourne
27,1977-1978,1977-12-01,1978-02-28,90,2,0,4,4,0,0,0,4,0,0,FL - Melbourne
28,1978-1979,1978-12-01,1979-02-28,90,0,0,1,1,0,0,0,1,0,0,FL - Melbourne
29,1979-1980,1979-12-01,1980-02-29,91,3,0,1,1,0,0,0,1,0,0,FL - Melbourne
30,1980-1981,1980-12-01,1981-02-28,90,0,0,5,5,0,0,0,5,0,0,FL - Melbourne
31,1981-1982,1981-12-01,1982-02-28,90,0,0,6,6,0,0,0,6,0,0,FL - Melbourne
32,1982-1983,1982-12-01,1983-02-28,90,4,0,0,0,0,0,0,0,0,0,FL - Melbourne
33,1983-1984,1983-12-01,1984-02-29,91,1,0,5,5,0,0,0,5,0,0,FL - Melbourne
34,1984-1985,1984-12-01,1985-02-28,90,1,0,5,5,0,0,0,5,0,0,FL - Melbourne
35,1985-1986,1985-12-01,1986-02-28,90,0,0,4,4,0,0,0,4,0,0,FL - Melbourne
37,1987-1988,1987-12-01,1988-02-29,91,0,0,0,0,0,0,0,0,0,0,FL - Melbourne
38,1988-1989,1988-12-01,1989-02-28,90,2,0,2,2,0,0,0,2,0,0,FL - Melbourne
40,1990-1991,1990-12-01,1991-02-28,90,0,0,1,1,0,0,0,1,0,0,FL - Melbourne
41,1991-1992,1991-12-01,1992-02-29,91,0,0,0,0,0,0,0,0,0,0,FL - Melbourne
42,1992-1993,1992-12-01,1993-02-28,90,0,0,0,0,0,0,0,0,0,0,FL - Melbourne
43,1993-1994,1993-12-01,1994-02-28,90,0,0,1,1,0,0,0,1,0,0,FL - Melbourne
44,1994-1995,1994-12-01,1995-02-28,90,0,0,2,2,0,0,0,2,0,0,FL - Melbourne
45,1995-1996,1995-12-01,1996-02-29,91,0,0,8,8,0,0,0,8,0,0,FL - Melbourne
46,1996-1997,1996-12-01,1997-02-28,90,0,0,1,1,0,0,0,1,0,0,FL - Melbourne
47,1997-1998,1997-12-01,1998-02-28,90,0,0,0,0,0,0,0,0,0,0,FL - Melbourne
48,1998-1999,1998-12-01,1999-02-28,90,0,0,1,1,0,0,0,1,0,0,FL - Melbourne
49,1999-2000,1999-12-01,2000-02-29,91,0,0,1,1,0,0,0,1,0,0,FL - Melbourne
59,2009-2010,2009-12-01,2010-02-28,90,0,0,8,8,0,0,0,8,0,0,FL - Melbourne
60,2010-2011,2010-12-01,2011-02-28,90,0,0,7,7,0,0,0,7,0,0,FL - Melbourne
61,2011-2012,2011-12-01,2012-02-29,91,0,0,1,1,0,0,0,1,0,0,FL - Melbourne
62,2012-2013,2012-12-01,2013-02-28,90,0,0,0,0,0,0,0,0,0,0,FL - Melbourne
63,2013-2014,2013-12-01,2014-02-28,90,0,0,1,1,0,0,0,1,0,0,FL - Melbourne
64,2014-2015,2014-12-01,2015-02-28,90,1,0,0,0,0,0,0,0,0,0,FL - Melbourne
65,2015-2016,2015-12-01,2016-02-29,91,0,0,0,0,0,0,0,0,0,0,FL - Melbourne
66,2016-2017,2016-12-01,2017-02-28,90,0,0,0,0,0,0,0,0,0,0,FL - Melbourne
67,2017-2018,2017-12-01,2018-02-28,90,0,0,1,1,0,0,0,1,0,0,FL - Melbourne
68,2018-2019,2018-12-01,2019-02-28,90,0,0,0,0,0,0,0,0,0,0,FL - Melbourne
69,2019-2020,2019-12-01,2020-02-29,91,0,0,0,0,0,0,0,0,0,0,FL - Melbourne
0,1950-1951,1950-12-01,1951-02-28,90,1,0,4,4,0,0,0,4,0,0,FL - Orlando
1,1951-1952,1951-12-01,1952-02-29,91,0,0,0,0,0,0,0,0,0,0,FL - Orlando
2,1952-1953,1952-12-01,1953-02-28,90,0,0,1,1,0,0,0,1,0,0,FL - Orlando
3,1953-1954,1953-12-01,1954-02-28,90,0,0,0,0,0,0,0,0,0,0,FL - Orlando
4,1954-1955,1954-12-01,1955-02-28,90,0,0,4,4,0,0,0,4,0,0,FL - Orlando
5,1955-1956,1955-12-01,1956-02-29,91,0,0,2,2,0,0,0,2,0,0,FL - Orlando
6,1956-1957,1956-12-01,1957-02-28,90,0,0,0,0,0,0,0,0,0,0,FL - Orlando
7,1957-1958,1957-12-01,1958-02-28,90,0,0,14,14,0,0,0,14,0,0,FL - Orlando
8,1958-1959,1958-12-01,1959-02-28,90,0,0,4,4,0,0,0,4,0,0,FL - Orlando
9,1959-1960,1959-12-01,1960-02-29,91,0,0,3,3,0,0,0,3,0,0,FL - Orlando
10,1960-1961,1960-12-01,1961-02-28,90,0,0,3,3,0,0,0,3,0,0,FL - Orlando
11,1961-1962,1961-12-01,1962-02-28,90,0,0,2,2,0,0,0,2,0,0,FL - Orlando
12,1962-1963,1962-12-01,1963-02-28,90,0,0,5,5,0,0,0,5,0,0,FL - Orlando
13,1963-1964,1963-12-01,1964-02-29,91,0,0,1,1,0,0,0,1,0,0,FL - Orlando
14,1964-1965,1964-12-01,1965-02-28,90,0,0,2,2,0,0,0,2,0,0,FL - Orlando
15,1965-1966,1965-12-01,1966-02-28,90,0,0,3,3,0,0,0,3,0,0,FL - Orlando
16,1966-1967,1966-12-01,1967-02-28,90,0,0,2,2,0,0,0,2,0,0,FL - Orlando
17,1967-1968,1967-12-01,1968-02-29,91,0,0,1,1,0,0,0,1,0,0,FL - Orlando
18,1968-1969,1968-12-01,1969-02-28,90,0,0,2,2,0,0,0,2,0,0,FL - Orlando
19,1969-1970,1969-12-01,1970-02-28,90,0,0,5,5,0,0,0,5,0,0,FL - Orlando
20,1970-1971,1970-12-01,1971-02-28,90,0,0,3,3,0,0,0,3,0,0,FL - Orlando
21,1971-1972,1971-12-01,1972-02-29,91,0,0,0,0,0,0,0,0,0,0,FL - Orlando
22,1972-1973,1972-12-01,1973-02-28,90,0,0,0,0,0,0,0,0,0,0,FL - Orlando
23,1973-1974,1973-12-01,1974-02-28,90,0,0,3,3,0,0,0,3,0,0,FL - Orlando
24,1974-1975,1974-12-01,1975-02-28,90,0,0,0,0,0,0,0,0,0,0,FL - Orlando
25,1975-1976,1975-12-01,1976-02-29,91,0,0,5,5,0,0,0,5,0,0,FL - Orlando
26,1976-1977,1976-12-01,1977-02-28,90,0,0,11,11,0,0,0,11,0,0,FL - Orlando
27,1977-1978,1977-12-01,1978-02-28,90,0,0,6,6,0,0,0,6,0,0,FL - Orlando
28,1978-1979,1978-12-01,1979-02-28,90,0,0,1,1,0,0,0,1,0,0,FL - Orlando
29,1979-1980,1979-12-01,1980-02-29,91,0,0,2,2,0,0,0,2,0,0,FL - Orlando
30,1980-1981,1980-12-01,1981-02-28,90,0,0,11,11,0,0,0,11,0,0,FL - Orlando
31,1981-1982,1981-12-01,1982-02-28,90,0,0,6,6,0,0,0,6,0,0,FL - Orlando
32,1982-1983,1982-12-01,1983-02-28,90,0,0,0,0,0,0,0,0,0,0,FL - Orlando
33,1983-1984,1983-12-01,1984-02-29,91,0,0,5,5,0,0,0,5,0,0,FL - Orlando
34,1984-1985,1984-12-01,1985-02-28,90,0,0,8,8,0,0,0,8,0,0,FL - Orlando
35,1985-1986,1985-12-01,1986-02-28,90,0,0,5,5,0,0,0,5,0,0,FL - Orlando
36,1986-1987,1986-12-01,1987-02-28,90,0,0,1,1,0,0,0,1,0,0,FL - Orlando
37,1987-1988,1987-12-01,1988-02-29,91,0,0,0,0,0,0,0,0,0,0,FL - Orlando
38,1988-1989,1988-12-01,1989-02-28,90,0,0,2,2,0,0,0,2,0,0,FL - Orlando
39,1989-1990,1989-12-01,1990-02-28,90,0,0,5,5,0,0,0,5,0,0,FL - Orlando
40,1990-1991,1990-12-01,1991-02-28,90,0,0,1,1,0,0,0,1,0,0,FL - Orlando
41,1991-1992,1991-12-01,1992-02-29,91,0,0,0,0,0,0,0,0,0,0,FL - Orlando
42,1992-1993,1992-12-01,1993-02-28,90,0,0,0,0,0,0,0,0,0,0,FL - Orlando
43,1993-1994,1993-12-01,1994-02-28,90,0,0,0,0,0,0,0,0,0,0,FL - Orlando
44,1994-1995,1994-12-01,1995-02-28,90,0,0,1,1,0,0,0,1,0,0,FL - Orlando
45,1995-1996,1995-12-01,1996-02-29,91,0,0,5,5,0,0,0,5,0,0,FL - Orlando
46,1996-1997,1996-12-01,1997-02-28,90,0,0,2,2,0,0,0,2,0,0,FL - Orlando
47,1997-1998,1997-12-01,1998-02-28,90,0,0,0,0,0,0,0,0,0,0,FL - Orlando
48,1998-1999,1998-12-01,1999-02-28,90,0,0,1,1,0,0,0,1,0,0,FL - Orlando
49,1999-2000,1999-12-01,2000-02-29,91,0,0,1,1,0,0,0,1,0,0,FL - Orlando
50,2000-2001,2000-12-01,2001-02-28,90,0,0,7,7,0,0,0,7,0,0,FL - Orlando
51,2001-2002,2001-12-01,2002-02-28,90,0,0,2,2,0,0,0,2,0,0,FL - Orlando
52,2002-2003,2002-12-01,2003-02-28,90,0,0,2,2,0,0,0,2,0,0,FL - Orlando
53,2003-2004,2003-12-01,2004-02-29,91,0,0,0,0,0,0,0,0,0,0,FL - Orlando
54,2004-2005,2004-12-01,2005-02-28,90,0,0,0,0,0,0,0,0,0,0,FL - Orlando
55,2005-2006,2005-12-01,2006-02-28,90,0,0,0,0,0,0,0,0,0,0,FL - Orlando
56,2006-2007,2006-12-01,2007-02-28,90,0,0,0,0,0,0,0,0,0,0,FL - Orlando
57,2007-2008,2007-12-01,2008-02-29,91,0,0,1,1,0,0,0,1,0,0,FL - Orlando
58,2008-2009,2008-12-01,2009-02-28,90,0,0,4,4,0,0,0,4,0,0,FL - Orlando
59,2009-2010,2009-12-01,2010-02-28,90,0,0,6,6,0,0,0,6,0,0,FL - Orlando
60,2010-2011,2010-12-01,2011-02-28,90,0,0,9,9,0,0,0,9,0,0,FL - Orlando
61,2011-2012,2011-12-01,2012-02-29,91,0,0,3,3,0,0,0,3,0,0,FL - Orlando
62,2012-2013,2012-12-01,2013-02-28,90,0,0,0,0,0,0,0,0,0,0,FL - Orlando
63,2013-2014,2013-12-01,2014-02-28,90,0,0,1,1,0,0,0,1,0,0,FL - Orlando
64,2014-2015,2014-12-01,2015-02-28,90,0,0,0,0,0,0,0,0,0,0,FL - Orlando
65,2015-2016,2015-12-01,2016-02-29,91,0,0,0,0,0,0,0,0,0,0,FL - Orlando
66,2016-2017,2016-12-01,2017-02-28,90,0,0,0,0,0,0,0,0,0,0,FL - Orlando
67,2017-2018,2017-12-01,2018-02-28,90,0,0,3,3,0,0,0,3,0,0,FL - Orlando
68,2018-2019,2018-12-01,2019-02-28,90,0,0,0,0,0,0,0,0,0,0,FL - Orlando
69,2019-2020,2019-12-01,2020-02-29,91,0,0,0,0,0,0,0,0,0,0,FL - Orlando
0,1950-1951,1950-12-01,1951-02-28,90,0,1,21,22,0,0,0,22,0,0,FL - Pensacola
1,1951-1952,1951-12-01,1952-02-29,91,2,0,5,5,0,0,0,5,0,0,FL - Pensacola
2,1952-1953,1952-12-01,1953-02-28,90,0,0,5,5,0,0,0,5,0,0,FL - Pensacola
3,1953-1954,1953-12-01,1954-03-06,96,0,0,8,8,3,0,3,11,1,3,FL - Pensacola
4,1954-1955,1954-12-01,1955-02-28,90,0,0,9,9,0,0,0,9,0,0,FL - Pensacola
5,1955-1956,1955-12-01,1956-02-29,91,0,0,10,10,0,0,0,10,0,0,FL - Pensacola
6,1956-1957,1956-12-01,1957-02-28,90,1,0,3,3,0,0,0,3,0,0,FL - Pensacola
7,1957-1958,1957-12-01,1958-02-28,90,0,0,35,35,0,0,0,35,0,0,FL - Pensacola
8,1958-1959,1958-12-01,1959-02-28,90,0,0,15,15,0,0,0,15,0,0,FL - Pensacola
9,1959-1960,1959-12-01,1960-02-29,91,0,0,10,10,0,0,0,10,0,0,FL - Pensacola
10,1960-1961,1960-12-01,1961-02-28,90,0,0,18,18,0,0,0,18,0,0,FL - Pensacola
11,1961-1962,1961-12-01,1962-02-28,90,0,2,29,31,0,0,0,31,0,0,FL - Pensacola
12,1962-1963,1962-12-01,1963-02-28,90,0,3,34,37,0,0,0,37,0,0,FL - Pensacola
13,1963-1964,1963-12-01,1964-02-29,91,0,0,29,29,0,0,0,29,0,0,FL - Pensacola
14,1964-1965,1964-12-01,1965-02-28,90,0,0,16,16,0,0,0,16,0,0,FL - Pensacola
15,1965-1966,1965-12-01,1966-02-28,90,0,1,22,23,0,0,0,23,0,0,FL - Pensacola
16,1966-1967,1966-12-01,1967-02-28,90,0,0,8,8,0,0,0,8,0,0,FL - Pensacola
17,1967-1968,1967-12-01,1968-02-29,91,0,0,19,19,0,0,0,19,0,0,FL - Pensacola
18,1968-1969,1968-12-01,1969-02-28,90,0,0,18,18,0,0,0,18,0,0,FL - Pensacola
19,1969-1970,1969-12-01,1970-02-28,90,0,0,19,19,0,0,0,19,0,0,FL - Pensacola
20,1970-1971,1970-12-01,1971-02-28,90,0,0,18,18,0,0,0,18,0,0,FL - Pensacola
21,1971-1972,1971-12-01,1972-02-29,91,0,0,8,8,0,0,0,8,0,0,FL - Pensacola
22,1972-1973,1972-12-01,1973-02-28,90,0,0,13,13,3,2,5,18,2,5,FL - Pensacola
23,1973-1974,1973-12-01,1974-02-28,90,0,0,9,9,0,0,0,9,0,0,FL - Pensacola
24,1974-1975,1974-12-01,1975-02-28,90,0,0,8,8,0,0,0,8,0,0,FL - Pensacola
25,1975-1976,1975-12-01,1976-02-29,91,0,0,13,13,0,0,0,13,0,0,FL - Pensacola
26,1976-1977,1976-12-01,1977-02-28,90,0,1,39,40,4,0,4,44,2,7,FL - Pensacola
27,1977-1978,1977-12-01,1978-02-28,90,0,0,30,30,0,0,0,30,0,0,FL - Pensacola
29,1979-1980,1979-12-01,1980-02-29,91,0,0,19,19,0,0,0,19,0,0,FL - Pensacola
30,1980-1981,1980-12-01,1981-02-28,90,0,0,33,33,0,0,0,33,0,0,FL - Pensacola
31,1981-1982,1981-12-01,1982-02-28,90,0,1,29,30,0,0,0,30,0,0,FL - Pensacola
32,1982-1983,1982-12-01,1983-02-28,90,0,0,10,10,0,0,0,10,0,0,FL - Pensacola
33,1983-1984,1983-12-01,1984-02-29,91,0,1,29,30,0,0,0,30,0,0,FL - Pensacola
34,1984-1985,1984-12-01,1985-02-28,90,0,1,22,23,0,0,0,23,0,0,FL - Pensacola
35,1985-1986,1985-12-01,1986-02-28,90,0,0,21,21,0,0,0,21,0,0,FL - Pensacola
36,1986-1987,1986-12-01,1987-02-28,90,0,0,8,8,0,0,0,8,0,0,FL - Pensacola
37,1987-1988,1987-12-01,1988-02-29,91,0,0,15,15,0,0,0,15,0,0,FL - Pensacola
38,1988-1989,1988-12-01,1989-02-28,90,0,0,11,11,0,0,0,11,0,0,FL - Pensacola
39,1989-1990,1989-12-01,1990-02-28,90,0,1,22,23,0,0,0,23,0,0,FL - Pensacola
40,1990-1991,1990-12-01,1991-02-28,90,0,0,6,6,0,0,0,6,0,0,FL - Pensacola
41,1991-1992,1991-12-01,1992-02-29,91,0,0,10,10,0,0,0,10,0,0,FL - Pensacola
42,1992-1993,1992-12-01,1993-02-28,90,0,0,1,1,0,0,0,1,0,0,FL - Pensacola
43,1993-1994,1993-12-01,1994-02-28,90,0,0,13,13,0,0,0,13,0,0,FL - Pensacola
44,1994-1995,1994-12-01,1995-02-28,90,2,0,8,8,0,0,0,8,0,0,FL - Pensacola
45,1995-1996,1995-12-01,1996-02-29,91,0,1,36,37,0,0,0,37,0,0,FL - Pensacola
46,1996-1997,1996-12-01,1997-02-28,90,0,0,13,13,0,0,0,13,0,0,FL - Pensacola
47,1997-1998,1997-12-01,1998-02-28,90,14,0,4,4,0,0,0,4,0,0,FL - Pensacola
48,1998-1999,1998-12-01,1999-02-28,90,16,0,10,10,0,0,0,10,0,0,FL - Pensacola
49,1999-2000,1999-12-01,2000-02-29,91,14,0,10,10,0,0,0,10,0,0,FL - Pensacola
50,2000-2001,2000-12-01,2001-02-28,90,14,0,29,29,0,0,0,29,0,0,FL - Pensacola
51,2001-2002,2001-12-01,2002-02-28,90,14,0,11,11,0,0,0,11,0,0,FL - Pensacola
52,2002-2003,2002-12-01,2003-02-28,90,14,0,16,16,0,0,0,16,0,0,FL - Pensacola
53,2003-2004,2003-12-01,2004-02-29,91,14,0,15,15,0,0,0,15,0,0,FL - Pensacola
54,2004-2005,2004-12-01,2005-02-28,90,14,0,11,11,0,0,0,11,0,0,FL - Pensacola
55,2005-2006,2005-12-01,2006-02-28,90,14,0,5,5,0,0,0,5,0,0,FL - Pensacola
56,2006-2007,2006-12-01,2007-02-28,90,14,0,10,10,0,0,0,10,0,0,FL - Pensacola
57,2007-2008,2007-12-01,2008-02-29,91,14,0,8,8,0,0,0,8,0,0,FL - Pensacola
58,2008-2009,2008-12-01,2009-02-28,90,8,0,13,13,0,0,0,13,0,0,FL - Pensacola
59,2009-2010,2009-12-01,2010-02-28,90,0,0,30,30,0,0,0,30,0,0,FL - Pensacola
60,2010-2011,2010-12-01,2011-02-28,90,0,0,24,24,0,0,0,24,0,0,FL - Pensacola
61,2011-2012,2011-12-01,2012-02-29,91,0,0,6,6,0,0,0,6,0,0,FL - Pensacola
62,2012-2013,2012-12-01,2013-02-28,90,0,0,3,3,0,0,0,3,0,0,FL - Pensacola
63,2013-2014,2013-12-01,2014-02-28,90,1,1,19,20,2,1,3,23,1,3,FL - Pensacola
64,2014-2015,2014-12-01,2015-02-28,90,6,0,11,11,0,0,0,11,0,0,FL - Pensacola
65,2015-2016,2015-12-01,2016-02-29,91,3,0,5,5,0,0,0,5,0,0,FL - Pensacola
66,2016-2017,2016-12-01,2017-02-28,90,9,0,2,2,0,0,0,2,0,0,FL - Pensacola
67,2017-2018,2017-12-01,2018-02-28,90,2,0,15,15,0,0,0,15,0,0,FL - Pensacola
68,2018-2019,2018-12-01,2019-02-28,90,5,0,0,0,0,0,0,0,0,0,FL - Pensacola
0,1950-1951,1950-12-01,1951-02-28,90,0,0,1,1,0,0,0,1,0,0,FL - Tampa
1,1951-1952,1951-12-01,1952-02-29,91,0,0,0,0,0,0,0,0,0,0,FL - Tampa
2,1952-1953,1952-12-01,1953-02-28,90,0,0,0,0,0,0,0,0,0,0,FL - Tampa
3,1953-1954,1953-12-01,1954-02-28,90,0,0,0,0,0,0,0,0,0,0,FL - Tampa
4,1954-1955,1954-12-01,1955-02-28,90,0,0,1,1,0,0,0,1,0,0,FL - Tampa
5,1955-1956,1955-12-01,1956-02-29,91,0,0,1,1,0,0,0,1,0,0,FL - Tampa
6,1956-1957,1956-12-01,1957-02-28,90,0,0,0,0,0,0,0,0,0,0,FL - Tampa
7,1957-1958,1957-12-01,1958-02-28,90,0,0,9,9,0,0,0,9,0,0,FL - Tampa
8,1958-1959,1958-12-01,1959-02-28,90,0,0,2,2,0,0,0,2,0,0,FL - Tampa
9,1959-1960,1959-12-01,1960-02-29,91,0,0,2,2,0,0,0,2,0,0,FL - Tampa
10,1960-1961,1960-12-01,1961-02-28,90,0,0,4,4,0,0,0,4,0,0,FL - Tampa
11,1961-1962,1961-12-01,1962-02-28,90,0,0,1,1,0,0,0,1,0,0,FL - Tampa
12,1962-1963,1962-12-01,1963-02-28,90,0,0,5,5,0,0,0,5,0,0,FL - Tampa
13,1963-1964,1963-12-01,1964-02-29,91,0,0,4,4,0,0,0,4,0,0,FL - Tampa
14,1964-1965,1964-12-01,1965-02-28,90,0,0,3,3,0,0,0,3,0,0,FL - Tampa
15,1965-1966,1965-12-01,1966-02-28,90,0,0,7,7,0,0,0,7,0,0,FL - Tampa
16,1966-1967,1966-12-01,1967-02-28,90,0,0,3,3,0,0,0,3,0,0,FL - Tampa
17,1967-1968,1967-12-01,1968-02-29,91,0,0,2,2,0,0,0,2,0,0,FL - Tampa
18,1968-1969,1968-12-01,1969-02-28,90,0,0,3,3,0,0,0,3,0,0,FL - Tampa
19,1969-1970,1969-12-01,1970-02-28,90,0,0,7,7,0,0,0,7,0,0,FL - Tampa
20,1970-1971,1970-12-01,1971-02-28,90,0,0,7,7,0,0,0,7,0,0,FL - Tampa
21,1971-1972,1971-12-01,1972-02-29,91,0,0,0,0,0,0,0,0,0,0,FL - Tampa
22,1972-1973,1972-12-01,1973-02-28,90,0,0,3,3,0,0,0,3,0,0,FL - Tampa
23,1973-1974,1973-12-01,1974-02-28,90,0,0,5,5,0,0,0,5,0,0,FL - Tampa
24,1974-1975,1974-12-01,1975-02-28,90,0,0,0,0,0,0,0,0,0,0,FL - Tampa
25,1975-1976,1975-12-01,1976-02-29,91,0,0,5,5,0,0,0,5,0,0,FL - Tampa
26,1976-1977,1976-12-01,1977-02-28,90,0,0,8,8,1,0,1,9,1,2,FL - Tampa
27,1977-1978,1977-12-01,1978-02-28,90,0,0,8,8,0,0,0,8,0,0,FL - Tampa
28,1978-1979,1978-12-01,1979-02-28,90,0,0,3,3,0,0,0,3,0,0,FL - Tampa
29,1979-1980,1979-12-01,1980-02-29,91,0,0,2,2,0,0,0,2,0,0,FL - Tampa
30,1980-1981,1980-12-01,1981-02-28,90,0,0,7,7,0,0,0,7,0,0,FL - Tampa
31,1981-1982,1981-12-01,1982-02-28,90,0,0,8,8,0,0,0,8,0,0,FL - Tampa
32,1982-1983,1982-12-01,1983-02-28,90,0,0,0,0,0,0,0,0,0,0,FL - Tampa
33,1983-1984,1983-12-01,1984-02-29,91,0,0,7,7,0,0,0,7,0,0,FL - Tampa
34,1984-1985,1984-12-01,1985-02-28,90,0,0,5,5,0,0,0,5,0,0,FL - Tampa
35,1985-1986,1985-12-01,1986-02-28,90,0,0,3,3,0,0,0,3,0,0,FL - Tampa
36,1986-1987,1986-12-01,1987-02-28,90,0,0,0,0,0,0,0,0,0,0,FL - Tampa
37,1987-1988,1987-12-01,1988-02-29,91,0,0,0,0,0,0,0,0,0,0,FL - Tampa
38,1988-1989,1988-12-01,1989-02-28,90,0,0,1,1,0,0,0,1,0,0,FL - Tampa
39,1989-1990,1989-12-01,1990-02-28,90,0,0,4,4,0,0,0,4,0,0,FL - Tampa
40,1990-1991,1990-12-01,1991-02-28,90,0,0,0,0,0,0,0,0,0,0,FL - Tampa
41,1991-1992,1991-12-01,1992-02-29,91,0,0,0,0,0,0,0,0,0,0,FL - Tampa
42,1992-1993,1992-12-01,1993-02-28,90,0,0,0,0,0,0,0,0,0,0,FL - Tampa
43,1993-1994,1993-12-01,1994-02-28,90,0,0,0,0,0,0,0,0,0,0,FL - Tampa
44,1994-1995,1994-12-01,1995-02-28,90,0,0,1,1,0,0,0,1,0,0,FL - Tampa
45,1995-1996,1995-12-01,1996-02-29,91,0,0,3,3,0,0,0,3,0,0,FL - Tampa
46,1996-1997,1996-12-01,1997-02-28,90,0,0,1,1,0,0,0,1,0,0,FL - Tampa
47,1997-1998,1997-12-01,1998-02-28,90,0,0,0,0,0,0,0,0,0,0,FL - Tampa
48,1998-1999,1998-12-01,1999-02-28,90,0,0,1,1,0,0,0,1,0,0,FL - Tampa
49,1999-2000,1999-12-01,2000-02-29,91,0,0,1,1,0,0,0,1,0,0,FL - Tampa
50,2000-2001,2000-12-01,2001-02-28,90,0,0,3,3,0,0,0,3,0,0,FL - Tampa
51,2001-2002,2001-12-01,2002-02-28,90,0,0,0,0,0,0,0,0,0,0,FL - Tampa
52,2002-2003,2002-12-01,2003-02-28,90,0,0,1,1,0,0,0,1,0,0,FL - Tampa
53,2003-2004,2003-12-01,2004-02-29,91,0,0,0,0,0,0,0,0,0,0,FL - Tampa
54,2004-2005,2004-12-01,2005-02-28,90,0,0,1,1,0,0,0,1,0,0,FL - Tampa
55,2005-2006,2005-12-01,2006-02-28,90,0,0,0,0,0,0,0,0,0,0,FL - Tampa
56,2006-2007,2006-12-01,2007-02-28,90,0,0,0,0,0,0,0,0,0,0,FL - Tampa
57,2007-2008,2007-12-01,2008-02-29,91,0,0,1,1,0,0,0,1,0,0,FL - Tampa
58,2008-2009,2008-12-01,2009-02-28,90,0,0,1,1,0,0,0,1,0,0,FL - Tampa
59,2009-2010,2009-12-01,2010-02-28,90,0,0,5,5,0,0,0,5,0,0,FL - Tampa
60,2010-2011,2010-12-01,2011-02-28,90,0,0,3,3,0,0,0,3,0,0,FL - Tampa
61,2011-2012,2011-12-01,2012-02-29,91,0,0,0,0,0,0,0,0,0,0,FL - Tampa
62,2012-2013,2012-12-01,2013-02-28,90,0,0,0,0,0,0,0,0,0,0,FL - Tampa
63,2013-2014,2013-12-01,2014-02-28,90,0,0,0,0,0,0,0,0,0,0,FL - Tampa
64,2014-2015,2014-12-01,2015-02-28,90,0,0,0,0,0,0,0,0,0,0,FL - Tampa
65,2015-2016,2015-12-01,2016-02-29,91,0,0,0,0,0,0,0,0,0,0,FL - Tampa
66,2016-2017,2016-12-01,2017-02-28,90,0,0,0,0,0,0,0,0,0,0,FL - Tampa
67,2017-2018,2017-12-01,2018-02-28,90,0,0,1,1,0,0,0,1,0,0,FL - Tampa
68,2018-2019,2018-12-01,2019-02-28,90,0,0,0,0,0,0,0,0,0,0,FL - Tampa
69,2019-2020,2019-12-01,2020-02-29,91,0,0,0,0,0,0,0,0,0,0,FL - Tampa
0,1950-1951,1950-11-25,1951-02-28,96,0,2,43,45,0,0,0,45,0,0,GA - Albany
1,1951-1952,1951-12-01,1952-02-29,91,0,0,13,13,0,0,0,13,0,0,GA - Albany
2,1952-1953,1952-12-01,1953-02-28,90,0,0,14,14,0,0,0,14,0,0,GA - Albany
3,1953-1954,1953-12-01,1954-02-28,90,0,0,17,17,0,0,0,17,0,0,GA - Albany
4,1954-1955,1954-12-01,1955-02-28,90,1,0,26,26,0,0,0,26,0,0,GA - Albany
5,1955-1956,1955-12-01,1956-02-29,91,0,0,23,23,0,0,0,23,0,0,GA - Albany
6,1956-1957,1956-12-01,1957-02-28,90,1,0,19,19,0,0,0,19,0,0,GA - Albany
7,1957-1958,1957-12-01,1958-02-28,90,0,0,59,59,1,0,1,60,1,3,GA - Albany
8,1958-1959,1958-12-01,1959-02-28,90,1,0,35,35,0,0,0,35,0,0,GA - Albany
9,1959-1960,1959-12-01,1960-02-29,91,1,0,35,35,0,0,0,35,0,0,GA - Albany
10,1960-1961,1960-12-01,1961-02-28,90,0,0,52,52,0,0,0,52,0,0,GA - Albany
11,1961-1962,1961-12-01,1962-02-28,90,1,0,29,29,0,0,0,29,0,0,GA - Albany
12,1962-1963,1962-12-01,1963-02-28,90,0,0,51,51,0,0,0,51,0,0,GA - Albany
13,1963-1964,1963-12-01,1964-02-29,91,17,0,80,80,0,0,0,80,0,0,GA - Albany
14,1964-1965,1964-12-01,1965-02-28,90,1,0,49,49,0,0,0,49,0,0,GA - Albany
15,1965-1966,1965-12-01,1966-02-28,90,0,1,72,73,0,0,0,73,0,0,GA - Albany
16,1966-1967,1966-12-01,1967-02-28,90,0,0,48,48,0,0,0,48,0,0,GA - Albany
18,1968-1969,1968-12-01,1969-02-28,90,0,0,78,78,0,0,0,78,0,0,GA - Albany
19,1969-1970,1969-12-01,1970-02-28,90,0,1,94,95,0,0,0,95,0,0,GA - Albany
20,1970-1971,1970-12-01,1971-02-28,90,0,0,55,55,0,0,0,55,0,0,GA - Albany
21,1971-1972,1971-12-01,1972-02-29,91,0,0,28,28,0,0,0,28,0,0,GA - Albany
23,1973-1974,1973-12-01,1974-02-28,90,2,0,28,28,0,0,0,28,0,0,GA - Albany
24,1974-1975,1974-12-01,1975-02-28,90,1,0,28,28,0,0,0,28,0,0,GA - Albany
25,1975-1976,1975-12-01,1976-02-29,91,6,0,56,56,0,0,0,56,0,0,GA - Albany
26,1976-1977,1976-12-01,1977-02-28,90,2,1,94,95,0,0,0,95,0,0,GA - Albany
27,1977-1978,1977-12-01,1978-02-28,90,4,0,78,78,0,0,0,78,0,0,GA - Albany
28,1978-1979,1978-12-01,1979-02-28,90,3,1,78,79,0,0,0,79,0,0,GA - Albany
29,1979-1980,1979-12-01,1980-03-03,94,7,1,83,84,0,0,0,84,0,0,GA - Albany
30,1980-1981,1980-12-01,1981-02-28,90,0,0,86,86,0,0,0,86,0,0,GA - Albany
32,1982-1983,1982-12-01,1983-02-28,90,0,0,54,54,0,0,0,54,0,0,GA - Albany
33,1983-1984,1983-12-01,1984-02-29,91,6,2,58,60,0,0,0,60,0,0,GA - Albany
35,1985-1986,1985-12-01,1986-02-28,90,3,2,75,77,0,0,0,77,0,0,GA - Albany
36,1986-1987,1986-12-01,1987-02-28,90,19,0,44,44,0,0,0,44,0,0,GA - Albany
37,1987-1988,1987-12-01,1988-02-29,91,2,0,57,57,0,0,0,57,0,0,GA - Albany
38,1988-1989,1988-12-01,1989-02-28,90,0,0,53,53,0,0,0,53,0,0,GA - Albany
39,1989-1990,1989-12-01,1990-02-28,90,0,2,62,64,0,0,0,64,0,0,GA - Albany
40,1990-1991,1990-12-01,1991-02-28,90,0,0,33,33,0,0,0,33,0,0,GA - Albany
41,1991-1992,1991-12-01,1992-02-29,91,0,0,55,55,0,0,0,55,0,0,GA - Albany
42,1992-1993,1992-12-01,1993-02-28,90,0,0,29,29,0,0,0,29,0,0,GA - Albany
43,1993-1994,1993-12-01,1994-02-28,90,0,0,45,45,0,0,0,45,0,0,GA - Albany
44,1994-1995,1994-12-01,1995-02-28,90,1,0,25,25,0,0,0,25,0,0,GA - Albany
46,1996-1997,1996-12-01,1997-02-28,90,2,0,14,14,0,0,0,14,0,0,GA - Albany
47,1997-1998,1997-12-01,1998-02-28,90,3,0,28,28,0,0,0,28,0,0,GA - Albany
48,1998-1999,1998-12-01,1999-02-28,90,1,0,26,26,0,0,0,26,0,0,GA - Albany
49,1999-2000,1999-12-01,2000-02-29,91,0,0,42,42,0,0,0,42,0,0,GA - Albany
59,2009-2010,2009-12-01,2010-02-28,90,16,0,50,50,2,0,2,52,1,2,GA - Albany
60,2010-2011,2010-12-01,2011-02-28,90,4,0,56,56,0,0,0,56,0,0,GA - Albany
61,2011-2012,2011-12-01,2012-02-29,91,19,0,21,21,0,0,0,21,0,0,GA - Albany
62,2012-2013,2012-12-01,2013-02-28,90,14,0,15,15,0,0,0,15,0,0,GA - Albany
63,2013-2014,2013-12-01,2014-02-28,90,15,1,33,34,0,0,0,34,0,0,GA - Albany
64,2014-2015,2014-12-01,2015-02-28,90,5,0,32,32,0,0,0,32,0,0,GA - Albany
65,2015-2016,2015-12-01,2016-02-29,91,5,0,22,22,0,0,0,22,0,0,GA - Albany
66,2016-2017,2016-12-01,2017-02-28,90,8,0,7,7,0,0,0,7,0,0,GA - Albany
67,2017-2018,2017-12-01,2018-02-28,90,9,0,29,29,1,0,1,30,1,3,GA - Albany
68,2018-2019,2018-12-01,2019-02-28,90,9,0,10,10,0,0,0,10,0,0,GA - Albany
69,2019-2020,2019-12-01,2020-02-29,91,18,0,8,8,0,0,0,8,0,0,GA - Albany
0,1950-1951,1950-11-25,1951-02-28,96,0,1,60,61,0,0,0,61,0,0,GA - Alma
1,1951-1952,1951-12-01,1952-02-29,91,0,0,17,17,0,0,0,17,0,0,GA - Alma
2,1952-1953,1952-12-01,1953-02-28,90,0,0,31,31,0,0,0,31,0,0,GA - Alma
3,1953-1954,1953-12-01,1954-02-28,90,0,0,27,27,0,0,0,27,0,0,GA - Alma
4,1954-1955,1954-12-01,1955-02-28,90,0,0,48,48,0,0,0,48,0,0,GA - Alma
5,1955-1956,1955-12-01,1956-02-29,91,0,0,44,44,0,0,0,44,0,0,GA - Alma
6,1956-1957,1956-12-01,1957-02-28,90,0,0,28,28,0,0,0,28,0,0,GA - Alma
7,1957-1958,1957-12-01,1958-02-28,90,0,0,69,69,0,0,0,69,0,0,GA - Alma
8,1958-1959,1958-12-01,1959-02-28,90,0,0,48,48,0,0,0,48,0,0,GA - Alma
9,1959-1960,1959-12-01,1960-02-29,91,0,0,33,33,0,0,0,33,0,0,GA - Alma
10,1960-1961,1960-12-01,1961-02-28,90,0,0,56,56,0,0,0,56,0,0,GA - Alma
11,1961-1962,1961-12-01,1962-02-28,90,0,0,31,31,0,0,0,31,0,0,GA - Alma
12,1962-1963,1962-12-01,1963-02-28,90,0,1,61,62,0,0,0,62,0,0,GA - Alma
13,1963-1964,1963-12-01,1964-02-29,91,0,0,50,50,0,0,0,50,0,0,GA - Alma
14,1964-1965,1964-12-01,1965-02-28,90,0,0,26,26,0,0,0,26,0,0,GA - Alma
15,1965-1966,1965-12-01,1966-02-28,90,0,0,40,40,0,0,0,40,0,0,GA - Alma
16,1966-1967,1966-12-01,1967-02-28,90,0,0,25,25,0,0,0,25,0,0,GA - Alma
17,1967-1968,1967-12-01,1968-02-29,91,0,0,38,38,1,0,1,39,1,2,GA - Alma
18,1968-1969,1968-12-01,1969-02-28,90,0,0,36,36,0,0,0,36,0,0,GA - Alma
19,1969-1970,1969-12-01,1970-02-28,90,0,1,51,52,0,0,0,52,0,0,GA - Alma
20,1970-1971,1970-12-01,1971-02-28,90,0,0,29,29,0,0,0,29,0,0,GA - Alma
21,1971-1972,1971-12-01,1972-02-29,91,0,0,11,11,0,0,0,11,0,0,GA - Alma
22,1972-1973,1972-12-01,1973-02-28,90,0,0,23,23,6,7,13,36,1,7,GA - Alma
23,1973-1974,1973-12-01,1974-02-28,90,0,0,18,18,0,0,0,18,0,0,GA - Alma
24,1974-1975,1974-12-01,1975-02-28,90,0,0,13,13,0,0,0,13,0,0,GA - Alma
25,1975-1976,1975-12-01,1976-02-29,91,0,0,29,29,0,0,0,29,0,0,GA - Alma
26,1976-1977,1976-12-01,1977-02-28,90,0,2,47,49,0,0,0,49,0,0,GA - Alma
27,1977-1978,1977-12-01,1978-02-28,90,0,0,45,45,0,0,0,45,0,0,GA - Alma
28,1978-1979,1978-12-01,1979-02-28,90,0,0,40,40,0,0,0,40,0,0,GA - Alma
29,1979-1980,1979-12-01,1980-02-29,91,0,0,28,28,0,0,0,28,0,0,GA - Alma
30,1980-1981,1980-12-01,1981-02-28,90,0,0,48,48,0,0,0,48,0,0,GA - Alma
31,1981-1982,1981-12-01,1982-02-28,90,0,1,34,35,0,0,0,35,0,0,GA - Alma
32,1982-1983,1982-12-01,1983-02-28,90,0,0,20,20,0,0,0,20,0,0,GA - Alma
33,1983-1984,1983-12-01,1984-02-29,91,0,1,40,41,0,0,0,41,0,0,GA - Alma
34,1984-1985,1984-12-01,1985-02-28,90,0,1,45,46,0,0,0,46,0,0,GA - Alma
35,1985-1986,1985-12-01,1986-02-28,90,0,0,33,33,0,0,0,33,0,0,GA - Alma
36,1986-1987,1986-12-01,1987-02-28,90,0,0,11,11,0,0,0,11,0,0,GA - Alma
37,1987-1988,1987-12-01,1988-02-29,91,0,0,33,33,0,0,0,33,0,0,GA - Alma
38,1988-1989,1988-12-01,1989-02-28,90,0,0,17,17,0,0,0,17,0,0,GA - Alma
39,1989-1990,1989-12-01,1990-02-28,90,0,0,16,16,3,1,4,20,1,6,GA - Alma
40,1990-1991,1990-12-01,1991-02-28,90,0,0,14,14,0,0,0,14,0,0,GA - Alma
41,1991-1992,1991-12-01,1992-02-29,91,0,0,11,11,0,0,0,11,0,0,GA - Alma
42,1992-1993,1992-12-01,1993-02-28,90,0,0,3,3,0,0,0,3,0,0,GA - Alma
43,1993-1994,1993-12-01,1994-02-28,90,0,0,19,19,0,0,0,19,0,0,GA - Alma
44,1994-1995,1994-12-01,1995-02-28,90,0,0,12,12,0,0,0,12,0,0,GA - Alma
45,1995-1996,1995-12-01,1996-02-29,91,0,0,42,42,0,0,0,42,0,0,GA - Alma
46,1996-1997,1996-12-01,1997-02-28,90,0,0,12,12,0,0,0,12,0,0,GA - Alma
47,1997-1998,1997-12-01,1998-02-28,90,0,0,6,6,0,0,0,6,0,0,GA - Alma
48,1998-1999,1998-12-01,1999-02-28,90,0,0,21,21,0,0,0,21,0,0,GA - Alma
49,1999-2000,1999-12-01,2000-02-29,91,0,0,26,26,0,0,0,26,0,0,GA - Alma
50,2000-2001,2000-12-01,2001-02-28,90,0,0,50,50,0,0,0,50,0,0,GA - Alma
51,2001-2002,2001-12-01,2002-02-28,90,0,0,26,26,0,0,0,26,0,0,GA - Alma
52,2002-2003,2002-12-01,2003-02-28,90,0,0,36,36,0,0,0,36,0,0,GA - Alma
53,2003-2004,2003-12-01,2004-02-29,91,0,0,32,32,0,0,0,32,0,0,GA - Alma
54,2004-2005,2004-12-01,2005-02-28,90,0,0,20,20,0,0,0,20,0,0,GA - Alma
55,2005-2006,2005-12-01,2006-02-28,90,0,0,20,20,0,0,0,20,0,0,GA - Alma
56,2006-2007,2006-12-01,2007-02-28,90,0,0,22,22,0,0,0,22,0,0,GA - Alma
57,2007-2008,2007-12-01,2008-02-29,91,0,0,20,20,0,0,0,20,0,0,GA - Alma
58,2008-2009,2008-12-01,2009-02-28,90,0,0,37,37,0,0,0,37,0,0,GA - Alma
59,2009-2010,2009-12-01,2010-02-28,90,0,0,46,46,0,0,0,46,0,0,GA - Alma
60,2010-2011,2010-12-01,2011-02-28,90,0,0,56,56,0,0,0,56,0,0,GA - Alma
61,2011-2012,2011-12-01,2012-02-29,91,0,0,22,22,0,0,0,22,0,0,GA - Alma
62,2012-2013,2012-12-01,2013-02-28,90,0,0,12,12,0,0,0,12,0,0,GA - Alma
63,2013-2014,2013-12-01,2014-02-28,90,0,1,23,24,0,0,0,24,0,0,GA - Alma
64,2014-2015,2014-12-01,2015-02-28,90,3,0,23,23,0,0,0,23,0,0,GA - Alma
65,2015-2016,2015-12-01,2016-02-29,91,2,0,18,18,0,0,0,18,0,0,GA - Alma
66,2016-2017,2016-12-01,2017-02-28,90,1,0,8,8,0,0,0,8,0,0,GA - Alma
67,2017-2018,2017-12-01,2018-02-28,90,0,0,29,29,4,0,4,33,1,6,GA - Alma
68,2018-2019,2018-12-01,2019-02-28,90,0,0,11,11,0,0,0,11,0,0,GA - Alma
69,2019-2020,2019-12-01,2020-02-29,91,0,0,12,12,0,0,0,12,0,0,GA - Alma
0,1950-1951,1950-11-25,1951-02-28,96,0,5,73,78,0,0,0,78,0,0,GA - Atlanta
1,1951-1952,1951-12-01,1952-02-29,91,0,0,34,34,4,1,5,39,1,4,GA - Atlanta
2,1952-1953,1952-12-01,1953-02-28,90,0,0,27,27,2,0,2,29,1,2,GA - Atlanta
3,1953-1954,1953-12-01,1954-02-28,90,0,0,40,40,1,0,1,41,1,1,GA - Atlanta
4,1954-1955,1954-12-01,1955-02-28,90,0,1,41,42,1,0,1,43,1,2,GA - Atlanta
5,1955-1956,1955-12-01,1956-02-29,91,0,0,39,39,0,0,0,39,0,0,GA - Atlanta
6,1956-1957,1956-12-01,1957-02-28,90,0,1,19,20,0,0,0,20,0,0,GA - Atlanta
7,1957-1958,1957-12-01,1958-02-28,90,0,6,90,96,3,1,4,100,1,4,GA - Atlanta
8,1958-1959,1958-12-01,1959-02-28,90,0,1,51,52,4,0,4,56,2,6,GA - Atlanta
9,1959-1960,1959-12-01,1960-03-12,103,0,3,54,57,7,5,12,69,2,9,GA - Atlanta
10,1960-1961,1960-12-01,1961-02-28,90,0,4,73,77,1,1,2,79,1,3,GA - Atlanta
11,1961-1962,1961-12-01,1962-02-28,90,0,4,62,66,6,5,11,77,2,9,GA - Atlanta
12,1962-1963,1962-12-01,1963-02-28,90,0,7,115,122,0,0,0,122,0,0,GA - Atlanta
13,1963-1964,1963-12-01,1964-02-29,91,0,3,86,89,6,3,9,98,4,13,GA - Atlanta
14,1964-1965,1964-12-01,1965-03-05,95,0,2,68,70,5,5,10,80,3,11,GA - Atlanta
15,1965-1966,1965-12-01,1966-02-28,90,0,4,74,78,3,0,3,81,3,10,GA - Atlanta
16,1966-1967,1966-12-01,1967-02-28,90,0,1,54,55,3,1,4,59,1,4,GA - Atlanta
17,1967-1968,1967-12-01,1968-02-29,91,0,3,80,83,8,3,11,94,6,15,GA - Atlanta
18,1968-1969,1968-11-11,1969-02-28,110,0,1,98,99,4,1,5,104,3,8,GA - Atlanta
19,1969-1970,1969-12-01,1970-02-28,90,0,5,93,98,4,0,4,102,4,8,GA - Atlanta
20,1970-1971,1970-11-24,1971-02-28,97,0,3,79,82,2,2,4,86,1,4,GA - Atlanta
21,1971-1972,1971-12-01,1972-02-29,91,0,1,42,43,2,1,3,46,1,3,GA - Atlanta
22,1972-1973,1972-12-01,1973-02-28,90,0,4,58,62,2,0,2,64,1,3,GA - Atlanta
23,1973-1974,1973-12-01,1974-02-28,90,0,1,44,45,0,0,0,45,0,0,GA - Atlanta
24,1974-1975,1974-12-01,1975-02-28,90,0,0,43,43,0,0,0,43,0,0,GA - Atlanta
25,1975-1976,1975-11-23,1976-02-29,99,0,1,83,84,1,1,2,86,1,1,GA - Atlanta
26,1976-1977,1976-12-01,1977-02-28,90,0,8,147,155,2,1,3,158,1,4,GA - Atlanta
27,1977-1978,1977-12-01,1978-02-28,90,0,6,113,119,1,0,1,120,1,2,GA - Atlanta
28,1978-1979,1978-12-01,1979-02-28,90,0,2,88,90,9,7,16,106,4,16,GA - Atlanta
29,1979-1980,1979-12-01,1980-03-03,94,0,2,56,58,6,3,9,67,3,12,GA - Atlanta
30,1980-1981,1980-12-01,1981-02-28,90,0,2,78,80,0,0,0,80,0,0,GA - Atlanta
31,1981-1982,1981-12-01,1982-02-28,90,0,8,88,96,11,4,15,111,4,25,GA - Atlanta
32,1982-1983,1982-12-01,1983-03-25,115,0,0,42,42,16,7,23,65,6,21,GA - Atlanta
33,1983-1984,1983-12-01,1984-02-29,91,0,7,75,82,3,0,3,85,2,6,GA - Atlanta
34,1984-1985,1984-12-01,1985-02-28,90,0,4,74,78,4,1,5,83,4,18,GA - Atlanta
35,1985-1986,1985-12-01,1986-02-28,90,0,1,75,76,1,0,1,77,1,7,GA - Atlanta
36,1986-1987,1986-12-01,1987-03-12,102,0,0,32,32,6,2,8,40,3,9,GA - Atlanta
37,1987-1988,1987-12-01,1988-02-29,91,0,4,55,59,6,4,10,69,1,9,GA - Atlanta
38,1988-1989,1988-12-01,1989-02-28,90,0,0,33,33,1,0,1,34,1,3,GA - Atlanta
39,1989-1990,1989-12-01,1990-02-28,90,0,4,44,48,3,0,3,51,2,4,GA - Atlanta
40,1990-1991,1990-12-01,1991-02-28,90,0,0,30,30,3,0,3,33,1,3,GA - Atlanta
41,1991-1992,1991-12-01,1992-02-29,91,0,0,28,28,7,6,13,41,1,8,GA - Atlanta
42,1992-1993,1992-12-01,1993-03-14,104,0,0,31,31,6,5,11,42,1,8,GA - Atlanta
43,1993-1994,1993-12-01,1994-02-28,90,0,3,50,53,4,1,5,58,2,5,GA - Atlanta
44,1994-1995,1994-12-01,1995-02-28,90,0,1,34,35,2,0,2,37,2,6,GA - Atlanta
47,1997-1998,1997-12-01,1998-02-28,90,20,0,30,30,1,1,2,32,1,2,GA - Atlanta
48,1998-1999,1998-12-01,1999-02-28,90,0,2,30,32,1,0,1,33,1,2,GA - Atlanta
49,1999-2000,1999-12-01,2000-02-29,91,0,0,39,39,0,0,0,39,0,0,GA - Atlanta
50,2000-2001,2000-12-01,2001-02-28,90,0,4,68,72,5,4,9,81,3,13,GA - Atlanta
55,2005-2006,2005-12-01,2006-02-28,90,0,0,41,41,0,0,0,41,0,0,GA - Atlanta
56,2006-2007,2006-12-01,2007-02-28,90,0,0,41,41,1,0,1,42,1,1,GA - Atlanta
57,2007-2008,2007-12-01,2008-02-29,91,0,2,39,41,3,1,4,45,2,5,GA - Atlanta
58,2008-2009,2008-12-01,2009-03-02,92,0,2,57,59,6,1,7,66,1,6,GA - Atlanta
59,2009-2010,2009-12-01,2010-03-02,92,0,3,74,77,7,4,11,88,3,10,GA - Atlanta
60,2010-2011,2010-12-01,2011-02-28,90,0,4,64,68,11,16,27,95,6,21,GA - Atlanta
61,2011-2012,2011-12-01,2012-02-29,91,0,0,21,21,0,0,0,21,0,0,GA - Atlanta
62,2012-2013,2012-12-01,2013-02-28,90,0,0,18,18,0,0,0,18,0,0,GA - Atlanta
63,2013-2014,2013-11-27,2014-02-28,94,0,3,73,76,7,5,12,88,4,13,GA - Atlanta
64,2014-2015,2014-12-01,2015-02-28,90,0,1,45,46,0,0,0,46,0,0,GA - Atlanta
65,2015-2016,2015-12-01,2016-02-29,91,0,0,29,29,2,0,2,31,2,4,GA - Atlanta
66,2016-2017,2016-12-01,2017-02-28,90,0,1,18,19,0,0,0,19,0,0,GA - Atlanta
67,2017-2018,2017-12-01,2018-02-28,90,0,2,49,51,7,8,15,66,4,14,GA - Atlanta
68,2018-2019,2018-12-01,2019-02-28,90,0,0,17,17,0,0,0,17,0,0,GA - Atlanta
69,2019-2020,2019-12-01,2020-02-29,91,0,0,13,13,0,0,0,13,0,0,GA - Atlanta
0,1950-1951,1950-11-25,1951-02-28,96,0,2,78,80,0,0,0,80,0,0,GA - Augusta
1,1951-1952,1951-12-01,1952-02-29,91,0,0,35,35,1,0,1,36,1,1,GA - Augusta
2,1952-1953,1952-12-01,1953-02-28,90,0,0,41,41,0,0,0,41,0,0,GA - Augusta
3,1953-1954,1953-12-01,1954-02-28,90,0,0,50,50,0,0,0,50,0,0,GA - Augusta
4,1954-1955,1954-12-01,1955-02-28,90,0,0,65,65,1,0,1,66,1,2,GA - Augusta
5,1955-1956,1955-12-01,1956-02-29,91,0,0,60,60,0,0,0,60,0,0,GA - Augusta
6,1956-1957,1956-12-01,1957-02-28,90,0,0,33,33,0,0,0,33,0,0,GA - Augusta
7,1957-1958,1957-12-01,1958-02-28,90,0,1,81,82,2,1,3,85,1,3,GA - Augusta
8,1958-1959,1958-12-01,1959-02-28,90,0,0,70,70,1,1,2,72,1,3,GA - Augusta
9,1959-1960,1959-12-01,1960-03-11,102,0,0,59,59,1,0,1,60,1,2,GA - Augusta
10,1960-1961,1960-12-01,1961-02-28,90,0,1,90,91,1,0,1,92,1,2,GA - Augusta
11,1961-1962,1961-12-01,1962-02-28,90,0,1,44,45,0,0,0,45,0,0,GA - Augusta
12,1962-1963,1962-12-01,1963-02-28,90,0,1,84,85,0,0,0,85,0,0,GA - Augusta
13,1963-1964,1963-12-01,1964-02-29,91,0,0,79,79,0,0,0,79,0,0,GA - Augusta
14,1964-1965,1964-12-01,1965-02-28,90,0,0,53,53,0,0,0,53,0,0,GA - Augusta
15,1965-1966,1965-12-01,1966-02-28,90,0,1,70,71,2,0,2,73,2,4,GA - Augusta
16,1966-1967,1966-12-01,1967-02-28,90,0,0,65,65,4,2,6,71,1,5,GA - Augusta
17,1967-1968,1967-12-01,1968-02-29,91,0,1,83,84,4,2,6,90,3,6,GA - Augusta
18,1968-1969,1968-12-01,1969-02-28,90,0,0,85,85,0,0,0,85,0,0,GA - Augusta
19,1969-1970,1969-12-01,1970-02-28,90,0,3,114,117,2,1,3,120,1,5,GA - Augusta
20,1970-1971,1970-12-01,1971-02-28,90,0,0,67,67,0,0,0,67,0,0,GA - Augusta
21,1971-1972,1971-12-01,1972-02-29,91,0,1,29,30,1,0,1,31,1,2,GA - Augusta
22,1972-1973,1972-12-01,1973-02-28,90,0,0,62,62,22,27,49,111,3,27,GA - Augusta
23,1973-1974,1973-12-01,1974-02-28,90,0,0,40,40,0,0,0,40,0,0,GA - Augusta
24,1974-1975,1974-12-01,1975-02-28,90,0,0,37,37,0,0,0,37,0,0,GA - Augusta
25,1975-1976,1975-12-01,1976-02-29,91,0,0,69,69,0,0,0,69,0,0,GA - Augusta
26,1976-1977,1976-12-01,1977-02-28,90,0,2,111,113,1,0,1,114,1,2,GA - Augusta
27,1977-1978,1977-12-01,1978-02-28,90,0,0,94,94,2,1,3,97,1,3,GA - Augusta
28,1978-1979,1978-12-01,1979-02-28,90,0,1,79,80,4,6,10,90,1,7,GA - Augusta
29,1979-1980,1979-12-01,1980-03-03,94,0,1,74,75,8,5,13,88,2,12,GA - Augusta
30,1980-1981,1980-12-01,1981-02-28,90,0,0,93,93,0,0,0,93,0,0,GA - Augusta
31,1981-1982,1981-12-01,1982-02-28,90,0,4,96,100,2,0,2,102,1,5,GA - Augusta
32,1982-1983,1982-12-01,1983-02-28,90,0,0,50,50,0,0,0,50,0,0,GA - Augusta
33,1983-1984,1983-12-01,1984-02-29,91,0,1,69,70,0,0,0,70,0,0,GA - Augusta
34,1984-1985,1984-12-01,1985-02-28,90,0,1,64,65,0,0,0,65,0,0,GA - Augusta
35,1985-1986,1985-12-01,1986-02-28,90,0,0,76,76,0,0,0,76,0,0,GA - Augusta
36,1986-1987,1986-12-01,1987-02-28,90,0,0,38,38,0,0,0,38,0,0,GA - Augusta
37,1987-1988,1987-12-01,1988-02-29,91,0,2,76,78,3,6,9,87,1,6,GA - Augusta
38,1988-1989,1988-12-01,1989-02-28,90,0,0,50,50,4,4,8,58,1,5,GA - Augusta
39,1989-1990,1989-12-01,1990-02-28,90,0,2,44,46,2,0,2,48,2,4,GA - Augusta
40,1990-1991,1990-12-01,1991-02-28,90,0,0,33,33,0,0,0,33,0,0,GA - Augusta
41,1991-1992,1991-12-01,1992-02-29,91,0,0,47,47,3,3,6,53,1,4,GA - Augusta
42,1992-1993,1992-12-01,1993-02-28,90,0,0,28,28,0,0,0,28,0,0,GA - Augusta
43,1993-1994,1993-12-01,1994-02-28,90,0,1,65,66,2,1,3,69,1,3,GA - Augusta
44,1994-1995,1994-12-01,1995-02-28,90,0,0,40,40,0,0,0,40,0,0,GA - Augusta
45,1995-1996,1995-12-01,1996-02-29,91,8,1,83,84,3,0,3,87,2,8,GA - Augusta
46,1996-1997,1996-12-01,1997-02-28,90,0,0,54,54,0,0,0,54,0,0,GA - Augusta
47,1997-1998,1997-12-01,1998-02-28,90,2,0,35,35,0,0,0,35,0,0,GA - Augusta
48,1998-1999,1998-12-01,1999-02-28,90,0,0,47,47,0,0,0,47,0,0,GA - Augusta
49,1999-2000,1999-12-01,2000-02-29,91,0,0,73,73,1,1,2,75,1,1,GA - Augusta
50,2000-2001,2000-12-01,2001-02-28,90,0,0,88,88,0,0,0,88,0,0,GA - Augusta
51,2001-2002,2001-12-01,2002-02-28,90,0,0,59,59,5,6,11,70,2,7,GA - Augusta
52,2002-2003,2002-12-01,2003-02-28,90,0,0,68,68,0,0,0,68,0,0,GA - Augusta
53,2003-2004,2003-12-01,2004-02-29,91,0,0,87,87,0,0,0,87,0,0,GA - Augusta
54,2004-2005,2004-12-01,2005-02-28,90,0,0,58,58,0,0,0,58,0,0,GA - Augusta
55,2005-2006,2005-12-01,2006-02-28,90,0,0,52,52,0,0,0,52,0,0,GA - Augusta
56,2006-2007,2006-12-01,2007-02-28,90,0,0,50,50,0,0,0,50,0,0,GA - Augusta
57,2007-2008,2007-12-01,2008-02-29,91,0,0,48,48,0,0,0,48,0,0,GA - Augusta
58,2008-2009,2008-12-01,2009-02-28,90,0,0,63,63,0,0,0,63,0,0,GA - Augusta
59,2009-2010,2009-12-01,2010-02-28,90,0,0,75,75,12,5,17,92,1,13,GA - Augusta
60,2010-2011,2010-12-01,2011-02-28,90,0,1,93,94,5,1,6,100,2,8,GA - Augusta
61,2011-2012,2011-12-01,2012-02-29,91,0,0,44,44,0,0,0,44,0,0,GA - Augusta
62,2012-2013,2012-12-01,2013-02-28,90,0,0,35,35,0,0,0,35,0,0,GA - Augusta
63,2013-2014,2013-12-01,2014-02-28,90,0,2,74,76,5,4,9,85,3,10,GA - Augusta
64,2014-2015,2014-12-01,2015-02-28,90,0,0,71,71,0,0,0,71,0,0,GA - Augusta
65,2015-2016,2015-12-01,2016-02-29,91,0,0,38,38,1,0,1,39,1,2,GA - Augusta
66,2016-2017,2016-12-01,2017-02-28,90,1,0,16,16,0,0,0,16,0,0,GA - Augusta
67,2017-2018,2017-12-01,2018-02-28,90,0,0,57,57,0,0,0,57,0,0,GA - Augusta
68,2018-2019,2018-12-01,2019-02-28,90,0,0,30,30,0,0,0,30,0,0,GA - Augusta
69,2019-2020,2019-12-01,2020-02-29,91,0,0,18,18,0,0,0,18,0,0,GA - Augusta
0,1950-1951,1950-12-01,1951-02-28,90,0,0,19,19,0,0,0,19,0,0,GA - Brunswick
1,1951-1952,1951-12-01,1952-02-29,91,0,0,7,7,0,0,0,7,0,0,GA - Brunswick
2,1952-1953,1952-12-01,1953-02-28,90,0,0,6,6,0,0,0,6,0,0,GA - Brunswick
3,1953-1954,1953-12-01,1954-02-28,90,0,0,8,8,0,0,0,8,0,0,GA - Brunswick
4,1954-1955,1954-12-01,1955-02-28,90,0,0,20,20,0,0,0,20,0,0,GA - Brunswick
5,1955-1956,1955-12-01,1956-02-29,91,0,0,13,13,0,0,0,13,0,0,GA - Brunswick
6,1956-1957,1956-12-01,1957-02-28,90,0,0,4,4,0,0,0,4,0,0,GA - Brunswick
7,1957-1958,1957-12-01,1958-02-28,90,0,0,36,36,2,2,4,40,1,3,GA - Brunswick
8,1958-1959,1958-12-01,1959-02-28,90,0,0,21,21,0,0,0,21,0,0,GA - Brunswick
9,1959-1960,1959-12-01,1960-02-29,91,0,0,15,15,0,0,0,15,0,0,GA - Brunswick
10,1960-1961,1960-12-01,1961-02-28,90,0,0,25,25,0,0,0,25,0,0,GA - Brunswick
11,1961-1962,1961-12-01,1962-02-28,90,0,0,12,12,0,0,0,12,0,0,GA - Brunswick
12,1962-1963,1962-12-01,1963-02-28,90,0,0,31,31,0,0,0,31,0,0,GA - Brunswick
13,1963-1964,1963-12-01,1964-02-29,91,0,0,17,17,0,0,0,17,0,0,GA - Brunswick
14,1964-1965,1964-12-01,1965-02-28,90,0,0,13,13,0,0,0,13,0,0,GA - Brunswick
15,1965-1966,1965-12-01,1966-02-28,90,0,0,17,17,0,0,0,17,0,0,GA - Brunswick
16,1966-1967,1966-12-01,1967-02-28,90,0,0,9,9,0,0,0,9,0,0,GA - Brunswick
17,1967-1968,1967-12-01,1968-02-29,91,0,0,16,16,0,0,0,16,0,0,GA - Brunswick
18,1968-1969,1968-12-01,1969-02-28,90,0,0,17,17,0,0,0,17,0,0,GA - Brunswick
19,1969-1970,1969-12-01,1970-02-28,90,0,0,27,27,0,0,0,27,0,0,GA - Brunswick
20,1970-1971,1970-12-01,1971-02-28,90,0,0,17,17,0,0,0,17,0,0,GA - Brunswick
21,1971-1972,1971-12-01,1972-02-29,91,2,0,5,5,0,0,0,5,0,0,GA - Brunswick
22,1972-1973,1972-12-01,1973-02-28,90,0,0,13,13,1,0,1,14,1,2,GA - Brunswick
23,1973-1974,1973-12-01,1974-02-28,90,0,0,8,8,0,0,0,8,0,0,GA - Brunswick
24,1974-1975,1974-12-01,1975-02-28,90,0,0,5,5,0,0,0,5,0,0,GA - Brunswick
25,1975-1976,1975-12-01,1976-02-29,91,0,0,15,15,0,0,0,15,0,0,GA - Brunswick
26,1976-1977,1976-12-01,1977-02-28,90,0,0,27,27,0,0,0,27,0,0,GA - Brunswick
27,1977-1978,1977-12-01,1978-02-28,90,0,0,23,23,0,0,0,23,0,0,GA - Brunswick
28,1978-1979,1978-12-01,1979-02-28,90,0,0,16,16,0,0,0,16,0,0,GA - Brunswick
29,1979-1980,1979-12-01,1980-02-29,91,2,0,10,10,0,0,0,10,0,0,GA - Brunswick
30,1980-1981,1980-12-01,1981-02-28,90,0,0,22,22,0,0,0,22,0,0,GA - Brunswick
31,1981-1982,1981-12-01,1982-02-28,90,0,0,19,19,0,0,0,19,0,0,GA - Brunswick
32,1982-1983,1982-12-01,1983-02-28,90,0,0,7,7,0,0,0,7,0,0,GA - Brunswick
33,1983-1984,1983-12-01,1984-02-29,91,0,1,24,25,0,0,0,25,0,0,GA - Brunswick
34,1984-1985,1984-12-01,1985-02-28,90,0,1,27,28,0,0,0,28,0,0,GA - Brunswick
35,1985-1986,1985-12-01,1986-02-28,90,0,0,18,18,0,0,0,18,0,0,GA - Brunswick
36,1986-1987,1986-12-01,1987-02-28,90,3,0,5,5,0,0,0,5,0,0,GA - Brunswick
37,1987-1988,1987-12-01,1988-02-29,91,0,0,14,14,0,0,0,14,0,0,GA - Brunswick
38,1988-1989,1988-12-01,1989-02-28,90,0,0,11,11,0,0,0,11,0,0,GA - Brunswick
39,1989-1990,1989-12-01,1990-02-28,90,0,2,18,20,6,10,16,36,1,11,GA - Brunswick
40,1990-1991,1990-12-01,1991-02-28,90,0,0,8,8,0,0,0,8,0,0,GA - Brunswick
41,1991-1992,1991-12-01,1992-02-29,91,0,0,4,4,0,0,0,4,0,0,GA - Brunswick
42,1992-1993,1992-12-01,1993-02-28,90,0,0,1,1,0,0,0,1,0,0,GA - Brunswick
43,1993-1994,1993-12-01,1994-02-28,90,0,0,14,14,0,0,0,14,0,0,GA - Brunswick
44,1994-1995,1994-12-01,1995-02-28,90,0,0,8,8,0,0,0,8,0,0,GA - Brunswick
45,1995-1996,1995-12-01,1996-02-29,91,2,0,26,26,0,0,0,26,0,0,GA - Brunswick
46,1996-1997,1996-12-01,1997-02-28,90,0,0,7,7,0,0,0,7,0,0,GA - Brunswick
47,1997-1998,1997-12-01,1998-02-28,90,2,0,2,2,0,0,0,2,0,0,GA - Brunswick
48,1998-1999,1998-12-01,1999-02-28,90,4,0,8,8,0,0,0,8,0,0,GA - Brunswick
49,1999-2000,1999-12-01,2000-02-29,91,0,0,10,10,0,0,0,10,0,0,GA - Brunswick
50,2000-2001,2000-12-01,2001-02-28,90,0,0,23,23,0,0,0,23,0,0,GA - Brunswick
51,2001-2002,2001-12-01,2002-02-28,90,0,0,6,6,0,0,0,6,0,0,GA - Brunswick
52,2002-2003,2002-12-01,2003-02-28,90,0,0,12,12,0,0,0,12,0,0,GA - Brunswick
53,2003-2004,2003-12-01,2004-02-29,91,0,0,10,10,0,0,0,10,0,0,GA - Brunswick
54,2004-2005,2004-12-01,2005-02-28,90,8,0,11,11,0,0,0,11,0,0,GA - Brunswick
55,2005-2006,2005-12-01,2006-02-28,90,6,0,5,5,0,0,0,5,0,0,GA - Brunswick
56,2006-2007,2006-12-01,2007-02-28,90,5,0,6,6,0,0,0,6,0,0,GA - Brunswick
57,2007-2008,2007-12-01,2008-02-29,91,7,0,7,7,0,0,0,7,0,0,GA - Brunswick
58,2008-2009,2008-12-01,2009-02-28,90,3,0,8,8,0,0,0,8,0,0,GA - Brunswick
59,2009-2010,2009-12-01,2010-02-28,90,0,0,19,19,0,0,0,19,0,0,GA - Brunswick
60,2010-2011,2010-12-01,2011-02-28,90,0,0,19,19,0,0,0,19,0,0,GA - Brunswick
61,2011-2012,2011-12-01,2012-02-29,91,0,0,4,4,0,0,0,4,0,0,GA - Brunswick
62,2012-2013,2012-12-01,2013-02-28,90,0,0,3,3,0,0,0,3,0,0,GA - Brunswick
63,2013-2014,2013-12-01,2014-02-28,90,0,0,9,9,0,0,0,9,0,0,GA - Brunswick
64,2014-2015,2014-12-01,2015-02-28,90,3,0,7,7,0,0,0,7,0,0,GA - Brunswick
65,2015-2016,2015-12-01,2016-02-29,91,4,0,4,4,0,0,0,4,0,0,GA - Brunswick
66,2016-2017,2016-12-01,2017-02-28,90,2,0,1,1,0,0,0,1,0,0,GA - Brunswick
67,2017-2018,2017-12-01,2018-02-28,90,0,1,11,12,0,0,0,12,0,0,GA - Brunswick
68,2018-2019,2018-12-01,2019-02-28,90,0,0,1,1,0,0,0,1,0,0,GA - Brunswick
69,2019-2020,2019-12-01,2020-02-29,91,0,0,0,0,0,0,0,0,0,0,GA - Brunswick
0,1950-1951,1950-11-25,1951-02-28,96,0,1,38,39,0,0,0,39,0,0,GA - Savannah
1,1951-1952,1951-12-01,1952-02-29,91,0,0,14,14,0,0,0,14,0,0,GA - Savannah
2,1952-1953,1952-12-01,1953-02-28,90,0,0,16,16,0,0,0,16,0,0,GA - Savannah
3,1953-1954,1953-12-01,1954-02-28,90,0,0,20,20,0,0,0,20,0,0,GA - Savannah
4,1954-1955,1954-12-01,1955-02-28,90,0,0,39,39,0,0,0,39,0,0,GA - Savannah
5,1955-1956,1955-12-01,1956-02-29,91,0,0,27,27,0,0,0,27,0,0,GA - Savannah
6,1956-1957,1956-12-01,1957-02-28,90,0,0,17,17,0,0,0,17,0,0,GA - Savannah
7,1957-1958,1957-12-01,1958-02-28,90,0,0,58,58,2,0,2,60,1,3,GA - Savannah
8,1958-1959,1958-12-01,1959-02-28,90,0,0,39,39,0,0,0,39,0,0,GA - Savannah
9,1959-1960,1959-12-01,1960-02-29,91,0,0,31,31,0,0,0,31,0,0,GA - Savannah
10,1960-1961,1960-12-01,1961-02-28,90,0,0,56,56,0,0,0,56,0,0,GA - Savannah
11,1961-1962,1961-12-01,1962-02-28,90,0,0,28,28,0,0,0,28,0,0,GA - Savannah
12,1962-1963,1962-12-01,1963-02-28,90,0,0,48,48,0,0,0,48,0,0,GA - Savannah
13,1963-1964,1963-12-01,1964-02-29,91,0,0,42,42,0,0,0,42,0,0,GA - Savannah
14,1964-1965,1964-12-01,1965-02-28,90,0,0,33,33,0,0,0,33,0,0,GA - Savannah
15,1965-1966,1965-12-01,1966-02-28,90,0,0,53,53,0,0,0,53,0,0,GA - Savannah
16,1966-1967,1966-12-01,1967-02-28,90,0,0,39,39,0,0,0,39,0,0,GA - Savannah
17,1967-1968,1967-12-01,1968-02-29,91,0,1,45,46,4,4,8,54,1,5,GA - Savannah
18,1968-1969,1968-12-01,1969-02-28,90,0,0,51,51,0,0,0,51,0,0,GA - Savannah
19,1969-1970,1969-12-01,1970-02-28,90,0,1,56,57,0,0,0,57,0,0,GA - Savannah
20,1970-1971,1970-12-01,1971-02-28,90,0,0,38,38,0,0,0,38,0,0,GA - Savannah
21,1971-1972,1971-12-01,1972-02-29,91,0,0,17,17,0,0,0,17,0,0,GA - Savannah
22,1972-1973,1972-12-01,1973-02-28,90,0,0,25,25,4,3,7,32,1,5,GA - Savannah
23,1973-1974,1973-12-01,1974-02-28,90,0,0,20,20,0,0,0,20,0,0,GA - Savannah
24,1974-1975,1974-12-01,1975-02-28,90,0,0,10,10,0,0,0,10,0,0,GA - Savannah
25,1975-1976,1975-12-01,1976-02-29,91,0,0,37,37,0,0,0,37,0,0,GA - Savannah
26,1976-1977,1976-12-01,1977-02-28,90,0,2,50,52,3,0,3,55,2,7,GA - Savannah
27,1977-1978,1977-12-01,1978-02-28,90,0,0,49,49,0,0,0,49,0,0,GA - Savannah
28,1978-1979,1978-12-01,1979-02-28,90,0,0,37,37,0,0,0,37,0,0,GA - Savannah
29,1979-1980,1979-12-01,1980-03-02,93,0,1,27,28,0,0,0,28,0,0,GA - Savannah
30,1980-1981,1980-12-01,1981-02-28,90,0,0,42,42,0,0,0,42,0,0,GA - Savannah
31,1981-1982,1981-12-01,1982-02-28,90,0,1,35,36,0,0,0,36,0,0,GA - Savannah
32,1982-1983,1982-12-01,1983-02-28,90,0,0,15,15,0,0,0,15,0,0,GA - Savannah
33,1983-1984,1983-12-01,1984-02-29,91,0,1,33,34,0,0,0,34,0,0,GA - Savannah
34,1984-1985,1984-12-01,1985-02-28,90,0,1,40,41,0,0,0,41,0,0,GA - Savannah
35,1985-1986,1985-12-01,1986-03-01,91,0,0,32,32,3,0,3,35,2,6,GA - Savannah
36,1986-1987,1986-12-01,1987-02-28,90,0,0,10,10,0,0,0,10,0,0,GA - Savannah
37,1987-1988,1987-12-01,1988-02-29,91,0,0,34,34,0,0,0,34,0,0,GA - Savannah
38,1988-1989,1988-12-01,1989-02-28,90,0,0,22,22,2,1,3,25,1,3,GA - Savannah
39,1989-1990,1989-12-01,1990-02-28,90,0,2,22,24,6,8,14,38,3,16,GA - Savannah
40,1990-1991,1990-12-01,1991-02-28,90,0,0,11,11,0,0,0,11,0,0,GA - Savannah
41,1991-1992,1991-12-01,1992-02-29,91,0,0,10,10,0,0,0,10,0,0,GA - Savannah
42,1992-1993,1992-12-01,1993-03-13,103,0,0,6,6,1,0,1,7,1,1,GA - Savannah
43,1993-1994,1993-12-01,1994-02-28,90,0,0,23,23,0,0,0,23,0,0,GA - Savannah
44,1994-1995,1994-12-01,1995-02-28,90,0,0,9,9,0,0,0,9,0,0,GA - Savannah
45,1995-1996,1995-12-01,1996-02-29,91,0,0,34,34,1,0,1,35,1,2,GA - Savannah
52,2002-2003,2002-12-01,2003-02-28,90,0,0,35,35,0,0,0,35,0,0,GA - Savannah
53,2003-2004,2003-12-01,2004-02-29,91,0,0,29,29,0,0,0,29,0,0,GA - Savannah
54,2004-2005,2004-12-01,2005-02-28,90,0,0,21,21,0,0,0,21,0,0,GA - Savannah
55,2005-2006,2005-12-01,2006-02-28,90,0,0,22,22,0,0,0,22,0,0,GA - Savannah
56,2006-2007,2006-12-01,2007-02-28,90,0,0,24,24,0,0,0,24,0,0,GA - Savannah
57,2007-2008,2007-12-01,2008-02-29,91,0,0,16,16,0,0,0,16,0,0,GA - Savannah
58,2008-2009,2008-12-01,2009-02-28,90,0,0,28,28,0,0,0,28,0,0,GA - Savannah
59,2009-2010,2009-12-01,2010-02-28,90,0,0,39,39,1,1,2,41,1,1,GA - Savannah
60,2010-2011,2010-12-01,2011-02-28,90,0,0,48,48,0,0,0,48,0,0,GA - Savannah
61,2011-2012,2011-12-01,2012-02-29,91,0,0,16,16,0,0,0,16,0,0,GA - Savannah
62,2012-2013,2012-12-01,2013-02-28,90,0,0,11,11,0,0,0,11,0,0,GA - Savannah
63,2013-2014,2013-12-01,2014-02-28,90,0,1,20,21,0,0,0,21,0,0,GA - Savannah
64,2014-2015,2014-12-01,2015-02-28,90,0,0,19,19,0,0,0,19,0,0,GA - Savannah
65,2015-2016,2015-12-01,2016-02-29,91,0,0,15,15,0,0,0,15,0,0,GA - Savannah
66,2016-2017,2016-12-01,2017-02-28,90,0,0,6,6,0,0,0,6,0,0,GA - Savannah
67,2017-2018,2017-12-01,2018-02-28,90,0,1,30,31,2,1,3,34,1,5,GA - Savannah
68,2018-2019,2018-12-01,2019-02-28,90,0,0,7,7,0,0,0,7,0,0,GA - Savannah
69,2019-2020,2019-12-01,2020-02-29,91,0,0,5,5,0,0,0,5,0,0,GA - Savannah
0,1950-1951,1950-12-01,1951-03-30,120,0,18,159,177,44,17,61,238,22,84,ID - Boise
1,1951-1952,1951-12-01,1952-03-23,114,0,42,248,290,68,94,162,452,33,149,ID - Boise
2,1952-1953,1952-11-27,1953-04-12,137,1,6,145,151,21,6,27,178,17,39,ID - Boise
3,1953-1954,1953-12-01,1954-04-30,151,0,7,163,170,29,9,38,208,18,56,ID - Boise
4,1954-1955,1954-12-01,1955-04-19,140,0,45,298,343,42,85,127,470,23,99,ID - Boise
5,1955-1956,1955-11-01,1956-03-05,126,1,40,220,260,56,57,113,373,40,161,ID - Boise
6,1956-1957,1956-11-01,1957-03-03,123,1,49,263,312,39,70,109,421,20,109,ID - Boise
7,1957-1958,1957-12-01,1958-03-15,105,0,10,120,130,25,3,28,158,16,41,ID - Boise
8,1958-1959,1958-11-16,1959-03-10,115,0,10,129,139,15,8,23,162,10,33,ID - Boise
9,1959-1960,1959-11-13,1960-03-12,121,0,32,300,332,38,47,85,417,27,127,ID - Boise
10,1960-1961,1960-11-15,1961-03-11,117,0,3,157,160,15,3,18,178,13,30,ID - Boise
11,1961-1962,1961-11-20,1962-03-11,112,0,75,232,307,34,120,154,461,18,93,ID - Boise
12,1962-1963,1962-11-17,1963-04-20,155,0,31,198,229,20,8,28,257,12,61,ID - Boise
13,1963-1964,1963-11-22,1964-05-02,163,0,42,290,332,66,108,174,506,36,149,ID - Boise
14,1964-1965,1964-11-15,1965-04-10,147,0,17,191,208,61,36,97,305,33,114,ID - Boise
15,1965-1966,1965-11-26,1966-04-26,152,0,18,213,231,29,38,67,298,19,69,ID - Boise
16,1966-1967,1966-10-13,1967-04-28,198,0,11,176,187,37,33,70,257,18,74,ID - Boise
17,1967-1968,1967-11-29,1968-04-21,145,0,22,199,221,20,22,42,263,17,70,ID - Boise
18,1968-1969,1968-11-13,1969-04-07,146,0,13,131,144,68,60,128,272,36,128,ID - Boise
19,1969-1970,1969-10-12,1970-05-12,213,0,10,185,195,28,11,39,234,20,50,ID - Boise
20,1970-1971,1970-10-26,1971-03-16,142,0,16,149,165,24,8,32,197,21,66,ID - Boise
21,1971-1972,1971-10-27,1972-04-29,186,0,24,212,236,50,42,92,328,32,102,ID - Boise
22,1972-1973,1972-12-01,1973-03-17,107,0,58,204,262,31,65,96,358,13,105,ID - Boise
23,1973-1974,1973-11-20,1974-03-08,109,0,32,126,158,45,31,76,234,25,94,ID - Boise
24,1974-1975,1974-11-23,1975-05-03,162,0,19,189,208,41,63,104,312,31,87,ID - Boise
25,1975-1976,1975-11-22,1976-04-15,146,0,31,206,237,44,31,75,312,27,88,ID - Boise
26,1976-1977,1976-11-27,1977-03-28,122,0,57,324,381,27,131,158,539,19,76,ID - Boise
27,1977-1978,1977-11-19,1978-02-28,102,0,5,85,90,31,29,60,150,20,63,ID - Boise
28,1978-1979,1978-11-11,1979-04-11,152,0,78,345,423,44,90,134,557,36,174,ID - Boise
29,1979-1980,1979-11-22,1980-03-27,127,0,20,169,189,25,37,62,251,18,73,ID - Boise
30,1980-1981,1980-11-23,1981-04-03,132,0,15,167,182,13,22,35,217,7,25,ID - Boise
31,1981-1982,1981-11-24,1982-04-06,134,0,47,247,294,55,185,240,534,32,134,ID - Boise
32,1982-1983,1982-11-10,1983-05-08,180,0,19,164,183,21,55,76,259,16,54,ID - Boise
33,1983-1984,1983-11-28,1984-04-24,149,0,90,294,384,57,281,338,722,27,167,ID - Boise
34,1984-1985,1984-11-27,1985-04-19,144,0,88,361,449,37,155,192,641,28,169,ID - Boise
35,1985-1986,1985-11-09,1986-02-28,112,0,113,352,465,58,279,337,802,26,143,ID - Boise
36,1986-1987,1986-11-07,1987-02-28,114,0,24,209,233,13,4,17,250,8,32,ID - Boise
37,1987-1988,1987-11-24,1988-04-07,136,0,27,235,262,23,60,83,345,17,53,ID - Boise
38,1988-1989,1988-11-24,1989-03-03,100,0,70,294,364,34,147,181,545,20,112,ID - Boise
39,1989-1990,1989-11-26,1990-03-11,106,0,9,186,195,25,11,36,231,19,60,ID - Boise
40,1990-1991,1990-11-21,1991-03-25,125,0,86,300,386,31,122,153,539,17,130,ID - Boise
41,1991-1992,1991-10-29,1992-02-29,124,0,3,156,159,10,0,10,169,8,19,ID - Boise
42,1992-1993,1992-11-09,1993-03-04,116,0,60,265,325,56,115,171,496,32,169,ID - Boise
43,1993-1994,1993-11-23,1994-02-28,98,0,15,171,186,15,22,37,223,9,32,ID - Boise
44,1994-1995,1994-11-16,1995-03-23,128,0,24,165,189,40,69,109,298,23,93,ID - Boise
45,1995-1996,1995-11-10,1996-03-25,137,0,30,142,172,33,29,62,234,19,66,ID - Boise
46,1996-1997,1996-12-01,1997-03-03,93,0,8,122,130,28,31,59,189,14,49,ID - Boise
47,1997-1998,1997-12-01,1998-03-08,98,0,3,102,105,14,5,19,124,9,21,ID - Boise
48,1998-1999,1998-12-01,1999-04-03,124,0,18,138,156,40,17,57,213,21,66,ID - Boise
49,1999-2000,1999-11-21,2000-03-09,110,0,13,103,116,28,7,35,151,23,62,ID - Boise
50,2000-2001,2000-11-08,2001-03-02,115,0,34,198,232,33,47,80,312,22,71,ID - Boise
51,2001-2002,2001-11-24,2002-03-19,116,0,17,174,191,51,21,72,263,25,95,ID - Boise
52,2002-2003,2002-12-01,2003-04-06,127,0,3,90,93,12,1,13,106,11,23,ID - Boise
53,2003-2004,2003-11-22,2004-03-04,104,0,22,134,156,34,39,73,229,21,74,ID - Boise
54,2004-2005,2004-11-27,2005-02-28,94,0,11,121,132,10,0,10,142,10,34,ID - Boise
55,2005-2006,2005-11-08,2006-03-25,138,0,23,183,206,24,8,32,238,19,51,ID - Boise
56,2006-2007,2006-11-27,2007-03-02,96,0,18,169,187,18,8,26,213,15,46,ID - Boise
57,2007-2008,2007-11-20,2008-03-26,128,0,24,176,200,49,53,102,302,29,104,ID - Boise
58,2008-2009,2008-10-10,2009-04-03,176,0,21,166,187,50,53,103,290,24,89,ID - Boise
59,2009-2010,2009-11-13,2010-04-02,141,0,22,138,160,31,38,69,229,18,58,ID - Boise
60,2010-2011,2010-11-20,2011-03-27,128,0,20,162,182,39,48,87,269,25,74,ID - Boise
61,2011-2012,2011-11-04,2012-03-20,138,0,0,168,168,16,1,17,185,10,23,ID - Boise
62,2012-2013,2012-12-01,2013-03-22,112,0,51,201,252,27,71,98,350,18,75,ID - Boise
63,2013-2014,2013-11-16,2014-02-28,105,0,45,184,229,25,34,59,288,15,69,ID - Boise
64,2014-2015,2014-11-12,2015-02-28,109,0,27,131,158,23,70,93,251,13,50,ID - Boise
65,2015-2016,2015-11-15,2016-02-29,107,0,34,141,175,20,35,55,230,15,53,ID - Boise
66,2016-2017,2016-12-01,2017-04-08,129,0,74,243,317,57,216,273,590,25,163,ID - Boise
67,2017-2018,2017-12-01,2018-04-12,133,0,17,143,160,35,61,96,256,18,72,ID - Boise
68,2018-2019,2018-12-01,2019-02-28,90,0,9,124,133,34,36,70,203,23,66,ID - Boise
69,2019-2020,2019-10-29,2020-02-29,124,0,1,117,118,27,16,43,161,18,52,ID - Boise
1,1951-1952,1951-10-20,1952-04-17,181,0,206,654,860,167,1308,1475,2335,49,414,ID - Dubois
2,1952-1953,1952-11-18,1953-04-07,141,0,116,404,520,59,760,819,1339,22,123,ID - Dubois
3,1953-1954,1953-11-17,1954-04-30,165,2,85,422,507,61,409,470,977,25,147,ID - Dubois
6,1956-1957,1956-10-27,1957-03-31,156,7,123,534,657,56,314,370,1027,21,129,ID - Dubois
8,1958-1959,1958-11-12,1959-05-18,188,14,86,471,557,71,362,433,990,26,168,ID - Dubois
10,1960-1961,1960-11-09,1961-03-20,132,2,59,381,440,40,425,465,905,16,81,ID - Dubois
11,1961-1962,1961-10-22,1962-04-29,190,4,179,602,781,88,549,637,1418,33,263,ID - Dubois
12,1962-1963,1962-11-17,1963-04-27,162,0,101,451,552,19,19,38,590,9,66,ID - Dubois
14,1964-1965,1964-10-30,1965-04-09,162,11,113,516,629,94,806,900,1529,45,266,ID - Dubois
15,1965-1966,1965-11-11,1966-03-22,132,1,90,418,508,50,433,483,991,33,183,ID - Dubois
16,1966-1967,1966-11-09,1967-04-05,148,3,102,416,518,58,777,835,1353,25,161,ID - Dubois
17,1967-1968,1967-11-22,1968-03-18,118,0,116,418,534,70,689,759,1293,36,247,ID - Dubois
18,1968-1969,1968-11-05,1969-04-08,155,5,133,533,666,110,1009,1119,1785,43,283,ID - Dubois
19,1969-1970,1969-10-02,1970-05-12,223,0,68,490,558,68,340,408,966,42,186,ID - Dubois
20,1970-1971,1970-10-23,1971-04-02,162,0,153,541,694,78,983,1061,1755,39,251,ID - Dubois
21,1971-1972,1971-10-28,1972-03-26,151,0,170,543,713,103,882,985,1698,43,384,ID - Dubois
23,1973-1974,1973-11-02,1974-03-30,149,0,131,484,615,59,763,822,1437,22,146,ID - Dubois
24,1974-1975,1974-10-21,1975-05-20,212,2,152,634,786,119,967,1086,1872,39,266,ID - Dubois
25,1975-1976,1975-10-22,1976-06-14,237,0,128,559,687,79,744,823,1510,26,181,ID - Dubois
26,1976-1977,1976-11-26,1977-05-17,173,0,91,476,567,36,225,261,828,14,89,ID - Dubois
27,1977-1978,1977-10-31,1978-04-17,169,0,91,417,508,69,588,657,1165,31,147,ID - Dubois
28,1978-1979,1978-09-18,1979-05-29,254,0,211,701,912,89,922,1011,1923,36,245,ID - Dubois
29,1979-1980,1979-11-04,1980-05-26,205,0,82,476,558,68,456,524,1082,20,109,ID - Dubois
30,1980-1981,1980-11-14,1981-05-07,175,0,35,331,366,44,190,234,600,13,74,ID - Dubois
31,1981-1982,1981-10-30,1982-05-28,211,5,122,536,658,79,677,756,1414,43,232,ID - Dubois
32,1982-1983,1982-10-01,1983-05-16,228,1,70,466,536,102,950,1052,1588,49,203,ID - Dubois
33,1983-1984,1983-09-19,1984-06-11,267,2,159,591,750,102,889,991,1741,48,263,ID - Dubois
34,1984-1985,1984-10-24,1985-05-11,200,5,171,675,846,76,967,1043,1889,33,195,ID - Dubois
35,1985-1986,1985-10-08,1986-04-29,204,3,125,522,647,97,754,851,1498,41,270,ID - Dubois
36,1986-1987,1986-11-06,1987-03-19,134,1,61,404,465,43,257,300,765,19,88,ID - Dubois
37,1987-1988,1987-11-16,1988-04-25,162,1,90,474,564,62,376,438,1002,36,191,ID - Dubois
39,1989-1990,1989-10-28,1990-06-12,228,1,83,527,610,65,392,457,1067,26,161,ID - Dubois
40,1990-1991,1990-11-05,1991-05-02,179,2,123,542,665,55,245,300,965,30,157,ID - Dubois
41,1991-1992,1991-10-23,1992-04-23,184,1,61,436,497,61,601,662,1159,30,144,ID - Dubois
42,1992-1993,1992-11-02,1993-05-08,188,5,137,582,719,115,1118,1233,1952,49,317,ID - Dubois
43,1993-1994,1993-11-19,1994-04-07,140,0,84,433,517,58,522,580,1097,25,150,ID - Dubois
44,1994-1995,1994-10-04,1995-06-06,246,1,91,499,590,113,995,1108,1698,55,291,ID - Dubois
45,1995-1996,1995-10-21,1996-04-21,184,0,73,479,552,88,470,558,1110,35,189,ID - Dubois
46,1996-1997,1996-10-19,1997-04-09,173,1,87,473,560,83,519,602,1162,39,209,ID - Dubois
47,1997-1998,1997-10-24,1998-04-13,172,1,56,431,487,84,816,900,1387,37,169,ID - Dubois
48,1998-1999,1998-11-06,1999-05-16,192,3,89,493,582,94,779,873,1455,41,215,ID - Dubois
49,1999-2000,1999-11-20,2000-05-12,175,3,59,387,446,70,675,745,1191,41,202,ID - Dubois
50,2000-2001,2000-11-05,2001-06-13,221,5,101,546,647,72,824,896,1543,38,199,ID - Dubois
51,2001-2002,2001-10-11,2002-05-08,210,1,138,593,731,86,947,1033,1764,43,293,ID - Dubois
52,2002-2003,2002-10-24,2003-05-06,195,7,48,414,462,61,344,405,867,37,165,ID - Dubois
53,2003-2004,2003-11-03,2004-04-28,178,0,91,454,545,63,668,731,1276,30,161,ID - Dubois
54,2004-2005,2004-10-18,2005-04-20,185,0,65,424,489,63,569,632,1121,31,134,ID - Dubois
55,2005-2006,2005-11-04,2006-04-17,165,0,139,503,642,77,955,1032,1674,38,204,ID - Dubois
56,2006-2007,2006-10-25,2007-05-22,210,3,106,488,594,56,357,413,1007,27,143,ID - Dubois
57,2007-2008,2007-11-21,2008-05-01,163,12,167,606,773,108,1083,1191,1964,43,307,ID - Dubois
58,2008-2009,2008-12-01,2009-04-29,150,3,125,463,588,94,728,822,1410,49,325,ID - Dubois
59,2009-2010,2009-10-05,2010-05-06,214,1,123,425,548,96,661,757,1305,54,247,ID - Dubois
60,2010-2011,2010-10-26,2011-04-21,178,0,88,338,426,114,1012,1126,1552,70,300,ID - Dubois
61,2011-2012,2011-10-06,2012-04-07,185,6,65,409,474,70,275,345,819,38,169,ID - Dubois
62,2012-2013,2012-10-25,2013-04-08,166,4,110,397,507,87,595,682,1189,57,298,ID - Dubois
64,2014-2015,2014-11-02,2015-04-15,165,0,68,322,390,41,218,259,649,25,96,ID - Dubois
65,2015-2016,2015-11-04,2016-03-28,146,4,102,379,481,95,594,689,1170,52,298,ID - Dubois
66,2016-2017,2016-10-05,2017-05-18,226,4,135,387,522,138,707,845,1367,72,412,ID - Dubois
67,2017-2018,2017-10-20,2018-03-24,156,0,74,354,428,70,207,277,705,37,195,ID - Dubois
69,2019-2020,2019-09-29,2020-04-15,200,15,110,472,582,85,766,851,1433,49,292,ID - Dubois
10,1960-1961,1960-10-08,1961-05-06,211,2,36,605,641,97,189,286,927,47,228,ID - Idaho Falls
11,1961-1962,1961-09-21,1962-05-14,236,4,107,648,755,148,372,520,1275,62,402,ID - Idaho Falls
12,1962-1963,1962-09-08,1963-04-27,232,2,62,606,668,90,170,260,928,37,227,ID - Idaho Falls
14,1964-1965,1964-11-11,1965-05-25,196,2,68,560,628,116,443,559,1187,55,290,ID - Idaho Falls
15,1965-1966,1965-09-16,1966-05-22,249,2,65,631,696,139,496,635,1331,54,339,ID - Idaho Falls
16,1966-1967,1966-10-13,1967-06-01,232,0,44,547,591,106,431,537,1128,56,279,ID - Idaho Falls
17,1967-1968,1967-11-21,1968-04-26,158,2,66,557,623,113,506,619,1242,49,327,ID - Idaho Falls
18,1968-1969,1968-09-21,1969-04-25,217,0,71,647,718,146,702,848,1566,58,365,ID - Idaho Falls
19,1969-1970,1969-10-02,1970-05-14,225,0,49,611,660,119,367,486,1146,59,291,ID - Idaho Falls
20,1970-1971,1970-10-26,1971-05-17,204,0,88,572,660,166,616,782,1442,63,413,ID - Idaho Falls
21,1971-1972,1971-10-01,1972-04-30,213,3,106,571,677,210,914,1124,1801,71,489,ID - Idaho Falls
22,1972-1973,1972-10-23,1973-06-17,238,0,103,728,831,134,671,805,1636,64,373,ID - Idaho Falls
23,1973-1974,1973-11-01,1974-05-20,201,2,92,565,657,139,660,799,1456,71,393,ID - Idaho Falls
25,1975-1976,1975-10-08,1976-06-14,251,9,73,607,680,159,622,781,1461,63,387,ID - Idaho Falls
26,1976-1977,1976-11-27,1977-05-18,173,0,60,583,643,66,227,293,936,28,168,ID - Idaho Falls
27,1977-1978,1977-10-10,1978-05-30,233,1,43,418,461,123,615,738,1199,55,262,ID - Idaho Falls
29,1979-1980,1979-11-01,1980-05-26,208,1,64,508,572,103,275,378,950,48,244,ID - Idaho Falls
30,1980-1981,1980-10-14,1981-05-08,207,4,28,467,495,63,160,223,718,32,134,ID - Idaho Falls
32,1982-1983,1982-10-07,1983-05-18,224,6,60,529,589,133,568,701,1290,66,282,ID - Idaho Falls
33,1983-1984,1983-11-08,1984-05-06,181,5,104,623,727,137,1045,1182,1909,69,370,ID - Idaho Falls
34,1984-1985,1984-10-14,1985-04-22,191,10,107,740,847,144,1060,1204,2051,47,292,ID - Idaho Falls
36,1986-1987,1986-09-26,1987-04-19,206,8,54,572,626,63,236,299,925,28,147,ID - Idaho Falls
37,1987-1988,1987-11-14,1988-05-07,176,2,91,624,715,81,428,509,1224,38,215,ID - Idaho Falls
38,1988-1989,1988-11-09,1989-05-15,188,6,123,561,684,139,840,979,1663,46,291,ID - Idaho Falls
39,1989-1990,1989-10-28,1990-05-08,193,7,74,535,609,81,368,449,1058,34,225,ID - Idaho Falls
40,1990-1991,1990-11-04,1991-05-09,187,8,106,614,720,98,320,418,1138,33,253,ID - Idaho Falls
41,1991-1992,1991-10-25,1992-04-17,176,8,48,492,540,50,249,299,839,29,121,ID - Idaho Falls
42,1992-1993,1992-11-01,1993-05-06,187,7,121,658,779,147,1070,1217,1996,56,381,ID - Idaho Falls
43,1993-1994,1993-11-13,1994-04-28,167,6,69,530,599,70,334,404,1003,31,184,ID - Idaho Falls
44,1994-1995,1994-11-02,1995-06-06,217,16,71,478,549,95,461,556,1105,43,205,ID - Idaho Falls
51,2001-2002,2001-11-23,2002-06-09,199,11,127,561,688,129,737,866,1554,39,287,ID - Idaho Falls
52,2002-2003,2002-10-01,2003-04-15,197,9,42,449,491,51,194,245,736,24,119,ID - Idaho Falls
53,2003-2004,2003-10-30,2004-05-13,197,4,93,481,574,129,664,793,1367,37,243,ID - Idaho Falls
54,2004-2005,2004-10-28,2005-04-28,183,7,43,454,497,72,188,260,757,33,179,ID - Idaho Falls
55,2005-2006,2005-10-29,2006-04-17,171,20,102,458,560,145,550,695,1255,46,286,ID - Idaho Falls
56,2006-2007,2006-09-21,2007-05-05,227,9,84,563,647,54,109,163,810,24,123,ID - Idaho Falls
60,2010-2011,2010-10-07,2011-04-13,189,20,123,498,621,159,626,785,1406,51,343,ID - Idaho Falls
61,2011-2012,2011-10-06,2012-04-13,191,3,63,521,584,99,332,431,1015,33,213,ID - Idaho Falls
62,2012-2013,2012-10-25,2013-03-26,153,1,100,467,567,87,422,509,1076,29,212,ID - Idaho Falls
63,2013-2014,2013-11-03,2014-05-12,191,0,67,480,547,92,320,412,959,30,199,ID - Idaho Falls
64,2014-2015,2014-11-10,2015-04-15,157,0,54,330,384,55,203,258,642,15,122,ID - Idaho Falls
66,2016-2017,2016-11-17,2017-04-27,162,0,110,467,577,127,677,804,1381,46,316,ID - Idaho Falls
67,2017-2018,2017-10-14,2018-04-12,181,2,56,454,510,79,311,390,900,30,176,ID - Idaho Falls
68,2018-2019,2018-11-11,2019-04-10,151,0,82,523,605,130,951,1081,1686,43,275,ID - Idaho Falls
69,2019-2020,2019-10-09,2020-05-23,228,11,75,587,662,140,754,894,1556,49,359,ID - Idaho Falls
0,1950-1951,1950-11-12,1951-03-07,116,0,11,107,118,15,10,25,143,12,36,ID - Lewiston
1,1951-1952,1951-12-01,1952-03-31,122,0,24,169,193,30,76,106,299,23,85,ID - Lewiston
2,1952-1953,1952-11-22,1953-04-01,131,0,5,91,96,6,0,6,102,6,11,ID - Lewiston
3,1953-1954,1953-12-01,1954-02-28,90,0,11,80,91,10,13,23,114,7,37,ID - Lewiston
4,1954-1955,1954-12-01,1955-03-24,114,0,10,185,195,37,21,58,253,22,78,ID - Lewiston
5,1955-1956,1955-11-01,1956-03-13,134,0,51,236,287,75,97,172,459,37,171,ID - Lewiston
6,1956-1957,1956-11-19,1957-02-28,102,0,76,212,288,48,146,194,482,21,150,ID - Lewiston
7,1957-1958,1957-12-01,1958-03-17,107,0,1,62,63,2,0,2,65,1,3,ID - Lewiston
8,1958-1959,1958-11-15,1959-02-28,106,0,9,97,106,15,4,19,125,11,37,ID - Lewiston
9,1959-1960,1959-11-13,1960-03-06,115,0,38,199,237,38,95,133,370,19,107,ID - Lewiston
10,1960-1961,1960-12-01,1961-04-20,141,0,12,98,110,18,6,24,134,13,42,ID - Lewiston
11,1961-1962,1961-11-23,1962-03-27,125,0,31,153,184,44,57,101,285,21,95,ID - Lewiston
12,1962-1963,1962-12-01,1963-03-12,102,0,36,151,187,14,22,36,223,9,58,ID - Lewiston
13,1963-1964,1963-12-01,1964-03-25,116,0,8,115,123,30,15,45,168,19,56,ID - Lewiston
14,1964-1965,1964-11-17,1965-03-27,131,0,16,159,175,52,114,166,341,20,83,ID - Lewiston
15,1965-1966,1965-12-01,1966-03-21,111,0,2,94,96,37,21,58,154,13,52,ID - Lewiston
16,1966-1967,1966-11-09,1967-03-11,123,0,0,55,55,7,1,8,63,6,13,ID - Lewiston
17,1967-1968,1967-11-28,1968-02-29,94,0,17,96,113,22,14,36,149,14,60,ID - Lewiston
18,1968-1969,1968-12-01,1969-02-28,90,0,57,178,235,68,165,233,468,28,200,ID - Lewiston
19,1969-1970,1969-12-01,1970-03-04,94,0,14,69,83,30,20,50,133,21,62,ID - Lewiston
20,1970-1971,1970-11-22,1971-03-05,104,0,13,106,119,21,13,34,153,13,59,ID - Lewiston
21,1971-1972,1971-10-27,1972-04-17,174,0,27,156,183,35,23,58,241,26,99,ID - Lewiston
22,1972-1973,1972-12-01,1973-02-28,90,0,50,157,207,21,20,41,248,12,70,ID - Lewiston
23,1973-1974,1973-10-31,1974-03-02,123,0,42,122,164,23,72,95,259,14,56,ID - Lewiston
24,1974-1975,1974-12-01,1975-02-28,90,0,7,92,99,34,29,63,162,21,71,ID - Lewiston
25,1975-1976,1975-11-28,1976-04-01,126,0,8,108,116,13,1,14,130,12,31,ID - Lewiston
26,1976-1977,1976-11-26,1977-03-27,122,0,20,123,143,14,16,30,173,11,30,ID - Lewiston
27,1977-1978,1977-11-19,1978-03-03,105,0,19,74,93,36,36,72,165,18,80,ID - Lewiston
28,1978-1979,1978-11-10,1979-04-01,143,0,101,253,354,33,138,171,525,22,98,ID - Lewiston
29,1979-1980,1979-11-24,1980-03-30,128,0,23,122,145,35,37,72,217,15,69,ID - Lewiston
30,1980-1981,1980-11-23,1981-02-28,98,0,8,65,73,10,4,14,87,6,23,ID - Lewiston
31,1981-1982,1981-12-01,1982-02-28,90,0,25,104,129,26,48,74,203,17,59,ID - Lewiston
32,1982-1983,1982-11-24,1983-02-28,97,0,9,63,72,6,3,9,81,4,13,ID - Lewiston
33,1983-1984,1983-12-01,1984-02-29,91,0,42,137,179,17,46,63,242,11,65,ID - Lewiston
34,1984-1985,1984-11-25,1985-03-21,117,0,38,176,214,44,58,102,316,23,106,ID - Lewiston
35,1985-1986,1985-11-11,1986-02-28,110,0,73,193,266,25,43,68,334,20,111,ID - Lewiston
36,1986-1987,1986-11-08,1987-02-28,113,0,12,107,119,5,15,20,139,3,8,ID - Lewiston
37,1987-1988,1987-12-01,1988-02-29,91,0,22,96,118,10,6,16,134,9,32,ID - Lewiston
38,1988-1989,1988-11-14,1989-03-05,112,0,39,160,199,44,56,100,299,17,83,ID - Lewiston
39,1989-1990,1989-12-01,1990-02-28,90,0,3,55,58,6,3,9,67,5,14,ID - Lewiston
40,1990-1991,1990-12-01,1991-03-14,104,0,31,113,144,13,6,19,163,8,39,ID - Lewiston
41,1991-1992,1991-11-30,1992-02-29,92,0,2,61,63,0,0,0,63,0,0,ID - Lewiston
42,1992-1993,1992-11-27,1993-03-02,96,0,40,167,207,37,94,131,338,21,102,ID - Lewiston
43,1993-1994,1993-11-13,1994-02-28,108,0,15,102,117,12,6,18,135,7,29,ID - Lewiston
54,2004-2005,2004-12-01,2005-02-28,90,2,7,75,82,5,2,7,89,4,14,ID - Lewiston
55,2005-2006,2005-12-01,2006-03-15,105,0,19,98,117,8,4,12,129,5,15,ID - Lewiston
56,2006-2007,2006-11-28,2007-02-28,93,0,22,106,128,14,16,30,158,12,46,ID - Lewiston
57,2007-2008,2007-11-19,2008-02-29,103,0,14,98,112,25,20,45,157,13,41,ID - Lewiston
58,2008-2009,2008-12-01,2009-03-10,100,1,38,123,161,28,46,74,235,17,91,ID - Lewiston
59,2009-2010,2009-12-01,2010-02-28,90,0,17,81,98,5,2,7,105,3,14,ID - Lewiston
60,2010-2011,2010-11-21,2011-03-01,101,0,24,120,144,32,31,63,207,19,67,ID - Lewiston
61,2011-2012,2011-11-19,2012-02-29,103,0,7,99,106,21,20,41,147,8,31,ID - Lewiston
62,2012-2013,2012-12-01,2013-02-28,90,0,4,69,73,7,3,10,83,6,20,ID - Lewiston
63,2013-2014,2013-11-27,2014-03-02,96,0,33,121,154,29,24,53,207,17,85,ID - Lewiston
64,2014-2015,2014-11-13,2015-02-28,108,0,15,83,98,2,1,3,101,2,5,ID - Lewiston
65,2015-2016,2015-11-28,2016-02-29,94,0,9,68,77,12,4,16,93,9,23,ID - Lewiston
66,2016-2017,2016-12-01,2017-03-09,99,0,46,173,219,56,90,146,365,26,118,ID - Lewiston
67,2017-2018,2017-12-01,2018-02-28,90,0,19,85,104,23,34,57,161,12,61,ID - Lewiston
68,2018-2019,2018-12-01,2019-03-13,103,1,24,134,158,53,112,165,323,25,106,ID - Lewiston
69,2019-2020,2019-11-29,2020-03-15,108,0,3,60,63,21,24,45,108,9,38,ID - Lewiston
2,1952-1953,1952-11-25,1953-03-20,116,5,8,95,103,28,16,44,147,10,38,ID - Moscow
3,1953-1954,1953-12-01,1954-03-21,111,2,16,131,147,55,80,135,282,20,111,ID - Moscow
4,1954-1955,1954-12-01,1955-04-26,147,5,18,232,250,79,140,219,469,32,133,ID - Moscow
8,1958-1959,1958-11-14,1959-04-15,153,16,22,141,163,63,62,125,288,22,96,ID - Moscow
10,1960-1961,1960-11-15,1961-03-04,110,1,18,117,135,22,49,71,206,10,39,ID - Moscow
13,1963-1964,1963-12-01,1964-04-22,144,20,17,216,233,89,277,366,599,26,126,ID - Moscow
14,1964-1965,1964-11-15,1965-04-02,139,3,33,216,249,112,233,345,594,34,187,ID - Moscow
15,1965-1966,1965-11-25,1966-03-21,117,3,22,168,190,82,105,187,377,24,138,ID - Moscow
16,1966-1967,1966-10-22,1967-04-29,190,3,4,140,144,62,17,79,223,29,98,ID - Moscow
17,1967-1968,1967-11-28,1968-02-29,94,3,33,149,182,49,82,131,313,21,123,ID - Moscow
18,1968-1969,1968-11-15,1969-03-19,125,1,72,314,386,166,772,938,1324,49,359,ID - Moscow
19,1969-1970,1969-12-01,1970-03-06,96,1,28,129,157,48,128,176,333,18,94,ID - Moscow
20,1970-1971,1970-11-18,1971-04-24,158,3,39,229,268,103,157,260,528,36,189,ID - Moscow
22,1972-1973,1972-10-28,1973-03-31,155,4,68,257,325,37,77,114,439,20,107,ID - Moscow
23,1973-1974,1973-10-31,1974-04-12,164,1,52,221,273,115,213,328,601,38,189,ID - Moscow
24,1974-1975,1974-11-25,1975-04-17,144,1,28,246,274,127,478,605,879,45,230,ID - Moscow
25,1975-1976,1975-10-27,1976-04-01,158,4,24,258,282,116,138,254,536,31,180,ID - Moscow
26,1976-1977,1976-11-26,1977-04-01,127,0,30,198,228,35,37,72,300,20,76,ID - Moscow
27,1977-1978,1977-11-09,1978-04-21,164,5,29,175,204,69,120,189,393,27,116,ID - Moscow
28,1978-1979,1978-11-10,1979-04-02,144,0,118,395,513,104,630,734,1247,47,252,ID - Moscow
29,1979-1980,1979-11-23,1980-03-30,129,4,41,202,243,49,154,203,446,15,90,ID - Moscow
30,1980-1981,1980-12-01,1981-04-03,124,1,16,111,127,30,28,58,185,11,61,ID - Moscow
31,1981-1982,1981-11-23,1982-04-06,135,17,53,200,253,110,290,400,653,40,213,ID - Moscow
32,1982-1983,1982-10-18,1983-02-28,134,11,27,146,173,30,59,89,262,15,62,ID - Moscow
33,1983-1984,1983-11-23,1984-05-06,166,3,70,232,302,46,94,140,442,29,131,ID - Moscow
34,1984-1985,1984-10-27,1985-03-30,155,9,82,337,419,122,575,697,1116,47,259,ID - Moscow
35,1985-1986,1985-11-11,1986-02-28,110,2,92,287,379,65,417,482,861,24,174,ID - Moscow
36,1986-1987,1986-11-07,1987-03-28,142,3,23,194,217,36,72,108,325,15,66,ID - Moscow
37,1987-1988,1987-11-16,1988-03-30,136,3,35,207,242,49,151,200,442,22,98,ID - Moscow
38,1988-1989,1988-11-14,1989-03-17,124,0,48,253,301,140,467,607,908,37,221,ID - Moscow
39,1989-1990,1989-12-01,1990-04-28,149,0,12,151,163,42,51,93,256,22,90,ID - Moscow
40,1990-1991,1990-11-21,1991-03-26,126,1,58,193,251,56,118,174,425,20,123,ID - Moscow
41,1991-1992,1991-10-27,1992-02-29,126,0,2,102,104,19,10,29,133,10,30,ID - Moscow
42,1992-1993,1992-11-09,1993-03-11,123,2,49,294,343,112,603,715,1058,39,236,ID - Moscow
43,1993-1994,1993-11-13,1994-04-04,143,3,18,169,187,34,28,62,249,15,60,ID - Moscow
44,1994-1995,1994-11-01,1995-03-05,125,1,29,177,206,68,100,168,374,27,133,ID - Moscow
45,1995-1996,1995-11-07,1996-04-20,166,1,39,214,253,107,184,291,544,26,170,ID - Moscow
46,1996-1997,1996-10-19,1997-04-03,167,3,20,196,216,141,155,296,512,40,210,ID - Moscow
47,1997-1998,1997-12-01,1998-03-05,95,1,12,120,132,42,111,153,285,20,78,ID - Moscow
48,1998-1999,1998-11-09,1999-05-08,181,6,23,177,200,77,49,126,326,29,117,ID - Moscow
49,1999-2000,1999-11-21,2000-05-11,173,2,10,151,161,84,110,194,355,28,122,ID - Moscow
50,2000-2001,2000-11-08,2001-04-08,152,3,30,249,279,68,384,452,731,29,119,ID - Moscow
51,2001-2002,2001-11-25,2002-05-08,165,3,25,216,241,127,292,419,660,45,209,ID - Moscow
52,2002-2003,2002-10-30,2003-05-18,201,1,6,156,162,46,19,65,227,21,68,ID - Moscow
53,2003-2004,2003-11-03,2004-03-05,124,1,23,179,202,88,257,345,547,33,167,ID - Moscow
54,2004-2005,2004-10-24,2005-03-29,157,2,13,179,192,30,62,92,284,15,60,ID - Moscow
55,2005-2006,2005-11-29,2006-04-15,138,3,29,179,208,37,112,149,357,16,68,ID - Moscow
56,2006-2007,2006-11-24,2007-04-10,138,1,40,205,245,51,140,191,436,24,113,ID - Moscow
57,2007-2008,2007-11-19,2008-04-09,143,1,33,238,271,129,419,548,819,42,214,ID - Moscow
58,2008-2009,2008-12-01,2009-04-02,123,3,40,239,279,150,249,399,678,41,272,ID - Moscow
59,2009-2010,2009-11-13,2010-05-06,175,8,27,172,199,40,25,65,264,17,69,ID - Moscow
60,2010-2011,2010-11-18,2011-04-07,141,2,39,213,252,123,293,416,668,37,214,ID - Moscow
61,2011-2012,2011-11-12,2012-04-04,145,0,8,190,198,89,116,205,403,32,140,ID - Moscow
62,2012-2013,2012-11-08,2013-03-22,135,0,21,178,199,63,111,174,373,26,106,ID - Moscow
63,2013-2014,2013-11-04,2014-02-28,117,0,49,218,267,60,89,149,416,21,111,ID - Moscow
64,2014-2015,2014-11-12,2015-04-14,154,0,20,152,172,22,23,45,217,11,32,ID - Moscow
65,2015-2016,2015-11-05,2016-04-04,152,0,23,163,186,56,163,219,405,22,93,ID - Moscow
66,2016-2017,2016-11-28,2017-04-15,139,0,66,297,363,118,484,602,965,40,236,ID - Moscow
67,2017-2018,2017-11-05,2018-04-02,149,0,29,230,259,63,141,204,463,22,126,ID - Moscow
68,2018-2019,2018-11-24,2019-03-22,119,0,31,278,309,118,329,447,756,38,230,ID - Moscow
69,2019-2020,2019-10-09,2020-04-01,176,0,16,272,288,70,90,160,448,26,132,ID - Moscow
0,1950-1951,1950-11-09,1951-04-30,173,0,36,302,338,40,65,105,443,27,104,ID - Pocatello
1,1951-1952,1951-10-21,1952-04-15,178,0,98,511,609,85,294,379,988,44,247,ID - Pocatello
2,1952-1953,1952-11-14,1953-05-21,189,0,37,310,347,63,115,178,525,36,125,ID - Pocatello
3,1953-1954,1953-10-21,1954-04-30,192,0,18,299,317,48,47,95,412,26,95,ID - Pocatello
4,1954-1955,1954-10-24,1955-05-31,220,0,100,561,661,87,282,369,1030,45,243,ID - Pocatello
5,1955-1956,1955-11-12,1956-04-02,143,0,77,371,448,67,159,226,674,40,203,ID - Pocatello
6,1956-1957,1956-10-24,1957-04-06,165,0,61,430,491,42,103,145,636,27,151,ID - Pocatello
7,1957-1958,1957-11-01,1958-04-22,173,0,22,343,365,57,56,113,478,43,139,ID - Pocatello
8,1958-1959,1958-11-15,1959-04-19,156,0,31,261,292,39,61,100,392,22,97,ID - Pocatello
9,1959-1960,1959-11-13,1960-04-24,164,0,81,466,547,58,165,223,770,37,243,ID - Pocatello
10,1960-1961,1960-11-14,1961-05-05,173,0,21,330,351,36,31,67,418,25,74,ID - Pocatello
11,1961-1962,1961-10-21,1962-04-08,170,0,93,455,548,95,170,265,813,39,255,ID - Pocatello
12,1962-1963,1962-11-16,1963-04-22,158,0,50,345,395,50,45,95,490,26,142,ID - Pocatello
13,1963-1964,1963-11-21,1964-05-01,163,0,100,544,644,93,544,637,1281,54,288,ID - Pocatello
14,1964-1965,1964-11-10,1965-05-07,179,0,31,356,387,45,46,91,478,37,128,ID - Pocatello
15,1965-1966,1965-09-16,1966-04-26,223,0,40,437,477,56,104,160,637,37,165,ID - Pocatello
16,1966-1967,1966-10-13,1967-05-02,202,0,32,361,393,59,38,97,490,35,134,ID - Pocatello
17,1967-1968,1967-11-21,1968-04-26,158,0,64,436,500,59,147,206,706,34,192,ID - Pocatello
18,1968-1969,1968-11-15,1969-03-19,125,0,56,376,432,80,158,238,670,46,239,ID - Pocatello
19,1969-1970,1969-12-01,1970-04-30,151,0,35,239,274,50,52,102,376,33,105,ID - Pocatello
20,1970-1971,1970-10-22,1971-04-26,187,0,63,385,448,67,86,153,601,41,194,ID - Pocatello
21,1971-1972,1971-10-01,1972-04-13,196,0,84,413,497,93,137,230,727,46,230,ID - Pocatello
22,1972-1973,1972-10-28,1973-04-20,175,0,116,466,582,84,161,245,827,48,285,ID - Pocatello
23,1973-1974,1973-10-29,1974-04-20,174,0,64,327,391,83,93,176,567,48,233,ID - Pocatello
24,1974-1975,1974-10-21,1975-05-20,212,0,70,389,459,101,81,182,641,67,275,ID - Pocatello
25,1975-1976,1975-10-07,1976-04-29,206,0,42,356,398,94,79,173,571,46,203,ID - Pocatello
26,1976-1977,1976-11-25,1977-05-16,173,0,66,427,493,41,87,128,621,29,139,ID - Pocatello
27,1977-1978,1977-10-30,1978-05-05,188,0,24,211,235,48,22,70,305,36,108,ID - Pocatello
28,1978-1979,1978-11-09,1979-05-29,202,0,152,518,670,86,164,250,920,58,373,ID - Pocatello
29,1979-1980,1979-10-28,1980-04-10,166,0,62,343,405,59,72,131,536,33,143,ID - Pocatello
30,1980-1981,1980-10-15,1981-06-14,243,0,32,348,380,52,55,107,487,31,113,ID - Pocatello
31,1981-1982,1981-10-12,1982-05-09,210,0,92,429,521,105,309,414,935,57,311,ID - Pocatello
32,1982-1983,1982-10-18,1983-05-15,210,0,42,316,358,97,80,177,535,54,190,ID - Pocatello
33,1983-1984,1983-09-19,1984-05-06,231,0,134,529,663,137,498,635,1298,74,432,ID - Pocatello
34,1984-1985,1984-10-14,1985-04-22,191,0,145,621,766,94,348,442,1208,59,384,ID - Pocatello
35,1985-1986,1985-10-07,1986-05-08,214,0,128,489,617,102,338,440,1057,49,279,ID - Pocatello
36,1986-1987,1986-11-06,1987-04-19,165,0,49,402,451,55,104,159,610,38,166,ID - Pocatello
37,1987-1988,1987-11-14,1988-05-01,170,0,58,400,458,57,93,150,608,42,182,ID - Pocatello
38,1988-1989,1988-11-10,1989-05-12,184,0,130,448,578,94,254,348,926,61,363,ID - Pocatello
39,1989-1990,1989-10-27,1990-05-08,194,0,24,364,388,62,33,95,483,34,142,ID - Pocatello
40,1990-1991,1990-10-16,1991-05-10,207,0,95,474,569,82,184,266,835,48,285,ID - Pocatello
41,1991-1992,1991-10-27,1992-04-22,179,0,25,365,390,36,52,88,478,26,89,ID - Pocatello
42,1992-1993,1992-10-30,1993-05-08,191,0,117,528,645,145,540,685,1330,72,441,ID - Pocatello
43,1993-1994,1993-11-04,1994-04-26,174,0,37,398,435,56,124,180,615,39,155,ID - Pocatello
44,1994-1995,1994-11-03,1995-06-05,215,0,41,334,375,60,112,172,547,42,161,ID - Pocatello
45,1995-1996,1995-10-21,1996-04-27,190,3,37,299,336,52,108,160,496,33,126,ID - Pocatello
46,1996-1997,1996-10-25,1997-04-01,159,0,32,291,323,71,61,132,455,41,164,ID - Pocatello
47,1997-1998,1997-10-11,1998-03-29,170,0,37,311,348,60,62,122,470,35,127,ID - Pocatello
48,1998-1999,1998-11-09,1999-05-15,188,0,57,328,385,52,73,125,510,27,121,ID - Pocatello
49,1999-2000,1999-12-01,2000-03-29,120,0,22,228,250,42,40,82,332,29,111,ID - Pocatello
50,2000-2001,2000-10-29,2001-04-20,174,0,86,511,597,58,194,252,849,37,160,ID - Pocatello
51,2001-2002,2001-11-24,2002-04-19,147,0,116,443,559,80,176,256,815,37,218,ID - Pocatello
52,2002-2003,2002-10-29,2003-04-26,180,0,32,314,346,33,39,72,418,24,85,ID - Pocatello
53,2003-2004,2003-11-13,2004-04-28,168,0,71,341,412,106,316,422,834,45,265,ID - Pocatello
54,2004-2005,2004-10-31,2005-04-27,179,0,50,346,396,66,135,201,597,35,153,ID - Pocatello
55,2005-2006,2005-11-26,2006-04-18,144,0,60,321,381,62,53,115,496,38,171,ID - Pocatello
56,2006-2007,2006-10-25,2007-04-19,177,0,64,418,482,40,50,90,572,26,130,ID - Pocatello
57,2007-2008,2007-09-29,2008-05-01,216,0,74,466,540,69,77,146,686,45,196,ID - Pocatello
58,2008-2009,2008-10-11,2009-04-16,188,0,54,426,480,84,158,242,722,41,218,ID - Pocatello
59,2009-2010,2009-10-05,2010-05-06,214,0,50,447,497,53,41,94,591,37,138,ID - Pocatello
60,2010-2011,2010-11-08,2011-05-26,200,0,83,382,465,87,177,264,729,46,215,ID - Pocatello
61,2011-2012,2011-11-04,2012-04-06,155,0,23,372,395,27,28,55,450,20,62,ID - Pocatello
62,2012-2013,2012-10-24,2013-04-22,181,0,83,412,495,61,147,208,703,38,194,ID - Pocatello
63,2013-2014,2013-11-16,2014-04-02,138,0,54,337,391,49,62,111,502,26,163,ID - Pocatello
64,2014-2015,2014-11-11,2015-04-15,156,0,42,276,318,33,41,74,392,17,85,ID - Pocatello
65,2015-2016,2015-11-16,2016-03-30,136,0,67,329,396,54,120,174,570,31,156,ID - Pocatello
66,2016-2017,2016-11-28,2017-04-28,152,0,99,385,484,134,371,505,989,49,332,ID - Pocatello
67,2017-2018,2017-10-14,2018-03-26,164,0,32,282,314,50,84,134,448,31,130,ID - Pocatello
68,2018-2019,2018-11-17,2019-04-10,145,0,57,362,419,69,126,195,614,43,183,ID - Pocatello
69,2019-2020,2019-10-09,2020-04-16,191,0,30,413,443,61,110,171,614,37,155,ID - Pocatello
0,1950-1951,1950-11-11,1951-04-02,143,2,43,329,372,183,959,1142,1514,52,313,ID - Priest River
1,1951-1952,1951-10-16,1952-04-09,177,8,79,417,496,205,1272,1477,1973,63,396,ID - Priest River
2,1952-1953,1952-11-25,1953-04-14,141,0,20,223,243,94,461,555,798,41,157,ID - Priest River
3,1953-1954,1953-11-16,1954-04-03,139,1,38,282,320,143,919,1062,1382,37,255,ID - Priest River
4,1954-1955,1954-12-01,1955-05-13,164,3,58,364,422,143,934,1077,1499,55,269,ID - Priest River
5,1955-1956,1955-10-27,1956-04-08,165,2,105,431,536,195,1390,1585,2121,73,424,ID - Priest River
6,1956-1957,1956-10-24,1957-03-30,158,1,112,432,544,136,917,1053,1597,51,325,ID - Priest River
7,1957-1958,1957-10-22,1958-03-20,150,2,16,223,239,91,682,773,1012,42,154,ID - Priest River
8,1958-1959,1958-11-04,1959-04-01,149,0,52,314,366,156,1052,1208,1574,51,282,ID - Priest River
9,1959-1960,1959-11-11,1960-04-15,157,5,90,389,479,113,970,1083,1562,51,258,ID - Priest River
10,1960-1961,1960-11-10,1961-03-17,128,5,39,219,258,79,429,508,766,26,124,ID - Priest River
11,1961-1962,1961-10-23,1962-04-02,162,0,92,426,518,148,1129,1277,1795,41,294,ID - Priest River
12,1962-1963,1962-11-22,1963-02-28,99,0,60,223,283,37,116,153,436,13,80,ID - Priest River
13,1963-1964,1963-11-06,1964-04-08,155,5,44,297,341,143,1081,1224,1565,58,255,ID - Priest River
14,1964-1965,1964-11-02,1965-04-05,155,3,69,354,423,156,1091,1247,1670,47,299,ID - Priest River
15,1965-1966,1965-11-23,1966-03-30,128,4,38,231,269,150,971,1121,1390,37,223,ID - Priest River
17,1967-1968,1967-11-26,1968-04-12,139,0,57,302,359,109,726,835,1194,28,193,ID - Priest River
18,1968-1969,1968-11-08,1969-04-04,148,0,108,402,510,233,1286,1519,2029,57,450,ID - Priest River
19,1969-1970,1969-11-16,1970-04-01,137,1,56,282,338,123,901,1024,1362,31,203,ID - Priest River
20,1970-1971,1970-11-21,1971-04-04,135,0,64,307,371,150,1067,1217,1588,48,265,ID - Priest River
21,1971-1972,1971-09-29,1972-03-13,167,4,89,364,453,147,858,1005,1458,40,288,ID - Priest River
22,1972-1973,1972-10-28,1973-03-09,133,1,99,300,399,72,436,508,907,26,149,ID - Priest River
23,1973-1974,1973-11-03,1974-03-27,145,0,73,255,328,154,786,940,1268,40,243,ID - Priest River
24,1974-1975,1974-11-23,1975-04-18,147,0,55,281,336,160,1077,1237,1573,47,272,ID - Priest River
25,1975-1976,1975-10-25,1976-04-04,163,0,71,317,388,140,781,921,1309,43,233,ID - Priest River
26,1976-1977,1976-11-15,1977-03-06,112,2,65,222,287,42,433,475,762,15,83,ID - Priest River
27,1977-1978,1977-11-09,1978-03-24,136,0,59,227,286,142,996,1138,1424,38,223,ID - Priest River
28,1978-1979,1978-11-10,1979-03-28,139,2,163,457,620,111,1027,1138,1758,39,247,ID - Priest River
29,1979-1980,1979-10-19,1980-03-30,164,3,67,291,358,103,698,801,1159,30,180,ID - Priest River
30,1980-1981,1980-11-15,1981-02-28,106,0,45,158,203,54,175,229,432,17,89,ID - Priest River
31,1981-1982,1981-11-28,1982-04-03,127,5,79,260,339,119,680,799,1138,31,237,ID - Priest River
32,1982-1983,1982-11-12,1983-03-05,114,2,55,169,224,86,587,673,897,22,123,ID - Priest River
33,1983-1984,1983-11-22,1984-03-25,125,2,102,288,390,86,893,979,1369,25,154,ID - Priest River
34,1984-1985,1984-10-23,1985-04-08,168,4,146,431,577,160,1235,1395,1972,34,301,ID - Priest River
35,1985-1986,1985-11-09,1986-03-21,133,1,127,349,476,90,963,1053,1529,22,177,ID - Priest River
36,1986-1987,1986-11-09,1987-03-19,131,3,49,206,255,44,570,614,869,16,73,ID - Priest River
37,1987-1988,1987-11-15,1988-03-29,136,1,73,288,361,77,577,654,1015,42,211,ID - Priest River
38,1988-1989,1988-11-08,1989-04-04,148,2,107,356,463,129,916,1045,1508,43,265,ID - Priest River
39,1989-1990,1989-11-15,1990-03-28,134,7,48,214,262,134,604,738,1000,32,209,ID - Priest River
40,1990-1991,1990-11-03,1991-03-27,145,18,95,300,395,83,644,727,1122,22,165,ID - Priest River
41,1991-1992,1991-10-30,1992-02-29,123,1,22,164,186,49,345,394,580,23,86,ID - Priest River
42,1992-1993,1992-11-09,1993-03-29,141,5,111,397,508,139,1060,1199,1707,38,283,ID - Priest River
43,1993-1994,1993-11-14,1994-03-22,129,3,53,257,310,79,834,913,1223,34,141,ID - Priest River
44,1994-1995,1994-11-01,1995-03-11,131,3,67,281,348,105,756,861,1209,39,198,ID - Priest River
45,1995-1996,1995-11-07,1996-03-13,128,4,77,307,384,69,337,406,790,33,173,ID - Priest River
46,1996-1997,1996-11-06,1997-04-18,164,5,86,375,461,234,1963,2197,2658,62,405,ID - Priest River
47,1997-1998,1997-11-15,1998-03-15,121,3,42,201,243,69,476,545,788,31,128,ID - Priest River
48,1998-1999,1998-12-01,1999-03-30,120,9,38,216,254,93,645,738,992,40,168,ID - Priest River
49,1999-2000,1999-11-23,2000-04-14,144,14,30,248,278,102,845,947,1225,37,179,ID - Priest River
50,2000-2001,2000-11-08,2001-04-03,147,16,61,345,406,94,856,950,1356,44,212,ID - Priest River
51,2001-2002,2001-11-28,2002-03-30,123,6,37,252,289,124,953,1077,1366,44,233,ID - Priest River
52,2002-2003,2002-11-25,2003-03-26,122,5,23,188,211,62,395,457,668,19,87,ID - Priest River
53,2003-2004,2003-10-31,2004-03-21,143,5,52,323,375,113,903,1016,1391,43,250,ID - Priest River
54,2004-2005,2004-11-27,2005-03-20,114,12,37,265,302,64,413,477,779,26,135,ID - Priest River
55,2005-2006,2005-11-06,2006-03-22,137,7,49,291,340,65,435,500,840,33,130,ID - Priest River
56,2006-2007,2006-11-23,2007-03-18,116,4,58,262,320,112,831,943,1263,41,222,ID - Priest River
57,2007-2008,2007-11-21,2008-04-17,149,3,66,342,408,193,1402,1595,2003,56,347,ID - Priest River
58,2008-2009,2008-11-06,2009-04-13,159,4,73,378,451,147,1064,1211,1662,42,308,ID - Priest River
60,2010-2011,2010-11-19,2011-04-02,135,3,64,365,429,130,1002,1132,1561,46,280,ID - Priest River
61,2011-2012,2011-11-14,2012-04-09,148,0,42,276,318,115,918,1033,1351,40,205,ID - Priest River
62,2012-2013,2012-11-09,2013-03-27,139,0,29,234,263,103,833,936,1199,41,172,ID - Priest River
63,2013-2014,2013-11-16,2014-03-22,127,0,62,313,375,85,582,667,1042,40,188,ID - Priest River
64,2014-2015,2014-11-12,2015-04-06,146,3,32,245,277,50,275,325,602,21,86,ID - Priest River
65,2015-2016,2015-11-24,2016-03-02,100,0,26,151,177,77,497,574,751,32,123,ID - Priest River
66,2016-2017,2016-11-19,2017-03-28,130,0,73,323,396,88,855,943,1339,43,210,ID - Priest River
67,2017-2018,2017-11-02,2018-04-03,153,0,47,277,324,145,910,1055,1379,49,248,ID - Priest River
68,2018-2019,2018-11-09,2019-04-01,144,0,59,321,380,122,862,984,1364,42,249,ID - Priest River
69,2019-2020,2019-11-12,2020-03-31,141,7,37,237,274,97,768,865,1139,33,176,ID - Priest River
0,1950-1951,1950-11-09,1951-03-23,135,2,60,392,452,69,407,476,928,21,138,ID - Richfield
1,1951-1952,1951-11-26,1952-04-05,132,4,126,539,665,123,988,1111,1776,32,245,ID - Richfield
2,1952-1953,1952-11-17,1953-03-05,109,3,31,266,297,47,219,266,563,15,87,ID - Richfield
3,1953-1954,1953-12-01,1954-03-11,101,2,21,249,270,27,79,106,376,6,40,ID - Richfield
4,1954-1955,1954-12-01,1955-03-21,111,0,92,459,551,35,369,404,955,16,92,ID - Richfield
5,1955-1956,1955-11-12,1956-03-18,128,4,87,398,485,102,358,460,945,30,199,ID - Richfield
6,1956-1957,1956-11-03,1957-02-28,118,1,62,408,470,34,234,268,738,12,76,ID - Richfield
7,1957-1958,1957-11-19,1958-03-07,109,1,28,291,319,40,252,292,611,13,78,ID - Richfield
8,1958-1959,1958-11-16,1959-02-28,105,1,24,239,263,34,104,138,401,9,54,ID - Richfield
9,1959-1960,1959-12-01,1960-04-22,144,3,77,434,511,41,284,325,836,15,85,ID - Richfield
10,1960-1961,1960-11-28,1961-03-07,100,0,17,261,278,18,29,47,325,4,24,ID - Richfield
11,1961-1962,1961-11-21,1962-03-18,118,2,88,418,506,54,313,367,873,13,114,ID - Richfield
12,1962-1963,1962-11-18,1963-02-28,103,1,43,267,310,11,17,28,338,4,23,ID - Richfield
13,1963-1964,1963-11-22,1964-04-03,134,1,115,583,698,87,965,1052,1750,27,204,ID - Richfield
14,1964-1965,1964-11-12,1965-03-18,127,0,40,324,364,44,147,191,555,17,98,ID - Richfield
15,1965-1966,1965-11-27,1966-03-21,115,3,45,343,388,25,213,238,626,12,56,ID - Richfield
16,1966-1967,1966-12-01,1967-02-28,90,1,28,217,245,14,40,54,299,7,43,ID - Richfield
17,1967-1968,1967-11-27,1968-02-29,95,0,75,368,443,50,506,556,999,12,96,ID - Richfield
18,1968-1969,1968-11-15,1969-04-02,139,0,76,455,531,99,797,896,1427,28,212,ID - Richfield
19,1969-1970,1969-12-01,1970-03-29,119,0,42,271,313,30,141,171,484,11,60,ID - Richfield
20,1970-1971,1970-12-01,1971-03-19,109,0,58,333,391,37,183,220,611,14,78,ID - Richfield
21,1971-1972,1971-10-29,1972-03-04,128,0,83,411,494,66,568,634,1128,21,132,ID - Richfield
22,1972-1973,1972-11-22,1973-03-04,103,0,99,370,469,37,298,335,804,17,96,ID - Richfield
23,1973-1974,1973-11-05,1974-03-18,134,1,65,383,448,72,504,576,1024,23,135,ID - Richfield
24,1974-1975,1974-12-01,1975-05-20,171,1,69,418,487,70,442,512,999,24,147,ID - Richfield
25,1975-1976,1975-11-18,1976-03-30,134,0,54,427,481,67,531,598,1079,19,127,ID - Richfield
26,1976-1977,1976-11-27,1977-03-30,124,1,41,422,463,12,114,126,589,4,21,ID - Richfield
27,1977-1978,1977-11-19,1978-05-05,168,15,27,322,349,78,419,497,846,14,113,ID - Richfield
28,1978-1979,1978-11-10,1979-03-13,124,1,114,466,580,38,351,389,969,16,109,ID - Richfield
29,1979-1980,1979-11-23,1980-02-29,99,3,46,284,330,48,314,362,692,10,70,ID - Richfield
30,1980-1981,1980-11-24,1981-02-28,97,4,17,234,251,22,112,134,385,3,26,ID - Richfield
32,1982-1983,1982-11-21,1983-05-11,172,8,36,336,372,37,309,346,718,13,65,ID - Richfield
33,1983-1984,1983-11-22,1984-03-31,131,8,118,516,634,73,924,997,1631,21,161,ID - Richfield
35,1985-1986,1985-11-09,1986-03-16,128,16,120,456,576,76,714,790,1366,27,194,ID - Richfield
38,1988-1989,1988-11-10,1989-03-06,117,4,132,499,631,61,553,614,1245,15,120,ID - Richfield
39,1989-1990,1989-11-17,1990-03-11,115,2,41,323,364,28,106,134,498,11,61,ID - Richfield
47,1997-1998,1997-12-01,1998-03-29,119,14,31,268,299,24,63,87,386,8,40,ID - Richfield
48,1998-1999,1998-12-01,1999-03-20,110,16,61,361,422,64,379,443,865,16,115,ID - Richfield
52,2002-2003,2002-10-31,2003-02-28,121,17,19,255,274,23,98,121,395,6,36,ID - Richfield
58,2008-2009,2008-10-11,2009-04-02,174,10,86,537,623,68,637,705,1328,14,143,ID - Richfield
59,2009-2010,2009-10-05,2010-04-05,183,12,72,495,567,62,481,543,1110,20,132,ID - Richfield
62,2012-2013,2012-11-14,2013-03-08,115,0,83,373,456,28,213,241,697,11,73,ID - Richfield
63,2013-2014,2013-12-01,2014-02-28,90,0,56,288,344,31,64,95,439,9,71,ID - Richfield
64,2014-2015,2014-11-12,2015-02-28,109,1,51,265,316,32,165,197,513,7,54,ID - Richfield
65,2015-2016,2015-11-27,2016-02-29,95,9,82,353,435,45,451,496,931,12,84,ID - Richfield
66,2016-2017,2016-12-01,2017-03-21,111,4,112,418,530,104,754,858,1388,25,223,ID - Richfield
67,2017-2018,2017-12-01,2018-03-18,108,15,31,291,322,25,97,122,444,7,59,ID - Richfield
68,2018-2019,2018-11-28,2019-03-15,108,2,42,327,369,42,207,249,618,12,85,ID - Richfield
69,2019-2020,2019-10-29,2020-02-29,124,0,38,348,386,52,253,305,691,17,108,ID - Richfield
0,1950-1951,1950-11-10,1951-04-01,143,0,124,480,604,65,359,424,1028,41,298,IL - Aurora
1,1951-1952,1951-11-02,1952-04-04,155,4,71,422,493,90,310,400,893,29,202,IL - Aurora
2,1952-1953,1952-11-27,1953-04-19,144,1,35,295,330,45,66,111,441,23,142,IL - Aurora
3,1953-1954,1953-11-25,1954-04-04,131,0,44,330,374,50,80,130,504,27,127,IL - Aurora
4,1954-1955,1954-11-01,1955-03-27,147,4,60,357,417,52,128,180,597,31,179,IL - Aurora
5,1955-1956,1955-11-02,1956-03-17,137,0,55,347,402,40,35,75,477,29,119,IL - Aurora
6,1956-1957,1956-11-22,1957-04-11,141,0,71,346,417,55,127,182,599,36,203,IL - Aurora
7,1957-1958,1957-11-22,1958-03-21,120,0,89,353,442,43,257,300,742,24,103,IL - Aurora
8,1958-1959,1958-11-27,1959-04-20,145,0,128,458,586,77,276,353,939,38,269,IL - Aurora
9,1959-1960,1959-10-26,1960-05-09,197,0,88,426,514,69,229,298,812,33,184,IL - Aurora
11,1961-1962,1961-11-19,1962-03-17,119,3,118,429,547,57,454,511,1058,34,206,IL - Aurora
12,1962-1963,1962-10-25,1963-03-13,140,1,160,497,657,46,188,234,891,30,236,IL - Aurora
13,1963-1964,1963-12-01,1964-03-30,121,3,87,382,469,29,168,197,666,13,76,IL - Aurora
14,1964-1965,1964-11-19,1965-03-29,131,0,110,423,533,79,196,275,808,32,231,IL - Aurora
15,1965-1966,1965-11-28,1966-04-05,129,0,96,352,448,29,106,135,583,21,108,IL - Aurora
16,1966-1967,1966-12-01,1967-04-23,144,4,86,356,442,76,320,396,838,30,210,IL - Aurora
17,1967-1968,1967-10-26,1968-03-21,148,1,82,384,466,36,75,111,577,25,122,IL - Aurora
18,1968-1969,1968-11-19,1969-03-31,133,0,86,348,434,25,113,138,572,17,90,IL - Aurora
19,1969-1970,1969-11-13,1970-04-02,141,0,123,421,544,77,249,326,870,36,235,IL - Aurora
20,1970-1971,1970-11-23,1971-04-03,132,2,98,360,458,40,130,170,628,24,120,IL - Aurora
22,1972-1973,1972-10-18,1973-04-12,177,1,56,318,374,38,92,130,504,24,109,IL - Aurora
23,1973-1974,1973-12-01,1974-03-30,120,0,68,279,347,65,250,315,662,27,172,IL - Aurora
24,1974-1975,1974-11-13,1975-04-03,142,17,33,278,311,65,151,216,527,35,145,IL - Aurora
26,1976-1977,1976-11-22,1977-03-22,121,9,171,533,704,37,185,222,926,22,179,IL - Aurora
27,1977-1978,1977-11-25,1978-03-28,124,3,152,514,666,67,390,457,1123,30,254,IL - Aurora
28,1978-1979,1978-11-20,1979-03-25,126,5,161,521,682,88,769,857,1539,29,250,IL - Aurora
31,1981-1982,1981-11-20,1982-04-09,141,18,126,514,640,62,298,360,1000,31,284,IL - Aurora
32,1982-1983,1982-11-04,1983-03-25,142,9,32,241,273,9,43,52,325,6,30,IL - Aurora
33,1983-1984,1983-11-24,1984-03-22,120,0,144,437,581,55,317,372,953,32,235,IL - Aurora
35,1985-1986,1985-11-20,1986-03-20,121,5,107,429,536,39,133,172,708,22,160,IL - Aurora
37,1987-1988,1987-12-01,1988-03-18,109,1,84,336,420,53,210,263,683,18,136,IL - Aurora
38,1988-1989,1988-11-06,1989-03-18,133,3,62,357,419,52,162,214,633,21,145,IL - Aurora
39,1989-1990,1989-11-18,1990-03-19,122,4,68,321,389,40,138,178,567,15,121,IL - Aurora
40,1990-1991,1990-12-01,1991-03-14,104,8,65,338,403,32,110,142,545,13,94,IL - Aurora
41,1991-1992,1991-11-02,1992-03-22,142,16,36,257,293,23,41,64,357,9,59,IL - Aurora
43,1993-1994,1993-11-06,1994-03-05,120,9,120,427,547,50,162,212,759,22,194,IL - Aurora
44,1994-1995,1994-12-01,1995-03-09,99,9,63,331,394,23,90,113,507,8,60,IL - Aurora
46,1996-1997,1996-11-10,1997-03-15,126,18,92,367,459,61,117,178,637,21,175,IL - Aurora
47,1997-1998,1997-10-27,1998-03-16,141,4,31,248,279,46,180,226,505,19,91,IL - Aurora
48,1998-1999,1998-12-01,1999-03-16,106,7,53,310,363,58,186,244,607,17,166,IL - Aurora
49,1999-2000,1999-12-01,2000-04-08,130,6,48,292,340,40,144,184,524,11,89,IL - Aurora
50,2000-2001,2000-11-20,2001-03-25,126,9,88,479,567,60,300,360,927,21,182,IL - Aurora
51,2001-2002,2001-12-01,2002-03-26,116,4,28,192,220,39,99,138,358,12,69,IL - Aurora
53,2003-2004,2003-11-28,2004-03-17,111,7,76,260,336,27,117,144,480,14,84,IL - Aurora
54,2004-2005,2004-11-25,2005-03-17,113,2,66,239,305,41,79,120,425,14,93,IL - Aurora
55,2005-2006,2005-11-17,2006-03-25,129,1,57,261,318,27,85,112,430,13,72,IL - Aurora
56,2006-2007,2006-12-01,2007-04-11,132,2,102,299,401,41,142,183,584,16,114,IL - Aurora
57,2007-2008,2007-12-01,2008-03-22,113,3,92,328,420,68,191,259,679,19,141,IL - Aurora
58,2008-2009,2008-11-21,2009-04-06,137,8,125,406,531,85,298,383,914,26,235,IL - Aurora
59,2009-2010,2009-12-01,2010-02-28,90,2,85,271,356,61,228,289,645,19,134,IL - Aurora
60,2010-2011,2010-12-01,2011-03-06,96,14,109,315,424,64,231,295,719,21,147,IL - Aurora
61,2011-2012,2011-12-01,2012-03-05,96,0,31,175,206,33,36,69,275,10,66,IL - Aurora
62,2012-2013,2012-11-25,2013-03-21,117,2,64,274,338,32,56,88,426,12,69,IL - Aurora
63,2013-2014,2013-11-12,2014-04-15,155,5,197,572,769,110,429,539,1308,37,315,IL - Aurora
64,2014-2015,2014-11-13,2015-03-24,132,3,136,421,557,56,214,270,827,16,145,IL - Aurora
65,2015-2016,2015-11-21,2016-03-05,106,4,56,210,266,35,33,68,334,18,105,IL - Aurora
66,2016-2017,2016-12-01,2017-03-16,106,0,67,237,304,28,86,114,418,9,61,IL - Aurora
67,2017-2018,2017-12-01,2018-04-19,140,0,111,361,472,57,148,205,677,19,163,IL - Aurora
69,2019-2020,2019-10-30,2020-04-18,172,3,50,279,329,51,56,107,436,23,100,IL - Aurora
0,1950-1951,1950-11-10,1951-04-12,154,2,93,354,447,62,163,225,672,33,207,IL - Bloomington-Normal
1,1951-1952,1951-11-03,1952-03-06,125,13,51,262,313,44,114,158,471,15,90,IL - Bloomington-Normal
2,1952-1953,1952-11-27,1953-04-17,142,10,21,191,212,23,37,60,272,12,66,IL - Bloomington-Normal
3,1953-1954,1953-11-27,1954-03-14,108,0,29,205,234,22,36,58,292,9,39,IL - Bloomington-Normal
4,1954-1955,1954-11-01,1955-03-28,148,13,33,260,293,39,96,135,428,19,106,IL - Bloomington-Normal
5,1955-1956,1955-11-03,1956-03-16,135,8,36,287,323,44,25,69,392,22,120,IL - Bloomington-Normal
6,1956-1957,1956-11-21,1957-04-12,143,5,42,290,332,52,120,172,504,25,161,IL - Bloomington-Normal
7,1957-1958,1957-11-21,1958-03-11,111,1,55,238,293,26,53,79,372,16,65,IL - Bloomington-Normal
9,1959-1960,1959-11-12,1960-03-26,136,0,67,312,379,78,226,304,683,24,157,IL - Bloomington-Normal
10,1960-1961,1960-11-09,1961-04-17,160,0,56,265,321,36,89,125,446,17,101,IL - Bloomington-Normal
11,1961-1962,1961-11-19,1962-04-13,146,0,86,330,416,70,188,258,674,33,190,IL - Bloomington-Normal
12,1962-1963,1962-12-01,1963-03-06,96,0,120,358,478,46,128,174,652,28,221,IL - Bloomington-Normal
13,1963-1964,1963-11-30,1964-03-29,121,10,74,299,373,62,92,154,527,27,138,IL - Bloomington-Normal
14,1964-1965,1964-11-19,1965-03-27,129,6,82,320,402,56,118,174,576,23,144,IL - Bloomington-Normal
15,1965-1966,1965-11-29,1966-03-24,116,3,55,231,286,14,6,20,306,8,38,IL - Bloomington-Normal
16,1966-1967,1966-12-01,1967-04-24,145,4,48,263,311,31,95,126,437,16,79,IL - Bloomington-Normal
17,1967-1968,1967-10-27,1968-03-22,148,8,63,337,400,38,69,107,507,23,121,IL - Bloomington-Normal
18,1968-1969,1968-11-11,1969-03-31,141,0,61,324,385,27,64,91,476,15,70,IL - Bloomington-Normal
19,1969-1970,1969-11-14,1970-04-02,140,2,88,371,459,52,132,184,643,30,158,IL - Bloomington-Normal
20,1970-1971,1970-11-23,1971-03-20,118,1,68,289,357,17,8,25,382,6,37,IL - Bloomington-Normal
21,1971-1972,1971-11-09,1972-04-02,146,1,59,292,351,36,80,116,467,19,117,IL - Bloomington-Normal
22,1972-1973,1972-11-19,1973-04-10,143,2,56,241,297,27,45,72,369,18,74,IL - Bloomington-Normal
23,1973-1974,1973-12-01,1974-04-05,126,1,69,267,336,50,137,187,523,24,140,IL - Bloomington-Normal
24,1974-1975,1974-11-13,1975-04-03,142,0,42,258,300,48,54,102,402,24,119,IL - Bloomington-Normal
25,1975-1976,1975-11-21,1976-02-29,101,1,47,223,270,36,55,91,361,19,92,IL - Bloomington-Normal
26,1976-1977,1976-11-22,1977-04-06,136,1,127,435,562,45,198,243,805,25,193,IL - Bloomington-Normal
27,1977-1978,1977-11-25,1978-03-27,123,1,136,475,611,66,333,399,1010,34,223,IL - Bloomington-Normal
28,1978-1979,1978-11-21,1979-03-25,125,0,128,419,547,51,415,466,1013,21,170,IL - Bloomington-Normal
29,1979-1980,1979-11-26,1980-04-15,142,0,62,289,351,30,45,75,426,20,105,IL - Bloomington-Normal
30,1980-1981,1980-11-27,1981-03-19,113,0,55,280,335,36,109,145,480,13,79,IL - Bloomington-Normal
31,1981-1982,1981-11-21,1982-04-10,141,2,105,394,499,71,293,364,863,29,217,IL - Bloomington-Normal
32,1982-1983,1982-11-04,1983-03-25,142,10,29,195,224,23,46,69,293,13,57,IL - Bloomington-Normal
33,1983-1984,1983-11-13,1984-03-18,127,0,113,348,461,50,202,252,713,26,161,IL - Bloomington-Normal
34,1984-1985,1984-12-01,1985-02-28,90,2,67,282,349,25,130,155,504,17,97,IL - Bloomington-Normal
35,1985-1986,1985-12-01,1986-03-03,93,5,65,282,347,30,103,133,480,13,81,IL - Bloomington-Normal
36,1986-1987,1986-11-12,1987-02-28,109,2,29,197,226,27,94,121,347,8,52,IL - Bloomington-Normal
37,1987-1988,1987-12-01,1988-03-18,109,2,60,284,344,21,59,80,424,9,57,IL - Bloomington-Normal
38,1988-1989,1988-11-28,1989-04-08,132,15,60,299,359,29,96,125,484,13,79,IL - Bloomington-Normal
39,1989-1990,1989-10-20,1990-02-28,132,2,60,286,346,20,74,94,440,11,91,IL - Bloomington-Normal
40,1990-1991,1990-12-01,1991-03-14,104,2,71,291,362,22,52,74,436,14,115,IL - Bloomington-Normal
41,1991-1992,1991-11-02,1992-03-15,135,5,32,271,303,22,48,70,373,13,86,IL - Bloomington-Normal
42,1992-1993,1992-11-27,1993-03-19,113,11,56,347,403,38,113,151,554,16,103,IL - Bloomington-Normal
43,1993-1994,1993-11-27,1994-04-06,131,11,98,413,511,33,110,143,654,15,140,IL - Bloomington-Normal
44,1994-1995,1994-12-01,1995-03-09,99,14,61,277,338,12,14,26,364,9,69,IL - Bloomington-Normal
46,1996-1997,1996-11-11,1997-04-11,152,13,95,331,426,38,99,137,563,14,100,IL - Bloomington-Normal
47,1997-1998,1997-11-03,1998-03-21,139,15,38,182,220,30,76,106,326,19,66,IL - Bloomington-Normal
48,1998-1999,1998-11-08,1999-03-14,127,6,53,269,322,50,197,247,569,17,131,IL - Bloomington-Normal
50,2000-2001,2000-11-20,2001-03-25,126,1,86,377,463,40,230,270,733,16,123,IL - Bloomington-Normal
51,2001-2002,2001-12-01,2002-03-26,116,13,31,210,241,18,29,47,288,9,38,IL - Bloomington-Normal
56,2006-2007,2006-12-01,2007-03-08,98,15,70,265,335,37,146,183,518,8,79,IL - Bloomington-Normal
57,2007-2008,2007-12-01,2008-03-09,100,12,77,304,381,54,86,140,521,20,148,IL - Bloomington-Normal
58,2008-2009,2008-11-21,2009-04-06,137,0,99,419,518,40,119,159,677,22,156,IL - Bloomington-Normal
59,2009-2010,2009-12-01,2010-02-28,90,2,87,302,389,37,165,202,591,16,106,IL - Bloomington-Normal
60,2010-2011,2010-12-01,2011-03-06,96,4,87,366,453,63,203,266,719,19,163,IL - Bloomington-Normal
61,2011-2012,2011-12-01,2012-03-05,96,1,17,182,199,10,15,25,224,5,27,IL - Bloomington-Normal
62,2012-2013,2012-12-01,2013-03-27,117,4,43,269,312,31,61,92,404,10,62,IL - Bloomington-Normal
63,2013-2014,2013-11-12,2014-04-15,155,3,141,543,684,76,220,296,980,24,205,IL - Bloomington-Normal
64,2014-2015,2014-11-13,2015-03-07,115,1,95,385,480,38,101,139,619,15,113,IL - Bloomington-Normal
65,2015-2016,2015-11-22,2016-02-29,100,0,40,209,249,24,39,63,312,10,75,IL - Bloomington-Normal
66,2016-2017,2016-12-01,2017-03-16,106,0,50,222,272,20,14,34,306,11,68,IL - Bloomington-Normal
67,2017-2018,2017-11-19,2018-04-16,149,0,93,397,490,51,123,174,664,19,142,IL - Bloomington-Normal
68,2018-2019,2018-11-09,2019-04-15,158,2,66,391,457,53,131,184,641,25,155,IL - Bloomington-Normal
69,2019-2020,2019-10-31,2020-04-15,168,6,36,264,300,39,45,84,384,20,84,IL - Bloomington-Normal
0,1950-1951,1950-11-10,1951-04-12,154,3,84,337,421,67,182,249,670,37,209,IL - Champaign-Urbana
1,1951-1952,1951-11-03,1952-03-05,124,1,50,229,279,44,103,147,426,17,103,IL - Champaign-Urbana
2,1952-1953,1952-11-27,1953-04-17,142,0,22,159,181,23,24,47,228,17,75,IL - Champaign-Urbana
3,1953-1954,1953-11-26,1954-03-14,109,0,25,185,210,11,4,15,225,8,27,IL - Champaign-Urbana
4,1954-1955,1954-11-01,1955-03-26,146,0,40,221,261,28,34,62,323,19,91,IL - Champaign-Urbana
5,1955-1956,1955-11-03,1956-04-07,157,0,40,280,320,49,62,111,431,24,109,IL - Champaign-Urbana
6,1956-1957,1956-11-22,1957-04-08,138,0,52,228,280,25,20,45,325,16,76,IL - Champaign-Urbana
7,1957-1958,1957-11-29,1958-03-20,112,0,63,238,301,21,10,31,332,18,58,IL - Champaign-Urbana
8,1958-1959,1958-11-26,1959-03-16,111,0,84,320,404,36,64,100,504,19,107,IL - Champaign-Urbana
9,1959-1960,1959-11-06,1960-03-26,142,0,77,311,388,71,194,265,653,38,194,IL - Champaign-Urbana
10,1960-1961,1960-11-09,1961-04-17,160,0,69,284,353,44,145,189,542,22,124,IL - Champaign-Urbana
11,1961-1962,1961-11-19,1962-04-12,145,0,72,296,368,74,119,193,561,38,192,IL - Champaign-Urbana
12,1962-1963,1962-12-01,1963-03-05,95,0,121,366,487,49,145,194,681,28,213,IL - Champaign-Urbana
13,1963-1964,1963-11-30,1964-04-08,131,0,69,299,368,69,128,197,565,30,147,IL - Champaign-Urbana
14,1964-1965,1964-11-21,1965-03-26,126,6,77,305,382,46,96,142,524,25,154,IL - Champaign-Urbana
15,1965-1966,1965-11-28,1966-04-05,129,0,69,253,322,24,18,42,364,14,68,IL - Champaign-Urbana
16,1966-1967,1966-11-02,1967-04-23,173,0,58,276,334,32,19,51,385,23,96,IL - Champaign-Urbana
17,1967-1968,1967-11-03,1968-03-23,142,1,69,309,378,55,126,181,559,30,156,IL - Champaign-Urbana
18,1968-1969,1968-11-18,1969-03-30,133,0,64,265,329,30,86,116,445,14,73,IL - Champaign-Urbana
19,1969-1970,1969-11-14,1970-04-02,140,1,92,325,417,43,149,192,609,26,142,IL - Champaign-Urbana
20,1970-1971,1970-11-23,1971-04-04,133,0,66,280,346,19,8,27,373,12,60,IL - Champaign-Urbana
21,1971-1972,1971-11-09,1972-04-01,145,2,59,259,318,27,60,87,405,14,65,IL - Champaign-Urbana
22,1972-1973,1972-11-19,1973-04-09,142,0,53,212,265,19,8,27,292,16,58,IL - Champaign-Urbana
23,1973-1974,1973-11-08,1974-03-25,138,2,60,242,302,56,143,199,501,21,122,IL - Champaign-Urbana
24,1974-1975,1974-11-13,1975-04-02,141,2,39,213,252,56,63,119,371,29,130,IL - Champaign-Urbana
25,1975-1976,1975-11-21,1976-03-17,118,5,54,217,271,39,57,96,367,18,82,IL - Champaign-Urbana
26,1976-1977,1976-11-22,1977-04-06,136,0,134,404,538,51,227,278,816,27,205,IL - Champaign-Urbana
27,1977-1978,1977-11-26,1978-03-27,122,3,142,415,557,98,415,513,1070,34,251,IL - Champaign-Urbana
28,1978-1979,1978-11-26,1979-04-04,130,0,136,394,530,61,387,448,978,25,210,IL - Champaign-Urbana
29,1979-1980,1979-11-28,1980-03-17,111,2,62,261,323,28,60,88,411,19,94,IL - Champaign-Urbana
30,1980-1981,1980-11-27,1981-03-18,112,0,62,257,319,45,107,152,471,15,107,IL - Champaign-Urbana
31,1981-1982,1981-11-21,1982-04-09,140,6,116,380,496,77,337,414,910,27,218,IL - Champaign-Urbana
32,1982-1983,1982-11-04,1983-03-27,144,3,32,187,219,30,28,58,277,17,59,IL - Champaign-Urbana
33,1983-1984,1983-11-13,1984-03-21,130,4,125,345,470,71,325,396,866,30,211,IL - Champaign-Urbana
34,1984-1985,1984-11-18,1985-03-05,108,10,80,276,356,30,129,159,515,18,101,IL - Champaign-Urbana
35,1985-1986,1985-11-20,1986-04-15,147,3,80,343,423,31,80,111,534,16,101,IL - Champaign-Urbana
41,1991-1992,1991-11-02,1992-04-01,152,3,31,214,245,26,21,47,292,20,83,IL - Champaign-Urbana
42,1992-1993,1992-11-05,1993-04-01,148,3,59,263,322,53,126,179,501,23,110,IL - Champaign-Urbana
43,1993-1994,1993-10-30,1994-04-07,160,0,103,347,450,39,93,132,582,24,148,IL - Champaign-Urbana
44,1994-1995,1994-12-01,1995-03-08,98,2,53,207,260,14,39,53,313,9,45,IL - Champaign-Urbana
45,1995-1996,1995-11-04,1996-03-20,138,0,97,373,470,38,137,175,645,17,114,IL - Champaign-Urbana
46,1996-1997,1996-11-02,1997-03-15,134,0,84,278,362,40,121,161,523,14,104,IL - Champaign-Urbana
47,1997-1998,1997-11-03,1998-03-21,139,0,28,169,197,26,30,56,253,17,58,IL - Champaign-Urbana
48,1998-1999,1998-12-01,1999-03-12,102,1,49,206,255,48,174,222,477,15,114,IL - Champaign-Urbana
49,1999-2000,1999-12-01,2000-03-11,102,4,42,208,250,31,107,138,388,15,95,IL - Champaign-Urbana
50,2000-2001,2000-11-17,2001-03-25,129,14,87,341,428,41,185,226,654,25,167,IL - Champaign-Urbana
51,2001-2002,2001-12-01,2002-03-28,118,0,27,200,227,24,24,48,275,12,62,IL - Champaign-Urbana
52,2002-2003,2002-11-24,2003-03-10,107,0,68,307,375,43,84,127,502,22,124,IL - Champaign-Urbana
53,2003-2004,2003-11-24,2004-03-17,115,0,57,237,294,28,79,107,401,19,92,IL - Champaign-Urbana
54,2004-2005,2004-11-25,2005-03-11,107,2,45,198,243,25,42,67,310,17,84,IL - Champaign-Urbana
55,2005-2006,2005-11-17,2006-03-22,126,0,45,219,264,29,55,84,348,18,92,IL - Champaign-Urbana
56,2006-2007,2006-12-01,2007-03-06,96,1,71,234,305,38,126,164,469,14,112,IL - Champaign-Urbana
57,2007-2008,2007-12-01,2008-03-08,99,5,63,260,323,43,66,109,432,21,138,IL - Champaign-Urbana
58,2008-2009,2008-11-21,2009-04-06,137,2,87,337,424,37,84,121,545,22,133,IL - Champaign-Urbana
59,2009-2010,2009-12-01,2010-02-28,90,0,84,270,354,38,166,204,558,17,115,IL - Champaign-Urbana
60,2010-2011,2010-12-01,2011-03-06,96,0,91,284,375,61,241,302,677,25,175,IL - Champaign-Urbana
61,2011-2012,2011-12-01,2012-03-05,96,0,18,151,169,20,19,39,208,13,68,IL - Champaign-Urbana
62,2012-2013,2012-11-24,2013-03-28,125,0,42,237,279,33,48,81,360,11,65,IL - Champaign-Urbana
63,2013-2014,2013-11-12,2014-04-15,155,4,122,454,576,70,182,252,828,34,248,IL - Champaign-Urbana
64,2014-2015,2014-11-13,2015-03-08,116,0,97,351,448,40,130,170,618,15,133,IL - Champaign-Urbana
65,2015-2016,2015-11-21,2016-02-29,101,0,40,171,211,21,36,57,268,13,83,IL - Champaign-Urbana
66,2016-2017,2016-12-01,2017-03-15,105,0,41,187,228,14,19,33,261,10,68,IL - Champaign-Urbana
67,2017-2018,2017-12-01,2018-04-16,137,0,93,314,407,29,93,122,529,15,117,IL - Champaign-Urbana
68,2018-2019,2018-11-09,2019-03-08,120,0,66,272,338,30,68,98,436,18,108,IL - Champaign-Urbana
69,2019-2020,2019-11-01,2020-03-15,136,0,31,221,252,26,41,67,319,17,69,IL - Champaign-Urbana
0,1950-1951,1950-11-10,1951-04-01,143,0,118,399,517,82,191,273,790,37,265,IL - Chicago
1,1951-1952,1951-11-02,1952-04-04,155,0,64,310,374,97,169,266,640,32,205,IL - Chicago
2,1952-1953,1952-10-20,1953-03-09,141,0,34,200,234,34,36,70,304,17,92,IL - Chicago
3,1953-1954,1953-11-05,1954-04-03,150,0,43,219,262,62,65,127,389,25,109,IL - Chicago
4,1954-1955,1954-10-29,1955-03-27,150,0,59,245,304,56,76,132,436,34,166,IL - Chicago
5,1955-1956,1955-11-02,1956-03-18,138,0,59,282,341,45,42,87,428,24,115,IL - Chicago
6,1956-1957,1956-11-21,1957-04-12,143,1,65,277,342,56,95,151,493,33,163,IL - Chicago
7,1957-1958,1957-10-26,1958-03-20,146,0,83,267,350,34,103,137,487,21,84,IL - Chicago
8,1958-1959,1958-11-26,1959-04-08,134,0,122,378,500,61,164,225,725,29,203,IL - Chicago
9,1959-1960,1959-11-06,1960-03-26,142,1,80,297,377,84,187,271,648,43,210,IL - Chicago
10,1960-1961,1960-11-09,1961-04-17,160,0,79,270,349,63,81,144,493,26,154,IL - Chicago
11,1961-1962,1961-11-19,1962-04-13,146,0,105,348,453,101,259,360,813,53,288,IL - Chicago
12,1962-1963,1962-10-25,1963-03-12,139,0,153,406,559,69,157,226,785,40,283,IL - Chicago
13,1963-1964,1963-12-01,1964-04-01,123,0,86,319,405,55,54,109,514,24,124,IL - Chicago
14,1964-1965,1964-11-19,1965-03-28,130,0,99,339,438,83,160,243,681,34,218,IL - Chicago
15,1965-1966,1965-11-28,1966-05-11,165,0,87,278,365,42,97,139,504,28,135,IL - Chicago
16,1966-1967,1966-11-02,1967-04-24,174,0,72,289,361,102,316,418,779,36,211,IL - Chicago
17,1967-1968,1967-10-26,1968-03-23,150,0,68,293,361,46,61,107,468,30,139,IL - Chicago
18,1968-1969,1968-11-18,1969-03-31,134,0,77,285,362,44,84,128,490,25,111,IL - Chicago
19,1969-1970,1969-11-13,1970-04-03,142,0,106,338,444,118,218,336,780,49,328,IL - Chicago
20,1970-1971,1970-11-14,1971-04-03,141,0,90,327,417,61,68,129,546,32,148,IL - Chicago
21,1971-1972,1971-11-08,1972-04-08,153,0,75,303,378,69,92,161,539,36,176,IL - Chicago
22,1972-1973,1972-10-18,1973-04-12,177,0,60,251,311,53,73,126,437,34,139,IL - Chicago
23,1973-1974,1973-12-01,1974-04-05,126,0,82,261,343,89,131,220,563,41,242,IL - Chicago
24,1974-1975,1974-11-13,1975-04-09,148,0,54,268,322,89,92,181,503,48,218,IL - Chicago
25,1975-1976,1975-11-12,1976-05-02,173,0,60,272,332,71,168,239,571,38,161,IL - Chicago
26,1976-1977,1976-10-27,1977-04-05,161,0,163,468,631,87,222,309,940,47,349,IL - Chicago
27,1977-1978,1977-11-13,1978-04-20,159,0,159,458,617,125,411,536,1153,47,377,IL - Chicago
28,1978-1979,1978-11-20,1979-03-26,127,0,163,441,604,129,650,779,1383,45,339,IL - Chicago
29,1979-1980,1979-11-27,1980-04-15,141,2,84,329,413,58,106,164,577,34,186,IL - Chicago
30,1980-1981,1980-11-18,1981-03-19,122,0,86,327,413,57,67,124,537,30,166,IL - Chicago
31,1981-1982,1981-11-20,1982-04-10,142,0,145,479,624,95,197,292,916,42,358,IL - Chicago
32,1982-1983,1982-11-04,1983-04-16,164,0,50,254,304,44,41,85,389,28,118,IL - Chicago
33,1983-1984,1983-11-24,1984-04-03,132,0,152,426,578,72,175,247,825,37,250,IL - Chicago
34,1984-1985,1984-12-01,1985-03-05,95,0,118,360,478,60,264,324,802,26,194,IL - Chicago
35,1985-1986,1985-11-20,1986-04-15,147,0,115,423,538,53,66,119,657,34,196,IL - Chicago
36,1986-1987,1986-11-11,1987-03-15,125,0,41,215,256,40,55,95,351,20,85,IL - Chicago
37,1987-1988,1987-10-20,1988-03-30,163,0,91,347,438,73,144,217,655,32,172,IL - Chicago
38,1988-1989,1988-11-06,1989-05-06,182,0,75,323,398,45,71,116,514,30,168,IL - Chicago
39,1989-1990,1989-10-18,1990-04-11,176,0,78,312,390,58,97,155,545,33,172,IL - Chicago
40,1990-1991,1990-12-01,1991-03-31,121,0,68,277,345,40,74,114,459,21,113,IL - Chicago
41,1991-1992,1991-11-02,1992-04-02,153,0,39,272,311,47,69,116,427,25,116,IL - Chicago
42,1992-1993,1992-10-20,1993-04-02,165,0,63,303,366,66,134,200,566,32,145,IL - Chicago
43,1993-1994,1993-11-06,1994-03-06,121,0,121,352,473,67,199,266,739,30,243,IL - Chicago
44,1994-1995,1994-12-01,1995-04-12,133,0,62,249,311,35,82,117,428,15,68,IL - Chicago
49,1999-2000,1999-12-01,2000-04-08,130,0,52,236,288,44,112,156,444,20,119,IL - Chicago
50,2000-2001,2000-11-16,2001-04-16,152,0,106,394,500,66,324,390,890,27,176,IL - Chicago
51,2001-2002,2001-12-01,2002-04-04,125,18,39,206,245,51,78,129,374,22,114,IL - Chicago
52,2002-2003,2002-11-17,2003-04-08,143,0,93,352,445,44,52,96,541,21,124,IL - Chicago
53,2003-2004,2003-11-24,2004-03-18,116,0,78,276,354,42,120,162,516,25,140,IL - Chicago
54,2004-2005,2004-11-24,2005-03-25,122,0,63,250,313,64,119,183,496,27,146,IL - Chicago
55,2005-2006,2005-11-16,2006-03-24,129,0,52,244,296,48,92,140,436,28,121,IL - Chicago
56,2006-2007,2006-10-12,2007-04-12,183,0,94,294,388,53,118,171,559,23,126,IL - Chicago
57,2007-2008,2007-11-21,2008-03-28,129,3,87,325,412,88,185,273,685,44,256,IL - Chicago
58,2008-2009,2008-11-16,2009-04-06,142,0,117,398,515,83,228,311,826,40,265,IL - Chicago
59,2009-2010,2009-12-01,2010-03-20,110,0,84,249,333,77,199,276,609,30,166,IL - Chicago
60,2010-2011,2010-11-26,2011-04-18,144,3,101,330,431,82,241,323,754,32,204,IL - Chicago
61,2011-2012,2011-12-01,2012-03-04,95,0,22,144,166,34,34,68,234,18,91,IL - Chicago
62,2012-2013,2012-11-24,2013-04-19,147,0,50,263,313,53,73,126,439,29,137,IL - Chicago
63,2013-2014,2013-11-11,2014-04-15,156,0,158,498,656,122,327,449,1105,51,392,IL - Chicago
64,2014-2015,2014-10-31,2015-03-27,148,0,127,397,524,80,257,337,861,35,269,IL - Chicago
65,2015-2016,2015-11-20,2016-04-08,141,0,54,214,268,49,52,101,369,24,130,IL - Chicago
66,2016-2017,2016-12-01,2017-03-16,106,0,60,218,278,39,74,113,391,15,101,IL - Chicago
67,2017-2018,2017-11-10,2018-04-19,161,0,91,320,411,57,96,153,564,31,195,IL - Chicago
68,2018-2019,2018-11-09,2019-04-27,170,0,90,328,418,76,125,201,619,37,234,IL - Chicago
69,2019-2020,2019-10-30,2020-04-17,171,0,34,210,244,55,62,117,361,29,110,IL - Chicago
0,1950-1951,1950-11-10,1951-03-14,125,2,78,310,388,45,123,168,556,18,129,IL - Effingham
2,1952-1953,1952-11-27,1953-03-07,101,1,19,137,156,22,12,34,190,11,57,IL - Effingham
3,1953-1954,1953-12-01,1954-03-05,95,9,17,144,161,1,0,1,162,1,4,IL - Effingham
7,1957-1958,1957-12-01,1958-03-10,100,0,44,216,260,18,25,43,303,8,46,IL - Effingham
8,1958-1959,1958-11-27,1959-03-10,104,0,49,280,329,10,19,29,358,4,29,IL - Effingham
9,1959-1960,1959-11-17,1960-03-25,130,2,40,241,281,48,89,137,418,19,98,IL - Effingham
10,1960-1961,1960-12-01,1961-04-15,136,0,37,212,249,35,71,106,355,16,92,IL - Effingham
11,1961-1962,1961-11-19,1962-03-16,118,0,41,230,271,47,77,124,395,23,120,IL - Effingham
12,1962-1963,1962-12-01,1963-03-01,91,0,70,286,356,25,27,52,408,20,111,IL - Effingham
13,1963-1964,1963-12-01,1964-03-27,118,0,50,268,318,46,102,148,466,15,81,IL - Effingham
14,1964-1965,1964-11-21,1965-03-27,127,3,46,269,315,51,92,143,458,14,115,IL - Effingham
15,1965-1966,1965-11-29,1966-03-06,98,0,38,201,239,13,32,45,284,5,32,IL - Effingham
16,1966-1967,1966-12-01,1967-03-08,98,3,30,205,235,14,8,22,257,7,34,IL - Effingham
17,1967-1968,1967-11-23,1968-03-22,121,2,49,266,315,36,126,162,477,12,79,IL - Effingham
18,1968-1969,1968-12-01,1969-03-11,101,2,26,203,229,6,9,15,244,3,12,IL - Effingham
19,1969-1970,1969-11-19,1970-03-18,120,1,65,288,353,58,197,255,608,17,120,IL - Effingham
20,1970-1971,1970-11-23,1971-02-28,98,1,31,225,256,13,27,40,296,6,38,IL - Effingham
21,1971-1972,1971-12-01,1972-02-29,91,4,27,185,212,12,14,26,238,5,48,IL - Effingham
22,1972-1973,1972-11-23,1973-04-10,139,2,28,190,218,15,14,29,247,5,28,IL - Effingham
23,1973-1974,1973-12-01,1974-03-25,115,0,43,208,251,56,145,201,452,12,120,IL - Effingham
26,1976-1977,1976-11-29,1977-03-22,114,0,123,420,543,45,211,256,799,18,142,IL - Effingham
27,1977-1978,1977-11-27,1978-03-26,120,0,123,447,570,65,362,427,997,27,194,IL - Effingham
28,1978-1979,1978-12-01,1979-03-26,116,0,115,392,507,50,293,343,850,23,204,IL - Effingham
29,1979-1980,1979-11-29,1980-04-15,139,0,56,298,354,41,122,163,517,14,102,IL - Effingham
30,1980-1981,1980-11-18,1981-02-28,103,0,59,285,344,34,53,87,431,12,84,IL - Effingham
31,1981-1982,1981-11-22,1982-04-09,139,6,93,358,451,51,182,233,684,18,135,IL - Effingham
32,1982-1983,1982-11-14,1983-03-24,131,6,25,165,190,15,7,22,212,12,42,IL - Effingham
33,1983-1984,1983-12-01,1984-03-14,105,3,105,309,414,45,139,184,598,26,163,IL - Effingham
40,1990-1991,1990-12-01,1991-03-04,94,3,43,180,223,23,100,123,346,6,52,IL - Effingham
41,1991-1992,1991-11-03,1992-03-31,150,12,22,191,213,24,30,54,267,6,43,IL - Effingham
42,1992-1993,1992-11-15,1993-03-18,124,7,47,232,279,56,70,126,405,13,100,IL - Effingham
43,1993-1994,1993-10-31,1994-04-07,159,5,68,283,351,18,47,65,416,11,56,IL - Effingham
44,1994-1995,1994-12-01,1995-03-09,99,2,43,199,242,19,42,61,303,7,43,IL - Effingham
49,1999-2000,1999-12-01,2000-03-13,104,0,30,199,229,22,51,73,302,7,48,IL - Effingham
50,2000-2001,2000-11-22,2001-02-28,99,1,63,291,354,27,140,167,521,12,89,IL - Effingham
51,2001-2002,2001-12-01,2002-03-26,116,0,18,179,197,15,21,36,233,7,34,IL - Effingham
52,2002-2003,2002-12-01,2003-03-11,101,0,50,276,326,43,58,101,427,21,117,IL - Effingham
53,2003-2004,2003-12-01,2004-02-29,91,1,41,196,237,15,27,42,279,11,74,IL - Effingham
54,2004-2005,2004-12-01,2005-03-02,92,0,34,178,212,22,43,65,277,11,54,IL - Effingham
55,2005-2006,2005-11-18,2006-03-23,126,6,27,203,230,25,34,59,289,8,45,IL - Effingham
56,2006-2007,2006-12-01,2007-03-04,94,0,47,214,261,15,30,45,306,7,47,IL - Effingham
57,2007-2008,2007-12-01,2008-03-09,100,0,47,241,288,30,39,69,357,15,82,IL - Effingham
58,2008-2009,2008-11-22,2009-03-04,103,0,61,291,352,24,40,64,416,10,66,IL - Effingham
59,2009-2010,2009-12-01,2010-02-28,90,0,49,249,298,25,53,78,376,11,65,IL - Effingham
60,2010-2011,2010-12-01,2011-02-28,90,0,58,249,307,31,104,135,442,14,89,IL - Effingham
62,2012-2013,2012-12-01,2013-03-27,117,6,24,213,237,23,39,62,299,8,33,IL - Effingham
63,2013-2014,2013-11-24,2014-03-25,122,2,85,419,504,53,136,189,693,19,137,IL - Effingham
64,2014-2015,2014-11-14,2015-03-09,116,2,59,312,371,35,102,137,508,11,85,IL - Effingham
65,2015-2016,2015-12-01,2016-02-29,91,0,27,135,162,12,19,31,193,5,29,IL - Effingham
66,2016-2017,2016-12-01,2017-03-15,105,1,30,164,194,5,4,9,203,4,18,IL - Effingham
67,2017-2018,2017-12-01,2018-04-09,130,0,56,258,314,12,9,21,335,8,39,IL - Effingham
68,2018-2019,2018-11-14,2019-03-06,113,0,37,223,260,18,24,42,302,8,52,IL - Effingham
69,2019-2020,2019-11-12,2020-02-29,110,0,20,169,189,11,21,32,221,6,25,IL - Effingham
1,1951-1952,1951-11-03,1952-03-08,127,14,55,308,363,45,77,122,485,16,126,IL - La Harpe
3,1953-1954,1953-12-01,1954-03-14,104,14,23,223,246,12,14,26,272,6,31,IL - La Harpe
4,1954-1955,1954-12-01,1955-03-26,116,7,39,269,308,37,98,135,443,14,87,IL - La Harpe
5,1955-1956,1955-11-03,1956-03-18,137,1,55,357,412,28,43,71,483,19,97,IL - La Harpe
6,1956-1957,1956-11-21,1957-04-10,141,4,56,299,355,46,118,164,519,18,138,IL - La Harpe
7,1957-1958,1957-11-30,1958-03-11,102,0,83,282,365,27,173,200,565,10,55,IL - La Harpe
8,1958-1959,1958-11-27,1959-03-15,109,7,90,368,458,36,155,191,649,10,87,IL - La Harpe
9,1959-1960,1959-11-06,1960-03-27,143,0,84,382,466,64,253,317,783,19,134,IL - La Harpe
10,1960-1961,1960-12-01,1961-04-17,138,5,54,318,372,28,77,105,477,10,69,IL - La Harpe
11,1961-1962,1961-12-01,1962-03-15,105,5,94,347,441,35,236,271,712,12,70,IL - La Harpe
12,1962-1963,1962-12-01,1963-03-01,91,8,113,376,489,27,101,128,617,12,111,IL - La Harpe
13,1963-1964,1963-12-01,1964-03-29,120,6,72,352,424,37,104,141,565,12,77,IL - La Harpe
14,1964-1965,1964-11-21,1965-03-28,128,5,89,408,497,61,142,203,700,14,139,IL - La Harpe
15,1965-1966,1965-11-29,1966-03-24,116,3,59,264,323,14,7,21,344,8,43,IL - La Harpe
17,1967-1968,1967-10-27,1968-03-21,147,3,65,367,432,26,69,95,527,11,76,IL - La Harpe
18,1968-1969,1968-11-11,1969-03-30,140,4,68,324,392,29,95,124,516,10,53,IL - La Harpe
19,1969-1970,1969-11-14,1970-04-03,141,2,81,384,465,56,174,230,695,15,102,IL - La Harpe
20,1970-1971,1970-11-23,1971-03-11,109,1,71,337,408,27,87,114,522,8,39,IL - La Harpe
21,1971-1972,1971-11-29,1972-03-29,122,0,68,317,385,43,109,152,537,13,101,IL - La Harpe
22,1972-1973,1972-10-18,1973-04-10,175,5,67,284,351,16,58,74,425,6,44,IL - La Harpe
24,1974-1975,1974-11-14,1975-04-03,141,2,43,367,410,72,128,200,610,16,126,IL - La Harpe
25,1975-1976,1975-11-25,1976-02-29,97,2,40,228,268,38,63,101,369,12,85,IL - La Harpe
26,1976-1977,1976-11-27,1977-03-22,116,3,122,429,551,41,202,243,794,16,137,IL - La Harpe
27,1977-1978,1977-11-25,1978-03-27,123,0,131,523,654,76,387,463,1117,21,199,IL - La Harpe
28,1978-1979,1978-11-20,1979-03-25,126,1,144,461,605,78,530,608,1213,20,203,IL - La Harpe
29,1979-1980,1979-11-28,1980-04-15,140,2,56,315,371,42,88,130,501,16,108,IL - La Harpe
30,1980-1981,1980-11-27,1981-02-28,94,0,44,258,302,22,45,67,369,11,68,IL - La Harpe
31,1981-1982,1981-11-20,1982-04-09,141,2,98,431,529,53,260,313,842,17,149,IL - La Harpe
32,1982-1983,1982-11-13,1983-03-26,134,3,25,211,236,27,64,91,327,11,59,IL - La Harpe
33,1983-1984,1983-11-29,1984-03-22,115,5,114,367,481,50,239,289,770,19,146,IL - La Harpe
34,1984-1985,1984-12-01,1985-02-28,90,6,85,336,421,30,277,307,728,9,75,IL - La Harpe
36,1986-1987,1986-11-11,1987-02-28,110,1,29,213,242,19,46,65,307,6,38,IL - La Harpe
37,1987-1988,1987-11-29,1988-03-30,123,4,72,362,434,33,102,135,569,9,74,IL - La Harpe
38,1988-1989,1988-11-22,1989-03-19,118,2,55,351,406,19,105,124,530,8,62,IL - La Harpe
39,1989-1990,1989-11-17,1990-03-24,128,1,68,433,501,26,110,136,637,9,86,IL - La Harpe
40,1990-1991,1990-12-01,1991-03-14,104,0,67,358,425,26,101,127,552,9,77,IL - La Harpe
41,1991-1992,1991-11-03,1992-03-14,133,5,34,228,262,24,39,63,325,10,59,IL - La Harpe
42,1992-1993,1992-11-27,1993-04-02,127,2,62,323,385,50,153,203,588,14,92,IL - La Harpe
43,1993-1994,1993-11-07,1994-03-03,117,6,95,361,456,38,149,187,643,14,117,IL - La Harpe
44,1994-1995,1994-11-30,1995-03-09,100,0,58,296,354,26,150,176,530,8,57,IL - La Harpe
45,1995-1996,1995-11-11,1996-03-27,138,4,100,436,536,31,106,137,673,13,94,IL - La Harpe
46,1996-1997,1996-11-11,1997-04-13,154,3,86,403,489,33,112,145,634,11,98,IL - La Harpe
47,1997-1998,1997-11-17,1998-03-14,118,4,32,201,233,49,114,163,396,12,76,IL - La Harpe
48,1998-1999,1998-11-08,1999-03-15,128,6,57,306,363,51,192,243,606,9,104,IL - La Harpe
49,1999-2000,1999-12-01,2000-04-08,130,3,41,277,318,20,79,99,417,8,51,IL - La Harpe
50,2000-2001,2000-11-21,2001-03-17,117,2,92,448,540,45,346,391,931,15,137,IL - La Harpe
51,2001-2002,2001-12-01,2002-03-26,116,2,28,280,308,29,58,87,395,8,52,IL - La Harpe
52,2002-2003,2002-11-26,2003-03-11,106,2,62,389,451,26,70,96,547,9,67,IL - La Harpe
60,2010-2011,2010-11-22,2011-05-15,175,18,92,343,435,34,165,199,634,17,63,IL - La Harpe
62,2012-2013,2012-12-01,2013-03-28,118,17,53,283,336,41,134,175,511,12,69,IL - La Harpe
63,2013-2014,2013-11-12,2014-03-17,126,0,147,514,661,66,274,340,1001,18,161,IL - La Harpe
64,2014-2015,2014-11-12,2015-03-07,116,14,103,377,480,41,131,172,652,10,91,IL - La Harpe
65,2015-2016,2015-11-21,2016-02-29,101,5,41,179,220,19,33,52,272,8,62,IL - La Harpe
66,2016-2017,2016-12-01,2017-03-15,105,4,43,212,255,16,20,36,291,5,40,IL - La Harpe
67,2017-2018,2017-12-01,2018-04-09,130,3,92,352,444,26,103,129,573,9,85,IL - La Harpe
68,2018-2019,2018-11-09,2019-03-08,120,3,90,355,445,42,153,195,640,13,84,IL - La Harpe
69,2019-2020,2019-10-30,2020-04-17,171,4,47,266,313,43,82,125,438,15,77,IL - La Harpe
0,1950-1951,1950-11-08,1951-04-01,145,0,149,464,613,60,161,221,834,32,222,IL - Moline
1,1951-1952,1951-11-02,1952-03-23,143,0,87,379,466,65,165,230,696,28,168,IL - Moline
2,1952-1953,1952-11-27,1953-04-19,144,0,52,277,329,41,81,122,451,17,115,IL - Moline
3,1953-1954,1953-11-26,1954-04-03,129,0,54,296,350,26,34,60,410,10,56,IL - Moline
4,1954-1955,1954-11-01,1955-03-26,146,0,66,337,403,72,145,217,620,35,225,IL - Moline
5,1955-1956,1955-11-16,1956-04-07,144,0,73,392,465,30,43,73,538,21,101,IL - Moline
6,1956-1957,1956-11-21,1957-04-12,143,0,80,357,437,54,92,146,583,25,170,IL - Moline
7,1957-1958,1957-11-19,1958-03-05,107,0,103,318,421,42,212,254,675,18,107,IL - Moline
8,1958-1959,1958-11-26,1959-04-20,146,0,120,431,551,64,169,233,784,30,190,IL - Moline
9,1959-1960,1959-11-06,1960-03-27,143,0,108,429,537,89,382,471,1008,41,266,IL - Moline
10,1960-1961,1960-11-29,1961-04-17,140,0,86,349,435,25,47,72,507,16,115,IL - Moline
11,1961-1962,1961-12-01,1962-04-13,134,0,127,418,545,77,355,432,977,42,246,IL - Moline
12,1962-1963,1962-10-24,1963-03-13,141,0,172,510,682,46,111,157,839,27,269,IL - Moline
13,1963-1964,1963-12-01,1964-03-29,120,0,108,378,486,50,109,159,645,25,116,IL - Moline
14,1964-1965,1964-11-19,1965-03-27,129,0,126,417,543,72,135,207,750,39,237,IL - Moline
15,1965-1966,1965-11-18,1966-04-05,139,0,111,368,479,29,66,95,574,22,145,IL - Moline
16,1966-1967,1966-12-01,1967-04-24,145,0,89,342,431,54,123,177,608,24,149,IL - Moline
17,1967-1968,1967-10-26,1968-03-22,149,0,93,394,487,42,76,118,605,27,171,IL - Moline
18,1968-1969,1968-11-08,1969-03-30,143,0,108,384,492,41,59,100,592,24,116,IL - Moline
19,1969-1970,1969-11-14,1970-04-02,140,0,126,455,581,84,154,238,819,38,301,IL - Moline
20,1970-1971,1970-11-22,1971-03-23,122,0,117,369,486,49,185,234,720,19,110,IL - Moline
21,1971-1972,1971-11-09,1972-04-07,151,0,101,384,485,79,163,242,727,33,216,IL - Moline
22,1972-1973,1972-10-18,1973-04-10,175,0,85,303,388,46,77,123,511,26,145,IL - Moline
23,1973-1974,1973-11-09,1974-04-04,147,0,110,352,462,53,124,177,639,27,169,IL - Moline
24,1974-1975,1974-11-13,1975-04-05,144,0,70,344,414,105,133,238,652,41,233,IL - Moline
25,1975-1976,1975-11-12,1976-03-13,123,0,63,297,360,40,41,81,441,22,97,IL - Moline
26,1976-1977,1976-11-04,1977-04-05,153,0,165,538,703,60,182,242,945,30,248,IL - Moline
27,1977-1978,1977-11-24,1978-03-27,124,0,187,535,722,65,319,384,1106,33,252,IL - Moline
28,1978-1979,1978-11-20,1979-04-02,134,0,198,552,750,98,601,699,1449,42,341,IL - Moline
29,1979-1980,1979-11-10,1980-04-15,158,0,90,387,477,63,87,150,627,37,199,IL - Moline
30,1980-1981,1980-10-27,1981-02-28,125,0,79,336,415,34,55,89,504,22,141,IL - Moline
31,1981-1982,1981-11-19,1982-04-11,144,0,153,488,641,71,193,264,905,38,303,IL - Moline
32,1982-1983,1982-11-05,1983-04-03,150,0,39,235,274,40,60,100,374,24,94,IL - Moline
33,1983-1984,1983-11-13,1984-04-03,143,0,144,401,545,74,249,323,868,36,249,IL - Moline
34,1984-1985,1984-12-01,1985-03-30,120,0,110,360,470,49,276,325,795,27,198,IL - Moline
35,1985-1986,1985-11-20,1986-04-15,147,0,120,424,544,50,148,198,742,31,202,IL - Moline
36,1986-1987,1986-11-10,1987-03-01,112,0,40,240,280,20,18,38,318,14,55,IL - Moline
37,1987-1988,1987-11-29,1988-03-29,122,0,98,332,430,56,140,196,626,24,149,IL - Moline
38,1988-1989,1988-11-05,1989-03-18,134,0,71,326,397,27,107,134,531,16,104,IL - Moline
39,1989-1990,1989-11-16,1990-02-28,105,0,82,321,403,45,113,158,561,20,141,IL - Moline
40,1990-1991,1990-12-01,1991-03-16,106,0,77,325,402,40,131,171,573,21,136,IL - Moline
41,1991-1992,1991-11-02,1992-03-15,135,0,40,251,291,33,38,71,362,21,94,IL - Moline
42,1992-1993,1992-11-05,1993-04-16,163,0,65,342,407,41,113,154,561,24,101,IL - Moline
43,1993-1994,1993-11-06,1994-04-30,176,0,130,425,555,68,190,258,813,32,249,IL - Moline
44,1994-1995,1994-11-29,1995-04-10,133,0,73,296,369,51,161,212,581,21,129,IL - Moline
45,1995-1996,1995-11-02,1996-03-26,146,4,124,453,577,47,94,141,718,27,165,IL - Moline
46,1996-1997,1996-11-10,1997-04-13,155,0,118,386,504,90,116,206,710,36,257,IL - Moline
50,2000-2001,2000-11-13,2001-03-25,133,20,125,445,570,78,339,417,987,39,252,IL - Moline
51,2001-2002,2001-12-01,2002-04-02,123,0,40,244,284,48,86,134,418,22,121,IL - Moline
52,2002-2003,2002-11-24,2003-04-07,135,0,74,377,451,34,54,88,539,20,112,IL - Moline
53,2003-2004,2003-11-24,2004-03-17,115,0,76,280,356,50,177,227,583,21,124,IL - Moline
54,2004-2005,2004-11-24,2005-03-23,120,10,56,255,311,28,71,99,410,19,77,IL - Moline
55,2005-2006,2005-11-17,2006-03-24,128,3,60,264,324,34,102,136,460,18,97,IL - Moline
56,2006-2007,2006-12-01,2007-04-12,133,4,89,304,393,53,201,254,647,19,126,IL - Moline
57,2007-2008,2007-12-01,2008-03-27,118,3,96,357,453,81,211,292,745,38,238,IL - Moline
58,2008-2009,2008-11-21,2009-04-05,136,1,111,421,532,67,166,233,765,29,218,IL - Moline
59,2009-2010,2009-12-01,2010-03-21,111,0,97,322,419,66,236,302,721,27,167,IL - Moline
60,2010-2011,2010-11-30,2011-02-28,91,0,106,321,427,67,233,300,727,28,182,IL - Moline
61,2011-2012,2011-11-09,2012-03-06,119,2,24,212,236,27,37,64,300,16,80,IL - Moline
62,2012-2013,2012-11-24,2013-03-25,122,1,60,310,370,52,122,174,544,21,112,IL - Moline
63,2013-2014,2013-10-22,2014-03-25,155,0,176,584,760,91,249,340,1100,38,318,IL - Moline
64,2014-2015,2014-11-11,2015-03-23,133,1,115,427,542,56,200,256,798,21,170,IL - Moline
65,2015-2016,2015-11-20,2016-03-25,127,2,43,219,262,35,51,86,348,15,91,IL - Moline
66,2016-2017,2016-12-01,2017-03-15,105,1,50,215,265,32,46,78,343,13,68,IL - Moline
67,2017-2018,2017-12-01,2018-04-16,137,0,101,367,468,61,118,179,647,26,215,IL - Moline
68,2018-2019,2018-10-15,2019-03-17,154,16,87,376,463,86,157,243,706,29,233,IL - Moline
15,1965-1966,1965-11-29,1966-03-06,98,4,37,175,212,20,39,59,271,7,47,IL - Nashville
16,1966-1967,1966-12-01,1967-03-09,99,4,20,155,175,6,1,7,182,6,21,IL - Nashville
17,1967-1968,1967-12-01,1968-03-15,106,1,41,215,256,17,39,56,312,10,67,IL - Nashville
18,1968-1969,1968-12-01,1969-03-11,101,0,23,166,189,20,26,46,235,4,28,IL - Nashville
19,1969-1970,1969-11-19,1970-03-29,131,0,58,258,316,44,205,249,565,19,111,IL - Nashville
20,1970-1971,1970-11-24,1971-04-08,136,0,32,211,243,32,36,68,311,10,57,IL - Nashville
21,1971-1972,1971-11-24,1972-02-29,98,0,24,151,175,11,16,27,202,7,42,IL - Nashville
22,1972-1973,1972-12-01,1973-02-28,90,0,26,157,183,7,3,10,193,6,28,IL - Nashville
23,1973-1974,1973-12-01,1974-03-25,115,0,38,168,206,37,70,107,313,9,76,IL - Nashville
24,1974-1975,1974-12-01,1975-03-14,104,0,11,120,131,24,20,44,175,9,37,IL - Nashville
25,1975-1976,1975-11-27,1976-03-16,111,0,24,147,171,23,43,66,237,7,47,IL - Nashville
26,1976-1977,1976-11-28,1977-03-01,94,2,82,296,378,39,226,265,643,12,105,IL - Nashville
27,1977-1978,1977-11-26,1978-03-26,121,1,86,320,406,46,271,317,723,18,111,IL - Nashville
28,1978-1979,1978-12-01,1979-03-25,115,3,77,286,363,43,221,264,627,18,149,IL - Nashville
29,1979-1980,1979-11-29,1980-04-15,139,0,35,191,226,24,81,105,331,13,77,IL - Nashville
30,1980-1981,1980-11-27,1981-02-28,94,0,24,172,196,20,24,44,240,6,41,IL - Nashville
31,1981-1982,1981-12-01,1982-04-08,129,2,54,249,303,59,205,264,567,13,113,IL - Nashville
32,1982-1983,1982-12-01,1983-04-18,139,12,14,100,114,11,8,19,133,8,26,IL - Nashville
33,1983-1984,1983-12-01,1984-03-21,112,3,76,242,318,41,121,162,480,17,110,IL - Nashville
34,1984-1985,1984-12-01,1985-02-28,90,1,52,206,258,21,117,138,396,12,72,IL - Nashville
35,1985-1986,1985-12-01,1986-02-28,90,12,35,188,223,13,20,33,256,8,56,IL - Nashville
36,1986-1987,1986-11-13,1987-02-28,108,1,19,137,156,14,27,41,197,8,36,IL - Nashville
37,1987-1988,1987-12-01,1988-03-18,109,3,33,195,228,14,13,27,255,7,45,IL - Nashville
38,1988-1989,1988-12-01,1989-03-10,100,0,22,182,204,17,41,58,262,7,47,IL - Nashville
39,1989-1990,1989-11-29,1990-03-25,117,1,47,231,278,23,66,89,367,8,61,IL - Nashville
40,1990-1991,1990-12-01,1991-03-14,104,0,28,212,240,20,82,102,342,8,64,IL - Nashville
41,1991-1992,1991-11-03,1992-03-14,133,0,11,130,141,10,24,34,175,5,20,IL - Nashville
42,1992-1993,1992-12-01,1993-03-14,104,0,23,158,181,29,62,91,272,6,52,IL - Nashville
43,1993-1994,1993-10-30,1994-03-09,131,0,41,208,249,20,35,55,304,13,59,IL - Nashville
44,1994-1995,1994-12-01,1995-03-08,98,3,25,161,186,5,5,10,196,5,25,IL - Nashville
45,1995-1996,1995-12-01,1996-03-21,112,0,47,217,264,24,62,86,350,11,69,IL - Nashville
46,1996-1997,1996-11-27,1997-03-15,109,4,43,186,229,21,81,102,331,10,61,IL - Nashville
47,1997-1998,1997-11-14,1998-03-12,119,2,14,99,113,21,28,49,162,8,36,IL - Nashville
48,1998-1999,1998-12-01,1999-03-14,104,1,30,139,169,19,63,82,251,9,63,IL - Nashville
49,1999-2000,1999-12-01,2000-03-13,104,0,9,121,130,11,12,23,153,4,21,IL - Nashville
50,2000-2001,2000-11-21,2001-02-28,100,2,50,225,275,27,151,178,453,11,72,IL - Nashville
51,2001-2002,2001-12-01,2002-03-26,116,1,17,136,153,13,20,33,186,8,41,IL - Nashville
52,2002-2003,2002-12-01,2003-03-01,91,1,38,193,231,46,87,133,364,15,95,IL - Nashville
53,2003-2004,2003-12-01,2004-02-29,91,2,26,137,163,10,6,16,179,8,45,IL - Nashville
54,2004-2005,2004-12-01,2005-03-01,91,4,23,124,147,16,29,45,192,9,42,IL - Nashville
56,2006-2007,2006-12-01,2007-02-28,90,8,24,141,165,8,18,26,191,5,25,IL - Nashville
57,2007-2008,2007-12-01,2008-03-09,100,6,34,186,220,19,12,31,251,8,36,IL - Nashville
58,2008-2009,2008-11-22,2009-03-13,112,2,46,238,284,12,37,49,333,2,23,IL - Nashville
59,2009-2010,2009-12-01,2010-02-28,90,2,53,212,265,16,45,61,326,6,38,IL - Nashville
60,2010-2011,2010-12-01,2011-03-27,117,3,54,211,265,24,59,83,348,6,38,IL - Nashville
61,2011-2012,2011-12-01,2012-02-29,91,0,9,101,110,5,3,8,118,4,14,IL - Nashville
62,2012-2013,2012-12-01,2013-03-25,115,0,16,170,186,30,44,74,260,8,40,IL - Nashville
63,2013-2014,2013-11-25,2014-03-04,100,0,75,314,389,42,120,162,551,11,91,IL - Nashville
64,2014-2015,2014-11-14,2015-03-07,114,0,45,252,297,26,40,66,363,9,70,IL - Nashville
65,2015-2016,2015-12-01,2016-02-29,91,3,24,118,142,9,9,18,160,6,33,IL - Nashville
66,2016-2017,2016-12-01,2017-03-13,103,2,23,142,165,4,4,8,173,2,9,IL - Nashville
67,2017-2018,2017-12-01,2018-02-28,90,14,52,195,247,6,4,10,257,5,23,IL - Nashville
68,2018-2019,2018-11-15,2019-03-06,112,5,32,177,209,27,31,58,267,8,67,IL - Nashville
0,1950-1951,1950-11-22,1951-03-25,124,0,71,294,365,59,164,223,588,25,170,IL - Pana
1,1951-1952,1951-11-06,1952-03-05,121,9,30,209,239,48,96,144,383,16,105,IL - Pana
2,1952-1953,1952-11-27,1953-03-07,101,2,20,155,175,32,38,70,245,12,65,IL - Pana
3,1953-1954,1953-11-29,1954-03-14,106,1,23,171,194,10,7,17,211,6,22,IL - Pana
4,1954-1955,1954-11-01,1955-03-26,146,4,33,200,233,27,25,52,285,15,73,IL - Pana
5,1955-1956,1955-11-18,1956-03-16,120,4,34,223,257,40,71,111,368,15,78,IL - Pana
6,1956-1957,1956-11-22,1957-04-12,142,0,36,189,225,18,34,52,277,13,68,IL - Pana
7,1957-1958,1957-12-01,1958-03-17,107,2,49,219,268,20,17,37,305,12,48,IL - Pana
8,1958-1959,1958-11-27,1959-03-12,106,1,65,267,332,24,49,73,405,12,72,IL - Pana
9,1959-1960,1959-11-17,1960-03-25,130,0,59,258,317,54,176,230,547,20,108,IL - Pana
10,1960-1961,1960-12-01,1961-02-28,90,0,54,215,269,30,107,137,406,12,80,IL - Pana
11,1961-1962,1961-11-19,1962-03-08,110,0,58,251,309,53,122,175,484,20,124,IL - Pana
12,1962-1963,1962-12-01,1963-03-09,99,0,93,312,405,22,67,89,494,15,99,IL - Pana
13,1963-1964,1963-12-01,1964-03-12,103,0,64,251,315,57,138,195,510,14,100,IL - Pana
14,1964-1965,1964-11-20,1965-03-25,126,0,63,279,342,46,97,143,485,19,138,IL - Pana
15,1965-1966,1965-11-29,1966-03-08,100,3,47,203,250,7,36,43,293,5,19,IL - Pana
16,1966-1967,1966-11-27,1967-03-09,103,3,33,206,239,17,17,34,273,10,38,IL - Pana
17,1967-1968,1967-11-23,1968-03-23,122,1,60,262,322,41,142,183,505,18,120,IL - Pana
18,1968-1969,1968-11-20,1969-03-31,132,0,47,240,287,28,73,101,388,12,61,IL - Pana
19,1969-1970,1969-11-14,1970-04-02,140,0,86,310,396,59,211,270,666,26,155,IL - Pana
20,1970-1971,1970-11-23,1971-03-07,105,2,55,227,282,10,25,35,317,6,42,IL - Pana
21,1971-1972,1971-11-23,1972-02-29,99,3,37,179,216,20,38,58,274,12,78,IL - Pana
22,1972-1973,1972-11-19,1973-04-10,143,0,41,204,245,38,42,80,325,21,91,IL - Pana
23,1973-1974,1973-11-09,1974-04-05,148,2,55,217,272,79,195,274,546,23,171,IL - Pana
24,1974-1975,1974-11-30,1975-03-27,118,1,25,171,196,34,45,79,275,17,83,IL - Pana
25,1975-1976,1975-11-27,1976-03-17,112,6,39,191,230,41,53,94,324,14,93,IL - Pana
26,1976-1977,1976-11-28,1977-04-06,130,0,112,358,470,49,245,294,764,22,164,IL - Pana
27,1977-1978,1977-11-25,1978-03-27,123,6,124,397,521,92,433,525,1046,34,249,IL - Pana
28,1978-1979,1978-12-01,1979-03-25,115,3,109,342,451,54,365,419,870,24,207,IL - Pana
29,1979-1980,1979-11-29,1980-04-15,139,0,54,243,297,52,129,181,478,20,119,IL - Pana
30,1980-1981,1980-11-27,1981-03-05,99,0,42,207,249,38,67,105,354,13,99,IL - Pana
31,1981-1982,1981-11-21,1982-04-09,140,5,80,317,397,65,350,415,812,19,174,IL - Pana
32,1982-1983,1982-11-13,1983-04-18,157,4,18,162,180,30,30,60,240,14,69,IL - Pana
33,1983-1984,1983-12-01,1984-03-15,106,9,84,292,376,67,310,377,753,27,203,IL - Pana
34,1984-1985,1984-11-18,1985-02-28,103,0,57,279,336,25,122,147,483,16,119,IL - Pana
35,1985-1986,1985-12-01,1986-03-07,97,1,49,307,356,22,49,71,427,15,96,IL - Pana
36,1986-1987,1986-11-13,1987-02-28,108,3,22,194,216,34,99,133,349,11,77,IL - Pana
37,1987-1988,1987-12-01,1988-03-18,109,8,44,223,267,34,80,114,381,14,75,IL - Pana
38,1988-1989,1988-11-07,1989-03-10,124,6,38,244,282,51,96,147,429,19,129,IL - Pana
39,1989-1990,1989-10-20,1990-03-25,157,4,55,243,298,31,70,101,399,13,89,IL - Pana
40,1990-1991,1990-12-01,1991-03-14,104,1,35,189,224,37,109,146,370,15,97,IL - Pana
41,1991-1992,1991-11-03,1992-04-28,178,4,16,179,195,22,45,67,262,14,58,IL - Pana
42,1992-1993,1992-11-06,1993-04-02,148,4,33,232,265,52,126,178,443,20,95,IL - Pana
43,1993-1994,1993-10-31,1994-04-06,158,8,51,253,304,47,66,113,417,15,107,IL - Pana
49,1999-2000,1999-12-01,2000-04-08,130,16,40,196,236,31,53,84,320,10,80,IL - Pana
50,2000-2001,2000-11-18,2001-03-06,109,8,80,328,408,24,120,144,552,8,74,IL - Pana
55,2005-2006,2005-11-18,2006-03-24,127,5,30,213,243,30,49,79,322,10,67,IL - Pana
59,2009-2010,2009-12-01,2010-02-28,90,6,60,240,300,25,74,99,399,9,57,IL - Pana
60,2010-2011,2010-12-01,2011-02-28,90,4,65,240,305,32,143,175,480,12,77,IL - Pana
62,2012-2013,2012-12-01,2013-03-28,118,8,27,216,243,33,42,75,318,10,53,IL - Pana
63,2013-2014,2013-11-12,2014-03-25,134,4,91,446,537,53,149,202,739,18,152,IL - Pana
64,2014-2015,2014-11-13,2015-03-09,117,5,62,332,394,28,86,114,508,13,103,IL - Pana
65,2015-2016,2015-12-01,2016-02-29,91,4,26,155,181,12,20,32,213,5,31,IL - Pana
66,2016-2017,2016-12-01,2017-03-15,105,0,31,175,206,6,7,13,219,5,24,IL - Pana
67,2017-2018,2017-12-01,2018-04-09,130,5,58,279,337,7,13,20,357,5,25,IL - Pana
68,2018-2019,2018-11-10,2019-03-07,118,3,44,256,300,20,39,59,359,7,37,IL - Pana
69,2019-2020,2019-11-12,2020-02-29,110,2,24,181,205,19,41,60,265,8,39,IL - Pana
0,1950-1951,1950-11-10,1951-04-12,154,0,114,410,524,58,109,167,691,32,177,IL - Peoria
1,1951-1952,1951-11-02,1952-03-25,145,0,59,337,396,51,114,165,561,26,143,IL - Peoria
2,1952-1953,1952-11-27,1953-04-19,144,0,34,212,246,21,26,47,293,15,66,IL - Peoria
3,1953-1954,1953-11-26,1954-03-14,109,0,42,230,272,21,29,50,322,10,53,IL - Peoria
4,1954-1955,1954-11-01,1955-03-27,147,0,60,278,338,53,114,167,505,30,170,IL - Peoria
5,1955-1956,1955-11-02,1956-03-15,135,0,61,308,369,31,20,51,420,22,102,IL - Peoria
6,1956-1957,1956-11-21,1957-04-11,142,0,73,285,358,57,91,148,506,30,161,IL - Peoria
7,1957-1958,1957-11-21,1958-03-10,110,0,83,282,365,33,122,155,520,16,74,IL - Peoria
8,1958-1959,1958-11-26,1959-03-11,106,0,103,366,469,36,129,165,634,16,119,IL - Peoria
9,1959-1960,1959-11-06,1960-03-27,143,0,105,375,480,65,191,256,736,35,196,IL - Peoria
10,1960-1961,1960-11-09,1961-04-17,160,0,83,346,429,24,70,94,523,15,93,IL - Peoria
11,1961-1962,1961-11-19,1962-04-01,134,0,121,394,515,55,182,237,752,33,178,IL - Peoria
12,1962-1963,1962-12-01,1963-03-02,92,0,153,418,571,27,78,105,676,19,165,IL - Peoria
13,1963-1964,1963-11-30,1964-03-29,121,0,96,350,446,42,89,131,577,23,107,IL - Peoria
14,1964-1965,1964-11-19,1965-03-28,130,0,103,387,490,45,114,159,649,23,152,IL - Peoria
15,1965-1966,1965-11-18,1966-05-08,172,0,83,317,400,17,11,28,428,13,55,IL - Peoria
16,1966-1967,1966-12-01,1967-04-23,144,0,81,299,380,35,100,135,515,19,110,IL - Peoria
17,1967-1968,1967-10-26,1968-03-22,149,0,85,353,438,35,80,115,553,27,124,IL - Peoria
18,1968-1969,1968-11-11,1969-03-30,140,0,81,338,419,30,62,92,511,21,96,IL - Peoria
19,1969-1970,1969-11-14,1970-04-02,140,0,117,402,519,61,175,236,755,36,236,IL - Peoria
20,1970-1971,1970-11-23,1971-03-19,117,0,90,318,408,27,5,32,440,15,83,IL - Peoria
21,1971-1972,1971-11-08,1972-04-02,147,0,84,335,419,48,72,120,539,28,148,IL - Peoria
22,1972-1973,1972-10-18,1973-04-10,175,0,83,283,366,38,56,94,460,30,135,IL - Peoria
23,1973-1974,1973-11-08,1974-04-05,149,0,96,314,410,51,122,173,583,26,159,IL - Peoria
24,1974-1975,1974-11-13,1975-04-03,142,0,57,290,347,64,101,165,512,33,153,IL - Peoria
25,1975-1976,1975-11-12,1976-03-10,120,0,69,283,352,39,50,89,441,19,92,IL - Peoria
26,1976-1977,1976-11-04,1977-04-06,154,0,147,514,661,47,157,204,865,29,209,IL - Peoria
27,1977-1978,1977-11-10,1978-03-27,138,0,172,524,696,74,280,354,1050,38,275,IL - Peoria
28,1978-1979,1978-11-20,1979-03-26,127,0,168,474,642,80,471,551,1193,33,280,IL - Peoria
29,1979-1980,1979-11-10,1980-04-15,158,0,92,356,448,45,90,135,583,26,145,IL - Peoria
30,1980-1981,1980-11-27,1981-02-28,94,0,78,275,353,38,72,110,463,21,136,IL - Peoria
31,1981-1982,1981-11-19,1982-04-11,144,0,114,405,519,71,272,343,862,35,244,IL - Peoria
32,1982-1983,1982-11-05,1983-04-03,150,0,34,204,238,33,49,82,320,21,81,IL - Peoria
33,1983-1984,1983-11-13,1984-03-18,127,0,136,360,496,56,181,237,733,31,217,IL - Peoria
34,1984-1985,1984-12-01,1985-03-05,95,0,98,311,409,30,146,176,585,22,147,IL - Peoria
35,1985-1986,1985-11-20,1986-04-15,147,0,101,385,486,40,90,130,616,25,165,IL - Peoria
36,1986-1987,1986-11-11,1987-02-28,110,0,40,215,255,28,76,104,359,12,61,IL - Peoria
37,1987-1988,1987-11-29,1988-03-30,123,0,76,302,378,40,73,113,491,20,94,IL - Peoria
38,1988-1989,1988-11-06,1989-04-08,154,0,70,307,377,35,105,140,517,17,97,IL - Peoria
39,1989-1990,1989-10-19,1990-02-28,133,0,78,291,369,34,106,140,509,15,117,IL - Peoria
40,1990-1991,1990-12-01,1991-03-15,105,0,66,267,333,35,89,124,457,16,113,IL - Peoria
41,1991-1992,1991-11-02,1992-03-15,135,0,37,227,264,31,39,70,334,19,99,IL - Peoria
42,1992-1993,1992-11-03,1993-04-16,165,0,56,294,350,52,113,165,515,30,126,IL - Peoria
43,1993-1994,1993-11-06,1994-04-05,151,0,108,339,447,44,120,164,611,25,171,IL - Peoria
44,1994-1995,1994-12-01,1995-03-08,98,0,53,241,294,16,27,43,337,13,58,IL - Peoria
45,1995-1996,1995-11-11,1996-04-15,157,0,103,393,496,26,28,54,550,20,117,IL - Peoria
47,1997-1998,1997-11-02,1998-03-20,139,0,39,188,227,41,109,150,377,19,82,IL - Peoria
48,1998-1999,1998-11-07,1999-03-12,126,1,58,231,289,48,148,196,485,17,122,IL - Peoria
49,1999-2000,1999-12-01,2000-02-29,91,0,43,201,244,25,71,96,340,14,73,IL - Peoria
50,2000-2001,2000-11-17,2001-03-25,129,0,97,377,474,50,231,281,755,25,186,IL - Peoria
51,2001-2002,2001-12-01,2002-03-26,116,0,30,192,222,19,18,37,259,11,46,IL - Peoria
52,2002-2003,2002-11-25,2003-04-06,133,0,68,326,394,28,48,76,470,18,95,IL - Peoria
53,2003-2004,2003-11-24,2004-03-17,115,0,65,246,311,35,54,89,400,18,101,IL - Peoria
54,2004-2005,2004-11-24,2005-03-22,119,0,46,225,271,27,26,53,324,16,73,IL - Peoria
55,2005-2006,2005-11-17,2006-03-22,126,0,48,218,266,28,90,118,384,12,72,IL - Peoria
56,2006-2007,2006-11-30,2007-03-06,97,0,78,259,337,35,122,157,494,8,74,IL - Peoria
57,2007-2008,2007-12-01,2008-03-08,99,0,70,278,348,51,91,142,490,22,148,IL - Peoria
58,2008-2009,2008-11-21,2009-04-06,137,0,100,354,454,49,138,187,641,24,161,IL - Peoria
59,2009-2010,2009-12-01,2010-03-20,110,0,86,290,376,59,201,260,636,26,144,IL - Peoria
60,2010-2011,2010-12-01,2011-02-28,90,0,91,275,366,76,228,304,670,30,205,IL - Peoria
61,2011-2012,2011-12-01,2012-03-05,96,0,16,160,176,22,21,43,219,13,59,IL - Peoria
62,2012-2013,2012-11-24,2013-03-28,125,0,44,254,298,41,70,111,409,21,93,IL - Peoria
63,2013-2014,2013-11-11,2014-04-14,155,0,138,471,609,90,235,325,934,43,288,IL - Peoria
64,2014-2015,2014-11-12,2015-03-07,116,0,82,328,410,44,139,183,593,20,139,IL - Peoria
65,2015-2016,2015-11-21,2016-03-03,104,0,34,176,210,25,37,62,272,12,81,IL - Peoria
66,2016-2017,2016-12-01,2017-03-15,105,0,48,187,235,21,17,38,273,10,64,IL - Peoria
67,2017-2018,2017-12-01,2018-04-16,137,0,94,321,415,51,124,175,590,25,191,IL - Peoria
68,2018-2019,2018-11-08,2019-04-15,159,0,73,316,389,56,149,205,594,27,160,IL - Peoria
69,2019-2020,2019-10-29,2020-04-17,172,0,36,230,266,53,86,139,405,28,107,IL - Peoria
1,1951-1952,1951-11-02,1952-04-10,161,0,101,412,513,76,190,266,779,30,209,IL - Rockford
2,1952-1953,1952-11-27,1953-03-24,118,0,55,286,341,32,105,137,478,16,93,IL - Rockford
3,1953-1954,1953-11-26,1954-04-03,129,0,58,330,388,35,56,91,479,17,84,IL - Rockford
4,1954-1955,1954-11-01,1955-03-27,147,0,80,386,466,47,118,165,631,23,145,IL - Rockford
5,1955-1956,1955-11-17,1956-03-17,122,0,77,382,459,34,37,71,530,22,128,IL - Rockford
6,1956-1957,1956-11-22,1957-03-26,125,0,90,370,460,31,121,152,612,11,74,IL - Rockford
7,1957-1958,1957-11-21,1958-03-06,106,0,103,353,456,29,224,253,709,13,77,IL - Rockford
8,1958-1959,1958-11-23,1959-04-08,137,0,152,497,649,85,327,412,1061,41,317,IL - Rockford
9,1959-1960,1959-10-26,1960-03-28,155,0,110,430,540,85,401,486,1026,39,246,IL - Rockford
10,1960-1961,1960-11-29,1961-04-17,140,0,96,361,457,36,90,126,583,15,120,IL - Rockford
11,1961-1962,1961-11-19,1962-04-13,146,0,149,451,600,84,401,485,1085,45,268,IL - Rockford
12,1962-1963,1962-10-25,1963-03-26,153,0,185,522,707,56,185,241,948,34,288,IL - Rockford
13,1963-1964,1963-12-01,1964-04-01,123,0,111,422,533,65,203,268,801,28,159,IL - Rockford
14,1964-1965,1964-11-19,1965-03-30,132,0,137,472,609,73,189,262,871,37,240,IL - Rockford
15,1965-1966,1965-11-18,1966-05-11,175,3,106,412,518,33,147,180,698,18,110,IL - Rockford
16,1966-1967,1966-12-01,1967-04-24,145,0,96,391,487,59,206,265,752,28,178,IL - Rockford
17,1967-1968,1967-10-26,1968-04-24,182,0,95,414,509,25,41,66,575,22,127,IL - Rockford
18,1968-1969,1968-11-19,1969-03-31,133,0,103,372,475,35,125,160,635,16,94,IL - Rockford
19,1969-1970,1969-11-14,1970-04-03,141,0,137,460,597,63,299,362,959,34,233,IL - Rockford
20,1970-1971,1970-11-23,1971-04-03,132,0,127,398,525,53,170,223,748,29,145,IL - Rockford
21,1971-1972,1971-11-08,1972-04-08,153,0,108,424,532,63,135,198,730,35,179,IL - Rockford
22,1972-1973,1972-10-18,1973-04-12,177,0,81,319,400,41,115,156,556,25,122,IL - Rockford
23,1973-1974,1973-12-01,1974-03-24,114,0,106,337,443,75,259,334,777,34,217,IL - Rockford
24,1974-1975,1974-11-13,1975-04-07,146,0,81,388,469,77,206,283,752,39,204,IL - Rockford
25,1975-1976,1975-11-12,1976-04-04,145,0,88,394,482,39,171,210,692,26,131,IL - Rockford
26,1976-1977,1976-11-11,1977-04-05,146,0,209,599,808,53,237,290,1098,34,296,IL - Rockford
27,1977-1978,1977-11-21,1978-03-27,127,0,214,594,808,75,504,579,1387,35,272,IL - Rockford
28,1978-1979,1978-11-20,1979-04-28,160,0,209,580,789,109,786,895,1684,46,334,IL - Rockford
29,1979-1980,1979-11-09,1980-04-15,159,0,120,462,582,53,125,178,760,34,189,IL - Rockford
30,1980-1981,1980-10-27,1981-03-11,136,0,100,376,476,35,68,103,579,23,134,IL - Rockford
31,1981-1982,1981-11-19,1982-04-10,143,0,167,533,700,66,287,353,1053,37,310,IL - Rockford
32,1982-1983,1982-11-04,1983-03-27,144,0,53,284,337,45,103,148,485,26,115,IL - Rockford
33,1983-1984,1983-11-24,1984-04-22,151,0,169,458,627,66,307,373,1000,35,227,IL - Rockford
34,1984-1985,1984-11-19,1985-04-08,141,0,130,447,577,62,317,379,956,35,232,IL - Rockford
35,1985-1986,1985-11-20,1986-04-15,147,0,140,456,596,63,253,316,912,36,211,IL - Rockford
36,1986-1987,1986-11-10,1987-03-15,126,0,50,296,346,36,64,100,446,25,106,IL - Rockford
37,1987-1988,1987-11-20,1988-04-27,160,0,120,403,523,69,237,306,829,29,176,IL - Rockford
38,1988-1989,1988-11-06,1989-04-18,164,0,93,387,480,58,200,258,738,32,188,IL - Rockford
39,1989-1990,1989-10-19,1990-05-10,204,0,104,415,519,64,123,187,706,39,237,IL - Rockford
40,1990-1991,1990-11-09,1991-03-31,143,0,89,375,464,57,190,247,711,26,159,IL - Rockford
41,1991-1992,1991-11-02,1992-04-01,152,1,43,312,355,54,79,133,488,25,137,IL - Rockford
42,1992-1993,1992-10-19,1993-04-16,180,0,79,376,455,79,191,270,725,41,196,IL - Rockford
43,1993-1994,1993-11-05,1994-04-30,177,0,158,471,629,86,285,371,1000,43,332,IL - Rockford
44,1994-1995,1994-11-29,1995-03-23,115,0,97,307,404,51,217,268,672,20,130,IL - Rockford
45,1995-1996,1995-11-03,1996-03-26,145,0,157,482,639,45,87,132,771,27,191,IL - Rockford
50,2000-2001,2000-11-13,2001-04-17,156,14,141,486,627,60,387,447,1074,28,205,IL - Rockford
54,2004-2005,2004-11-24,2005-03-25,122,5,81,311,392,53,145,198,590,27,133,IL - Rockford
55,2005-2006,2005-11-16,2006-03-24,129,0,69,299,368,44,103,147,515,27,134,IL - Rockford
56,2006-2007,2006-11-10,2007-04-12,154,3,104,349,453,44,192,236,689,28,177,IL - Rockford
57,2007-2008,2007-11-21,2008-03-27,128,3,111,391,502,111,339,450,952,48,330,IL - Rockford
58,2008-2009,2008-11-17,2009-04-05,140,0,139,452,591,84,289,373,964,37,259,IL - Rockford
59,2009-2010,2009-11-26,2010-03-20,115,0,103,334,437,76,267,343,780,32,191,IL - Rockford
60,2010-2011,2010-12-01,2011-03-05,95,0,110,333,443,80,309,389,832,37,245,IL - Rockford
61,2011-2012,2011-12-01,2012-03-04,95,0,32,202,234,38,67,105,339,17,89,IL - Rockford
62,2012-2013,2012-12-01,2013-03-25,115,3,73,309,382,63,144,207,589,30,170,IL - Rockford
63,2013-2014,2013-11-11,2014-04-14,155,0,204,617,821,91,457,548,1369,48,391,IL - Rockford
64,2014-2015,2014-10-31,2015-03-25,146,0,138,454,592,59,230,289,881,28,233,IL - Rockford
65,2015-2016,2015-11-20,2016-04-08,141,0,63,231,294,41,97,138,432,26,129,IL - Rockford
66,2016-2017,2016-12-01,2017-03-15,105,0,68,240,308,36,90,126,434,17,91,IL - Rockford
67,2017-2018,2017-11-10,2018-04-19,161,0,116,421,537,56,124,180,717,32,219,IL - Rockford
68,2018-2019,2018-11-09,2019-04-28,171,0,120,402,522,85,213,298,820,34,273,IL - Rockford
69,2019-2020,2019-10-29,2020-04-17,172,0,44,282,326,57,119,176,502,32,128,IL - Rockford
8,1958-1959,1958-11-28,1959-02-28,93,5,41,241,282,13,14,27,309,4,26,IL - Salem
9,1959-1960,1959-11-17,1960-03-26,131,10,34,243,277,34,82,116,393,9,58,IL - Salem
10,1960-1961,1960-12-01,1961-04-15,136,0,33,232,265,18,41,59,324,9,55,IL - Salem
12,1962-1963,1962-12-01,1963-03-02,92,1,57,283,340,20,22,42,382,8,61,IL - Salem
13,1963-1964,1963-12-01,1964-03-10,101,0,42,238,280,25,73,98,378,7,51,IL - Salem
14,1964-1965,1964-11-21,1965-03-26,126,0,44,278,322,32,57,89,411,12,93,IL - Salem
15,1965-1966,1965-11-29,1966-03-06,98,1,36,203,239,14,31,45,284,1,18,IL - Salem
17,1967-1968,1967-12-01,1968-03-13,104,3,39,243,282,17,47,64,346,7,46,IL - Salem
18,1968-1969,1968-12-01,1969-03-11,101,0,26,200,226,13,10,23,249,4,22,IL - Salem
19,1969-1970,1969-12-01,1970-03-29,119,3,52,277,329,38,119,157,486,16,86,IL - Salem
20,1970-1971,1970-11-23,1971-04-07,136,1,33,233,266,17,16,33,299,4,24,IL - Salem
21,1971-1972,1971-11-23,1972-02-29,99,2,25,165,190,9,12,21,211,4,21,IL - Salem
22,1972-1973,1972-12-01,1973-04-09,130,3,33,163,196,5,3,8,204,3,10,IL - Salem
24,1974-1975,1974-12-01,1975-03-14,104,0,10,141,151,16,9,25,176,6,25,IL - Salem
25,1975-1976,1975-11-26,1976-02-29,96,1,23,166,189,25,32,57,246,9,47,IL - Salem
26,1976-1977,1976-11-24,1977-03-01,98,1,76,336,412,36,182,218,630,19,125,IL - Salem
27,1977-1978,1977-11-26,1978-03-17,112,0,85,355,440,47,222,269,709,22,129,IL - Salem
28,1978-1979,1978-12-01,1979-03-25,115,0,73,326,399,38,201,239,638,17,138,IL - Salem
29,1979-1980,1979-11-29,1980-03-13,106,1,33,220,253,21,76,97,350,10,61,IL - Salem
30,1980-1981,1980-12-01,1981-02-28,90,0,26,190,216,7,7,14,230,4,23,IL - Salem
33,1983-1984,1983-12-01,1984-03-21,112,6,74,258,332,43,96,139,471,15,97,IL - Salem
34,1984-1985,1984-11-18,1985-02-28,103,1,44,230,274,26,45,71,345,16,91,IL - Salem
35,1985-1986,1985-12-01,1986-02-28,90,5,39,217,256,12,15,27,283,6,44,IL - Salem
36,1986-1987,1986-11-13,1987-02-28,108,11,17,154,171,20,30,50,221,9,41,IL - Salem
37,1987-1988,1987-12-01,1988-03-18,109,1,34,228,262,16,14,30,292,8,48,IL - Salem
39,1989-1990,1989-12-01,1990-03-24,114,2,45,210,255,26,48,74,329,7,58,IL - Salem
40,1990-1991,1990-12-01,1991-02-28,90,5,20,134,154,16,67,83,237,5,36,IL - Salem
41,1991-1992,1991-11-03,1992-03-10,129,3,10,140,150,9,5,14,164,5,25,IL - Salem
42,1992-1993,1992-11-14,1993-03-14,121,1,23,192,215,29,56,85,300,7,50,IL - Salem
46,1996-1997,1996-12-01,1997-02-28,90,16,40,171,211,17,68,85,296,9,52,IL - Salem
47,1997-1998,1997-11-14,1998-03-13,120,19,16,113,129,17,11,28,157,7,30,IL - Salem
48,1998-1999,1998-12-01,1999-02-28,90,6,35,149,184,16,60,76,260,6,50,IL - Salem
49,1999-2000,1999-12-01,2000-03-14,105,8,20,172,192,18,16,34,226,3,32,IL - Salem
50,2000-2001,2000-11-22,2001-02-28,99,6,68,257,325,32,130,162,487,13,99,IL - Salem
51,2001-2002,2001-12-01,2002-03-05,95,1,20,146,166,11,7,18,184,6,28,IL - Salem
52,2002-2003,2002-12-01,2003-03-11,101,11,47,241,288,39,63,102,390,9,73,IL - Salem
53,2003-2004,2003-11-29,2004-02-29,93,2,39,184,223,14,18,32,255,8,56,IL - Salem
54,2004-2005,2004-12-01,2005-03-01,91,7,28,150,178,17,37,54,232,9,42,IL - Salem
55,2005-2006,2005-12-01,2006-03-22,112,9,21,159,180,22,20,42,222,9,47,IL - Salem
56,2006-2007,2006-12-01,2007-04-08,129,4,40,198,238,12,16,28,266,5,35,IL - Salem
57,2007-2008,2007-12-01,2008-03-09,100,15,36,214,250,21,36,57,307,10,49,IL - Salem
58,2008-2009,2008-12-01,2009-03-13,103,4,49,239,288,13,39,52,340,4,35,IL - Salem
59,2009-2010,2009-12-01,2010-02-28,90,0,55,217,272,13,24,37,309,5,30,IL - Salem
63,2013-2014,2013-11-25,2014-03-04,100,4,83,332,415,46,104,150,565,11,97,IL - Salem
64,2014-2015,2014-11-14,2015-03-08,115,15,57,282,339,18,74,92,431,8,63,IL - Salem
65,2015-2016,2015-12-01,2016-02-29,91,3,27,121,148,16,22,38,186,6,38,IL - Salem
66,2016-2017,2016-12-01,2017-03-15,105,2,38,175,213,2,2,4,217,2,16,IL - Salem
67,2017-2018,2017-12-01,2018-02-28,90,6,56,211,267,3,7,10,277,2,10,IL - Salem
68,2018-2019,2018-11-14,2019-03-07,114,2,40,207,247,14,18,32,279,5,43,IL - Salem
69,2019-2020,2019-11-12,2020-02-29,110,1,18,138,156,8,11,19,175,4,17,IL - Salem
0,1950-1951,1950-11-10,1951-04-16,158,0,93,354,447,48,85,133,580,29,166,IL - Springfield
1,1951-1952,1951-11-02,1952-03-08,128,0,45,261,306,46,76,122,428,25,129,IL - Springfield
2,1952-1953,1952-11-27,1953-04-18,143,0,26,166,192,24,24,48,240,11,57,IL - Springfield
3,1953-1954,1953-11-25,1954-03-14,110,0,31,203,234,12,11,23,257,9,32,IL - Springfield
4,1954-1955,1954-11-01,1955-03-28,148,0,39,235,274,26,28,54,328,20,95,IL - Springfield
5,1955-1956,1955-11-18,1956-03-16,120,0,42,274,316,38,59,97,413,24,112,IL - Springfield
6,1956-1957,1956-11-22,1957-04-11,141,0,50,241,291,28,34,62,353,18,86,IL - Springfield
7,1957-1958,1957-11-29,1958-03-11,103,0,62,235,297,22,12,34,331,15,56,IL - Springfield
8,1958-1959,1958-11-26,1959-03-16,111,0,80,297,377,18,43,61,438,13,70,IL - Springfield
9,1959-1960,1959-11-06,1960-03-27,143,0,75,331,406,60,206,266,672,27,169,IL - Springfield
10,1960-1961,1960-11-09,1961-04-17,160,0,65,304,369,31,87,118,487,14,99,IL - Springfield
11,1961-1962,1961-11-18,1962-04-13,147,0,84,315,399,67,108,175,574,35,189,IL - Springfield
12,1962-1963,1962-12-01,1963-03-06,96,0,114,369,483,37,90,127,610,20,151,IL - Springfield
13,1963-1964,1963-12-01,1964-03-29,120,0,70,319,389,54,111,165,554,23,114,IL - Springfield
14,1964-1965,1964-11-19,1965-03-27,129,0,83,329,412,59,95,154,566,26,182,IL - Springfield
15,1965-1966,1965-11-29,1966-03-07,99,0,62,238,300,24,27,51,351,13,61,IL - Springfield
16,1966-1967,1966-11-27,1967-04-23,148,0,59,244,303,25,27,52,355,16,72,IL - Springfield
17,1967-1968,1967-10-27,1968-03-21,147,0,74,315,389,45,97,142,531,23,123,IL - Springfield
18,1968-1969,1968-11-09,1969-03-30,142,0,66,303,369,37,60,97,466,16,87,IL - Springfield
19,1969-1970,1969-11-14,1970-04-02,140,0,94,331,425,46,119,165,590,34,173,IL - Springfield
20,1970-1971,1970-11-23,1971-04-06,135,0,61,278,339,25,19,44,383,18,71,IL - Springfield
21,1971-1972,1971-11-08,1972-03-30,144,0,59,246,305,35,55,90,395,19,106,IL - Springfield
22,1972-1973,1972-11-14,1973-04-10,148,0,57,233,290,24,16,40,330,20,79,IL - Springfield
23,1973-1974,1973-11-08,1974-04-05,149,0,75,263,338,59,135,194,532,24,135,IL - Springfield
24,1974-1975,1974-11-13,1975-04-03,142,0,33,214,247,48,46,94,341,26,103,IL - Springfield
25,1975-1976,1975-11-13,1976-03-16,125,0,45,225,270,41,44,85,355,19,76,IL - Springfield
26,1976-1977,1976-11-28,1977-04-06,130,0,121,412,533,59,197,256,789,29,213,IL - Springfield
27,1977-1978,1977-11-26,1978-03-27,122,0,142,452,594,82,297,379,973,37,266,IL - Springfield
28,1978-1979,1978-12-01,1979-03-25,115,0,134,397,531,48,254,302,833,25,200,IL - Springfield
29,1979-1980,1979-11-27,1980-04-15,141,0,62,279,341,50,95,145,486,23,128,IL - Springfield
30,1980-1981,1980-11-27,1981-03-04,98,0,52,238,290,27,41,68,358,13,84,IL - Springfield
31,1981-1982,1981-11-19,1982-04-09,142,0,104,379,483,72,217,289,772,27,216,IL - Springfield
32,1982-1983,1982-11-13,1983-04-17,156,0,32,185,217,18,11,29,246,15,55,IL - Springfield
33,1983-1984,1983-11-30,1984-03-18,110,0,124,333,457,54,160,214,671,25,204,IL - Springfield
34,1984-1985,1984-11-17,1985-02-28,104,0,79,296,375,26,105,131,506,18,105,IL - Springfield
35,1985-1986,1985-11-20,1986-04-15,147,0,74,319,393,36,47,83,476,19,113,IL - Springfield
36,1986-1987,1986-11-11,1987-02-28,110,0,35,190,225,33,66,99,324,11,67,IL - Springfield
37,1987-1988,1987-11-29,1988-03-18,111,0,62,251,313,34,76,110,423,16,79,IL - Springfield
38,1988-1989,1988-11-21,1989-03-09,109,0,57,253,310,36,92,128,438,15,101,IL - Springfield
39,1989-1990,1989-10-19,1990-03-24,157,0,64,268,332,20,40,60,392,17,107,IL - Springfield
40,1990-1991,1990-12-01,1991-03-14,104,0,57,216,273,33,61,94,367,19,126,IL - Springfield
41,1991-1992,1991-11-02,1992-03-14,134,0,27,185,212,21,25,46,258,16,69,IL - Springfield
42,1992-1993,1992-11-07,1993-04-01,146,0,42,223,265,50,82,132,397,25,111,IL - Springfield
43,1993-1994,1993-10-30,1994-04-06,159,0,78,290,368,31,54,85,453,23,120,IL - Springfield
44,1994-1995,1994-12-01,1995-03-08,98,0,41,200,241,17,27,44,285,11,50,IL - Springfield
45,1995-1996,1995-11-11,1996-03-20,131,0,90,341,431,34,76,110,541,16,108,IL - Springfield
46,1996-1997,1996-11-12,1997-03-15,124,0,79,275,354,31,84,115,469,11,75,IL - Springfield
47,1997-1998,1997-11-13,1998-03-20,128,0,29,158,187,34,36,70,257,21,76,IL - Springfield
48,1998-1999,1998-12-01,1999-03-12,102,0,47,199,246,44,114,158,404,13,113,IL - Springfield
49,1999-2000,1999-12-01,2000-03-12,103,0,26,193,219,26,49,75,294,12,66,IL - Springfield
50,2000-2001,2000-11-17,2001-03-16,120,0,84,339,423,24,139,163,586,17,118,IL - Springfield
51,2001-2002,2001-12-01,2002-03-26,116,0,22,181,203,18,14,32,235,8,34,IL - Springfield
52,2002-2003,2002-12-01,2003-03-10,100,0,63,276,339,40,63,103,442,16,103,IL - Springfield
53,2003-2004,2003-12-01,2004-03-17,108,0,51,219,270,26,57,83,353,18,99,IL - Springfield
54,2004-2005,2004-11-24,2005-03-11,108,0,36,176,212,28,28,56,268,15,65,IL - Springfield
55,2005-2006,2005-11-17,2006-03-23,127,0,39,206,245,35,59,94,339,13,74,IL - Springfield
56,2006-2007,2006-11-30,2007-03-03,94,0,58,221,279,36,109,145,424,13,88,IL - Springfield
57,2007-2008,2007-11-22,2008-03-23,123,0,50,256,306,61,63,124,430,24,142,IL - Springfield
58,2008-2009,2008-11-21,2009-04-06,137,0,57,276,333,30,34,64,397,18,102,IL - Springfield
59,2009-2010,2009-12-01,2010-02-28,90,0,67,248,315,36,115,151,466,21,103,IL - Springfield
60,2010-2011,2010-12-01,2011-02-28,90,0,67,243,310,52,160,212,522,21,142,IL - Springfield
61,2011-2012,2011-12-01,2012-03-05,96,0,9,131,140,15,16,31,171,9,38,IL - Springfield
62,2012-2013,2012-12-01,2013-03-28,118,0,31,219,250,49,55,104,354,16,80,IL - Springfield
63,2013-2014,2013-11-11,2014-04-14,155,0,102,441,543,65,171,236,779,30,196,IL - Springfield
64,2014-2015,2014-11-12,2015-03-08,117,0,60,311,371,50,106,156,527,20,150,IL - Springfield
65,2015-2016,2015-11-21,2016-03-01,102,0,30,147,177,23,43,66,243,12,69,IL - Springfield
66,2016-2017,2016-12-01,2017-03-15,105,0,31,154,185,17,14,31,216,8,45,IL - Springfield
67,2017-2018,2017-12-01,2018-04-09,130,0,67,283,350,20,40,60,410,12,85,IL - Springfield
68,2018-2019,2018-11-08,2019-04-14,158,0,58,292,350,46,89,135,485,16,95,IL - Springfield
69,2019-2020,2019-10-31,2020-04-16,169,0,29,205,234,43,58,101,335,19,80,IL - Springfield
0,1950-1951,1950-11-04,1951-04-01,149,1,100,369,469,73,233,306,775,24,174,IN - Angola
2,1952-1953,1952-11-28,1953-03-25,118,5,57,237,294,44,67,111,405,14,101,IN - Angola
3,1953-1954,1953-11-30,1954-04-04,126,3,60,281,341,48,94,142,483,15,106,IN - Angola
4,1954-1955,1954-11-02,1955-03-29,148,6,73,330,403,41,107,148,551,16,109,IN - Angola
5,1955-1956,1955-11-18,1956-04-08,143,0,73,382,455,47,121,168,623,24,135,IN - Angola
6,1956-1957,1956-11-24,1957-04-13,141,4,76,330,406,62,164,226,632,23,147,IN - Angola
7,1957-1958,1957-11-10,1958-03-25,136,0,89,326,415,38,153,191,606,19,95,IN - Angola
8,1958-1959,1958-11-27,1959-03-18,112,15,113,414,527,29,242,271,798,13,103,IN - Angola
9,1959-1960,1959-11-07,1960-04-05,151,0,93,360,453,58,199,257,710,30,159,IN - Angola
10,1960-1961,1960-11-30,1961-04-18,140,8,95,362,457,55,182,237,694,17,122,IN - Angola
11,1961-1962,1961-11-20,1962-03-18,119,6,117,367,484,61,276,337,821,28,192,IN - Angola
12,1962-1963,1962-10-25,1963-05-01,189,0,162,491,653,100,542,642,1295,45,328,IN - Angola
13,1963-1964,1963-11-02,1964-04-01,152,1,87,370,457,70,172,242,699,42,202,IN - Angola
14,1964-1965,1964-11-19,1965-04-02,135,1,112,404,516,88,186,274,790,45,268,IN - Angola
15,1965-1966,1965-11-19,1966-05-12,175,0,81,342,423,50,88,138,561,36,182,IN - Angola
16,1966-1967,1966-11-02,1967-04-24,174,1,87,374,461,92,285,377,838,47,261,IN - Angola
17,1967-1968,1967-09-30,1968-03-24,177,1,104,394,498,42,100,142,640,18,116,IN - Angola
27,1977-1978,1977-11-26,1978-03-26,121,0,158,594,752,84,586,670,1422,26,244,IN - Angola
28,1978-1979,1978-11-22,1979-04-07,137,0,143,469,612,39,260,299,911,26,172,IN - Angola
29,1979-1980,1979-11-28,1980-03-14,108,2,82,376,458,30,110,140,598,21,135,IN - Angola
30,1980-1981,1980-10-28,1981-03-21,145,0,105,457,562,45,294,339,901,22,142,IN - Angola
31,1981-1982,1981-11-21,1982-04-12,143,6,123,519,642,105,531,636,1278,33,317,IN - Angola
32,1982-1983,1982-11-06,1983-04-19,165,2,53,291,344,28,60,88,432,12,66,IN - Angola
33,1983-1984,1983-11-11,1984-03-23,134,0,149,474,623,73,381,454,1077,25,195,IN - Angola
34,1984-1985,1984-11-11,1985-04-09,150,9,96,393,489,38,185,223,712,23,153,IN - Angola
35,1985-1986,1985-11-21,1986-03-21,121,0,121,397,518,48,238,286,804,24,178,IN - Angola
36,1986-1987,1986-11-13,1987-03-15,123,3,57,301,358,50,180,230,588,18,120,IN - Angola
37,1987-1988,1987-11-21,1988-03-21,122,0,101,341,442,44,145,189,631,19,124,IN - Angola
39,1989-1990,1989-10-19,1990-04-12,176,1,92,366,458,43,134,177,635,26,156,IN - Angola
40,1990-1991,1990-12-01,1991-03-10,100,1,63,266,329,36,67,103,432,21,128,IN - Angola
41,1991-1992,1991-11-03,1992-04-03,153,2,53,326,379,40,113,153,532,19,116,IN - Angola
42,1992-1993,1992-10-20,1993-03-23,155,2,77,343,420,70,217,287,707,33,175,IN - Angola
43,1993-1994,1993-11-29,1994-04-07,130,0,141,454,595,62,289,351,946,24,211,IN - Angola
44,1994-1995,1994-12-01,1995-04-05,126,7,79,300,379,26,133,159,538,11,79,IN - Angola
45,1995-1996,1995-11-04,1996-04-16,165,0,139,500,639,63,123,186,825,33,233,IN - Angola
46,1996-1997,1996-11-03,1997-04-09,158,2,105,371,476,59,138,197,673,29,198,IN - Angola
47,1997-1998,1997-11-14,1998-03-21,128,1,44,210,254,29,65,94,348,14,67,IN - Angola
48,1998-1999,1998-12-01,1999-03-17,107,1,70,299,369,72,224,296,665,21,197,IN - Angola
49,1999-2000,1999-12-01,2000-04-08,130,0,68,314,382,40,154,194,576,22,151,IN - Angola
50,2000-2001,2000-11-17,2001-03-27,131,0,111,411,522,69,440,509,1031,37,251,IN - Angola
51,2001-2002,2001-12-01,2002-03-29,119,0,45,237,282,34,65,99,381,17,98,IN - Angola
52,2002-2003,2002-11-22,2003-04-08,138,0,112,429,541,61,195,256,797,29,205,IN - Angola
53,2003-2004,2003-11-25,2004-03-22,119,0,95,345,440,48,267,315,755,25,149,IN - Angola
54,2004-2005,2004-11-25,2005-04-24,151,0,84,359,443,71,207,278,721,30,203,IN - Angola
55,2005-2006,2005-11-18,2006-03-18,121,0,67,271,338,43,145,188,526,19,109,IN - Angola
56,2006-2007,2006-11-03,2007-04-15,164,1,101,358,459,45,174,219,678,21,144,IN - Angola
57,2007-2008,2007-11-24,2008-03-29,127,1,92,361,453,96,221,317,770,30,235,IN - Angola
58,2008-2009,2008-11-11,2009-04-07,148,3,115,457,572,75,243,318,890,31,234,IN - Angola
59,2009-2010,2009-11-27,2010-03-08,102,6,83,293,376,60,244,304,680,29,177,IN - Angola
60,2010-2011,2010-11-27,2011-03-06,100,0,103,352,455,81,299,380,835,34,261,IN - Angola
61,2011-2012,2011-11-11,2012-03-06,117,4,27,195,222,33,34,67,289,17,70,IN - Angola
62,2012-2013,2012-11-25,2013-04-20,147,0,71,297,368,43,112,155,523,25,153,IN - Angola
63,2013-2014,2013-11-12,2014-04-15,155,0,172,569,741,110,592,702,1443,37,334,IN - Angola
64,2014-2015,2014-11-13,2015-03-28,136,1,143,485,628,50,293,343,971,19,186,IN - Angola
65,2015-2016,2015-11-22,2016-04-10,141,0,41,231,272,53,77,130,402,22,144,IN - Angola
66,2016-2017,2016-11-21,2017-03-18,118,0,68,253,321,43,95,138,459,26,161,IN - Angola
67,2017-2018,2017-11-11,2018-04-19,160,0,109,392,501,61,183,244,745,40,280,IN - Angola
68,2018-2019,2018-11-09,2019-04-15,158,7,111,369,480,57,106,163,643,34,204,IN - Angola
69,2019-2020,2019-11-12,2020-04-18,159,8,44,257,301,52,102,154,455,31,153,IN - Angola
2,1952-1953,1952-11-30,1953-04-19,141,3,12,149,161,27,22,49,210,7,44,IN - Columbus
3,1953-1954,1953-12-01,1954-03-15,105,2,23,176,199,6,18,24,223,2,14,IN - Columbus
4,1954-1955,1954-11-03,1955-03-27,145,18,31,218,249,6,7,13,262,5,19,IN - Columbus
7,1957-1958,1957-12-01,1958-03-14,104,16,41,236,277,14,1,15,292,6,23,IN - Columbus
14,1964-1965,1964-11-22,1965-03-27,126,7,39,306,345,48,46,94,439,13,118,IN - Columbus
16,1966-1967,1966-11-03,1967-03-18,136,0,32,266,298,25,18,43,341,8,53,IN - Columbus
32,1982-1983,1982-11-25,1983-02-28,96,11,15,134,149,1,0,1,150,1,6,IN - Columbus
39,1989-1990,1989-10-19,1990-03-25,158,5,56,259,315,23,79,102,417,8,57,IN - Columbus
40,1990-1991,1990-12-01,1991-02-28,90,2,28,163,191,14,15,29,220,5,34,IN - Columbus
41,1991-1992,1991-11-04,1992-04-02,151,15,18,205,223,13,13,26,249,8,40,IN - Columbus
42,1992-1993,1992-11-28,1993-03-15,108,14,32,208,240,24,44,68,308,6,40,IN - Columbus
43,1993-1994,1993-10-30,1994-03-10,132,0,68,258,326,26,56,82,408,10,75,IN - Columbus
44,1994-1995,1994-12-01,1995-03-09,99,3,32,185,217,20,42,62,279,10,62,IN - Columbus
45,1995-1996,1995-12-01,1996-03-24,115,0,78,300,378,62,137,199,577,15,128,IN - Columbus
46,1996-1997,1996-11-14,1997-02-28,107,4,51,199,250,19,55,74,324,7,38,IN - Columbus
47,1997-1998,1997-12-01,1998-03-13,103,2,11,114,125,14,27,41,166,6,31,IN - Columbus
48,1998-1999,1998-12-01,1999-03-11,101,5,32,180,212,27,75,102,314,9,72,IN - Columbus
49,1999-2000,1999-12-01,2000-03-12,103,15,29,182,211,18,43,61,272,10,53,IN - Columbus
50,2000-2001,2000-11-21,2001-02-28,100,12,47,238,285,17,80,97,382,8,52,IN - Columbus
51,2001-2002,2001-12-01,2002-03-05,95,1,15,134,149,8,7,15,164,4,14,IN - Columbus
52,2002-2003,2002-12-01,2003-03-11,101,10,45,250,295,54,82,136,431,20,118,IN - Columbus
53,2003-2004,2003-11-25,2004-03-16,113,3,43,207,250,22,76,98,348,10,58,IN - Columbus
54,2004-2005,2004-12-01,2005-03-11,101,1,32,185,217,37,65,102,319,9,72,IN - Columbus
55,2005-2006,2005-11-24,2006-03-22,119,4,23,173,196,25,37,62,258,9,47,IN - Columbus
56,2006-2007,2006-12-01,2007-02-28,90,3,43,192,235,23,68,91,326,12,73,IN - Columbus
57,2007-2008,2007-12-01,2008-03-11,102,1,35,201,236,30,29,59,295,18,97,IN - Columbus
58,2008-2009,2008-11-23,2009-03-04,102,5,54,266,320,25,45,70,390,14,84,IN - Columbus
59,2009-2010,2009-12-01,2010-02-28,90,4,48,221,269,37,101,138,407,19,105,IN - Columbus
62,2012-2013,2012-12-01,2013-03-26,116,0,18,176,194,29,70,99,293,13,58,IN - Columbus
64,2014-2015,2014-11-17,2015-03-07,111,1,46,267,313,24,84,108,421,12,90,IN - Columbus
65,2015-2016,2015-12-01,2016-02-29,91,2,20,131,151,13,14,27,178,8,47,IN - Columbus
66,2016-2017,2016-12-01,2017-03-14,104,0,20,134,154,7,5,12,166,5,25,IN - Columbus
67,2017-2018,2017-12-01,2018-04-09,130,6,42,228,270,26,30,56,326,16,73,IN - Columbus
68,2018-2019,2018-11-28,2019-03-08,101,0,28,169,197,21,27,48,245,9,57,IN - Columbus
69,2019-2020,2019-11-12,2020-02-29,110,0,9,130,139,11,6,17,156,9,28,IN - Columbus
0,1950-1951,1950-11-23,1951-03-19,117,0,52,234,286,39,48,87,373,20,130,IN - Evansville
1,1951-1952,1951-11-02,1952-03-04,124,0,14,148,162,20,0,20,182,13,47,IN - Evansville
2,1952-1953,1952-11-28,1953-04-18,142,0,6,90,96,19,8,27,123,9,34,IN - Evansville
3,1953-1954,1953-12-01,1954-03-03,93,0,15,122,137,10,10,20,157,5,24,IN - Evansville
4,1954-1955,1954-12-01,1955-03-26,116,0,22,143,165,16,11,27,192,10,28,IN - Evansville
5,1955-1956,1955-11-28,1956-02-29,94,0,16,152,168,11,28,39,207,6,29,IN - Evansville
6,1956-1957,1956-11-22,1957-02-28,99,0,18,111,129,8,1,9,138,7,24,IN - Evansville
7,1957-1958,1957-12-01,1958-03-17,107,0,33,182,215,18,2,20,235,11,38,IN - Evansville
8,1958-1959,1958-11-28,1959-02-28,93,0,36,206,242,15,22,37,279,6,43,IN - Evansville
9,1959-1960,1959-11-17,1960-03-20,125,0,32,202,234,45,100,145,379,15,85,IN - Evansville
10,1960-1961,1960-12-01,1961-04-15,136,0,28,190,218,32,43,75,293,15,89,IN - Evansville
11,1961-1962,1961-11-19,1962-04-01,134,0,34,184,218,22,11,33,251,16,64,IN - Evansville
12,1962-1963,1962-12-01,1963-02-28,90,0,59,282,341,11,29,40,381,8,58,IN - Evansville
13,1963-1964,1963-12-01,1964-02-29,91,0,30,247,277,25,38,63,340,11,70,IN - Evansville
14,1964-1965,1964-11-20,1965-03-26,127,0,44,252,296,27,49,76,372,14,91,IN - Evansville
15,1965-1966,1965-11-29,1966-03-06,98,0,33,203,236,23,50,73,309,9,62,IN - Evansville
16,1966-1967,1966-11-02,1967-03-09,128,0,20,199,219,24,16,40,259,12,57,IN - Evansville
17,1967-1968,1967-12-01,1968-03-24,115,0,37,218,255,25,57,82,337,12,60,IN - Evansville
18,1968-1969,1968-11-19,1969-03-11,113,0,24,154,178,16,15,31,209,8,31,IN - Evansville
19,1969-1970,1969-11-14,1970-03-29,136,0,59,255,314,58,78,136,450,21,127,IN - Evansville
20,1970-1971,1970-11-23,1971-04-07,136,0,36,213,249,35,35,70,319,13,64,IN - Evansville
21,1971-1972,1971-11-06,1972-03-25,141,0,24,172,196,15,6,21,217,11,45,IN - Evansville
22,1972-1973,1972-11-21,1973-04-10,141,0,27,158,185,12,9,21,206,10,33,IN - Evansville
23,1973-1974,1973-12-01,1974-03-24,114,0,30,124,154,23,22,45,199,9,46,IN - Evansville
24,1974-1975,1974-12-01,1975-03-29,119,0,10,104,114,28,15,43,157,13,47,IN - Evansville
25,1975-1976,1975-11-26,1976-03-16,112,0,25,153,178,14,5,19,197,12,43,IN - Evansville
26,1976-1977,1976-11-28,1977-02-28,93,0,78,309,387,43,185,228,615,22,142,IN - Evansville
27,1977-1978,1977-11-26,1978-03-26,121,0,83,338,421,68,240,308,729,36,206,IN - Evansville
28,1978-1979,1978-12-01,1979-03-25,115,0,67,260,327,38,123,161,488,20,129,IN - Evansville
29,1979-1980,1979-11-29,1980-03-13,106,0,37,194,231,29,69,98,329,13,74,IN - Evansville
30,1980-1981,1980-11-27,1981-02-28,94,0,27,168,195,8,9,17,212,7,26,IN - Evansville
31,1981-1982,1981-11-20,1982-04-08,140,0,44,225,269,30,52,82,351,21,124,IN - Evansville
32,1982-1983,1982-12-01,1983-04-18,139,0,5,83,88,12,1,13,101,12,21,IN - Evansville
33,1983-1984,1983-12-01,1984-03-21,112,0,62,227,289,39,45,84,373,24,108,IN - Evansville
34,1984-1985,1984-12-01,1985-02-28,90,0,53,209,262,38,104,142,404,14,100,IN - Evansville
35,1985-1986,1985-12-01,1986-02-28,90,0,38,197,235,17,22,39,274,10,67,IN - Evansville
36,1986-1987,1986-11-13,1987-03-31,139,0,16,141,157,17,7,24,181,13,49,IN - Evansville
37,1987-1988,1987-12-01,1988-03-18,109,0,31,180,211,13,9,22,233,9,35,IN - Evansville
38,1988-1989,1988-12-01,1989-03-07,97,0,14,134,148,9,6,15,163,7,27,IN - Evansville
39,1989-1990,1989-10-19,1990-03-25,158,0,42,194,236,22,31,53,289,14,74,IN - Evansville
40,1990-1991,1990-12-01,1991-03-14,104,0,19,126,145,22,14,36,181,15,70,IN - Evansville
41,1991-1992,1991-11-03,1992-03-14,133,0,8,120,128,7,5,12,140,5,19,IN - Evansville
42,1992-1993,1992-11-14,1993-03-14,121,0,17,152,169,31,42,73,242,9,43,IN - Evansville
43,1993-1994,1993-10-29,1994-03-11,134,0,36,190,226,37,48,85,311,18,82,IN - Evansville
44,1994-1995,1994-12-01,1995-03-02,92,0,16,114,130,7,4,11,141,7,20,IN - Evansville
45,1995-1996,1995-11-11,1996-03-22,133,20,48,237,285,43,67,110,395,17,102,IN - Evansville
46,1996-1997,1996-12-01,1997-02-28,90,1,36,144,180,11,13,24,204,8,30,IN - Evansville
47,1997-1998,1997-12-01,1998-03-12,102,2,11,97,108,31,37,68,176,12,50,IN - Evansville
48,1998-1999,1998-12-01,1999-03-14,104,0,23,135,158,12,2,14,172,6,31,IN - Evansville
49,1999-2000,1999-12-01,2000-02-29,91,0,12,125,137,8,3,11,148,5,22,IN - Evansville
50,2000-2001,2000-11-17,2001-04-17,152,0,39,233,272,25,56,81,353,12,64,IN - Evansville
51,2001-2002,2001-12-01,2002-03-04,94,0,9,116,125,8,8,16,141,5,21,IN - Evansville
52,2002-2003,2002-12-01,2003-02-28,90,1,29,164,193,34,22,56,249,19,82,IN - Evansville
53,2003-2004,2003-11-28,2004-02-29,94,5,21,142,163,12,4,16,179,8,37,IN - Evansville
54,2004-2005,2004-12-01,2005-03-01,91,5,22,128,150,31,37,68,218,3,45,IN - Evansville
55,2005-2006,2005-12-01,2006-02-28,90,0,11,112,123,9,7,16,139,5,21,IN - Evansville
56,2006-2007,2006-12-01,2007-02-28,90,0,22,142,164,5,0,5,169,3,16,IN - Evansville
57,2007-2008,2007-12-01,2008-03-08,99,0,20,138,158,18,4,22,180,11,44,IN - Evansville
58,2008-2009,2008-12-01,2009-02-28,90,5,29,168,197,11,11,22,219,6,27,IN - Evansville
59,2009-2010,2009-12-01,2010-02-28,90,0,35,185,220,22,33,55,275,8,57,IN - Evansville
60,2010-2011,2010-12-01,2011-02-28,90,0,35,172,207,22,13,35,242,11,53,IN - Evansville
61,2011-2012,2011-11-29,2012-02-29,93,0,4,89,93,3,0,3,96,3,7,IN - Evansville
62,2012-2013,2012-12-01,2013-02-28,90,0,9,111,120,18,26,44,164,6,28,IN - Evansville
63,2013-2014,2013-11-27,2014-03-25,119,0,40,243,283,21,31,52,335,11,50,IN - Evansville
64,2014-2015,2014-11-13,2015-03-07,115,0,33,199,232,28,46,74,306,9,60,IN - Evansville
65,2015-2016,2015-12-01,2016-02-29,91,0,11,90,101,21,25,46,147,9,44,IN - Evansville
66,2016-2017,2016-12-01,2017-03-13,103,0,13,101,114,3,0,3,117,3,9,IN - Evansville
67,2017-2018,2017-12-01,2018-04-07,128,1,42,185,227,17,19,36,263,7,32,IN - Evansville
68,2018-2019,2018-11-13,2019-03-06,114,0,20,137,157,16,9,25,182,12,46,IN - Evansville
69,2019-2020,2019-11-11,2020-02-29,111,0,9,104,113,2,1,3,116,1,4,IN - Evansville
0,1950-1951,1950-11-03,1951-03-31,149,0,99,364,463,76,161,237,700,41,242,IN - Fort Wayne
1,1951-1952,1951-11-03,1952-04-06,156,0,55,289,344,55,98,153,497,30,153,IN - Fort Wayne
2,1952-1953,1952-10-28,1953-04-20,175,0,41,223,264,40,39,79,343,25,115,IN - Fort Wayne
3,1953-1954,1953-11-26,1954-03-30,125,0,36,221,257,43,28,71,328,24,99,IN - Fort Wayne
4,1954-1955,1954-10-30,1955-03-29,151,0,50,281,331,51,51,102,433,34,152,IN - Fort Wayne
5,1955-1956,1955-11-17,1956-04-24,160,0,49,332,381,64,100,164,545,35,144,IN - Fort Wayne
6,1956-1957,1956-11-21,1957-04-12,143,0,60,275,335,66,124,190,525,41,175,IN - Fort Wayne
7,1957-1958,1957-10-27,1958-04-07,163,0,64,286,350,32,33,65,415,29,99,IN - Fort Wayne
8,1958-1959,1958-11-27,1959-03-27,121,0,102,382,484,49,104,153,637,33,214,IN - Fort Wayne
9,1959-1960,1959-11-06,1960-04-09,156,0,72,335,407,59,121,180,587,37,174,IN - Fort Wayne
10,1960-1961,1960-11-06,1961-04-17,163,0,82,317,399,52,65,117,516,30,169,IN - Fort Wayne
11,1961-1962,1961-11-19,1962-04-13,146,0,94,331,425,53,103,156,581,32,180,IN - Fort Wayne
12,1962-1963,1962-10-25,1963-03-21,148,0,136,453,589,53,137,190,779,39,265,IN - Fort Wayne
13,1963-1964,1963-11-02,1964-03-30,150,0,83,342,425,82,140,222,647,43,218,IN - Fort Wayne
14,1964-1965,1964-11-19,1965-04-01,134,0,95,362,457,62,124,186,643,33,198,IN - Fort Wayne
15,1965-1966,1965-11-18,1966-04-06,140,0,66,274,340,29,28,57,397,23,116,IN - Fort Wayne
16,1966-1967,1966-11-02,1967-04-24,174,0,79,323,402,76,115,191,593,44,225,IN - Fort Wayne
17,1967-1968,1967-11-05,1968-04-24,172,0,96,386,482,46,107,153,635,29,167,IN - Fort Wayne
18,1968-1969,1968-12-01,1969-04-19,140,0,75,307,382,29,35,64,446,25,103,IN - Fort Wayne
19,1969-1970,1969-11-14,1970-04-02,140,0,110,385,495,64,160,224,719,41,217,IN - Fort Wayne
20,1970-1971,1970-11-14,1971-04-02,140,0,80,319,399,48,47,95,494,31,152,IN - Fort Wayne
21,1971-1972,1971-11-09,1972-04-08,152,0,66,308,374,48,49,97,471,36,145,IN - Fort Wayne
22,1972-1973,1972-10-18,1973-04-12,177,0,50,247,297,54,40,94,391,27,102,IN - Fort Wayne
23,1973-1974,1973-12-01,1974-04-08,129,0,76,289,365,64,168,232,597,30,179,IN - Fort Wayne
24,1974-1975,1974-10-19,1975-04-03,167,0,48,258,306,69,71,140,446,43,173,IN - Fort Wayne
25,1975-1976,1975-11-24,1976-03-17,115,0,58,246,304,44,117,161,465,20,102,IN - Fort Wayne
26,1976-1977,1976-11-04,1977-04-06,154,0,156,482,638,70,219,289,927,43,285,IN - Fort Wayne
27,1977-1978,1977-11-11,1978-04-21,162,0,158,513,671,95,499,594,1265,46,329,IN - Fort Wayne
28,1978-1979,1978-11-26,1979-03-26,121,0,123,371,494,55,216,271,765,33,197,IN - Fort Wayne
29,1979-1980,1979-11-27,1980-04-15,141,0,94,311,405,46,92,138,543,27,149,IN - Fort Wayne
30,1980-1981,1980-10-27,1981-03-20,145,0,85,319,404,62,178,240,644,32,170,IN - Fort Wayne
31,1981-1982,1981-11-20,1982-04-11,143,0,133,414,547,117,415,532,1079,47,352,IN - Fort Wayne
32,1982-1983,1982-11-29,1983-04-18,141,0,35,162,197,29,32,61,258,20,73,IN - Fort Wayne
33,1983-1984,1983-11-11,1984-04-17,159,0,119,365,484,79,248,327,811,40,237,IN - Fort Wayne
34,1984-1985,1984-11-11,1985-04-08,149,0,91,302,393,54,213,267,660,31,193,IN - Fort Wayne
35,1985-1986,1985-11-27,1986-04-15,140,0,94,325,419,55,123,178,597,34,180,IN - Fort Wayne
36,1986-1987,1986-11-11,1987-03-30,140,0,43,239,282,44,78,122,404,23,108,IN - Fort Wayne
37,1987-1988,1987-11-20,1988-03-20,122,0,76,299,375,57,86,143,518,31,160,IN - Fort Wayne
38,1988-1989,1988-11-06,1989-03-31,146,0,59,283,342,38,67,105,447,23,123,IN - Fort Wayne
39,1989-1990,1989-10-19,1990-02-28,133,0,66,254,320,43,66,109,429,28,174,IN - Fort Wayne
40,1990-1991,1990-12-01,1991-03-14,104,0,46,212,258,49,75,124,382,26,131,IN - Fort Wayne
41,1991-1992,1991-11-03,1992-04-01,151,0,34,229,263,44,64,108,371,29,134,IN - Fort Wayne
42,1992-1993,1992-10-20,1993-04-17,180,0,55,272,327,75,146,221,548,45,185,IN - Fort Wayne
43,1993-1994,1993-10-30,1994-04-07,160,0,90,338,428,70,114,184,612,38,233,IN - Fort Wayne
44,1994-1995,1994-11-01,1995-04-02,153,0,56,256,312,25,56,81,393,18,83,IN - Fort Wayne
45,1995-1996,1995-11-08,1996-04-06,151,0,97,385,482,69,176,245,727,42,243,IN - Fort Wayne
46,1996-1997,1996-11-09,1997-04-11,154,0,89,306,395,68,129,197,592,36,202,IN - Fort Wayne
47,1997-1998,1997-11-03,1998-03-21,139,0,29,175,204,28,18,46,250,21,73,IN - Fort Wayne
48,1998-1999,1998-12-01,1999-03-16,106,1,55,251,306,51,157,208,514,25,175,IN - Fort Wayne
49,1999-2000,1999-11-03,2000-04-08,158,0,59,267,326,52,123,175,501,32,170,IN - Fort Wayne
50,2000-2001,2000-11-14,2001-04-17,155,0,83,358,441,57,196,253,694,41,237,IN - Fort Wayne
51,2001-2002,2001-12-01,2002-03-29,119,0,23,178,201,32,32,64,265,21,91,IN - Fort Wayne
52,2002-2003,2002-11-15,2003-03-10,116,0,100,352,452,73,139,212,664,41,235,IN - Fort Wayne
53,2003-2004,2003-11-28,2004-03-17,111,0,78,270,348,61,122,183,531,34,204,IN - Fort Wayne
54,2004-2005,2004-11-24,2005-04-24,152,0,72,293,365,77,140,217,582,40,208,IN - Fort Wayne
55,2005-2006,2005-11-16,2006-03-26,131,0,53,232,285,51,92,143,428,31,140,IN - Fort Wayne
56,2006-2007,2006-12-01,2007-04-15,136,0,83,284,367,45,101,146,513,26,150,IN - Fort Wayne
57,2007-2008,2007-12-01,2008-03-22,113,0,68,283,351,72,115,187,538,40,218,IN - Fort Wayne
58,2008-2009,2008-11-16,2009-04-06,142,0,89,365,454,52,101,153,607,34,213,IN - Fort Wayne
59,2009-2010,2009-12-01,2010-02-28,90,0,66,224,290,56,91,147,437,37,184,IN - Fort Wayne
60,2010-2011,2010-12-01,2011-03-24,114,0,90,320,410,73,191,264,674,39,239,IN - Fort Wayne
61,2011-2012,2011-11-29,2012-03-04,97,0,24,153,177,53,40,93,270,30,127,IN - Fort Wayne
62,2012-2013,2012-10-30,2013-03-26,148,0,51,254,305,72,83,155,460,40,187,IN - Fort Wayne
63,2013-2014,2013-11-11,2014-04-15,156,0,139,477,616,120,252,372,988,53,397,IN - Fort Wayne
64,2014-2015,2014-11-13,2015-03-24,132,0,111,382,493,72,165,237,730,35,247,IN - Fort Wayne
65,2015-2016,2015-11-21,2016-04-09,141,0,41,195,236,46,21,67,303,36,164,IN - Fort Wayne
66,2016-2017,2016-11-19,2017-04-06,139,0,45,197,242,36,59,95,337,22,103,IN - Fort Wayne
67,2017-2018,2017-11-10,2018-04-19,161,0,87,312,399,64,93,157,556,45,252,IN - Fort Wayne
68,2018-2019,2018-11-09,2019-04-14,157,0,61,241,302,47,51,98,400,32,169,IN - Fort Wayne
69,2019-2020,2019-10-31,2020-04-17,170,0,22,224,246,44,44,88,334,28,95,IN - Fort Wayne
0,1950-1951,1950-11-10,1951-04-16,158,0,80,341,421,55,112,167,588,32,194,IN - Indianapolis
1,1951-1952,1951-11-03,1952-04-06,156,0,41,236,277,27,44,71,348,17,76,IN - Indianapolis
2,1952-1953,1952-11-27,1953-04-18,143,0,24,175,199,37,29,66,265,21,101,IN - Indianapolis
3,1953-1954,1953-11-25,1954-03-14,110,0,27,186,213,28,26,54,267,20,66,IN - Indianapolis
4,1954-1955,1954-11-01,1955-03-28,148,0,45,247,292,41,35,76,368,31,130,IN - Indianapolis
5,1955-1956,1955-11-18,1956-04-07,142,0,39,265,304,45,85,130,434,24,114,IN - Indianapolis
6,1956-1957,1956-11-21,1957-04-12,143,0,37,206,243,31,28,59,302,23,93,IN - Indianapolis
7,1957-1958,1957-12-01,1958-03-20,110,0,54,236,290,21,7,28,318,18,65,IN - Indianapolis
8,1958-1959,1958-11-27,1959-03-17,111,0,79,318,397,34,53,87,484,16,88,IN - Indianapolis
9,1959-1960,1959-11-11,1960-03-25,136,0,65,297,362,38,104,142,504,22,104,IN - Indianapolis
10,1960-1961,1960-11-30,1961-04-17,139,0,74,285,359,42,94,136,495,19,122,IN - Indianapolis
11,1961-1962,1961-11-19,1962-03-16,118,0,69,262,331,42,73,115,446,22,125,IN - Indianapolis
12,1962-1963,1962-10-25,1963-03-06,133,0,112,392,504,46,106,152,656,27,189,IN - Indianapolis
13,1963-1964,1963-11-13,1964-04-08,148,0,69,317,386,58,111,169,555,30,136,IN - Indianapolis
14,1964-1965,1964-11-19,1965-03-26,128,0,71,290,361,58,82,140,501,23,142,IN - Indianapolis
15,1965-1966,1965-11-29,1966-03-24,116,0,58,228,286,19,39,58,344,9,48,IN - Indianapolis
16,1966-1967,1966-11-02,1967-03-20,139,0,45,239,284,38,29,67,351,18,91,IN - Indianapolis
17,1967-1968,1967-11-20,1968-03-24,126,0,54,291,345,52,88,140,485,19,111,IN - Indianapolis
18,1968-1969,1968-11-18,1969-03-30,133,0,48,259,307,34,31,65,372,16,75,IN - Indianapolis
19,1969-1970,1969-11-14,1970-04-02,140,0,84,342,426,67,176,243,669,37,211,IN - Indianapolis
20,1970-1971,1970-11-14,1971-03-23,130,0,69,283,352,30,16,46,398,22,111,IN - Indianapolis
21,1971-1972,1971-11-06,1972-04-07,154,0,46,276,322,36,44,80,402,24,111,IN - Indianapolis
22,1972-1973,1972-11-19,1973-04-12,145,0,36,204,240,20,4,24,264,18,54,IN - Indianapolis
23,1973-1974,1973-11-08,1974-04-08,152,0,44,230,274,69,131,200,474,23,146,IN - Indianapolis
24,1974-1975,1974-11-30,1975-04-03,125,0,23,185,208,56,49,105,313,35,129,IN - Indianapolis
25,1975-1976,1975-11-21,1976-03-16,117,0,44,219,263,33,33,66,329,18,77,IN - Indianapolis
26,1976-1977,1976-11-21,1977-04-05,136,0,130,422,552,53,200,253,805,35,239,IN - Indianapolis
27,1977-1978,1977-11-10,1978-03-16,127,0,118,394,512,96,358,454,966,45,303,IN - Indianapolis
28,1978-1979,1978-12-01,1979-04-09,130,0,97,331,428,60,233,293,721,27,197,IN - Indianapolis
29,1979-1980,1979-11-28,1980-04-15,140,0,55,278,333,40,90,130,463,24,127,IN - Indianapolis
30,1980-1981,1980-11-17,1981-03-19,123,0,60,276,336,33,38,71,407,22,116,IN - Indianapolis
31,1981-1982,1981-11-20,1982-04-09,141,0,79,351,430,88,205,293,723,36,285,IN - Indianapolis
32,1982-1983,1982-11-13,1983-03-22,130,0,19,150,169,16,7,23,192,15,47,IN - Indianapolis
33,1983-1984,1983-11-11,1984-03-22,133,0,96,325,421,66,103,169,590,35,200,IN - Indianapolis
34,1984-1985,1984-11-18,1985-04-08,142,0,72,280,352,47,149,196,548,27,152,IN - Indianapolis
35,1985-1986,1985-12-01,1986-03-20,110,0,64,272,336,37,43,80,416,25,144,IN - Indianapolis
36,1986-1987,1986-11-13,1987-03-30,138,0,32,185,217,29,31,60,277,13,60,IN - Indianapolis
37,1987-1988,1987-12-01,1988-03-18,109,0,55,236,291,24,23,47,338,19,83,IN - Indianapolis
38,1988-1989,1988-11-06,1989-05-06,182,0,34,230,264,29,31,60,324,20,77,IN - Indianapolis
39,1989-1990,1989-10-18,1990-03-24,158,0,54,263,317,42,46,88,405,22,129,IN - Indianapolis
40,1990-1991,1990-12-01,1991-03-14,104,0,34,187,221,27,30,57,278,15,84,IN - Indianapolis
41,1991-1992,1991-11-03,1992-04-02,152,0,21,188,209,29,26,55,264,20,81,IN - Indianapolis
42,1992-1993,1992-10-20,1993-03-14,146,0,38,208,246,50,58,108,354,27,104,IN - Indianapolis
43,1993-1994,1993-10-30,1994-04-07,160,0,69,293,362,52,64,116,478,34,202,IN - Indianapolis
44,1994-1995,1994-12-01,1995-03-08,98,0,46,186,232,27,61,88,320,14,73,IN - Indianapolis
45,1995-1996,1995-11-05,1996-03-23,140,6,86,336,422,85,158,243,665,34,232,IN - Indianapolis
46,1996-1997,1996-11-13,1997-03-15,123,0,57,217,274,51,99,150,424,24,133,IN - Indianapolis
47,1997-1998,1997-11-13,1998-03-12,120,0,19,130,149,22,18,40,189,17,60,IN - Indianapolis
48,1998-1999,1998-12-01,1999-03-12,102,0,43,184,227,46,108,154,381,23,157,IN - Indianapolis
49,1999-2000,1999-12-01,2000-03-13,104,0,38,181,219,43,92,135,354,21,111,IN - Indianapolis
50,2000-2001,2000-11-17,2001-04-16,151,0,62,295,357,33,131,164,521,20,124,IN - Indianapolis
51,2001-2002,2001-12-01,2002-03-26,116,0,18,157,175,19,10,29,204,12,57,IN - Indianapolis
52,2002-2003,2002-11-22,2003-03-10,109,0,61,280,341,81,150,231,572,41,207,IN - Indianapolis
53,2003-2004,2003-11-28,2004-03-17,111,0,42,197,239,35,71,106,345,20,90,IN - Indianapolis
54,2004-2005,2004-11-25,2005-03-12,108,0,43,190,233,47,78,125,358,24,126,IN - Indianapolis
55,2005-2006,2005-11-17,2006-03-24,128,0,32,194,226,42,62,104,330,18,85,IN - Indianapolis
56,2006-2007,2006-12-01,2007-04-07,128,0,58,226,284,39,116,155,439,18,106,IN - Indianapolis
57,2007-2008,2007-12-01,2008-03-08,99,0,40,201,241,42,42,84,325,29,138,IN - Indianapolis
58,2008-2009,2008-11-30,2009-03-03,94,0,56,244,300,47,71,118,418,25,144,IN - Indianapolis
59,2009-2010,2009-12-01,2010-02-28,90,0,54,217,271,53,123,176,447,25,136,IN - Indianapolis
60,2010-2011,2010-12-01,2011-03-30,120,0,65,244,309,60,180,240,549,32,160,IN - Indianapolis
61,2011-2012,2011-11-29,2012-03-05,98,0,13,111,124,22,11,33,157,18,71,IN - Indianapolis
62,2012-2013,2012-11-12,2013-03-27,136,0,38,214,252,54,85,139,391,25,112,IN - Indianapolis
63,2013-2014,2013-11-11,2014-04-15,156,0,98,397,495,86,240,326,821,36,238,IN - Indianapolis
64,2014-2015,2014-10-31,2015-03-09,130,0,77,320,397,43,100,143,540,22,144,IN - Indianapolis
65,2015-2016,2015-11-21,2016-03-03,104,0,33,149,182,21,25,46,228,14,73,IN - Indianapolis
66,2016-2017,2016-12-01,2017-03-14,104,0,36,150,186,17,12,29,215,10,48,IN - Indianapolis
67,2017-2018,2017-12-01,2018-04-16,137,0,72,269,341,42,63,105,446,23,133,IN - Indianapolis
68,2018-2019,2018-11-14,2019-03-30,137,0,49,217,266,31,35,66,332,18,81,IN - Indianapolis
69,2019-2020,2019-11-11,2020-03-14,125,0,20,155,175,25,35,60,235,14,54,IN - Indianapolis
0,1950-1951,1950-11-10,1951-04-16,158,8,102,430,532,147,384,531,1063,41,365,IN - La Porte
1,1951-1952,1951-11-02,1952-04-05,156,7,57,345,402,167,360,527,929,31,296,IN - La Porte
2,1952-1953,1952-11-28,1953-04-19,143,8,25,226,251,68,79,147,398,16,124,IN - La Porte
3,1953-1954,1953-11-25,1954-05-04,161,1,35,258,293,122,172,294,587,29,203,IN - La Porte
4,1954-1955,1954-10-29,1955-03-29,152,0,50,308,358,121,236,357,715,27,244,IN - La Porte
5,1955-1956,1955-11-03,1956-03-30,149,1,37,316,353,93,231,324,677,23,165,IN - La Porte
6,1956-1957,1956-11-22,1957-04-11,141,5,59,280,339,87,241,328,667,24,169,IN - La Porte
7,1957-1958,1957-11-09,1958-03-20,132,0,65,271,336,165,404,569,905,40,334,IN - La Porte
8,1958-1959,1958-11-27,1959-03-17,111,0,99,372,471,156,505,661,1132,38,361,IN - La Porte
9,1959-1960,1959-11-06,1960-03-27,143,0,69,329,398,168,345,513,911,48,333,IN - La Porte
10,1960-1961,1960-11-06,1961-04-17,163,0,70,332,402,150,282,432,834,40,310,IN - La Porte
11,1961-1962,1961-11-19,1962-04-15,148,0,94,376,470,121,398,519,989,46,326,IN - La Porte
12,1962-1963,1962-10-23,1963-03-21,150,0,135,471,606,177,684,861,1467,48,455,IN - La Porte
13,1963-1964,1963-11-13,1964-03-31,140,0,70,352,422,109,306,415,837,41,273,IN - La Porte
14,1964-1965,1964-11-19,1965-04-01,134,0,90,354,444,132,275,407,851,51,372,IN - La Porte
15,1965-1966,1965-11-18,1966-05-11,175,8,70,312,382,85,204,289,671,35,217,IN - La Porte
18,1968-1969,1968-11-12,1969-03-30,139,1,63,302,365,102,212,314,679,21,168,IN - La Porte
25,1975-1976,1975-11-14,1976-03-13,121,2,57,241,298,79,208,287,585,30,194,IN - La Porte
27,1977-1978,1977-11-12,1978-03-22,131,1,141,460,601,179,616,795,1396,48,473,IN - La Porte
28,1978-1979,1978-11-26,1979-03-25,120,1,132,419,551,113,543,656,1207,41,330,IN - La Porte
29,1979-1980,1979-11-28,1980-04-24,149,8,68,308,376,77,204,281,657,31,215,IN - La Porte
30,1980-1981,1980-10-27,1981-03-19,144,19,91,307,398,113,336,449,847,42,303,IN - La Porte
31,1981-1982,1981-11-20,1982-04-11,143,6,120,412,532,150,553,703,1235,43,362,IN - La Porte
32,1982-1983,1982-11-26,1983-04-18,144,14,39,187,226,45,114,159,385,21,92,IN - La Porte
33,1983-1984,1983-11-11,1984-04-17,159,16,139,382,521,109,360,469,990,48,339,IN - La Porte
34,1984-1985,1984-11-19,1985-04-09,142,2,96,310,406,101,293,394,800,33,277,IN - La Porte
35,1985-1986,1985-11-20,1986-04-15,147,4,103,341,444,124,224,348,792,46,323,IN - La Porte
36,1986-1987,1986-11-11,1987-04-03,144,0,47,239,286,55,124,179,465,25,146,IN - La Porte
37,1987-1988,1987-11-20,1988-03-20,122,9,90,294,384,89,99,188,572,35,235,IN - La Porte
40,1990-1991,1990-12-01,1991-03-13,103,15,65,225,290,85,114,199,489,33,238,IN - La Porte
41,1991-1992,1991-11-02,1992-04-02,153,4,46,237,283,91,117,208,491,38,226,IN - La Porte
42,1992-1993,1992-10-20,1993-04-02,165,2,70,267,337,103,155,258,595,50,256,IN - La Porte
43,1993-1994,1993-10-30,1994-04-06,159,2,129,371,500,88,238,326,826,52,393,IN - La Porte
44,1994-1995,1994-11-30,1995-04-10,132,0,69,233,302,55,110,165,467,29,193,IN - La Porte
45,1995-1996,1995-11-03,1996-04-16,166,0,111,379,490,78,91,169,659,45,276,IN - La Porte
46,1996-1997,1996-11-09,1997-05-01,174,0,93,312,405,94,114,208,613,45,264,IN - La Porte
47,1997-1998,1997-10-26,1998-03-20,146,0,33,179,212,98,118,216,428,33,172,IN - La Porte
48,1998-1999,1998-12-01,1999-03-14,104,0,67,234,301,81,190,271,572,28,234,IN - La Porte
49,1999-2000,1999-11-29,2000-04-08,132,0,55,220,275,85,159,244,519,34,227,IN - La Porte
50,2000-2001,2000-10-08,2001-04-17,192,0,98,353,451,135,352,487,938,59,398,IN - La Porte
51,2001-2002,2001-12-01,2002-04-04,125,3,20,138,158,83,94,177,335,36,165,IN - La Porte
53,2003-2004,2003-12-01,2004-03-21,112,0,81,256,337,76,183,259,596,31,191,IN - La Porte
56,2006-2007,2006-10-23,2007-04-11,171,8,87,282,369,98,185,283,652,40,298,IN - La Porte
57,2007-2008,2007-11-22,2008-03-27,127,0,84,302,386,137,206,343,729,48,343,IN - La Porte
58,2008-2009,2008-11-16,2009-04-06,142,3,100,375,475,136,228,364,839,55,384,IN - La Porte
59,2009-2010,2009-12-01,2010-03-03,93,2,73,236,309,103,205,308,617,43,263,IN - La Porte
61,2011-2012,2011-12-01,2012-03-05,96,1,31,153,184,69,73,142,326,21,134,IN - La Porte
62,2012-2013,2012-11-24,2013-03-21,118,0,60,229,289,84,110,194,483,35,228,IN - La Porte
63,2013-2014,2013-11-11,2014-04-15,156,0,166,506,672,173,350,523,1195,52,482,IN - La Porte
64,2014-2015,2014-11-13,2015-03-27,135,0,128,380,508,93,259,352,860,32,299,IN - La Porte
65,2015-2016,2015-11-21,2016-04-09,141,1,53,217,270,89,123,212,482,25,211,IN - La Porte
66,2016-2017,2016-12-01,2017-03-15,105,0,62,206,268,64,124,188,456,19,160,IN - La Porte
67,2017-2018,2017-11-10,2018-04-19,161,6,100,329,429,201,210,411,840,47,471,IN - La Porte
68,2018-2019,2018-11-09,2019-04-27,170,0,102,318,420,77,61,138,558,31,220,IN - La Porte
69,2019-2020,2019-11-11,2020-04-17,159,0,34,217,251,55,54,109,360,28,130,IN - La Porte
4,1954-1955,1954-12-01,1955-03-29,119,0,53,274,327,29,70,99,426,14,103,IN - Lafayette
5,1955-1956,1955-11-03,1956-04-07,157,0,45,356,401,50,98,148,549,21,102,IN - Lafayette
6,1956-1957,1956-11-22,1957-04-12,142,1,56,284,340,29,72,101,441,16,94,IN - Lafayette
7,1957-1958,1957-11-10,1958-03-20,131,0,65,283,348,15,10,25,373,10,43,IN - Lafayette
8,1958-1959,1958-11-27,1959-03-18,112,0,92,378,470,29,58,87,557,15,99,IN - Lafayette
9,1959-1960,1959-11-07,1960-03-27,142,1,73,362,435,40,167,207,642,19,123,IN - Lafayette
10,1960-1961,1960-11-30,1961-04-17,139,1,75,319,394,35,149,184,578,15,102,IN - Lafayette
11,1961-1962,1961-11-19,1962-03-15,117,3,85,321,406,37,77,114,520,15,100,IN - Lafayette
12,1962-1963,1962-12-01,1963-03-09,99,0,126,441,567,34,107,141,708,18,140,IN - Lafayette
13,1963-1964,1963-12-01,1964-03-30,121,1,79,380,459,55,164,219,678,22,122,IN - Lafayette
14,1964-1965,1964-11-20,1965-03-27,128,0,87,345,432,38,89,127,559,15,104,IN - Lafayette
15,1965-1966,1965-11-29,1966-03-25,117,1,66,289,355,15,22,37,392,8,45,IN - Lafayette
16,1966-1967,1966-11-03,1967-03-20,138,0,70,335,405,30,53,83,488,16,89,IN - Lafayette
17,1967-1968,1967-11-23,1968-03-24,123,0,73,356,429,35,130,165,594,19,124,IN - Lafayette
18,1968-1969,1968-11-20,1969-03-31,132,0,77,327,404,18,51,69,473,11,62,IN - Lafayette
19,1969-1970,1969-11-15,1970-04-03,140,0,100,408,508,34,137,171,679,19,127,IN - Lafayette
20,1970-1971,1970-11-24,1971-03-24,121,0,83,325,408,18,23,41,449,12,67,IN - Lafayette
21,1971-1972,1971-11-08,1972-04-08,153,1,71,331,402,21,43,64,466,12,78,IN - Lafayette
22,1972-1973,1972-11-22,1973-03-17,116,0,52,241,293,14,11,25,318,10,37,IN - Lafayette
23,1973-1974,1973-11-10,1974-03-25,136,0,71,293,364,53,149,202,566,18,145,IN - Lafayette
24,1974-1975,1974-11-14,1975-04-03,141,2,45,259,304,43,52,95,399,22,98,IN - Lafayette
25,1975-1976,1975-11-25,1976-03-17,114,0,59,253,312,38,61,99,411,14,78,IN - Lafayette
26,1976-1977,1976-11-23,1977-03-22,120,3,162,482,644,46,183,229,873,24,200,IN - Lafayette
27,1977-1978,1977-11-27,1978-03-26,120,0,162,532,694,70,432,502,1196,30,227,IN - Lafayette
28,1978-1979,1978-11-29,1979-04-09,132,1,139,441,580,37,210,247,827,23,199,IN - Lafayette
29,1979-1980,1979-11-11,1980-03-14,125,0,74,329,403,28,79,107,510,16,98,IN - Lafayette
30,1980-1981,1980-11-27,1981-03-20,114,0,75,325,400,27,84,111,511,11,77,IN - Lafayette
31,1981-1982,1981-11-22,1982-04-11,141,8,119,433,552,77,239,316,868,27,232,IN - Lafayette
32,1982-1983,1982-11-06,1983-03-25,140,6,40,207,247,15,16,31,278,11,48,IN - Lafayette
33,1983-1984,1983-12-01,1984-03-22,113,0,145,406,551,66,286,352,903,30,240,IN - Lafayette
34,1984-1985,1984-11-18,1985-02-28,103,1,89,312,401,23,126,149,550,16,112,IN - Lafayette
35,1985-1986,1985-11-21,1986-03-21,121,3,79,334,413,25,66,91,504,16,109,IN - Lafayette
36,1986-1987,1986-11-11,1987-02-28,110,0,39,222,261,36,91,127,388,13,83,IN - Lafayette
37,1987-1988,1987-11-21,1988-03-18,119,4,70,293,363,31,74,105,468,11,61,IN - Lafayette
38,1988-1989,1988-11-06,1989-04-09,155,11,57,294,351,21,51,72,423,11,55,IN - Lafayette
39,1989-1990,1989-10-19,1990-02-28,133,6,66,279,345,34,71,105,450,13,80,IN - Lafayette
40,1990-1991,1990-12-01,1991-03-14,104,17,58,250,308,28,57,85,393,13,87,IN - Lafayette
41,1991-1992,1991-11-03,1992-04-02,152,5,29,240,269,25,40,65,334,15,72,IN - Lafayette
42,1992-1993,1992-11-28,1993-03-18,111,0,58,282,340,31,108,139,479,12,66,IN - Lafayette
47,1997-1998,1997-12-01,1998-03-13,103,11,21,147,168,7,11,18,186,3,14,IN - Lafayette
48,1998-1999,1998-12-01,1999-03-16,106,6,54,240,294,42,160,202,496,9,94,IN - Lafayette
49,1999-2000,1999-12-01,2000-03-13,104,16,49,241,290,43,118,161,451,10,89,IN - Lafayette
51,2001-2002,2001-12-01,2002-03-29,119,11,28,187,215,16,31,47,262,6,34,IN - Lafayette
52,2002-2003,2002-11-27,2003-03-11,105,17,85,338,423,55,153,208,631,18,131,IN - Lafayette
53,2003-2004,2003-11-25,2004-03-16,113,19,63,257,320,27,58,85,405,14,80,IN - Lafayette
54,2004-2005,2004-11-25,2005-03-13,109,19,54,226,280,37,73,110,390,16,88,IN - Lafayette
55,2005-2006,2005-11-17,2006-03-22,126,7,40,238,278,20,61,81,359,9,42,IN - Lafayette
56,2006-2007,2006-12-01,2007-04-15,136,9,79,291,370,41,123,164,534,8,87,IN - Lafayette
57,2007-2008,2007-12-01,2008-03-09,100,13,69,263,332,50,102,152,484,15,128,IN - Lafayette
58,2008-2009,2008-11-22,2009-03-13,112,10,87,319,406,26,87,113,519,11,83,IN - Lafayette
59,2009-2010,2009-12-01,2010-03-06,96,1,73,297,370,45,195,240,610,19,118,IN - Lafayette
62,2012-2013,2012-11-05,2013-03-28,144,0,43,264,307,32,78,110,417,9,55,IN - Lafayette
63,2013-2014,2013-11-12,2014-03-29,138,11,123,464,587,88,231,319,906,27,223,IN - Lafayette
64,2014-2015,2014-11-13,2015-03-09,117,0,99,360,459,42,129,171,630,9,87,IN - Lafayette
65,2015-2016,2015-11-22,2016-03-04,104,0,48,188,236,23,38,61,297,6,51,IN - Lafayette
66,2016-2017,2016-12-01,2017-03-16,106,0,48,186,234,15,15,30,264,7,46,IN - Lafayette
67,2017-2018,2017-12-01,2018-04-09,130,0,92,327,419,39,114,153,572,14,105,IN - Lafayette
68,2018-2019,2018-11-14,2019-03-08,115,0,65,265,330,30,63,93,423,12,92,IN - Lafayette
69,2019-2020,2019-11-01,2020-03-23,144,0,29,210,239,27,46,73,312,13,53,IN - Lafayette
0,1950-1951,1950-11-23,1951-03-25,123,7,40,252,292,87,96,183,475,25,176,IN - Oolitic
1,1951-1952,1951-11-04,1952-03-02,120,17,18,176,194,28,13,41,235,11,57,IN - Oolitic
2,1952-1953,1952-11-28,1953-04-18,142,4,8,133,141,33,18,51,192,14,61,IN - Oolitic
3,1953-1954,1953-12-01,1954-03-04,94,0,12,144,156,18,23,41,197,4,30,IN - Oolitic
4,1954-1955,1954-11-01,1955-03-26,146,1,17,188,205,35,10,45,250,22,91,IN - Oolitic
5,1955-1956,1955-11-19,1956-03-16,119,2,15,202,217,37,47,84,301,14,71,IN - Oolitic
6,1956-1957,1956-11-23,1957-03-08,106,0,15,150,165,19,18,37,202,11,44,IN - Oolitic
7,1957-1958,1957-12-01,1958-03-20,110,2,33,214,247,25,11,36,283,12,46,IN - Oolitic
8,1958-1959,1958-11-28,1959-03-17,110,2,40,272,312,40,35,75,387,13,78,IN - Oolitic
9,1959-1960,1959-11-28,1960-03-17,111,0,28,201,229,43,95,138,367,12,74,IN - Oolitic
10,1960-1961,1960-11-10,1961-04-16,158,4,31,243,274,54,56,110,384,18,109,IN - Oolitic
11,1961-1962,1961-12-01,1962-04-01,122,2,33,215,248,47,34,81,329,17,101,IN - Oolitic
12,1962-1963,1962-12-01,1963-03-06,96,0,49,301,350,44,54,98,448,20,111,IN - Oolitic
14,1964-1965,1964-11-20,1965-03-27,128,3,43,319,362,53,80,133,495,17,144,IN - Oolitic
15,1965-1966,1965-11-30,1966-03-08,99,0,41,237,278,35,62,97,375,14,82,IN - Oolitic
16,1966-1967,1966-11-02,1967-03-18,137,0,34,298,332,30,23,53,385,12,75,IN - Oolitic
17,1967-1968,1967-12-01,1968-03-24,115,3,46,306,352,35,72,107,459,16,99,IN - Oolitic
18,1968-1969,1968-11-19,1969-03-26,128,0,37,281,318,13,11,24,342,10,37,IN - Oolitic
19,1969-1970,1969-11-15,1970-04-04,141,1,65,351,416,68,206,274,690,30,195,IN - Oolitic
20,1970-1971,1970-11-24,1971-03-20,117,0,54,286,340,25,42,67,407,12,77,IN - Oolitic
21,1971-1972,1971-11-07,1972-03-06,121,0,34,249,283,23,31,54,337,13,73,IN - Oolitic
22,1972-1973,1972-12-01,1973-04-11,132,0,32,201,233,9,12,21,254,6,24,IN - Oolitic
23,1973-1974,1973-12-01,1974-03-25,115,0,41,217,258,29,54,83,341,11,77,IN - Oolitic
24,1974-1975,1974-12-01,1975-03-26,116,0,18,185,203,18,18,36,239,9,46,IN - Oolitic
25,1975-1976,1975-11-25,1976-03-16,113,0,33,226,259,15,23,38,297,10,39,IN - Oolitic
26,1976-1977,1976-11-29,1977-03-01,93,2,104,400,504,39,220,259,763,17,128,IN - Oolitic
27,1977-1978,1977-11-27,1978-03-26,120,1,104,444,548,71,335,406,954,26,207,IN - Oolitic
28,1978-1979,1978-12-01,1979-03-26,116,0,81,373,454,56,174,230,684,18,168,IN - Oolitic
29,1979-1980,1979-11-29,1980-03-14,107,0,37,276,313,27,80,107,420,13,80,IN - Oolitic
30,1980-1981,1980-11-18,1981-03-20,123,0,51,325,376,13,15,28,404,9,49,IN - Oolitic
31,1981-1982,1981-11-21,1982-04-08,139,0,65,375,440,35,116,151,591,13,104,IN - Oolitic
32,1982-1983,1982-12-01,1983-03-22,112,1,14,170,184,8,3,11,195,7,23,IN - Oolitic
33,1983-1984,1983-12-01,1984-03-13,104,8,82,299,381,26,29,55,436,19,118,IN - Oolitic
34,1984-1985,1984-11-18,1985-02-28,103,0,65,294,359,30,128,158,517,17,119,IN - Oolitic
35,1985-1986,1985-12-01,1986-03-21,111,7,45,297,342,14,18,32,374,8,61,IN - Oolitic
36,1986-1987,1986-12-01,1987-03-31,121,1,21,196,217,14,8,22,239,8,36,IN - Oolitic
37,1987-1988,1987-11-21,1988-03-18,119,3,44,281,325,13,10,23,348,8,45,IN - Oolitic
39,1989-1990,1989-10-19,1990-03-26,159,2,46,296,342,26,63,89,431,10,73,IN - Oolitic
40,1990-1991,1990-12-01,1991-02-28,90,0,24,184,208,18,13,31,239,8,51,IN - Oolitic
41,1991-1992,1991-11-04,1992-04-02,151,2,16,233,249,11,3,14,263,8,40,IN - Oolitic
42,1992-1993,1992-11-15,1993-03-15,121,2,28,247,275,32,48,80,355,12,60,IN - Oolitic
43,1993-1994,1993-10-30,1994-03-10,132,20,71,301,372,27,43,70,442,12,65,IN - Oolitic
46,1996-1997,1996-12-01,1997-02-28,90,15,53,207,260,16,40,56,316,11,56,IN - Oolitic
47,1997-1998,1997-11-15,1998-03-13,119,15,12,150,162,26,26,52,214,15,62,IN - Oolitic
48,1998-1999,1998-12-01,1999-03-15,105,4,25,191,216,29,62,91,307,15,91,IN - Oolitic
49,1999-2000,1999-12-01,2000-03-12,103,13,23,193,216,18,21,39,255,11,50,IN - Oolitic
50,2000-2001,2000-11-18,2001-02-28,103,18,53,287,340,49,112,161,501,24,168,IN - Oolitic
51,2001-2002,2001-12-01,2002-03-05,95,3,16,169,185,15,11,26,211,8,49,IN - Oolitic
52,2002-2003,2002-12-01,2003-03-07,97,2,43,247,290,60,130,190,480,24,144,IN - Oolitic
53,2003-2004,2003-11-25,2004-02-29,97,0,32,210,242,24,59,83,325,10,62,IN - Oolitic
54,2004-2005,2004-12-01,2005-03-12,102,2,26,195,221,41,68,109,330,14,83,IN - Oolitic
55,2005-2006,2005-11-18,2006-03-22,125,3,19,212,231,28,32,60,291,10,56,IN - Oolitic
56,2006-2007,2006-12-01,2007-04-08,129,0,40,240,280,17,14,31,311,10,57,IN - Oolitic
57,2007-2008,2007-12-01,2008-03-10,101,0,37,227,264,30,32,62,326,12,74,IN - Oolitic
58,2008-2009,2008-12-01,2009-03-03,93,3,52,258,310,31,57,88,398,17,114,IN - Oolitic
59,2009-2010,2009-12-01,2010-02-28,90,1,43,237,280,42,94,136,416,16,102,IN - Oolitic
60,2010-2011,2010-12-01,2011-03-27,117,0,53,249,302,32,68,100,402,21,98,IN - Oolitic
61,2011-2012,2011-11-30,2012-03-05,97,0,12,146,158,11,3,14,172,8,36,IN - Oolitic
62,2012-2013,2012-11-25,2013-03-26,122,4,28,234,262,39,80,119,381,17,83,IN - Oolitic
63,2013-2014,2013-11-25,2014-03-26,122,6,79,383,462,39,95,134,596,21,141,IN - Oolitic
64,2014-2015,2014-11-14,2015-03-08,115,0,55,327,382,29,106,135,517,12,90,IN - Oolitic
65,2015-2016,2015-12-01,2016-02-29,91,0,26,162,188,18,25,43,231,10,70,IN - Oolitic
66,2016-2017,2016-12-01,2017-03-15,105,1,30,165,195,3,6,9,204,3,18,IN - Oolitic
67,2017-2018,2017-12-01,2018-04-09,130,0,59,288,347,32,44,76,423,19,113,IN - Oolitic
68,2018-2019,2018-11-15,2019-03-08,114,0,41,207,248,18,16,34,282,13,65,IN - Oolitic
69,2019-2020,2019-11-12,2020-02-29,110,1,13,155,168,15,7,22,190,9,29,IN - Oolitic
0,1950-1951,1950-11-11,1951-04-16,157,0,95,394,489,92,205,297,786,51,323,IN - South Bend
1,1951-1952,1951-11-02,1952-04-06,157,0,64,330,394,118,213,331,725,48,304,IN - South Bend
2,1952-1953,1952-10-28,1953-04-20,175,0,39,234,273,61,59,120,393,39,175,IN - South Bend
3,1953-1954,1953-11-25,1954-05-04,161,0,42,267,309,105,135,240,549,46,252,IN - South Bend
4,1954-1955,1954-10-29,1955-03-28,151,0,59,305,364,104,191,295,659,42,261,IN - South Bend
5,1955-1956,1955-11-03,1956-04-18,168,0,59,352,411,91,143,234,645,54,267,IN - South Bend
6,1956-1957,1956-11-21,1957-04-11,142,0,67,295,362,96,192,288,650,50,271,IN - South Bend
7,1957-1958,1957-11-09,1958-03-25,137,0,75,294,369,114,308,422,791,50,342,IN - South Bend
8,1958-1959,1958-11-27,1959-03-27,121,0,117,398,515,134,419,553,1068,56,448,IN - South Bend
9,1959-1960,1959-11-06,1960-04-09,156,0,82,347,429,145,287,432,861,68,402,IN - South Bend
10,1960-1961,1960-11-06,1961-04-18,164,0,88,328,416,111,196,307,723,46,310,IN - South Bend
11,1961-1962,1961-11-17,1962-04-15,150,0,100,362,462,96,269,365,827,56,364,IN - South Bend
12,1962-1963,1962-10-23,1963-04-30,190,0,158,463,621,144,546,690,1311,63,515,IN - South Bend
13,1963-1964,1963-11-02,1964-04-08,159,0,81,336,417,126,237,363,780,69,384,IN - South Bend
14,1964-1965,1964-11-19,1965-04-01,134,0,104,348,452,134,248,382,834,64,426,IN - South Bend
15,1965-1966,1965-10-23,1966-05-11,201,0,76,294,370,108,189,297,667,55,327,IN - South Bend
16,1966-1967,1966-11-01,1967-04-24,175,0,77,304,381,159,458,617,998,61,366,IN - South Bend
17,1967-1968,1967-10-26,1968-04-24,182,0,95,334,429,106,264,370,799,52,333,IN - South Bend
18,1968-1969,1968-11-08,1969-03-30,143,0,85,309,394,115,233,348,742,57,330,IN - South Bend
19,1969-1970,1969-11-13,1970-04-05,144,0,100,376,476,137,326,463,939,69,452,IN - South Bend
20,1970-1971,1970-11-23,1971-04-03,132,0,86,319,405,123,249,372,777,57,363,IN - South Bend
21,1971-1972,1971-11-07,1972-04-08,154,0,67,294,361,127,211,338,699,63,330,IN - South Bend
22,1972-1973,1972-10-18,1973-04-12,177,0,45,223,268,82,139,221,489,43,202,IN - South Bend
23,1973-1974,1973-11-09,1974-04-23,166,0,60,253,313,96,168,264,577,46,280,IN - South Bend
24,1974-1975,1974-10-19,1975-04-06,170,0,36,227,263,108,162,270,533,55,227,IN - South Bend
25,1975-1976,1975-11-13,1976-05-03,173,0,50,271,321,107,301,408,729,48,271,IN - South Bend
26,1976-1977,1976-10-19,1977-04-06,170,0,138,439,577,194,546,740,1317,80,614,IN - South Bend
27,1977-1978,1977-10-16,1978-03-21,157,0,139,445,584,240,769,1009,1593,62,577,IN - South Bend
28,1978-1979,1978-11-21,1979-04-07,138,0,120,373,493,149,533,682,1175,62,430,IN - South Bend
29,1979-1980,1979-11-08,1980-04-14,159,0,63,267,330,101,160,261,591,47,278,IN - South Bend
30,1980-1981,1980-10-25,1981-03-20,147,0,58,271,329,125,300,425,754,50,304,IN - South Bend
31,1981-1982,1981-10-23,1982-04-10,170,0,115,413,528,195,429,624,1152,66,508,IN - South Bend
32,1982-1983,1982-11-12,1983-04-17,157,0,31,179,210,57,80,137,347,36,133,IN - South Bend
33,1983-1984,1983-11-11,1984-04-03,145,0,134,360,494,120,325,445,939,56,404,IN - South Bend
34,1984-1985,1984-11-19,1985-04-09,142,0,83,302,385,132,275,407,792,53,369,IN - South Bend
35,1985-1986,1985-11-22,1986-04-15,145,0,96,340,436,129,228,357,793,56,377,IN - South Bend
36,1986-1987,1986-11-11,1987-04-03,144,0,45,254,299,82,133,215,514,34,195,IN - South Bend
37,1987-1988,1987-11-19,1988-03-20,123,0,84,312,396,95,140,235,631,49,315,IN - South Bend
38,1988-1989,1988-10-24,1989-04-18,177,0,62,294,356,72,77,149,505,42,213,IN - South Bend
39,1989-1990,1989-10-19,1990-04-12,176,0,73,310,383,113,182,295,678,46,291,IN - South Bend
40,1990-1991,1990-12-01,1991-03-28,118,0,56,221,277,90,124,214,491,37,235,IN - South Bend
41,1991-1992,1991-11-03,1992-04-02,152,0,39,234,273,99,132,231,504,45,246,IN - South Bend
42,1992-1993,1992-10-20,1993-04-17,180,0,61,271,332,125,169,294,626,56,281,IN - South Bend
43,1993-1994,1993-09-29,1994-04-06,190,0,124,388,512,89,202,291,803,51,381,IN - South Bend
44,1994-1995,1994-11-30,1995-04-10,132,0,66,252,318,77,132,209,527,35,228,IN - South Bend
45,1995-1996,1995-11-04,1996-04-26,175,0,105,401,506,92,130,222,728,55,337,IN - South Bend
46,1996-1997,1996-11-02,1997-04-17,167,0,93,337,430,116,138,254,684,47,323,IN - South Bend
47,1997-1998,1997-10-27,1998-03-21,146,1,36,194,230,83,119,202,432,31,166,IN - South Bend
48,1998-1999,1998-12-01,1999-03-16,106,0,65,262,327,105,212,317,644,30,282,IN - South Bend
49,1999-2000,1999-11-03,2000-04-08,158,0,49,239,288,86,149,235,523,36,232,IN - South Bend
50,2000-2001,2000-11-17,2001-04-17,152,0,94,366,460,107,304,411,871,44,309,IN - South Bend
51,2001-2002,2001-12-01,2002-04-04,125,0,36,193,229,96,90,186,415,37,214,IN - South Bend
52,2002-2003,2002-11-22,2003-04-07,137,0,95,341,436,89,100,189,625,44,282,IN - South Bend
53,2003-2004,2003-11-28,2004-03-16,110,0,73,257,330,79,122,201,531,40,241,IN - South Bend
54,2004-2005,2004-11-24,2005-04-24,152,0,66,289,355,112,157,269,624,43,283,IN - South Bend
55,2005-2006,2005-11-17,2006-03-16,120,0,55,221,276,60,100,160,436,33,183,IN - South Bend
56,2006-2007,2006-10-12,2007-04-11,182,0,87,296,383,98,147,245,628,47,314,IN - South Bend
57,2007-2008,2007-11-22,2008-03-28,128,0,82,307,389,110,171,281,670,52,330,IN - South Bend
58,2008-2009,2008-10-27,2009-04-06,162,0,106,407,513,116,256,372,885,56,386,IN - South Bend
59,2009-2010,2009-12-01,2010-03-02,92,0,69,233,302,88,216,304,606,38,227,IN - South Bend
60,2010-2011,2010-11-05,2011-03-23,139,0,93,317,410,151,319,470,880,52,364,IN - South Bend
61,2011-2012,2011-12-01,2012-03-05,96,0,27,154,181,71,64,135,316,23,131,IN - South Bend
62,2012-2013,2012-11-24,2013-03-26,123,0,52,227,279,87,147,234,513,36,218,IN - South Bend
64,2014-2015,2014-10-31,2015-03-27,148,0,109,379,488,124,349,473,961,47,398,IN - South Bend
65,2015-2016,2015-11-21,2016-04-10,142,0,54,242,296,104,144,248,544,38,266,IN - South Bend
66,2016-2017,2016-11-19,2017-04-06,139,1,61,231,292,66,99,165,457,35,213,IN - South Bend
67,2017-2018,2017-11-10,2018-04-19,161,0,102,361,463,133,241,374,837,52,419,IN - South Bend
68,2018-2019,2018-11-09,2019-04-27,170,0,93,331,424,69,113,182,606,40,233,IN - South Bend
69,2019-2020,2019-10-31,2020-04-17,170,0,28,222,250,70,79,149,399,35,148,IN - South Bend
0,1950-1951,1950-11-10,1951-04-04,146,3,158,508,666,86,448,534,1200,31,257,IA - Cedar Rapids
1,1951-1952,1951-11-02,1952-04-14,165,0,104,427,531,74,270,344,875,33,215,IA - Cedar Rapids
2,1952-1953,1952-11-25,1953-03-10,106,0,58,276,334,45,131,176,510,25,147,IA - Cedar Rapids
3,1953-1954,1953-11-23,1954-04-03,132,0,58,334,392,56,103,159,551,23,121,IA - Cedar Rapids
4,1954-1955,1954-11-01,1955-03-27,147,0,77,366,443,42,129,171,614,28,177,IA - Cedar Rapids
5,1955-1956,1955-11-07,1956-04-08,154,1,85,464,549,33,103,136,685,24,140,IA - Cedar Rapids
7,1957-1958,1957-11-18,1958-03-20,123,8,97,337,434,33,165,198,632,18,74,IA - Cedar Rapids
8,1958-1959,1958-11-26,1959-04-20,146,0,137,484,621,71,345,416,1037,26,185,IA - Cedar Rapids
9,1959-1960,1959-11-05,1960-03-28,145,0,113,448,561,91,436,527,1088,27,189,IA - Cedar Rapids
10,1960-1961,1960-11-29,1961-04-17,140,0,73,339,412,31,56,87,499,15,97,IA - Cedar Rapids
11,1961-1962,1961-12-01,1962-04-01,122,0,154,439,593,84,557,641,1234,34,242,IA - Cedar Rapids
12,1962-1963,1962-12-01,1963-03-13,103,2,166,442,608,53,214,267,875,27,242,IA - Cedar Rapids
13,1963-1964,1963-11-23,1964-03-30,129,0,95,390,485,46,137,183,668,25,118,IA - Cedar Rapids
14,1964-1965,1964-11-20,1965-03-29,130,0,142,476,618,65,168,233,851,27,211,IA - Cedar Rapids
15,1965-1966,1965-11-18,1966-05-11,175,0,107,398,505,26,115,141,646,19,110,IA - Cedar Rapids
16,1966-1967,1966-12-01,1967-04-23,144,0,81,355,436,45,164,209,645,19,124,IA - Cedar Rapids
17,1967-1968,1967-10-26,1968-03-22,149,0,87,381,468,21,72,93,561,16,99,IA - Cedar Rapids
18,1968-1969,1968-11-08,1969-03-31,144,0,112,423,535,45,261,306,841,24,131,IA - Cedar Rapids
19,1969-1970,1969-11-14,1970-04-02,140,1,128,478,606,73,362,435,1041,29,216,IA - Cedar Rapids
20,1970-1971,1970-11-23,1971-03-23,121,3,129,434,563,52,251,303,866,18,109,IA - Cedar Rapids
21,1971-1972,1971-11-08,1972-04-07,152,0,104,436,540,76,195,271,811,26,187,IA - Cedar Rapids
22,1972-1973,1972-10-18,1973-04-13,178,0,107,369,476,70,190,260,736,21,150,IA - Cedar Rapids
23,1973-1974,1973-12-01,1974-03-30,120,2,113,372,485,42,174,216,701,23,158,IA - Cedar Rapids
24,1974-1975,1974-11-13,1975-04-09,148,1,80,412,492,93,275,368,860,32,187,IA - Cedar Rapids
25,1975-1976,1975-11-21,1976-04-25,157,2,54,348,402,27,33,60,462,12,63,IA - Cedar Rapids
26,1976-1977,1976-10-19,1977-04-05,169,0,164,595,759,33,134,167,926,21,171,IA - Cedar Rapids
27,1977-1978,1977-11-10,1978-03-26,137,0,182,599,781,80,459,539,1320,36,288,IA - Cedar Rapids
28,1978-1979,1978-11-20,1979-04-04,136,0,212,568,780,90,632,722,1502,45,360,IA - Cedar Rapids
29,1979-1980,1979-11-09,1980-04-14,158,2,93,398,491,44,85,129,620,24,140,IA - Cedar Rapids
30,1980-1981,1980-10-27,1981-02-28,125,0,79,338,417,27,42,69,486,16,109,IA - Cedar Rapids
31,1981-1982,1981-11-19,1982-04-10,143,1,154,520,674,64,342,406,1080,34,286,IA - Cedar Rapids
32,1982-1983,1982-11-04,1983-04-09,157,3,44,289,333,40,91,131,464,18,87,IA - Cedar Rapids
33,1983-1984,1983-11-13,1984-04-22,162,3,155,461,616,70,343,413,1029,35,238,IA - Cedar Rapids
34,1984-1985,1984-11-30,1985-03-31,122,0,107,385,492,38,193,231,723,20,130,IA - Cedar Rapids
35,1985-1986,1985-11-20,1986-04-15,147,0,145,490,635,64,428,492,1127,31,218,IA - Cedar Rapids
36,1986-1987,1986-10-13,1987-03-30,169,2,43,293,336,29,35,64,400,13,63,IA - Cedar Rapids
37,1987-1988,1987-12-01,1988-03-15,106,1,106,359,465,41,155,196,661,17,126,IA - Cedar Rapids
38,1988-1989,1988-11-06,1989-03-18,133,1,72,368,440,26,42,68,508,18,126,IA - Cedar Rapids
39,1989-1990,1989-11-18,1990-02-28,103,0,79,316,395,31,79,110,505,17,111,IA - Cedar Rapids
40,1990-1991,1990-11-05,1991-03-16,132,0,98,371,469,57,174,231,700,25,159,IA - Cedar Rapids
41,1991-1992,1991-11-01,1992-04-13,165,2,50,304,354,53,89,142,496,27,133,IA - Cedar Rapids
42,1992-1993,1992-11-06,1993-04-16,162,0,99,382,481,69,204,273,754,38,181,IA - Cedar Rapids
43,1993-1994,1993-10-30,1994-04-30,183,4,161,460,621,55,271,326,947,31,249,IA - Cedar Rapids
44,1994-1995,1994-11-29,1995-04-10,133,0,95,319,414,42,157,199,613,17,105,IA - Cedar Rapids
45,1995-1996,1995-10-31,1996-04-29,182,0,135,493,628,56,161,217,845,28,195,IA - Cedar Rapids
46,1996-1997,1996-11-11,1997-05-01,172,1,127,424,551,87,192,279,830,39,266,IA - Cedar Rapids
47,1997-1998,1997-10-26,1998-03-15,141,0,59,252,311,64,154,218,529,33,149,IA - Cedar Rapids
48,1998-1999,1998-11-08,1999-03-13,126,2,82,286,368,42,193,235,603,22,164,IA - Cedar Rapids
49,1999-2000,1999-10-03,2000-04-08,189,4,57,299,356,43,137,180,536,24,134,IA - Cedar Rapids
50,2000-2001,2000-11-13,2001-03-25,133,4,143,464,607,63,463,526,1133,28,224,IA - Cedar Rapids
51,2001-2002,2001-12-01,2002-04-01,122,0,45,240,285,32,48,80,365,15,87,IA - Cedar Rapids
52,2002-2003,2002-11-24,2003-04-08,136,0,80,383,463,37,68,105,568,18,111,IA - Cedar Rapids
53,2003-2004,2003-11-24,2004-03-17,115,1,70,306,376,38,167,205,581,19,125,IA - Cedar Rapids
54,2004-2005,2004-11-29,2005-03-23,115,0,64,283,347,41,144,185,532,21,107,IA - Cedar Rapids
55,2005-2006,2005-11-15,2006-03-16,122,0,68,285,353,55,160,215,568,22,154,IA - Cedar Rapids
56,2006-2007,2006-10-12,2007-04-11,182,10,97,370,467,33,194,227,694,15,99,IA - Cedar Rapids
57,2007-2008,2007-11-21,2008-04-04,136,1,137,457,594,93,484,577,1171,40,274,IA - Cedar Rapids
58,2008-2009,2008-11-21,2009-03-29,129,0,134,473,607,68,251,319,926,27,203,IA - Cedar Rapids
59,2009-2010,2009-12-01,2010-03-20,110,0,129,381,510,62,451,513,1023,24,171,IA - Cedar Rapids
60,2010-2011,2010-12-01,2011-04-16,137,0,123,388,511,61,271,332,843,23,156,IA - Cedar Rapids
61,2011-2012,2011-11-09,2012-03-05,118,1,31,223,254,37,94,131,385,20,103,IA - Cedar Rapids
62,2012-2013,2012-11-24,2013-03-25,122,2,68,342,410,42,196,238,648,14,82,IA - Cedar Rapids
63,2013-2014,2013-11-11,2014-03-25,135,0,190,585,775,67,481,548,1323,35,302,IA - Cedar Rapids
64,2014-2015,2014-11-12,2015-03-09,118,0,127,424,551,38,214,252,803,17,137,IA - Cedar Rapids
65,2015-2016,2015-11-20,2016-03-03,105,0,68,232,300,29,123,152,452,18,97,IA - Cedar Rapids
66,2016-2017,2016-12-01,2017-03-15,105,0,65,254,319,25,70,95,414,12,68,IA - Cedar Rapids
67,2017-2018,2017-11-10,2018-04-19,161,9,117,435,552,67,148,215,767,32,246,IA - Cedar Rapids
69,2019-2020,2019-10-29,2020-04-17,172,0,65,321,386,60,158,218,604,31,165,IA - Cedar Rapids
2,1952-1953,1952-11-26,1953-03-07,102,19,45,280,325,41,106,147,472,12,90,IA - Clarinda
3,1953-1954,1953-12-01,1954-03-30,120,1,38,313,351,9,11,20,371,5,27,IA - Clarinda
4,1954-1955,1954-12-01,1955-03-27,117,1,55,343,398,43,158,201,599,14,118,IA - Clarinda
5,1955-1956,1955-11-16,1956-03-12,118,3,72,398,470,28,78,106,576,13,93,IA - Clarinda
6,1956-1957,1956-11-16,1957-04-12,148,0,67,375,442,55,114,169,611,16,131,IA - Clarinda
7,1957-1958,1957-10-26,1958-03-11,137,7,68,336,404,45,148,193,597,19,98,IA - Clarinda
8,1958-1959,1958-11-27,1959-03-18,112,0,86,383,469,40,121,161,630,16,119,IA - Clarinda
9,1959-1960,1959-11-05,1960-04-30,178,0,97,478,575,82,394,476,1051,26,196,IA - Clarinda
10,1960-1961,1960-11-30,1961-04-01,123,0,42,359,401,32,46,78,479,14,80,IA - Clarinda
11,1961-1962,1961-11-16,1962-04-01,137,0,133,481,614,77,438,515,1129,18,163,IA - Clarinda
12,1962-1963,1962-11-19,1963-03-11,113,0,122,431,553,34,110,144,697,14,131,IA - Clarinda
13,1963-1964,1963-12-01,1964-03-27,118,2,77,354,431,39,89,128,559,13,114,IA - Clarinda
14,1964-1965,1964-11-21,1965-03-26,126,0,91,449,540,50,93,143,683,16,152,IA - Clarinda
15,1965-1966,1965-11-28,1966-03-06,99,0,67,293,360,5,3,8,368,3,19,IA - Clarinda
16,1966-1967,1966-11-02,1967-04-24,174,0,58,392,450,24,72,96,546,7,60,IA - Clarinda
17,1967-1968,1967-12-01,1968-03-22,113,0,69,312,381,20,96,116,497,5,60,IA - Clarinda
20,1970-1971,1970-11-23,1971-03-25,123,0,95,386,481,56,317,373,854,10,92,IA - Clarinda
21,1971-1972,1971-11-23,1972-03-31,130,3,67,349,416,23,45,68,484,9,69,IA - Clarinda
22,1972-1973,1972-11-14,1973-04-10,148,0,88,350,438,51,156,207,645,12,113,IA - Clarinda
23,1973-1974,1973-12-01,1974-03-23,113,0,79,319,398,53,200,253,651,12,142,IA - Clarinda
24,1974-1975,1974-11-29,1975-04-03,126,0,56,363,419,68,156,224,643,13,128,IA - Clarinda
25,1975-1976,1975-11-25,1976-03-05,102,1,40,269,309,35,53,88,397,8,66,IA - Clarinda
26,1976-1977,1976-11-12,1977-02-28,109,0,103,446,549,22,96,118,667,8,77,IA - Clarinda
27,1977-1978,1977-11-21,1978-03-18,118,3,150,510,660,38,259,297,957,12,127,IA - Clarinda
28,1978-1979,1978-11-19,1979-04-02,135,1,176,523,699,52,331,383,1082,14,159,IA - Clarinda
29,1979-1980,1979-11-28,1980-03-14,108,0,69,344,413,43,110,153,566,12,103,IA - Clarinda
30,1980-1981,1980-10-28,1981-03-05,129,4,49,323,372,21,57,78,450,5,54,IA - Clarinda
32,1982-1983,1982-11-04,1983-03-28,145,4,39,252,291,21,54,75,366,5,40,IA - Clarinda
33,1983-1984,1983-11-24,1984-03-21,119,8,125,399,524,67,244,311,835,18,184,IA - Clarinda
34,1984-1985,1984-12-01,1985-04-01,122,13,64,336,400,38,81,119,519,8,85,IA - Clarinda
35,1985-1986,1985-11-20,1986-04-15,147,5,90,366,456,34,131,165,621,10,91,IA - Clarinda
36,1986-1987,1986-11-11,1987-03-30,140,10,25,283,308,18,20,38,346,6,41,IA - Clarinda
37,1987-1988,1987-11-27,1988-02-29,95,3,66,307,373,30,67,97,470,6,73,IA - Clarinda
39,1989-1990,1989-11-17,1990-03-24,128,1,96,377,473,37,121,158,631,17,135,IA - Clarinda
40,1990-1991,1990-11-28,1991-03-14,107,3,109,364,473,35,207,242,715,14,141,IA - Clarinda
42,1992-1993,1992-11-06,1993-04-02,148,8,109,391,500,51,269,320,820,20,150,IA - Clarinda
43,1993-1994,1993-10-31,1994-04-30,182,16,114,446,560,30,82,112,672,17,143,IA - Clarinda
44,1994-1995,1994-11-28,1995-03-10,103,2,80,321,401,31,129,160,561,14,99,IA - Clarinda
45,1995-1996,1995-11-02,1996-03-31,151,9,140,471,611,50,228,278,889,26,184,IA - Clarinda
47,1997-1998,1997-10-26,1998-03-21,147,9,67,329,396,54,152,206,602,16,100,IA - Clarinda
48,1998-1999,1998-11-07,1999-03-11,125,6,70,317,387,30,75,105,492,10,75,IA - Clarinda
49,1999-2000,1999-12-01,2000-03-19,110,0,36,322,358,17,24,41,399,8,46,IA - Clarinda
50,2000-2001,2000-11-09,2001-03-17,129,6,143,547,690,58,254,312,1002,21,217,IA - Clarinda
51,2001-2002,2001-11-28,2002-03-27,120,0,47,354,401,23,47,70,471,7,55,IA - Clarinda
52,2002-2003,2002-10-17,2003-03-11,146,2,80,475,555,37,77,114,669,14,107,IA - Clarinda
53,2003-2004,2003-11-06,2004-03-17,133,0,95,376,471,43,176,219,690,14,109,IA - Clarinda
54,2004-2005,2004-11-29,2005-03-01,93,3,64,295,359,20,88,108,467,6,61,IA - Clarinda
55,2005-2006,2005-11-16,2006-03-22,127,0,60,335,395,25,44,69,464,9,72,IA - Clarinda
56,2006-2007,2006-11-30,2007-03-08,99,0,97,373,470,45,167,212,682,11,107,IA - Clarinda
57,2007-2008,2007-11-22,2008-03-11,111,3,120,486,606,60,229,289,895,21,189,IA - Clarinda
58,2008-2009,2008-11-22,2009-03-12,111,0,101,441,542,31,67,98,640,14,114,IA - Clarinda
59,2009-2010,2009-12-01,2010-03-21,111,0,152,469,621,83,377,460,1081,25,230,IA - Clarinda
60,2010-2011,2010-11-26,2011-03-29,124,0,101,424,525,43,154,197,722,16,127,IA - Clarinda
61,2011-2012,2011-11-09,2012-02-29,113,0,32,279,311,16,20,36,347,8,33,IA - Clarinda
62,2012-2013,2012-12-01,2013-03-26,116,0,59,329,388,31,47,78,466,7,61,IA - Clarinda
63,2013-2014,2013-11-23,2014-03-06,104,3,141,506,647,37,114,151,798,10,97,IA - Clarinda
64,2014-2015,2014-11-12,2015-03-06,115,0,90,417,507,28,50,78,585,10,86,IA - Clarinda
65,2015-2016,2015-11-28,2016-03-02,96,0,47,225,272,17,34,51,323,8,52,IA - Clarinda
66,2016-2017,2016-12-01,2017-03-14,104,0,54,271,325,4,5,9,334,3,19,IA - Clarinda
67,2017-2018,2017-12-01,2018-04-16,137,0,106,420,526,24,74,98,624,11,98,IA - Clarinda
68,2018-2019,2018-11-09,2019-03-10,122,0,126,460,586,75,296,371,957,20,174,IA - Clarinda
69,2019-2020,2019-10-31,2020-04-17,170,0,45,339,384,31,28,59,443,12,69,IA - Clarinda
0,1950-1951,1950-11-10,1951-03-24,135,4,126,459,585,62,267,329,914,31,201,IA - Clinton
1,1951-1952,1951-11-02,1952-03-23,143,2,85,349,434,86,235,321,755,23,197,IA - Clinton
2,1952-1953,1952-11-26,1953-04-19,145,3,48,268,316,48,98,146,462,20,131,IA - Clinton
3,1953-1954,1953-11-26,1954-04-03,129,0,46,279,325,45,78,123,448,11,71,IA - Clinton
4,1954-1955,1954-11-01,1955-03-26,146,0,60,304,364,54,123,177,541,23,154,IA - Clinton
5,1955-1956,1955-11-16,1956-03-15,121,0,62,353,415,26,43,69,484,22,110,IA - Clinton
6,1956-1957,1956-11-22,1957-03-25,124,0,75,314,389,43,107,150,539,20,143,IA - Clinton
7,1957-1958,1957-11-30,1958-03-05,96,0,86,300,386,40,245,285,671,15,87,IA - Clinton
8,1958-1959,1958-11-26,1959-03-17,112,0,129,473,602,66,230,296,898,15,140,IA - Clinton
9,1959-1960,1959-11-06,1960-03-27,143,0,97,441,538,90,382,472,1010,25,181,IA - Clinton
10,1960-1961,1960-11-29,1961-04-17,140,2,76,330,406,29,73,102,508,10,64,IA - Clinton
11,1961-1962,1961-11-19,1962-03-21,123,0,157,447,604,58,418,476,1080,19,146,IA - Clinton
12,1962-1963,1962-12-01,1963-03-13,103,0,161,470,631,42,151,193,824,17,159,IA - Clinton
13,1963-1964,1963-12-01,1964-03-29,120,2,105,417,522,49,129,178,700,15,94,IA - Clinton
14,1964-1965,1964-11-20,1965-03-27,128,1,122,438,560,76,168,244,804,20,182,IA - Clinton
15,1965-1966,1965-11-28,1966-03-24,117,0,106,350,456,31,157,188,644,11,89,IA - Clinton
16,1966-1967,1966-12-01,1967-04-23,144,1,76,345,421,56,172,228,649,17,126,IA - Clinton
17,1967-1968,1967-10-27,1968-03-22,148,1,80,374,454,29,55,84,538,14,96,IA - Clinton
18,1968-1969,1968-12-01,1969-03-31,121,1,91,368,459,18,71,89,548,7,48,IA - Clinton
19,1969-1970,1969-11-14,1970-04-02,140,1,154,527,681,56,189,245,926,24,184,IA - Clinton
20,1970-1971,1970-11-23,1971-03-23,121,1,111,379,490,38,197,235,725,12,84,IA - Clinton
21,1971-1972,1971-11-24,1972-04-07,136,2,85,375,460,53,161,214,674,16,103,IA - Clinton
22,1972-1973,1972-10-18,1973-04-09,174,8,74,305,379,23,87,110,489,8,42,IA - Clinton
23,1973-1974,1973-12-01,1974-03-24,114,1,98,317,415,48,165,213,628,16,125,IA - Clinton
24,1974-1975,1974-11-13,1975-04-05,144,3,64,345,409,68,171,239,648,20,112,IA - Clinton
25,1975-1976,1975-11-25,1976-02-29,97,0,50,278,328,24,63,87,415,12,61,IA - Clinton
26,1976-1977,1976-11-11,1977-03-22,132,2,166,533,699,40,211,251,950,20,165,IA - Clinton
27,1977-1978,1977-11-25,1978-03-26,122,0,166,532,698,67,354,421,1119,24,193,IA - Clinton
28,1978-1979,1978-11-20,1979-03-25,126,2,188,511,699,109,860,969,1668,30,256,IA - Clinton
29,1979-1980,1979-11-29,1980-04-15,139,0,78,345,423,40,123,163,586,16,95,IA - Clinton
30,1980-1981,1980-10-28,1981-02-28,124,0,65,319,384,23,63,86,470,13,83,IA - Clinton
31,1981-1982,1981-11-20,1982-04-09,141,2,127,473,600,55,261,316,916,27,197,IA - Clinton
32,1982-1983,1982-11-05,1983-03-26,142,0,36,256,292,26,52,78,370,15,63,IA - Clinton
33,1983-1984,1983-11-29,1984-03-21,114,0,136,399,535,53,262,315,850,24,171,IA - Clinton
34,1984-1985,1984-12-01,1985-03-05,95,0,103,378,481,47,289,336,817,21,149,IA - Clinton
35,1985-1986,1985-11-21,1986-03-07,107,0,125,400,525,47,202,249,774,24,146,IA - Clinton
36,1986-1987,1986-11-11,1987-02-28,110,0,41,228,269,23,21,44,313,15,63,IA - Clinton
37,1987-1988,1987-12-01,1988-03-15,106,0,105,328,433,49,204,253,686,20,154,IA - Clinton
39,1989-1990,1989-11-18,1990-02-28,103,0,80,312,392,42,116,158,550,22,167,IA - Clinton
40,1990-1991,1990-11-09,1991-03-17,129,0,81,332,413,55,171,226,639,19,134,IA - Clinton
41,1991-1992,1991-11-02,1992-04-01,152,3,45,275,320,34,62,96,416,16,84,IA - Clinton
42,1992-1993,1992-11-13,1993-04-01,140,0,79,321,400,50,116,166,566,28,137,IA - Clinton
43,1993-1994,1993-11-06,1994-03-04,119,0,154,395,549,72,315,387,936,30,273,IA - Clinton
44,1994-1995,1994-12-01,1995-03-08,98,0,80,269,349,43,239,282,631,14,92,IA - Clinton
45,1995-1996,1995-11-09,1996-03-26,139,2,121,432,553,44,138,182,735,23,148,IA - Clinton
46,1996-1997,1996-11-12,1997-04-12,152,0,116,384,500,62,158,220,720,28,196,IA - Clinton
47,1997-1998,1997-10-26,1998-03-16,142,0,49,226,275,54,120,174,449,23,104,IA - Clinton
48,1998-1999,1998-11-08,1999-03-15,128,2,79,287,366,58,211,269,635,23,179,IA - Clinton
49,1999-2000,1999-12-01,2000-04-08,130,0,66,283,349,58,191,249,598,22,155,IA - Clinton
50,2000-2001,2000-11-13,2001-03-25,133,2,130,447,577,59,375,434,1011,31,222,IA - Clinton
51,2001-2002,2001-12-01,2002-04-01,122,2,42,241,283,35,75,110,393,15,87,IA - Clinton
52,2002-2003,2002-11-24,2003-04-07,135,0,75,387,462,37,64,101,563,21,119,IA - Clinton
53,2003-2004,2003-11-24,2004-03-17,115,0,73,294,367,40,138,178,545,20,116,IA - Clinton
54,2004-2005,2004-11-30,2005-03-23,114,2,57,265,322,31,85,116,438,17,84,IA - Clinton
55,2005-2006,2005-11-16,2006-03-17,122,0,69,280,349,30,108,138,487,17,100,IA - Clinton
56,2006-2007,2006-12-01,2007-04-12,133,0,103,319,422,43,185,228,650,15,108,IA - Clinton
57,2007-2008,2007-12-01,2008-03-24,115,3,112,387,499,85,328,413,912,34,247,IA - Clinton
58,2008-2009,2008-11-21,2009-03-29,129,0,124,452,576,53,251,304,880,29,220,IA - Clinton
59,2009-2010,2009-12-01,2010-03-20,110,1,114,343,457,52,294,346,803,24,135,IA - Clinton
61,2011-2012,2011-11-09,2012-03-03,116,0,28,200,228,32,68,100,328,14,79,IA - Clinton
62,2012-2013,2012-11-27,2013-03-25,119,0,57,300,357,41,134,175,532,20,95,IA - Clinton
63,2013-2014,2013-11-11,2014-03-25,135,0,184,559,743,75,454,529,1272,37,306,IA - Clinton
64,2014-2015,2014-11-12,2015-03-23,132,0,117,413,530,53,277,330,860,21,164,IA - Clinton
65,2015-2016,2015-11-21,2016-03-24,125,0,53,216,269,30,56,86,355,16,82,IA - Clinton
66,2016-2017,2016-12-01,2017-03-15,105,0,64,230,294,31,64,95,389,13,93,IA - Clinton
67,2017-2018,2017-11-10,2018-04-19,161,0,119,423,542,54,134,188,730,27,203,IA - Clinton
68,2018-2019,2018-11-08,2019-03-17,130,0,124,393,517,69,298,367,884,28,215,IA - Clinton
69,2019-2020,2019-10-29,2020-04-17,172,0,42,256,298,46,86,132,430,24,97,IA - Clinton
2,1952-1953,1952-11-25,1953-04-15,142,2,84,355,439,36,257,293,732,13,97,IA - Denison
3,1953-1954,1953-12-01,1954-03-31,121,2,66,391,457,20,15,35,492,6,44,IA - Denison
4,1954-1955,1954-11-30,1955-03-28,119,3,87,412,499,23,163,186,685,7,61,IA - Denison
5,1955-1956,1955-11-07,1956-03-15,130,4,132,506,638,12,74,86,724,6,51,IA - Denison
6,1956-1957,1956-11-20,1957-04-05,137,11,98,412,510,22,96,118,628,5,47,IA - Denison
7,1957-1958,1957-10-26,1958-03-17,143,4,104,393,497,40,169,209,706,8,66,IA - Denison
8,1958-1959,1958-11-26,1959-04-20,146,6,123,527,650,30,106,136,786,7,61,IA - Denison
9,1959-1960,1959-11-05,1960-03-29,146,5,168,521,689,74,509,583,1272,15,150,IA - Denison
10,1960-1961,1960-11-29,1961-03-15,107,0,77,357,434,38,77,115,549,9,87,IA - Denison
11,1961-1962,1961-11-05,1962-03-23,139,3,181,528,709,72,486,558,1267,14,154,IA - Denison
12,1962-1963,1962-11-18,1963-03-09,112,0,147,452,599,36,168,204,803,11,124,IA - Denison
14,1964-1965,1964-11-19,1965-04-26,159,1,152,566,718,64,248,312,1030,32,283,IA - Denison
15,1965-1966,1965-11-27,1966-04-05,130,1,109,385,494,23,98,121,615,15,95,IA - Denison
16,1966-1967,1966-11-02,1967-03-17,136,0,85,454,539,23,96,119,658,17,130,IA - Denison
17,1967-1968,1967-11-04,1968-03-22,140,1,85,430,515,18,41,59,574,14,114,IA - Denison
18,1968-1969,1968-11-08,1969-03-30,143,3,164,502,666,67,517,584,1250,30,221,IA - Denison
19,1969-1970,1969-11-14,1970-03-31,138,0,144,498,642,63,379,442,1084,23,208,IA - Denison
20,1970-1971,1970-10-10,1971-04-02,175,0,146,483,629,52,275,327,956,19,143,IA - Denison
21,1971-1972,1971-11-23,1972-04-04,134,0,129,454,583,53,206,259,842,20,179,IA - Denison
22,1972-1973,1972-11-14,1973-04-16,154,1,135,392,527,68,279,347,874,27,232,IA - Denison
23,1973-1974,1973-12-01,1974-04-14,135,0,124,390,514,46,262,308,822,21,183,IA - Denison
24,1974-1975,1974-11-13,1975-04-03,142,0,109,469,578,87,526,613,1191,31,237,IA - Denison
25,1975-1976,1975-11-12,1976-03-30,140,0,78,382,460,36,73,109,569,16,124,IA - Denison
26,1976-1977,1976-10-19,1977-03-21,154,0,132,546,678,40,77,117,795,21,153,IA - Denison
27,1977-1978,1977-11-10,1978-03-17,128,1,247,584,831,54,216,270,1101,21,210,IA - Denison
28,1978-1979,1978-11-17,1979-04-04,139,0,267,628,895,95,657,752,1647,29,296,IA - Denison
29,1979-1980,1979-10-23,1980-03-27,157,3,103,409,512,38,72,110,622,19,151,IA - Denison
30,1980-1981,1980-10-28,1981-02-28,124,2,87,344,431,24,49,73,504,9,92,IA - Denison
33,1983-1984,1983-11-10,1984-04-22,165,3,193,490,683,79,446,525,1208,24,214,IA - Denison
34,1984-1985,1984-11-09,1985-04-03,146,4,105,414,519,47,84,131,650,18,149,IA - Denison
35,1985-1986,1985-11-09,1986-03-17,129,3,135,450,585,49,278,327,912,19,170,IA - Denison
36,1986-1987,1986-11-09,1987-04-04,147,2,38,290,328,49,84,133,461,15,113,IA - Denison
37,1987-1988,1987-11-17,1988-03-17,122,6,89,374,463,46,151,197,660,20,156,IA - Denison
38,1988-1989,1988-11-16,1989-03-18,123,8,101,395,496,35,59,94,590,19,161,IA - Denison
39,1989-1990,1989-11-16,1990-03-23,128,1,91,383,474,39,82,121,595,17,140,IA - Denison
40,1990-1991,1990-10-18,1991-03-28,162,0,135,445,580,58,314,372,952,20,178,IA - Denison
41,1991-1992,1991-10-30,1992-04-22,176,7,64,328,392,43,112,155,547,18,115,IA - Denison
42,1992-1993,1992-11-03,1993-04-01,150,3,159,443,602,61,281,342,944,25,179,IA - Denison
43,1993-1994,1993-10-30,1994-05-01,184,4,182,525,707,47,205,252,959,23,215,IA - Denison
44,1994-1995,1994-11-28,1995-04-04,128,3,119,357,476,41,154,195,671,10,101,IA - Denison
45,1995-1996,1995-10-31,1996-04-16,169,5,170,520,690,47,141,188,878,18,177,IA - Denison
46,1996-1997,1996-10-31,1997-04-14,166,15,202,546,748,62,188,250,998,19,187,IA - Denison
47,1997-1998,1997-10-26,1998-03-25,151,2,100,350,450,62,201,263,713,30,163,IA - Denison
48,1998-1999,1998-11-07,1999-03-18,132,2,103,330,433,63,264,327,760,18,157,IA - Denison
49,1999-2000,1999-12-01,2000-04-08,130,4,63,314,377,32,97,129,506,17,114,IA - Denison
50,2000-2001,2000-11-07,2001-03-26,140,2,206,578,784,68,576,644,1428,27,260,IA - Denison
51,2001-2002,2001-11-29,2002-03-22,114,2,84,321,405,26,115,141,546,7,61,IA - Denison
52,2002-2003,2002-10-24,2003-04-09,168,5,117,483,600,52,123,175,775,15,129,IA - Denison
53,2003-2004,2003-11-23,2004-03-20,119,1,132,390,522,83,325,408,930,20,202,IA - Denison
54,2004-2005,2004-11-29,2005-03-13,105,2,92,333,425,23,95,118,543,8,68,IA - Denison
55,2005-2006,2005-11-16,2006-03-23,128,6,87,343,430,36,70,106,536,16,120,IA - Denison
56,2006-2007,2006-11-11,2007-04-12,153,5,127,427,554,63,210,273,827,14,134,IA - Denison
57,2007-2008,2007-11-22,2008-04-12,143,0,132,480,612,48,204,252,864,25,180,IA - Denison
58,2008-2009,2008-11-08,2009-04-08,152,1,114,467,581,57,187,244,825,21,166,IA - Denison
59,2009-2010,2009-12-01,2010-03-21,111,0,158,428,586,75,663,738,1324,21,187,IA - Denison
60,2010-2011,2010-11-12,2011-03-29,138,0,191,534,725,64,294,358,1083,22,214,IA - Denison
61,2011-2012,2011-11-20,2012-03-04,106,0,72,316,388,33,98,131,519,10,85,IA - Denison
62,2012-2013,2012-11-12,2013-05-02,172,0,126,496,622,59,198,257,879,15,122,IA - Denison
63,2013-2014,2013-11-12,2014-04-14,154,0,219,664,883,45,79,124,1007,21,202,IA - Denison
64,2014-2015,2014-11-11,2015-04-10,151,1,132,462,594,37,110,147,741,14,112,IA - Denison
65,2015-2016,2015-11-21,2016-03-04,105,0,115,297,412,53,222,275,687,18,143,IA - Denison
66,2016-2017,2016-12-01,2017-03-22,112,0,101,334,435,36,63,99,534,13,88,IA - Denison
67,2017-2018,2017-10-28,2018-04-19,174,0,176,526,702,52,125,177,879,24,200,IA - Denison
68,2018-2019,2018-10-15,2019-04-02,170,0,181,542,723,62,266,328,1051,19,178,IA - Denison
69,2019-2020,2019-10-29,2020-04-17,172,0,74,425,499,40,102,142,641,24,134,IA - Denison
0,1950-1951,1950-11-09,1951-03-31,143,0,150,492,642,44,151,195,837,22,168,IA - Des Moines
1,1951-1952,1951-11-01,1952-04-13,165,0,122,421,543,51,175,226,769,26,174,IA - Des Moines
2,1952-1953,1952-11-24,1953-03-24,121,0,73,288,361,46,152,198,559,22,122,IA - Des Moines
3,1953-1954,1953-11-27,1954-04-03,128,0,65,343,408,20,35,55,463,10,58,IA - Des Moines
4,1954-1955,1954-10-30,1955-03-27,149,0,82,365,447,45,156,201,648,26,178,IA - Des Moines
5,1955-1956,1955-10-30,1956-04-16,170,0,122,471,593,33,86,119,712,22,129,IA - Des Moines
6,1956-1957,1956-11-20,1957-04-10,142,0,92,369,461,60,112,172,633,31,214,IA - Des Moines
7,1957-1958,1957-11-17,1958-03-17,121,0,104,350,454,50,189,239,693,24,130,IA - Des Moines
8,1958-1959,1958-11-26,1959-04-21,147,0,132,439,571,60,161,221,792,28,194,IA - Des Moines
9,1959-1960,1959-11-05,1960-04-30,178,0,147,472,619,89,472,561,1180,39,266,IA - Des Moines
10,1960-1961,1960-11-30,1961-04-17,139,0,81,340,421,51,67,118,539,31,165,IA - Des Moines
11,1961-1962,1961-11-05,1962-04-12,159,0,202,525,727,103,547,650,1377,44,361,IA - Des Moines
12,1962-1963,1962-10-24,1963-03-13,141,0,183,488,671,56,186,242,913,32,298,IA - Des Moines
13,1963-1964,1963-12-01,1964-03-30,121,0,127,412,539,43,105,148,687,21,134,IA - Des Moines
14,1964-1965,1964-11-20,1965-03-27,128,0,167,520,687,61,154,215,902,36,282,IA - Des Moines
15,1965-1966,1965-11-27,1966-03-24,118,0,116,352,468,15,59,74,542,12,75,IA - Des Moines
16,1966-1967,1966-11-02,1967-04-23,173,0,86,421,507,27,71,98,605,18,120,IA - Des Moines
17,1967-1968,1967-10-26,1968-04-04,162,0,93,374,467,31,44,75,542,19,117,IA - Des Moines
18,1968-1969,1968-11-09,1969-03-30,142,0,147,451,598,60,225,285,883,31,184,IA - Des Moines
19,1969-1970,1969-11-14,1970-04-02,140,0,141,447,588,44,181,225,813,25,185,IA - Des Moines
20,1970-1971,1970-11-03,1971-04-01,150,0,127,385,512,61,208,269,781,25,136,IA - Des Moines
21,1971-1972,1971-11-08,1972-04-03,148,0,125,416,541,47,155,202,743,25,169,IA - Des Moines
22,1972-1973,1972-11-13,1973-04-16,155,0,137,362,499,80,205,285,784,29,210,IA - Des Moines
23,1973-1974,1973-12-01,1974-04-14,135,0,127,346,473,45,145,190,663,25,185,IA - Des Moines
24,1974-1975,1974-11-13,1975-04-05,144,0,97,372,469,87,212,299,768,36,205,IA - Des Moines
25,1975-1976,1975-11-12,1976-03-06,116,0,60,303,363,36,43,79,442,16,86,IA - Des Moines
26,1976-1977,1976-11-11,1977-04-05,146,0,136,493,629,37,66,103,732,28,189,IA - Des Moines
27,1977-1978,1977-11-09,1978-04-20,163,0,211,546,757,83,383,466,1223,37,273,IA - Des Moines
28,1978-1979,1978-11-16,1979-04-04,140,0,217,534,751,84,455,539,1290,42,332,IA - Des Moines
29,1979-1980,1979-11-12,1980-04-11,152,0,93,355,448,43,66,109,557,26,159,IA - Des Moines
30,1980-1981,1980-10-27,1981-02-28,125,0,73,316,389,32,48,80,469,13,114,IA - Des Moines
31,1981-1982,1981-10-24,1982-04-10,169,0,173,478,651,92,350,442,1093,37,308,IA - Des Moines
32,1982-1983,1982-10-19,1983-04-18,182,0,47,267,314,80,114,194,508,33,168,IA - Des Moines
33,1983-1984,1983-11-12,1984-04-29,170,0,165,429,594,84,321,405,999,38,301,IA - Des Moines
34,1984-1985,1984-11-10,1985-04-02,144,0,104,417,521,46,128,174,695,24,169,IA - Des Moines
35,1985-1986,1985-11-10,1986-04-15,157,0,141,468,609,49,275,324,933,24,197,IA - Des Moines
36,1986-1987,1986-11-10,1987-03-31,142,0,40,285,325,32,31,63,388,18,80,IA - Des Moines
37,1987-1988,1987-11-24,1988-03-17,115,0,106,350,456,38,88,126,582,22,147,IA - Des Moines
38,1988-1989,1988-11-05,1989-04-09,156,0,81,392,473,35,113,148,621,23,164,IA - Des Moines
39,1989-1990,1989-11-02,1990-03-23,142,0,85,355,440,49,103,152,592,28,194,IA - Des Moines
40,1990-1991,1990-11-06,1991-03-13,128,0,99,357,456,37,163,200,656,17,142,IA - Des Moines
41,1991-1992,1991-11-01,1992-04-21,173,0,43,280,323,39,53,92,415,23,104,IA - Des Moines
42,1992-1993,1992-11-03,1993-04-16,165,0,105,370,475,71,245,316,791,36,193,IA - Des Moines
43,1993-1994,1993-10-30,1994-04-30,183,0,137,461,598,46,163,209,807,25,206,IA - Des Moines
44,1994-1995,1994-11-28,1995-04-10,134,0,81,310,391,43,171,214,605,17,103,IA - Des Moines
45,1995-1996,1995-10-30,1996-04-14,168,0,143,480,623,66,213,279,902,22,196,IA - Des Moines
46,1996-1997,1996-11-10,1997-04-13,155,0,140,424,564,51,146,197,761,24,184,IA - Des Moines
47,1997-1998,1997-10-26,1998-03-21,147,0,70,264,334,70,172,242,576,29,149,IA - Des Moines
48,1998-1999,1998-11-07,1999-04-16,161,0,84,284,368,67,185,252,620,23,179,IA - Des Moines
49,1999-2000,1999-12-01,2000-04-08,130,0,46,249,295,36,73,109,404,16,103,IA - Des Moines
50,2000-2001,2000-11-08,2001-03-25,138,0,161,486,647,79,408,487,1134,27,246,IA - Des Moines
51,2001-2002,2001-11-28,2002-03-25,118,0,46,256,302,24,57,81,383,14,71,IA - Des Moines
52,2002-2003,2002-10-23,2003-04-09,169,0,95,426,521,50,122,172,693,19,134,IA - Des Moines
53,2003-2004,2003-11-24,2004-03-18,116,0,93,307,400,66,192,258,658,20,171,IA - Des Moines
54,2004-2005,2004-11-29,2005-03-25,117,0,66,274,340,32,120,152,492,15,82,IA - Des Moines
55,2005-2006,2005-11-15,2006-03-22,128,0,59,271,330,40,69,109,439,22,138,IA - Des Moines
56,2006-2007,2006-11-10,2007-04-12,154,0,102,346,448,57,223,280,728,24,166,IA - Des Moines
57,2007-2008,2007-11-21,2008-04-12,144,0,118,421,539,90,325,415,954,40,281,IA - Des Moines
58,2008-2009,2008-11-07,2009-04-06,151,0,100,406,506,67,213,280,786,34,250,IA - Des Moines
59,2009-2010,2009-10-10,2010-03-21,163,0,128,385,513,100,606,706,1219,36,275,IA - Des Moines
60,2010-2011,2010-11-25,2011-03-29,125,0,101,363,464,61,249,310,774,31,209,IA - Des Moines
61,2011-2012,2011-11-09,2012-03-04,117,0,30,205,235,36,68,104,339,21,100,IA - Des Moines
62,2012-2013,2012-12-01,2013-05-04,155,0,60,298,358,79,225,304,662,27,151,IA - Des Moines
63,2013-2014,2013-11-11,2014-04-14,155,0,154,514,668,72,191,263,931,33,238,IA - Des Moines
64,2014-2015,2014-11-11,2015-03-05,115,0,100,361,461,46,109,155,616,18,141,IA - Des Moines
65,2015-2016,2015-11-20,2016-03-19,121,0,53,210,263,47,88,135,398,22,131,IA - Des Moines
66,2016-2017,2016-12-01,2017-03-21,111,0,52,226,278,23,25,48,326,14,66,IA - Des Moines
67,2017-2018,2017-12-01,2018-04-18,139,0,111,355,466,54,99,153,619,36,260,IA - Des Moines
68,2018-2019,2018-10-12,2019-04-02,173,0,123,427,550,76,247,323,873,35,259,IA - Des Moines
69,2019-2020,2019-10-28,2020-04-17,173,0,63,311,374,58,151,209,583,34,161,IA - Des Moines
0,1950-1951,1950-11-10,1951-04-01,143,0,173,537,710,85,422,507,1217,35,279,IA - Dubuque
1,1951-1952,1951-11-02,1952-04-14,165,0,132,495,627,86,278,364,991,34,249,IA - Dubuque
2,1952-1953,1952-11-24,1953-04-19,147,0,86,352,438,45,148,193,631,27,144,IA - Dubuque
3,1953-1954,1953-11-26,1954-04-03,129,0,84,374,458,46,101,147,605,16,104,IA - Dubuque
4,1954-1955,1954-11-01,1955-03-28,148,0,115,420,535,56,155,211,746,37,249,IA - Dubuque
5,1955-1956,1955-10-30,1956-04-07,161,0,121,510,631,41,177,218,849,26,170,IA - Dubuque
6,1956-1957,1956-11-16,1957-04-03,139,0,124,437,561,52,167,219,780,28,175,IA - Dubuque
7,1957-1958,1957-11-18,1958-03-14,117,0,131,378,509,42,238,280,789,20,107,IA - Dubuque
8,1958-1959,1958-11-23,1959-04-20,149,0,192,568,760,100,500,600,1360,40,325,IA - Dubuque
9,1959-1960,1959-11-05,1960-05-08,186,0,148,514,662,105,625,730,1392,43,297,IA - Dubuque
10,1960-1961,1960-11-08,1961-04-17,161,0,113,418,531,56,151,207,738,22,146,IA - Dubuque
11,1961-1962,1961-11-06,1962-04-13,159,0,192,528,720,104,671,775,1495,38,301,IA - Dubuque
12,1962-1963,1962-10-24,1963-03-18,146,0,209,552,761,56,251,307,1068,33,303,IA - Dubuque
13,1963-1964,1963-11-30,1964-04-01,124,0,131,440,571,47,192,239,810,23,123,IA - Dubuque
14,1964-1965,1964-11-19,1965-04-02,135,0,182,552,734,73,258,331,1065,33,277,IA - Dubuque
15,1965-1966,1965-11-18,1966-05-11,175,0,140,449,589,36,161,197,786,18,115,IA - Dubuque
16,1966-1967,1966-12-01,1967-04-23,144,0,122,424,546,59,205,264,810,24,175,IA - Dubuque
17,1967-1968,1967-10-26,1968-04-24,182,0,123,439,562,30,70,100,662,22,158,IA - Dubuque
18,1968-1969,1968-11-16,1969-03-31,136,0,153,457,610,49,283,332,942,27,164,IA - Dubuque
19,1969-1970,1969-11-13,1970-04-02,141,0,184,561,745,68,448,516,1261,34,260,IA - Dubuque
20,1970-1971,1970-10-31,1971-04-03,155,0,185,499,684,71,481,552,1236,32,199,IA - Dubuque
21,1971-1972,1971-11-07,1972-04-14,160,0,158,492,650,87,242,329,979,37,239,IA - Dubuque
22,1972-1973,1972-10-18,1973-04-16,181,0,141,393,534,78,191,269,803,31,209,IA - Dubuque
23,1973-1974,1973-11-09,1974-04-14,157,0,160,430,590,53,197,250,840,33,231,IA - Dubuque
24,1974-1975,1974-11-14,1975-04-11,149,0,129,450,579,107,362,469,1048,43,265,IA - Dubuque
25,1975-1976,1975-11-24,1976-03-16,114,0,99,368,467,41,68,109,576,15,89,IA - Dubuque
26,1976-1977,1976-10-19,1977-04-05,169,0,235,643,878,59,183,242,1120,39,346,IA - Dubuque
27,1977-1978,1977-11-10,1978-03-27,138,0,266,638,904,106,554,660,1564,40,362,IA - Dubuque
28,1978-1979,1978-11-17,1979-04-05,140,0,265,624,889,98,693,791,1680,40,334,IA - Dubuque
29,1979-1980,1979-11-09,1980-04-15,159,0,122,436,558,60,118,178,736,36,233,IA - Dubuque
30,1980-1981,1980-10-27,1981-03-11,136,0,104,376,480,41,64,105,585,26,172,IA - Dubuque
32,1982-1983,1982-11-04,1983-04-10,158,0,74,325,399,80,170,250,649,28,166,IA - Dubuque
33,1983-1984,1983-11-12,1984-04-23,164,0,207,497,704,75,324,399,1103,41,267,IA - Dubuque
34,1984-1985,1984-11-19,1985-04-07,140,0,142,434,576,67,296,363,939,33,221,IA - Dubuque
35,1985-1986,1985-11-09,1986-04-15,158,0,197,560,757,93,549,642,1399,37,286,IA - Dubuque
36,1986-1987,1986-11-10,1987-03-31,142,0,70,320,390,54,68,122,512,25,106,IA - Dubuque
37,1987-1988,1987-11-17,1988-04-26,162,0,146,436,582,65,238,303,885,30,197,IA - Dubuque
38,1988-1989,1988-11-05,1989-04-09,156,0,115,426,541,42,105,147,688,25,169,IA - Dubuque
39,1989-1990,1989-11-03,1990-04-02,151,0,112,415,527,49,97,146,673,30,189,IA - Dubuque
40,1990-1991,1990-11-05,1991-04-23,170,0,123,425,548,78,332,410,958,33,222,IA - Dubuque
41,1991-1992,1991-11-01,1992-04-21,173,0,80,349,429,61,119,180,609,32,167,IA - Dubuque
42,1992-1993,1992-10-19,1993-04-20,184,0,128,423,551,99,255,354,905,43,229,IA - Dubuque
43,1993-1994,1993-11-05,1994-05-01,178,0,190,486,676,77,336,413,1089,33,294,IA - Dubuque
44,1994-1995,1994-11-28,1995-04-12,136,0,116,351,467,54,230,284,751,16,123,IA - Dubuque
45,1995-1996,1995-10-30,1996-04-29,183,19,180,547,727,54,166,220,947,23,150,IA - Dubuque
46,1996-1997,1996-10-31,1997-04-12,164,0,165,468,633,81,28,109,742,32,244,IA - Dubuque
47,1997-1998,1997-10-26,1998-03-15,141,15,79,270,349,61,0,61,410,31,147,IA - Dubuque
54,2004-2005,2004-11-24,2005-03-25,122,4,96,326,422,47,155,202,624,27,135,IA - Dubuque
55,2005-2006,2005-11-15,2006-03-24,130,1,98,354,452,50,200,250,702,23,141,IA - Dubuque
56,2006-2007,2006-11-10,2007-04-13,155,1,130,399,529,59,223,282,811,24,179,IA - Dubuque
57,2007-2008,2007-11-21,2008-04-08,140,0,174,502,676,115,495,610,1286,43,364,IA - Dubuque
58,2008-2009,2008-10-26,2009-04-05,162,0,169,542,711,78,269,347,1058,34,289,IA - Dubuque
59,2009-2010,2009-12-01,2010-03-20,110,0,140,393,533,69,380,449,982,33,228,IA - Dubuque
60,2010-2011,2010-11-23,2011-04-18,147,0,166,466,632,93,408,501,1133,36,275,IA - Dubuque
61,2011-2012,2011-11-09,2012-03-06,119,0,54,273,327,50,109,159,486,20,118,IA - Dubuque
62,2012-2013,2012-11-06,2013-03-26,141,0,111,414,525,78,270,348,873,31,188,IA - Dubuque
63,2013-2014,2013-11-11,2014-04-14,155,0,255,695,950,94,442,536,1486,46,430,IA - Dubuque
64,2014-2015,2014-11-11,2015-03-25,135,1,172,501,673,56,234,290,963,27,209,IA - Dubuque
65,2015-2016,2015-11-20,2016-04-08,141,6,79,288,367,59,195,254,621,30,168,IA - Dubuque
66,2016-2017,2016-12-01,2017-04-28,149,0,96,305,401,41,136,177,578,17,106,IA - Dubuque
67,2017-2018,2017-11-10,2018-04-19,161,0,145,483,628,59,151,210,838,34,259,IA - Dubuque
68,2018-2019,2018-11-08,2019-04-28,172,0,155,480,635,81,275,356,991,32,274,IA - Dubuque
69,2019-2020,2019-10-28,2020-04-17,173,0,78,369,447,58,211,269,716,36,171,IA - Dubuque
1,1951-1952,1951-11-03,1952-03-24,143,15,76,422,498,79,243,322,820,25,186,IA - Iowa City
2,1952-1953,1952-11-27,1953-03-09,103,0,46,275,321,47,68,115,436,20,123,IA - Iowa City
3,1953-1954,1953-11-26,1954-03-30,125,0,38,310,348,38,57,95,443,8,60,IA - Iowa City
4,1954-1955,1954-11-01,1955-03-26,146,2,61,343,404,52,132,184,588,30,185,IA - Iowa City
5,1955-1956,1955-11-16,1956-03-18,124,0,73,436,509,26,44,70,579,19,108,IA - Iowa City
6,1956-1957,1956-11-22,1957-04-03,133,0,67,352,419,30,81,111,530,15,119,IA - Iowa City
7,1957-1958,1957-11-19,1958-03-08,110,0,85,335,420,27,159,186,606,13,62,IA - Iowa City
8,1958-1959,1958-11-27,1959-04-20,145,0,109,464,573,70,202,272,845,23,176,IA - Iowa City
9,1959-1960,1959-11-06,1960-03-28,144,0,105,445,550,75,413,488,1038,29,176,IA - Iowa City
10,1960-1961,1960-11-29,1961-04-17,140,0,58,366,424,24,50,74,498,9,60,IA - Iowa City
11,1961-1962,1961-12-01,1962-03-19,109,0,133,452,585,69,436,505,1090,29,201,IA - Iowa City
12,1962-1963,1962-12-01,1963-03-13,103,0,159,464,623,35,129,164,787,21,202,IA - Iowa City
13,1963-1964,1963-12-01,1964-03-29,120,0,88,440,528,39,96,135,663,18,103,IA - Iowa City
14,1964-1965,1964-11-20,1965-03-26,127,0,117,467,584,45,97,142,726,25,181,IA - Iowa City
15,1965-1966,1965-11-28,1966-03-24,117,1,90,347,437,14,71,85,522,6,28,IA - Iowa City
16,1966-1967,1966-12-01,1967-04-23,144,0,59,352,411,25,75,100,511,13,63,IA - Iowa City
17,1967-1968,1967-10-27,1968-02-29,126,0,74,325,399,19,25,44,443,9,65,IA - Iowa City
18,1968-1969,1968-11-10,1969-03-30,141,16,85,380,465,38,106,144,609,18,90,IA - Iowa City
19,1969-1970,1969-11-14,1970-04-02,140,4,110,443,553,71,276,347,900,25,169,IA - Iowa City
20,1970-1971,1970-11-23,1971-03-23,121,1,107,368,475,32,182,214,689,14,64,IA - Iowa City
21,1971-1972,1971-11-22,1972-04-03,134,3,89,353,442,47,175,222,664,16,100,IA - Iowa City
22,1972-1973,1972-10-18,1973-04-11,176,0,82,313,395,62,121,183,578,20,113,IA - Iowa City
23,1973-1974,1973-12-01,1974-03-30,120,0,104,328,432,34,166,200,632,17,121,IA - Iowa City
24,1974-1975,1974-11-13,1975-04-03,142,2,57,318,375,79,184,263,638,23,123,IA - Iowa City
25,1975-1976,1975-11-21,1976-02-29,101,0,41,263,304,18,34,52,356,8,38,IA - Iowa City
26,1976-1977,1976-11-13,1977-04-06,145,1,142,493,635,41,136,177,812,20,143,IA - Iowa City
27,1977-1978,1977-11-25,1978-03-27,123,0,159,497,656,55,403,458,1114,25,177,IA - Iowa City
28,1978-1979,1978-11-21,1979-04-02,133,1,182,496,678,73,610,683,1361,23,205,IA - Iowa City
29,1979-1980,1979-11-29,1980-04-15,139,0,70,322,392,46,105,151,543,17,104,IA - Iowa City
30,1980-1981,1980-10-27,1981-02-28,125,0,58,288,346,23,42,65,411,11,68,IA - Iowa City
31,1981-1982,1981-11-20,1982-04-09,141,1,125,442,567,60,355,415,982,25,187,IA - Iowa City
32,1982-1983,1982-11-05,1983-04-09,156,7,41,227,268,34,76,110,378,13,56,IA - Iowa City
33,1983-1984,1983-11-13,1984-03-21,130,1,131,397,528,59,279,338,866,24,178,IA - Iowa City
34,1984-1985,1984-12-01,1985-03-05,95,13,92,331,423,31,246,277,700,15,103,IA - Iowa City
35,1985-1986,1985-11-20,1986-04-15,147,2,125,417,542,44,284,328,870,21,135,IA - Iowa City
36,1986-1987,1986-11-11,1987-03-30,140,6,32,237,269,15,13,28,297,9,38,IA - Iowa City
37,1987-1988,1987-12-01,1988-03-15,106,0,87,314,401,35,113,148,549,15,103,IA - Iowa City
39,1989-1990,1989-11-18,1990-02-28,103,0,69,291,360,37,99,136,496,16,122,IA - Iowa City
40,1990-1991,1990-12-01,1991-03-13,103,0,84,300,384,35,161,196,580,9,71,IA - Iowa City
41,1991-1992,1991-11-02,1992-03-13,133,11,38,233,271,25,64,89,360,11,61,IA - Iowa City
42,1992-1993,1992-11-14,1993-04-16,154,10,76,312,388,47,157,204,592,23,108,IA - Iowa City
43,1993-1994,1993-11-26,1994-03-03,98,2,131,348,479,49,193,242,721,19,161,IA - Iowa City
44,1994-1995,1994-12-01,1995-03-09,99,2,71,260,331,22,154,176,507,7,40,IA - Iowa City
45,1995-1996,1995-11-08,1996-03-26,140,6,116,400,516,35,154,189,705,9,72,IA - Iowa City
46,1996-1997,1996-11-11,1997-04-13,154,9,105,349,454,52,148,200,654,20,157,IA - Iowa City
47,1997-1998,1997-10-26,1998-03-12,138,10,40,200,240,35,126,161,401,16,73,IA - Iowa City
48,1998-1999,1998-12-01,1999-03-14,104,2,65,233,298,53,200,253,551,18,149,IA - Iowa City
49,1999-2000,1999-12-01,2000-04-08,130,7,44,234,278,46,176,222,500,14,113,IA - Iowa City
50,2000-2001,2000-11-17,2001-03-25,129,9,130,411,541,60,431,491,1032,20,195,IA - Iowa City
51,2001-2002,2001-12-01,2002-04-02,123,4,34,210,244,25,64,89,333,6,40,IA - Iowa City
52,2002-2003,2002-11-27,2003-03-13,107,5,66,378,444,27,64,91,535,7,61,IA - Iowa City
53,2003-2004,2003-11-24,2004-03-18,116,2,56,285,341,53,148,201,542,15,110,IA - Iowa City
54,2004-2005,2004-11-29,2005-03-10,102,13,52,221,273,22,72,94,367,7,44,IA - Iowa City
55,2005-2006,2005-11-17,2006-03-21,125,2,55,280,335,31,131,162,497,10,73,IA - Iowa City
56,2006-2007,2006-12-01,2007-03-03,93,11,68,279,347,23,114,137,484,8,53,IA - Iowa City
57,2007-2008,2007-12-01,2008-03-11,102,4,83,367,450,88,397,485,935,23,162,IA - Iowa City
58,2008-2009,2008-11-21,2009-03-29,129,2,79,405,484,52,196,248,732,21,158,IA - Iowa City
59,2009-2010,2009-12-01,2010-03-20,110,1,89,354,443,51,262,313,756,17,116,IA - Iowa City
60,2010-2011,2010-12-01,2011-02-28,90,2,83,305,388,53,235,288,676,12,96,IA - Iowa City
62,2012-2013,2012-11-24,2013-03-25,122,1,46,310,356,28,63,91,447,10,47,IA - Iowa City
64,2014-2015,2014-11-13,2015-03-07,115,0,132,465,597,40,140,180,777,13,115,IA - Iowa City
65,2015-2016,2015-11-21,2016-03-03,104,4,63,245,308,19,53,72,380,7,50,IA - Iowa City
66,2016-2017,2016-12-01,2017-03-16,106,0,66,278,344,19,28,47,391,9,50,IA - Iowa City
67,2017-2018,2017-12-01,2018-04-09,130,2,119,435,554,44,128,172,726,16,153,IA - Iowa City
68,2018-2019,2018-11-09,2019-03-17,129,2,123,469,592,60,200,260,852,17,154,IA - Iowa City
69,2019-2020,2019-10-29,2020-04-17,172,5,55,322,377,33,88,121,498,13,70,IA - Iowa City
0,1950-1951,1950-11-09,1951-04-11,154,7,246,727,973,79,574,653,1626,37,364,IA - Mason City
1,1951-1952,1951-11-01,1952-04-13,165,0,193,588,781,73,320,393,1174,35,258,IA - Mason City
2,1952-1953,1952-11-24,1953-03-24,121,0,141,432,573,46,457,503,1076,24,158,IA - Mason City
3,1953-1954,1953-11-22,1954-04-03,133,0,118,471,589,33,52,85,674,19,130,IA - Mason City
4,1954-1955,1954-10-30,1955-03-28,150,0,150,495,645,38,164,202,847,28,201,IA - Mason City
5,1955-1956,1955-11-03,1956-04-29,179,1,220,706,926,54,351,405,1331,27,208,IA - Mason City
6,1956-1957,1956-11-15,1957-04-11,148,2,151,524,675,47,151,198,873,20,180,IA - Mason City
7,1957-1958,1957-10-25,1958-03-20,147,0,150,456,606,35,241,276,882,15,86,IA - Mason City
8,1958-1959,1958-11-24,1959-03-27,124,0,225,624,849,57,328,385,1234,20,185,IA - Mason City
9,1959-1960,1959-11-04,1960-03-27,145,0,174,560,734,51,235,286,1020,26,185,IA - Mason City
10,1960-1961,1960-11-09,1961-04-17,160,0,158,569,727,67,321,388,1115,23,202,IA - Mason City
11,1961-1962,1961-11-05,1962-04-13,160,0,249,627,876,88,698,786,1662,31,292,IA - Mason City
12,1962-1963,1962-11-18,1963-03-16,119,0,217,538,755,56,214,270,1025,21,209,IA - Mason City
13,1963-1964,1963-11-23,1964-04-01,131,1,165,544,709,48,160,208,917,22,164,IA - Mason City
14,1964-1965,1964-11-19,1965-04-06,139,7,241,639,880,73,371,444,1324,23,241,IA - Mason City
15,1965-1966,1965-11-18,1966-04-11,145,0,188,504,692,41,184,225,917,15,122,IA - Mason City
16,1966-1967,1966-11-01,1967-03-18,138,0,138,510,648,39,210,249,897,13,130,IA - Mason City
17,1967-1968,1967-11-04,1968-03-22,140,0,136,507,643,16,40,56,699,6,53,IA - Mason City
18,1968-1969,1968-11-08,1969-03-31,144,0,237,633,870,71,690,761,1631,25,219,IA - Mason City
19,1969-1970,1969-11-13,1970-04-01,140,0,224,644,868,65,566,631,1499,16,147,IA - Mason City
20,1970-1971,1970-11-02,1971-04-02,152,1,250,620,870,97,759,856,1726,16,170,IA - Mason City
21,1971-1972,1971-11-06,1972-04-07,154,3,219,626,845,43,274,317,1162,18,151,IA - Mason City
22,1972-1973,1972-10-18,1973-04-14,179,0,177,491,668,79,305,384,1052,16,165,IA - Mason City
23,1973-1974,1973-11-08,1974-04-04,148,0,200,510,710,57,294,351,1061,18,170,IA - Mason City
24,1974-1975,1974-11-05,1975-04-10,157,0,168,539,707,71,467,538,1245,27,172,IA - Mason City
25,1975-1976,1975-11-13,1976-03-30,139,0,109,424,533,22,44,66,599,8,58,IA - Mason City
26,1976-1977,1976-10-19,1977-03-03,136,0,238,686,924,37,128,165,1089,16,154,IA - Mason City
27,1977-1978,1977-11-21,1978-03-20,120,3,284,653,937,51,474,525,1462,18,174,IA - Mason City
28,1978-1979,1978-11-14,1979-04-06,144,0,350,772,1122,90,903,993,2115,29,326,IA - Mason City
29,1979-1980,1979-10-22,1980-04-09,171,0,160,526,686,51,134,185,871,17,147,IA - Mason City
30,1980-1981,1980-11-14,1981-03-06,113,0,136,421,557,25,51,76,633,8,90,IA - Mason City
31,1981-1982,1981-10-23,1982-04-11,171,1,248,640,888,83,562,645,1533,24,239,IA - Mason City
32,1982-1983,1982-11-04,1983-04-18,166,0,101,399,500,70,230,300,800,20,140,IA - Mason City
33,1983-1984,1983-11-10,1984-04-30,173,3,284,631,915,73,529,602,1517,25,236,IA - Mason City
34,1984-1985,1984-11-19,1985-04-04,137,1,185,527,712,58,142,200,912,21,167,IA - Mason City
35,1985-1986,1985-11-08,1986-03-20,133,0,247,604,851,66,418,484,1335,18,169,IA - Mason City
36,1986-1987,1986-11-09,1987-04-01,144,0,84,398,482,36,69,105,587,15,92,IA - Mason City
37,1987-1988,1987-11-20,1988-04-27,160,0,198,548,746,60,279,339,1085,22,204,IA - Mason City
38,1988-1989,1988-11-12,1989-04-09,149,0,148,509,657,56,107,163,820,27,187,IA - Mason City
39,1989-1990,1989-10-30,1990-03-23,145,0,132,510,642,44,105,149,791,21,171,IA - Mason City
40,1990-1991,1990-10-17,1991-03-29,164,3,159,526,685,60,365,425,1110,24,197,IA - Mason City
41,1991-1992,1991-10-18,1992-04-21,187,0,100,414,514,77,219,296,810,44,243,IA - Mason City
42,1992-1993,1992-11-02,1993-04-20,170,0,181,561,742,98,465,563,1305,52,306,IA - Mason City
43,1993-1994,1993-10-30,1994-04-05,158,0,233,636,869,68,302,370,1239,36,343,IA - Mason City
44,1994-1995,1994-11-21,1995-04-09,140,0,135,452,587,54,226,280,867,28,187,IA - Mason City
45,1995-1996,1995-10-31,1996-04-15,168,0,194,632,826,72,166,238,1064,34,238,IA - Mason City
46,1996-1997,1996-10-31,1997-04-12,164,3,204,571,775,97,373,470,1245,52,415,IA - Mason City
47,1997-1998,1997-11-02,1998-04-16,166,0,109,386,495,82,238,320,815,47,249,IA - Mason City
48,1998-1999,1998-11-07,1999-04-23,168,0,117,425,542,82,300,382,924,35,293,IA - Mason City
49,1999-2000,1999-10-01,2000-04-08,191,3,83,429,512,68,178,246,758,31,227,IA - Mason City
52,2002-2003,2002-10-23,2003-04-10,170,0,132,566,698,51,78,129,827,23,157,IA - Mason City
53,2003-2004,2003-11-05,2004-03-16,133,2,140,458,598,49,232,281,879,20,135,IA - Mason City
54,2004-2005,2004-11-27,2005-03-24,118,0,118,407,525,46,170,216,741,18,119,IA - Mason City
55,2005-2006,2005-11-15,2006-03-17,123,8,105,387,492,47,191,238,730,24,152,IA - Mason City
56,2006-2007,2006-10-11,2007-04-12,184,0,167,523,690,79,373,452,1142,25,210,IA - Mason City
57,2007-2008,2007-11-21,2008-04-01,133,0,212,577,789,56,499,555,1344,31,261,IA - Mason City
58,2008-2009,2008-11-07,2009-04-01,146,0,199,618,817,66,503,569,1386,31,292,IA - Mason City
59,2009-2010,2009-10-13,2010-03-14,153,0,221,540,761,62,692,754,1515,28,240,IA - Mason City
60,2010-2011,2010-11-18,2011-04-20,154,0,201,551,752,78,469,547,1299,28,240,IA - Mason City
61,2011-2012,2011-11-20,2012-03-05,107,6,61,319,380,30,147,177,557,14,96,IA - Mason City
62,2012-2013,2012-11-12,2013-05-04,174,0,130,540,670,84,304,388,1058,29,210,IA - Mason City
63,2013-2014,2013-11-11,2014-04-14,155,0,287,732,1019,91,563,654,1673,40,400,IA - Mason City
64,2014-2015,2014-11-11,2015-04-09,150,0,190,548,738,57,336,393,1131,22,176,IA - Mason City
65,2015-2016,2015-11-20,2016-03-25,127,0,116,350,466,78,357,435,901,22,170,IA - Mason City
66,2016-2017,2016-12-01,2017-03-18,108,0,119,363,482,69,387,456,938,19,172,IA - Mason City
67,2017-2018,2017-10-27,2018-04-21,177,0,183,607,790,95,252,347,1137,31,260,IA - Mason City
68,2018-2019,2018-10-14,2019-04-27,196,0,216,595,811,85,390,475,1286,38,340,IA - Mason City
69,2019-2020,2019-10-30,2020-04-14,168,0,122,465,587,58,295,353,940,32,199,IA - Mason City
0,1950-1951,1950-11-09,1951-04-12,155,0,137,568,705,42,133,175,880,24,181,IA - Sioux City
1,1951-1952,1951-10-22,1952-04-12,174,0,136,530,666,62,209,271,937,31,222,IA - Sioux City
2,1952-1953,1952-11-24,1953-04-15,143,0,93,431,524,58,342,400,924,27,189,IA - Sioux City
3,1953-1954,1953-11-20,1954-04-01,133,0,75,384,459,43,68,111,570,20,120,IA - Sioux City
4,1954-1955,1954-11-26,1955-03-28,123,0,93,412,505,41,179,220,725,22,162,IA - Sioux City
5,1955-1956,1955-11-15,1956-04-29,167,0,159,556,715,43,157,200,915,32,244,IA - Sioux City
6,1956-1957,1956-11-15,1957-04-08,145,0,97,443,540,58,139,197,737,26,195,IA - Sioux City
7,1957-1958,1957-11-04,1958-04-06,154,0,93,391,484,47,160,207,691,29,135,IA - Sioux City
8,1958-1959,1958-11-17,1959-04-20,155,0,134,530,664,51,122,173,837,24,178,IA - Sioux City
9,1959-1960,1959-10-08,1960-04-02,178,0,179,577,756,102,576,678,1434,41,325,IA - Sioux City
10,1960-1961,1960-11-09,1961-04-17,160,0,91,441,532,55,138,193,725,30,169,IA - Sioux City
11,1961-1962,1961-09-30,1962-04-12,195,0,206,593,799,106,514,620,1419,44,382,IA - Sioux City
12,1962-1963,1962-10-24,1963-03-25,153,0,148,489,637,53,168,221,858,34,286,IA - Sioux City
13,1963-1964,1963-12-01,1964-03-29,120,0,106,440,546,39,85,124,670,27,157,IA - Sioux City
14,1964-1965,1964-11-19,1965-04-25,158,0,166,597,763,73,248,321,1084,35,298,IA - Sioux City
15,1965-1966,1965-11-26,1966-03-28,123,0,127,407,534,33,114,147,681,17,132,IA - Sioux City
16,1966-1967,1966-10-14,1967-03-17,155,0,95,487,582,37,146,183,765,24,175,IA - Sioux City
17,1967-1968,1967-10-26,1968-04-23,181,0,107,461,568,16,19,35,603,13,96,IA - Sioux City
18,1968-1969,1968-11-09,1969-03-30,142,0,174,528,702,74,599,673,1375,35,266,IA - Sioux City
19,1969-1970,1969-11-13,1970-03-27,135,0,144,507,651,66,275,341,992,32,267,IA - Sioux City
20,1970-1971,1970-10-09,1971-04-01,175,0,147,479,626,40,172,212,838,22,159,IA - Sioux City
21,1971-1972,1971-11-06,1972-04-08,155,0,134,493,627,51,168,219,846,33,231,IA - Sioux City
22,1972-1973,1972-10-18,1973-04-09,174,0,128,399,527,46,177,223,750,25,186,IA - Sioux City
23,1973-1974,1973-11-04,1974-04-04,152,0,121,415,536,39,159,198,734,25,217,IA - Sioux City
24,1974-1975,1974-11-13,1975-04-04,143,0,127,484,611,63,368,431,1042,32,192,IA - Sioux City
25,1975-1976,1975-11-20,1976-03-15,117,0,92,374,466,35,65,100,566,21,141,IA - Sioux City
26,1976-1977,1976-10-18,1977-04-04,169,0,157,604,761,35,58,93,854,20,138,IA - Sioux City
27,1977-1978,1977-11-09,1978-03-16,128,0,240,586,826,51,253,304,1130,33,250,IA - Sioux City
28,1978-1979,1978-11-11,1979-04-02,143,0,278,701,979,64,634,698,1677,38,295,IA - Sioux City
29,1979-1980,1979-10-22,1980-04-03,165,0,101,428,529,37,55,92,621,25,146,IA - Sioux City
30,1980-1981,1980-10-27,1981-03-09,134,0,80,401,481,26,51,77,558,12,93,IA - Sioux City
31,1981-1982,1981-10-24,1982-04-08,167,0,199,574,773,87,373,460,1233,37,374,IA - Sioux City
32,1982-1983,1982-10-19,1983-04-17,181,0,88,362,450,95,253,348,798,36,189,IA - Sioux City
33,1983-1984,1983-11-09,1984-04-30,174,0,197,472,669,87,401,488,1157,32,263,IA - Sioux City
34,1984-1985,1984-11-09,1985-04-02,145,0,107,414,521,39,33,72,593,20,127,IA - Sioux City
35,1985-1986,1985-11-08,1986-04-15,159,0,152,470,622,46,99,145,767,29,200,IA - Sioux City
36,1986-1987,1986-11-09,1987-04-01,144,0,40,334,374,34,47,81,455,18,94,IA - Sioux City
37,1987-1988,1987-11-27,1988-04-26,152,0,117,435,552,41,96,137,689,20,140,IA - Sioux City
38,1988-1989,1988-11-15,1989-04-09,146,0,104,430,534,43,63,106,640,27,179,IA - Sioux City
39,1989-1990,1989-11-16,1990-04-13,149,0,100,451,551,34,52,86,637,20,140,IA - Sioux City
40,1990-1991,1990-10-17,1991-03-29,164,0,110,448,558,55,124,179,737,29,213,IA - Sioux City
41,1991-1992,1991-10-29,1992-04-22,177,0,53,326,379,50,90,140,519,25,138,IA - Sioux City
42,1992-1993,1992-11-01,1993-04-13,164,0,137,473,610,72,268,340,950,42,279,IA - Sioux City
43,1993-1994,1993-10-30,1994-04-28,181,0,159,539,698,73,294,367,1065,39,307,IA - Sioux City
44,1994-1995,1994-11-27,1995-04-12,137,0,106,373,479,64,294,358,837,28,195,IA - Sioux City
45,1995-1996,1995-10-30,1996-04-15,169,0,146,556,702,35,87,122,824,24,197,IA - Sioux City
46,1996-1997,1996-11-01,1997-04-14,165,0,196,543,739,60,242,302,1041,23,199,IA - Sioux City
47,1997-1998,1997-10-25,1998-04-01,159,0,77,357,434,42,70,112,546,26,110,IA - Sioux City
48,1998-1999,1998-11-07,1999-04-17,162,0,82,380,462,59,175,234,696,20,159,IA - Sioux City
49,1999-2000,1999-11-23,2000-04-07,137,0,50,339,389,26,40,66,455,15,78,IA - Sioux City
50,2000-2001,2000-11-06,2001-04-23,169,0,190,602,792,72,511,583,1375,30,230,IA - Sioux City
51,2001-2002,2001-11-28,2002-03-21,114,0,72,344,416,39,88,127,543,12,93,IA - Sioux City
52,2002-2003,2002-10-16,2003-04-10,177,0,88,508,596,46,64,110,706,22,125,IA - Sioux City
53,2003-2004,2003-11-05,2004-03-19,136,0,116,406,522,83,304,387,909,21,198,IA - Sioux City
54,2004-2005,2004-11-28,2005-03-25,118,0,70,341,411,23,83,106,517,10,64,IA - Sioux City
55,2005-2006,2005-11-15,2006-03-26,132,0,74,378,452,51,131,182,634,21,164,IA - Sioux City
56,2006-2007,2006-10-18,2007-04-11,176,0,118,485,603,79,240,319,922,29,247,IA - Sioux City
57,2007-2008,2007-11-22,2008-04-25,156,0,143,542,685,67,329,396,1081,33,252,IA - Sioux City
58,2008-2009,2008-11-07,2009-04-05,150,0,116,523,639,59,197,256,895,31,223,IA - Sioux City
59,2009-2010,2009-10-10,2010-03-19,161,0,165,484,649,87,619,706,1355,34,295,IA - Sioux City
60,2010-2011,2010-11-22,2011-03-29,128,0,145,504,649,65,304,369,1018,30,232,IA - Sioux City
61,2011-2012,2011-11-20,2012-02-29,102,0,46,325,371,28,62,90,461,11,74,IA - Sioux City
62,2012-2013,2012-10-25,2013-05-01,189,0,88,480,568,70,152,222,790,26,155,IA - Sioux City
63,2013-2014,2013-11-05,2014-04-14,161,0,157,626,783,44,68,112,895,28,188,IA - Sioux City
64,2014-2015,2014-11-10,2015-03-04,115,0,101,418,519,35,118,153,672,18,130,IA - Sioux City
65,2015-2016,2015-11-20,2016-03-28,130,0,62,289,351,89,321,410,761,28,172,IA - Sioux City
66,2016-2017,2016-11-18,2017-03-21,124,0,61,295,356,45,85,130,486,18,119,IA - Sioux City
67,2017-2018,2017-12-01,2018-04-18,139,0,134,473,607,70,308,378,985,26,217,IA - Sioux City
68,2018-2019,2018-10-14,2019-04-02,171,0,149,517,666,46,209,255,921,26,193,IA - Sioux City
69,2019-2020,2019-11-06,2020-04-13,160,0,67,386,453,57,151,208,661,27,156,IA - Sioux City
5,1955-1956,1955-11-03,1956-04-07,157,0,150,584,734,28,95,123,857,22,141,IA - Waterloo
6,1956-1957,1956-11-16,1957-03-20,125,0,119,454,573,38,139,177,750,18,128,IA - Waterloo
7,1957-1958,1957-11-17,1958-03-16,120,0,125,409,534,35,148,183,717,15,80,IA - Waterloo
8,1958-1959,1958-11-23,1959-04-20,149,1,163,563,726,65,222,287,1013,28,218,IA - Waterloo
9,1959-1960,1959-11-05,1960-04-17,165,0,138,556,694,65,347,412,1106,34,240,IA - Waterloo
10,1960-1961,1960-11-09,1961-04-17,160,0,116,465,581,42,93,135,716,23,144,IA - Waterloo
11,1961-1962,1961-11-13,1962-04-02,141,0,209,582,791,89,542,631,1422,39,322,IA - Waterloo
12,1962-1963,1962-10-24,1963-03-14,142,0,204,584,788,47,144,191,979,29,249,IA - Waterloo
13,1963-1964,1963-11-22,1964-04-01,132,0,146,534,680,35,112,147,827,19,122,IA - Waterloo
14,1964-1965,1964-11-19,1965-03-31,133,0,209,607,816,54,167,221,1037,27,223,IA - Waterloo
15,1965-1966,1965-11-27,1966-05-11,166,0,139,482,621,26,108,134,755,18,118,IA - Waterloo
16,1966-1967,1966-11-02,1967-04-26,176,0,117,518,635,34,109,143,778,22,170,IA - Waterloo
17,1967-1968,1967-11-04,1968-03-22,140,0,126,479,605,28,35,63,668,21,139,IA - Waterloo
18,1968-1969,1968-11-10,1969-03-31,142,0,180,528,708,44,246,290,998,26,156,IA - Waterloo
19,1969-1970,1969-11-13,1970-03-28,136,0,221,644,865,61,396,457,1322,34,307,IA - Waterloo
20,1970-1971,1970-11-13,1971-03-25,133,0,223,572,795,70,498,568,1363,25,187,IA - Waterloo
21,1971-1972,1971-11-06,1972-04-08,155,0,201,603,804,69,221,290,1094,32,279,IA - Waterloo
22,1972-1973,1972-10-18,1973-04-16,181,0,157,463,620,69,228,297,917,28,208,IA - Waterloo
23,1973-1974,1973-11-08,1974-04-14,158,0,158,458,616,43,138,181,797,26,171,IA - Waterloo
24,1974-1975,1974-11-13,1975-04-10,149,0,136,490,626,76,262,338,964,43,230,IA - Waterloo
25,1975-1976,1975-11-13,1976-03-16,125,0,100,417,517,23,43,66,583,12,65,IA - Waterloo
26,1976-1977,1976-10-19,1977-04-04,168,0,233,749,982,34,141,175,1157,27,250,IA - Waterloo
27,1977-1978,1977-11-09,1978-04-20,163,0,307,745,1052,69,514,583,1635,38,345,IA - Waterloo
28,1978-1979,1978-11-16,1979-04-02,138,0,267,638,905,71,589,660,1565,41,329,IA - Waterloo
29,1979-1980,1979-11-09,1980-04-09,153,0,133,466,599,46,149,195,794,27,187,IA - Waterloo
30,1980-1981,1980-12-01,1981-02-28,90,0,117,364,481,35,67,102,583,15,141,IA - Waterloo
31,1981-1982,1981-11-19,1982-04-11,144,0,231,605,836,61,428,489,1325,34,319,IA - Waterloo
32,1982-1983,1982-10-20,1983-04-14,177,0,67,340,407,61,134,195,602,32,154,IA - Waterloo
33,1983-1984,1983-11-12,1984-04-22,163,0,215,540,755,72,364,436,1191,37,259,IA - Waterloo
34,1984-1985,1984-11-30,1985-04-07,129,0,145,457,602,48,194,242,844,30,204,IA - Waterloo
35,1985-1986,1985-11-09,1986-04-15,158,0,194,605,799,64,615,679,1478,27,204,IA - Waterloo
36,1986-1987,1986-11-10,1987-03-30,141,0,67,369,436,44,165,209,645,20,95,IA - Waterloo
37,1987-1988,1987-11-17,1988-03-15,120,0,150,438,588,40,188,228,816,21,150,IA - Waterloo
38,1988-1989,1988-11-12,1989-03-18,127,0,124,442,566,28,85,113,679,22,155,IA - Waterloo
39,1989-1990,1989-10-31,1990-03-23,144,0,106,446,552,30,64,94,646,22,147,IA - Waterloo
40,1990-1991,1990-11-06,1991-04-23,169,0,131,496,627,52,317,369,996,24,182,IA - Waterloo
41,1991-1992,1991-10-18,1992-04-12,178,0,66,376,442,67,127,194,636,39,184,IA - Waterloo
42,1992-1993,1992-11-05,1993-04-20,167,0,123,471,594,91,311,402,996,41,214,IA - Waterloo
43,1993-1994,1993-11-05,1994-04-05,152,0,195,567,762,62,322,384,1146,33,295,IA - Waterloo
44,1994-1995,1994-11-28,1995-04-10,134,0,115,385,500,49,174,223,723,19,144,IA - Waterloo
45,1995-1996,1995-11-02,1996-04-15,166,0,161,581,742,58,190,248,990,21,153,IA - Waterloo
46,1996-1997,1996-11-10,1997-04-30,172,0,182,525,707,69,222,291,998,31,268,IA - Waterloo
47,1997-1998,1997-10-26,1998-03-21,147,1,84,319,403,63,181,244,647,28,147,IA - Waterloo
48,1998-1999,1998-11-07,1999-03-13,127,0,97,355,452,57,237,294,746,28,233,IA - Waterloo
49,1999-2000,1999-12-01,2000-04-08,130,0,70,352,422,58,184,242,664,24,173,IA - Waterloo
50,2000-2001,2000-11-08,2001-03-26,139,0,210,591,801,69,593,662,1463,28,236,IA - Waterloo
51,2001-2002,2001-12-01,2002-04-03,124,0,54,314,368,32,59,91,459,19,107,IA - Waterloo
52,2002-2003,2002-10-24,2003-04-09,168,0,97,519,616,45,84,129,745,24,152,IA - Waterloo
53,2003-2004,2003-11-05,2004-03-17,134,0,107,409,516,42,165,207,723,19,133,IA - Waterloo
54,2004-2005,2004-12-01,2005-03-14,104,0,91,338,429,28,148,176,605,12,90,IA - Waterloo
55,2005-2006,2005-11-15,2006-03-06,112,0,96,373,469,49,167,216,685,20,154,IA - Waterloo
56,2006-2007,2006-11-10,2007-04-12,154,0,136,437,573,42,215,257,830,19,138,IA - Waterloo
57,2007-2008,2007-11-21,2008-03-28,129,0,180,534,714,81,491,572,1286,39,316,IA - Waterloo
58,2008-2009,2008-11-07,2009-04-05,150,0,161,568,729,74,322,396,1125,29,274,IA - Waterloo
59,2009-2010,2009-12-01,2010-03-20,110,0,175,466,641,76,601,677,1318,28,235,IA - Waterloo
60,2010-2011,2010-11-23,2011-04-19,148,0,160,496,656,78,321,399,1055,30,250,IA - Waterloo
61,2011-2012,2011-11-09,2012-03-05,118,0,42,296,338,39,93,132,470,14,94,IA - Waterloo
62,2012-2013,2012-11-12,2013-05-03,173,0,105,469,574,74,221,295,869,26,164,IA - Waterloo
63,2013-2014,2013-10-22,2014-04-14,175,0,246,743,989,85,319,404,1393,42,402,IA - Waterloo
64,2014-2015,2014-11-11,2015-03-24,134,0,163,504,667,45,174,219,886,20,158,IA - Waterloo
65,2015-2016,2015-11-20,2016-03-05,107,0,91,297,388,65,239,304,692,22,174,IA - Waterloo
66,2016-2017,2016-12-01,2017-03-17,107,0,88,302,390,38,105,143,533,14,100,IA - Waterloo
67,2017-2018,2017-11-10,2018-04-19,161,0,147,534,681,73,160,233,914,32,277,IA - Waterloo
68,2018-2019,2018-10-14,2019-04-27,196,0,158,534,692,89,342,431,1123,40,344,IA - Waterloo
69,2019-2020,2019-10-28,2020-04-12,168,0,79,373,452,50,246,296,748,31,164,IA - Waterloo
7,1957-1958,1957-10-25,1958-04-01,159,4,43,390,433,77,218,295,728,30,196,KS - Colby
8,1958-1959,1958-11-17,1959-04-12,147,1,64,390,454,71,101,172,626,32,236,KS - Colby
9,1959-1960,1959-10-01,1960-03-19,171,8,100,492,592,61,214,275,867,26,218,KS - Colby
10,1960-1961,1960-11-09,1961-04-11,154,8,33,374,407,41,58,99,506,17,101,KS - Colby
11,1961-1962,1961-11-03,1962-03-11,129,1,95,447,542,38,72,110,652,22,198,KS - Colby
12,1962-1963,1962-11-16,1963-03-16,121,0,75,382,457,45,53,98,555,17,156,KS - Colby
13,1963-1964,1963-11-17,1964-04-05,141,0,52,428,480,47,54,101,581,21,138,KS - Colby
14,1964-1965,1964-11-19,1965-03-26,128,2,51,473,524,23,23,46,570,12,88,KS - Colby
15,1965-1966,1965-12-01,1966-05-12,163,0,77,401,478,34,100,134,612,18,150,KS - Colby
16,1966-1967,1966-10-15,1967-05-04,202,3,39,423,462,28,57,85,547,16,94,KS - Colby
17,1967-1968,1967-11-02,1968-02-29,120,1,31,405,436,17,19,36,472,11,64,KS - Colby
18,1968-1969,1968-11-15,1969-03-29,135,0,67,439,506,47,185,232,738,25,166,KS - Colby
19,1969-1970,1969-10-12,1970-05-01,202,3,42,441,483,51,58,109,592,26,138,KS - Colby
20,1970-1971,1970-10-08,1971-03-25,169,0,51,446,497,30,49,79,576,12,69,KS - Colby
21,1971-1972,1971-10-30,1972-02-29,123,0,44,364,408,15,24,39,447,9,67,KS - Colby
22,1972-1973,1972-10-31,1973-04-10,162,0,105,405,510,54,136,190,700,21,156,KS - Colby
23,1973-1974,1973-11-05,1974-04-14,161,4,73,405,478,45,140,185,663,17,135,KS - Colby
24,1974-1975,1974-11-29,1975-04-18,141,1,44,441,485,25,44,69,554,16,94,KS - Colby
25,1975-1976,1975-11-19,1976-03-30,133,3,63,354,417,37,88,125,542,15,100,KS - Colby
26,1976-1977,1976-10-07,1977-04-05,181,0,47,507,554,35,51,86,640,11,89,KS - Colby
27,1977-1978,1977-11-09,1978-03-14,126,1,130,494,624,32,102,134,758,17,145,KS - Colby
28,1978-1979,1978-11-12,1979-05-10,180,1,115,486,601,60,113,173,774,30,189,KS - Colby
29,1979-1980,1979-10-22,1980-04-05,167,0,72,415,487,86,187,273,760,29,197,KS - Colby
30,1980-1981,1980-10-27,1981-03-11,136,3,42,372,414,36,88,124,538,14,91,KS - Colby
31,1981-1982,1981-11-19,1982-04-06,139,1,67,406,473,26,61,87,560,17,134,KS - Colby
32,1982-1983,1982-11-23,1983-04-14,143,3,45,284,329,59,170,229,558,17,119,KS - Colby
33,1983-1984,1983-11-09,1984-04-30,174,12,116,479,595,99,258,357,952,27,239,KS - Colby
34,1984-1985,1984-09-28,1985-03-31,185,11,68,430,498,43,133,176,674,17,132,KS - Colby
35,1985-1986,1985-09-29,1986-04-28,212,14,68,418,486,32,38,70,556,19,132,KS - Colby
36,1986-1987,1986-10-12,1987-04-14,185,1,32,376,408,51,57,108,516,21,119,KS - Colby
38,1988-1989,1988-11-16,1989-04-10,146,6,62,477,539,28,18,46,585,15,101,KS - Colby
39,1989-1990,1989-12-01,1990-05-04,155,3,49,396,445,44,85,129,574,17,128,KS - Colby
40,1990-1991,1990-10-21,1991-03-27,158,6,72,413,485,31,33,64,549,19,117,KS - Colby
41,1991-1992,1991-10-31,1992-03-19,141,1,22,281,303,41,50,91,394,13,89,KS - Colby
42,1992-1993,1992-10-29,1993-04-20,174,2,95,552,647,91,375,466,1113,30,234,KS - Colby
43,1993-1994,1993-10-29,1994-04-30,184,7,49,500,549,53,106,159,708,18,123,KS - Colby
44,1994-1995,1994-11-04,1995-04-27,175,5,43,341,384,49,78,127,511,23,140,KS - Colby
45,1995-1996,1995-09-21,1996-04-14,207,11,62,508,570,34,44,78,648,13,98,KS - Colby
46,1996-1997,1996-11-17,1997-04-12,147,3,62,440,502,39,68,107,609,12,109,KS - Colby
47,1997-1998,1997-10-25,1998-03-19,146,6,39,312,351,56,80,136,487,14,95,KS - Colby
48,1998-1999,1998-11-03,1999-03-17,135,5,35,304,339,40,56,96,435,9,77,KS - Colby
49,1999-2000,1999-11-23,2000-03-03,102,4,6,282,288,14,13,27,315,6,36,KS - Colby
50,2000-2001,2000-11-11,2001-03-12,122,7,49,432,481,53,196,249,730,12,114,KS - Colby
51,2001-2002,2001-11-27,2002-03-26,120,7,25,392,417,24,32,56,473,7,54,KS - Colby
52,2002-2003,2002-10-24,2003-04-07,166,10,37,380,417,15,15,30,447,7,42,KS - Colby
53,2003-2004,2003-11-06,2004-04-12,159,19,31,373,404,27,40,67,471,12,72,KS - Colby
54,2004-2005,2004-11-14,2005-04-29,167,20,35,306,341,22,37,59,400,12,75,KS - Colby
55,2005-2006,2005-11-28,2006-03-26,119,14,35,304,339,33,51,84,423,7,60,KS - Colby
56,2006-2007,2006-11-30,2007-04-14,136,16,63,392,455,65,321,386,841,18,162,KS - Colby
63,2013-2014,2013-10-18,2014-04-14,179,0,80,490,570,40,72,112,682,22,162,KS - Colby
64,2014-2015,2014-11-12,2015-04-03,143,0,54,398,452,34,66,100,552,19,136,KS - Colby
65,2015-2016,2015-11-18,2016-04-30,165,1,18,304,322,46,86,132,454,13,81,KS - Colby
66,2016-2017,2016-11-18,2017-05-02,166,2,34,371,405,34,34,68,473,7,68,KS - Colby
67,2017-2018,2017-11-01,2018-04-14,165,0,58,453,511,31,36,67,578,14,97,KS - Colby
68,2018-2019,2018-10-14,2019-05-22,221,2,66,441,507,57,70,127,634,24,160,KS - Colby
69,2019-2020,2019-10-29,2020-04-03,158,2,20,364,384,27,28,55,439,13,79,KS - Colby
1,1951-1952,1951-11-02,1952-04-09,160,0,51,289,340,32,36,68,408,17,90,KS - Concordia
2,1952-1953,1952-11-25,1953-03-08,104,0,38,213,251,33,118,151,402,14,74,KS - Concordia
3,1953-1954,1953-11-06,1954-03-29,144,1,35,228,263,13,11,24,287,8,33,KS - Concordia
4,1954-1955,1954-12-01,1955-03-27,117,8,38,253,291,29,89,118,409,14,85,KS - Concordia
5,1955-1956,1955-11-15,1956-04-23,161,1,72,332,404,43,108,151,555,25,158,KS - Concordia
6,1956-1957,1956-11-15,1957-04-11,148,16,53,252,305,37,44,81,386,21,110,KS - Concordia
7,1957-1958,1957-10-24,1958-03-19,147,18,49,261,310,70,143,213,523,32,180,KS - Concordia
8,1958-1959,1958-11-17,1959-03-26,130,0,73,301,374,52,98,150,524,24,178,KS - Concordia
9,1959-1960,1959-11-05,1960-04-09,157,0,102,356,458,92,325,417,875,35,239,KS - Concordia
10,1960-1961,1960-11-30,1961-05-01,153,0,29,217,246,36,27,63,309,23,89,KS - Concordia
11,1961-1962,1961-11-15,1962-03-13,119,20,102,321,423,35,125,160,583,23,150,KS - Concordia
12,1962-1963,1962-11-16,1963-03-06,111,0,75,321,396,29,61,90,486,18,136,KS - Concordia
13,1963-1964,1963-12-01,1964-03-25,116,0,57,304,361,20,17,37,398,14,83,KS - Concordia
14,1964-1965,1964-11-18,1965-03-25,128,0,62,368,430,42,77,119,549,15,107,KS - Concordia
15,1965-1966,1965-12-01,1966-03-24,114,0,50,276,326,14,11,25,351,10,58,KS - Concordia
16,1966-1967,1966-11-09,1967-04-23,166,0,49,325,374,35,97,132,506,15,109,KS - Concordia
17,1967-1968,1967-11-02,1968-04-23,174,0,54,313,367,27,50,77,444,16,89,KS - Concordia
18,1968-1969,1968-11-30,1969-03-29,120,0,71,331,402,54,154,208,610,25,146,KS - Concordia
19,1969-1970,1969-12-01,1970-04-12,133,0,58,312,370,25,20,45,415,13,66,KS - Concordia
20,1970-1971,1970-10-09,1971-03-26,169,0,73,362,435,65,176,241,676,21,128,KS - Concordia
21,1971-1972,1971-11-22,1972-02-29,100,0,49,252,301,22,28,50,351,9,51,KS - Concordia
22,1972-1973,1972-11-13,1973-04-08,147,0,83,280,363,40,98,138,501,22,111,KS - Concordia
23,1973-1974,1973-11-20,1974-04-04,136,0,78,276,354,39,141,180,534,26,172,KS - Concordia
24,1974-1975,1974-11-29,1975-04-02,125,0,47,285,332,54,109,163,495,20,125,KS - Concordia
25,1975-1976,1975-11-19,1976-03-30,133,0,43,272,315,31,30,61,376,15,86,KS - Concordia
26,1976-1977,1976-10-26,1977-04-03,160,0,54,372,426,22,76,98,524,14,83,KS - Concordia
27,1977-1978,1977-11-09,1978-03-11,123,0,122,439,561,37,169,206,767,19,148,KS - Concordia
28,1978-1979,1978-11-14,1979-04-03,141,0,135,461,596,42,275,317,913,19,144,KS - Concordia
29,1979-1980,1979-10-22,1980-03-29,160,0,61,326,387,43,108,151,538,19,121,KS - Concordia
30,1980-1981,1980-12-01,1981-02-28,90,0,29,209,238,9,22,31,269,4,29,KS - Concordia
31,1981-1982,1981-11-19,1982-04-08,141,0,87,343,430,34,64,98,528,20,129,KS - Concordia
32,1982-1983,1982-11-23,1983-04-14,143,0,44,230,274,50,117,167,441,19,95,KS - Concordia
33,1983-1984,1983-11-23,1984-03-21,120,0,126,331,457,51,235,286,743,17,165,KS - Concordia
34,1984-1985,1984-11-10,1985-03-31,142,0,79,327,406,37,182,219,625,13,101,KS - Concordia
35,1985-1986,1985-11-10,1986-03-07,118,0,70,286,356,23,55,78,434,13,94,KS - Concordia
36,1986-1987,1986-11-11,1987-04-01,142,0,18,199,217,38,46,84,301,14,74,KS - Concordia
37,1987-1988,1987-11-27,1988-03-18,113,0,62,279,341,37,115,152,493,16,111,KS - Concordia
38,1988-1989,1988-11-15,1989-03-20,126,0,49,261,310,12,14,26,336,8,40,KS - Concordia
39,1989-1990,1989-11-16,1990-03-25,130,0,56,274,330,26,53,79,409,14,101,KS - Concordia
40,1990-1991,1990-11-03,1991-03-15,133,0,60,279,339,26,59,85,424,15,118,KS - Concordia
41,1991-1992,1991-10-30,1992-04-21,175,0,17,173,190,28,49,77,267,13,54,KS - Concordia
43,1993-1994,1993-10-30,1994-05-01,184,0,59,324,383,22,44,66,449,12,83,KS - Concordia
50,2000-2001,2000-11-12,2001-03-07,116,6,83,347,430,58,210,268,698,16,156,KS - Concordia
54,2004-2005,2004-11-28,2005-02-28,93,0,49,200,249,26,63,89,338,8,60,KS - Concordia
55,2005-2006,2005-11-15,2006-03-24,130,0,39,233,272,22,35,57,329,7,51,KS - Concordia
56,2006-2007,2006-11-29,2007-04-05,128,0,52,239,291,25,68,93,384,8,58,KS - Concordia
57,2007-2008,2007-11-23,2008-02-29,99,0,51,277,328,36,153,189,517,19,109,KS - Concordia
58,2008-2009,2008-12-01,2009-04-02,123,0,49,305,354,19,26,45,399,10,63,KS - Concordia
59,2009-2010,2009-11-16,2010-03-21,126,0,91,308,399,53,239,292,691,20,138,KS - Concordia
60,2010-2011,2010-11-23,2011-03-14,112,0,66,309,375,29,69,98,473,8,85,KS - Concordia
61,2011-2012,2011-12-01,2012-02-29,91,0,16,172,188,13,9,22,210,8,31,KS - Concordia
62,2012-2013,2012-12-01,2013-04-23,144,0,37,276,313,43,93,136,449,14,76,KS - Concordia
63,2013-2014,2013-11-22,2014-03-24,123,0,95,373,468,34,91,125,593,17,119,KS - Concordia
64,2014-2015,2014-11-10,2015-02-28,111,0,51,287,338,21,18,39,377,13,79,KS - Concordia
65,2015-2016,2015-11-26,2016-02-29,96,0,23,158,181,17,43,60,241,5,25,KS - Concordia
66,2016-2017,2016-12-01,2017-03-11,101,0,31,199,230,7,6,13,243,6,41,KS - Concordia
67,2017-2018,2017-12-01,2018-04-15,136,0,62,320,382,23,29,52,434,16,106,KS - Concordia
68,2018-2019,2018-10-14,2019-03-30,168,0,74,331,405,67,162,229,634,18,129,KS - Concordia
69,2019-2020,2019-10-30,2020-04-16,170,1,15,200,215,16,14,30,245,9,38,KS - Concordia
0,1950-1951,1950-11-09,1951-04-10,153,0,43,321,364,21,15,36,400,12,86,KS - Dodge City
1,1951-1952,1951-10-31,1952-03-22,144,0,28,263,291,31,32,63,354,11,70,KS - Dodge City
2,1952-1953,1952-11-09,1953-04-11,154,0,25,223,248,24,104,128,376,15,56,KS - Dodge City
3,1953-1954,1953-11-06,1954-03-02,117,0,18,187,205,16,13,29,234,9,40,KS - Dodge City
4,1954-1955,1954-12-01,1955-03-26,116,0,24,239,263,14,17,31,294,12,71,KS - Dodge City
5,1955-1956,1955-11-15,1956-04-10,148,0,39,308,347,32,69,101,448,15,85,KS - Dodge City
6,1956-1957,1956-11-20,1957-04-12,144,0,46,261,307,40,40,80,387,15,93,KS - Dodge City
7,1957-1958,1957-11-16,1958-03-29,134,0,35,238,273,36,51,87,360,23,97,KS - Dodge City
8,1958-1959,1958-11-17,1959-04-10,145,0,46,303,349,39,58,97,446,18,120,KS - Dodge City
9,1959-1960,1959-11-04,1960-03-18,136,0,76,333,409,47,152,199,608,19,151,KS - Dodge City
10,1960-1961,1960-10-30,1961-04-08,161,0,23,236,259,20,24,44,303,16,60,KS - Dodge City
11,1961-1962,1961-11-15,1962-03-11,117,0,63,288,351,15,38,53,404,10,65,KS - Dodge City
12,1962-1963,1962-11-15,1963-02-28,106,0,49,267,316,14,5,19,335,11,66,KS - Dodge City
13,1963-1964,1963-12-01,1964-03-25,116,0,33,278,311,24,37,61,372,15,89,KS - Dodge City
14,1964-1965,1964-11-18,1965-03-25,128,0,30,317,347,30,65,95,442,16,94,KS - Dodge City
15,1965-1966,1965-12-01,1966-03-22,112,0,54,246,300,24,77,101,401,14,107,KS - Dodge City
16,1966-1967,1966-12-01,1967-03-07,97,0,32,243,275,24,47,71,346,13,80,KS - Dodge City
17,1967-1968,1967-11-02,1968-03-11,131,0,34,250,284,20,15,35,319,18,93,KS - Dodge City
18,1968-1969,1968-12-01,1969-03-24,114,0,49,257,306,43,126,169,475,16,101,KS - Dodge City
19,1969-1970,1969-11-17,1970-04-03,138,0,25,265,290,46,42,88,378,18,106,KS - Dodge City
20,1970-1971,1970-10-08,1971-03-05,149,0,48,272,320,39,108,147,467,12,90,KS - Dodge City
21,1971-1972,1971-11-22,1972-03-29,129,0,32,242,274,21,20,41,315,14,91,KS - Dodge City
22,1972-1973,1972-10-31,1973-04-26,178,0,77,297,374,42,67,109,483,27,158,KS - Dodge City
23,1973-1974,1973-11-20,1974-04-03,135,0,58,246,304,29,91,120,424,17,127,KS - Dodge City
24,1974-1975,1974-11-29,1975-03-15,107,0,29,244,273,22,27,49,322,13,64,KS - Dodge City
25,1975-1976,1975-11-19,1976-03-31,134,0,30,241,271,17,15,32,303,8,41,KS - Dodge City
26,1976-1977,1976-10-26,1977-04-04,161,0,39,305,344,23,34,57,401,13,77,KS - Dodge City
27,1977-1978,1977-11-08,1978-05-03,177,0,78,364,442,42,101,143,585,22,149,KS - Dodge City
28,1978-1979,1978-11-11,1979-05-04,175,0,106,383,489,42,93,135,624,24,179,KS - Dodge City
29,1979-1980,1979-11-10,1980-04-02,145,0,57,299,356,52,70,122,478,20,130,KS - Dodge City
30,1980-1981,1980-10-28,1981-03-09,133,0,18,217,235,19,14,33,268,9,55,KS - Dodge City
31,1981-1982,1981-12-01,1982-03-27,117,0,57,264,321,27,70,97,418,11,96,KS - Dodge City
32,1982-1983,1982-11-27,1983-04-13,138,0,26,171,197,46,80,126,323,17,84,KS - Dodge City
33,1983-1984,1983-11-09,1984-04-29,173,0,96,326,422,42,85,127,549,22,161,KS - Dodge City
34,1984-1985,1984-11-26,1985-04-01,127,0,39,247,286,34,49,83,369,17,95,KS - Dodge City
35,1985-1986,1985-11-10,1986-02-28,111,0,46,223,269,21,36,57,326,11,75,KS - Dodge City
36,1986-1987,1986-11-12,1987-03-31,140,0,19,189,208,42,66,108,316,12,78,KS - Dodge City
37,1987-1988,1987-11-26,1988-03-29,125,0,43,283,326,38,76,114,440,15,94,KS - Dodge City
38,1988-1989,1988-11-15,1989-04-10,147,0,32,306,338,16,5,21,359,8,40,KS - Dodge City
39,1989-1990,1989-12-01,1990-04-05,126,0,37,242,279,41,68,109,388,18,110,KS - Dodge City
40,1990-1991,1990-11-03,1991-03-16,134,0,46,273,319,22,18,40,359,16,122,KS - Dodge City
41,1991-1992,1991-10-30,1992-03-22,145,0,12,164,176,11,19,30,206,6,36,KS - Dodge City
42,1992-1993,1992-11-11,1993-03-18,128,0,66,307,373,92,282,374,747,27,184,KS - Dodge City
43,1993-1994,1993-10-29,1994-04-06,160,0,28,328,356,13,7,20,376,9,52,KS - Dodge City
44,1994-1995,1994-12-01,1995-03-29,119,0,30,189,219,37,54,91,310,16,118,KS - Dodge City
45,1995-1996,1995-09-21,1996-03-25,187,0,45,352,397,24,16,40,437,14,100,KS - Dodge City
46,1996-1997,1996-10-21,1997-04-11,173,0,43,287,330,25,20,45,375,14,78,KS - Dodge City
47,1997-1998,1997-10-25,1998-04-03,161,0,27,228,255,63,84,147,402,23,119,KS - Dodge City
48,1998-1999,1998-12-01,1999-03-19,109,0,27,198,225,45,46,91,316,14,90,KS - Dodge City
49,1999-2000,1999-12-01,2000-03-18,109,0,11,186,197,16,21,37,234,7,32,KS - Dodge City
50,2000-2001,2000-11-12,2001-03-26,135,0,41,306,347,50,76,126,473,17,118,KS - Dodge City
51,2001-2002,2001-11-27,2002-03-25,119,0,19,281,300,20,30,50,350,9,49,KS - Dodge City
52,2002-2003,2002-10-24,2003-03-05,133,0,37,253,290,32,62,94,384,13,74,KS - Dodge City
53,2003-2004,2003-11-05,2004-04-12,160,0,24,263,287,21,26,47,334,10,52,KS - Dodge City
54,2004-2005,2004-11-13,2005-02-28,108,0,29,174,203,29,28,57,260,13,75,KS - Dodge City
55,2005-2006,2005-11-27,2006-03-24,118,0,23,205,228,22,27,49,277,10,61,KS - Dodge City
56,2006-2007,2006-11-29,2007-04-14,137,0,32,224,256,32,29,61,317,14,90,KS - Dodge City
57,2007-2008,2007-11-23,2008-03-07,106,0,20,251,271,30,53,83,354,10,67,KS - Dodge City
58,2008-2009,2008-12-01,2009-04-05,126,0,25,265,290,31,23,54,344,13,91,KS - Dodge City
59,2009-2010,2009-11-15,2010-03-20,126,0,45,277,322,34,63,97,419,19,99,KS - Dodge City
60,2010-2011,2010-12-01,2011-04-15,136,0,28,280,308,22,35,57,365,12,85,KS - Dodge City
61,2011-2012,2011-11-02,2012-02-29,120,0,11,195,206,11,30,41,247,5,20,KS - Dodge City
62,2012-2013,2012-12-01,2013-05-02,153,0,20,281,301,41,83,124,425,14,84,KS - Dodge City
63,2013-2014,2013-10-18,2014-04-14,179,0,75,356,431,46,80,126,557,23,171,KS - Dodge City
64,2014-2015,2014-11-11,2015-03-04,114,0,38,260,298,32,39,71,369,16,98,KS - Dodge City
65,2015-2016,2015-11-18,2016-03-18,122,0,15,178,193,19,29,48,241,10,39,KS - Dodge City
66,2016-2017,2016-12-01,2017-04-30,151,0,23,226,249,12,10,22,271,6,39,KS - Dodge City
67,2017-2018,2017-12-01,2018-04-07,128,0,31,295,326,9,4,13,339,6,34,KS - Dodge City
68,2018-2019,2018-10-14,2019-03-30,168,0,38,298,336,37,43,80,416,20,113,KS - Dodge City
69,2019-2020,2019-10-30,2020-02-29,123,0,9,198,207,24,17,41,248,13,55,KS - Dodge City
0,1950-1951,1950-11-09,1951-04-21,164,0,53,483,536,30,19,49,585,20,144,KS - Goodland
1,1951-1952,1951-10-31,1952-04-09,162,0,44,471,515,41,35,76,591,24,147,KS - Goodland
2,1952-1953,1952-10-14,1953-04-18,187,0,39,443,482,45,92,137,619,19,131,KS - Goodland
3,1953-1954,1953-11-04,1954-05-02,180,0,34,363,397,62,103,165,562,22,138,KS - Goodland
4,1954-1955,1954-10-28,1955-03-27,151,0,46,431,477,37,99,136,613,18,140,KS - Goodland
5,1955-1956,1955-10-23,1956-04-09,170,0,59,466,525,41,89,130,655,21,151,KS - Goodland
6,1956-1957,1956-10-25,1957-04-12,170,0,51,438,489,67,69,136,625,35,223,KS - Goodland
7,1957-1958,1957-10-24,1958-04-29,188,0,40,446,486,68,165,233,719,32,179,KS - Goodland
8,1958-1959,1958-11-17,1959-04-12,147,0,46,397,443,65,76,141,584,31,213,KS - Goodland
9,1959-1960,1959-09-29,1960-03-18,172,0,94,478,572,78,219,297,869,33,254,KS - Goodland
10,1960-1961,1960-10-30,1961-04-25,178,0,25,372,397,54,65,119,516,26,128,KS - Goodland
11,1961-1962,1961-11-02,1962-03-29,148,0,87,478,565,45,82,127,692,20,185,KS - Goodland
12,1962-1963,1962-11-15,1963-03-16,122,0,65,360,425,51,61,112,537,20,172,KS - Goodland
13,1963-1964,1963-11-16,1964-04-12,149,0,44,443,487,54,66,120,607,26,157,KS - Goodland
14,1964-1965,1964-11-18,1965-03-26,129,0,48,464,512,39,40,79,591,22,166,KS - Goodland
15,1965-1966,1965-12-01,1966-05-12,163,0,59,375,434,45,125,170,604,25,180,KS - Goodland
16,1966-1967,1966-10-14,1967-05-04,203,0,30,408,438,40,31,71,509,19,117,KS - Goodland
17,1967-1968,1967-11-02,1968-05-16,197,0,29,397,426,31,33,64,490,22,112,KS - Goodland
18,1968-1969,1968-11-14,1969-03-16,123,0,55,365,420,55,150,205,625,22,157,KS - Goodland
19,1969-1970,1969-10-11,1970-05-01,203,0,25,372,397,64,48,112,509,30,142,KS - Goodland
20,1970-1971,1970-10-07,1971-03-18,163,0,40,355,395,54,67,121,516,27,151,KS - Goodland
21,1971-1972,1971-10-29,1972-03-28,152,0,34,340,374,27,18,45,419,18,121,KS - Goodland
22,1972-1973,1972-10-28,1973-05-01,186,0,99,416,515,109,177,286,801,49,332,KS - Goodland
23,1973-1974,1973-10-10,1974-04-13,186,0,68,369,437,66,121,187,624,30,227,KS - Goodland
24,1974-1975,1974-11-03,1975-04-18,167,0,31,432,463,50,53,103,566,20,129,KS - Goodland
25,1975-1976,1975-11-18,1976-03-29,133,0,33,297,330,50,101,151,481,20,123,KS - Goodland
26,1976-1977,1976-10-06,1977-04-20,197,0,34,436,470,53,77,130,600,20,132,KS - Goodland
27,1977-1978,1977-11-01,1978-05-06,187,0,101,497,598,47,126,173,771,28,217,KS - Goodland
28,1978-1979,1978-10-22,1979-04-03,164,0,94,447,541,86,113,199,740,31,218,KS - Goodland
29,1979-1980,1979-10-21,1980-04-08,171,0,59,346,405,137,243,380,785,33,239,KS - Goodland
30,1980-1981,1980-10-27,1981-04-03,159,0,33,333,366,57,126,183,549,14,110,KS - Goodland
31,1981-1982,1981-11-19,1982-05-05,168,0,58,383,441,32,74,106,547,17,128,KS - Goodland
32,1982-1983,1982-10-19,1983-04-13,177,0,34,299,333,76,184,260,593,30,143,KS - Goodland
33,1983-1984,1983-11-08,1984-04-30,175,0,123,422,545,136,277,413,958,34,311,KS - Goodland
34,1984-1985,1984-09-27,1985-05-13,229,0,54,363,417,56,115,171,588,24,145,KS - Goodland
35,1985-1986,1985-09-28,1986-04-27,212,0,63,343,406,47,57,104,510,22,147,KS - Goodland
36,1986-1987,1986-10-11,1987-04-13,185,0,27,305,332,74,85,159,491,29,147,KS - Goodland
37,1987-1988,1987-11-15,1988-05-02,170,0,66,385,451,88,132,220,671,22,185,KS - Goodland
38,1988-1989,1988-11-15,1989-04-30,167,0,62,397,459,40,29,69,528,20,130,KS - Goodland
39,1989-1990,1989-10-16,1990-05-04,201,0,49,378,427,58,90,148,575,21,148,KS - Goodland
40,1990-1991,1990-10-08,1991-05-04,209,0,69,370,439,58,49,107,546,25,169,KS - Goodland
41,1991-1992,1991-10-29,1992-03-18,142,0,25,238,263,37,69,106,369,17,76,KS - Goodland
42,1992-1993,1992-10-29,1993-04-07,161,0,92,451,543,66,216,282,825,27,188,KS - Goodland
43,1993-1994,1993-10-29,1994-04-30,184,0,56,439,495,60,106,166,661,19,135,KS - Goodland
44,1994-1995,1994-11-04,1995-04-27,175,0,42,336,378,70,100,170,548,28,185,KS - Goodland
45,1995-1996,1995-09-20,1996-04-28,222,0,58,473,531,50,54,104,635,21,163,KS - Goodland
46,1996-1997,1996-11-14,1997-04-13,151,0,62,414,476,35,60,95,571,14,127,KS - Goodland
47,1997-1998,1997-10-25,1998-03-11,138,0,40,272,312,57,81,138,450,20,109,KS - Goodland
48,1998-1999,1998-11-02,1999-04-23,173,0,34,332,366,44,49,93,459,16,104,KS - Goodland
49,1999-2000,1999-11-22,2000-04-15,146,0,7,286,293,32,13,45,338,20,83,KS - Goodland
50,2000-2001,2000-09-24,2001-03-26,184,0,53,398,451,51,107,158,609,23,159,KS - Goodland
51,2001-2002,2001-10-15,2002-03-26,163,0,26,371,397,27,35,62,459,11,75,KS - Goodland
52,2002-2003,2002-10-22,2003-04-07,168,0,38,348,386,33,32,65,451,16,93,KS - Goodland
53,2003-2004,2003-11-05,2004-04-12,160,0,24,351,375,34,33,67,442,19,103,KS - Goodland
54,2004-2005,2004-11-01,2005-04-29,180,0,33,293,326,26,18,44,370,17,85,KS - Goodland
55,2005-2006,2005-11-27,2006-04-07,132,0,32,285,317,39,56,95,412,16,119,KS - Goodland
56,2006-2007,2006-11-29,2007-04-14,137,0,73,360,433,70,386,456,889,20,184,KS - Goodland
57,2007-2008,2007-11-21,2008-05-03,165,0,39,393,432,54,98,152,584,23,136,KS - Goodland
58,2008-2009,2008-10-23,2009-04-06,166,0,30,391,421,33,27,60,481,22,109,KS - Goodland
59,2009-2010,2009-10-10,2010-04-07,180,0,52,392,444,56,73,129,573,28,154,KS - Goodland
60,2010-2011,2010-11-29,2011-04-15,138,0,46,368,414,40,58,98,512,17,127,KS - Goodland
61,2011-2012,2011-10-26,2012-02-29,127,0,15,301,316,29,52,81,397,13,72,KS - Goodland
62,2012-2013,2012-10-05,2013-05-02,210,0,36,470,506,86,124,210,716,27,188,KS - Goodland
63,2013-2014,2013-10-18,2014-04-13,178,0,79,432,511,45,70,115,626,23,186,KS - Goodland
64,2014-2015,2014-11-11,2015-04-03,144,0,57,342,399,40,64,104,503,22,156,KS - Goodland
65,2015-2016,2015-11-11,2016-04-29,171,0,20,292,312,42,60,102,414,13,76,KS - Goodland
66,2016-2017,2016-11-17,2017-04-30,165,0,37,354,391,20,13,33,424,11,70,KS - Goodland
67,2017-2018,2017-10-31,2018-04-24,176,0,43,412,455,41,56,97,552,18,122,KS - Goodland
68,2018-2019,2018-10-09,2019-04-11,185,0,52,409,461,46,63,109,570,24,151,KS - Goodland
69,2019-2020,2019-10-28,2020-03-14,139,0,21,312,333,33,30,63,396,14,97,KS - Goodland
1,1951-1952,1951-11-01,1952-04-10,162,8,38,414,452,29,46,75,527,16,90,KS - Hays
2,1952-1953,1952-11-24,1953-04-12,140,9,33,314,347,47,133,180,527,16,99,KS - Hays
3,1953-1954,1953-11-06,1954-03-30,145,7,35,326,361,39,53,92,453,11,69,KS - Hays
4,1954-1955,1954-12-01,1955-03-27,117,0,38,354,392,18,59,77,469,6,44,KS - Hays
5,1955-1956,1955-11-16,1956-04-10,147,4,65,434,499,46,155,201,700,13,115,KS - Hays
6,1956-1957,1956-11-21,1957-04-12,143,0,58,383,441,32,51,83,524,17,99,KS - Hays
7,1957-1958,1957-10-26,1958-03-30,156,0,44,381,425,70,207,277,702,18,137,KS - Hays
8,1958-1959,1958-11-17,1959-04-12,147,0,66,393,459,37,71,108,567,16,128,KS - Hays
9,1959-1960,1959-11-06,1960-03-25,141,0,92,444,536,61,281,342,878,17,163,KS - Hays
10,1960-1961,1960-11-09,1961-04-10,153,0,35,348,383,31,63,94,477,10,61,KS - Hays
11,1961-1962,1961-11-16,1962-03-12,117,16,85,372,457,38,103,141,598,14,140,KS - Hays
12,1962-1963,1962-11-16,1963-03-06,111,0,65,358,423,19,26,45,468,10,87,KS - Hays
13,1963-1964,1963-12-01,1964-03-26,117,0,46,363,409,15,40,55,464,4,34,KS - Hays
14,1964-1965,1964-11-19,1965-03-26,128,0,58,427,485,28,70,98,583,8,67,KS - Hays
15,1965-1966,1965-12-01,1966-03-23,113,0,61,330,391,21,89,110,501,10,77,KS - Hays
16,1966-1967,1966-12-01,1967-03-18,108,0,40,328,368,25,88,113,481,10,73,KS - Hays
17,1967-1968,1967-11-03,1968-02-29,119,0,41,327,368,12,29,41,409,7,40,KS - Hays
19,1969-1970,1969-12-01,1970-04-03,124,0,38,333,371,29,38,67,438,11,67,KS - Hays
20,1970-1971,1970-11-23,1971-03-26,124,0,54,367,421,41,127,168,589,10,87,KS - Hays
21,1971-1972,1971-11-28,1972-04-03,128,0,44,316,360,10,15,25,385,5,36,KS - Hays
22,1972-1973,1972-11-10,1973-04-10,152,0,76,350,426,32,67,99,525,14,107,KS - Hays
23,1973-1974,1973-11-21,1974-04-04,135,0,68,315,383,46,189,235,618,14,112,KS - Hays
24,1974-1975,1974-11-29,1975-04-03,126,0,36,347,383,34,77,111,494,11,78,KS - Hays
25,1975-1976,1975-11-20,1976-03-16,118,0,40,314,354,23,40,63,417,6,44,KS - Hays
26,1976-1977,1976-10-27,1977-04-04,160,0,48,435,483,25,69,94,577,11,80,KS - Hays
27,1977-1978,1977-11-22,1978-03-24,123,0,84,443,527,36,131,167,694,9,81,KS - Hays
28,1978-1979,1978-11-12,1979-04-04,144,0,116,469,585,52,271,323,908,16,149,KS - Hays
29,1979-1980,1979-11-29,1980-04-03,127,0,49,315,364,53,140,193,557,12,96,KS - Hays
31,1981-1982,1981-11-20,1982-03-06,107,3,64,341,405,24,70,94,499,11,98,KS - Hays
32,1982-1983,1982-11-23,1983-04-05,134,8,28,248,276,33,84,117,393,14,75,KS - Hays
34,1984-1985,1984-11-27,1985-04-01,126,6,60,345,405,47,181,228,633,14,124,KS - Hays
36,1986-1987,1986-11-13,1987-04-01,140,4,22,255,277,37,41,78,355,11,70,KS - Hays
40,1990-1991,1990-11-28,1991-03-16,109,0,62,332,394,13,13,26,420,9,62,KS - Hays
41,1991-1992,1991-10-31,1992-03-19,141,1,15,206,221,14,30,44,265,5,28,KS - Hays
42,1992-1993,1992-11-12,1993-04-04,144,3,82,393,475,70,420,490,965,25,167,KS - Hays
43,1993-1994,1993-11-24,1994-04-30,158,0,47,340,387,25,46,71,458,12,75,KS - Hays
44,1994-1995,1994-11-23,1995-03-09,107,0,36,259,295,26,72,98,393,12,81,KS - Hays
45,1995-1996,1995-11-11,1996-03-26,137,10,59,427,486,21,45,66,552,10,82,KS - Hays
46,1996-1997,1996-11-22,1997-04-13,143,7,60,367,427,24,40,64,491,9,66,KS - Hays
47,1997-1998,1997-10-26,1998-03-19,145,10,32,281,313,31,86,117,430,11,48,KS - Hays
48,1998-1999,1998-11-10,1999-03-16,127,9,33,252,285,30,25,55,340,14,76,KS - Hays
49,1999-2000,1999-12-01,2000-03-04,95,4,12,217,229,18,23,41,270,8,46,KS - Hays
50,2000-2001,2000-11-13,2001-03-12,120,15,51,363,414,35,82,117,531,11,90,KS - Hays
51,2001-2002,2001-11-28,2002-03-26,119,4,26,327,353,15,43,58,411,4,41,KS - Hays
52,2002-2003,2002-10-24,2003-03-10,138,3,48,336,384,14,17,31,415,8,54,KS - Hays
53,2003-2004,2003-11-06,2004-04-13,160,0,48,350,398,23,92,115,513,12,73,KS - Hays
54,2004-2005,2004-11-29,2005-02-28,92,4,42,225,267,18,33,51,318,10,74,KS - Hays
55,2005-2006,2005-11-28,2006-03-24,117,3,37,259,296,21,41,62,358,9,63,KS - Hays
56,2006-2007,2006-11-30,2007-04-06,128,2,39,261,300,23,45,68,368,8,55,KS - Hays
57,2007-2008,2007-11-24,2008-03-08,106,5,33,316,349,47,177,224,573,11,82,KS - Hays
58,2008-2009,2008-11-28,2009-04-05,129,8,40,331,371,10,9,19,390,7,46,KS - Hays
59,2009-2010,2009-10-11,2010-03-20,161,0,63,327,390,30,66,96,486,15,94,KS - Hays
62,2012-2013,2012-12-01,2013-04-23,144,0,33,313,346,52,117,169,515,12,92,KS - Hays
63,2013-2014,2013-10-19,2014-03-08,141,2,84,409,493,31,55,86,579,17,135,KS - Hays
64,2014-2015,2014-11-12,2015-03-01,110,0,49,320,369,18,17,35,404,12,85,KS - Hays
65,2015-2016,2015-11-27,2016-03-24,119,0,20,218,238,24,41,65,303,7,39,KS - Hays
66,2016-2017,2016-12-01,2017-04-30,151,0,31,277,308,7,3,10,318,5,42,KS - Hays
67,2017-2018,2017-11-01,2018-04-15,166,0,54,411,465,19,11,30,495,15,84,KS - Hays
68,2018-2019,2018-10-15,2019-03-30,167,0,71,391,462,47,109,156,618,14,100,KS - Hays
69,2019-2020,2019-10-29,2020-02-29,124,0,18,281,299,20,16,36,335,13,61,KS - Hays
0,1950-1951,1950-12-01,1951-03-13,103,0,25,191,216,15,22,37,253,5,46,KS - Independence
1,1951-1952,1951-11-02,1952-03-04,124,0,13,156,169,23,31,54,223,6,48,KS - Independence
2,1952-1953,1952-11-28,1953-04-18,142,0,4,127,131,6,3,9,140,4,12,KS - Independence
3,1953-1954,1953-12-01,1954-03-02,92,6,10,151,161,9,6,15,176,3,23,KS - Independence
4,1954-1955,1954-12-01,1955-03-26,116,0,4,167,171,16,14,30,201,3,21,KS - Independence
5,1955-1956,1955-11-28,1956-03-15,109,1,15,209,224,26,47,73,297,10,46,KS - Independence
6,1956-1957,1956-12-01,1957-04-12,133,3,20,147,167,10,5,15,182,3,17,KS - Independence
7,1957-1958,1957-12-01,1958-03-17,107,1,18,172,190,30,22,52,242,7,45,KS - Independence
8,1958-1959,1958-11-27,1959-03-05,99,0,32,203,235,24,45,69,304,8,59,KS - Independence
9,1959-1960,1959-11-17,1960-03-15,120,0,29,198,227,29,68,97,324,11,62,KS - Independence
10,1960-1961,1960-12-01,1961-02-28,90,0,12,167,179,7,4,11,190,2,9,KS - Independence
11,1961-1962,1961-12-01,1962-03-01,91,0,36,190,226,16,28,44,270,5,33,KS - Independence
12,1962-1963,1962-12-01,1963-02-28,90,1,34,229,263,9,7,16,279,4,39,KS - Independence
13,1963-1964,1963-12-01,1964-03-25,116,0,27,223,250,16,10,26,276,5,41,KS - Independence
14,1964-1965,1964-11-21,1965-03-25,125,0,23,246,269,5,3,8,277,2,16,KS - Independence
15,1965-1966,1965-12-01,1966-02-28,90,0,21,155,176,8,6,14,190,6,25,KS - Independence
16,1966-1967,1966-12-01,1967-03-08,98,0,18,197,215,16,40,56,271,5,33,KS - Independence
17,1967-1968,1967-12-01,1968-03-20,111,1,17,162,179,6,3,9,188,2,12,KS - Independence
18,1968-1969,1968-12-01,1969-03-11,101,0,20,172,192,9,11,20,212,3,15,KS - Independence
19,1969-1970,1969-12-01,1970-03-19,109,0,27,185,212,29,30,59,271,3,45,KS - Independence
20,1970-1971,1970-11-23,1971-02-28,98,0,20,168,188,14,17,31,219,3,25,KS - Independence
21,1971-1972,1971-11-22,1972-02-29,100,0,16,144,160,19,17,36,196,5,35,KS - Independence
22,1972-1973,1972-11-16,1973-02-28,105,3,40,183,223,20,56,76,299,9,43,KS - Independence
24,1974-1975,1974-11-29,1975-03-28,120,2,11,154,165,30,29,59,224,9,43,KS - Independence
26,1976-1977,1976-11-28,1977-02-28,93,0,31,236,267,12,33,45,312,4,34,KS - Independence
27,1977-1978,1977-12-01,1978-03-04,94,0,54,268,322,33,125,158,480,11,84,KS - Independence
28,1978-1979,1978-12-01,1979-04-03,124,9,63,334,397,29,158,187,584,12,96,KS - Independence
29,1979-1980,1979-12-01,1980-03-02,93,0,21,202,223,24,51,75,298,3,34,KS - Independence
30,1980-1981,1980-12-01,1981-02-28,90,0,8,168,176,3,8,11,187,2,13,KS - Independence
32,1982-1983,1982-12-01,1983-03-20,110,8,10,135,145,4,25,29,174,2,7,KS - Independence
33,1983-1984,1983-12-01,1984-03-31,122,3,65,294,359,27,106,133,492,9,94,KS - Independence
34,1984-1985,1984-11-18,1985-02-28,103,4,29,242,271,26,59,85,356,9,53,KS - Independence
35,1985-1986,1985-11-27,1986-02-28,94,11,23,190,213,15,15,30,243,7,37,KS - Independence
37,1987-1988,1987-12-01,1988-03-17,108,3,27,191,218,46,88,134,352,11,76,KS - Independence
38,1988-1989,1988-12-01,1989-03-05,95,1,21,149,170,14,14,28,198,7,41,KS - Independence
39,1989-1990,1989-12-01,1990-03-24,114,1,27,170,197,20,27,47,244,10,49,KS - Independence
40,1990-1991,1990-12-01,1991-02-28,90,2,23,148,171,9,5,14,185,9,47,KS - Independence
41,1991-1992,1991-11-02,1992-03-19,139,7,3,95,98,1,0,1,99,1,1,KS - Independence
42,1992-1993,1992-11-22,1993-02-28,99,4,18,134,152,29,59,88,240,7,45,KS - Independence
43,1993-1994,1993-11-25,1994-03-09,105,5,21,167,188,13,8,21,209,6,34,KS - Independence
44,1994-1995,1994-12-01,1995-03-07,97,1,10,106,116,10,9,19,135,6,31,KS - Independence
45,1995-1996,1995-12-01,1996-03-09,100,6,39,219,258,13,13,26,284,8,38,KS - Independence
46,1996-1997,1996-11-25,1997-02-28,96,4,28,182,210,17,40,57,267,7,41,KS - Independence
47,1997-1998,1997-11-12,1998-03-20,129,1,8,132,140,12,4,16,156,6,22,KS - Independence
48,1998-1999,1998-12-01,1999-03-15,105,6,23,122,145,10,12,22,167,2,12,KS - Independence
49,1999-2000,1999-12-01,2000-03-12,103,1,5,121,126,18,20,38,164,4,28,KS - Independence
50,2000-2001,2000-11-09,2001-03-01,113,6,36,271,307,31,101,132,439,9,66,KS - Independence
51,2001-2002,2001-11-29,2002-03-04,96,8,10,156,166,9,14,23,189,2,17,KS - Independence
52,2002-2003,2002-12-01,2003-03-06,96,19,23,192,215,19,66,85,300,7,50,KS - Independence
53,2003-2004,2003-12-01,2004-02-29,91,4,15,158,173,20,20,40,213,4,32,KS - Independence
54,2004-2005,2004-12-01,2005-02-28,90,7,14,128,142,0,1,1,143,0,0,KS - Independence
55,2005-2006,2005-12-01,2006-02-28,90,9,14,147,161,9,8,17,178,3,15,KS - Independence
56,2006-2007,2006-12-01,2007-02-28,90,13,28,178,206,31,83,114,320,6,56,KS - Independence
59,2009-2010,2009-12-01,2010-03-22,112,13,35,222,257,29,45,74,331,6,53,KS - Independence
64,2014-2015,2014-11-13,2015-03-05,113,0,21,192,213,13,8,21,234,5,28,KS - Independence
65,2015-2016,2015-12-01,2016-02-29,91,0,9,108,117,2,0,2,119,2,6,KS - Independence
66,2016-2017,2016-12-01,2017-02-28,90,0,16,137,153,1,0,1,154,1,12,KS - Independence
67,2017-2018,2017-12-01,2018-02-28,90,0,24,191,215,5,3,8,223,3,18,KS - Independence
68,2018-2019,2018-11-12,2019-03-05,114,0,25,189,214,12,11,23,237,5,22,KS - Independence
69,2019-2020,2019-11-13,2020-02-29,109,0,7,126,133,6,1,7,140,3,15,KS - Independence
0,1950-1951,1950-11-23,1951-04-12,141,2,46,348,394,19,19,38,432,10,71,KS - Manhattan
1,1951-1952,1951-11-02,1952-03-26,146,4,30,325,355,24,44,68,423,13,84,KS - Manhattan
2,1952-1953,1952-11-26,1953-03-06,101,1,25,278,303,38,107,145,448,12,77,KS - Manhattan
3,1953-1954,1953-11-07,1954-03-29,143,0,24,258,282,13,18,31,313,4,25,KS - Manhattan
4,1954-1955,1954-12-01,1955-03-26,116,1,16,255,271,34,83,117,388,11,73,KS - Manhattan
5,1955-1956,1955-11-16,1956-04-09,146,3,48,344,392,37,69,106,498,20,124,KS - Manhattan
6,1956-1957,1956-11-21,1957-04-12,143,0,32,249,281,28,25,53,334,15,88,KS - Manhattan
7,1957-1958,1957-10-26,1958-03-19,145,0,33,261,294,28,44,72,366,16,88,KS - Manhattan
8,1958-1959,1958-11-27,1959-04-12,137,0,53,296,349,38,88,126,475,15,117,KS - Manhattan
9,1959-1960,1959-11-05,1960-03-26,143,3,57,387,444,73,250,323,767,22,164,KS - Manhattan
10,1960-1961,1960-12-01,1961-04-09,130,0,23,235,258,20,39,59,317,10,57,KS - Manhattan
11,1961-1962,1961-11-18,1962-03-13,116,1,69,312,381,36,108,144,525,18,141,KS - Manhattan
12,1962-1963,1962-12-01,1963-03-05,95,0,61,277,338,15,25,40,378,11,111,KS - Manhattan
13,1963-1964,1963-12-01,1964-03-26,117,0,39,265,304,17,35,52,356,12,62,KS - Manhattan
14,1964-1965,1964-11-19,1965-03-25,127,0,35,325,360,38,72,110,470,12,82,KS - Manhattan
15,1965-1966,1965-12-01,1966-02-28,90,5,35,199,234,10,10,20,254,5,26,KS - Manhattan
16,1966-1967,1966-12-01,1967-02-28,90,0,32,223,255,27,79,106,361,9,69,KS - Manhattan
17,1967-1968,1967-12-01,1968-02-29,91,3,31,205,236,34,53,87,323,11,85,KS - Manhattan
19,1969-1970,1969-12-01,1970-04-02,123,0,46,279,325,32,51,83,408,13,80,KS - Manhattan
20,1970-1971,1970-11-23,1971-03-26,124,0,48,278,326,44,134,178,504,7,68,KS - Manhattan
21,1971-1972,1971-11-23,1972-03-31,130,0,34,231,265,14,16,30,295,9,59,KS - Manhattan
22,1972-1973,1972-11-16,1973-02-28,105,0,70,239,309,31,94,125,434,11,82,KS - Manhattan
23,1973-1974,1973-12-01,1974-04-04,125,0,62,234,296,37,91,128,424,17,141,KS - Manhattan
24,1974-1975,1974-11-29,1975-04-03,126,0,25,245,270,50,108,158,428,13,91,KS - Manhattan
25,1975-1976,1975-11-20,1976-03-16,118,0,25,211,236,31,32,63,299,14,80,KS - Manhattan
26,1976-1977,1976-11-27,1977-04-04,129,0,43,316,359,18,73,91,450,10,62,KS - Manhattan
27,1977-1978,1977-11-26,1978-03-11,106,1,88,365,453,41,147,188,641,13,107,KS - Manhattan
28,1978-1979,1978-11-15,1979-03-23,129,1,115,388,503,57,326,383,886,18,176,KS - Manhattan
29,1979-1980,1979-11-29,1980-03-24,117,0,40,257,297,32,69,101,398,14,90,KS - Manhattan
30,1980-1981,1980-12-01,1981-02-28,90,0,23,188,211,14,24,38,249,6,49,KS - Manhattan
31,1981-1982,1981-12-01,1982-04-08,129,2,65,303,368,25,51,76,444,9,95,KS - Manhattan
32,1982-1983,1982-11-23,1983-04-14,143,3,19,196,215,41,86,127,342,16,74,KS - Manhattan
33,1983-1984,1983-11-23,1984-03-24,123,12,95,330,425,43,144,187,612,19,157,KS - Manhattan
34,1984-1985,1984-11-10,1985-03-31,142,0,49,286,335,30,185,215,550,12,93,KS - Manhattan
35,1985-1986,1985-11-23,1986-02-28,98,4,36,264,300,15,48,63,363,8,64,KS - Manhattan
36,1986-1987,1986-11-13,1987-03-30,138,10,13,194,207,16,38,54,261,7,39,KS - Manhattan
37,1987-1988,1987-11-28,1988-03-18,112,0,35,274,309,28,56,84,393,13,73,KS - Manhattan
38,1988-1989,1988-12-01,1989-03-05,95,2,36,215,251,13,14,27,278,7,49,KS - Manhattan
39,1989-1990,1989-12-01,1990-03-25,115,7,40,229,269,26,52,78,347,9,63,KS - Manhattan
40,1990-1991,1990-12-01,1991-03-14,104,6,41,250,291,14,43,57,348,7,64,KS - Manhattan
41,1991-1992,1991-10-31,1992-03-10,132,4,9,175,184,12,16,28,212,6,29,KS - Manhattan
42,1992-1993,1992-11-25,1993-03-19,115,20,42,286,328,44,112,156,484,13,91,KS - Manhattan
43,1993-1994,1993-11-24,1994-02-28,97,4,33,268,301,14,14,28,329,5,36,KS - Manhattan
44,1994-1995,1994-12-01,1995-03-09,99,12,23,229,252,25,51,76,328,6,58,KS - Manhattan
46,1996-1997,1996-11-24,1997-02-28,97,15,41,262,303,15,42,57,360,4,28,KS - Manhattan
48,1998-1999,1998-12-01,1999-03-08,98,7,29,189,218,8,9,17,235,6,34,KS - Manhattan
49,1999-2000,1999-12-01,2000-02-29,91,8,8,173,181,15,18,33,214,5,29,KS - Manhattan
50,2000-2001,2000-12-01,2001-03-03,93,10,36,302,338,43,157,200,538,13,102,KS - Manhattan
52,2002-2003,2002-12-01,2003-03-05,95,1,21,245,266,11,18,29,295,4,35,KS - Manhattan
53,2003-2004,2003-12-01,2004-02-29,91,5,40,227,267,36,121,157,424,13,97,KS - Manhattan
54,2004-2005,2004-11-24,2005-02-28,97,13,22,192,214,15,29,44,258,7,41,KS - Manhattan
55,2005-2006,2005-11-28,2006-03-22,115,9,20,186,206,30,34,64,270,9,66,KS - Manhattan
56,2006-2007,2006-11-30,2007-03-01,92,8,30,206,236,30,45,75,311,9,73,KS - Manhattan
57,2007-2008,2007-11-24,2008-03-08,106,3,30,303,333,51,110,161,494,19,113,KS - Manhattan
58,2008-2009,2008-12-01,2009-03-29,119,1,40,302,342,23,37,60,402,10,77,KS - Manhattan
59,2009-2010,2009-12-01,2010-03-21,111,0,67,346,413,45,145,190,603,17,137,KS - Manhattan
60,2010-2011,2010-12-01,2011-03-28,118,0,54,307,361,39,115,154,515,11,102,KS - Manhattan
61,2011-2012,2011-11-09,2012-02-29,113,2,12,186,198,8,5,13,211,5,19,KS - Manhattan
62,2012-2013,2012-12-01,2013-04-23,144,0,29,258,287,37,64,101,388,11,63,KS - Manhattan
63,2013-2014,2013-11-23,2014-04-14,143,0,100,378,478,58,181,239,717,17,155,KS - Manhattan
64,2014-2015,2014-11-12,2015-03-01,110,0,51,285,336,20,35,55,391,9,69,KS - Manhattan
65,2015-2016,2015-11-28,2016-03-24,118,0,23,169,192,13,19,32,224,7,32,KS - Manhattan
66,2016-2017,2016-12-01,2017-03-15,105,2,33,209,242,6,8,14,256,4,37,KS - Manhattan
67,2017-2018,2017-12-01,2018-04-07,128,1,64,298,362,10,19,29,391,7,50,KS - Manhattan
68,2018-2019,2018-11-09,2019-03-06,118,0,65,301,366,37,79,116,482,10,77,KS - Manhattan
69,2019-2020,2019-10-31,2020-04-17,170,3,23,256,279,16,12,28,307,7,36,KS - Manhattan
1,1951-1952,1951-11-02,1952-04-10,161,5,34,363,397,57,128,185,582,14,108,KS - Smith Center
2,1952-1953,1952-11-24,1953-03-05,102,2,39,265,304,57,162,219,523,14,115,KS - Smith Center
4,1954-1955,1954-12-01,1955-03-26,116,1,22,368,390,29,64,93,483,7,63,KS - Smith Center
5,1955-1956,1955-11-16,1956-03-12,118,1,59,388,447,29,104,133,580,8,77,KS - Smith Center
6,1956-1957,1956-12-01,1957-04-08,129,0,39,353,392,18,15,33,425,7,46,KS - Smith Center
7,1957-1958,1957-10-25,1958-03-28,155,0,37,399,436,69,183,252,688,15,114,KS - Smith Center
8,1958-1959,1958-11-18,1959-03-15,118,5,53,388,441,39,66,105,546,13,124,KS - Smith Center
10,1960-1961,1960-12-01,1961-04-10,131,0,22,330,352,27,33,60,412,14,77,KS - Smith Center
12,1962-1963,1962-11-18,1963-03-13,116,3,63,320,383,11,9,20,403,7,62,KS - Smith Center
13,1963-1964,1963-12-01,1964-03-25,116,0,47,311,358,10,16,26,384,5,36,KS - Smith Center
14,1964-1965,1964-11-21,1965-03-26,126,0,38,380,418,29,103,132,550,10,90,KS - Smith Center
15,1965-1966,1965-12-01,1966-04-20,141,0,44,294,338,14,40,54,392,8,54,KS - Smith Center
16,1966-1967,1966-12-01,1967-02-28,90,3,38,257,295,18,74,92,387,4,44,KS - Smith Center
17,1967-1968,1967-11-04,1968-02-29,118,1,32,303,335,18,63,81,416,10,85,KS - Smith Center
18,1968-1969,1968-12-01,1969-03-30,120,0,65,334,399,53,206,259,658,17,122,KS - Smith Center
19,1969-1970,1969-12-01,1970-04-13,134,0,41,329,370,35,83,118,488,18,116,KS - Smith Center
20,1970-1971,1970-11-23,1971-03-25,123,0,49,341,390,45,164,209,599,13,102,KS - Smith Center
21,1971-1972,1971-11-28,1972-04-03,128,0,29,285,314,17,17,34,348,12,73,KS - Smith Center
22,1972-1973,1972-11-13,1973-04-10,149,0,73,295,368,34,93,127,495,22,138,KS - Smith Center
23,1973-1974,1973-11-21,1974-04-04,135,0,64,293,357,34,153,187,544,18,131,KS - Smith Center
24,1974-1975,1974-11-29,1975-04-02,125,0,33,302,335,34,90,124,459,16,100,KS - Smith Center
25,1975-1976,1975-11-20,1976-03-16,118,0,36,289,325,37,76,113,438,13,88,KS - Smith Center
26,1976-1977,1976-11-27,1977-04-04,129,0,39,342,381,19,70,89,470,10,72,KS - Smith Center
27,1977-1978,1977-11-21,1978-03-08,108,0,93,411,504,24,126,150,654,12,107,KS - Smith Center
28,1978-1979,1978-11-16,1979-04-02,138,0,103,436,539,34,133,167,706,21,137,KS - Smith Center
29,1979-1980,1979-11-28,1980-04-03,128,0,50,298,348,45,142,187,535,16,119,KS - Smith Center
30,1980-1981,1980-10-28,1981-03-07,131,0,20,267,287,11,17,28,315,9,49,KS - Smith Center
31,1981-1982,1981-12-01,1982-03-06,96,0,67,333,400,23,72,95,495,14,130,KS - Smith Center
32,1982-1983,1982-11-23,1983-04-13,142,1,24,236,260,19,59,78,338,12,55,KS - Smith Center
33,1983-1984,1983-11-27,1984-03-22,117,0,101,363,464,41,270,311,775,15,131,KS - Smith Center
34,1984-1985,1984-11-10,1985-03-31,142,0,60,357,417,30,229,259,676,11,83,KS - Smith Center
35,1985-1986,1985-09-29,1986-02-28,153,2,56,304,360,15,24,39,399,8,62,KS - Smith Center
36,1986-1987,1986-11-12,1987-03-31,140,0,13,229,242,27,33,60,302,8,48,KS - Smith Center
37,1987-1988,1987-11-27,1988-03-17,112,1,59,295,354,32,101,133,487,12,87,KS - Smith Center
38,1988-1989,1988-11-16,1989-03-21,126,1,44,314,358,15,15,30,388,11,53,KS - Smith Center
39,1989-1990,1989-12-01,1990-04-13,134,0,50,280,330,15,55,70,400,9,76,KS - Smith Center
40,1990-1991,1990-12-01,1991-03-16,106,0,59,296,355,17,35,52,407,11,88,KS - Smith Center
41,1991-1992,1991-10-30,1992-03-19,142,0,20,182,202,22,50,72,274,9,52,KS - Smith Center
42,1992-1993,1992-11-06,1993-03-18,133,2,84,351,435,50,293,343,778,20,133,KS - Smith Center
43,1993-1994,1993-11-15,1994-04-30,167,0,53,333,386,28,66,94,480,12,92,KS - Smith Center
44,1994-1995,1994-12-01,1995-03-09,99,0,43,222,265,15,34,49,314,8,63,KS - Smith Center
45,1995-1996,1995-11-11,1996-04-15,157,1,60,378,438,23,26,49,487,11,81,KS - Smith Center
46,1996-1997,1996-11-14,1997-04-13,151,0,62,331,393,30,54,84,477,12,73,KS - Smith Center
47,1997-1998,1997-10-26,1998-03-16,142,0,31,235,266,37,94,131,397,13,68,KS - Smith Center
48,1998-1999,1998-11-10,1999-03-13,124,1,33,206,239,15,13,28,267,13,66,KS - Smith Center
49,1999-2000,1999-11-23,2000-03-03,102,1,11,176,187,11,27,38,225,5,25,KS - Smith Center
50,2000-2001,2000-11-07,2001-03-12,126,1,56,336,392,44,154,198,590,19,131,KS - Smith Center
51,2001-2002,2001-11-27,2002-03-26,120,0,26,278,304,23,58,81,385,10,69,KS - Smith Center
52,2002-2003,2002-10-24,2003-03-09,137,0,34,278,312,17,17,34,346,12,80,KS - Smith Center
53,2003-2004,2003-11-23,2004-04-12,142,0,55,291,346,32,146,178,524,13,98,KS - Smith Center
54,2004-2005,2004-11-28,2005-02-28,93,0,51,225,276,17,70,87,363,8,62,KS - Smith Center
55,2005-2006,2005-11-28,2006-03-24,117,0,47,279,326,22,47,69,395,9,54,KS - Smith Center
56,2006-2007,2006-11-30,2007-04-06,128,0,57,311,368,29,46,75,443,11,86,KS - Smith Center
57,2007-2008,2007-11-24,2008-03-08,106,8,57,343,400,40,119,159,559,16,102,KS - Smith Center
58,2008-2009,2008-12-01,2009-03-12,102,0,53,334,387,14,24,38,425,8,67,KS - Smith Center
59,2009-2010,2009-12-01,2010-03-20,110,0,77,325,402,30,149,179,581,14,97,KS - Smith Center
60,2010-2011,2010-11-21,2011-03-14,114,0,70,376,446,36,103,139,585,11,105,KS - Smith Center
61,2011-2012,2011-11-17,2012-02-29,105,1,19,266,285,14,38,52,337,8,38,KS - Smith Center
62,2012-2013,2012-12-01,2013-04-23,144,0,44,347,391,55,172,227,618,16,102,KS - Smith Center
63,2013-2014,2013-11-22,2014-04-14,144,0,88,448,536,43,81,124,660,16,127,KS - Smith Center
64,2014-2015,2014-11-11,2015-03-05,115,0,55,369,424,19,16,35,459,13,78,KS - Smith Center
65,2015-2016,2015-11-27,2016-03-24,119,0,26,227,253,25,64,89,342,11,45,KS - Smith Center
66,2016-2017,2016-12-01,2017-03-12,102,0,39,257,296,10,5,15,311,8,52,KS - Smith Center
67,2017-2018,2017-11-01,2018-04-15,166,0,71,414,485,23,33,56,541,14,98,KS - Smith Center
68,2018-2019,2018-10-15,2019-04-11,179,0,79,396,475,57,137,194,669,17,118,KS - Smith Center
69,2019-2020,2019-10-29,2020-03-14,138,0,22,299,321,18,10,28,349,12,54,KS - Smith Center
0,1950-1951,1950-11-03,1951-03-20,138,0,51,326,377,15,11,26,403,10,68,KS - Topeka
1,1951-1952,1951-11-02,1952-03-26,146,0,35,270,305,30,42,72,377,15,75,KS - Topeka
2,1952-1953,1952-11-24,1953-03-09,106,0,20,192,212,30,80,110,322,11,53,KS - Topeka
3,1953-1954,1953-11-06,1954-03-29,144,0,26,233,259,13,18,31,290,6,32,KS - Topeka
4,1954-1955,1954-12-01,1955-03-27,117,0,24,241,265,37,87,124,389,18,92,KS - Topeka
5,1955-1956,1955-11-15,1956-04-09,147,0,49,327,376,39,85,124,500,24,137,KS - Topeka
6,1956-1957,1956-11-20,1957-04-12,144,0,41,262,303,27,36,63,366,16,87,KS - Topeka
7,1957-1958,1957-12-01,1958-03-19,109,0,41,237,278,35,54,89,367,16,82,KS - Topeka
8,1958-1959,1958-11-26,1959-04-12,138,0,65,290,355,44,90,134,489,18,129,KS - Topeka
9,1959-1960,1959-11-05,1960-03-25,142,0,75,357,432,68,208,276,708,23,154,KS - Topeka
10,1960-1961,1960-12-01,1961-04-09,130,0,23,250,273,30,23,53,326,15,69,KS - Topeka
11,1961-1962,1961-11-18,1962-03-10,113,0,82,332,414,49,186,235,649,18,128,KS - Topeka
12,1962-1963,1962-12-01,1963-03-05,95,0,70,298,368,19,56,75,443,11,87,KS - Topeka
13,1963-1964,1963-12-01,1964-03-26,117,0,46,293,339,18,27,45,384,12,60,KS - Topeka
14,1964-1965,1964-11-18,1965-03-25,128,0,54,318,372,33,50,83,455,16,84,KS - Topeka
15,1965-1966,1965-12-01,1966-03-04,94,0,37,224,261,10,7,17,278,8,35,KS - Topeka
16,1966-1967,1966-12-01,1967-03-18,108,0,32,254,286,26,57,83,369,12,66,KS - Topeka
17,1967-1968,1967-12-01,1968-02-29,91,0,51,223,274,33,64,97,371,14,86,KS - Topeka
18,1968-1969,1968-12-01,1969-03-11,101,0,43,237,280,21,45,66,346,13,81,KS - Topeka
19,1969-1970,1969-11-13,1970-04-02,141,0,55,306,361,37,35,72,433,16,92,KS - Topeka
20,1970-1971,1970-10-09,1971-03-26,169,0,64,296,360,55,82,137,497,15,81,KS - Topeka
21,1971-1972,1971-11-22,1972-03-31,131,0,46,248,294,27,25,52,346,16,90,KS - Topeka
22,1972-1973,1972-11-13,1973-04-08,147,0,71,251,322,42,79,121,443,20,117,KS - Topeka
23,1973-1974,1973-12-01,1974-04-04,125,0,66,260,326,46,101,147,473,19,142,KS - Topeka
24,1974-1975,1974-11-29,1975-04-04,127,0,30,248,278,39,67,106,384,16,81,KS - Topeka
25,1975-1976,1975-11-20,1976-03-16,118,0,42,244,286,35,32,67,353,17,94,KS - Topeka
26,1976-1977,1976-11-26,1977-04-04,130,0,66,373,439,25,126,151,590,14,95,KS - Topeka
27,1977-1978,1977-11-26,1978-03-25,120,0,102,409,511,42,126,168,679,23,155,KS - Topeka
28,1978-1979,1978-11-19,1979-04-04,137,0,129,452,581,63,276,339,920,25,224,KS - Topeka
29,1979-1980,1979-11-28,1980-03-24,118,0,50,286,336,29,78,107,443,15,92,KS - Topeka
30,1980-1981,1980-12-01,1981-02-28,90,0,33,204,237,13,20,33,270,8,42,KS - Topeka
31,1981-1982,1981-12-01,1982-04-08,129,0,78,316,394,24,53,77,471,16,116,KS - Topeka
32,1982-1983,1982-11-23,1983-04-09,138,0,15,165,180,43,92,135,315,18,77,KS - Topeka
33,1983-1984,1983-11-09,1984-03-20,133,0,104,321,425,47,119,166,591,23,186,KS - Topeka
34,1984-1985,1984-12-01,1985-03-31,121,0,56,297,353,53,202,255,608,15,111,KS - Topeka
35,1985-1986,1985-11-20,1986-02-28,101,0,54,244,298,16,32,48,346,10,64,KS - Topeka
36,1986-1987,1986-11-10,1987-03-29,140,0,22,190,212,32,54,86,298,14,71,KS - Topeka
37,1987-1988,1987-11-27,1988-03-18,113,0,38,246,284,37,35,72,356,18,99,KS - Topeka
38,1988-1989,1988-11-19,1989-03-20,122,0,37,263,300,18,19,37,337,10,66,KS - Topeka
39,1989-1990,1989-11-16,1990-03-26,131,0,55,303,358,27,49,76,434,8,60,KS - Topeka
40,1990-1991,1990-12-01,1991-02-28,90,0,41,222,263,21,38,59,322,11,86,KS - Topeka
41,1991-1992,1991-11-01,1992-03-19,140,0,9,156,165,13,8,21,186,7,22,KS - Topeka
42,1992-1993,1992-11-05,1993-03-19,135,0,47,254,301,65,127,192,493,18,121,KS - Topeka
43,1993-1994,1993-11-24,1994-04-06,134,0,45,270,315,22,6,28,343,12,65,KS - Topeka
44,1994-1995,1994-12-01,1995-03-09,99,1,26,199,225,13,30,43,268,6,39,KS - Topeka
45,1995-1996,1995-11-02,1996-03-25,145,2,69,332,401,20,42,62,463,11,59,KS - Topeka
46,1996-1997,1996-10-22,1997-04-11,172,0,58,284,342,35,20,55,397,17,86,KS - Topeka
47,1997-1998,1997-12-01,1998-03-13,103,0,22,162,184,21,40,61,245,10,53,KS - Topeka
48,1998-1999,1998-12-01,1999-03-13,103,0,37,174,211,14,11,25,236,9,56,KS - Topeka
49,1999-2000,1999-12-01,2000-02-29,91,0,12,154,166,21,22,43,209,10,46,KS - Topeka
50,2000-2001,2000-11-08,2001-03-16,129,0,55,326,381,29,83,112,493,14,99,KS - Topeka
51,2001-2002,2001-11-28,2002-03-04,97,0,17,175,192,15,19,34,226,8,41,KS - Topeka
52,2002-2003,2002-12-01,2003-03-09,99,0,32,239,271,21,22,43,314,11,67,KS - Topeka
53,2003-2004,2003-12-01,2004-02-29,91,0,45,205,250,28,88,116,366,10,69,KS - Topeka
54,2004-2005,2004-11-23,2005-02-28,98,0,31,179,210,17,12,29,239,11,39,KS - Topeka
55,2005-2006,2005-11-28,2006-03-21,114,0,30,190,220,21,22,43,263,9,57,KS - Topeka
56,2006-2007,2006-11-29,2007-02-28,92,0,41,200,241,17,20,37,278,13,67,KS - Topeka
57,2007-2008,2007-11-22,2008-03-07,107,0,37,272,309,48,95,143,452,18,108,KS - Topeka
58,2008-2009,2008-11-29,2009-03-28,120,0,37,255,292,19,13,32,324,14,67,KS - Topeka
59,2009-2010,2009-12-01,2010-03-21,111,0,61,253,314,61,141,202,516,24,167,KS - Topeka
60,2010-2011,2010-12-01,2011-03-28,118,0,45,283,328,56,121,177,505,12,106,KS - Topeka
61,2011-2012,2011-12-01,2012-03-08,99,0,7,145,152,6,3,9,161,4,11,KS - Topeka
62,2012-2013,2012-12-01,2013-04-23,144,0,19,215,234,42,59,101,335,14,67,KS - Topeka
63,2013-2014,2013-11-22,2014-04-14,144,0,77,357,434,43,79,122,556,20,143,KS - Topeka
64,2014-2015,2014-11-12,2015-03-04,113,0,40,270,310,19,14,33,343,15,79,KS - Topeka
65,2015-2016,2015-11-27,2016-03-27,122,0,15,153,168,11,8,19,187,9,36,KS - Topeka
66,2016-2017,2016-12-01,2017-03-14,104,0,24,184,208,9,13,22,230,6,37,KS - Topeka
67,2017-2018,2017-10-31,2018-04-01,153,1,46,264,310,15,12,27,337,10,49,KS - Topeka
68,2018-2019,2018-10-14,2019-03-06,144,0,47,276,323,39,78,117,440,16,91,KS - Topeka
69,2019-2020,2019-10-30,2020-02-29,123,0,14,187,201,20,21,41,242,11,45,KS - Topeka
1,1951-1952,1951-10-31,1952-03-22,144,0,26,195,221,31,25,56,277,13,74,KS - Wichita
2,1952-1953,1952-11-25,1953-03-04,100,0,20,144,164,16,35,51,215,7,37,KS - Wichita
3,1953-1954,1953-11-06,1954-03-03,118,0,22,163,185,7,7,14,199,5,31,KS - Wichita
4,1954-1955,1954-12-01,1955-03-26,116,0,13,191,204,14,15,29,233,9,43,KS - Wichita
5,1955-1956,1955-11-15,1956-04-09,147,0,37,264,301,24,32,56,357,16,80,KS - Wichita
6,1956-1957,1956-12-01,1957-04-12,133,0,34,188,222,18,9,27,249,17,83,KS - Wichita
7,1957-1958,1957-10-26,1958-03-19,145,0,34,203,237,35,30,65,302,15,80,KS - Wichita
8,1958-1959,1958-11-26,1959-04-12,138,0,48,236,284,30,61,91,375,13,101,KS - Wichita
9,1959-1960,1959-11-05,1960-03-18,135,0,61,265,326,44,125,169,495,17,106,KS - Wichita
10,1960-1961,1960-10-30,1961-03-20,142,0,19,199,218,33,28,61,279,13,65,KS - Wichita
11,1961-1962,1961-11-18,1962-02-28,103,0,54,223,277,35,93,128,405,9,70,KS - Wichita
12,1962-1963,1962-12-01,1963-02-28,90,0,49,235,284,12,24,36,320,6,55,KS - Wichita
13,1963-1964,1963-12-01,1964-03-25,116,0,34,235,269,9,13,22,291,5,48,KS - Wichita
14,1964-1965,1964-11-19,1965-03-24,126,0,27,253,280,18,21,39,319,7,37,KS - Wichita
15,1965-1966,1965-12-01,1966-02-28,90,0,30,174,204,12,19,31,235,11,48,KS - Wichita
16,1966-1967,1966-12-01,1967-03-18,108,0,28,218,246,15,39,54,300,10,55,KS - Wichita
17,1967-1968,1967-11-02,1968-02-29,120,0,28,190,218,23,24,47,265,13,65,KS - Wichita
18,1968-1969,1968-11-30,1969-03-13,104,0,28,219,247,25,48,73,320,10,53,KS - Wichita
19,1969-1970,1969-12-01,1970-04-04,125,0,32,225,257,31,36,67,324,11,68,KS - Wichita
20,1970-1971,1970-11-23,1971-03-02,100,0,34,232,266,21,46,67,333,4,33,KS - Wichita
21,1971-1972,1971-11-22,1972-03-29,129,0,32,231,263,19,13,32,295,13,82,KS - Wichita
22,1972-1973,1972-11-15,1973-04-08,145,0,60,235,295,44,67,111,406,17,100,KS - Wichita
23,1973-1974,1973-12-01,1974-04-03,124,0,52,231,283,24,70,94,377,14,104,KS - Wichita
24,1974-1975,1974-11-04,1975-04-02,150,0,21,217,238,48,79,127,365,15,77,KS - Wichita
25,1975-1976,1975-11-24,1976-02-29,98,1,25,190,215,12,11,23,238,6,42,KS - Wichita
26,1976-1977,1976-11-27,1977-02-28,94,0,34,255,289,10,10,20,309,9,57,KS - Wichita
27,1977-1978,1977-12-01,1978-03-24,114,0,79,304,383,29,104,133,516,19,124,KS - Wichita
28,1978-1979,1978-11-20,1979-04-04,136,0,104,346,450,40,171,211,661,21,159,KS - Wichita
29,1979-1980,1979-12-01,1980-03-24,115,0,44,216,260,19,55,74,334,5,32,KS - Wichita
30,1980-1981,1980-12-01,1981-03-08,98,0,13,173,186,6,6,12,198,5,20,KS - Wichita
31,1981-1982,1981-12-01,1982-03-05,95,0,62,256,318,18,61,79,397,7,73,KS - Wichita
32,1982-1983,1982-11-27,1983-04-04,129,0,23,160,183,35,89,124,307,15,72,KS - Wichita
33,1983-1984,1983-11-23,1984-03-31,130,0,97,313,410,41,65,106,516,17,165,KS - Wichita
34,1984-1985,1984-11-18,1985-03-31,134,0,37,227,264,31,40,71,335,13,75,KS - Wichita
35,1985-1986,1985-11-24,1986-02-28,97,0,36,192,228,17,26,43,271,9,55,KS - Wichita
36,1986-1987,1986-11-12,1987-03-29,138,0,18,177,195,36,69,105,300,12,65,KS - Wichita
37,1987-1988,1987-11-27,1988-03-18,113,0,39,238,277,53,116,169,446,15,104,KS - Wichita
38,1988-1989,1988-11-19,1989-03-05,107,0,28,195,223,7,3,10,233,4,22,KS - Wichita
39,1989-1990,1989-12-01,1990-04-05,126,0,42,211,253,21,20,41,294,12,68,KS - Wichita
40,1990-1991,1990-12-01,1991-02-28,90,0,33,192,225,14,14,28,253,11,86,KS - Wichita
41,1991-1992,1991-10-31,1992-02-29,122,0,6,103,109,3,10,13,122,2,5,KS - Wichita
42,1992-1993,1992-11-25,1993-03-12,108,0,35,190,225,30,99,129,354,9,50,KS - Wichita
43,1993-1994,1993-11-24,1994-02-28,97,0,20,199,219,4,2,6,225,3,21,KS - Wichita
44,1994-1995,1994-12-01,1995-03-08,98,0,24,151,175,16,25,41,216,10,65,KS - Wichita
45,1995-1996,1995-11-02,1996-03-25,145,0,49,294,343,20,19,39,382,15,87,KS - Wichita
46,1996-1997,1996-10-22,1997-04-09,170,0,35,223,258,28,15,43,301,14,66,KS - Wichita
47,1997-1998,1997-10-26,1998-03-21,147,0,16,163,179,33,18,51,230,15,58,KS - Wichita
48,1998-1999,1998-12-01,1999-03-14,104,0,26,146,172,13,13,26,198,5,28,KS - Wichita
49,1999-2000,1999-12-01,2000-03-16,107,0,10,138,148,31,46,77,225,8,51,KS - Wichita
50,2000-2001,2000-12-01,2001-02-28,90,0,45,226,271,16,25,41,312,12,69,KS - Wichita
51,2001-2002,2001-11-28,2002-03-03,96,0,13,176,189,10,10,20,209,7,32,KS - Wichita
52,2002-2003,2002-12-01,2003-03-05,95,0,29,181,210,36,58,94,304,10,65,KS - Wichita
53,2003-2004,2003-12-01,2004-02-29,91,0,23,162,185,22,50,72,257,8,47,KS - Wichita
54,2004-2005,2004-11-24,2005-03-09,106,0,19,155,174,11,6,17,191,8,25,KS - Wichita
55,2005-2006,2005-12-01,2006-03-23,113,0,21,163,184,16,19,35,219,7,36,KS - Wichita
56,2006-2007,2006-11-30,2007-04-14,136,0,27,194,221,26,45,71,292,10,57,KS - Wichita
57,2007-2008,2007-11-23,2008-03-07,106,0,20,222,242,35,56,91,333,15,82,KS - Wichita
58,2008-2009,2008-12-01,2009-04-09,130,0,26,209,235,21,13,34,269,10,64,KS - Wichita
59,2009-2010,2009-12-01,2010-03-21,111,0,39,209,248,25,39,64,312,16,82,KS - Wichita
60,2010-2011,2010-12-01,2011-02-28,90,0,34,229,263,24,49,73,336,6,64,KS - Wichita
61,2011-2012,2011-11-08,2012-03-08,122,0,5,148,153,8,2,10,163,7,21,KS - Wichita
62,2012-2013,2012-12-01,2013-04-23,144,0,11,193,204,44,68,112,316,12,66,KS - Wichita
63,2013-2014,2013-11-22,2014-04-14,144,0,58,303,361,36,72,108,469,14,108,KS - Wichita
64,2014-2015,2014-11-12,2015-03-04,113,0,27,220,247,27,35,62,309,15,81,KS - Wichita
65,2015-2016,2015-11-27,2016-03-27,122,0,12,130,142,8,4,12,154,5,19,KS - Wichita
66,2016-2017,2016-12-01,2017-02-28,90,0,15,146,161,3,6,9,170,1,9,KS - Wichita
67,2017-2018,2017-12-01,2018-04-07,128,0,24,207,231,4,1,5,236,4,18,KS - Wichita
68,2018-2019,2018-10-14,2019-03-05,143,0,26,214,240,16,15,31,271,9,38,KS - Wichita
69,2019-2020,2019-10-30,2020-02-29,123,0,8,158,166,15,8,23,189,10,35,KS - Wichita
0,1950-1951,1950-11-23,1951-04-02,131,0,34,208,242,32,49,81,323,14,83,KY - Bowling Green
1,1951-1952,1951-11-02,1952-02-29,120,0,5,124,129,3,0,3,132,3,6,KY - Bowling Green
2,1952-1953,1952-11-29,1953-02-28,92,0,4,68,72,3,2,5,77,2,6,KY - Bowling Green
3,1953-1954,1953-12-01,1954-02-28,90,1,11,123,134,6,10,16,150,2,8,KY - Bowling Green
4,1954-1955,1954-11-02,1955-03-26,145,0,13,143,156,8,7,15,171,4,22,KY - Bowling Green
5,1955-1956,1955-11-28,1956-02-29,94,0,6,120,126,1,0,1,127,1,2,KY - Bowling Green
6,1956-1957,1956-11-27,1957-03-08,102,0,8,89,97,1,0,1,98,1,2,KY - Bowling Green
7,1957-1958,1957-12-01,1958-03-18,108,2,24,192,216,10,16,26,242,5,22,KY - Bowling Green
8,1958-1959,1958-12-01,1959-02-28,90,0,20,181,201,1,0,1,202,1,3,KY - Bowling Green
9,1959-1960,1959-11-28,1960-03-19,113,0,17,175,192,70,84,154,346,12,95,KY - Bowling Green
10,1960-1961,1960-12-01,1961-02-28,90,2,17,165,182,22,17,39,221,11,67,KY - Bowling Green
11,1961-1962,1961-12-01,1962-03-06,96,4,17,126,143,14,10,24,167,7,31,KY - Bowling Green
12,1962-1963,1962-12-01,1963-02-28,90,0,35,245,280,23,41,64,344,7,58,KY - Bowling Green
13,1963-1964,1963-12-01,1964-02-29,91,0,21,197,218,38,57,95,313,10,74,KY - Bowling Green
14,1964-1965,1964-11-21,1965-03-20,120,3,17,192,209,25,38,63,272,10,65,KY - Bowling Green
15,1965-1966,1965-12-01,1966-02-28,90,0,22,141,163,12,26,38,201,3,25,KY - Bowling Green
16,1966-1967,1966-11-02,1967-03-07,126,0,11,164,175,34,31,65,240,8,47,KY - Bowling Green
17,1967-1968,1967-12-01,1968-03-25,116,0,22,211,233,44,61,105,338,10,64,KY - Bowling Green
18,1968-1969,1968-11-19,1969-03-26,128,0,12,157,169,18,15,33,202,7,25,KY - Bowling Green
19,1969-1970,1969-12-01,1970-03-13,103,0,27,195,222,29,44,73,295,15,66,KY - Bowling Green
20,1970-1971,1970-11-23,1971-03-03,101,0,23,159,182,22,25,47,229,8,43,KY - Bowling Green
21,1971-1972,1971-12-01,1972-03-03,94,0,12,119,131,5,3,8,139,2,7,KY - Bowling Green
22,1972-1973,1972-11-30,1973-02-28,91,0,13,121,134,6,6,12,146,4,16,KY - Bowling Green
23,1973-1974,1973-12-01,1974-02-28,90,0,11,97,108,2,1,3,111,1,5,KY - Bowling Green
24,1974-1975,1974-12-01,1975-03-10,100,0,5,112,117,11,5,16,133,6,23,KY - Bowling Green
25,1975-1976,1975-12-01,1976-02-29,91,0,11,132,143,5,3,8,151,2,13,KY - Bowling Green
26,1976-1977,1976-11-28,1977-02-28,93,0,47,260,307,30,78,108,415,10,71,KY - Bowling Green
27,1977-1978,1977-11-26,1978-03-04,99,0,52,268,320,59,179,238,558,16,116,KY - Bowling Green
28,1978-1979,1978-12-01,1979-02-28,90,0,32,202,234,40,59,99,333,10,81,KY - Bowling Green
29,1979-1980,1979-11-29,1980-03-04,97,0,20,145,165,19,26,45,210,5,37,KY - Bowling Green
30,1980-1981,1980-12-01,1981-02-28,90,0,24,165,189,13,17,30,219,3,20,KY - Bowling Green
31,1981-1982,1981-12-01,1982-02-28,90,0,28,167,195,10,26,36,231,4,26,KY - Bowling Green
32,1982-1983,1982-12-01,1983-04-18,139,0,8,103,111,9,2,11,122,5,17,KY - Bowling Green
33,1983-1984,1983-12-01,1984-02-29,91,0,50,191,241,21,33,54,295,7,50,KY - Bowling Green
34,1984-1985,1984-12-01,1985-02-28,90,0,33,176,209,28,62,90,299,11,71,KY - Bowling Green
35,1985-1986,1985-12-01,1986-02-28,90,0,25,167,192,20,30,50,242,5,43,KY - Bowling Green
36,1986-1987,1986-12-01,1987-03-31,121,0,9,103,112,20,9,29,141,8,37,KY - Bowling Green
37,1987-1988,1987-12-01,1988-03-14,105,0,25,161,186,11,19,30,216,4,29,KY - Bowling Green
38,1988-1989,1988-12-01,1989-03-07,97,0,11,110,121,7,2,9,130,5,17,KY - Bowling Green
39,1989-1990,1989-12-01,1990-03-19,109,0,30,138,168,14,21,35,203,6,32,KY - Bowling Green
40,1990-1991,1990-12-01,1991-03-29,119,0,11,119,130,9,2,11,141,6,34,KY - Bowling Green
41,1991-1992,1991-12-01,1992-03-14,105,0,4,94,98,2,0,2,100,2,7,KY - Bowling Green
42,1992-1993,1992-12-01,1993-03-14,104,0,9,119,128,17,8,25,153,7,34,KY - Bowling Green
43,1993-1994,1993-10-31,1994-03-09,130,1,26,181,207,20,27,47,254,8,40,KY - Bowling Green
44,1994-1995,1994-12-01,1995-03-08,98,1,10,116,126,5,2,7,133,4,12,KY - Bowling Green
46,1996-1997,1996-12-01,1997-02-28,90,0,19,119,138,7,5,12,150,5,17,KY - Bowling Green
47,1997-1998,1997-12-01,1998-03-11,101,11,6,75,81,14,2,16,97,8,24,KY - Bowling Green
49,1999-2000,1999-12-01,2000-02-29,91,6,7,105,112,2,0,2,114,1,5,KY - Bowling Green
50,2000-2001,2000-12-01,2001-02-28,90,6,21,165,186,9,4,13,199,8,30,KY - Bowling Green
51,2001-2002,2001-12-01,2002-03-04,94,0,7,129,136,8,4,12,148,4,12,KY - Bowling Green
52,2002-2003,2002-12-01,2003-02-28,90,2,18,128,146,19,17,36,182,13,47,KY - Bowling Green
53,2003-2004,2003-12-01,2004-02-29,91,1,11,133,144,6,4,10,154,4,11,KY - Bowling Green
54,2004-2005,2004-12-01,2005-03-11,101,4,10,105,115,3,1,4,119,2,8,KY - Bowling Green
55,2005-2006,2005-12-01,2006-02-28,90,1,5,95,100,13,12,25,125,9,31,KY - Bowling Green
56,2006-2007,2006-12-01,2007-02-28,90,2,11,125,136,6,4,10,146,3,16,KY - Bowling Green
57,2007-2008,2007-12-01,2008-03-09,100,10,11,116,127,8,4,12,139,3,17,KY - Bowling Green
58,2008-2009,2008-12-01,2009-03-13,103,6,13,135,148,6,3,9,157,3,10,KY - Bowling Green
59,2009-2010,2009-12-01,2010-02-28,90,0,20,147,167,23,27,50,217,13,65,KY - Bowling Green
60,2010-2011,2010-12-01,2011-02-28,90,1,24,146,170,32,40,72,242,15,71,KY - Bowling Green
61,2011-2012,2011-12-01,2012-02-29,91,0,1,70,71,3,2,5,76,2,7,KY - Bowling Green
62,2012-2013,2012-12-01,2013-03-26,116,0,2,96,98,9,1,10,108,8,16,KY - Bowling Green
63,2013-2014,2013-11-25,2014-03-25,121,0,27,213,240,22,14,36,276,16,58,KY - Bowling Green
64,2014-2015,2014-11-17,2015-03-07,111,1,22,174,196,34,63,97,293,10,72,KY - Bowling Green
65,2015-2016,2015-12-01,2016-02-29,91,3,12,98,110,36,39,75,185,9,58,KY - Bowling Green
66,2016-2017,2016-12-01,2017-02-28,90,2,8,71,79,1,1,2,81,1,4,KY - Bowling Green
67,2017-2018,2017-12-01,2018-04-07,128,0,24,148,172,16,31,47,219,8,45,KY - Bowling Green
68,2018-2019,2018-11-15,2019-03-04,110,11,8,86,94,11,5,16,110,8,28,KY - Bowling Green
0,1950-1951,1950-11-24,1951-03-26,123,4,25,199,224,49,88,137,361,19,120,KY - Cave Run Lake
1,1951-1952,1951-11-03,1952-02-29,119,2,5,145,150,10,8,18,168,6,20,KY - Cave Run Lake
2,1952-1953,1952-11-30,1953-03-02,93,0,2,102,104,12,11,23,127,6,22,KY - Cave Run Lake
3,1953-1954,1953-12-01,1954-03-04,94,3,7,155,162,27,40,67,229,7,41,KY - Cave Run Lake
4,1954-1955,1954-11-02,1955-02-28,119,0,11,180,191,35,51,86,277,15,73,KY - Cave Run Lake
5,1955-1956,1955-11-19,1956-02-29,103,0,5,182,187,15,24,39,226,9,30,KY - Cave Run Lake
6,1956-1957,1956-11-23,1957-03-09,107,0,8,133,141,16,23,39,180,8,39,KY - Cave Run Lake
7,1957-1958,1957-12-01,1958-03-18,108,2,26,216,242,29,66,95,337,18,86,KY - Cave Run Lake
8,1958-1959,1958-11-29,1959-02-28,92,0,17,223,240,9,16,25,265,4,23,KY - Cave Run Lake
9,1959-1960,1959-11-28,1960-03-21,115,0,18,229,247,67,126,193,440,16,112,KY - Cave Run Lake
10,1960-1961,1960-12-01,1961-04-01,122,3,23,240,263,27,72,99,362,12,65,KY - Cave Run Lake
11,1961-1962,1961-11-19,1962-03-07,109,3,12,180,192,20,21,41,233,11,54,KY - Cave Run Lake
12,1962-1963,1962-12-01,1963-02-28,90,0,26,305,331,34,71,105,436,13,86,KY - Cave Run Lake
13,1963-1964,1963-11-29,1964-02-29,93,0,16,270,286,48,86,134,420,16,97,KY - Cave Run Lake
14,1964-1965,1964-11-30,1965-03-21,112,0,19,201,220,32,43,75,295,11,86,KY - Cave Run Lake
15,1965-1966,1965-12-01,1966-03-07,97,1,25,185,210,33,88,121,331,9,76,KY - Cave Run Lake
16,1966-1967,1966-11-02,1967-03-07,126,1,9,192,201,37,34,71,272,13,64,KY - Cave Run Lake
17,1967-1968,1967-12-01,1968-03-23,114,2,19,244,263,38,82,120,383,14,75,KY - Cave Run Lake
18,1968-1969,1968-12-01,1969-03-11,101,4,12,184,196,12,8,20,216,8,33,KY - Cave Run Lake
19,1969-1970,1969-11-14,1970-03-29,136,5,29,252,281,41,68,109,390,12,76,KY - Cave Run Lake
20,1970-1971,1970-11-24,1971-03-26,123,2,29,200,229,34,42,76,305,9,70,KY - Cave Run Lake
21,1971-1972,1971-12-01,1972-03-03,94,0,8,123,131,9,7,16,147,4,19,KY - Cave Run Lake
22,1972-1973,1972-12-01,1973-02-28,90,0,12,129,141,3,3,6,147,3,12,KY - Cave Run Lake
24,1974-1975,1974-12-01,1975-03-04,94,18,3,101,104,12,15,27,131,6,20,KY - Cave Run Lake
25,1975-1976,1975-12-01,1976-02-29,91,9,22,168,190,10,21,31,221,5,28,KY - Cave Run Lake
39,1989-1990,1989-12-01,1990-02-28,90,6,31,224,255,6,50,56,311,3,20,KY - Cave Run Lake
40,1990-1991,1990-12-01,1991-02-28,90,1,13,135,148,2,2,4,152,2,12,KY - Cave Run Lake
41,1991-1992,1991-11-26,1992-03-12,108,3,9,153,162,2,3,5,167,2,7,KY - Cave Run Lake
45,1995-1996,1995-12-01,1996-03-22,113,15,49,226,275,25,73,98,373,15,65,KY - Cave Run Lake
46,1996-1997,1996-12-01,1997-02-28,90,6,21,124,145,0,7,7,152,0,0,KY - Cave Run Lake
47,1997-1998,1997-11-16,1998-03-12,117,14,7,87,94,24,34,58,152,14,46,KY - Cave Run Lake
48,1998-1999,1998-12-01,1999-03-04,94,7,14,121,135,11,9,20,155,9,36,KY - Cave Run Lake
49,1999-2000,1999-12-01,2000-02-29,91,12,14,127,141,12,22,34,175,6,24,KY - Cave Run Lake
50,2000-2001,2000-11-22,2001-02-28,99,5,27,193,220,16,31,47,267,9,46,KY - Cave Run Lake
51,2001-2002,2001-12-01,2002-03-05,95,19,8,129,137,15,18,33,170,13,50,KY - Cave Run Lake
52,2002-2003,2002-11-28,2003-03-03,96,17,25,155,180,24,34,58,238,14,69,KY - Cave Run Lake
53,2003-2004,2003-11-29,2004-02-29,93,11,17,146,163,15,22,37,200,8,31,KY - Cave Run Lake
54,2004-2005,2004-12-01,2005-03-14,104,2,15,141,156,10,6,16,172,7,30,KY - Cave Run Lake
55,2005-2006,2005-12-01,2006-02-28,90,6,7,107,114,7,4,11,125,5,19,KY - Cave Run Lake
56,2006-2007,2006-12-01,2007-02-28,90,4,25,149,174,23,0,23,197,15,104,KY - Cave Run Lake
57,2007-2008,2007-12-01,2008-03-09,100,12,14,137,151,7,7,14,165,5,21,KY - Cave Run Lake
58,2008-2009,2008-11-21,2009-03-13,113,2,21,202,223,29,22,51,274,13,62,KY - Cave Run Lake
59,2009-2010,2009-12-01,2010-02-28,90,0,27,166,193,44,54,98,291,20,107,KY - Cave Run Lake
60,2010-2011,2010-12-01,2011-03-27,117,1,36,222,258,49,99,148,406,24,136,KY - Cave Run Lake
61,2011-2012,2011-12-01,2012-03-06,97,4,5,137,142,15,9,24,166,5,30,KY - Cave Run Lake
62,2012-2013,2012-10-30,2013-03-07,129,11,9,213,222,15,11,26,248,12,47,KY - Cave Run Lake
63,2013-2014,2013-11-12,2014-03-25,134,0,37,278,315,43,53,96,411,23,113,KY - Cave Run Lake
64,2014-2015,2014-11-14,2015-03-08,115,1,42,248,290,46,82,128,418,14,127,KY - Cave Run Lake
65,2015-2016,2015-12-01,2016-03-04,95,1,19,141,160,39,38,77,237,9,76,KY - Cave Run Lake
66,2016-2017,2016-12-01,2017-03-16,106,2,17,118,135,6,10,16,151,2,12,KY - Cave Run Lake
67,2017-2018,2017-12-01,2018-04-09,130,0,45,220,265,20,20,40,305,11,51,KY - Cave Run Lake
68,2018-2019,2018-11-16,2019-03-08,113,7,24,143,167,14,8,22,189,10,35,KY - Cave Run Lake
69,2019-2020,2019-11-12,2020-02-29,110,0,8,109,117,10,9,19,136,5,18,KY - Cave Run Lake
31,1981-1982,1981-11-21,1982-04-08,139,3,31,180,211,35,43,78,289,15,84,KY - Jackson
32,1982-1983,1982-12-01,1983-04-18,139,0,11,104,115,25,19,44,159,16,55,KY - Jackson
33,1983-1984,1983-12-01,1984-03-21,112,0,43,183,226,27,34,61,287,16,86,KY - Jackson
34,1984-1985,1984-12-01,1985-02-28,90,0,43,170,213,55,154,209,422,23,148,KY - Jackson
35,1985-1986,1985-12-01,1986-03-07,97,0,25,167,192,37,49,86,278,19,102,KY - Jackson
36,1986-1987,1986-11-15,1987-04-07,144,0,16,121,137,51,50,101,238,20,95,KY - Jackson
37,1987-1988,1987-12-01,1988-03-18,109,0,27,156,183,24,19,43,226,17,84,KY - Jackson
38,1988-1989,1988-11-28,1989-05-07,161,0,11,117,128,20,5,25,153,14,42,KY - Jackson
39,1989-1990,1989-10-20,1990-03-20,152,0,31,152,183,32,43,75,258,21,97,KY - Jackson
40,1990-1991,1990-12-01,1991-03-30,120,0,10,97,107,18,10,28,135,13,56,KY - Jackson
41,1991-1992,1991-12-01,1992-04-04,126,0,6,107,113,16,1,17,130,14,44,KY - Jackson
42,1992-1993,1992-11-06,1993-04-02,148,0,12,141,153,57,40,97,250,22,94,KY - Jackson
43,1993-1994,1993-10-31,1994-03-31,152,0,37,186,223,72,104,176,399,27,161,KY - Jackson
44,1994-1995,1994-12-01,1995-03-10,100,3,18,128,146,33,37,70,216,20,89,KY - Jackson
45,1995-1996,1995-11-11,1996-04-01,143,4,52,215,267,97,136,233,500,41,222,KY - Jackson
46,1996-1997,1996-11-09,1997-02-28,112,1,22,128,150,17,7,24,174,12,50,KY - Jackson
47,1997-1998,1997-11-12,1998-03-21,130,1,13,89,102,51,71,122,224,25,96,KY - Jackson
48,1998-1999,1998-12-01,1999-03-13,103,2,14,109,123,29,21,50,173,18,71,KY - Jackson
49,1999-2000,1999-12-01,2000-03-12,103,0,21,107,128,25,55,80,208,18,80,KY - Jackson
50,2000-2001,2000-11-18,2001-04-17,151,0,30,184,214,37,38,75,289,27,121,KY - Jackson
51,2001-2002,2001-12-01,2002-03-22,112,0,12,105,117,31,30,61,178,14,64,KY - Jackson
52,2002-2003,2002-11-22,2003-03-03,102,0,32,148,180,41,42,83,263,26,112,KY - Jackson
53,2003-2004,2003-11-28,2004-02-29,94,0,14,126,140,30,21,51,191,21,75,KY - Jackson
54,2004-2005,2004-11-25,2005-04-24,151,0,12,116,128,26,11,37,165,20,73,KY - Jackson
55,2005-2006,2005-12-01,2006-03-25,115,0,6,90,96,25,14,39,135,17,54,KY - Jackson
56,2006-2007,2006-12-01,2007-04-07,128,0,21,144,165,21,11,32,197,16,74,KY - Jackson
57,2007-2008,2007-12-01,2008-03-24,115,0,14,121,135,22,10,32,167,16,61,KY - Jackson
58,2008-2009,2008-11-16,2009-04-07,143,0,31,176,207,54,44,98,305,32,136,KY - Jackson
59,2009-2010,2009-12-01,2010-03-03,93,0,41,155,196,78,86,164,360,32,182,KY - Jackson
60,2010-2011,2010-12-01,2011-03-28,118,0,41,162,203,65,75,140,343,37,175,KY - Jackson
61,2011-2012,2011-12-01,2012-03-06,97,0,5,72,77,24,16,40,117,14,53,KY - Jackson
62,2012-2013,2012-10-30,2013-03-26,148,0,14,133,147,35,16,51,198,22,76,KY - Jackson
63,2013-2014,2013-10-24,2014-04-15,174,0,32,228,260,65,45,110,370,37,156,KY - Jackson
64,2014-2015,2014-11-01,2015-03-07,127,0,26,195,221,46,76,122,343,21,123,KY - Jackson
65,2015-2016,2015-12-01,2016-04-09,131,0,19,111,130,49,54,103,233,18,103,KY - Jackson
66,2016-2017,2016-12-01,2017-03-15,105,0,13,87,100,12,4,16,116,9,40,KY - Jackson
67,2017-2018,2017-12-01,2018-04-16,137,0,33,164,197,43,23,66,263,25,93,KY - Jackson
68,2018-2019,2018-11-15,2019-03-08,114,0,15,111,126,20,7,27,153,16,57,KY - Jackson
69,2019-2020,2019-11-12,2020-04-14,155,0,5,66,71,18,6,24,95,14,37,KY - Jackson
0,1950-1951,1950-11-23,1951-04-02,131,0,48,237,285,64,103,167,452,31,178,KY - Lexington
1,1951-1952,1951-11-02,1952-03-02,122,0,17,151,168,18,6,24,192,13,50,KY - Lexington
2,1952-1953,1952-11-22,1953-04-20,150,0,10,104,114,19,10,29,143,13,47,KY - Lexington
3,1953-1954,1953-11-25,1954-03-01,97,0,18,127,145,16,29,45,190,7,29,KY - Lexington
4,1954-1955,1954-10-31,1955-03-27,148,0,22,171,193,31,39,70,263,18,84,KY - Lexington
5,1955-1956,1955-11-18,1956-04-07,142,0,15,178,193,20,15,35,228,16,52,KY - Lexington
6,1956-1957,1956-11-22,1957-03-09,108,0,18,134,152,13,6,19,171,9,41,KY - Lexington
7,1957-1958,1957-11-30,1958-03-20,111,0,45,203,248,27,28,55,303,23,98,KY - Lexington
8,1958-1959,1958-11-28,1959-04-13,137,0,32,236,268,14,18,32,300,10,35,KY - Lexington
9,1959-1960,1959-11-27,1960-03-22,117,0,34,201,235,58,143,201,436,21,112,KY - Lexington
10,1960-1961,1960-12-01,1961-04-01,122,0,42,193,235,28,59,87,322,17,99,KY - Lexington
11,1961-1962,1961-11-19,1962-04-01,134,0,34,186,220,28,20,48,268,19,76,KY - Lexington
12,1962-1963,1962-12-01,1963-02-28,90,0,55,250,305,33,46,79,384,22,119,KY - Lexington
13,1963-1964,1963-11-29,1964-03-29,122,1,36,225,261,52,73,125,386,20,105,KY - Lexington
14,1964-1965,1964-11-21,1965-03-20,120,0,38,221,259,26,38,64,323,16,93,KY - Lexington
15,1965-1966,1965-11-29,1966-03-07,99,0,42,187,229,34,82,116,345,11,74,KY - Lexington
16,1966-1967,1966-11-02,1967-03-08,127,0,26,174,200,42,32,74,274,18,84,KY - Lexington
17,1967-1968,1967-12-01,1968-03-25,116,0,32,222,254,49,109,158,412,16,94,KY - Lexington
18,1968-1969,1968-11-11,1969-03-26,136,0,23,185,208,26,10,36,244,21,70,KY - Lexington
19,1969-1970,1969-11-14,1970-03-29,136,0,43,241,284,48,57,105,389,28,135,KY - Lexington
20,1970-1971,1970-11-23,1971-03-26,124,0,39,211,250,33,35,68,318,17,78,KY - Lexington
21,1971-1972,1971-11-23,1972-03-04,103,0,23,145,168,17,13,30,198,12,43,KY - Lexington
22,1972-1973,1972-10-19,1973-04-11,175,0,17,137,154,20,0,20,174,20,44,KY - Lexington
23,1973-1974,1973-12-01,1974-03-24,114,0,18,122,140,15,12,27,167,9,37,KY - Lexington
24,1974-1975,1974-11-13,1975-03-10,118,0,6,123,129,30,13,43,172,20,68,KY - Lexington
25,1975-1976,1975-12-01,1976-03-16,107,0,27,165,192,22,11,33,225,16,71,KY - Lexington
26,1976-1977,1976-11-21,1977-04-06,137,0,70,301,371,46,110,156,527,30,135,KY - Lexington
27,1977-1978,1977-11-26,1978-03-16,111,0,89,309,398,66,200,266,664,33,192,KY - Lexington
28,1978-1979,1978-12-01,1979-03-27,117,0,59,233,292,38,79,117,409,21,128,KY - Lexington
29,1979-1980,1979-11-29,1980-04-15,139,0,39,200,239,31,86,117,356,13,76,KY - Lexington
30,1980-1981,1980-11-18,1981-03-19,122,0,37,219,256,9,6,15,271,8,36,KY - Lexington
31,1981-1982,1981-11-20,1982-04-08,140,0,40,222,262,25,25,50,312,18,107,KY - Lexington
32,1982-1983,1982-12-01,1983-03-21,111,0,13,99,112,14,14,28,140,9,30,KY - Lexington
33,1983-1984,1983-12-01,1984-03-21,112,0,53,210,263,26,37,63,326,15,62,KY - Lexington
34,1984-1985,1984-12-01,1985-04-08,129,0,49,207,256,43,76,119,375,22,126,KY - Lexington
35,1985-1986,1985-12-01,1986-03-07,97,0,31,200,231,26,30,56,287,17,95,KY - Lexington
36,1986-1987,1986-11-15,1987-04-05,142,0,16,132,148,29,14,43,191,18,77,KY - Lexington
37,1987-1988,1987-11-10,1988-03-18,130,0,31,194,225,21,15,36,261,15,63,KY - Lexington
38,1988-1989,1988-12-01,1989-03-07,97,0,15,135,150,6,3,9,159,5,20,KY - Lexington
39,1989-1990,1989-11-16,1990-03-24,129,0,41,185,226,23,53,76,302,12,68,KY - Lexington
40,1990-1991,1990-12-01,1991-03-30,120,0,13,117,130,10,5,15,145,7,25,KY - Lexington
41,1991-1992,1991-11-04,1992-04-02,151,0,11,143,154,8,1,9,163,8,27,KY - Lexington
42,1992-1993,1992-11-14,1993-03-16,123,0,18,148,166,37,37,74,240,16,65,KY - Lexington
43,1993-1994,1993-11-06,1994-03-11,126,0,46,207,253,47,83,130,383,21,124,KY - Lexington
44,1994-1995,1994-12-01,1995-03-10,100,0,25,149,174,19,12,31,205,14,60,KY - Lexington
45,1995-1996,1995-11-13,1996-04-01,141,2,56,239,295,51,82,133,428,27,134,KY - Lexington
46,1996-1997,1996-12-01,1997-02-28,90,0,32,130,162,7,5,12,174,5,20,KY - Lexington
47,1997-1998,1997-12-01,1998-03-12,102,0,11,91,102,28,48,76,178,9,44,KY - Lexington
48,1998-1999,1998-12-01,1999-03-13,103,0,19,133,152,10,4,14,166,10,36,KY - Lexington
49,1999-2000,1999-12-01,2000-03-11,102,4,27,139,166,12,4,16,182,10,41,KY - Lexington
50,2000-2001,2000-11-21,2001-04-17,148,3,39,222,261,17,25,42,303,11,57,KY - Lexington
51,2001-2002,2001-12-01,2002-03-04,94,0,15,122,137,13,12,25,162,7,26,KY - Lexington
52,2002-2003,2002-11-26,2003-02-28,95,0,38,173,211,32,30,62,273,19,90,KY - Lexington
53,2003-2004,2003-12-01,2004-02-29,91,0,22,155,177,14,18,32,209,10,42,KY - Lexington
54,2004-2005,2004-12-01,2005-03-14,104,0,21,141,162,13,5,18,180,11,39,KY - Lexington
55,2005-2006,2005-11-25,2006-02-28,96,0,14,117,131,17,12,29,160,11,40,KY - Lexington
56,2006-2007,2006-11-20,2007-04-06,138,0,26,169,195,15,9,24,219,12,64,KY - Lexington
57,2007-2008,2007-12-01,2008-03-09,100,0,22,144,166,22,15,37,203,13,70,KY - Lexington
58,2008-2009,2008-11-20,2009-03-12,113,0,33,196,229,23,28,51,280,16,64,KY - Lexington
59,2009-2010,2009-12-01,2010-02-28,90,0,37,175,212,38,48,86,298,23,123,KY - Lexington
60,2010-2011,2010-11-26,2011-03-26,121,0,44,188,232,42,76,118,350,23,101,KY - Lexington
61,2011-2012,2011-12-01,2012-03-06,97,0,7,96,103,13,7,20,123,7,35,KY - Lexington
62,2012-2013,2012-12-01,2013-03-26,116,0,16,139,155,23,15,38,193,16,52,KY - Lexington
63,2013-2014,2013-11-12,2014-04-15,155,0,42,258,300,46,71,117,417,28,126,KY - Lexington
64,2014-2015,2014-11-15,2015-03-09,115,0,37,239,276,59,92,151,427,14,110,KY - Lexington
65,2015-2016,2015-12-01,2016-03-03,94,0,22,115,137,23,26,49,186,10,56,KY - Lexington
66,2016-2017,2016-12-01,2017-02-28,90,0,12,90,102,7,5,12,114,5,17,KY - Lexington
67,2017-2018,2017-12-01,2018-04-09,130,0,35,183,218,34,31,65,283,18,83,KY - Lexington
68,2018-2019,2018-11-13,2019-03-08,116,0,16,121,137,18,10,28,165,12,49,KY - Lexington
69,2019-2020,2019-11-11,2020-02-29,111,0,5,82,87,10,6,16,103,8,28,KY - Lexington
0,1950-1951,1950-11-23,1951-03-25,123,0,40,209,249,49,61,110,359,22,131,KY - Louisville
1,1951-1952,1951-11-02,1952-03-02,122,0,12,136,148,16,5,21,169,11,38,KY - Louisville
2,1952-1953,1952-11-29,1953-04-18,141,0,4,82,86,18,9,27,113,6,26,KY - Louisville
3,1953-1954,1953-12-01,1954-02-28,90,0,14,107,121,10,9,19,140,3,16,KY - Louisville
4,1954-1955,1954-11-02,1955-03-26,145,0,20,133,153,14,14,28,181,10,38,KY - Louisville
5,1955-1956,1955-11-18,1956-03-16,120,0,11,133,144,20,30,50,194,9,35,KY - Louisville
6,1956-1957,1956-11-23,1957-04-06,135,0,10,109,119,13,3,16,135,11,37,KY - Louisville
7,1957-1958,1957-12-01,1958-03-18,108,0,30,172,202,27,18,45,247,17,57,KY - Louisville
8,1958-1959,1958-11-28,1959-02-28,93,0,26,187,213,13,15,28,241,6,36,KY - Louisville
9,1959-1960,1959-11-27,1960-03-19,114,0,22,160,182,54,52,106,288,20,93,KY - Louisville
10,1960-1961,1960-12-01,1961-04-16,137,0,35,202,237,40,49,89,326,17,99,KY - Louisville
11,1961-1962,1961-11-19,1962-04-01,134,0,31,169,200,34,12,46,246,21,80,KY - Louisville
12,1962-1963,1962-12-01,1963-03-06,96,0,50,263,313,25,32,57,370,19,103,KY - Louisville
13,1963-1964,1963-12-01,1964-03-29,120,0,29,220,249,54,49,103,352,25,109,KY - Louisville
14,1964-1965,1964-11-20,1965-03-20,121,0,28,203,231,34,43,77,308,17,90,KY - Louisville
15,1965-1966,1965-11-29,1966-04-05,128,0,39,174,213,29,68,97,310,10,65,KY - Louisville
16,1966-1967,1966-11-02,1967-03-09,128,0,23,179,202,52,31,83,285,17,86,KY - Louisville
17,1967-1968,1967-12-01,1968-03-24,115,0,35,189,224,46,55,101,325,14,78,KY - Louisville
18,1968-1969,1968-11-19,1969-03-26,128,0,15,158,173,23,11,34,207,15,45,KY - Louisville
19,1969-1970,1969-11-19,1970-03-30,132,0,35,209,244,54,52,106,350,26,127,KY - Louisville
20,1970-1971,1970-11-14,1971-04-06,144,0,34,184,218,34,37,71,289,17,63,KY - Louisville
21,1971-1972,1971-11-06,1972-03-03,119,0,20,134,154,23,10,33,187,15,55,KY - Louisville
22,1972-1973,1972-11-28,1973-04-10,134,0,17,119,136,19,2,21,157,16,41,KY - Louisville
23,1973-1974,1973-12-01,1974-03-24,114,0,19,97,116,17,7,24,140,13,43,KY - Louisville
24,1974-1975,1974-11-30,1975-03-27,118,0,7,94,101,28,9,37,138,15,47,KY - Louisville
25,1975-1976,1975-11-13,1976-03-16,125,0,13,139,152,12,2,14,166,12,34,KY - Louisville
26,1976-1977,1976-11-28,1977-04-06,130,0,61,272,333,44,101,145,478,28,147,KY - Louisville
27,1977-1978,1977-11-26,1978-03-16,111,0,70,278,348,71,250,321,669,27,151,KY - Louisville
28,1978-1979,1978-12-01,1979-03-25,115,0,43,213,256,32,56,88,344,18,96,KY - Louisville
29,1979-1980,1979-11-29,1980-03-04,97,0,32,170,202,27,76,103,305,12,67,KY - Louisville
30,1980-1981,1980-12-01,1981-03-19,109,0,24,175,199,5,11,16,215,3,14,KY - Louisville
31,1981-1982,1981-11-20,1982-04-08,140,0,36,217,253,20,15,35,288,14,63,KY - Louisville
32,1982-1983,1982-12-01,1983-03-10,100,0,5,91,96,10,4,14,110,8,18,KY - Louisville
33,1983-1984,1983-12-01,1984-03-21,112,0,51,200,251,20,17,37,288,11,45,KY - Louisville
34,1984-1985,1984-12-01,1985-02-28,90,0,42,169,211,32,67,99,310,17,87,KY - Louisville
35,1985-1986,1985-12-01,1986-03-07,97,0,30,174,204,20,26,46,250,11,50,KY - Louisville
36,1986-1987,1986-11-13,1987-04-01,140,0,11,115,126,30,19,49,175,10,53,KY - Louisville
37,1987-1988,1987-12-01,1988-03-18,109,0,26,164,190,12,18,30,220,5,35,KY - Louisville
38,1988-1989,1988-12-01,1989-03-07,97,0,13,111,124,5,0,5,129,5,15,KY - Louisville
39,1989-1990,1989-10-19,1990-03-25,158,0,35,161,196,25,37,62,258,16,74,KY - Louisville
40,1990-1991,1990-12-01,1991-03-29,119,0,13,108,121,13,4,17,138,10,32,KY - Louisville
41,1991-1992,1991-11-04,1992-04-02,151,0,6,113,119,11,0,11,130,11,28,KY - Louisville
42,1992-1993,1992-11-14,1993-03-14,121,0,13,125,138,32,36,68,206,14,50,KY - Louisville
43,1993-1994,1993-10-30,1994-03-11,133,0,37,186,223,47,81,128,351,17,104,KY - Louisville
44,1994-1995,1994-12-01,1995-03-08,98,0,15,110,125,8,6,14,139,5,17,KY - Louisville
45,1995-1996,1995-11-13,1996-03-22,131,0,53,226,279,54,63,117,396,27,127,KY - Louisville
46,1996-1997,1996-12-01,1997-02-28,90,0,28,135,163,10,7,17,180,8,40,KY - Louisville
47,1997-1998,1997-11-15,1998-03-21,127,0,12,99,111,41,52,93,204,13,68,KY - Louisville
48,1998-1999,1998-12-01,1999-03-14,104,0,18,126,144,17,7,24,168,13,63,KY - Louisville
49,1999-2000,1999-12-01,2000-03-11,102,0,16,116,132,19,16,35,167,11,49,KY - Louisville
50,2000-2001,2000-11-21,2001-04-01,132,0,36,207,243,31,54,85,328,20,106,KY - Louisville
51,2001-2002,2001-12-01,2002-03-04,94,0,11,110,121,15,12,27,148,8,34,KY - Louisville
52,2002-2003,2002-11-26,2003-02-28,95,0,34,161,195,42,38,80,275,27,118,KY - Louisville
53,2003-2004,2003-11-28,2004-04-13,138,1,17,153,170,21,16,37,207,14,60,KY - Louisville
54,2004-2005,2004-12-01,2005-03-13,103,0,21,139,160,25,36,61,221,13,58,KY - Louisville
55,2005-2006,2005-12-01,2006-02-28,90,0,13,95,108,12,1,13,121,9,28,KY - Louisville
56,2006-2007,2006-12-01,2007-02-28,90,0,18,121,139,7,2,9,148,6,24,KY - Louisville
57,2007-2008,2007-12-01,2008-03-23,114,0,13,113,126,33,24,57,183,14,58,KY - Louisville
58,2008-2009,2008-12-01,2009-03-02,92,0,24,152,176,22,27,49,225,13,58,KY - Louisville
59,2009-2010,2009-12-01,2010-02-28,90,0,30,147,177,33,63,96,273,15,75,KY - Louisville
60,2010-2011,2010-11-26,2011-03-26,121,0,29,140,169,31,20,51,220,20,80,KY - Louisville
61,2011-2012,2011-12-01,2012-03-06,97,0,3,74,77,10,9,19,96,7,25,KY - Louisville
62,2012-2013,2012-12-01,2013-03-26,116,0,8,102,110,18,8,26,136,13,34,KY - Louisville
63,2013-2014,2013-11-12,2014-04-15,155,0,31,222,253,45,77,122,375,28,112,KY - Louisville
64,2014-2015,2014-11-17,2015-03-08,112,0,28,178,206,40,59,99,305,10,69,KY - Louisville
65,2015-2016,2015-12-01,2016-03-03,94,0,12,93,105,19,26,45,150,9,47,KY - Louisville
66,2016-2017,2016-12-01,2017-02-28,90,0,10,73,83,5,2,7,90,3,12,KY - Louisville
67,2017-2018,2017-12-01,2018-04-16,137,0,31,148,179,31,31,62,241,17,67,KY - Louisville
68,2018-2019,2018-11-15,2019-03-08,114,0,12,94,106,22,12,34,140,14,52,KY - Louisville
69,2019-2020,2019-11-11,2020-02-29,111,0,5,65,70,10,2,12,82,9,23,KY - Louisville
0,1950-1951,1950-11-24,1951-04-02,130,9,21,173,194,25,8,33,227,4,36,KY - Murray
1,1951-1952,1951-12-01,1952-02-29,91,0,2,68,70,0,0,0,70,0,0,KY - Murray
2,1952-1953,1952-11-29,1953-02-28,92,0,3,63,66,0,0,0,66,0,0,KY - Murray
3,1953-1954,1953-12-01,1954-02-28,90,0,4,93,97,3,5,8,105,1,5,KY - Murray
4,1954-1955,1954-12-01,1955-02-28,90,12,2,101,103,4,3,7,110,1,5,KY - Murray
5,1955-1956,1955-12-01,1956-02-29,91,0,3,105,108,2,0,2,110,2,4,KY - Murray
6,1956-1957,1956-11-26,1957-02-28,95,0,5,82,87,1,0,1,88,1,2,KY - Murray
7,1957-1958,1957-12-01,1958-03-17,107,1,14,159,173,12,17,29,202,6,27,KY - Murray
8,1958-1959,1958-11-28,1959-02-28,93,2,18,164,182,5,3,8,190,4,19,KY - Murray
9,1959-1960,1959-11-28,1960-03-15,109,1,14,142,156,40,66,106,262,12,60,KY - Murray
10,1960-1961,1960-12-01,1961-02-28,90,5,12,162,174,7,13,20,194,3,14,KY - Murray
12,1962-1963,1962-12-01,1963-02-28,90,0,42,237,279,14,20,34,313,8,62,KY - Murray
13,1963-1964,1963-12-01,1964-02-29,91,0,19,179,198,11,25,36,234,2,18,KY - Murray
14,1964-1965,1964-11-22,1965-03-20,119,3,18,174,192,28,26,54,246,10,62,KY - Murray
15,1965-1966,1965-12-01,1966-02-28,90,0,22,135,157,11,26,37,194,6,35,KY - Murray
16,1966-1967,1966-11-03,1967-03-07,125,0,14,159,173,11,7,18,191,5,29,KY - Murray
17,1967-1968,1967-12-01,1968-03-25,116,0,27,188,215,42,74,116,331,9,69,KY - Murray
18,1968-1969,1968-12-01,1969-03-11,101,0,13,130,143,11,8,19,162,4,20,KY - Murray
19,1969-1970,1969-11-14,1970-03-17,124,0,34,194,228,30,28,58,286,18,89,KY - Murray
20,1970-1971,1970-11-24,1971-03-03,100,0,16,129,145,22,20,42,187,8,42,KY - Murray
21,1971-1972,1971-12-01,1972-02-29,91,0,9,91,100,2,0,2,102,2,7,KY - Murray
22,1972-1973,1972-12-01,1973-02-28,90,0,13,98,111,5,5,10,121,4,16,KY - Murray
23,1973-1974,1973-12-01,1974-02-28,90,0,13,81,94,5,4,9,103,3,13,KY - Murray
24,1974-1975,1974-12-01,1975-03-14,104,1,2,94,96,12,3,15,111,5,19,KY - Murray
25,1975-1976,1975-12-01,1976-02-29,91,0,8,100,108,4,4,8,116,1,8,KY - Murray
26,1976-1977,1976-11-11,1977-02-28,110,4,33,222,255,30,61,91,346,10,68,KY - Murray
27,1977-1978,1977-11-26,1978-03-05,100,7,45,228,273,58,195,253,526,12,86,KY - Murray
28,1978-1979,1978-12-01,1979-03-25,115,4,29,205,234,42,78,120,354,14,91,KY - Murray
29,1979-1980,1979-11-29,1980-03-12,105,0,13,155,168,18,22,40,208,8,37,KY - Murray
32,1982-1983,1982-12-01,1983-02-28,90,2,1,80,81,3,3,6,87,1,5,KY - Murray
33,1983-1984,1983-12-01,1984-02-29,91,2,38,164,202,13,18,31,233,7,44,KY - Murray
37,1987-1988,1987-12-01,1988-02-29,91,0,19,119,138,13,27,40,178,3,25,KY - Murray
38,1988-1989,1988-12-01,1989-03-07,97,1,12,103,115,13,9,22,137,2,15,KY - Murray
39,1989-1990,1989-12-01,1990-03-19,109,5,25,111,136,7,4,11,147,4,19,KY - Murray
40,1990-1991,1990-12-01,1991-03-29,119,6,8,95,103,4,6,10,113,2,10,KY - Murray
41,1991-1992,1991-12-01,1992-02-29,91,0,2,65,67,0,0,0,67,0,0,KY - Murray
42,1992-1993,1992-12-01,1993-02-28,90,6,6,85,91,8,17,25,116,2,12,KY - Murray
43,1993-1994,1993-10-30,1994-03-09,131,1,22,141,163,18,36,54,217,7,35,KY - Murray
44,1994-1995,1994-12-01,1995-02-28,90,2,12,86,98,2,1,3,101,1,5,KY - Murray
45,1995-1996,1995-12-01,1996-03-20,111,11,29,160,189,19,22,41,230,4,32,KY - Murray
46,1996-1997,1996-11-10,1997-02-28,111,8,23,114,137,12,15,27,164,8,32,KY - Murray
48,1998-1999,1998-12-01,1999-02-28,90,6,10,73,83,0,0,0,83,0,0,KY - Murray
49,1999-2000,1999-12-01,2000-02-29,91,12,5,74,79,9,11,20,99,3,14,KY - Murray
50,2000-2001,2000-12-01,2001-02-28,90,3,22,132,154,12,7,19,173,9,36,KY - Murray
51,2001-2002,2001-12-01,2002-02-28,90,4,4,71,75,5,1,6,81,3,8,KY - Murray
53,2003-2004,2003-12-01,2004-04-13,135,7,5,95,100,3,0,3,103,3,5,KY - Murray
54,2004-2005,2004-12-01,2005-02-28,90,1,8,85,93,10,35,45,138,2,18,KY - Murray
55,2005-2006,2005-12-01,2006-02-28,90,1,4,86,90,14,11,25,115,8,38,KY - Murray
56,2006-2007,2006-12-01,2007-02-28,90,0,11,98,109,8,0,8,117,4,18,KY - Murray
57,2007-2008,2007-12-01,2008-03-08,99,8,7,97,104,8,3,11,115,2,11,KY - Murray
58,2008-2009,2008-12-01,2009-03-12,102,4,14,121,135,4,1,5,140,3,12,KY - Murray
59,2009-2010,2009-12-01,2010-02-28,90,12,20,140,160,17,21,38,198,6,33,KY - Murray
61,2011-2012,2011-12-01,2012-02-29,91,1,1,65,66,3,1,4,70,2,6,KY - Murray
62,2012-2013,2012-12-01,2013-03-25,115,0,7,93,100,9,5,14,114,5,16,KY - Murray
63,2013-2014,2013-11-24,2014-03-07,104,0,38,199,237,8,15,23,260,4,25,KY - Murray
64,2014-2015,2014-11-17,2015-03-07,111,0,27,163,190,28,58,86,276,7,54,KY - Murray
65,2015-2016,2015-12-01,2016-02-29,91,0,12,86,98,22,24,46,144,6,38,KY - Murray
66,2016-2017,2016-12-01,2017-03-11,101,0,12,72,84,3,0,3,87,2,7,KY - Murray
67,2017-2018,2017-12-01,2018-04-07,128,0,30,147,177,23,43,66,243,7,43,KY - Murray
68,2018-2019,2018-11-14,2019-03-06,113,0,14,107,121,5,5,10,131,3,13,KY - Murray
69,2019-2020,2019-11-12,2020-02-29,110,0,9,83,92,4,3,7,99,2,9,KY - Murray
0,1950-1951,1950-11-23,1951-03-19,117,0,39,198,237,21,41,62,299,10,68,KY - Paducah
1,1951-1952,1951-12-01,1952-02-29,91,0,10,87,97,8,1,9,106,3,13,KY - Paducah
2,1952-1953,1952-11-28,1953-02-28,93,1,5,68,73,0,0,0,73,0,0,KY - Paducah
3,1953-1954,1953-12-01,1954-02-28,90,2,10,108,118,3,12,15,133,1,6,KY - Paducah
4,1954-1955,1954-12-01,1955-03-26,116,0,13,126,139,5,1,6,145,3,10,KY - Paducah
5,1955-1956,1955-11-28,1956-02-29,94,0,12,127,139,9,7,16,155,3,20,KY - Paducah
6,1956-1957,1956-11-29,1957-02-28,92,0,12,85,97,0,0,0,97,0,0,KY - Paducah
7,1957-1958,1957-12-01,1958-03-18,108,0,25,167,192,13,13,26,218,6,24,KY - Paducah
8,1958-1959,1958-11-28,1959-02-28,93,0,26,185,211,9,8,17,228,2,17,KY - Paducah
9,1959-1960,1959-11-17,1960-03-18,123,0,21,174,195,50,85,135,330,12,80,KY - Paducah
10,1960-1961,1960-12-01,1961-02-28,90,1,24,172,196,16,28,44,240,7,35,KY - Paducah
11,1961-1962,1961-12-01,1962-03-01,91,2,25,138,163,5,5,10,173,2,10,KY - Paducah
12,1962-1963,1962-12-01,1963-02-28,90,0,42,236,278,7,12,19,297,4,26,KY - Paducah
13,1963-1964,1963-12-01,1964-02-29,91,0,21,193,214,12,23,35,249,4,32,KY - Paducah
14,1964-1965,1964-11-21,1965-03-19,119,0,25,179,204,28,37,65,269,9,65,KY - Paducah
15,1965-1966,1965-12-01,1966-02-28,90,0,24,133,157,8,19,27,184,3,13,KY - Paducah
16,1966-1967,1966-12-01,1967-03-09,99,1,10,160,170,25,26,51,221,3,32,KY - Paducah
17,1967-1968,1967-12-01,1968-03-23,114,0,29,194,223,22,38,60,283,8,45,KY - Paducah
18,1968-1969,1968-12-01,1969-02-28,90,0,8,109,117,15,11,26,143,5,22,KY - Paducah
19,1969-1970,1969-11-14,1970-03-18,125,0,35,203,238,34,44,78,316,12,75,KY - Paducah
20,1970-1971,1970-11-23,1971-04-06,135,0,22,175,197,20,22,42,239,8,39,KY - Paducah
21,1971-1972,1971-11-23,1972-02-29,99,0,13,107,120,4,2,6,126,2,8,KY - Paducah
22,1972-1973,1972-12-01,1973-02-28,90,0,15,116,131,5,2,7,138,3,13,KY - Paducah
23,1973-1974,1973-12-01,1974-02-28,90,0,23,99,122,6,8,14,136,3,13,KY - Paducah
24,1974-1975,1974-11-30,1975-03-15,106,0,8,108,116,16,8,24,140,6,23,KY - Paducah
25,1975-1976,1975-12-01,1976-02-29,91,0,15,116,131,8,6,14,145,3,17,KY - Paducah
26,1976-1977,1976-11-28,1977-02-28,93,0,45,257,302,20,72,92,394,7,63,KY - Paducah
27,1977-1978,1977-11-26,1978-03-16,111,0,53,271,324,51,241,292,616,13,91,KY - Paducah
28,1978-1979,1978-12-01,1979-03-25,115,0,36,218,254,40,87,127,381,15,90,KY - Paducah
29,1979-1980,1979-11-29,1980-03-03,96,0,17,141,158,20,34,54,212,7,39,KY - Paducah
30,1980-1981,1980-12-01,1981-02-28,90,0,20,164,184,10,10,20,204,3,16,KY - Paducah
31,1981-1982,1981-12-01,1982-03-06,96,0,30,185,215,14,41,55,270,4,24,KY - Paducah
32,1982-1983,1982-12-01,1983-04-18,139,0,4,99,103,5,0,5,108,5,10,KY - Paducah
33,1983-1984,1983-12-01,1984-03-02,93,0,51,195,246,23,30,53,299,7,54,KY - Paducah
34,1984-1985,1984-12-01,1985-02-28,90,0,40,200,240,39,119,158,398,14,93,KY - Paducah
35,1985-1986,1985-12-01,1986-02-28,90,0,24,172,196,15,27,42,238,7,40,KY - Paducah
36,1986-1987,1986-11-13,1987-03-31,139,0,9,130,139,13,5,18,157,11,42,KY - Paducah
37,1987-1988,1987-12-01,1988-03-18,109,0,19,155,174,14,17,31,205,5,26,KY - Paducah
38,1988-1989,1988-12-01,1989-03-08,98,0,14,128,142,9,9,18,160,5,28,KY - Paducah
39,1989-1990,1989-12-01,1990-03-19,109,0,27,139,166,9,3,12,178,8,31,KY - Paducah
40,1990-1991,1990-12-01,1991-02-28,90,0,12,110,122,7,7,14,136,5,27,KY - Paducah
41,1991-1992,1991-12-01,1992-02-29,91,0,3,77,80,0,0,0,80,0,0,KY - Paducah
42,1992-1993,1992-12-01,1993-03-13,103,0,7,108,115,28,29,57,172,7,40,KY - Paducah
43,1993-1994,1993-10-29,1994-03-12,135,0,25,180,205,28,53,81,286,10,51,KY - Paducah
44,1994-1995,1994-12-01,1995-03-02,92,0,11,105,116,5,2,7,123,4,17,KY - Paducah
45,1995-1996,1995-12-01,1996-03-20,111,0,41,181,222,22,27,49,271,11,49,KY - Paducah
46,1996-1997,1996-11-09,1997-02-28,112,0,30,131,161,18,27,45,206,9,37,KY - Paducah
47,1997-1998,1997-11-12,1998-03-11,120,1,2,99,101,8,0,8,109,7,18,KY - Paducah
48,1998-1999,1998-12-01,1999-02-28,90,0,19,99,118,8,3,11,129,8,30,KY - Paducah
49,1999-2000,1999-12-01,2000-03-11,102,0,7,112,119,7,1,8,127,6,19,KY - Paducah
50,2000-2001,2000-12-01,2001-02-28,90,0,31,172,203,15,19,34,237,11,59,KY - Paducah
51,2001-2002,2001-12-01,2002-03-03,93,0,7,110,117,10,11,21,138,4,16,KY - Paducah
52,2002-2003,2002-11-26,2003-02-28,95,2,26,159,185,38,46,84,269,17,87,KY - Paducah
53,2003-2004,2003-12-01,2004-02-29,91,0,10,123,133,7,2,9,142,5,14,KY - Paducah
54,2004-2005,2004-12-01,2005-02-28,90,0,13,112,125,19,39,58,183,2,31,KY - Paducah
55,2005-2006,2005-12-01,2006-02-28,90,0,10,110,120,13,10,23,143,8,36,KY - Paducah
56,2006-2007,2006-12-01,2007-02-28,90,0,15,117,132,5,0,5,137,4,19,KY - Paducah
57,2007-2008,2007-12-01,2008-03-08,99,2,9,122,131,14,1,15,146,13,34,KY - Paducah
58,2008-2009,2008-12-01,2009-02-28,90,0,19,137,156,7,6,13,169,6,23,KY - Paducah
59,2009-2010,2009-12-01,2010-02-28,90,0,24,171,195,14,23,37,232,7,36,KY - Paducah
60,2010-2011,2010-12-01,2011-02-28,90,0,23,161,184,28,31,59,243,11,58,KY - Paducah
61,2011-2012,2011-11-29,2012-02-29,93,0,2,76,78,4,0,4,82,4,12,KY - Paducah
62,2012-2013,2012-12-01,2013-03-26,116,0,3,114,117,12,14,26,143,7,22,KY - Paducah
63,2013-2014,2013-12-01,2014-03-25,115,3,33,219,252,30,78,108,360,12,61,KY - Paducah
64,2014-2015,2014-11-16,2015-03-08,113,0,25,188,213,42,89,131,344,10,78,KY - Paducah
65,2015-2016,2015-12-01,2016-02-29,91,0,10,94,104,16,12,28,132,6,32,KY - Paducah
66,2016-2017,2016-12-01,2017-03-13,103,0,9,89,98,3,0,3,101,3,9,KY - Paducah
67,2017-2018,2017-12-01,2018-04-07,128,0,26,167,193,22,35,57,250,5,34,KY - Paducah
68,2018-2019,2018-11-13,2019-03-04,112,2,8,101,109,12,6,18,127,10,35,KY - Paducah
69,2019-2020,2019-11-11,2020-02-29,111,0,5,91,96,2,1,3,99,1,4,KY - Paducah
0,1950-1951,1950-11-24,1951-02-28,97,0,5,59,64,7,21,28,92,3,13,LA - Monroe
1,1951-1952,1951-12-01,1952-02-29,91,0,0,20,20,0,0,0,20,0,0,LA - Monroe
2,1952-1953,1952-12-01,1953-02-28,90,0,0,22,22,0,0,0,22,0,0,LA - Monroe
3,1953-1954,1953-12-01,1954-03-05,95,0,0,36,36,1,1,2,38,1,2,LA - Monroe
4,1954-1955,1954-12-01,1955-02-28,90,1,0,37,37,0,0,0,37,0,0,LA - Monroe
5,1955-1956,1955-12-01,1956-02-29,91,0,0,31,31,0,0,0,31,0,0,LA - Monroe
6,1956-1957,1956-12-01,1957-02-28,90,0,0,17,17,0,0,0,17,0,0,LA - Monroe
7,1957-1958,1957-12-01,1958-02-28,90,0,1,41,42,3,2,5,47,1,4,LA - Monroe
8,1958-1959,1958-12-01,1959-02-28,90,0,0,53,53,0,0,0,53,0,0,LA - Monroe
9,1959-1960,1959-12-01,1960-02-29,91,0,1,34,35,13,5,18,53,3,16,LA - Monroe
10,1960-1961,1960-12-01,1961-02-28,90,0,4,46,50,0,0,0,50,0,0,LA - Monroe
11,1961-1962,1961-12-01,1962-02-28,90,0,6,58,64,6,8,14,78,1,10,LA - Monroe
12,1962-1963,1962-12-01,1963-02-28,90,0,5,108,113,5,2,7,120,2,7,LA - Monroe
13,1963-1964,1963-12-01,1964-02-29,91,0,3,71,74,7,12,19,93,2,11,LA - Monroe
14,1964-1965,1964-12-01,1965-02-28,90,0,1,44,45,0,0,0,45,0,0,LA - Monroe
15,1965-1966,1965-12-01,1966-02-28,90,0,2,37,39,0,0,0,39,0,0,LA - Monroe
16,1966-1967,1966-12-01,1967-02-28,90,0,1,41,42,0,0,0,42,0,0,LA - Monroe
17,1967-1968,1967-12-01,1968-03-22,113,0,2,44,46,4,3,7,53,1,5,LA - Monroe
18,1968-1969,1968-12-01,1969-02-28,90,0,0,38,38,0,0,0,38,0,0,LA - Monroe
19,1969-1970,1969-12-01,1970-02-28,90,0,2,47,49,0,0,0,49,0,0,LA - Monroe
20,1970-1971,1970-12-01,1971-02-28,90,0,2,44,46,6,4,10,56,2,10,LA - Monroe
21,1971-1972,1971-12-01,1972-02-29,91,0,1,25,26,0,0,0,26,0,0,LA - Monroe
22,1972-1973,1972-12-01,1973-02-28,90,0,4,48,52,0,0,0,52,0,0,LA - Monroe
23,1973-1974,1973-12-01,1974-02-28,90,0,1,34,35,1,0,1,36,1,2,LA - Monroe
24,1974-1975,1974-12-01,1975-02-28,90,0,0,29,29,1,0,1,30,1,2,LA - Monroe
25,1975-1976,1975-12-01,1976-02-29,91,0,2,48,50,0,0,0,50,0,0,LA - Monroe
26,1976-1977,1976-12-01,1977-02-28,90,0,3,70,73,6,1,7,80,2,10,LA - Monroe
27,1977-1978,1977-12-01,1978-02-28,90,0,10,85,95,3,0,3,98,1,5,LA - Monroe
28,1978-1979,1978-12-01,1979-02-28,90,0,4,62,66,0,0,0,66,0,0,LA - Monroe
29,1979-1980,1979-12-01,1980-02-29,91,0,0,47,47,0,0,0,47,0,0,LA - Monroe
30,1980-1981,1980-12-01,1981-02-28,90,0,1,45,46,0,0,0,46,0,0,LA - Monroe
31,1981-1982,1981-12-01,1982-02-28,90,0,4,61,65,7,4,11,76,2,16,LA - Monroe
32,1982-1983,1982-12-01,1983-02-28,90,0,0,27,27,0,0,0,27,0,0,LA - Monroe
33,1983-1984,1983-12-01,1984-02-29,91,0,12,87,99,2,0,2,101,2,4,LA - Monroe
34,1984-1985,1984-12-01,1985-02-28,90,3,7,69,76,9,7,16,92,3,20,LA - Monroe
35,1985-1986,1985-12-01,1986-02-28,90,0,0,53,53,0,0,0,53,0,0,LA - Monroe
36,1986-1987,1986-12-01,1987-02-28,90,0,0,24,24,0,0,0,24,0,0,LA - Monroe
37,1987-1988,1987-12-01,1988-02-29,91,0,4,34,38,6,3,9,47,3,11,LA - Monroe
38,1988-1989,1988-12-01,1989-02-28,90,2,3,28,31,0,0,0,31,0,0,LA - Monroe
39,1989-1990,1989-12-01,1990-02-28,90,0,7,44,51,1,0,1,52,1,1,LA - Monroe
40,1990-1991,1990-12-01,1991-02-28,90,0,1,27,28,0,0,0,28,0,0,LA - Monroe
41,1991-1992,1991-12-01,1992-02-29,91,0,0,19,19,1,0,1,20,1,2,LA - Monroe
42,1992-1993,1992-12-01,1993-03-12,102,2,0,13,13,2,1,3,16,1,2,LA - Monroe
43,1993-1994,1993-12-01,1994-02-28,90,0,1,32,33,0,0,0,33,0,0,LA - Monroe
44,1994-1995,1994-12-01,1995-02-28,90,0,0,23,23,0,0,0,23,0,0,LA - Monroe
45,1995-1996,1995-12-01,1996-02-29,91,0,5,64,69,2,2,4,73,2,8,LA - Monroe
46,1996-1997,1996-12-01,1997-02-28,90,0,3,28,31,1,0,1,32,1,1,LA - Monroe
47,1997-1998,1997-12-01,1998-02-28,90,0,0,13,13,2,1,3,16,1,3,LA - Monroe
56,2006-2007,2006-12-01,2007-02-28,90,14,0,38,38,1,0,1,39,1,2,LA - Monroe
57,2007-2008,2007-12-01,2008-02-29,91,14,0,40,40,0,0,0,40,0,0,LA - Monroe
58,2008-2009,2008-12-01,2009-02-28,90,10,0,31,31,0,0,0,31,0,0,LA - Monroe
59,2009-2010,2009-12-01,2010-02-28,90,0,2,45,47,5,3,8,55,2,5,LA - Monroe
60,2010-2011,2010-12-01,2011-02-28,90,0,0,45,45,0,0,0,45,0,0,LA - Monroe
61,2011-2012,2011-12-01,2012-02-29,91,0,0,21,21,0,0,0,21,0,0,LA - Monroe
62,2012-2013,2012-12-01,2013-02-28,90,0,0,22,22,1,0,1,23,1,2,LA - Monroe
63,2013-2014,2013-12-01,2014-02-28,90,14,4,74,78,2,0,2,80,2,5,LA - Monroe
64,2014-2015,2014-12-01,2015-03-05,95,18,0,41,41,5,0,5,46,2,7,LA - Monroe
65,2015-2016,2015-12-01,2016-02-29,91,8,0,22,22,0,0,0,22,0,0,LA - Monroe
66,2016-2017,2016-12-01,2017-02-28,90,7,0,22,22,0,0,0,22,0,0,LA - Monroe
67,2017-2018,2017-12-01,2018-02-28,90,3,2,58,60,3,1,4,64,2,6,LA - Monroe
68,2018-2019,2018-11-14,2019-02-28,107,6,0,21,21,1,0,1,22,1,2,LA - Monroe
1,1951-1952,1951-12-01,1952-02-29,91,0,0,15,15,0,0,0,15,0,0,LA - Natchitoches
2,1952-1953,1952-12-01,1953-02-28,90,0,0,30,30,0,0,0,30,0,0,LA - Natchitoches
3,1953-1954,1953-12-01,1954-02-28,90,0,0,38,38,0,0,0,38,0,0,LA - Natchitoches
4,1954-1955,1954-12-01,1955-02-28,90,0,0,34,34,0,0,0,34,0,0,LA - Natchitoches
5,1955-1956,1955-12-01,1956-02-29,91,1,0,36,36,0,0,0,36,0,0,LA - Natchitoches
6,1956-1957,1956-12-01,1957-02-28,90,1,0,17,17,0,0,0,17,0,0,LA - Natchitoches
7,1957-1958,1957-12-01,1958-02-28,90,0,0,39,39,0,0,0,39,0,0,LA - Natchitoches
8,1958-1959,1958-12-01,1959-02-28,90,0,0,43,43,0,0,0,43,0,0,LA - Natchitoches
9,1959-1960,1959-12-01,1960-02-29,91,4,0,34,34,10,0,10,44,1,11,LA - Natchitoches
10,1960-1961,1960-12-01,1961-02-28,90,4,1,45,46,0,0,0,46,0,0,LA - Natchitoches
11,1961-1962,1961-12-01,1962-02-28,90,5,3,37,40,1,1,2,42,1,3,LA - Natchitoches
12,1962-1963,1962-12-01,1963-02-28,90,8,0,59,59,0,0,0,59,0,0,LA - Natchitoches
13,1963-1964,1963-12-01,1964-02-29,91,12,1,62,63,0,0,0,63,0,0,LA - Natchitoches
14,1964-1965,1964-12-01,1965-02-28,90,0,0,28,28,0,0,0,28,0,0,LA - Natchitoches
15,1965-1966,1965-12-01,1966-02-28,90,0,0,32,32,0,0,0,32,0,0,LA - Natchitoches
16,1966-1967,1966-12-01,1967-02-28,90,0,0,40,40,0,0,0,40,0,0,LA - Natchitoches
17,1967-1968,1967-12-01,1968-02-29,91,2,1,41,42,7,3,10,52,2,10,LA - Natchitoches
18,1968-1969,1968-12-01,1969-02-28,90,1,0,24,24,0,0,0,24,0,0,LA - Natchitoches
19,1969-1970,1969-12-01,1970-02-28,90,0,0,35,35,0,0,0,35,0,0,LA - Natchitoches
20,1970-1971,1970-12-01,1971-02-28,90,0,0,28,28,2,0,2,30,1,4,LA - Natchitoches
21,1971-1972,1971-12-01,1972-02-29,91,0,0,18,18,0,0,0,18,0,0,LA - Natchitoches
22,1972-1973,1972-12-01,1973-02-28,90,3,0,36,36,6,0,6,42,2,9,LA - Natchitoches
23,1973-1974,1973-12-01,1974-02-28,90,0,0,20,20,0,0,0,20,0,0,LA - Natchitoches
24,1974-1975,1974-12-01,1975-02-28,90,2,0,24,24,0,0,0,24,0,0,LA - Natchitoches
25,1975-1976,1975-12-01,1976-02-29,91,1,0,41,41,0,0,0,41,0,0,LA - Natchitoches
26,1976-1977,1976-12-01,1977-02-28,90,2,1,67,68,9,5,14,82,1,10,LA - Natchitoches
27,1977-1978,1977-12-01,1978-02-28,90,0,4,70,74,4,0,4,78,2,9,LA - Natchitoches
28,1978-1979,1978-12-01,1979-02-28,90,1,1,61,62,0,0,0,62,0,0,LA - Natchitoches
29,1979-1980,1979-12-01,1980-02-29,91,1,0,39,39,0,0,0,39,0,0,LA - Natchitoches
30,1980-1981,1980-12-01,1981-02-28,90,2,0,55,55,0,0,0,55,0,0,LA - Natchitoches
31,1981-1982,1981-12-01,1982-02-28,90,5,2,58,60,1,3,4,64,1,4,LA - Natchitoches
32,1982-1983,1982-12-01,1983-02-28,90,2,0,21,21,0,0,0,21,0,0,LA - Natchitoches
33,1983-1984,1983-12-01,1984-02-29,91,2,6,76,82,0,0,0,82,0,0,LA - Natchitoches
35,1985-1986,1985-12-01,1986-02-28,90,1,1,45,46,0,0,0,46,0,0,LA - Natchitoches
36,1986-1987,1986-12-01,1987-02-28,90,1,0,25,25,0,0,0,25,0,0,LA - Natchitoches
37,1987-1988,1987-12-01,1988-02-29,91,6,4,43,47,0,0,0,47,0,0,LA - Natchitoches
38,1988-1989,1988-12-01,1989-02-28,90,1,4,27,31,0,0,0,31,0,0,LA - Natchitoches
39,1989-1990,1989-12-01,1990-02-28,90,0,7,46,53,0,0,0,53,0,0,LA - Natchitoches
40,1990-1991,1990-12-01,1991-02-28,90,0,1,33,34,0,0,0,34,0,0,LA - Natchitoches
41,1991-1992,1991-12-01,1992-02-29,91,0,0,24,24,0,0,0,24,0,0,LA - Natchitoches
42,1992-1993,1992-12-01,1993-02-28,90,1,0,15,15,0,0,0,15,0,0,LA - Natchitoches
43,1993-1994,1993-12-01,1994-02-28,90,1,0,41,41,0,0,0,41,0,0,LA - Natchitoches
44,1994-1995,1994-12-01,1995-02-28,90,1,0,25,25,0,0,0,25,0,0,LA - Natchitoches
45,1995-1996,1995-12-01,1996-02-29,91,0,4,60,64,0,0,0,64,0,0,LA - Natchitoches
46,1996-1997,1996-12-01,1997-02-28,90,0,2,35,37,3,0,3,40,3,6,LA - Natchitoches
47,1997-1998,1997-12-01,1998-02-28,90,0,0,16,16,0,0,0,16,0,0,LA - Natchitoches
48,1998-1999,1998-12-01,1999-02-28,90,5,2,24,26,0,0,0,26,0,0,LA - Natchitoches
49,1999-2000,1999-12-01,2000-02-29,91,6,0,28,28,0,0,0,28,0,0,LA - Natchitoches
50,2000-2001,2000-12-01,2001-02-28,90,1,1,42,43,1,1,2,45,1,2,LA - Natchitoches
51,2001-2002,2001-12-01,2002-02-28,90,0,0,40,40,0,0,0,40,0,0,LA - Natchitoches
52,2002-2003,2002-12-01,2003-02-28,90,7,0,28,28,0,0,0,28,0,0,LA - Natchitoches
53,2003-2004,2003-12-01,2004-02-29,91,4,0,22,22,0,0,0,22,0,0,LA - Natchitoches
54,2004-2005,2004-12-01,2005-02-28,90,3,0,18,18,0,0,0,18,0,0,LA - Natchitoches
55,2005-2006,2005-12-01,2006-02-28,90,1,0,16,16,0,0,0,16,0,0,LA - Natchitoches
56,2006-2007,2006-12-01,2007-02-28,90,1,0,22,22,0,0,0,22,0,0,LA - Natchitoches
57,2007-2008,2007-12-01,2008-02-29,91,0,0,21,21,0,0,0,21,0,0,LA - Natchitoches
58,2008-2009,2008-12-01,2009-02-28,90,0,0,22,22,0,0,0,22,0,0,LA - Natchitoches
59,2009-2010,2009-12-01,2010-02-28,90,0,1,33,34,0,0,0,34,0,0,LA - Natchitoches
60,2010-2011,2010-12-01,2011-02-28,90,0,2,44,46,1,0,1,47,1,3,LA - Natchitoches
61,2011-2012,2011-12-01,2012-02-29,91,0,0,17,17,0,0,0,17,0,0,LA - Natchitoches
62,2012-2013,2012-12-01,2013-02-28,90,0,0,13,13,0,0,0,13,0,0,LA - Natchitoches
63,2013-2014,2013-12-01,2014-02-28,90,0,1,50,51,4,4,8,59,2,8,LA - Natchitoches
64,2014-2015,2014-12-01,2015-02-28,90,0,0,36,36,1,0,1,37,1,2,LA - Natchitoches
65,2015-2016,2015-12-01,2016-02-29,91,0,0,18,18,0,0,0,18,0,0,LA - Natchitoches
66,2016-2017,2016-12-01,2017-02-28,90,0,0,10,10,0,0,0,10,0,0,LA - Natchitoches
67,2017-2018,2017-12-01,2018-02-28,90,1,1,34,35,3,3,6,41,3,9,LA - Natchitoches
68,2018-2019,2018-12-01,2019-02-28,90,0,0,13,13,0,0,0,13,0,0,LA - Natchitoches
69,2019-2020,2019-12-01,2020-02-29,91,0,0,15,15,0,0,0,15,0,0,LA - Natchitoches
0,1950-1951,1950-12-01,1951-02-28,90,0,8,52,60,6,13,19,79,3,17,LA - Shreveport
1,1951-1952,1951-12-01,1952-02-29,91,0,0,23,23,0,0,0,23,0,0,LA - Shreveport
2,1952-1953,1952-12-01,1953-02-28,90,0,0,14,14,0,0,0,14,0,0,LA - Shreveport
3,1953-1954,1953-12-01,1954-02-28,90,0,1,24,25,0,0,0,25,0,0,LA - Shreveport
4,1954-1955,1954-12-01,1955-02-28,90,0,0,30,30,0,0,0,30,0,0,LA - Shreveport
5,1955-1956,1955-12-01,1956-02-29,91,0,0,24,24,0,0,0,24,0,0,LA - Shreveport
6,1956-1957,1956-12-01,1957-02-28,90,0,0,16,16,0,0,0,16,0,0,LA - Shreveport
7,1957-1958,1957-12-01,1958-02-28,90,0,0,33,33,0,0,0,33,0,0,LA - Shreveport
8,1958-1959,1958-12-01,1959-02-28,90,0,1,52,53,0,0,0,53,0,0,LA - Shreveport
9,1959-1960,1959-12-01,1960-02-29,91,0,0,31,31,4,0,4,35,3,8,LA - Shreveport
10,1960-1961,1960-12-01,1961-02-28,90,0,3,36,39,1,0,1,40,1,4,LA - Shreveport
11,1961-1962,1961-12-01,1962-02-28,90,0,5,47,52,4,11,15,67,1,8,LA - Shreveport
12,1962-1963,1962-12-01,1963-02-28,90,0,6,73,79,3,1,4,83,1,4,LA - Shreveport
13,1963-1964,1963-12-01,1964-02-29,91,0,4,59,63,8,6,14,77,4,16,LA - Shreveport
14,1964-1965,1964-12-01,1965-03-04,94,0,0,42,42,9,3,12,54,2,12,LA - Shreveport
15,1965-1966,1965-12-01,1966-02-28,90,0,1,38,39,3,1,4,43,2,5,LA - Shreveport
16,1966-1967,1966-12-01,1967-02-28,90,0,1,48,49,0,0,0,49,0,0,LA - Shreveport
17,1967-1968,1967-12-01,1968-03-21,112,0,2,50,52,6,0,6,58,4,13,LA - Shreveport
18,1968-1969,1968-12-01,1969-02-28,90,0,0,25,25,0,0,0,25,0,0,LA - Shreveport
19,1969-1970,1969-12-01,1970-02-28,90,0,1,40,41,0,0,0,41,0,0,LA - Shreveport
20,1970-1971,1970-12-01,1971-03-03,93,0,1,34,35,3,1,4,39,3,8,LA - Shreveport
21,1971-1972,1971-12-01,1972-02-29,91,0,1,30,31,0,0,0,31,0,0,LA - Shreveport
22,1972-1973,1972-12-01,1973-02-28,90,0,3,37,40,1,1,2,42,1,3,LA - Shreveport
23,1973-1974,1973-12-01,1974-02-28,90,0,3,38,41,0,0,0,41,0,0,LA - Shreveport
24,1974-1975,1974-12-01,1975-02-28,90,0,0,37,37,4,1,5,42,1,6,LA - Shreveport
25,1975-1976,1975-12-01,1976-02-29,91,0,0,39,39,0,0,0,39,0,0,LA - Shreveport
26,1976-1977,1976-12-01,1977-02-28,90,0,1,76,77,7,5,12,89,1,8,LA - Shreveport
27,1977-1978,1977-12-01,1978-03-03,93,0,10,106,116,11,6,17,133,6,23,LA - Shreveport
28,1978-1979,1978-12-01,1979-02-28,90,0,2,73,75,3,0,3,78,2,4,LA - Shreveport
29,1979-1980,1979-12-01,1980-02-29,91,0,0,39,39,3,0,3,42,2,4,LA - Shreveport
30,1980-1981,1980-11-26,1981-02-28,95,0,1,53,54,4,1,5,59,3,5,LA - Shreveport
31,1981-1982,1981-12-01,1982-02-28,90,0,3,58,61,7,9,16,77,1,10,LA - Shreveport
32,1982-1983,1982-12-01,1983-02-28,90,0,0,24,24,0,0,0,24,0,0,LA - Shreveport
33,1983-1984,1983-12-01,1984-02-29,91,0,10,84,94,7,2,9,103,1,8,LA - Shreveport
34,1984-1985,1984-12-01,1985-02-28,90,0,4,52,56,8,11,19,75,3,16,LA - Shreveport
35,1985-1986,1985-12-01,1986-02-28,90,0,0,53,53,0,0,0,53,0,0,LA - Shreveport
36,1986-1987,1986-12-01,1987-04-02,123,0,0,33,33,1,0,1,34,1,1,LA - Shreveport
37,1987-1988,1987-12-01,1988-02-29,91,0,3,54,57,4,5,9,66,3,11,LA - Shreveport
38,1988-1989,1988-12-01,1989-03-06,96,0,5,36,41,0,0,0,41,0,0,LA - Shreveport
39,1989-1990,1989-12-01,1990-02-28,90,0,4,44,48,0,0,0,48,0,0,LA - Shreveport
40,1990-1991,1990-12-01,1991-02-28,90,0,3,40,43,0,0,0,43,0,0,LA - Shreveport
41,1991-1992,1991-12-01,1992-02-29,91,0,0,19,19,0,0,0,19,0,0,LA - Shreveport
42,1992-1993,1992-12-01,1993-03-12,102,0,0,16,16,2,1,3,19,1,2,LA - Shreveport
43,1993-1994,1993-12-01,1994-02-28,90,0,0,34,34,1,0,1,35,1,2,LA - Shreveport
44,1994-1995,1994-12-01,1995-02-28,90,0,0,22,22,0,0,0,22,0,0,LA - Shreveport
45,1995-1996,1995-12-01,1996-02-29,91,0,3,54,57,2,0,2,59,2,6,LA - Shreveport
46,1996-1997,1996-12-01,1997-02-28,90,0,2,35,37,2,0,2,39,2,4,LA - Shreveport
47,1997-1998,1997-12-01,1998-02-28,90,0,0,15,15,0,0,0,15,0,0,LA - Shreveport
48,1998-1999,1998-12-01,1999-02-28,90,0,2,26,28,1,0,1,29,1,3,LA - Shreveport
49,1999-2000,1999-12-01,2000-02-29,91,0,1,28,29,2,3,5,34,1,3,LA - Shreveport
50,2000-2001,2000-12-01,2001-02-28,90,0,1,49,50,3,1,4,54,1,6,LA - Shreveport
51,2001-2002,2001-12-01,2002-02-28,90,0,0,32,32,0,0,0,32,0,0,LA - Shreveport
52,2002-2003,2002-12-01,2003-02-28,90,0,0,29,29,0,0,0,29,0,0,LA - Shreveport
53,2003-2004,2003-12-01,2004-02-29,91,0,0,32,32,0,0,0,32,0,0,LA - Shreveport
54,2004-2005,2004-12-01,2005-02-28,90,0,0,26,26,0,0,0,26,0,0,LA - Shreveport
55,2005-2006,2005-12-01,2006-02-28,90,0,1,21,22,0,0,0,22,0,0,LA - Shreveport
56,2006-2007,2006-12-01,2007-02-28,90,0,0,29,29,1,0,1,30,1,2,LA - Shreveport
57,2007-2008,2007-12-01,2008-02-29,91,0,0,31,31,0,0,0,31,0,0,LA - Shreveport
58,2008-2009,2008-12-01,2009-02-28,90,0,1,37,38,0,0,0,38,0,0,LA - Shreveport
59,2009-2010,2009-12-01,2010-03-21,111,0,1,59,60,10,4,14,74,4,13,LA - Shreveport
60,2010-2011,2010-12-01,2011-02-28,90,0,3,52,55,8,2,10,65,2,11,LA - Shreveport
61,2011-2012,2011-12-01,2012-02-29,91,0,0,17,17,0,0,0,17,0,0,LA - Shreveport
62,2012-2013,2012-12-01,2013-02-28,90,0,0,22,22,1,0,1,23,1,2,LA - Shreveport
63,2013-2014,2013-12-01,2014-02-28,90,0,0,53,53,2,1,3,56,1,3,LA - Shreveport
64,2014-2015,2014-12-01,2015-03-05,95,0,0,32,32,7,1,8,40,3,9,LA - Shreveport
65,2015-2016,2015-12-01,2016-02-29,91,0,0,20,20,0,0,0,20,0,0,LA - Shreveport
66,2016-2017,2016-12-01,2017-02-28,90,0,0,17,17,0,0,0,17,0,0,LA - Shreveport
67,2017-2018,2017-12-01,2018-02-28,90,0,2,47,49,2,2,4,53,1,5,LA - Shreveport
68,2018-2019,2018-12-01,2019-02-28,90,0,0,12,12,0,0,0,12,0,0,LA - Shreveport
69,2019-2020,2019-12-01,2020-02-29,91,0,0,18,18,0,0,0,18,0,0,LA - Shreveport
3,1953-1954,1953-12-01,1954-04-16,137,0,101,381,482,113,255,368,850,29,243,ME - Bangor
4,1954-1955,1954-11-25,1955-03-29,125,2,116,397,513,148,571,719,1232,48,329,ME - Bangor
6,1956-1957,1956-11-18,1957-04-09,143,4,122,469,591,127,312,439,1030,35,310,ME - Bangor
7,1957-1958,1957-11-24,1958-04-28,156,5,75,350,425,162,434,596,1021,46,264,ME - Bangor
8,1958-1959,1958-11-28,1959-03-27,120,2,153,526,679,139,464,603,1282,33,317,ME - Bangor
9,1959-1960,1959-11-20,1960-04-12,145,0,81,364,445,143,506,649,1094,40,249,ME - Bangor
10,1960-1961,1960-12-01,1961-05-03,154,3,130,493,623,108,489,597,1220,41,247,ME - Bangor
11,1961-1962,1961-11-20,1962-04-26,158,1,128,483,611,169,451,620,1231,43,344,ME - Bangor
12,1962-1963,1962-10-26,1963-05-11,198,1,132,576,708,253,1244,1497,2205,58,512,ME - Bangor
13,1963-1964,1963-10-29,1964-04-23,178,1,129,508,637,126,341,467,1104,40,297,ME - Bangor
14,1964-1965,1964-12-01,1965-04-23,144,0,170,535,705,110,385,495,1200,47,398,ME - Bangor
15,1965-1966,1965-10-28,1966-05-10,195,0,104,478,582,141,443,584,1166,51,323,ME - Bangor
16,1966-1967,1966-11-16,1967-05-08,174,0,119,524,643,112,563,675,1318,47,328,ME - Bangor
17,1967-1968,1967-11-16,1968-03-22,128,0,162,526,688,98,424,522,1210,33,266,ME - Bangor
18,1968-1969,1968-11-08,1969-04-20,164,0,112,463,575,168,1003,1171,1746,57,324,ME - Bangor
19,1969-1970,1969-10-22,1970-04-09,170,0,152,531,683,107,196,303,986,33,221,ME - Bangor
20,1970-1971,1970-10-17,1971-04-18,184,3,213,674,887,174,1050,1224,2111,57,498,ME - Bangor
22,1972-1973,1972-11-14,1973-04-12,150,0,135,478,613,128,752,880,1493,43,325,ME - Bangor
23,1973-1974,1973-11-06,1974-04-25,171,1,106,426,532,59,134,193,725,24,146,ME - Bangor
24,1974-1975,1974-11-22,1975-04-10,140,0,100,472,572,100,517,617,1189,33,215,ME - Bangor
25,1975-1976,1975-11-24,1976-04-12,141,0,138,525,663,113,342,455,1118,34,299,ME - Bangor
26,1976-1977,1976-11-09,1977-04-10,153,0,131,521,652,122,772,894,1546,30,258,ME - Bangor
27,1977-1978,1977-11-28,1978-04-12,136,0,177,497,674,117,615,732,1406,26,241,ME - Bangor
28,1978-1979,1978-11-21,1979-04-10,141,0,144,418,562,72,236,308,870,27,171,ME - Bangor
29,1979-1980,1979-10-09,1980-03-17,161,0,107,422,529,33,113,146,675,14,84,ME - Bangor
30,1980-1981,1980-11-10,1981-03-19,130,0,141,490,631,71,296,367,998,27,229,ME - Bangor
31,1981-1982,1981-11-25,1982-04-12,139,3,144,527,671,130,796,926,1597,43,334,ME - Bangor
32,1982-1983,1982-11-28,1983-04-02,126,0,78,359,437,61,178,239,676,22,138,ME - Bangor
33,1983-1984,1983-11-16,1984-04-10,147,0,126,438,564,104,267,371,935,31,249,ME - Bangor
34,1984-1985,1984-11-19,1985-04-06,139,0,109,441,550,74,322,396,946,24,176,ME - Bangor
35,1985-1986,1985-11-12,1986-03-28,137,3,109,475,584,91,469,560,1144,30,215,ME - Bangor
36,1986-1987,1986-11-06,1987-04-29,175,3,96,461,557,125,767,892,1449,34,261,ME - Bangor
37,1987-1988,1987-11-12,1988-04-17,158,0,102,486,588,110,447,557,1145,27,228,ME - Bangor
38,1988-1989,1988-10-09,1989-04-23,197,6,105,500,605,84,200,284,889,27,172,ME - Bangor
39,1989-1990,1989-11-21,1990-04-01,132,3,142,527,669,111,579,690,1359,28,255,ME - Bangor
40,1990-1991,1990-11-19,1991-03-27,129,5,81,374,455,47,221,268,723,18,115,ME - Bangor
41,1991-1992,1991-11-26,1992-04-17,144,0,135,521,656,74,258,332,988,27,213,ME - Bangor
42,1992-1993,1992-11-19,1993-04-07,140,0,138,549,687,118,539,657,1344,33,326,ME - Bangor
43,1993-1994,1993-11-25,1994-04-01,128,0,181,537,718,94,516,610,1328,27,275,ME - Bangor
52,2002-2003,2002-11-02,2003-04-09,159,3,156,616,772,94,470,564,1336,30,225,ME - Bangor
53,2003-2004,2003-12-01,2004-04-06,128,3,134,466,600,90,172,262,862,26,187,ME - Bangor
54,2004-2005,2004-12-01,2005-04-12,133,0,117,512,629,113,450,563,1192,35,302,ME - Bangor
55,2005-2006,2005-11-24,2006-04-06,134,0,84,398,482,56,119,175,657,25,162,ME - Bangor
56,2006-2007,2006-12-01,2007-04-15,136,2,111,490,601,82,350,432,1033,22,151,ME - Bangor
57,2007-2008,2007-11-24,2008-03-31,129,0,93,485,578,135,507,642,1220,38,297,ME - Bangor
58,2008-2009,2008-11-20,2009-03-23,124,6,129,556,685,124,614,738,1423,30,283,ME - Bangor
59,2009-2010,2009-12-01,2010-03-01,91,0,57,264,321,86,330,416,737,27,150,ME - Bangor
60,2010-2011,2010-11-26,2011-04-06,132,3,96,466,562,154,701,855,1417,29,290,ME - Bangor
61,2011-2012,2011-10-29,2012-03-29,153,0,59,350,409,71,170,241,650,25,151,ME - Bangor
62,2012-2013,2012-11-07,2013-04-13,158,0,101,448,549,103,362,465,1014,29,217,ME - Bangor
63,2013-2014,2013-11-24,2014-04-16,144,0,149,586,735,111,589,700,1435,37,306,ME - Bangor
64,2014-2015,2014-11-02,2015-04-09,159,12,161,651,812,187,995,1182,1994,46,449,ME - Bangor
65,2015-2016,2015-11-23,2016-04-04,134,0,65,352,417,63,226,289,706,20,152,ME - Bangor
66,2016-2017,2016-11-27,2017-04-19,144,0,87,445,532,105,376,481,1013,30,247,ME - Bangor
67,2017-2018,2017-12-01,2018-04-07,128,0,116,464,580,160,550,710,1290,36,316,ME - Bangor
68,2018-2019,2018-11-09,2019-04-11,154,0,108,529,637,115,332,447,1084,43,278,ME - Bangor
69,2019-2020,2019-11-08,2020-05-09,184,0,70,429,499,76,263,339,838,31,189,ME - Bangor
0,1950-1951,1950-10-23,1951-04-26,186,0,187,597,784,114,762,876,1660,47,340,ME - Caribou
1,1951-1952,1951-10-28,1952-04-20,176,0,223,697,920,189,1333,1522,2442,67,570,ME - Caribou
2,1952-1953,1952-10-19,1953-04-21,185,3,197,594,791,157,595,752,1543,46,326,ME - Caribou
3,1953-1954,1953-10-07,1954-04-16,192,0,206,633,839,153,754,907,1746,65,494,ME - Caribou
4,1954-1955,1954-10-27,1955-04-20,176,0,231,656,887,251,1502,1753,2640,66,598,ME - Caribou
5,1955-1956,1955-10-27,1956-04-25,182,0,226,683,909,133,809,942,1851,61,433,ME - Caribou
6,1956-1957,1956-10-11,1957-05-03,205,1,257,777,1034,146,882,1028,2062,74,590,ME - Caribou
7,1957-1958,1957-10-27,1958-04-20,176,3,155,518,673,179,938,1117,1790,56,417,ME - Caribou
8,1958-1959,1958-10-12,1959-04-19,190,0,295,860,1155,171,1150,1321,2476,78,677,ME - Caribou
9,1959-1960,1959-10-16,1960-04-25,193,0,192,645,837,195,974,1169,2006,81,516,ME - Caribou
10,1960-1961,1960-11-07,1961-05-21,196,0,250,783,1033,209,1165,1374,2407,75,618,ME - Caribou
11,1961-1962,1961-10-15,1962-04-24,192,0,213,668,881,106,359,465,1346,58,403,ME - Caribou
12,1962-1963,1962-10-26,1963-04-25,182,0,246,785,1031,208,1291,1499,2530,66,610,ME - Caribou
13,1963-1964,1963-10-29,1964-04-23,178,0,234,694,928,150,671,821,1749,50,389,ME - Caribou
14,1964-1965,1964-10-13,1965-04-14,184,0,256,707,963,138,616,754,1717,56,466,ME - Caribou
15,1965-1966,1965-10-27,1966-05-10,196,0,191,656,847,173,1130,1303,2150,82,526,ME - Caribou
16,1966-1967,1966-10-20,1967-05-12,205,0,228,777,1005,161,1029,1190,2195,70,558,ME - Caribou
17,1967-1968,1967-11-09,1968-04-05,149,0,263,717,980,156,844,1000,1980,54,488,ME - Caribou
18,1968-1969,1968-11-08,1969-04-29,173,3,186,625,811,223,1480,1703,2514,76,560,ME - Caribou
19,1969-1970,1969-10-20,1970-04-21,184,0,230,708,938,137,555,692,1630,63,462,ME - Caribou
20,1970-1971,1970-10-17,1971-04-23,189,0,282,752,1034,190,1055,1245,2279,82,602,ME - Caribou
21,1971-1972,1971-11-07,1972-04-27,173,0,311,897,1208,202,1133,1335,2543,77,757,ME - Caribou
22,1972-1973,1972-10-24,1973-04-19,178,0,265,777,1042,215,1219,1434,2476,67,580,ME - Caribou
23,1973-1974,1973-11-05,1974-05-25,202,1,245,752,997,168,569,737,1734,69,531,ME - Caribou
24,1974-1975,1974-10-20,1975-04-29,192,0,228,762,990,184,951,1135,2125,75,574,ME - Caribou
25,1975-1976,1975-11-15,1976-05-07,175,0,271,822,1093,192,996,1188,2281,67,654,ME - Caribou
26,1976-1977,1976-10-22,1977-04-23,184,0,277,786,1063,208,1480,1688,2751,65,617,ME - Caribou
27,1977-1978,1977-11-13,1978-05-01,170,0,266,687,953,168,1012,1180,2133,58,499,ME - Caribou
28,1978-1979,1978-11-11,1979-04-19,160,0,250,627,877,179,1036,1215,2092,64,473,ME - Caribou
29,1979-1980,1979-10-09,1980-04-22,197,0,204,639,843,110,676,786,1629,50,359,ME - Caribou
30,1980-1981,1980-10-21,1981-05-17,209,0,237,683,920,186,812,998,1918,70,561,ME - Caribou
31,1981-1982,1981-10-22,1982-05-01,192,0,252,721,973,221,1273,1494,2467,67,563,ME - Caribou
32,1982-1983,1982-11-13,1983-04-12,151,0,182,570,752,124,457,581,1333,51,347,ME - Caribou
33,1983-1984,1983-11-04,1984-05-04,183,0,250,699,949,196,1214,1410,2359,73,593,ME - Caribou
34,1984-1985,1984-10-05,1985-05-14,222,0,233,725,958,138,892,1030,1988,57,441,ME - Caribou
35,1985-1986,1985-11-10,1986-04-13,155,0,254,751,1005,152,829,981,1986,59,485,ME - Caribou
36,1986-1987,1986-10-06,1987-04-30,207,0,232,722,954,129,1045,1174,2128,53,422,ME - Caribou
37,1987-1988,1987-11-06,1988-04-25,172,0,210,679,889,148,948,1096,1985,58,420,ME - Caribou
38,1988-1989,1988-10-05,1989-04-24,202,0,240,791,1031,130,870,1000,2031,67,472,ME - Caribou
39,1989-1990,1989-10-04,1990-05-22,231,0,275,801,1076,181,1195,1376,2452,72,648,ME - Caribou
40,1990-1991,1990-11-06,1991-04-19,165,0,195,658,853,141,1053,1194,2047,58,454,ME - Caribou
41,1991-1992,1991-09-29,1992-04-14,199,0,274,772,1046,139,750,889,1935,58,499,ME - Caribou
42,1992-1993,1992-10-19,1993-04-11,175,0,275,767,1042,125,760,885,1927,56,472,ME - Caribou
43,1993-1994,1993-10-10,1994-04-25,198,0,311,817,1128,190,984,1174,2302,67,596,ME - Caribou
44,1994-1995,1994-11-23,1995-05-07,166,0,217,645,862,193,986,1179,2041,56,485,ME - Caribou
45,1995-1996,1995-11-02,1996-05-13,194,0,272,719,991,167,552,719,1710,67,489,ME - Caribou
46,1996-1997,1996-10-30,1997-05-07,190,1,216,703,919,197,902,1099,2018,64,483,ME - Caribou
47,1997-1998,1997-10-23,1998-04-25,185,3,187,634,821,186,1383,1569,2390,64,457,ME - Caribou
48,1998-1999,1998-11-01,1999-04-24,175,3,177,603,780,194,688,882,1662,66,503,ME - Caribou
49,1999-2000,1999-10-14,2000-04-27,197,3,188,623,811,165,783,948,1759,53,430,ME - Caribou
50,2000-2001,2000-10-09,2001-04-21,195,0,237,693,930,193,962,1155,2085,63,496,ME - Caribou
51,2001-2002,2001-11-11,2002-05-15,186,0,160,548,708,135,525,660,1368,63,441,ME - Caribou
52,2002-2003,2002-10-19,2003-04-20,184,0,299,843,1142,170,1050,1220,2362,63,564,ME - Caribou
53,2003-2004,2003-10-21,2004-04-26,189,0,240,673,913,152,488,640,1553,55,415,ME - Caribou
54,2004-2005,2004-11-05,2005-04-29,176,3,244,701,945,186,770,956,1901,65,561,ME - Caribou
55,2005-2006,2005-10-25,2006-04-06,164,0,184,544,728,146,712,858,1586,67,471,ME - Caribou
56,2006-2007,2006-11-06,2007-05-17,193,0,210,651,861,156,567,723,1584,56,436,ME - Caribou
57,2007-2008,2007-10-29,2008-04-19,174,0,237,759,996,284,1284,1568,2564,79,719,ME - Caribou
58,2008-2009,2008-10-21,2009-04-13,175,6,246,759,1005,172,921,1093,2098,63,550,ME - Caribou
59,2009-2010,2009-10-22,2010-04-10,171,0,135,435,570,109,448,557,1127,47,283,ME - Caribou
60,2010-2011,2010-11-19,2011-04-22,155,0,188,573,761,153,604,757,1518,51,415,ME - Caribou
61,2011-2012,2011-10-30,2012-04-27,181,0,156,568,724,153,629,782,1506,50,383,ME - Caribou
62,2012-2013,2012-11-06,2013-04-14,160,0,186,572,758,161,534,695,1453,59,417,ME - Caribou
63,2013-2014,2013-10-28,2014-04-25,180,0,280,780,1060,223,1074,1297,2357,79,710,ME - Caribou
64,2014-2015,2014-11-01,2015-05-23,204,3,279,788,1067,212,1026,1238,2305,72,662,ME - Caribou
65,2015-2016,2015-10-19,2016-05-16,211,0,144,549,693,145,649,794,1487,54,375,ME - Caribou
66,2016-2017,2016-11-21,2017-04-23,154,0,191,596,787,192,1272,1464,2251,74,561,ME - Caribou
67,2017-2018,2017-11-11,2018-04-25,166,0,205,647,852,202,1211,1413,2265,74,611,ME - Caribou
68,2018-2019,2018-10-24,2019-04-25,184,0,244,755,999,240,1551,1791,2790,70,597,ME - Caribou
69,2019-2020,2019-11-07,2020-05-12,188,0,159,646,805,223,1196,1419,2224,67,505,ME - Caribou
26,1976-1977,1976-10-25,1977-04-30,188,2,183,678,861,178,1172,1350,2211,45,387,ME - Dover-Foxcroft
27,1977-1978,1977-11-13,1978-04-25,164,0,165,669,834,177,1170,1347,2181,49,417,ME - Dover-Foxcroft
28,1978-1979,1978-11-21,1979-04-17,148,0,184,575,759,185,1006,1191,1950,47,389,ME - Dover-Foxcroft
29,1979-1980,1979-10-10,1980-04-23,197,1,128,578,706,90,392,482,1188,32,203,ME - Dover-Foxcroft
30,1980-1981,1980-11-11,1981-04-25,166,4,181,635,816,112,546,658,1474,45,347,ME - Dover-Foxcroft
31,1981-1982,1981-10-24,1982-04-27,186,8,180,729,909,227,1732,1959,2868,56,475,ME - Dover-Foxcroft
32,1982-1983,1982-11-16,1983-04-14,150,3,103,503,606,122,463,585,1191,35,254,ME - Dover-Foxcroft
33,1983-1984,1983-11-15,1984-04-20,158,11,163,637,800,173,1030,1203,2003,45,401,ME - Dover-Foxcroft
34,1984-1985,1984-10-26,1985-04-15,172,9,142,645,787,162,978,1140,1927,39,342,ME - Dover-Foxcroft
35,1985-1986,1985-11-09,1986-05-06,179,5,170,689,859,141,902,1043,1902,42,375,ME - Dover-Foxcroft
36,1986-1987,1986-11-07,1987-05-01,176,15,166,649,815,114,1230,1344,2159,35,281,ME - Dover-Foxcroft
37,1987-1988,1987-11-07,1988-04-25,171,10,148,673,821,152,1165,1317,2138,37,365,ME - Dover-Foxcroft
40,1990-1991,1990-11-09,1991-04-18,161,11,145,555,700,131,870,1001,1701,31,275,ME - Dover-Foxcroft
41,1991-1992,1991-11-12,1992-04-18,159,6,192,665,857,107,771,878,1735,32,303,ME - Dover-Foxcroft
42,1992-1993,1992-11-08,1993-04-19,163,15,198,651,849,153,946,1099,1948,34,344,ME - Dover-Foxcroft
43,1993-1994,1993-11-01,1994-04-22,173,20,221,707,928,135,966,1101,2029,34,369,ME - Dover-Foxcroft
44,1994-1995,1994-11-24,1995-04-11,139,20,128,521,649,99,701,800,1449,29,235,ME - Dover-Foxcroft
46,1996-1997,1996-11-03,1997-05-08,187,2,145,628,773,151,945,1096,1869,36,322,ME - Dover-Foxcroft
47,1997-1998,1997-10-27,1998-04-07,163,17,94,499,593,122,1097,1219,1812,34,249,ME - Dover-Foxcroft
48,1998-1999,1998-11-20,1999-03-31,132,5,88,501,589,124,776,900,1489,30,307,ME - Dover-Foxcroft
54,2004-2005,2004-11-12,2005-04-13,153,10,184,595,779,121,783,904,1683,33,344,ME - Dover-Foxcroft
58,2008-2009,2008-11-20,2009-04-12,144,3,159,720,879,155,1093,1248,2127,32,373,ME - Dover-Foxcroft
59,2009-2010,2009-11-06,2010-03-28,143,10,92,391,483,64,603,667,1150,18,124,ME - Dover-Foxcroft
60,2010-2011,2010-10-31,2011-04-22,174,6,127,659,786,128,982,1110,1896,32,305,ME - Dover-Foxcroft
61,2011-2012,2011-11-23,2012-04-01,131,17,87,515,602,68,433,501,1103,17,151,ME - Dover-Foxcroft
62,2012-2013,2012-11-08,2013-04-14,158,15,111,507,618,75,605,680,1298,18,150,ME - Dover-Foxcroft
63,2013-2014,2013-11-14,2014-04-27,165,6,179,786,965,122,1307,1429,2394,33,338,ME - Dover-Foxcroft
64,2014-2015,2014-11-03,2015-04-20,169,1,186,790,976,115,1108,1223,2199,32,334,ME - Dover-Foxcroft
65,2015-2016,2015-11-23,2016-04-07,137,4,77,466,543,84,541,625,1168,24,213,ME - Dover-Foxcroft
66,2016-2017,2016-11-22,2017-04-16,146,0,107,573,680,145,1190,1335,2015,29,309,ME - Dover-Foxcroft
67,2017-2018,2017-11-11,2018-04-21,162,6,151,654,805,132,1082,1214,2019,26,286,ME - Dover-Foxcroft
68,2018-2019,2018-10-28,2019-04-21,176,9,137,780,917,125,1434,1559,2476,35,336,ME - Dover-Foxcroft
69,2019-2020,2019-11-09,2020-05-10,184,3,91,604,695,129,1013,1142,1837,36,286,ME - Dover-Foxcroft
16,1966-1967,1966-11-06,1967-05-08,184,8,115,702,817,115,797,912,1729,32,273,ME - Farmington
17,1967-1968,1967-11-15,1968-03-28,135,7,143,693,836,113,876,989,1825,26,271,ME - Farmington
18,1968-1969,1968-11-08,1969-04-20,164,0,130,706,836,241,1636,1877,2713,47,434,ME - Farmington
20,1970-1971,1970-11-16,1971-04-17,153,0,187,794,981,225,1639,1864,2845,38,466,ME - Farmington
21,1971-1972,1971-11-25,1972-04-21,149,0,150,732,882,180,1107,1287,2169,36,376,ME - Farmington
22,1972-1973,1972-11-09,1973-04-11,154,11,134,635,769,142,1054,1196,1965,31,300,ME - Farmington
23,1973-1974,1973-11-07,1974-04-25,170,0,120,650,770,90,200,290,1060,26,223,ME - Farmington
24,1974-1975,1974-10-03,1975-04-22,202,0,106,740,846,154,1077,1231,2077,33,290,ME - Farmington
25,1975-1976,1975-11-25,1976-04-13,141,1,179,775,954,159,1011,1170,2124,34,419,ME - Farmington
26,1976-1977,1976-10-24,1977-04-11,170,1,160,702,862,154,1095,1249,2111,29,292,ME - Farmington
27,1977-1978,1977-11-24,1978-04-22,150,0,160,695,855,179,1381,1560,2415,31,333,ME - Farmington
28,1978-1979,1978-11-21,1979-04-16,147,0,181,678,859,159,1038,1197,2056,34,340,ME - Farmington
30,1980-1981,1980-11-17,1981-03-28,132,0,162,692,854,63,333,396,1250,15,178,ME - Farmington
31,1981-1982,1981-11-21,1982-04-18,149,1,186,748,934,159,1365,1524,2458,36,365,ME - Farmington
32,1982-1983,1982-11-15,1983-04-11,148,14,95,528,623,78,261,339,962,21,156,ME - Farmington
33,1983-1984,1983-11-15,1984-04-05,143,3,137,677,814,109,704,813,1627,19,207,ME - Farmington
34,1984-1985,1984-11-20,1985-04-10,142,1,126,612,738,121,725,846,1584,30,280,ME - Farmington
35,1985-1986,1985-11-13,1986-05-05,174,0,124,666,790,117,800,917,1707,25,243,ME - Farmington
36,1986-1987,1986-11-06,1987-04-30,176,3,116,635,751,126,1216,1342,2093,24,234,ME - Farmington
37,1987-1988,1987-11-07,1988-04-17,163,2,120,644,764,122,987,1109,1873,19,205,ME - Farmington
38,1988-1989,1988-11-21,1989-04-17,148,4,143,691,834,102,694,796,1630,31,249,ME - Farmington
39,1989-1990,1989-11-20,1990-04-06,138,3,165,691,856,140,1071,1211,2067,31,324,ME - Farmington
40,1990-1991,1990-11-11,1991-03-28,138,0,104,536,640,100,592,692,1332,18,172,ME - Farmington
41,1991-1992,1991-11-12,1992-04-17,158,3,144,620,764,107,575,682,1446,24,256,ME - Farmington
42,1992-1993,1992-11-17,1993-04-11,146,5,154,663,817,177,798,975,1792,26,341,ME - Farmington
43,1993-1994,1993-11-01,1994-04-08,159,12,193,753,946,144,782,926,1872,28,344,ME - Farmington
44,1994-1995,1994-11-23,1995-04-06,135,6,116,558,674,116,511,627,1301,29,262,ME - Farmington
45,1995-1996,1995-11-11,1996-04-15,157,1,174,675,849,195,956,1151,2000,43,416,ME - Farmington
46,1996-1997,1996-11-14,1997-04-29,167,0,124,614,738,146,874,1020,1758,30,300,ME - Farmington
47,1997-1998,1997-10-23,1998-03-30,159,0,85,509,594,113,666,779,1373,31,237,ME - Farmington
48,1998-1999,1998-11-18,1999-03-28,131,2,82,491,573,115,640,755,1328,24,249,ME - Farmington
49,1999-2000,1999-11-13,2000-04-22,162,3,104,475,579,93,537,630,1209,19,165,ME - Farmington
51,2001-2002,2001-10-31,2002-05-13,195,2,50,439,489,122,600,722,1211,42,262,ME - Farmington
52,2002-2003,2002-11-01,2003-04-06,157,9,163,657,820,101,648,749,1569,26,204,ME - Farmington
53,2003-2004,2003-11-09,2004-04-13,157,1,151,567,718,122,898,1020,1738,23,225,ME - Farmington
54,2004-2005,2004-11-21,2005-04-13,144,0,137,555,692,144,845,989,1681,41,383,ME - Farmington
55,2005-2006,2005-10-25,2006-04-04,162,7,92,463,555,75,245,320,875,23,165,ME - Farmington
56,2006-2007,2006-12-01,2007-04-17,138,8,101,503,604,140,637,777,1381,28,237,ME - Farmington
57,2007-2008,2007-11-20,2008-04-16,149,0,107,555,662,196,1250,1446,2108,45,404,ME - Farmington
58,2008-2009,2008-11-19,2009-04-01,134,8,133,605,738,150,990,1140,1878,32,320,ME - Farmington
59,2009-2010,2009-11-05,2010-04-17,164,1,71,374,445,84,504,588,1033,27,153,ME - Farmington
62,2012-2013,2012-11-08,2013-04-12,156,0,99,464,563,126,619,745,1308,37,264,ME - Farmington
63,2013-2014,2013-11-10,2014-04-16,158,0,178,674,852,157,1085,1242,2094,45,392,ME - Farmington
64,2014-2015,2014-11-13,2015-04-11,150,0,175,673,848,146,1186,1332,2180,42,364,ME - Farmington
65,2015-2016,2015-11-23,2016-04-26,156,0,68,422,490,65,358,423,913,28,178,ME - Farmington
66,2016-2017,2016-11-24,2017-04-13,141,0,114,504,618,175,1117,1292,1910,41,371,ME - Farmington
67,2017-2018,2017-11-20,2018-04-17,149,0,140,532,672,138,814,952,1624,36,328,ME - Farmington
68,2018-2019,2018-10-23,2019-04-18,178,0,135,641,776,163,1379,1542,2318,44,348,ME - Farmington
69,2019-2020,2019-11-08,2020-05-09,184,0,80,501,581,121,676,797,1378,43,271,ME - Farmington
5,1955-1956,1955-11-19,1956-03-31,134,10,164,758,922,75,773,848,1770,17,164,ME - Fort Kent
7,1957-1958,1957-10-28,1958-04-13,168,2,128,577,705,167,1107,1274,1979,40,333,ME - Fort Kent
11,1961-1962,1961-10-15,1962-04-18,186,6,197,744,941,75,584,659,1600,32,252,ME - Fort Kent
12,1962-1963,1962-10-25,1963-04-22,180,0,216,909,1125,173,1451,1624,2749,47,459,ME - Fort Kent
13,1963-1964,1963-10-29,1964-04-12,167,0,190,757,947,114,837,951,1898,36,250,ME - Fort Kent
14,1964-1965,1964-11-12,1965-04-13,153,0,227,747,974,98,654,752,1726,45,397,ME - Fort Kent
15,1965-1966,1965-11-02,1966-05-07,187,0,165,713,878,162,1269,1431,2309,48,385,ME - Fort Kent
16,1966-1967,1966-11-14,1967-05-08,176,6,200,861,1061,136,970,1106,2167,44,421,ME - Fort Kent
17,1967-1968,1967-11-14,1968-03-31,139,4,243,776,1019,96,985,1081,2100,35,326,ME - Fort Kent
23,1973-1974,1973-11-05,1974-05-08,185,1,259,898,1157,148,1127,1275,2432,34,318,ME - Fort Kent
24,1974-1975,1974-10-21,1975-04-29,191,10,229,935,1164,197,1334,1531,2695,39,418,ME - Fort Kent
26,1976-1977,1976-10-26,1977-04-26,183,4,278,955,1233,226,1634,1860,3093,43,535,ME - Fort Kent
27,1977-1978,1977-11-14,1978-05-01,169,2,248,865,1113,163,1020,1183,2296,38,371,ME - Fort Kent
28,1978-1979,1978-11-11,1979-04-14,155,1,256,791,1047,161,1081,1242,2289,37,386,ME - Fort Kent
29,1979-1980,1979-11-16,1980-04-09,146,1,207,788,995,98,761,859,1854,25,263,ME - Fort Kent
30,1980-1981,1980-10-21,1981-04-16,178,0,252,855,1107,108,674,782,1889,26,292,ME - Fort Kent
31,1981-1982,1981-10-22,1982-05-01,192,12,248,860,1108,191,1160,1351,2459,43,434,ME - Fort Kent
33,1983-1984,1983-11-14,1984-04-24,163,5,243,870,1113,180,1435,1615,2728,32,407,ME - Fort Kent
34,1984-1985,1984-11-14,1985-04-18,156,7,266,854,1120,102,815,917,2037,26,298,ME - Fort Kent
35,1985-1986,1985-11-10,1986-04-12,154,10,245,783,1028,136,690,826,1854,36,339,ME - Fort Kent
38,1988-1989,1988-11-14,1989-04-24,162,15,248,933,1181,131,1027,1158,2339,44,428,ME - Fort Kent
39,1989-1990,1989-11-05,1990-04-15,162,15,303,884,1187,149,1123,1272,2459,41,456,ME - Fort Kent
40,1990-1991,1990-11-06,1991-04-22,168,10,194,815,1009,124,1278,1402,2411,30,297,ME - Fort Kent
41,1991-1992,1991-11-08,1992-04-15,160,7,270,896,1166,98,735,833,1999,31,305,ME - Fort Kent
42,1992-1993,1992-11-02,1993-04-10,160,7,258,964,1222,103,782,885,2107,30,314,ME - Fort Kent
47,1997-1998,1997-10-24,1998-04-13,172,15,201,725,926,165,1156,1321,2247,42,369,ME - Fort Kent
48,1998-1999,1998-11-13,1999-04-15,154,8,185,700,885,149,993,1142,2027,39,393,ME - Fort Kent
55,2005-2006,2005-10-26,2006-04-11,168,17,216,670,886,149,1009,1158,2044,47,440,ME - Fort Kent
56,2006-2007,2006-11-06,2007-05-17,193,5,207,757,964,155,863,1018,1982,39,353,ME - Fort Kent
57,2007-2008,2007-10-30,2008-04-22,176,1,261,897,1158,240,1440,1680,2838,62,671,ME - Fort Kent
58,2008-2009,2008-10-22,2009-04-13,174,7,264,941,1205,156,1131,1287,2492,35,413,ME - Fort Kent
59,2009-2010,2009-10-23,2010-04-27,187,16,143,512,655,110,823,933,1588,32,225,ME - Fort Kent
60,2010-2011,2010-11-20,2011-04-22,154,16,217,700,917,163,779,942,1859,41,431,ME - Fort Kent
62,2012-2013,2012-11-07,2013-04-16,161,4,218,716,934,169,773,942,1876,49,476,ME - Fort Kent
63,2013-2014,2013-10-29,2014-04-17,171,4,337,968,1305,180,1113,1293,2598,52,545,ME - Fort Kent
64,2014-2015,2014-11-03,2015-04-21,170,6,313,942,1255,122,793,915,2170,33,338,ME - Fort Kent
65,2015-2016,2015-11-18,2016-04-17,152,0,183,657,840,120,812,932,1772,32,320,ME - Fort Kent
66,2016-2017,2016-11-22,2017-04-23,153,2,237,724,961,162,1093,1255,2216,38,395,ME - Fort Kent
67,2017-2018,2017-11-08,2018-04-24,168,6,258,805,1063,183,1168,1351,2414,39,407,ME - Fort Kent
68,2018-2019,2018-10-28,2019-04-15,170,4,285,879,1164,229,1229,1458,2622,46,556,ME - Fort Kent
69,2019-2020,2019-11-10,2020-05-13,186,4,207,818,1025,187,1123,1310,2335,43,433,ME - Fort Kent
23,1973-1974,1973-11-06,1974-04-27,173,5,237,735,972,128,624,752,1724,41,369,ME - Jackman
24,1974-1975,1974-11-15,1975-04-28,165,1,198,758,956,195,1332,1527,2483,45,423,ME - Jackman
25,1975-1976,1975-10-18,1976-05-04,200,2,236,841,1077,214,859,1073,2150,52,588,ME - Jackman
26,1976-1977,1976-10-25,1977-04-25,183,1,268,770,1038,175,944,1119,2157,57,512,ME - Jackman
27,1977-1978,1977-11-14,1978-05-04,172,13,239,807,1046,176,1352,1528,2574,39,443,ME - Jackman
28,1978-1979,1978-11-21,1979-04-13,144,5,259,705,964,173,978,1151,2115,40,415,ME - Jackman
29,1979-1980,1979-10-10,1980-04-06,180,7,195,699,894,95,297,392,1286,33,280,ME - Jackman
30,1980-1981,1980-10-22,1981-04-22,183,8,224,803,1027,109,583,692,1719,37,331,ME - Jackman
31,1981-1982,1981-10-24,1982-04-18,177,3,246,837,1083,212,1533,1745,2828,53,510,ME - Jackman
32,1982-1983,1982-11-15,1983-04-13,150,7,150,604,754,103,355,458,1212,29,209,ME - Jackman
33,1983-1984,1983-11-13,1984-05-05,175,5,222,787,1009,157,801,958,1967,41,437,ME - Jackman
34,1984-1985,1984-10-26,1985-04-18,175,9,197,819,1016,141,550,691,1707,43,417,ME - Jackman
35,1985-1986,1985-11-09,1986-05-05,178,8,197,813,1010,184,803,987,1997,51,508,ME - Jackman
38,1988-1989,1988-11-21,1989-04-15,146,12,169,872,1041,125,975,1100,2141,30,312,ME - Jackman
40,1990-1991,1990-11-07,1991-04-21,166,4,142,766,908,155,1040,1195,2103,35,367,ME - Jackman
42,1992-1993,1992-10-26,1993-04-24,181,10,221,858,1079,178,1035,1213,2292,35,427,ME - Jackman
44,1994-1995,1994-11-23,1995-05-08,167,9,181,679,860,121,719,840,1700,33,312,ME - Jackman
45,1995-1996,1995-11-10,1996-04-18,161,3,249,781,1030,232,1118,1350,2380,47,482,ME - Jackman
46,1996-1997,1996-11-04,1997-05-08,186,2,205,741,946,174,1125,1299,2245,43,405,ME - Jackman
47,1997-1998,1997-10-27,1998-04-21,177,2,144,668,812,168,1133,1301,2113,47,376,ME - Jackman
48,1998-1999,1998-11-09,1999-04-06,149,1,140,586,726,122,726,848,1574,31,296,ME - Jackman
49,1999-2000,1999-10-05,2000-04-27,206,6,183,678,861,156,917,1073,1934,33,313,ME - Jackman
50,2000-2001,2000-10-10,2001-04-22,195,4,218,793,1011,237,1593,1830,2841,46,481,ME - Jackman
51,2001-2002,2001-11-01,2002-04-30,181,6,114,546,660,153,788,941,1601,42,349,ME - Jackman
52,2002-2003,2002-11-02,2003-04-25,175,5,269,807,1076,117,910,1027,2103,33,272,ME - Jackman
53,2003-2004,2003-10-21,2004-05-05,198,11,230,733,963,144,897,1041,2004,38,323,ME - Jackman
54,2004-2005,2004-11-05,2005-04-08,155,6,202,721,923,159,940,1099,2022,37,401,ME - Jackman
55,2005-2006,2005-10-26,2006-04-09,166,6,180,590,770,145,705,850,1620,46,389,ME - Jackman
56,2006-2007,2006-11-06,2007-04-28,174,2,203,668,871,179,924,1103,1974,28,306,ME - Jackman
57,2007-2008,2007-11-09,2008-04-30,174,6,191,705,896,245,1470,1715,2611,55,539,ME - Jackman
58,2008-2009,2008-10-30,2009-04-18,171,4,244,798,1042,171,1237,1408,2450,28,370,ME - Jackman
59,2009-2010,2009-10-22,2010-04-18,179,3,153,499,652,145,800,945,1597,32,276,ME - Jackman
60,2010-2011,2010-10-31,2011-04-28,180,0,208,689,897,183,1140,1323,2220,37,401,ME - Jackman
61,2011-2012,2011-10-30,2012-03-31,154,0,129,554,683,118,573,691,1374,37,281,ME - Jackman
62,2012-2013,2012-10-14,2013-04-19,188,0,186,648,834,167,1047,1214,2048,40,381,ME - Jackman
63,2013-2014,2013-11-10,2014-04-29,171,0,281,850,1131,158,1245,1403,2534,42,397,ME - Jackman
64,2014-2015,2014-11-07,2015-04-25,170,1,269,864,1133,163,906,1069,2202,56,492,ME - Jackman
65,2015-2016,2015-10-17,2016-04-10,177,2,136,605,741,103,297,400,1141,40,315,ME - Jackman
66,2016-2017,2016-10-28,2017-04-22,177,0,193,685,878,162,653,815,1693,53,462,ME - Jackman
67,2017-2018,2017-11-08,2018-04-22,166,0,257,885,1142,142,753,895,2037,46,474,ME - Jackman
68,2018-2019,2018-10-24,2019-05-14,203,0,232,912,1144,199,1205,1404,2548,64,587,ME - Jackman
69,2019-2020,2019-11-09,2020-05-09,183,0,172,782,954,146,839,985,1939,45,403,ME - Jackman
0,1950-1951,1950-11-21,1951-03-23,123,0,51,307,358,66,119,185,543,25,161,ME - Portland
1,1951-1952,1951-11-01,1952-03-24,145,0,57,423,480,140,392,532,1012,28,260,ME - Portland
2,1952-1953,1952-11-09,1953-04-14,157,0,38,316,354,48,65,113,467,25,121,ME - Portland
3,1953-1954,1953-11-07,1954-04-16,161,0,67,390,457,72,136,208,665,28,192,ME - Portland
4,1954-1955,1954-11-25,1955-03-28,124,0,64,355,419,80,139,219,638,33,209,ME - Portland
5,1955-1956,1955-11-11,1956-04-24,166,0,69,500,569,159,609,768,1337,47,314,ME - Portland
6,1956-1957,1956-11-18,1957-04-10,144,0,82,448,530,127,306,433,963,32,276,ME - Portland
7,1957-1958,1957-11-26,1958-04-28,154,0,42,335,377,129,358,487,864,36,217,ME - Portland
8,1958-1959,1958-11-28,1959-03-21,114,0,105,479,584,87,255,342,926,28,235,ME - Portland
9,1959-1960,1959-10-19,1960-04-01,166,3,44,373,417,135,438,573,990,37,231,ME - Portland
10,1960-1961,1960-12-01,1961-04-15,136,0,91,507,598,109,385,494,1092,28,231,ME - Portland
11,1961-1962,1961-10-15,1962-04-25,193,0,87,481,568,129,475,604,1172,41,285,ME - Portland
12,1962-1963,1962-10-26,1963-04-24,181,0,80,513,593,116,633,749,1342,40,260,ME - Portland
13,1963-1964,1963-10-30,1964-04-04,158,0,80,483,563,116,369,485,1048,40,305,ME - Portland
14,1964-1965,1964-12-01,1965-04-18,139,0,85,417,502,81,248,329,831,33,231,ME - Portland
15,1965-1966,1965-11-01,1966-05-10,191,0,59,426,485,116,563,679,1164,38,202,ME - Portland
16,1966-1967,1966-12-01,1967-05-07,158,0,75,473,548,147,687,834,1382,40,297,ME - Portland
17,1967-1968,1967-11-15,1968-03-17,124,0,93,464,557,86,392,478,1035,28,205,ME - Portland
18,1968-1969,1968-11-08,1969-03-30,143,0,61,374,435,155,529,684,1119,35,226,ME - Portland
19,1969-1970,1969-10-22,1970-04-02,163,0,74,406,480,97,337,434,914,33,194,ME - Portland
20,1970-1971,1970-12-01,1971-04-16,137,0,141,500,641,190,971,1161,1802,39,369,ME - Portland
21,1971-1972,1971-11-22,1972-04-14,145,0,85,443,528,127,289,416,944,39,288,ME - Portland
22,1972-1973,1972-11-05,1973-04-10,157,0,85,365,450,102,539,641,1091,36,226,ME - Portland
23,1973-1974,1973-12-01,1974-04-12,133,0,65,320,385,59,162,221,606,25,140,ME - Portland
24,1974-1975,1974-11-21,1975-04-05,136,0,36,363,399,72,242,314,713,31,152,ME - Portland
25,1975-1976,1975-11-24,1976-04-12,141,0,103,446,549,98,359,457,1006,31,264,ME - Portland
26,1976-1977,1976-11-10,1977-04-08,150,0,115,507,622,128,717,845,1467,33,277,ME - Portland
27,1977-1978,1977-11-27,1978-04-01,126,0,87,441,528,102,506,608,1136,29,241,ME - Portland
28,1978-1979,1978-11-21,1979-04-10,141,0,113,417,530,128,516,644,1174,31,252,ME - Portland
29,1979-1980,1979-10-10,1980-03-18,161,0,67,405,472,41,122,163,635,13,85,ME - Portland
30,1980-1981,1980-11-17,1981-03-21,125,0,96,437,533,61,244,305,838,25,170,ME - Portland
31,1981-1982,1981-12-01,1982-04-15,136,0,89,425,514,122,770,892,1406,42,284,ME - Portland
32,1982-1983,1982-11-26,1983-03-28,123,0,51,287,338,69,224,293,631,23,137,ME - Portland
33,1983-1984,1983-12-01,1984-04-01,123,0,87,358,445,99,284,383,828,25,209,ME - Portland
34,1984-1985,1984-12-01,1985-04-05,126,0,74,369,443,76,290,366,809,33,235,ME - Portland
35,1985-1986,1985-11-16,1986-03-21,126,0,66,375,441,75,361,436,877,32,193,ME - Portland
36,1986-1987,1986-11-05,1987-04-29,176,0,52,411,463,107,752,859,1322,32,195,ME - Portland
37,1987-1988,1987-11-06,1988-04-16,163,0,57,386,443,87,260,347,790,26,162,ME - Portland
38,1988-1989,1988-12-01,1989-04-10,131,0,68,363,431,50,74,124,555,28,134,ME - Portland
39,1989-1990,1989-11-20,1990-03-31,132,0,88,427,515,97,352,449,964,26,205,ME - Portland
40,1990-1991,1990-11-12,1991-03-26,135,0,42,276,318,48,90,138,456,20,104,ME - Portland
41,1991-1992,1991-12-01,1992-04-18,140,0,65,376,441,86,178,264,705,33,212,ME - Portland
42,1992-1993,1992-11-17,1993-04-27,162,0,85,433,518,162,441,603,1121,38,314,ME - Portland
43,1993-1994,1993-10-30,1994-03-27,149,0,124,442,566,114,487,601,1167,38,308,ME - Portland
44,1994-1995,1994-11-23,1995-04-05,134,0,64,325,389,53,213,266,655,19,133,ME - Portland
45,1995-1996,1995-11-25,1996-04-14,142,0,96,421,517,174,491,665,1182,44,354,ME - Portland
47,1997-1998,1997-11-14,1998-03-25,132,5,35,283,318,79,188,267,585,19,126,ME - Portland
48,1998-1999,1998-12-01,1999-03-20,110,0,46,296,342,70,173,243,585,22,159,ME - Portland
50,2000-2001,2000-11-24,2001-04-08,136,6,73,409,482,135,655,790,1272,33,239,ME - Portland
51,2001-2002,2001-12-01,2002-04-25,146,0,10,235,245,46,95,141,386,19,86,ME - Portland
52,2002-2003,2002-11-16,2003-04-06,142,0,106,454,560,97,423,520,1080,31,213,ME - Portland
53,2003-2004,2003-12-01,2004-04-05,127,0,88,370,458,69,128,197,655,19,124,ME - Portland
54,2004-2005,2004-12-01,2005-03-29,119,0,81,370,451,143,543,686,1137,31,298,ME - Portland
55,2005-2006,2005-11-23,2006-04-05,134,0,47,291,338,70,148,218,556,25,145,ME - Portland
56,2006-2007,2006-12-01,2007-04-15,136,0,80,344,424,81,226,307,731,22,144,ME - Portland
57,2007-2008,2007-11-24,2008-03-30,128,4,48,332,380,145,508,653,1033,34,245,ME - Portland
58,2008-2009,2008-11-20,2009-03-23,124,0,79,408,487,110,423,533,1020,28,223,ME - Portland
59,2009-2010,2009-12-01,2010-03-26,116,0,39,239,278,52,153,205,483,19,96,ME - Portland
60,2010-2011,2010-11-26,2011-04-04,130,0,59,364,423,113,564,677,1100,29,208,ME - Portland
61,2011-2012,2011-10-29,2012-03-28,152,0,30,250,280,66,131,197,477,24,127,ME - Portland
62,2012-2013,2012-11-07,2013-04-12,157,0,48,298,346,138,374,512,858,29,215,ME - Portland
63,2013-2014,2013-11-24,2014-04-16,144,0,103,446,549,122,501,623,1172,33,266,ME - Portland
64,2014-2015,2014-11-02,2015-04-10,160,0,89,446,535,134,656,790,1325,45,303,ME - Portland
65,2015-2016,2015-11-30,2016-04-27,150,0,36,253,289,76,191,267,556,24,148,ME - Portland
66,2016-2017,2016-11-20,2017-04-06,138,0,51,302,353,137,317,454,807,31,230,ME - Portland
67,2017-2018,2017-11-13,2018-04-15,154,0,81,367,448,133,412,545,993,37,254,ME - Portland
68,2018-2019,2018-11-15,2019-04-12,149,0,63,367,430,96,320,416,846,35,178,ME - Portland
69,2019-2020,2019-11-12,2020-04-10,151,0,28,257,285,86,305,391,676,26,140,ME - Portland
0,1950-1951,1950-11-25,1951-02-28,96,0,20,138,158,10,7,17,175,6,26,MD - Baltimore
1,1951-1952,1951-12-01,1952-03-03,94,0,6,104,110,21,15,36,146,5,29,MD - Baltimore
2,1952-1953,1952-11-29,1953-03-09,101,0,0,84,84,17,11,28,112,7,27,MD - Baltimore
3,1953-1954,1953-11-06,1954-03-11,126,0,14,144,158,29,39,68,226,8,49,MD - Baltimore
4,1954-1955,1954-12-01,1955-03-18,108,0,16,159,175,18,8,26,201,11,33,MD - Baltimore
5,1955-1956,1955-11-19,1956-03-28,131,0,15,177,192,27,35,62,254,12,46,MD - Baltimore
6,1956-1957,1956-12-01,1957-04-13,134,3,12,117,129,27,19,46,175,17,57,MD - Baltimore
7,1957-1958,1957-12-01,1958-03-23,113,0,24,158,182,58,95,153,335,15,79,MD - Baltimore
8,1958-1959,1958-11-30,1959-04-12,134,0,23,217,240,7,3,10,250,6,20,MD - Baltimore
9,1959-1960,1959-11-18,1960-03-22,126,0,14,159,173,51,66,117,290,15,87,MD - Baltimore
10,1960-1961,1960-11-07,1961-02-28,114,0,38,229,267,67,176,243,510,16,120,MD - Baltimore
11,1961-1962,1961-11-19,1962-03-09,111,0,19,191,210,53,31,84,294,21,100,MD - Baltimore
12,1962-1963,1962-11-05,1963-03-11,127,0,38,249,287,29,61,90,377,14,64,MD - Baltimore
13,1963-1964,1963-12-01,1964-04-01,123,0,22,198,220,73,67,140,360,18,109,MD - Baltimore
14,1964-1965,1964-12-01,1965-03-21,111,0,19,187,206,27,36,63,269,8,57,MD - Baltimore
15,1965-1966,1965-12-01,1966-02-28,90,0,24,168,192,49,87,136,328,11,89,MD - Baltimore
16,1966-1967,1966-12-01,1967-03-21,111,0,18,169,187,65,79,144,331,17,109,MD - Baltimore
17,1967-1968,1967-11-30,1968-03-23,115,0,24,187,211,34,29,63,274,12,53,MD - Baltimore
18,1968-1969,1968-11-10,1969-03-07,118,0,10,139,149,25,9,34,183,10,34,MD - Baltimore
19,1969-1970,1969-12-01,1970-03-18,108,0,26,170,196,31,40,71,267,14,64,MD - Baltimore
20,1970-1971,1970-12-01,1971-03-04,94,0,23,127,150,18,16,34,184,9,32,MD - Baltimore
21,1971-1972,1971-11-24,1972-04-08,137,0,7,124,131,23,14,37,168,12,37,MD - Baltimore
22,1972-1973,1972-12-01,1973-02-28,90,0,9,121,130,2,1,3,133,1,2,MD - Baltimore
23,1973-1974,1973-12-01,1974-02-28,90,0,11,105,116,26,27,53,169,7,40,MD - Baltimore
24,1974-1975,1974-12-01,1975-03-10,100,0,3,92,95,17,8,25,120,7,26,MD - Baltimore
25,1975-1976,1975-12-01,1976-03-11,102,0,14,127,141,18,8,26,167,8,32,MD - Baltimore
26,1976-1977,1976-11-12,1977-02-28,109,0,37,236,273,17,27,44,317,12,48,MD - Baltimore
27,1977-1978,1977-11-27,1978-03-16,110,0,26,202,228,50,75,125,353,20,92,MD - Baltimore
28,1978-1979,1978-11-26,1979-02-28,95,0,33,168,201,62,98,160,361,16,120,MD - Baltimore
29,1979-1980,1979-10-10,1980-03-14,157,0,18,154,172,23,24,47,219,13,59,MD - Baltimore
30,1980-1981,1980-12-01,1981-03-05,95,0,30,190,220,10,4,14,234,8,29,MD - Baltimore
31,1981-1982,1981-12-01,1982-03-07,97,0,28,174,202,35,92,127,329,16,80,MD - Baltimore
32,1982-1983,1982-12-01,1983-02-28,90,0,8,112,120,44,76,120,240,6,57,MD - Baltimore
33,1983-1984,1983-12-01,1984-03-13,104,0,30,176,206,21,41,62,268,8,43,MD - Baltimore
34,1984-1985,1984-12-01,1985-04-09,130,0,15,139,154,17,14,31,185,12,44,MD - Baltimore
35,1985-1986,1985-12-01,1986-03-08,98,0,19,175,194,25,25,50,244,14,64,MD - Baltimore
36,1986-1987,1986-12-01,1987-02-28,90,0,12,123,135,52,88,140,275,9,75,MD - Baltimore
37,1987-1988,1987-11-11,1988-02-29,111,0,20,159,179,30,49,79,258,10,54,MD - Baltimore
38,1988-1989,1988-12-01,1989-03-08,98,0,15,120,135,14,7,21,156,10,34,MD - Baltimore
39,1989-1990,1989-11-22,1990-04-06,136,0,22,173,195,27,63,90,285,13,53,MD - Baltimore
40,1990-1991,1990-12-01,1991-03-13,103,0,5,103,108,14,8,22,130,5,20,MD - Baltimore
41,1991-1992,1991-12-01,1992-02-29,91,0,10,122,132,7,4,11,143,4,18,MD - Baltimore
42,1992-1993,1992-12-01,1993-03-19,109,0,12,144,156,35,33,68,224,12,57,MD - Baltimore
43,1993-1994,1993-12-01,1994-03-18,108,0,33,188,221,28,39,67,288,14,69,MD - Baltimore
44,1994-1995,1994-11-23,1995-03-08,106,0,8,102,110,14,22,36,146,5,18,MD - Baltimore
45,1995-1996,1995-11-11,1996-03-09,120,0,26,172,198,89,137,226,424,18,134,MD - Baltimore
46,1996-1997,1996-11-14,1997-03-31,138,0,10,156,166,22,11,33,199,10,35,MD - Baltimore
47,1997-1998,1997-12-01,1998-03-21,111,0,0,91,91,6,0,6,97,5,11,MD - Baltimore
48,1998-1999,1998-12-01,1999-03-15,105,0,14,137,151,21,28,49,200,6,35,MD - Baltimore
49,1999-2000,1999-12-01,2000-04-09,131,0,19,149,168,34,73,107,275,7,51,MD - Baltimore
50,2000-2001,2000-12-01,2001-02-28,90,0,10,146,156,11,15,26,182,5,24,MD - Baltimore
51,2001-2002,2001-12-01,2002-02-28,90,0,1,90,91,3,3,6,97,1,4,MD - Baltimore
52,2002-2003,2002-12-01,2003-03-30,120,0,20,198,218,76,129,205,423,19,122,MD - Baltimore
53,2003-2004,2003-12-01,2004-03-16,107,2,22,166,188,26,64,90,278,12,58,MD - Baltimore
54,2004-2005,2004-12-01,2005-03-03,93,0,17,130,147,27,31,58,205,11,51,MD - Baltimore
55,2005-2006,2005-11-23,2006-02-28,98,0,3,115,118,27,24,51,169,8,38,MD - Baltimore
56,2006-2007,2006-12-01,2007-04-07,128,0,15,156,171,16,13,29,200,8,34,MD - Baltimore
57,2007-2008,2007-12-01,2008-02-29,91,0,7,108,115,12,10,22,137,5,23,MD - Baltimore
58,2008-2009,2008-12-01,2009-03-05,95,0,17,158,175,15,14,29,204,8,33,MD - Baltimore
59,2009-2010,2009-12-01,2010-02-28,90,0,15,145,160,113,200,313,473,17,151,MD - Baltimore
60,2010-2011,2010-12-01,2011-02-28,90,0,11,147,158,21,38,59,217,8,39,MD - Baltimore
61,2011-2012,2011-12-01,2012-02-29,91,0,5,80,85,3,4,7,92,3,8,MD - Baltimore
62,2012-2013,2012-12-01,2013-03-26,116,0,8,99,107,13,8,21,128,7,32,MD - Baltimore
63,2013-2014,2013-11-24,2014-03-25,122,0,34,224,258,53,64,117,375,18,110,MD - Baltimore
64,2014-2015,2014-11-26,2015-03-20,115,0,28,200,228,42,38,80,308,14,85,MD - Baltimore
65,2015-2016,2015-12-01,2016-03-04,95,0,13,122,135,49,74,123,258,8,69,MD - Baltimore
66,2016-2017,2016-12-01,2017-03-19,109,0,6,101,107,7,7,14,121,6,18,MD - Baltimore
67,2017-2018,2017-12-01,2018-03-22,112,0,24,168,192,22,15,37,229,11,47,MD - Baltimore
68,2018-2019,2018-11-15,2019-03-08,114,0,9,130,139,27,23,50,189,12,48,MD - Baltimore
69,2019-2020,2019-12-01,2020-02-29,91,0,0,68,68,4,1,5,73,3,6,MD - Baltimore
1,1951-1952,1951-12-01,1952-02-29,91,11,8,144,152,0,0,0,152,0,0,MD - Beltsville
2,1952-1953,1952-11-30,1953-03-08,99,1,3,131,134,12,4,16,150,5,22,MD - Beltsville
4,1954-1955,1954-12-01,1955-02-28,90,15,15,210,225,15,1,16,241,5,36,MD - Beltsville
5,1955-1956,1955-11-19,1956-03-20,123,2,9,251,260,24,28,52,312,7,37,MD - Beltsville
6,1956-1957,1956-12-01,1957-02-28,90,0,13,145,158,18,31,49,207,8,37,MD - Beltsville
8,1958-1959,1958-12-01,1959-02-28,90,1,24,239,263,6,7,13,276,3,19,MD - Beltsville
11,1961-1962,1961-11-20,1962-03-10,111,3,20,227,247,35,36,71,318,10,60,MD - Beltsville
12,1962-1963,1962-12-01,1963-03-12,102,3,36,283,319,25,79,104,423,7,46,MD - Beltsville
13,1963-1964,1963-12-01,1964-04-01,123,14,20,245,265,38,63,101,366,8,62,MD - Beltsville
14,1964-1965,1964-12-01,1965-03-21,111,2,24,227,251,27,30,57,308,7,63,MD - Beltsville
15,1965-1966,1965-12-01,1966-02-28,90,6,20,179,199,43,95,138,337,5,61,MD - Beltsville
16,1966-1967,1966-12-01,1967-03-22,112,6,16,207,223,48,57,105,328,11,86,MD - Beltsville
17,1967-1968,1967-12-01,1968-03-12,103,16,28,202,230,34,30,64,294,9,53,MD - Beltsville
19,1969-1970,1969-11-23,1970-02-28,98,4,27,226,253,17,42,59,312,5,37,MD - Beltsville
20,1970-1971,1970-12-01,1971-03-05,95,1,27,171,198,20,24,44,242,4,30,MD - Beltsville
22,1972-1973,1972-12-01,1973-02-28,90,0,11,142,153,0,0,0,153,0,0,MD - Beltsville
24,1974-1975,1974-12-01,1975-02-28,90,5,5,121,126,10,7,17,143,3,16,MD - Beltsville
28,1978-1979,1978-12-01,1979-02-28,90,18,27,218,245,29,79,108,353,7,62,MD - Beltsville
31,1981-1982,1981-12-01,1982-02-28,90,17,27,196,223,24,100,124,347,10,60,MD - Beltsville
34,1984-1985,1984-12-01,1985-02-28,90,12,20,153,173,12,22,34,207,5,27,MD - Beltsville
35,1985-1986,1985-12-01,1986-03-01,91,17,19,160,179,25,31,56,235,8,47,MD - Beltsville
38,1988-1989,1988-12-01,1989-03-07,97,14,11,123,134,5,3,8,142,4,11,MD - Beltsville
39,1989-1990,1989-11-23,1990-02-28,98,19,21,174,195,18,91,109,304,5,29,MD - Beltsville
40,1990-1991,1990-12-01,1991-02-28,90,3,3,122,125,9,6,15,140,3,15,MD - Beltsville
41,1991-1992,1991-12-01,1992-03-12,103,2,7,133,140,9,9,18,158,3,16,MD - Beltsville
42,1992-1993,1992-12-01,1993-03-20,110,19,9,144,153,23,31,54,207,5,34,MD - Beltsville
45,1995-1996,1995-11-12,1996-03-10,120,12,25,196,221,78,144,222,443,16,123,MD - Beltsville
46,1996-1997,1996-11-14,1997-03-19,126,3,11,130,141,19,20,39,180,9,31,MD - Beltsville
47,1997-1998,1997-12-01,1998-03-12,102,1,1,73,74,3,2,5,79,3,5,MD - Beltsville
48,1998-1999,1998-12-01,1999-03-15,105,2,10,135,145,25,21,46,191,8,43,MD - Beltsville
49,1999-2000,1999-12-01,2000-04-09,131,1,16,143,159,33,99,132,291,11,58,MD - Beltsville
50,2000-2001,2000-12-01,2001-02-28,90,2,12,159,171,16,17,33,204,4,28,MD - Beltsville
51,2001-2002,2001-12-01,2002-03-05,95,0,4,103,107,5,3,8,115,2,9,MD - Beltsville
52,2002-2003,2002-12-01,2003-03-05,95,0,24,190,214,65,176,241,455,14,107,MD - Beltsville
53,2003-2004,2003-12-01,2004-02-29,91,1,25,156,181,21,58,79,260,6,36,MD - Beltsville
54,2004-2005,2004-12-01,2005-03-03,93,0,23,136,159,21,32,53,212,5,39,MD - Beltsville
55,2005-2006,2005-11-24,2006-02-28,97,0,3,121,124,21,29,50,174,4,27,MD - Beltsville
56,2006-2007,2006-12-01,2007-04-07,128,0,16,157,173,23,42,65,238,7,42,MD - Beltsville
57,2007-2008,2007-12-01,2008-02-29,91,3,7,103,110,8,14,22,132,3,17,MD - Beltsville
58,2008-2009,2008-12-01,2009-03-05,95,0,15,160,175,15,15,30,205,5,25,MD - Beltsville
59,2009-2010,2009-12-01,2010-02-28,90,2,14,146,160,89,209,298,458,12,122,MD - Beltsville
60,2010-2011,2010-12-01,2011-02-28,90,0,12,148,160,19,28,47,207,9,39,MD - Beltsville
61,2011-2012,2011-12-01,2012-02-29,91,0,5,85,90,4,4,8,98,3,7,MD - Beltsville
62,2012-2013,2012-12-01,2013-03-25,115,0,8,109,117,12,7,19,136,7,29,MD - Beltsville
63,2013-2014,2013-11-25,2014-03-31,127,0,34,218,252,54,75,129,381,15,94,MD - Beltsville
64,2014-2015,2014-11-19,2015-03-21,123,0,29,221,250,46,89,135,385,17,88,MD - Beltsville
65,2015-2016,2015-12-01,2016-03-04,95,0,14,125,139,35,68,103,242,7,57,MD - Beltsville
66,2016-2017,2016-12-01,2017-03-17,107,0,9,100,109,9,11,20,129,7,24,MD - Beltsville
67,2017-2018,2017-12-01,2018-03-23,113,0,25,162,187,18,10,28,215,9,37,MD - Beltsville
68,2018-2019,2018-11-15,2019-03-09,115,0,10,131,141,30,37,67,208,12,53,MD - Beltsville
69,2019-2020,2019-12-01,2020-02-29,91,0,1,82,83,3,1,4,87,1,4,MD - Beltsville
6,1956-1957,1956-12-01,1957-03-07,97,1,7,140,147,34,31,65,212,13,65,MD - Emmitsburg
8,1958-1959,1958-12-01,1959-04-12,133,4,19,263,282,28,18,46,328,11,50,MD - Emmitsburg
9,1959-1960,1959-12-01,1960-03-22,113,6,8,192,200,52,67,119,319,12,80,MD - Emmitsburg
10,1960-1961,1960-12-01,1961-04-13,134,2,45,323,368,103,355,458,826,20,182,MD - Emmitsburg
11,1961-1962,1961-11-20,1962-03-12,113,7,13,229,242,68,119,187,429,21,115,MD - Emmitsburg
12,1962-1963,1962-12-01,1963-03-11,101,5,35,307,342,51,142,193,535,13,88,MD - Emmitsburg
13,1963-1964,1963-12-01,1964-04-01,123,2,19,255,274,94,182,276,550,18,133,MD - Emmitsburg
14,1964-1965,1964-12-01,1965-03-25,115,3,20,221,241,45,81,126,367,11,72,MD - Emmitsburg
15,1965-1966,1965-12-01,1966-04-13,134,0,19,242,261,65,127,192,453,11,108,MD - Emmitsburg
16,1966-1967,1966-11-30,1967-03-21,112,0,17,220,237,70,135,205,442,15,116,MD - Emmitsburg
18,1968-1969,1968-11-10,1969-03-07,118,4,13,225,238,41,37,78,316,9,51,MD - Emmitsburg
19,1969-1970,1969-12-01,1970-03-29,119,1,31,293,324,68,242,310,634,18,127,MD - Emmitsburg
20,1970-1971,1970-12-01,1971-04-07,128,0,25,249,274,53,171,224,498,11,78,MD - Emmitsburg
21,1971-1972,1971-11-24,1972-04-08,137,0,10,219,229,55,92,147,376,13,79,MD - Emmitsburg
22,1972-1973,1972-10-19,1973-02-28,133,0,11,191,202,10,5,15,217,5,18,MD - Emmitsburg
23,1973-1974,1973-12-01,1974-02-28,90,0,15,141,156,26,64,90,246,7,39,MD - Emmitsburg
24,1974-1975,1974-12-01,1975-03-15,105,0,3,153,156,40,62,102,258,13,63,MD - Emmitsburg
25,1975-1976,1975-12-01,1976-03-12,103,0,20,178,198,30,34,64,262,11,52,MD - Emmitsburg
26,1976-1977,1976-11-12,1977-02-28,109,0,42,306,348,37,122,159,507,13,77,MD - Emmitsburg
27,1977-1978,1977-11-28,1978-03-16,109,0,45,331,376,81,285,366,742,19,128,MD - Emmitsburg
28,1978-1979,1978-11-27,1979-02-28,94,0,32,232,264,74,114,188,452,14,129,MD - Emmitsburg
29,1979-1980,1979-12-01,1980-03-15,106,1,16,228,244,37,31,68,312,14,84,MD - Emmitsburg
30,1980-1981,1980-12-01,1981-03-07,97,0,27,228,255,26,29,55,310,10,53,MD - Emmitsburg
31,1981-1982,1981-11-24,1982-04-09,137,10,27,312,339,66,160,226,565,21,121,MD - Emmitsburg
32,1982-1983,1982-12-01,1983-04-20,141,2,6,166,172,55,71,126,298,10,76,MD - Emmitsburg
34,1984-1985,1984-11-19,1985-04-09,142,2,21,235,256,39,60,99,355,13,73,MD - Emmitsburg
35,1985-1986,1985-12-01,1986-03-08,98,7,23,213,236,41,52,93,329,14,81,MD - Emmitsburg
36,1986-1987,1986-12-01,1987-04-06,127,5,14,214,228,77,127,204,432,15,109,MD - Emmitsburg
37,1987-1988,1987-11-11,1988-02-29,111,0,24,205,229,23,51,74,303,6,37,MD - Emmitsburg
38,1988-1989,1988-12-01,1989-03-13,103,4,16,165,181,27,51,78,259,8,51,MD - Emmitsburg
39,1989-1990,1989-11-23,1990-04-07,136,1,27,217,244,37,42,79,323,15,68,MD - Emmitsburg
40,1990-1991,1990-12-01,1991-03-30,120,3,6,153,159,37,43,80,239,7,50,MD - Emmitsburg
41,1991-1992,1991-12-01,1992-03-22,113,4,5,164,169,20,15,35,204,7,36,MD - Emmitsburg
43,1993-1994,1993-12-01,1994-03-18,108,12,62,294,356,73,233,306,662,20,137,MD - Emmitsburg
44,1994-1995,1994-11-24,1995-03-10,107,1,15,162,177,19,45,64,241,5,30,MD - Emmitsburg
45,1995-1996,1995-11-12,1996-03-09,119,10,43,246,289,123,222,345,634,20,172,MD - Emmitsburg
46,1996-1997,1996-11-14,1997-03-19,126,16,12,173,185,39,39,78,263,10,49,MD - Emmitsburg
47,1997-1998,1997-12-01,1998-03-22,112,7,2,107,109,20,7,27,136,8,28,MD - Emmitsburg
48,1998-1999,1998-12-01,1999-03-16,106,8,14,171,185,44,38,82,267,13,77,MD - Emmitsburg
49,1999-2000,1999-12-01,2000-04-09,131,15,16,161,177,51,129,180,357,9,83,MD - Emmitsburg
50,2000-2001,2000-12-01,2001-03-05,95,10,17,203,220,41,79,120,340,8,68,MD - Emmitsburg
51,2001-2002,2001-12-01,2002-03-11,101,9,1,143,144,17,12,29,173,5,29,MD - Emmitsburg
52,2002-2003,2002-11-27,2003-04-07,132,10,28,254,282,81,199,280,562,15,120,MD - Emmitsburg
53,2003-2004,2003-12-01,2004-03-17,108,14,28,224,252,57,147,204,456,11,97,MD - Emmitsburg
58,2008-2009,2008-12-01,2009-03-04,94,8,27,186,213,11,1,12,225,4,24,MD - Emmitsburg
61,2011-2012,2011-10-30,2012-02-29,123,3,8,129,137,11,0,11,148,4,18,MD - Emmitsburg
62,2012-2013,2012-12-01,2013-03-26,116,0,14,149,163,33,0,33,196,11,56,MD - Emmitsburg
63,2013-2014,2013-11-25,2014-03-26,122,9,43,296,339,82,59,141,480,18,137,MD - Emmitsburg
64,2014-2015,2014-11-20,2015-03-21,122,6,36,290,326,62,56,118,444,16,123,MD - Emmitsburg
65,2015-2016,2015-12-01,2016-03-06,97,16,13,159,172,44,64,108,280,4,52,MD - Emmitsburg
66,2016-2017,2016-12-01,2017-03-19,109,1,9,142,151,22,20,42,193,9,40,MD - Emmitsburg
67,2017-2018,2017-12-01,2018-03-22,112,5,32,199,231,33,9,42,273,11,67,MD - Emmitsburg
68,2018-2019,2018-11-16,2019-03-09,114,0,16,185,201,47,28,75,276,14,81,MD - Emmitsburg
69,2019-2020,2019-12-01,2020-02-29,91,3,2,112,114,6,0,6,120,3,11,MD - Emmitsburg
0,1950-1951,1950-12-01,1951-02-28,90,0,7,100,107,5,5,10,117,2,7,MD - Royal Oak
1,1951-1952,1951-12-01,1952-03-03,94,3,4,83,87,6,0,6,93,3,9,MD - Royal Oak
2,1952-1953,1952-11-30,1953-03-08,99,0,0,56,56,14,1,15,71,7,23,MD - Royal Oak
3,1953-1954,1953-11-06,1954-02-28,115,0,5,76,81,29,31,60,141,8,44,MD - Royal Oak
4,1954-1955,1954-12-01,1955-02-28,90,0,9,112,121,12,6,18,139,7,25,MD - Royal Oak
5,1955-1956,1955-11-19,1956-03-19,122,0,3,120,123,7,1,8,131,5,13,MD - Royal Oak
6,1956-1957,1956-12-01,1957-04-13,134,0,4,86,90,20,14,34,124,7,31,MD - Royal Oak
7,1957-1958,1957-12-01,1958-03-20,110,0,10,127,137,34,53,87,224,10,47,MD - Royal Oak
8,1958-1959,1958-12-01,1959-02-28,90,0,12,151,163,9,15,24,187,4,19,MD - Royal Oak
9,1959-1960,1959-12-01,1960-03-17,108,0,6,110,116,38,66,104,220,10,56,MD - Royal Oak
10,1960-1961,1960-12-01,1961-02-28,90,1,21,161,182,34,93,127,309,9,65,MD - Royal Oak
11,1961-1962,1961-11-20,1962-03-07,108,0,8,126,134,25,16,41,175,12,47,MD - Royal Oak
12,1962-1963,1962-12-01,1963-03-11,101,0,18,169,187,17,23,40,227,10,36,MD - Royal Oak
13,1963-1964,1963-12-01,1964-04-01,123,0,13,136,149,40,49,89,238,12,64,MD - Royal Oak
14,1964-1965,1964-11-30,1965-03-20,111,0,11,127,138,23,21,44,182,9,46,MD - Royal Oak
15,1965-1966,1965-12-01,1966-02-28,90,0,11,117,128,46,103,149,277,7,72,MD - Royal Oak
16,1966-1967,1966-12-01,1967-03-21,111,0,7,127,134,55,75,130,264,9,74,MD - Royal Oak
17,1967-1968,1967-11-30,1968-03-13,105,0,14,158,172,35,26,61,233,9,53,MD - Royal Oak
18,1968-1969,1968-12-01,1969-03-09,99,0,7,122,129,24,8,32,161,6,30,MD - Royal Oak
19,1969-1970,1969-12-01,1970-02-28,90,1,13,142,155,18,36,54,209,7,34,MD - Royal Oak
20,1970-1971,1970-12-01,1971-03-26,116,0,14,128,142,19,15,34,176,10,36,MD - Royal Oak
21,1971-1972,1971-12-01,1972-04-08,130,0,5,105,110,21,12,33,143,6,27,MD - Royal Oak
22,1972-1973,1972-12-01,1973-02-28,90,0,8,88,96,2,0,2,98,2,11,MD - Royal Oak
23,1973-1974,1973-12-01,1974-03-12,102,0,4,73,77,19,20,39,116,9,35,MD - Royal Oak
24,1974-1975,1974-12-01,1975-03-10,100,0,0,69,69,11,5,16,85,5,17,MD - Royal Oak
25,1975-1976,1975-12-01,1976-03-10,101,0,10,100,110,6,3,9,119,4,14,MD - Royal Oak
26,1976-1977,1976-11-12,1977-02-28,109,0,23,194,217,23,54,77,294,9,39,MD - Royal Oak
27,1977-1978,1977-12-01,1978-03-10,100,0,21,177,198,42,90,132,330,12,65,MD - Royal Oak
28,1978-1979,1978-11-27,1979-02-28,94,0,26,150,176,54,103,157,333,12,100,MD - Royal Oak
29,1979-1980,1979-12-01,1980-03-03,94,0,12,106,118,25,22,47,165,10,58,MD - Royal Oak
30,1980-1981,1980-12-01,1981-03-21,111,0,17,162,179,8,4,12,191,5,15,MD - Royal Oak
31,1981-1982,1981-12-01,1982-02-28,90,3,17,132,149,30,75,105,254,12,61,MD - Royal Oak
32,1982-1983,1982-12-01,1983-02-28,90,1,4,70,74,26,33,59,133,5,37,MD - Royal Oak
33,1983-1984,1983-12-01,1984-03-10,101,0,21,131,152,10,25,35,187,4,21,MD - Royal Oak
34,1984-1985,1984-12-01,1985-04-09,130,0,8,115,123,23,35,58,181,7,38,MD - Royal Oak
35,1985-1986,1985-12-01,1986-03-08,98,2,14,116,130,25,13,38,168,14,62,MD - Royal Oak
36,1986-1987,1986-12-01,1987-03-10,100,0,5,95,100,40,78,118,218,7,55,MD - Royal Oak
37,1987-1988,1987-11-11,1988-03-21,132,0,11,124,135,18,40,58,193,6,28,MD - Royal Oak
38,1988-1989,1988-12-01,1989-03-08,98,0,6,85,91,19,6,25,116,7,30,MD - Royal Oak
39,1989-1990,1989-11-23,1990-02-28,98,0,14,118,132,31,75,106,238,10,50,MD - Royal Oak
40,1990-1991,1990-12-01,1991-02-28,90,2,2,64,66,8,5,13,79,3,11,MD - Royal Oak
41,1991-1992,1991-12-01,1992-02-29,91,0,1,73,74,5,1,6,80,2,8,MD - Royal Oak
42,1992-1993,1992-12-01,1993-03-15,105,1,6,77,83,13,7,20,103,4,19,MD - Royal Oak
43,1993-1994,1993-12-01,1994-03-02,92,2,25,133,158,20,35,55,213,9,50,MD - Royal Oak
44,1994-1995,1994-12-01,1995-02-28,90,2,4,76,80,8,1,9,89,3,13,MD - Royal Oak
45,1995-1996,1995-12-01,1996-03-09,100,3,17,130,147,62,116,178,325,10,85,MD - Royal Oak
46,1996-1997,1996-12-01,1997-04-01,122,1,6,69,75,16,8,24,99,7,21,MD - Royal Oak
47,1997-1998,1997-12-01,1998-03-22,112,0,0,50,50,1,0,1,51,1,1,MD - Royal Oak
48,1998-1999,1998-12-01,1999-03-10,100,4,5,80,85,14,8,22,107,6,25,MD - Royal Oak
49,1999-2000,1999-12-01,2000-02-29,91,0,10,99,109,29,80,109,218,6,41,MD - Royal Oak
50,2000-2001,2000-12-01,2001-03-26,116,3,4,126,130,16,5,21,151,8,29,MD - Royal Oak
51,2001-2002,2001-12-01,2002-02-28,90,5,0,55,55,7,2,9,64,3,11,MD - Royal Oak
52,2002-2003,2002-12-01,2003-03-02,92,1,9,119,128,70,125,195,323,15,99,MD - Royal Oak
53,2003-2004,2003-12-01,2004-02-29,91,3,10,110,120,12,19,31,151,5,20,MD - Royal Oak
54,2004-2005,2004-12-01,2005-03-08,98,0,8,103,111,29,45,74,185,8,49,MD - Royal Oak
55,2005-2006,2005-12-01,2006-02-28,90,1,1,63,64,16,19,35,99,3,19,MD - Royal Oak
56,2006-2007,2006-12-01,2007-04-07,128,2,4,102,106,6,2,8,114,3,9,MD - Royal Oak
57,2007-2008,2007-12-01,2008-02-29,91,2,1,68,69,10,3,13,82,6,18,MD - Royal Oak
58,2008-2009,2008-12-01,2009-03-05,95,1,11,111,122,20,23,43,165,5,28,MD - Royal Oak
59,2009-2010,2009-12-01,2010-02-28,90,0,6,101,107,78,204,282,389,8,91,MD - Royal Oak
62,2012-2013,2012-12-01,2013-03-25,115,0,4,82,86,9,2,11,97,5,19,MD - Royal Oak
63,2013-2014,2013-12-01,2014-03-26,116,0,14,171,185,47,47,94,279,17,86,MD - Royal Oak
64,2014-2015,2014-12-01,2015-03-20,110,0,18,166,184,31,55,86,270,9,51,MD - Royal Oak
65,2015-2016,2015-12-01,2016-03-04,95,0,10,78,88,37,37,74,162,9,54,MD - Royal Oak
66,2016-2017,2016-12-01,2017-02-28,90,0,5,47,52,12,14,26,78,2,16,MD - Royal Oak
67,2017-2018,2017-12-01,2018-03-22,112,0,19,126,145,23,22,45,190,8,38,MD - Royal Oak
68,2018-2019,2018-12-01,2019-03-01,91,0,6,76,82,15,12,27,109,7,28,MD - Royal Oak
69,2019-2020,2019-12-01,2020-02-29,91,0,0,51,51,1,0,1,52,1,1,MD - Royal Oak
1,1951-1952,1951-11-03,1952-03-19,138,2,34,299,333,87,316,403,736,27,156,MA - Amherst
4,1954-1955,1954-12-01,1955-03-28,118,5,50,252,302,23,32,55,357,11,56,MA - Amherst
5,1955-1956,1955-11-11,1956-04-23,165,3,62,344,406,111,254,365,771,28,195,MA - Amherst
6,1956-1957,1956-11-18,1957-04-09,143,5,49,326,375,79,176,255,630,28,173,MA - Amherst
7,1957-1958,1957-12-01,1958-03-22,112,3,57,270,327,65,291,356,683,19,144,MA - Amherst
9,1959-1960,1959-11-18,1960-03-25,129,9,43,265,308,41,182,223,531,23,114,MA - Amherst
10,1960-1961,1960-12-01,1961-03-25,115,0,92,511,603,90,665,755,1358,18,177,MA - Amherst
14,1964-1965,1964-12-01,1965-04-18,139,7,73,422,495,62,138,200,695,30,200,MA - Amherst
15,1965-1966,1965-12-01,1966-03-29,119,12,40,325,365,62,165,227,592,16,95,MA - Amherst
16,1966-1967,1966-12-01,1967-04-24,145,0,38,401,439,93,403,496,935,27,182,MA - Amherst
17,1967-1968,1967-11-22,1968-03-16,116,0,59,410,469,49,342,391,860,15,113,MA - Amherst
18,1968-1969,1968-11-10,1969-03-22,133,0,45,385,430,74,584,658,1088,21,117,MA - Amherst
19,1969-1970,1969-12-01,1970-04-02,123,0,63,452,515,81,350,431,946,32,189,MA - Amherst
20,1970-1971,1970-12-01,1971-04-07,128,0,67,456,523,101,611,712,1235,27,187,MA - Amherst
21,1971-1972,1971-11-24,1972-04-08,137,0,33,369,402,114,218,332,734,24,182,MA - Amherst
22,1972-1973,1972-11-15,1973-03-01,107,0,34,291,325,56,261,317,642,21,105,MA - Amherst
23,1973-1974,1973-12-01,1974-04-10,131,0,37,343,380,51,207,258,638,16,119,MA - Amherst
24,1974-1975,1974-12-01,1975-03-15,105,15,14,299,313,60,202,262,575,19,116,MA - Amherst
25,1975-1976,1975-12-01,1976-03-19,110,0,56,355,411,81,314,395,806,26,196,MA - Amherst
26,1976-1977,1976-11-10,1977-03-23,134,0,65,439,504,63,395,458,962,26,162,MA - Amherst
27,1977-1978,1977-11-28,1978-03-26,119,1,57,398,455,86,470,556,1011,26,182,MA - Amherst
30,1980-1981,1980-11-18,1981-02-28,103,7,48,391,439,34,128,162,601,10,63,MA - Amherst
32,1982-1983,1982-12-01,1983-03-24,114,2,25,271,296,51,162,213,509,9,82,MA - Amherst
33,1983-1984,1983-12-01,1984-03-30,121,17,68,385,453,66,270,336,789,14,110,MA - Amherst
34,1984-1985,1984-12-01,1985-03-08,98,4,34,294,328,33,117,150,478,7,60,MA - Amherst
35,1985-1986,1985-11-17,1986-03-10,114,4,33,346,379,54,273,327,706,14,81,MA - Amherst
36,1986-1987,1986-11-11,1987-03-14,124,2,15,376,391,62,414,476,867,16,106,MA - Amherst
37,1987-1988,1987-11-11,1988-03-07,118,4,30,349,379,66,241,307,686,11,90,MA - Amherst
38,1988-1989,1988-12-01,1989-04-05,126,9,29,340,369,21,30,51,420,7,45,MA - Amherst
39,1989-1990,1989-11-23,1990-03-06,104,3,49,316,365,49,169,218,583,12,86,MA - Amherst
40,1990-1991,1990-12-01,1991-03-15,105,5,18,219,237,11,71,82,319,2,17,MA - Amherst
41,1991-1992,1991-11-12,1992-04-17,158,10,38,378,416,35,57,92,508,16,88,MA - Amherst
42,1992-1993,1992-11-18,1993-04-27,161,9,45,398,443,76,260,336,779,23,138,MA - Amherst
43,1993-1994,1993-11-26,1994-03-28,123,19,101,504,605,76,455,531,1136,27,223,MA - Amherst
44,1994-1995,1994-11-28,1995-04-06,130,12,28,297,325,23,70,93,418,6,49,MA - Amherst
45,1995-1996,1995-11-13,1996-04-11,151,10,81,454,535,121,397,518,1053,37,289,MA - Amherst
46,1996-1997,1996-11-25,1997-04-03,130,9,35,274,309,68,162,230,539,24,137,MA - Amherst
47,1997-1998,1997-11-15,1998-03-22,128,3,14,259,273,27,116,143,416,11,51,MA - Amherst
48,1998-1999,1998-12-01,1999-03-16,106,8,30,278,308,41,129,170,478,12,87,MA - Amherst
49,1999-2000,1999-11-30,2000-03-18,110,3,47,329,376,41,174,215,591,15,100,MA - Amherst
50,2000-2001,2000-10-30,2001-03-27,149,15,41,433,474,108,503,611,1085,25,187,MA - Amherst
51,2001-2002,2001-12-01,2002-03-23,113,2,7,238,245,36,49,85,330,12,63,MA - Amherst
52,2002-2003,2002-10-23,2003-04-08,168,11,59,508,567,98,481,579,1146,32,204,MA - Amherst
53,2003-2004,2003-10-23,2004-03-23,153,6,68,383,451,63,198,261,712,20,132,MA - Amherst
54,2004-2005,2004-11-13,2005-03-25,133,9,48,390,438,95,226,321,759,25,197,MA - Amherst
55,2005-2006,2005-11-24,2006-03-04,101,6,25,286,311,53,174,227,538,20,128,MA - Amherst
56,2006-2007,2006-12-01,2007-04-05,126,5,54,315,369,41,142,183,552,15,89,MA - Amherst
57,2007-2008,2007-11-21,2008-03-28,129,8,38,339,377,89,280,369,746,21,158,MA - Amherst
58,2008-2009,2008-11-20,2009-03-06,107,16,61,397,458,53,292,345,803,12,115,MA - Amherst
59,2009-2010,2009-12-01,2010-02-28,90,8,48,258,306,31,69,100,406,16,72,MA - Amherst
62,2012-2013,2012-12-01,2013-03-23,113,1,39,270,309,64,173,237,546,21,129,MA - Amherst
63,2013-2014,2013-11-25,2014-04-16,143,0,86,473,559,68,291,359,918,24,185,MA - Amherst
64,2014-2015,2014-11-27,2015-04-09,134,3,85,501,586,90,399,489,1075,27,239,MA - Amherst
65,2015-2016,2015-12-01,2016-04-05,127,1,28,229,257,27,53,80,337,16,74,MA - Amherst
66,2016-2017,2016-12-01,2017-04-02,123,0,34,321,355,75,171,246,601,21,154,MA - Amherst
67,2017-2018,2017-12-01,2018-04-16,137,0,66,366,432,55,146,201,633,19,109,MA - Amherst
68,2018-2019,2018-11-16,2019-03-15,120,0,51,342,393,54,160,214,607,17,118,MA - Amherst
69,2019-2020,2019-11-14,2020-03-24,132,3,22,275,297,39,75,114,411,13,74,MA - Amherst
0,1950-1951,1950-11-22,1951-03-23,122,0,63,329,392,41,122,163,555,15,100,MA - Birch Hill Dam
1,1951-1952,1951-11-04,1952-04-05,154,1,54,410,464,105,682,787,1251,20,165,MA - Birch Hill Dam
2,1952-1953,1952-11-09,1953-04-20,163,0,36,317,353,60,207,267,620,19,106,MA - Birch Hill Dam
3,1953-1954,1953-11-07,1954-04-04,149,0,49,360,409,54,171,225,634,22,138,MA - Birch Hill Dam
4,1954-1955,1954-11-25,1955-04-04,131,0,58,356,414,54,158,212,626,22,108,MA - Birch Hill Dam
5,1955-1956,1955-11-19,1956-04-26,160,1,64,497,561,153,683,836,1397,37,246,MA - Birch Hill Dam
6,1956-1957,1956-11-18,1957-04-09,143,3,60,437,497,101,485,586,1083,30,197,MA - Birch Hill Dam
7,1957-1958,1957-11-27,1958-04-11,136,0,55,362,417,127,702,829,1246,25,188,MA - Birch Hill Dam
8,1958-1959,1958-11-28,1959-03-29,122,1,86,506,592,92,415,507,1099,22,173,MA - Birch Hill Dam
9,1959-1960,1959-11-03,1960-04-04,154,2,54,398,452,96,633,729,1181,26,170,MA - Birch Hill Dam
10,1960-1961,1960-10-25,1961-04-19,177,1,86,599,685,153,886,1039,1724,27,255,MA - Birch Hill Dam
11,1961-1962,1961-11-20,1962-04-13,145,2,72,442,514,97,647,744,1258,21,168,MA - Birch Hill Dam
12,1962-1963,1962-10-26,1963-03-30,156,0,86,552,638,116,802,918,1556,26,204,MA - Birch Hill Dam
13,1963-1964,1963-11-03,1964-04-20,170,0,73,488,561,111,552,663,1224,26,208,MA - Birch Hill Dam
14,1964-1965,1964-10-21,1965-04-19,181,0,75,500,575,72,272,344,919,25,163,MA - Birch Hill Dam
15,1965-1966,1965-12-01,1966-03-28,118,0,49,372,421,96,520,616,1037,24,167,MA - Birch Hill Dam
16,1966-1967,1966-11-06,1967-05-06,182,0,65,474,539,147,557,704,1243,33,251,MA - Birch Hill Dam
17,1967-1968,1967-11-09,1968-03-22,135,0,84,490,574,86,613,699,1273,20,160,MA - Birch Hill Dam
18,1968-1969,1968-11-10,1969-04-06,148,1,76,449,525,140,923,1063,1588,26,211,MA - Birch Hill Dam
19,1969-1970,1969-11-21,1970-04-05,136,0,97,508,605,102,743,845,1450,27,198,MA - Birch Hill Dam
20,1970-1971,1970-11-25,1971-04-09,136,1,104,610,714,133,864,997,1711,32,302,MA - Birch Hill Dam
21,1971-1972,1971-11-11,1972-04-09,151,2,78,550,628,151,402,553,1181,27,272,MA - Birch Hill Dam
22,1972-1973,1972-11-05,1973-04-05,152,0,62,438,500,78,393,471,971,21,154,MA - Birch Hill Dam
23,1973-1974,1973-12-01,1974-04-11,132,2,60,441,501,46,202,248,749,11,101,MA - Birch Hill Dam
24,1974-1975,1974-11-23,1975-04-10,139,0,50,490,540,85,433,518,1058,26,214,MA - Birch Hill Dam
25,1975-1976,1975-11-25,1976-03-20,117,2,88,484,572,104,391,495,1067,28,262,MA - Birch Hill Dam
26,1976-1977,1976-11-10,1977-05-10,182,0,122,635,757,119,692,811,1568,25,260,MA - Birch Hill Dam
27,1977-1978,1977-11-28,1978-03-27,120,0,104,557,661,105,543,648,1309,19,209,MA - Birch Hill Dam
28,1978-1979,1978-11-22,1979-04-11,141,0,115,473,588,66,403,469,1057,22,148,MA - Birch Hill Dam
29,1979-1980,1979-10-11,1980-03-23,165,0,67,446,513,30,124,154,667,8,58,MA - Birch Hill Dam
30,1980-1981,1980-11-18,1981-03-25,128,0,100,551,651,48,188,236,887,18,127,MA - Birch Hill Dam
31,1981-1982,1981-12-01,1982-04-14,135,1,110,555,665,110,898,1008,1673,26,220,MA - Birch Hill Dam
32,1982-1983,1982-11-28,1983-04-19,143,13,51,373,424,53,207,260,684,16,111,MA - Birch Hill Dam
33,1983-1984,1983-11-26,1984-04-02,129,10,84,472,556,98,350,448,1004,20,176,MA - Birch Hill Dam
34,1984-1985,1984-12-01,1985-04-09,130,6,67,430,497,61,304,365,862,18,155,MA - Birch Hill Dam
35,1985-1986,1985-11-17,1986-05-04,169,13,76,498,574,58,362,420,994,21,154,MA - Birch Hill Dam
36,1986-1987,1986-11-12,1987-04-30,170,4,51,534,585,108,681,789,1374,19,175,MA - Birch Hill Dam
37,1987-1988,1987-11-11,1988-04-16,158,15,73,525,598,90,332,422,1020,21,195,MA - Birch Hill Dam
38,1988-1989,1988-12-01,1989-03-25,115,10,66,458,524,34,63,97,621,12,89,MA - Birch Hill Dam
39,1989-1990,1989-11-20,1990-03-10,111,1,91,487,578,70,292,362,940,19,160,MA - Birch Hill Dam
54,2004-2005,2004-11-27,2005-03-30,124,2,84,543,627,111,448,559,1186,22,253,MA - Birch Hill Dam
55,2005-2006,2005-11-24,2006-03-21,118,4,67,438,505,67,214,281,786,13,132,MA - Birch Hill Dam
56,2006-2007,2006-12-01,2007-04-13,134,17,74,386,460,52,186,238,698,12,103,MA - Birch Hill Dam
57,2007-2008,2007-11-21,2008-03-31,132,7,63,457,520,123,454,577,1097,25,219,MA - Birch Hill Dam
59,2009-2010,2009-12-01,2010-03-05,95,8,51,330,381,89,312,401,782,15,122,MA - Birch Hill Dam
62,2012-2013,2012-11-08,2013-03-28,141,0,51,354,405,88,312,400,805,31,199,MA - Birch Hill Dam
63,2013-2014,2013-11-12,2014-04-16,156,0,113,553,666,90,448,538,1204,37,269,MA - Birch Hill Dam
64,2014-2015,2014-11-14,2015-04-10,148,4,114,589,703,102,525,627,1330,34,325,MA - Birch Hill Dam
65,2015-2016,2015-12-01,2016-04-06,128,0,41,273,314,34,92,126,440,13,82,MA - Birch Hill Dam
66,2016-2017,2016-11-21,2017-04-03,134,15,53,356,409,93,246,339,748,19,158,MA - Birch Hill Dam
67,2017-2018,2017-12-01,2018-04-16,137,14,89,398,487,92,299,391,878,26,172,MA - Birch Hill Dam
9,1959-1960,1959-11-19,1960-03-28,131,1,32,329,361,71,267,338,699,23,143,MA - Buffumville Lake
10,1960-1961,1960-10-25,1961-04-14,172,2,74,566,640,112,502,614,1254,22,215,MA - Buffumville Lake
11,1961-1962,1961-11-21,1962-03-25,125,6,61,397,458,93,492,585,1043,18,165,MA - Buffumville Lake
12,1962-1963,1962-11-14,1963-03-27,134,1,80,497,577,72,430,502,1079,21,156,MA - Buffumville Lake
13,1963-1964,1963-12-01,1964-03-20,111,1,56,400,456,79,317,396,852,21,171,MA - Buffumville Lake
14,1964-1965,1964-12-01,1965-04-19,140,0,68,412,480,76,219,295,775,24,181,MA - Buffumville Lake
15,1965-1966,1965-12-01,1966-03-29,119,0,47,338,385,87,369,456,841,21,153,MA - Buffumville Lake
16,1966-1967,1966-12-01,1967-04-08,129,0,67,409,476,114,375,489,965,24,231,MA - Buffumville Lake
17,1967-1968,1967-11-08,1968-03-21,135,0,83,465,548,79,533,612,1160,20,149,MA - Buffumville Lake
18,1968-1969,1968-11-11,1969-04-01,142,1,56,400,456,82,454,536,992,17,116,MA - Buffumville Lake
19,1969-1970,1969-12-01,1970-04-07,128,0,82,478,560,101,450,551,1111,29,229,MA - Buffumville Lake
20,1970-1971,1970-12-01,1971-04-10,131,0,88,450,538,103,680,783,1321,31,239,MA - Buffumville Lake
21,1971-1972,1971-11-25,1972-04-12,140,3,63,398,461,130,292,422,883,30,245,MA - Buffumville Lake
22,1972-1973,1972-10-19,1973-03-23,156,3,53,338,391,45,100,145,536,19,102,MA - Buffumville Lake
29,1979-1980,1979-10-11,1980-03-22,164,1,46,380,426,29,57,86,512,8,50,MA - Buffumville Lake
30,1980-1981,1980-11-18,1981-03-07,110,0,86,445,531,29,126,155,686,10,82,MA - Buffumville Lake
31,1981-1982,1981-12-01,1982-04-13,134,9,80,492,572,100,355,455,1027,24,212,MA - Buffumville Lake
32,1982-1983,1982-11-28,1983-04-19,143,8,46,329,375,90,262,352,727,13,154,MA - Buffumville Lake
33,1983-1984,1983-12-01,1984-04-04,126,4,67,427,494,89,218,307,801,18,163,MA - Buffumville Lake
34,1984-1985,1984-12-01,1985-04-08,129,3,55,422,477,44,183,227,704,16,126,MA - Buffumville Lake
35,1985-1986,1985-11-17,1986-03-10,114,3,60,418,478,38,115,153,631,19,126,MA - Buffumville Lake
36,1986-1987,1986-11-12,1987-04-30,170,6,36,415,451,127,589,716,1167,24,203,MA - Buffumville Lake
37,1987-1988,1987-11-11,1988-03-22,133,6,58,394,452,75,208,283,735,20,146,MA - Buffumville Lake
38,1988-1989,1988-12-01,1989-03-25,115,13,51,324,375,20,26,46,421,9,58,MA - Buffumville Lake
39,1989-1990,1989-11-22,1990-04-07,137,11,71,386,457,61,127,188,645,21,148,MA - Buffumville Lake
62,2012-2013,2012-11-08,2013-03-22,135,4,47,300,347,119,225,344,691,22,183,MA - Buffumville Lake
63,2013-2014,2013-11-26,2014-04-16,142,15,92,460,552,90,326,416,968,24,216,MA - Buffumville Lake
64,2014-2015,2014-11-14,2015-04-03,141,5,98,513,611,134,606,740,1351,24,259,MA - Buffumville Lake
65,2015-2016,2015-12-01,2016-04-05,127,0,34,247,281,56,101,157,438,13,99,MA - Buffumville Lake
66,2016-2017,2016-11-21,2017-04-02,133,2,39,302,341,91,170,261,602,21,160,MA - Buffumville Lake
67,2017-2018,2017-12-01,2018-04-07,128,0,71,336,407,106,220,326,733,28,196,MA - Buffumville Lake
68,2018-2019,2018-11-15,2019-03-23,129,0,50,340,390,68,156,224,614,16,121,MA - Buffumville Lake
69,2019-2020,2019-11-09,2020-04-18,162,0,22,278,300,42,85,127,427,9,62,MA - Buffumville Lake
22,1972-1973,1972-11-23,1973-03-23,121,0,25,119,144,29,33,62,206,12,57,MA - Chatham
23,1973-1974,1973-12-01,1974-03-29,119,0,17,123,140,38,44,82,222,15,66,MA - Chatham
24,1974-1975,1974-11-26,1975-03-30,125,0,10,118,128,44,33,77,205,15,67,MA - Chatham
25,1975-1976,1975-12-01,1976-03-18,109,3,23,155,178,57,70,127,305,16,104,MA - Chatham
26,1976-1977,1976-11-30,1977-03-19,110,3,49,218,267,34,48,82,349,13,65,MA - Chatham
27,1977-1978,1977-12-01,1978-03-19,109,0,38,177,215,55,85,140,355,14,86,MA - Chatham
28,1978-1979,1978-11-26,1979-03-16,111,0,52,175,227,20,39,59,286,10,54,MA - Chatham
29,1979-1980,1979-12-01,1980-03-03,94,0,28,135,163,16,11,27,190,6,32,MA - Chatham
30,1980-1981,1980-12-01,1981-02-28,90,0,41,193,234,44,112,156,390,11,92,MA - Chatham
31,1981-1982,1981-12-01,1982-04-08,129,3,41,193,234,53,97,150,384,18,102,MA - Chatham
32,1982-1983,1982-12-01,1983-04-02,123,4,14,93,107,65,66,131,238,15,101,MA - Chatham
33,1983-1984,1983-12-01,1984-03-30,121,0,27,151,178,36,50,86,264,8,55,MA - Chatham
34,1984-1985,1984-12-01,1985-03-06,96,12,16,124,140,36,77,113,253,11,69,MA - Chatham
35,1985-1986,1985-12-01,1986-03-21,111,2,16,154,170,26,37,63,233,9,45,MA - Chatham
37,1987-1988,1987-12-01,1988-03-21,112,0,22,142,164,28,33,61,225,7,55,MA - Chatham
38,1988-1989,1988-12-01,1989-03-12,102,1,21,133,154,33,36,69,223,15,76,MA - Chatham
39,1989-1990,1989-11-23,1990-04-07,136,3,36,170,206,54,73,127,333,14,93,MA - Chatham
40,1990-1991,1990-12-01,1991-03-11,101,2,10,93,103,23,10,33,136,12,57,MA - Chatham
42,1992-1993,1992-12-01,1993-03-21,111,0,22,146,168,64,102,166,334,13,97,MA - Chatham
43,1993-1994,1993-12-01,1994-03-20,110,5,39,185,224,95,117,212,436,28,162,MA - Chatham
47,1997-1998,1997-12-01,1998-03-13,103,16,5,74,79,0,0,0,79,0,0,MA - Chatham
48,1998-1999,1998-12-01,1999-02-28,90,16,10,89,99,48,44,92,191,10,69,MA - Chatham
49,1999-2000,1999-12-01,2000-03-18,109,13,23,135,158,27,37,64,222,8,59,MA - Chatham
51,2001-2002,2001-12-01,2002-03-22,112,4,3,75,78,6,6,12,90,1,7,MA - Chatham
52,2002-2003,2002-11-29,2003-04-08,131,16,32,192,224,76,148,224,448,12,106,MA - Chatham
53,2003-2004,2003-12-01,2004-03-20,111,11,47,176,223,32,46,78,301,9,55,MA - Chatham
55,2005-2006,2005-12-01,2006-03-09,99,5,16,105,121,21,48,69,190,9,39,MA - Chatham
56,2006-2007,2006-12-01,2007-03-10,100,1,36,146,182,14,11,25,207,8,36,MA - Chatham
57,2007-2008,2007-12-01,2008-02-29,91,1,13,100,113,26,26,52,165,10,47,MA - Chatham
58,2008-2009,2008-11-23,2009-03-24,122,3,35,169,204,27,47,74,278,12,58,MA - Chatham
59,2009-2010,2009-12-01,2010-03-05,95,0,29,137,166,25,96,121,287,10,46,MA - Chatham
60,2010-2011,2010-12-01,2011-03-24,114,0,27,159,186,32,46,78,264,11,46,MA - Chatham
61,2011-2012,2011-12-01,2012-02-29,91,0,6,76,82,17,11,28,110,5,25,MA - Chatham
62,2012-2013,2012-12-01,2013-03-23,113,1,22,114,136,42,60,102,238,15,80,MA - Chatham
63,2013-2014,2013-11-13,2014-03-27,135,1,42,205,247,55,94,149,396,23,122,MA - Chatham
64,2014-2015,2014-12-01,2015-03-21,111,6,29,181,210,62,271,333,543,19,122,MA - Chatham
65,2015-2016,2015-12-01,2016-03-21,112,0,11,91,102,30,64,94,196,9,63,MA - Chatham
66,2016-2017,2016-12-01,2017-03-16,106,0,13,111,124,42,58,100,224,12,71,MA - Chatham
68,2018-2019,2018-12-01,2019-03-08,98,2,22,144,166,7,11,18,184,4,24,MA - Chatham
69,2019-2020,2019-11-13,2020-03-07,116,3,9,93,102,8,7,15,117,6,15,MA - Chatham
32,1982-1983,1982-12-01,1983-02-28,90,2,17,135,152,29,57,86,238,4,42,MA - Edgartown
33,1983-1984,1983-12-01,1984-03-13,104,3,27,180,207,28,54,82,289,7,54,MA - Edgartown
34,1984-1985,1984-12-01,1985-02-28,90,1,28,157,185,31,75,106,291,8,56,MA - Edgartown
35,1985-1986,1985-11-26,1986-03-22,117,7,25,202,227,26,56,82,309,8,50,MA - Edgartown
36,1986-1987,1986-12-01,1987-03-14,104,4,17,178,195,59,198,257,452,10,80,MA - Edgartown
37,1987-1988,1987-12-01,1988-03-22,113,0,24,201,225,20,46,66,291,6,40,MA - Edgartown
38,1988-1989,1988-12-01,1989-03-13,103,1,20,171,191,25,37,62,253,11,61,MA - Edgartown
39,1989-1990,1989-11-23,1990-04-07,136,2,33,217,250,40,78,118,368,13,75,MA - Edgartown
40,1990-1991,1990-12-01,1991-02-28,90,2,7,128,135,6,2,8,143,5,26,MA - Edgartown
41,1991-1992,1991-12-01,1992-04-17,139,0,22,210,232,27,27,54,286,11,58,MA - Edgartown
42,1992-1993,1992-12-01,1993-03-20,110,1,15,176,191,22,16,38,229,11,49,MA - Edgartown
43,1993-1994,1993-11-26,1994-03-19,114,6,36,225,261,78,143,221,482,21,144,MA - Edgartown
44,1994-1995,1994-12-01,1995-02-28,90,1,10,127,137,3,0,3,140,1,6,MA - Edgartown
45,1995-1996,1995-12-01,1996-04-08,130,16,24,231,255,77,171,248,503,21,136,MA - Edgartown
46,1996-1997,1996-11-16,1997-04-02,138,11,8,167,175,22,18,40,215,10,45,MA - Edgartown
47,1997-1998,1997-12-01,1998-03-13,103,14,3,100,103,1,0,1,104,1,2,MA - Edgartown
49,1999-2000,1999-12-01,2000-03-18,109,16,26,147,173,14,16,30,203,6,32,MA - Edgartown
50,2000-2001,2000-11-25,2001-03-27,123,6,11,189,200,21,18,39,239,9,41,MA - Edgartown
51,2001-2002,2001-12-01,2002-03-18,108,10,0,87,87,14,5,19,106,5,20,MA - Edgartown
52,2002-2003,2002-12-01,2003-04-08,129,16,32,207,239,81,174,255,494,19,129,MA - Edgartown
53,2003-2004,2003-12-01,2004-03-20,111,9,39,186,225,42,61,103,328,13,71,MA - Edgartown
54,2004-2005,2004-12-01,2005-03-24,114,10,21,167,188,96,201,297,485,18,142,MA - Edgartown
55,2005-2006,2005-12-01,2006-03-08,98,10,10,122,132,26,45,71,203,6,37,MA - Edgartown
56,2006-2007,2006-12-01,2007-03-16,106,9,25,154,179,13,12,25,204,4,19,MA - Edgartown
57,2007-2008,2007-12-01,2008-02-29,91,4,11,127,138,17,18,35,173,5,26,MA - Edgartown
58,2008-2009,2008-11-23,2009-03-04,102,20,22,165,187,36,34,70,257,14,70,MA - Edgartown
59,2009-2010,2009-12-01,2010-03-05,95,2,20,138,158,35,100,135,293,10,53,MA - Edgartown
61,2011-2012,2011-12-01,2012-02-29,91,0,2,73,75,14,12,26,101,4,19,MA - Edgartown
62,2012-2013,2012-12-01,2013-03-23,113,0,16,117,133,49,65,114,247,13,77,MA - Edgartown
63,2013-2014,2013-11-25,2014-03-27,123,0,32,217,249,62,119,181,430,15,105,MA - Edgartown
64,2014-2015,2014-12-01,2015-03-29,119,1,30,217,247,80,304,384,631,21,147,MA - Edgartown
65,2015-2016,2015-12-01,2016-03-21,112,0,12,95,107,44,64,108,215,11,69,MA - Edgartown
66,2016-2017,2016-12-01,2017-03-16,106,0,12,108,120,50,56,106,226,11,74,MA - Edgartown
67,2017-2018,2017-12-01,2018-04-03,124,0,30,144,174,28,33,61,235,12,61,MA - Edgartown
68,2018-2019,2018-11-23,2019-03-08,106,0,18,147,165,3,1,4,169,2,8,MA - Edgartown
69,2019-2020,2019-12-01,2020-03-07,98,0,6,98,104,20,18,38,142,5,26,MA - Edgartown
0,1950-1951,1950-11-21,1951-03-22,122,0,32,209,241,50,83,133,374,24,130,MA - Haverhill
1,1951-1952,1951-11-20,1952-03-20,122,2,33,260,293,89,276,365,658,29,166,MA - Haverhill
2,1952-1953,1952-11-09,1953-04-14,157,0,15,192,207,62,109,171,378,19,93,MA - Haverhill
3,1953-1954,1953-12-01,1954-04-01,122,0,32,227,259,39,67,106,365,17,102,MA - Haverhill
4,1954-1955,1954-12-01,1955-03-26,116,0,29,232,261,56,81,137,398,17,101,MA - Haverhill
5,1955-1956,1955-11-11,1956-04-23,165,0,40,318,358,137,290,427,785,37,212,MA - Haverhill
6,1956-1957,1956-11-18,1957-04-09,143,0,41,296,337,102,250,352,689,28,183,MA - Haverhill
7,1957-1958,1957-12-01,1958-04-11,132,0,28,210,238,91,277,368,606,24,146,MA - Haverhill
8,1958-1959,1958-11-30,1959-03-28,119,0,56,346,402,81,113,194,596,27,159,MA - Haverhill
9,1959-1960,1959-11-29,1960-03-20,113,0,19,206,225,85,269,354,579,24,135,MA - Haverhill
10,1960-1961,1960-12-01,1961-04-14,135,0,53,354,407,115,491,606,1013,26,187,MA - Haverhill
11,1961-1962,1961-11-20,1962-04-16,148,0,46,309,355,94,371,465,820,26,171,MA - Haverhill
12,1962-1963,1962-10-26,1963-03-21,147,0,44,323,367,66,271,337,704,24,130,MA - Haverhill
13,1963-1964,1963-11-15,1964-03-19,126,0,41,286,327,106,346,452,779,29,194,MA - Haverhill
14,1964-1965,1964-12-01,1965-03-31,121,0,51,282,333,79,201,280,613,30,173,MA - Haverhill
15,1965-1966,1965-12-01,1966-03-13,103,0,21,224,245,99,300,399,644,25,152,MA - Haverhill
16,1966-1967,1966-12-01,1967-04-24,145,0,33,291,324,121,350,471,795,32,194,MA - Haverhill
17,1967-1968,1967-11-15,1968-03-16,123,0,58,347,405,96,467,563,968,19,159,MA - Haverhill
18,1968-1969,1968-11-12,1969-03-30,139,1,41,280,321,130,651,781,1102,28,191,MA - Haverhill
19,1969-1970,1969-10-22,1970-04-02,163,0,44,330,374,95,288,383,757,31,169,MA - Haverhill
20,1970-1971,1970-12-01,1971-04-16,137,0,68,341,409,118,628,746,1155,36,221,MA - Haverhill
21,1971-1972,1971-11-11,1972-04-20,162,1,38,316,354,140,304,444,798,31,216,MA - Haverhill
22,1972-1973,1972-11-14,1973-04-05,143,0,43,257,300,63,210,273,573,25,120,MA - Haverhill
23,1973-1974,1973-12-01,1974-04-10,131,0,37,239,276,54,145,199,475,19,108,MA - Haverhill
24,1974-1975,1974-11-22,1975-04-08,138,0,18,241,259,79,178,257,516,22,126,MA - Haverhill
25,1975-1976,1975-11-24,1976-03-20,118,0,53,288,341,95,306,401,742,29,200,MA - Haverhill
26,1976-1977,1976-11-10,1977-05-10,182,0,55,361,416,108,561,669,1085,23,159,MA - Haverhill
27,1977-1978,1977-11-28,1978-03-26,119,0,52,334,386,128,593,721,1107,27,224,MA - Haverhill
28,1978-1979,1978-11-21,1979-04-09,140,0,59,282,341,57,136,193,534,25,120,MA - Haverhill
33,1983-1984,1983-12-01,1984-03-30,121,17,58,335,393,53,160,213,606,15,109,MA - Haverhill
34,1984-1985,1984-12-01,1985-04-01,122,18,50,323,373,51,81,132,505,21,143,MA - Haverhill
35,1985-1986,1985-11-16,1986-03-21,126,11,43,357,400,45,85,130,530,16,91,MA - Haverhill
38,1988-1989,1988-12-01,1989-04-08,129,7,37,299,336,29,16,45,381,13,72,MA - Haverhill
40,1990-1991,1990-11-12,1991-03-24,133,8,28,252,280,35,67,102,382,12,63,MA - Haverhill
44,1994-1995,1994-11-23,1995-04-05,134,5,31,262,293,35,80,115,408,10,71,MA - Haverhill
47,1997-1998,1997-11-14,1998-03-22,129,12,14,219,233,52,119,171,404,16,81,MA - Haverhill
48,1998-1999,1998-12-01,1999-03-15,105,15,27,230,257,55,93,148,405,19,121,MA - Haverhill
51,2001-2002,2001-12-01,2002-04-25,146,15,3,197,200,55,73,128,328,17,82,MA - Haverhill
52,2002-2003,2002-11-16,2003-04-09,145,13,59,392,451,124,543,667,1118,32,235,MA - Haverhill
53,2003-2004,2003-12-01,2004-03-22,113,20,58,299,357,71,159,230,587,16,105,MA - Haverhill
62,2012-2013,2012-11-08,2013-03-23,136,5,37,254,291,94,202,296,587,21,155,MA - Haverhill
63,2013-2014,2013-11-25,2014-04-16,143,15,77,409,486,118,394,512,998,24,216,MA - Haverhill
64,2014-2015,2014-11-27,2015-04-09,134,8,78,426,504,169,499,668,1172,32,321,MA - Haverhill
65,2015-2016,2015-12-01,2016-04-05,127,8,29,214,243,46,72,118,361,10,80,MA - Haverhill
66,2016-2017,2016-12-01,2017-04-03,124,20,35,263,298,92,180,272,570,20,159,MA - Haverhill
67,2017-2018,2017-12-01,2018-04-07,128,20,57,297,354,112,220,332,686,17,149,MA - Haverhill
68,2018-2019,2018-11-16,2019-03-15,120,2,43,312,355,67,143,210,565,15,129,MA - Haverhill
69,2019-2020,2019-11-14,2020-04-18,157,4,23,264,287,52,111,163,450,12,80,MA - Haverhill
10,1960-1961,1960-10-25,1961-04-13,171,0,53,361,414,103,396,499,913,27,169,MA - Hingham
11,1961-1962,1961-11-21,1962-04-16,147,2,40,287,327,71,267,338,665,20,132,MA - Hingham
12,1962-1963,1962-10-26,1963-03-23,149,0,47,320,367,57,119,176,543,22,108,MA - Hingham
13,1963-1964,1963-12-01,1964-03-19,110,0,40,277,317,104,382,486,803,24,173,MA - Hingham
14,1964-1965,1964-12-01,1965-04-19,140,0,41,291,332,88,252,340,672,34,194,MA - Hingham
15,1965-1966,1965-12-01,1966-03-14,104,0,21,217,238,78,231,309,547,28,152,MA - Hingham
16,1966-1967,1966-12-01,1967-04-24,145,0,31,272,303,90,265,355,658,32,167,MA - Hingham
17,1967-1968,1967-11-15,1968-03-14,121,0,52,318,370,82,231,313,683,26,170,MA - Hingham
18,1968-1969,1968-12-01,1969-03-30,120,1,37,243,280,86,290,376,656,21,127,MA - Hingham
19,1969-1970,1969-12-01,1970-04-02,123,0,45,303,348,97,239,336,684,31,190,MA - Hingham
20,1970-1971,1970-12-01,1971-04-16,137,0,53,293,346,90,361,451,797,34,161,MA - Hingham
21,1971-1972,1971-11-11,1972-04-20,162,0,35,274,309,81,141,222,531,31,151,MA - Hingham
22,1972-1973,1972-11-15,1973-03-22,128,0,32,203,235,32,41,73,308,20,76,MA - Hingham
23,1973-1974,1973-12-01,1974-04-10,131,1,26,219,245,53,183,236,481,16,97,MA - Hingham
24,1974-1975,1974-11-22,1975-04-08,138,0,15,224,239,64,142,206,445,27,122,MA - Hingham
25,1975-1976,1975-12-01,1976-03-19,110,0,42,247,289,82,219,301,590,25,161,MA - Hingham
26,1976-1977,1976-11-10,1977-03-23,134,0,50,345,395,92,461,553,948,27,171,MA - Hingham
27,1977-1978,1977-11-28,1978-03-26,119,2,52,301,353,130,525,655,1008,29,211,MA - Hingham
28,1978-1979,1978-11-21,1979-04-09,140,0,59,270,329,50,110,160,489,21,107,MA - Hingham
29,1979-1980,1979-12-01,1980-03-14,105,1,30,231,261,29,30,59,320,15,71,MA - Hingham
30,1980-1981,1980-11-18,1981-03-21,124,0,54,314,368,44,177,221,589,19,112,MA - Hingham
31,1981-1982,1981-12-01,1982-04-11,132,0,46,282,328,84,219,303,631,30,171,MA - Hingham
32,1982-1983,1982-12-01,1983-03-12,102,0,24,171,195,60,162,222,417,17,96,MA - Hingham
33,1983-1984,1983-12-01,1984-04-01,123,1,46,251,297,65,143,208,505,23,138,MA - Hingham
34,1984-1985,1984-11-13,1985-04-08,147,0,32,254,286,66,181,247,533,30,148,MA - Hingham
35,1985-1986,1985-11-16,1986-03-21,126,0,25,233,258,41,65,106,364,23,84,MA - Hingham
36,1986-1987,1986-11-11,1987-04-29,170,1,16,253,269,78,299,377,646,33,130,MA - Hingham
37,1987-1988,1987-11-11,1988-03-21,132,0,27,247,274,87,253,340,614,22,126,MA - Hingham
38,1988-1989,1988-12-01,1989-04-08,129,0,30,236,266,39,76,115,381,18,86,MA - Hingham
39,1989-1990,1989-11-20,1990-04-07,139,0,51,269,320,77,142,219,539,27,156,MA - Hingham
40,1990-1991,1990-12-01,1991-03-30,120,1,15,181,196,34,46,80,276,19,78,MA - Hingham
41,1991-1992,1991-12-01,1992-04-17,139,0,27,241,268,46,36,82,350,28,115,MA - Hingham
42,1992-1993,1992-12-01,1993-04-27,148,0,36,258,294,88,208,296,590,30,176,MA - Hingham
43,1993-1994,1993-12-01,1994-03-21,111,0,60,284,344,137,496,633,977,37,260,MA - Hingham
44,1994-1995,1994-11-28,1995-03-12,105,0,24,176,200,29,45,74,274,15,63,MA - Hingham
45,1995-1996,1995-11-14,1996-04-10,149,0,49,287,336,163,411,574,910,43,274,MA - Hingham
46,1996-1997,1996-11-15,1997-04-06,143,2,25,190,215,71,70,141,356,24,116,MA - Hingham
47,1997-1998,1997-11-14,1998-03-23,130,0,7,153,160,37,62,99,259,24,66,MA - Hingham
48,1998-1999,1998-12-01,1999-03-16,106,0,21,181,202,73,88,161,363,21,130,MA - Hingham
49,1999-2000,1999-11-30,2000-03-18,110,0,31,193,224,40,142,182,406,17,92,MA - Hingham
50,2000-2001,2000-11-24,2001-04-02,130,0,23,242,265,78,203,281,546,36,142,MA - Hingham
51,2001-2002,2001-12-01,2002-04-06,127,0,1,138,139,32,22,54,193,19,56,MA - Hingham
52,2002-2003,2002-11-27,2003-04-08,133,0,55,300,355,113,290,403,758,34,193,MA - Hingham
53,2003-2004,2003-12-01,2004-03-20,111,0,49,241,290,63,108,171,461,22,114,MA - Hingham
54,2004-2005,2004-11-12,2005-03-24,133,0,32,261,293,132,412,544,837,37,233,MA - Hingham
55,2005-2006,2005-10-29,2006-04-05,159,1,18,205,223,55,87,142,365,22,97,MA - Hingham
56,2006-2007,2006-12-01,2007-04-04,125,0,29,211,240,34,32,66,306,17,63,MA - Hingham
57,2007-2008,2007-11-20,2008-03-15,117,0,21,193,214,67,159,226,440,24,115,MA - Hingham
58,2008-2009,2008-11-22,2009-03-09,108,0,35,242,277,102,328,430,707,22,156,MA - Hingham
59,2009-2010,2009-12-01,2010-03-05,95,0,24,177,201,65,160,225,426,23,105,MA - Hingham
60,2010-2011,2010-12-01,2011-04-01,122,0,26,254,280,100,469,569,849,30,170,MA - Hingham
61,2011-2012,2011-12-01,2012-03-10,101,5,9,131,140,19,13,32,172,14,40,MA - Hingham
62,2012-2013,2012-12-01,2013-03-23,113,0,19,168,187,97,188,285,472,27,150,MA - Hingham
63,2013-2014,2013-11-25,2014-04-16,143,5,42,299,341,97,245,342,683,32,190,MA - Hingham
64,2014-2015,2014-11-28,2015-04-04,128,1,53,316,369,163,655,818,1187,44,318,MA - Hingham
65,2015-2016,2015-12-01,2016-04-06,128,0,18,152,170,55,102,157,327,20,96,MA - Hingham
66,2016-2017,2016-12-01,2017-04-01,122,0,17,180,197,72,128,200,397,22,126,MA - Hingham
67,2017-2018,2017-12-01,2018-04-06,127,0,46,215,261,88,160,248,509,25,140,MA - Hingham
68,2018-2019,2018-11-16,2019-03-23,128,0,21,228,249,66,118,184,433,18,102,MA - Hingham
69,2019-2020,2019-11-12,2020-04-18,159,2,10,159,169,28,33,61,230,16,53,MA - Hingham
0,1950-1951,1950-11-21,1951-03-22,122,0,36,206,242,66,69,135,377,27,143,MA - Milton
1,1951-1952,1951-11-02,1952-03-25,145,1,38,255,293,94,265,359,652,35,171,MA - Milton
2,1952-1953,1952-11-09,1953-04-14,157,1,24,203,227,84,116,200,427,24,131,MA - Milton
3,1953-1954,1953-12-01,1954-04-01,122,4,46,224,270,51,98,149,419,21,129,MA - Milton
4,1954-1955,1954-11-26,1955-04-04,130,1,51,256,307,65,98,163,470,27,141,MA - Milton
5,1955-1956,1955-11-19,1956-04-23,157,4,59,333,392,153,297,450,842,36,239,MA - Milton
6,1956-1957,1956-11-18,1957-04-13,147,5,57,249,306,114,244,358,664,35,211,MA - Milton
7,1957-1958,1957-10-27,1958-04-12,168,7,44,251,295,127,301,428,723,30,197,MA - Milton
8,1958-1959,1958-11-30,1959-03-29,120,0,77,350,427,64,117,181,608,23,138,MA - Milton
9,1959-1960,1959-11-17,1960-03-27,132,3,38,261,299,87,252,339,638,34,183,MA - Milton
10,1960-1961,1960-10-24,1961-04-19,178,1,84,335,419,124,485,609,1028,23,188,MA - Milton
11,1961-1962,1961-11-20,1962-04-16,148,1,62,297,359,87,325,412,771,25,154,MA - Milton
12,1962-1963,1962-10-26,1963-03-24,150,0,68,339,407,71,229,300,707,29,154,MA - Milton
13,1963-1964,1963-10-30,1964-03-22,145,0,60,279,339,120,371,491,830,32,224,MA - Milton
14,1964-1965,1964-11-22,1965-04-19,149,0,70,315,385,92,239,331,716,33,226,MA - Milton
15,1965-1966,1965-12-01,1966-03-16,106,0,52,232,284,104,316,420,704,29,193,MA - Milton
16,1966-1967,1966-12-01,1967-04-24,145,0,60,285,345,152,342,494,839,35,248,MA - Milton
17,1967-1968,1967-11-07,1968-03-16,131,0,76,330,406,95,334,429,835,24,184,MA - Milton
18,1968-1969,1968-11-10,1969-04-01,143,0,67,287,354,123,530,653,1007,30,188,MA - Milton
19,1969-1970,1969-11-22,1970-04-02,132,0,86,333,419,85,342,427,846,26,180,MA - Milton
20,1970-1971,1970-11-25,1971-04-17,144,0,94,331,425,86,358,444,869,30,177,MA - Milton
21,1971-1972,1971-11-21,1972-04-21,153,0,61,307,368,113,194,307,675,33,218,MA - Milton
22,1972-1973,1972-10-19,1973-03-23,156,0,47,244,291,39,64,103,394,20,90,MA - Milton
23,1973-1974,1973-12-01,1974-04-11,132,0,53,250,303,50,176,226,529,17,113,MA - Milton
24,1974-1975,1974-11-21,1975-04-26,157,0,34,247,281,70,182,252,533,28,122,MA - Milton
25,1975-1976,1975-11-24,1976-03-20,118,0,61,280,341,88,203,291,632,29,196,MA - Milton
26,1976-1977,1976-11-09,1977-05-11,184,0,96,360,456,118,472,590,1046,29,217,MA - Milton
27,1977-1978,1977-11-27,1978-04-07,132,0,79,337,416,131,553,684,1100,25,211,MA - Milton
28,1978-1979,1978-11-21,1979-04-09,140,0,90,311,401,56,103,159,560,27,142,MA - Milton
29,1979-1980,1979-10-10,1980-03-26,169,0,54,286,340,39,40,79,419,17,94,MA - Milton
30,1980-1981,1980-11-17,1981-03-21,125,0,77,350,427,66,207,273,700,23,154,MA - Milton
31,1981-1982,1981-12-01,1982-04-12,133,0,75,329,404,109,328,437,841,34,229,MA - Milton
32,1982-1983,1982-12-01,1983-03-12,102,0,43,193,236,81,249,330,566,21,153,MA - Milton
33,1983-1984,1983-12-01,1984-04-05,127,0,67,281,348,89,178,267,615,29,186,MA - Milton
34,1984-1985,1984-11-13,1985-04-08,147,0,58,285,343,70,194,264,607,24,170,MA - Milton
35,1985-1986,1985-11-16,1986-03-21,126,0,56,278,334,43,82,125,459,29,132,MA - Milton
36,1986-1987,1986-11-11,1987-04-30,171,0,38,287,325,126,405,531,856,36,200,MA - Milton
37,1987-1988,1987-11-10,1988-03-21,133,0,51,266,317,99,259,358,675,22,148,MA - Milton
38,1988-1989,1988-12-01,1989-04-08,129,0,48,261,309,51,87,138,447,21,128,MA - Milton
39,1989-1990,1989-11-20,1990-04-07,139,0,73,321,394,88,179,267,661,28,186,MA - Milton
40,1990-1991,1990-11-08,1991-03-30,143,12,32,229,261,46,70,116,377,26,127,MA - Milton
41,1991-1992,1991-11-11,1992-04-17,159,0,47,288,335,50,55,105,440,30,139,MA - Milton
42,1992-1993,1992-11-15,1993-04-27,164,0,59,305,364,127,297,424,788,41,256,MA - Milton
43,1993-1994,1993-11-24,1994-03-30,127,0,91,335,426,147,479,626,1052,38,316,MA - Milton
44,1994-1995,1994-11-23,1995-04-05,134,0,45,234,279,34,56,90,369,19,81,MA - Milton
45,1995-1996,1995-11-13,1996-04-13,153,0,79,321,400,201,489,690,1090,42,353,MA - Milton
46,1996-1997,1996-11-15,1997-04-09,146,0,38,244,282,109,110,219,501,32,195,MA - Milton
47,1997-1998,1997-11-14,1998-04-10,148,0,24,178,202,66,182,248,450,27,115,MA - Milton
48,1998-1999,1998-12-01,1999-03-18,108,1,30,214,244,85,113,198,442,23,163,MA - Milton
49,1999-2000,1999-12-01,2000-04-27,149,0,55,245,300,48,183,231,531,17,106,MA - Milton
50,2000-2001,2000-10-30,2001-04-19,172,0,56,317,373,135,421,556,929,39,241,MA - Milton
51,2001-2002,2001-12-01,2002-04-26,147,0,14,167,181,59,73,132,313,19,91,MA - Milton
52,2002-2003,2002-10-23,2003-04-10,170,0,93,389,482,168,545,713,1195,45,308,MA - Milton
53,2003-2004,2003-10-23,2004-04-05,166,1,80,334,414,91,169,260,674,30,197,MA - Milton
54,2004-2005,2004-11-13,2005-04-13,152,4,57,283,340,173,489,662,1002,39,301,MA - Milton
55,2005-2006,2005-10-30,2006-04-06,159,2,37,247,284,78,146,224,508,27,147,MA - Milton
56,2006-2007,2006-12-01,2007-04-05,126,1,50,261,311,43,59,102,413,19,92,MA - Milton
57,2007-2008,2007-11-20,2008-03-29,131,2,39,249,288,99,206,305,593,37,184,MA - Milton
58,2008-2009,2008-11-20,2009-04-11,143,4,59,310,369,110,326,436,805,25,194,MA - Milton
61,2011-2012,2011-10-28,2012-03-07,132,0,14,176,190,38,45,83,273,18,83,MA - Milton
62,2012-2013,2012-11-08,2013-03-26,139,0,39,216,255,140,252,392,647,31,217,MA - Milton
63,2013-2014,2013-11-13,2014-04-16,155,0,78,359,437,123,332,455,892,35,261,MA - Milton
64,2014-2015,2014-11-03,2015-04-03,152,0,86,395,481,209,727,936,1417,46,420,MA - Milton
65,2015-2016,2015-12-01,2016-04-07,129,0,28,185,213,81,127,208,421,17,130,MA - Milton
66,2016-2017,2016-12-01,2017-04-03,124,0,34,225,259,89,153,242,501,23,164,MA - Milton
67,2017-2018,2017-12-01,2018-04-07,128,0,68,261,329,125,270,395,724,28,207,MA - Milton
68,2018-2019,2018-11-16,2019-03-23,128,0,46,292,338,68,133,201,539,16,116,MA - Milton
69,2019-2020,2019-11-13,2020-04-19,159,3,21,211,232,49,59,108,340,21,88,MA - Milton
1,1951-1952,1951-11-01,1952-04-12,164,0,106,483,589,157,735,892,1481,58,378,MI - Alpena
2,1952-1953,1952-10-19,1953-04-17,181,0,56,364,420,86,250,336,756,52,264,MI - Alpena
3,1953-1954,1953-10-28,1954-05-05,190,13,74,405,479,106,359,465,944,42,272,MI - Alpena
5,1955-1956,1955-11-03,1956-04-29,179,12,86,508,594,110,343,453,1047,29,218,MI - Alpena
7,1957-1958,1957-11-11,1958-03-20,130,19,92,363,455,46,335,381,836,25,118,MI - Alpena
8,1958-1959,1958-11-26,1959-04-10,136,12,176,539,715,100,490,590,1305,43,317,MI - Alpena
9,1959-1960,1959-10-27,1960-04-09,166,0,118,585,703,125,735,860,1563,66,427,MI - Alpena
10,1960-1961,1960-10-23,1961-05-02,192,0,133,597,730,94,344,438,1168,52,357,MI - Alpena
11,1961-1962,1961-11-07,1962-04-15,160,0,158,580,738,133,756,889,1627,62,455,MI - Alpena
12,1962-1963,1962-10-24,1963-05-01,190,0,205,729,934,130,740,870,1804,60,514,MI - Alpena
13,1963-1964,1963-11-01,1964-04-09,161,0,101,534,635,102,316,418,1053,57,392,MI - Alpena
14,1964-1965,1964-10-09,1965-04-17,191,0,146,610,756,149,448,597,1353,69,542,MI - Alpena
15,1965-1966,1965-10-28,1966-05-28,213,0,106,485,591,92,235,327,918,62,345,MI - Alpena
16,1966-1967,1966-11-02,1967-04-07,157,0,117,600,717,179,763,942,1659,59,531,MI - Alpena
17,1967-1968,1967-10-27,1968-04-25,182,0,139,540,679,94,260,354,1033,61,414,MI - Alpena
18,1968-1969,1968-10-29,1969-04-01,155,0,115,502,617,136,633,769,1386,66,466,MI - Alpena
19,1969-1970,1969-10-21,1970-05-05,197,0,145,639,784,148,586,734,1518,72,548,MI - Alpena
20,1970-1971,1970-11-21,1971-04-26,157,0,139,582,721,241,954,1195,1916,87,681,MI - Alpena
21,1971-1972,1971-11-07,1972-04-22,168,0,129,579,708,136,580,716,1424,68,450,MI - Alpena
22,1972-1973,1972-10-17,1973-04-14,180,0,106,468,574,131,388,519,1093,58,389,MI - Alpena
23,1973-1974,1973-11-09,1974-05-06,179,0,145,524,669,112,364,476,1145,56,365,MI - Alpena
24,1974-1975,1974-10-19,1975-04-09,173,0,83,465,548,102,505,607,1155,63,327,MI - Alpena
25,1975-1976,1975-11-13,1976-05-03,173,0,125,524,649,156,709,865,1514,74,533,MI - Alpena
26,1976-1977,1976-10-19,1977-04-08,172,0,195,592,787,104,601,705,1492,64,459,MI - Alpena
27,1977-1978,1977-11-11,1978-04-13,154,0,163,590,753,176,892,1068,1821,73,569,MI - Alpena
28,1978-1979,1978-11-20,1979-05-06,168,0,190,564,754,140,791,931,1685,66,463,MI - Alpena
29,1979-1980,1979-10-12,1980-04-15,187,0,133,487,620,115,295,410,1030,60,378,MI - Alpena
30,1980-1981,1980-10-04,1981-03-26,174,0,138,520,658,120,497,617,1275,58,456,MI - Alpena
31,1981-1982,1981-10-18,1982-04-17,182,0,166,580,746,135,733,868,1614,70,521,MI - Alpena
32,1982-1983,1982-10-16,1983-04-18,185,0,79,361,440,112,346,458,898,53,299,MI - Alpena
33,1983-1984,1983-11-10,1984-05-01,174,0,153,527,680,117,540,657,1337,67,446,MI - Alpena
34,1984-1985,1984-11-02,1985-04-07,157,0,129,468,597,183,736,919,1516,76,555,MI - Alpena
35,1985-1986,1985-11-09,1986-04-22,165,0,144,505,649,151,815,966,1615,75,536,MI - Alpena
36,1986-1987,1986-10-30,1987-04-05,158,0,59,414,473,96,368,464,937,54,291,MI - Alpena
37,1987-1988,1987-10-22,1988-04-27,189,0,124,514,638,148,445,593,1231,78,509,MI - Alpena
38,1988-1989,1988-10-11,1989-05-07,209,0,121,517,638,148,428,576,1214,82,511,MI - Alpena
39,1989-1990,1989-10-03,1990-05-10,220,0,127,566,693,183,818,1001,1694,81,556,MI - Alpena
40,1990-1991,1990-10-28,1991-04-10,165,0,92,408,500,114,375,489,989,60,359,MI - Alpena
41,1991-1992,1991-11-03,1992-04-17,167,0,99,465,564,129,549,678,1242,60,407,MI - Alpena
42,1992-1993,1992-10-17,1993-04-21,187,0,106,510,616,122,435,557,1173,65,380,MI - Alpena
43,1993-1994,1993-10-03,1994-05-01,211,0,192,645,837,141,545,686,1523,67,548,MI - Alpena
44,1994-1995,1994-11-22,1995-04-26,156,0,92,415,507,96,274,370,877,54,354,MI - Alpena
45,1995-1996,1995-10-31,1996-05-01,184,9,180,627,807,173,724,897,1704,86,586,MI - Alpena
48,1998-1999,1998-11-20,1999-03-24,125,5,107,389,496,106,515,621,1117,31,282,MI - Alpena
49,1999-2000,1999-11-03,2000-04-12,162,0,90,418,508,81,248,329,837,38,258,MI - Alpena
50,2000-2001,2000-10-08,2001-04-17,192,3,139,487,626,161,688,849,1475,57,464,MI - Alpena
51,2001-2002,2001-10-07,2002-05-03,209,3,63,385,448,128,412,540,988,42,290,MI - Alpena
52,2002-2003,2002-11-01,2003-04-12,163,3,177,573,750,124,379,503,1253,50,427,MI - Alpena
53,2003-2004,2003-11-08,2004-05-03,178,3,117,484,601,142,579,721,1322,53,398,MI - Alpena
54,2004-2005,2004-11-24,2005-04-25,153,0,141,503,644,155,730,885,1529,66,513,MI - Alpena
55,2005-2006,2005-11-16,2006-04-05,141,2,84,393,477,138,718,856,1333,64,381,MI - Alpena
56,2006-2007,2006-11-10,2007-04-16,158,0,119,413,532,119,483,602,1134,53,396,MI - Alpena
57,2007-2008,2007-11-08,2008-04-12,157,0,116,486,602,112,737,849,1451,58,366,MI - Alpena
58,2008-2009,2008-11-09,2009-04-06,149,0,158,560,718,187,915,1102,1820,72,570,MI - Alpena
59,2009-2010,2009-11-30,2010-05-08,160,0,95,370,465,77,477,554,1019,43,268,MI - Alpena
60,2010-2011,2010-11-05,2011-04-23,170,9,150,515,665,140,583,723,1388,67,477,MI - Alpena
61,2011-2012,2011-11-10,2012-03-30,142,3,54,293,347,79,315,394,741,35,195,MI - Alpena
62,2012-2013,2012-11-24,2013-04-20,148,1,101,380,481,80,381,461,942,52,294,MI - Alpena
63,2013-2014,2013-11-12,2014-04-16,156,0,245,715,960,114,771,885,1845,73,629,MI - Alpena
64,2014-2015,2014-11-10,2015-04-06,148,0,177,603,780,77,382,459,1239,34,283,MI - Alpena
65,2015-2016,2015-11-21,2016-04-13,145,0,76,353,429,144,427,571,1000,60,420,MI - Alpena
66,2016-2017,2016-11-19,2017-03-31,133,0,81,323,404,110,291,401,805,61,332,MI - Alpena
67,2017-2018,2017-11-10,2018-04-24,166,0,135,527,662,122,369,491,1153,49,380,MI - Alpena
68,2018-2019,2018-10-17,2019-04-15,181,0,136,537,673,156,699,855,1528,74,526,MI - Alpena
69,2019-2020,2019-10-31,2020-04-21,174,0,69,378,447,104,416,520,967,52,280,MI - Alpena
1,1951-1952,1951-11-03,1952-04-13,163,0,65,298,363,83,180,263,626,38,203,MI - Ann Arbor
2,1952-1953,1952-11-28,1953-04-21,145,0,30,190,220,33,35,68,288,25,91,MI - Ann Arbor
3,1953-1954,1953-11-07,1954-04-03,148,11,49,262,311,49,87,136,447,27,135,MI - Ann Arbor
5,1955-1956,1955-11-19,1956-03-27,130,9,41,303,344,51,151,202,546,23,114,MI - Ann Arbor
6,1956-1957,1956-11-23,1957-03-03,101,4,57,237,294,35,117,152,446,9,63,MI - Ann Arbor
7,1957-1958,1957-11-09,1958-02-28,112,1,58,243,301,25,46,71,372,16,71,MI - Ann Arbor
8,1958-1959,1958-11-27,1959-03-28,122,0,93,382,475,54,298,352,827,28,187,MI - Ann Arbor
9,1959-1960,1959-11-18,1960-03-25,129,0,63,286,349,45,167,212,561,20,113,MI - Ann Arbor
10,1960-1961,1960-11-30,1961-04-09,131,8,79,308,387,29,113,142,529,13,92,MI - Ann Arbor
11,1961-1962,1961-11-28,1962-03-15,108,1,85,300,385,44,159,203,588,19,115,MI - Ann Arbor
12,1962-1963,1962-12-01,1963-03-21,111,3,117,365,482,50,342,392,874,27,171,MI - Ann Arbor
13,1963-1964,1963-12-01,1964-04-03,125,0,58,285,343,50,117,167,510,19,106,MI - Ann Arbor
14,1964-1965,1964-11-21,1965-04-02,133,2,98,332,430,40,101,141,571,16,101,MI - Ann Arbor
15,1965-1966,1965-11-28,1966-04-07,131,0,75,251,326,11,24,35,361,8,33,MI - Ann Arbor
16,1966-1967,1966-11-02,1967-03-25,144,1,73,300,373,104,452,556,929,27,168,MI - Ann Arbor
17,1967-1968,1967-11-06,1968-03-25,141,3,74,302,376,33,78,111,487,11,74,MI - Ann Arbor
18,1968-1969,1968-11-20,1969-03-30,131,0,63,250,313,21,29,50,363,14,54,MI - Ann Arbor
19,1969-1970,1969-11-15,1970-04-02,139,0,73,342,415,73,153,226,641,44,246,MI - Ann Arbor
20,1970-1971,1970-11-15,1971-04-03,140,5,83,304,387,70,127,197,584,47,225,MI - Ann Arbor
21,1971-1972,1971-11-09,1972-04-07,151,2,69,309,378,45,47,92,470,34,153,MI - Ann Arbor
22,1972-1973,1972-11-14,1973-04-10,148,1,52,227,279,79,144,223,502,33,162,MI - Ann Arbor
23,1973-1974,1973-12-01,1974-04-05,126,1,70,266,336,71,203,274,610,33,200,MI - Ann Arbor
24,1974-1975,1974-11-14,1975-04-19,157,1,48,285,333,103,286,389,722,50,214,MI - Ann Arbor
25,1975-1976,1975-11-25,1976-04-26,154,0,72,326,398,84,327,411,809,46,226,MI - Ann Arbor
26,1976-1977,1976-11-07,1977-04-07,152,0,145,459,604,87,317,404,1008,55,367,MI - Ann Arbor
27,1977-1978,1977-11-11,1978-04-21,162,0,135,454,589,117,609,726,1315,62,398,MI - Ann Arbor
28,1978-1979,1978-11-21,1979-04-09,140,0,137,392,529,90,284,374,903,63,366,MI - Ann Arbor
29,1979-1980,1979-11-08,1980-04-15,160,12,82,329,411,61,90,151,562,44,215,MI - Ann Arbor
30,1980-1981,1980-10-28,1981-03-20,144,3,91,350,441,77,274,351,792,49,270,MI - Ann Arbor
31,1981-1982,1981-10-19,1982-04-11,175,1,121,421,542,128,473,601,1143,69,448,MI - Ann Arbor
32,1982-1983,1982-11-05,1983-04-18,165,2,43,233,276,58,41,99,375,32,129,MI - Ann Arbor
33,1983-1984,1983-11-16,1984-04-17,154,1,125,390,515,89,323,412,927,56,340,MI - Ann Arbor
34,1984-1985,1984-11-11,1985-04-17,158,0,76,328,404,88,258,346,750,51,296,MI - Ann Arbor
35,1985-1986,1985-11-16,1986-04-22,158,7,89,350,439,92,291,383,822,59,338,MI - Ann Arbor
36,1986-1987,1986-11-11,1987-04-05,146,0,38,260,298,84,162,246,544,43,191,MI - Ann Arbor
37,1987-1988,1987-10-21,1988-04-16,179,1,82,328,410,98,216,314,724,53,301,MI - Ann Arbor
38,1988-1989,1988-10-26,1989-04-10,167,0,58,304,362,73,56,129,491,49,221,MI - Ann Arbor
39,1989-1990,1989-10-19,1990-04-12,176,0,75,320,395,97,205,302,697,57,283,MI - Ann Arbor
40,1990-1991,1990-11-06,1991-04-01,147,0,48,255,303,73,117,190,493,39,203,MI - Ann Arbor
41,1991-1992,1991-11-03,1992-04-14,164,2,50,282,332,97,153,250,582,52,268,MI - Ann Arbor
42,1992-1993,1992-10-19,1993-04-21,185,1,55,289,344,124,230,354,698,65,296,MI - Ann Arbor
43,1993-1994,1993-10-31,1994-04-06,158,0,109,397,506,103,235,338,844,60,399,MI - Ann Arbor
44,1994-1995,1994-11-23,1995-04-10,139,0,60,274,334,86,198,284,618,42,223,MI - Ann Arbor
45,1995-1996,1995-11-04,1996-04-16,165,0,116,423,539,94,126,220,759,63,354,MI - Ann Arbor
46,1996-1997,1996-11-11,1997-04-13,154,1,75,304,379,114,163,277,656,68,348,MI - Ann Arbor
47,1997-1998,1997-10-27,1998-03-23,148,0,28,185,213,76,96,172,385,43,157,MI - Ann Arbor
48,1998-1999,1998-11-21,1999-03-21,121,0,66,261,327,100,237,337,664,35,274,MI - Ann Arbor
49,1999-2000,1999-12-01,2000-04-11,133,0,61,248,309,70,197,267,576,42,229,MI - Ann Arbor
50,2000-2001,2000-11-14,2001-04-17,155,1,81,333,414,126,398,524,938,67,353,MI - Ann Arbor
51,2001-2002,2001-10-26,2002-04-21,178,0,27,209,236,91,114,205,441,51,217,MI - Ann Arbor
52,2002-2003,2002-11-15,2003-04-08,145,1,92,371,463,105,189,294,757,53,310,MI - Ann Arbor
53,2003-2004,2003-11-13,2004-04-13,153,0,74,293,367,85,259,344,711,54,247,MI - Ann Arbor
54,2004-2005,2004-11-24,2005-05-03,161,0,71,301,372,124,277,401,773,54,292,MI - Ann Arbor
55,2005-2006,2005-11-17,2006-03-25,129,0,45,221,266,88,151,239,505,46,197,MI - Ann Arbor
56,2006-2007,2006-10-12,2007-04-15,186,0,74,278,352,83,164,247,599,58,301,MI - Ann Arbor
57,2007-2008,2007-11-18,2008-04-13,148,0,68,285,353,139,208,347,700,64,338,MI - Ann Arbor
58,2008-2009,2008-11-09,2009-04-07,150,0,100,369,469,130,298,428,897,69,411,MI - Ann Arbor
59,2009-2010,2009-11-27,2010-03-07,101,0,55,218,273,91,222,313,586,45,214,MI - Ann Arbor
60,2010-2011,2010-12-01,2011-04-18,139,0,87,311,398,108,358,466,864,56,306,MI - Ann Arbor
61,2011-2012,2011-11-10,2012-04-11,154,0,18,169,187,66,47,113,300,43,156,MI - Ann Arbor
62,2012-2013,2012-10-30,2013-04-25,178,2,54,270,324,109,182,291,615,57,290,MI - Ann Arbor
63,2013-2014,2013-10-24,2014-04-15,174,0,136,463,599,152,549,701,1300,72,476,MI - Ann Arbor
64,2014-2015,2014-11-01,2015-04-23,174,0,114,396,510,98,351,449,959,58,351,MI - Ann Arbor
65,2015-2016,2015-11-21,2016-05-15,177,0,44,207,251,92,110,202,453,51,244,MI - Ann Arbor
66,2016-2017,2016-11-19,2017-04-07,140,0,52,209,261,83,125,208,469,47,220,MI - Ann Arbor
67,2017-2018,2017-10-30,2018-04-19,172,0,91,395,486,133,260,393,879,62,398,MI - Ann Arbor
68,2018-2019,2018-10-20,2019-04-28,191,0,71,359,430,101,110,211,641,60,287,MI - Ann Arbor
69,2019-2020,2019-11-01,2020-05-12,194,0,27,271,298,106,146,252,550,51,209,MI - Ann Arbor
1,1951-1952,1951-11-02,1952-04-14,165,2,105,465,570,119,595,714,1284,53,321,MI - Cheboygan
2,1952-1953,1952-10-28,1953-04-19,174,9,63,321,384,116,410,526,910,47,251,MI - Cheboygan
3,1953-1954,1953-10-28,1954-05-07,192,2,85,393,478,94,424,518,996,50,286,MI - Cheboygan
4,1954-1955,1954-10-30,1955-03-30,152,0,96,391,487,116,552,668,1155,57,293,MI - Cheboygan
5,1955-1956,1955-10-25,1956-04-30,189,1,112,498,610,137,709,846,1456,56,319,MI - Cheboygan
6,1956-1957,1956-09-20,1957-04-13,206,5,113,463,576,110,369,479,1055,56,306,MI - Cheboygan
7,1957-1958,1957-11-09,1958-04-08,151,0,102,391,493,87,417,504,997,41,225,MI - Cheboygan
8,1958-1959,1958-11-27,1959-04-11,136,7,161,574,735,163,1094,1257,1992,58,487,MI - Cheboygan
9,1959-1960,1959-10-25,1960-04-18,177,0,108,479,587,128,706,834,1421,54,328,MI - Cheboygan
10,1960-1961,1960-10-24,1961-04-03,162,0,118,446,564,78,455,533,1097,42,294,MI - Cheboygan
11,1961-1962,1961-11-07,1962-04-13,158,1,130,483,613,161,883,1044,1657,69,466,MI - Cheboygan
12,1962-1963,1962-10-25,1963-05-10,198,3,187,569,756,148,939,1087,1843,54,464,MI - Cheboygan
13,1963-1964,1963-11-30,1964-04-15,138,1,83,401,484,99,473,572,1056,35,221,MI - Cheboygan
14,1964-1965,1964-10-07,1965-04-17,193,0,130,510,640,167,794,961,1601,66,471,MI - Cheboygan
15,1965-1966,1965-11-14,1966-04-26,164,0,103,365,468,72,252,324,792,32,173,MI - Cheboygan
16,1966-1967,1966-11-03,1967-03-31,149,6,126,464,590,140,876,1016,1606,49,384,MI - Cheboygan
17,1967-1968,1967-11-14,1968-04-11,150,4,130,502,632,87,532,619,1251,28,244,MI - Cheboygan
18,1968-1969,1968-11-18,1969-04-01,135,9,93,432,525,100,663,763,1288,32,243,MI - Cheboygan
19,1969-1970,1969-11-15,1970-03-29,135,1,125,509,634,51,469,520,1154,22,151,MI - Cheboygan
20,1970-1971,1970-11-22,1971-04-24,154,6,130,529,659,163,1091,1254,1913,49,358,MI - Cheboygan
22,1972-1973,1972-11-22,1973-04-11,141,6,83,354,437,63,269,332,769,33,208,MI - Cheboygan
23,1973-1974,1973-11-03,1974-04-08,157,14,145,435,580,78,456,534,1114,32,214,MI - Cheboygan
24,1974-1975,1974-11-15,1975-04-19,156,9,81,441,522,106,560,666,1188,26,204,MI - Cheboygan
26,1976-1977,1976-11-08,1977-04-11,155,7,203,611,814,96,595,691,1505,48,453,MI - Cheboygan
27,1977-1978,1977-11-13,1978-03-31,139,4,164,591,755,91,847,938,1693,37,300,MI - Cheboygan
28,1978-1979,1978-11-20,1979-04-09,141,15,197,596,793,135,935,1070,1863,53,506,MI - Cheboygan
29,1979-1980,1979-11-29,1980-04-16,140,3,122,491,613,103,279,382,995,38,283,MI - Cheboygan
30,1980-1981,1980-11-11,1981-04-06,147,2,139,512,651,96,471,567,1218,35,314,MI - Cheboygan
32,1982-1983,1982-11-13,1983-04-15,154,8,77,363,440,64,215,279,719,22,140,MI - Cheboygan
34,1984-1985,1984-11-11,1985-04-08,149,11,144,469,613,200,749,949,1562,53,495,MI - Cheboygan
35,1985-1986,1985-11-08,1986-03-27,140,5,150,545,695,171,839,1010,1705,52,441,MI - Cheboygan
36,1986-1987,1986-11-09,1987-04-02,145,5,73,391,464,115,269,384,848,43,279,MI - Cheboygan
37,1987-1988,1987-11-19,1988-04-14,148,5,130,483,613,129,452,581,1194,45,361,MI - Cheboygan
38,1988-1989,1988-11-17,1989-04-11,146,12,139,520,659,167,549,716,1375,50,450,MI - Cheboygan
39,1989-1990,1989-10-03,1990-04-17,197,8,126,565,691,172,691,863,1554,54,421,MI - Cheboygan
42,1992-1993,1992-11-06,1993-04-22,168,7,108,491,599,117,413,530,1129,50,337,MI - Cheboygan
44,1994-1995,1994-11-23,1995-04-06,135,5,101,402,503,113,387,500,1003,39,337,MI - Cheboygan
45,1995-1996,1995-11-04,1996-04-24,173,10,185,707,892,197,765,962,1854,63,537,MI - Cheboygan
46,1996-1997,1996-11-02,1997-04-17,167,16,135,531,666,246,925,1171,1837,72,589,MI - Cheboygan
47,1997-1998,1997-11-12,1998-03-28,137,9,62,287,349,104,374,478,827,32,217,MI - Cheboygan
48,1998-1999,1998-11-16,1999-03-24,129,6,87,431,518,140,556,696,1214,39,359,MI - Cheboygan
49,1999-2000,1999-11-29,2000-04-17,141,4,76,418,494,99,334,433,927,33,275,MI - Cheboygan
50,2000-2001,2000-11-19,2001-04-17,150,6,118,424,542,146,693,839,1381,60,394,MI - Cheboygan
51,2001-2002,2001-10-07,2002-04-28,204,7,66,352,418,160,511,671,1089,46,350,MI - Cheboygan
52,2002-2003,2002-11-16,2003-04-12,148,4,181,543,724,123,471,594,1318,45,399,MI - Cheboygan
53,2003-2004,2003-11-08,2004-03-31,145,6,116,391,507,152,667,819,1326,40,315,MI - Cheboygan
55,2005-2006,2005-11-18,2006-04-05,139,5,80,361,441,130,446,576,1017,42,275,MI - Cheboygan
56,2006-2007,2006-10-12,2007-04-15,186,3,113,414,527,117,389,506,1033,38,281,MI - Cheboygan
57,2007-2008,2007-11-24,2008-04-14,143,8,117,453,570,133,586,719,1289,45,316,MI - Cheboygan
58,2008-2009,2008-11-19,2009-03-31,133,3,152,522,674,146,567,713,1387,46,368,MI - Cheboygan
59,2009-2010,2009-12-01,2010-03-27,117,0,86,352,438,66,311,377,815,26,179,MI - Cheboygan
60,2010-2011,2010-11-24,2011-04-21,149,0,134,474,608,108,413,521,1129,36,283,MI - Cheboygan
61,2011-2012,2011-12-01,2012-04-20,142,0,46,271,317,77,185,262,579,20,146,MI - Cheboygan
62,2012-2013,2012-11-13,2013-04-14,153,0,97,399,496,119,506,625,1121,45,326,MI - Cheboygan
63,2013-2014,2013-11-11,2014-04-16,157,0,233,724,957,198,933,1131,2088,52,547,MI - Cheboygan
64,2014-2015,2014-11-10,2015-04-07,149,0,177,626,803,121,469,590,1393,44,361,MI - Cheboygan
65,2015-2016,2015-11-20,2016-04-14,147,0,75,322,397,134,481,615,1012,36,271,MI - Cheboygan
66,2016-2017,2016-11-20,2017-03-23,124,4,85,306,391,120,331,451,842,40,277,MI - Cheboygan
67,2017-2018,2017-11-09,2018-04-22,165,1,151,523,674,122,393,515,1189,40,314,MI - Cheboygan
68,2018-2019,2018-11-10,2019-04-12,154,0,150,522,672,128,636,764,1436,44,352,MI - Cheboygan
69,2019-2020,2019-11-07,2020-04-22,168,0,67,359,426,101,414,515,941,37,220,MI - Cheboygan
0,1950-1951,1950-11-10,1951-04-01,143,0,91,282,373,72,146,218,591,40,208,MI - Detroit
1,1951-1952,1951-11-02,1952-03-27,147,0,64,276,340,95,170,265,605,47,232,MI - Detroit
2,1952-1953,1952-11-27,1953-04-20,145,0,36,172,208,37,19,56,264,30,111,MI - Detroit
3,1953-1954,1953-11-07,1954-05-04,179,0,47,231,278,62,106,168,446,35,138,MI - Detroit
4,1954-1955,1954-11-02,1955-03-28,147,0,57,235,292,51,59,110,402,35,140,MI - Detroit
5,1955-1956,1955-11-08,1956-04-17,162,0,62,278,340,76,122,198,538,42,170,MI - Detroit
6,1956-1957,1956-11-21,1957-04-13,144,0,69,263,332,79,169,248,580,47,189,MI - Detroit
7,1957-1958,1957-11-21,1958-04-07,138,0,65,244,309,41,45,86,395,35,136,MI - Detroit
8,1958-1959,1958-11-24,1959-03-27,124,0,102,354,456,62,193,255,711,38,226,MI - Detroit
9,1959-1960,1959-11-12,1960-03-27,137,0,65,259,324,81,207,288,612,51,223,MI - Detroit
10,1960-1961,1960-11-29,1961-04-17,140,0,87,274,361,37,59,96,457,29,158,MI - Detroit
11,1961-1962,1961-12-01,1962-04-14,135,0,93,288,381,53,117,170,551,34,190,MI - Detroit
12,1962-1963,1962-11-17,1963-03-21,125,0,151,370,521,54,187,241,762,41,265,MI - Detroit
13,1963-1964,1963-12-01,1964-04-08,130,0,65,249,314,59,119,178,492,39,173,MI - Detroit
14,1964-1965,1964-11-19,1965-04-17,150,0,84,292,376,77,170,247,623,40,199,MI - Detroit
15,1965-1966,1965-11-28,1966-04-11,135,0,75,240,315,39,67,106,421,36,143,MI - Detroit
16,1966-1967,1966-11-02,1967-04-24,174,0,62,300,362,80,255,335,697,42,175,MI - Detroit
17,1967-1968,1967-11-04,1968-04-24,173,0,81,358,439,55,118,173,612,33,187,MI - Detroit
18,1968-1969,1968-12-01,1969-04-18,139,0,64,314,378,34,63,97,475,25,102,MI - Detroit
19,1969-1970,1969-11-19,1970-04-03,136,0,95,403,498,74,208,282,780,44,261,MI - Detroit
20,1970-1971,1970-11-14,1971-04-24,162,0,87,340,427,66,72,138,565,43,207,MI - Detroit
21,1971-1972,1971-11-09,1972-04-07,151,0,74,325,399,52,47,99,498,38,172,MI - Detroit
22,1972-1973,1972-11-14,1973-04-09,147,0,53,234,287,71,78,149,436,35,150,MI - Detroit
23,1973-1974,1973-11-09,1974-04-07,150,0,77,286,363,80,170,250,613,39,237,MI - Detroit
24,1974-1975,1974-11-13,1975-04-05,144,0,48,260,308,102,222,324,632,47,202,MI - Detroit
25,1975-1976,1975-11-21,1976-04-25,157,0,65,330,395,92,247,339,734,45,222,MI - Detroit
26,1976-1977,1976-11-04,1977-04-07,155,0,133,455,588,78,206,284,872,49,313,MI - Detroit
27,1977-1978,1977-11-11,1978-04-21,162,0,118,452,570,95,381,476,1046,41,271,MI - Detroit
28,1978-1979,1978-11-21,1979-04-09,140,0,124,391,515,65,200,265,780,43,247,MI - Detroit
29,1979-1980,1979-11-08,1980-04-24,169,0,74,343,417,55,34,89,506,38,173,MI - Detroit
30,1980-1981,1980-10-27,1981-03-19,144,0,85,371,456,66,171,237,693,35,186,MI - Detroit
31,1981-1982,1981-10-23,1982-04-11,171,0,123,428,551,115,365,480,1031,47,338,MI - Detroit
32,1982-1983,1982-11-26,1983-04-17,143,0,32,206,238,33,33,66,304,18,73,MI - Detroit
33,1983-1984,1983-11-11,1984-04-17,159,0,129,390,519,85,180,265,784,40,228,MI - Detroit
34,1984-1985,1984-11-11,1985-04-08,149,0,76,336,412,83,222,305,717,39,247,MI - Detroit
35,1985-1986,1985-11-15,1986-04-22,159,0,98,344,442,89,203,292,734,52,282,MI - Detroit
36,1986-1987,1986-11-11,1987-04-02,143,0,36,238,274,72,97,169,443,30,141,MI - Detroit
37,1987-1988,1987-11-19,1988-04-15,149,0,71,298,369,81,118,199,568,44,228,MI - Detroit
38,1988-1989,1988-11-06,1989-04-09,155,0,58,276,334,45,34,79,413,31,142,MI - Detroit
39,1989-1990,1989-10-19,1990-04-11,175,0,74,300,374,66,110,176,550,39,201,MI - Detroit
40,1990-1991,1990-12-01,1991-03-11,101,0,45,211,256,54,79,133,389,30,155,MI - Detroit
41,1991-1992,1991-11-03,1992-04-01,151,0,46,246,292,77,120,197,489,43,204,MI - Detroit
42,1992-1993,1992-10-20,1993-04-17,180,0,50,253,303,82,169,251,554,36,166,MI - Detroit
43,1993-1994,1993-10-30,1994-04-07,160,0,106,351,457,81,163,244,701,43,263,MI - Detroit
44,1994-1995,1994-12-01,1995-04-09,130,0,52,231,283,54,114,168,451,25,132,MI - Detroit
45,1995-1996,1995-11-08,1996-04-09,154,13,107,381,488,50,64,114,602,33,164,MI - Detroit
46,1996-1997,1996-11-11,1997-04-17,158,3,68,286,354,77,78,155,509,47,256,MI - Detroit
47,1997-1998,1997-10-27,1998-03-22,147,0,22,157,179,43,69,112,291,26,80,MI - Detroit
48,1998-1999,1998-12-01,1999-03-15,105,0,60,235,295,70,215,285,580,23,167,MI - Detroit
49,1999-2000,1999-12-01,2000-04-11,133,0,58,233,291,40,117,157,448,24,132,MI - Detroit
50,2000-2001,2000-11-14,2001-04-17,155,0,74,311,385,76,255,331,716,51,258,MI - Detroit
51,2001-2002,2001-12-01,2002-03-27,117,0,27,159,186,53,63,116,302,30,127,MI - Detroit
52,2002-2003,2002-11-22,2003-04-09,139,0,94,351,445,98,195,293,738,50,307,MI - Detroit
53,2003-2004,2003-11-28,2004-03-18,112,0,70,249,319,45,132,177,496,30,121,MI - Detroit
54,2004-2005,2004-11-25,2005-05-03,160,0,70,280,350,97,209,306,656,37,194,MI - Detroit
55,2005-2006,2005-11-17,2006-03-25,129,0,41,210,251,61,101,162,413,36,153,MI - Detroit
56,2006-2007,2006-10-12,2007-04-14,185,0,76,260,336,59,78,137,473,41,212,MI - Detroit
57,2007-2008,2007-11-25,2008-03-28,125,0,59,264,323,111,176,287,610,50,254,MI - Detroit
58,2008-2009,2008-11-16,2009-04-07,143,0,91,346,437,104,263,367,804,46,278,MI - Detroit
59,2009-2010,2009-12-01,2010-03-04,94,0,54,196,250,71,145,216,466,34,164,MI - Detroit
60,2010-2011,2010-12-01,2011-04-18,139,0,93,305,398,108,358,466,864,45,265,MI - Detroit
61,2011-2012,2011-11-30,2012-03-09,101,0,20,137,157,42,43,85,242,27,103,MI - Detroit
62,2012-2013,2012-11-23,2013-04-20,149,0,48,229,277,75,143,218,495,39,209,MI - Detroit
63,2013-2014,2013-11-11,2014-04-16,157,0,149,448,597,144,536,680,1277,56,433,MI - Detroit
64,2014-2015,2014-11-13,2015-03-23,131,0,117,375,492,72,361,433,925,36,270,MI - Detroit
65,2015-2016,2015-11-21,2016-04-10,142,0,37,187,224,59,87,146,370,33,151,MI - Detroit
66,2016-2017,2016-11-19,2017-04-06,139,0,45,182,227,67,126,193,420,35,156,MI - Detroit
67,2017-2018,2017-11-10,2018-04-17,159,0,89,309,398,94,232,326,724,40,262,MI - Detroit
68,2018-2019,2018-11-09,2019-04-01,144,0,63,275,338,59,72,131,469,39,180,MI - Detroit
69,2019-2020,2019-11-07,2020-05-10,186,0,21,194,215,69,107,176,391,35,136,MI - Detroit
0,1950-1951,1950-11-04,1951-04-03,151,0,106,374,480,69,164,233,713,48,258,MI - Flint
1,1951-1952,1951-11-03,1952-04-07,157,0,89,371,460,110,218,328,788,45,286,MI - Flint
2,1952-1953,1952-10-28,1953-04-20,175,0,44,272,316,45,40,85,401,35,160,MI - Flint
3,1953-1954,1953-11-26,1954-04-03,129,0,64,319,383,81,158,239,622,38,189,MI - Flint
4,1954-1955,1954-11-29,1955-03-27,119,0,81,318,399,56,69,125,524,29,139,MI - Flint
5,1955-1956,1955-11-07,1956-04-17,163,0,87,411,498,68,149,217,715,46,214,MI - Flint
6,1956-1957,1956-11-16,1957-04-13,149,0,84,368,452,61,133,194,646,46,214,MI - Flint
7,1957-1958,1957-11-09,1958-03-21,133,0,94,355,449,53,137,190,639,43,210,MI - Flint
8,1958-1959,1958-11-24,1959-04-08,136,0,142,526,668,96,351,447,1115,45,333,MI - Flint
9,1959-1960,1959-11-12,1960-04-09,150,0,93,402,495,108,240,348,843,69,359,MI - Flint
10,1960-1961,1960-11-09,1961-05-26,199,0,102,407,509,64,78,142,651,46,275,MI - Flint
11,1961-1962,1961-12-01,1962-04-15,136,0,123,407,530,67,219,286,816,40,244,MI - Flint
12,1962-1963,1962-10-23,1963-04-30,190,0,176,531,707,67,254,321,1028,44,290,MI - Flint
13,1963-1964,1963-12-01,1964-04-08,130,0,73,356,429,61,144,205,634,43,224,MI - Flint
14,1964-1965,1964-11-19,1965-04-17,150,0,99,392,491,111,220,331,822,53,340,MI - Flint
15,1965-1966,1965-11-13,1966-04-07,146,0,86,309,395,66,141,207,602,47,230,MI - Flint
16,1966-1967,1966-11-02,1967-03-23,142,0,97,412,509,119,422,541,1050,52,313,MI - Flint
17,1967-1968,1967-10-27,1968-04-25,182,0,89,384,473,71,115,186,659,40,236,MI - Flint
18,1968-1969,1968-11-12,1969-03-30,139,0,83,338,421,47,106,153,574,30,156,MI - Flint
19,1969-1970,1969-11-15,1970-04-05,142,0,117,437,554,94,218,312,866,56,345,MI - Flint
20,1970-1971,1970-11-14,1971-04-24,162,0,113,355,468,92,202,294,762,53,281,MI - Flint
21,1971-1972,1971-11-09,1972-04-07,151,0,88,344,432,86,145,231,663,52,251,MI - Flint
22,1972-1973,1972-11-13,1973-05-04,173,0,59,262,321,95,242,337,658,45,188,MI - Flint
23,1973-1974,1973-12-01,1974-04-05,126,0,90,313,403,74,205,279,682,38,259,MI - Flint
24,1974-1975,1974-11-13,1975-04-11,150,0,53,297,350,124,251,375,725,50,249,MI - Flint
25,1975-1976,1975-11-24,1976-04-26,155,0,70,331,401,119,342,461,862,55,284,MI - Flint
26,1976-1977,1976-11-20,1977-04-07,139,0,186,474,660,86,268,354,1014,62,472,MI - Flint
27,1977-1978,1977-11-11,1978-04-21,162,0,148,495,643,85,429,514,1157,53,356,MI - Flint
28,1978-1979,1978-11-20,1979-04-09,141,0,164,426,590,88,300,388,978,47,302,MI - Flint
29,1979-1980,1979-11-08,1980-04-25,170,0,96,360,456,70,84,154,610,46,226,MI - Flint
30,1980-1981,1980-11-27,1981-03-26,120,0,95,344,439,71,218,289,728,49,255,MI - Flint
31,1981-1982,1981-11-20,1982-04-10,142,0,141,415,556,97,320,417,973,52,352,MI - Flint
32,1982-1983,1982-11-05,1983-04-19,166,0,32,218,250,55,67,122,372,28,104,MI - Flint
33,1983-1984,1983-11-11,1984-04-22,164,0,151,442,593,71,243,314,907,43,259,MI - Flint
34,1984-1985,1984-11-11,1985-04-17,158,0,83,333,416,78,225,303,719,40,215,MI - Flint
35,1985-1986,1985-11-09,1986-04-22,165,0,121,408,529,83,313,396,925,48,282,MI - Flint
36,1986-1987,1986-11-11,1987-04-05,146,0,47,294,341,65,117,182,523,40,169,MI - Flint
37,1987-1988,1987-10-22,1988-04-16,178,0,93,368,461,69,148,217,678,46,271,MI - Flint
38,1988-1989,1988-11-06,1989-04-10,156,0,74,337,411,57,82,139,550,43,214,MI - Flint
39,1989-1990,1989-10-19,1990-04-11,175,0,91,372,463,81,200,281,744,44,226,MI - Flint
40,1990-1991,1990-12-01,1991-03-29,119,0,68,278,346,58,154,212,558,33,193,MI - Flint
41,1991-1992,1991-11-03,1992-04-04,154,0,63,320,383,90,145,235,618,41,240,MI - Flint
42,1992-1993,1992-10-20,1993-04-17,180,0,70,331,401,88,203,291,692,49,240,MI - Flint
43,1993-1994,1993-10-30,1994-05-01,184,0,146,483,629,79,222,301,930,49,335,MI - Flint
44,1994-1995,1994-11-23,1995-04-09,138,0,83,335,418,75,233,308,726,44,241,MI - Flint
45,1995-1996,1995-11-09,1996-03-26,139,0,129,455,584,71,165,236,820,43,259,MI - Flint
46,1996-1997,1996-11-02,1997-04-13,163,0,99,363,462,69,139,208,670,41,225,MI - Flint
47,1997-1998,1997-10-26,1998-03-17,143,0,37,219,256,47,78,125,381,32,113,MI - Flint
48,1998-1999,1998-11-20,1999-03-17,118,0,81,323,404,77,187,264,668,36,249,MI - Flint
49,1999-2000,1999-12-01,2000-04-11,133,0,69,335,404,54,144,198,602,37,222,MI - Flint
50,2000-2001,2000-11-14,2001-04-17,155,0,95,392,487,93,387,480,967,55,307,MI - Flint
51,2001-2002,2001-12-01,2002-04-22,143,0,40,223,263,75,131,206,469,47,191,MI - Flint
52,2002-2003,2002-11-15,2003-04-09,146,0,112,426,538,83,176,259,797,51,298,MI - Flint
53,2003-2004,2003-11-28,2004-04-27,152,0,82,335,417,77,273,350,767,39,200,MI - Flint
54,2004-2005,2004-11-24,2005-04-25,153,0,99,376,475,106,241,347,822,45,271,MI - Flint
55,2005-2006,2005-11-16,2006-04-05,141,0,65,280,345,96,157,253,598,56,267,MI - Flint
56,2006-2007,2006-10-12,2007-04-11,182,0,94,330,424,79,181,260,684,60,315,MI - Flint
57,2007-2008,2007-11-22,2008-04-13,144,1,71,332,403,128,234,362,765,61,316,MI - Flint
58,2008-2009,2008-11-10,2009-04-08,150,0,125,428,553,116,320,436,989,63,372,MI - Flint
59,2009-2010,2009-12-01,2010-03-21,111,0,73,299,372,70,242,312,684,40,220,MI - Flint
60,2010-2011,2010-11-25,2011-04-18,145,0,109,385,494,114,389,503,997,54,303,MI - Flint
61,2011-2012,2011-11-29,2012-03-30,123,0,27,183,210,57,83,140,350,38,156,MI - Flint
62,2012-2013,2012-10-30,2013-04-19,172,0,59,331,390,76,148,224,614,47,234,MI - Flint
63,2013-2014,2013-11-11,2014-04-15,156,0,165,539,704,131,504,635,1339,65,510,MI - Flint
64,2014-2015,2014-10-31,2015-04-22,174,0,114,456,570,78,327,405,975,46,306,MI - Flint
65,2015-2016,2015-11-21,2016-04-10,142,0,42,213,255,110,183,293,548,44,230,MI - Flint
66,2016-2017,2016-12-01,2017-04-07,128,0,65,228,293,72,115,187,480,41,202,MI - Flint
67,2017-2018,2017-10-31,2018-04-18,170,0,117,421,538,127,310,437,975,49,343,MI - Flint
68,2018-2019,2018-11-09,2019-04-15,158,0,100,360,460,92,170,262,722,55,298,MI - Flint
69,2019-2020,2019-10-31,2020-04-22,175,0,32,238,270,87,163,250,520,43,195,MI - Flint
1,1951-1952,1951-10-24,1952-04-14,174,16,96,556,652,198,859,1057,1709,72,514,MI - Gaylord
2,1952-1953,1952-10-16,1953-04-27,194,13,75,413,488,207,657,864,1352,55,393,MI - Gaylord
4,1954-1955,1954-10-31,1955-04-01,153,5,129,508,637,158,734,892,1529,53,385,MI - Gaylord
5,1955-1956,1955-10-25,1956-05-17,206,9,128,594,722,178,806,984,1706,53,407,MI - Gaylord
6,1956-1957,1956-09-20,1957-04-13,206,8,136,553,689,127,498,625,1314,49,358,MI - Gaylord
7,1957-1958,1957-11-09,1958-04-06,149,6,124,498,622,139,613,752,1374,53,374,MI - Gaylord
8,1958-1959,1958-11-06,1959-04-24,170,3,209,646,855,206,1124,1330,2185,80,714,MI - Gaylord
9,1959-1960,1959-11-02,1960-05-01,182,0,121,560,681,223,1084,1307,1988,86,595,MI - Gaylord
10,1960-1961,1960-10-24,1961-05-02,191,7,144,543,687,187,792,979,1666,62,533,MI - Gaylord
11,1961-1962,1961-11-08,1962-04-19,163,4,165,551,716,271,1152,1423,2139,73,645,MI - Gaylord
12,1962-1963,1962-10-23,1963-04-30,190,0,214,654,868,210,1097,1307,2175,59,589,MI - Gaylord
13,1963-1964,1963-11-01,1964-04-15,167,0,112,503,615,200,936,1136,1751,57,466,MI - Gaylord
14,1964-1965,1964-10-06,1965-04-17,194,1,156,564,720,265,1093,1358,2078,79,695,MI - Gaylord
15,1965-1966,1965-09-26,1966-04-26,213,0,124,442,566,184,478,662,1228,65,465,MI - Gaylord
16,1966-1967,1966-11-01,1967-04-07,158,2,134,487,621,228,991,1219,1840,67,571,MI - Gaylord
17,1967-1968,1967-10-26,1968-03-23,150,0,153,510,663,177,762,939,1602,61,525,MI - Gaylord
18,1968-1969,1968-10-29,1969-04-04,158,0,131,493,624,235,1041,1276,1900,61,527,MI - Gaylord
19,1969-1970,1969-10-22,1970-04-11,172,0,169,585,754,206,1059,1265,2019,74,603,MI - Gaylord
20,1970-1971,1970-10-16,1971-05-12,209,0,164,563,727,297,1433,1730,2457,78,689,MI - Gaylord
21,1971-1972,1971-11-04,1972-04-24,173,1,137,547,684,245,1088,1333,2017,76,639,MI - Gaylord
22,1972-1973,1972-10-15,1973-05-04,202,0,108,424,532,196,598,794,1326,61,445,MI - Gaylord
23,1973-1974,1973-11-05,1974-05-06,183,6,147,467,614,195,749,944,1558,57,451,MI - Gaylord
24,1974-1975,1974-11-12,1975-04-20,160,1,101,431,532,240,1079,1319,1851,76,534,MI - Gaylord
25,1975-1976,1975-11-13,1976-05-03,173,1,123,472,595,244,965,1209,1804,73,583,MI - Gaylord
26,1976-1977,1976-10-19,1977-04-08,172,0,215,633,848,269,1255,1524,2372,90,809,MI - Gaylord
27,1977-1978,1977-11-11,1978-04-14,155,2,147,657,804,227,1179,1406,2210,65,564,MI - Gaylord
28,1978-1979,1978-11-19,1979-05-06,169,3,165,627,792,221,1160,1381,2173,78,644,MI - Gaylord
29,1979-1980,1979-10-11,1980-04-16,189,8,110,587,697,192,711,903,1600,60,465,MI - Gaylord
30,1980-1981,1980-10-26,1981-03-26,152,0,114,541,655,202,826,1028,1683,64,585,MI - Gaylord
31,1981-1982,1981-10-19,1982-04-20,184,8,134,669,803,173,1097,1270,2073,69,555,MI - Gaylord
32,1982-1983,1982-10-16,1983-04-16,183,4,64,443,507,145,482,627,1134,45,295,MI - Gaylord
33,1983-1984,1983-11-11,1984-05-13,185,6,160,642,802,204,953,1157,1959,65,558,MI - Gaylord
35,1985-1986,1985-11-09,1986-04-21,164,6,197,540,737,228,1152,1380,2117,63,590,MI - Gaylord
36,1986-1987,1986-11-09,1987-04-03,146,0,96,412,508,154,652,806,1314,42,328,MI - Gaylord
38,1988-1989,1988-10-12,1989-04-13,184,5,143,525,668,231,861,1092,1760,69,576,MI - Gaylord
39,1989-1990,1989-10-10,1990-05-11,214,5,145,543,688,261,993,1254,1942,65,584,MI - Gaylord
40,1990-1991,1990-10-19,1991-04-10,174,10,127,467,594,205,724,929,1523,59,501,MI - Gaylord
41,1991-1992,1991-10-16,1992-04-11,179,1,135,501,636,205,780,985,1621,58,500,MI - Gaylord
42,1992-1993,1992-10-17,1993-04-21,187,3,149,550,699,224,897,1121,1820,63,507,MI - Gaylord
43,1993-1994,1993-10-03,1994-05-01,211,9,235,663,898,200,766,966,1864,66,624,MI - Gaylord
44,1994-1995,1994-11-22,1995-04-26,156,0,119,414,533,170,548,718,1251,49,438,MI - Gaylord
45,1995-1996,1995-10-31,1996-05-01,184,9,196,654,850,284,1258,1542,2392,69,622,MI - Gaylord
46,1996-1997,1996-10-31,1997-05-13,195,14,167,528,695,294,1103,1397,2092,80,659,MI - Gaylord
47,1997-1998,1997-10-22,1998-03-26,156,2,96,372,468,153,609,762,1230,42,312,MI - Gaylord
48,1998-1999,1998-11-16,1999-03-24,129,2,126,401,527,175,733,908,1435,48,439,MI - Gaylord
49,1999-2000,1999-11-29,2000-04-09,133,3,106,368,474,153,547,700,1174,45,367,MI - Gaylord
50,2000-2001,2000-10-07,2001-04-18,194,5,156,472,628,249,973,1222,1850,73,600,MI - Gaylord
52,2002-2003,2002-10-18,2003-04-09,174,9,177,571,748,229,705,934,1682,56,556,MI - Gaylord
53,2003-2004,2003-10-01,2004-03-28,180,16,131,427,558,247,868,1115,1673,54,487,MI - Gaylord
54,2004-2005,2004-10-17,2005-04-25,191,7,150,516,666,203,779,982,1648,54,471,MI - Gaylord
55,2005-2006,2005-11-10,2006-04-05,147,17,113,380,493,230,878,1108,1601,48,427,MI - Gaylord
56,2006-2007,2006-10-12,2007-04-13,184,5,129,446,575,238,675,913,1488,57,516,MI - Gaylord
57,2007-2008,2007-11-05,2008-04-13,161,6,165,514,679,202,815,1017,1696,76,610,MI - Gaylord
58,2008-2009,2008-10-28,2009-04-22,177,0,203,598,801,239,908,1147,1948,97,792,MI - Gaylord
59,2009-2010,2009-10-13,2010-05-08,208,1,136,440,576,123,596,719,1295,60,411,MI - Gaylord
60,2010-2011,2010-11-06,2011-04-22,168,0,197,540,737,192,591,783,1520,83,659,MI - Gaylord
61,2011-2012,2011-11-11,2012-04-21,163,0,94,350,444,154,543,697,1141,58,381,MI - Gaylord
62,2012-2013,2012-10-07,2013-05-13,219,0,155,487,642,225,816,1041,1683,90,624,MI - Gaylord
63,2013-2014,2013-10-22,2014-05-16,207,0,310,759,1069,251,1131,1382,2451,98,931,MI - Gaylord
64,2014-2015,2014-11-01,2015-04-23,174,0,259,775,1034,205,773,978,2012,81,705,MI - Gaylord
65,2015-2016,2015-10-17,2016-04-15,182,0,123,459,582,172,643,815,1397,71,535,MI - Gaylord
66,2016-2017,2016-10-27,2017-04-12,168,3,140,428,568,193,676,869,1437,70,554,MI - Gaylord
67,2017-2018,2017-10-31,2018-04-29,181,0,220,638,858,201,761,962,1820,81,719,MI - Gaylord
68,2018-2019,2018-10-18,2019-04-15,180,0,230,645,875,184,869,1053,1928,82,660,MI - Gaylord
69,2019-2020,2019-10-31,2020-05-10,193,0,138,502,640,176,792,968,1608,77,506,MI - Gaylord
0,1950-1951,1950-11-10,1951-04-16,158,0,103,354,457,129,281,410,867,71,402,MI - Grand Rapids
1,1951-1952,1951-11-01,1952-04-06,158,0,84,355,439,194,280,474,913,61,417,MI - Grand Rapids
2,1952-1953,1952-11-26,1953-04-20,146,0,48,241,289,66,48,114,403,45,183,MI - Grand Rapids
3,1953-1954,1953-11-25,1954-05-05,162,0,44,284,328,117,185,302,630,56,283,MI - Grand Rapids
4,1954-1955,1954-10-29,1955-03-28,151,0,62,311,373,105,193,298,671,51,278,MI - Grand Rapids
5,1955-1956,1955-11-02,1956-04-17,168,0,73,364,437,130,146,276,713,68,332,MI - Grand Rapids
6,1956-1957,1956-11-07,1957-04-13,158,0,70,327,397,104,138,242,639,69,341,MI - Grand Rapids
7,1957-1958,1957-11-08,1958-03-20,133,0,79,320,399,110,369,479,878,55,297,MI - Grand Rapids
8,1958-1959,1958-11-24,1959-04-10,138,0,127,439,566,153,599,752,1318,71,495,MI - Grand Rapids
9,1959-1960,1959-11-06,1960-04-09,156,0,76,345,421,139,392,531,952,68,349,MI - Grand Rapids
10,1960-1961,1960-11-09,1961-04-28,171,0,83,342,425,114,241,355,780,53,351,MI - Grand Rapids
11,1961-1962,1961-11-17,1962-04-14,149,0,113,368,481,136,407,543,1024,66,436,MI - Grand Rapids
12,1962-1963,1962-10-24,1963-04-30,189,0,145,461,606,136,522,658,1264,64,479,MI - Grand Rapids
13,1963-1964,1963-11-02,1964-04-03,154,0,78,342,420,113,253,366,786,54,330,MI - Grand Rapids
14,1964-1965,1964-11-19,1965-04-17,150,0,110,409,519,150,317,467,986,67,463,MI - Grand Rapids
15,1965-1966,1965-11-28,1966-04-07,131,0,80,317,397,106,234,340,737,50,291,MI - Grand Rapids
16,1966-1967,1966-11-02,1967-03-23,142,0,63,328,391,138,460,598,989,60,325,MI - Grand Rapids
17,1967-1968,1967-10-26,1968-04-25,183,0,95,383,478,94,169,263,741,51,306,MI - Grand Rapids
18,1968-1969,1968-11-08,1969-03-31,144,0,109,387,496,110,248,358,854,52,330,MI - Grand Rapids
19,1969-1970,1969-11-13,1970-04-06,145,0,116,460,576,130,312,442,1018,64,439,MI - Grand Rapids
20,1970-1971,1970-11-22,1971-04-23,153,0,120,399,519,153,490,643,1162,66,442,MI - Grand Rapids
21,1971-1972,1971-11-03,1972-04-07,157,0,98,385,483,125,208,333,816,71,385,MI - Grand Rapids
22,1972-1973,1972-10-18,1973-05-03,198,0,73,303,376,106,289,395,771,51,266,MI - Grand Rapids
23,1973-1974,1973-11-09,1974-04-23,166,0,94,344,438,98,264,362,800,56,310,MI - Grand Rapids
24,1974-1975,1974-10-19,1975-04-09,173,0,85,356,441,113,225,338,779,60,290,MI - Grand Rapids
25,1975-1976,1975-11-24,1976-05-03,162,0,71,368,439,105,397,502,941,54,318,MI - Grand Rapids
26,1976-1977,1976-10-19,1977-04-07,171,0,148,510,658,121,357,478,1136,78,517,MI - Grand Rapids
27,1977-1978,1977-11-10,1978-03-26,137,0,126,486,612,127,567,694,1306,61,411,MI - Grand Rapids
28,1978-1979,1978-11-20,1979-04-06,138,0,138,414,552,143,661,804,1356,62,445,MI - Grand Rapids
29,1979-1980,1979-11-08,1980-04-24,169,0,65,315,380,77,149,226,606,50,258,MI - Grand Rapids
30,1980-1981,1980-10-25,1981-03-20,147,0,83,350,433,83,264,347,780,45,268,MI - Grand Rapids
31,1981-1982,1981-11-20,1982-04-12,144,0,111,388,499,116,322,438,937,59,413,MI - Grand Rapids
32,1982-1983,1982-11-04,1983-04-16,164,0,37,237,274,57,55,112,386,30,116,MI - Grand Rapids
33,1983-1984,1983-11-11,1984-04-22,164,0,121,401,522,114,350,464,986,63,425,MI - Grand Rapids
34,1984-1985,1984-12-01,1985-04-09,130,0,100,332,432,109,393,502,934,56,365,MI - Grand Rapids
35,1985-1986,1985-11-09,1986-04-15,158,0,112,372,484,116,385,501,985,63,412,MI - Grand Rapids
36,1986-1987,1986-11-12,1987-04-02,142,0,50,275,325,70,129,199,524,37,184,MI - Grand Rapids
37,1987-1988,1987-10-21,1988-04-15,178,0,95,369,464,102,222,324,788,60,352,MI - Grand Rapids
38,1988-1989,1988-10-25,1989-04-12,170,0,92,351,443,96,170,266,709,52,304,MI - Grand Rapids
39,1989-1990,1989-10-19,1990-05-10,204,0,87,367,454,138,228,366,820,62,377,MI - Grand Rapids
40,1990-1991,1990-11-05,1991-03-31,147,0,68,279,347,92,137,229,576,45,287,MI - Grand Rapids
41,1991-1992,1991-10-18,1992-04-13,179,0,55,285,340,127,138,265,605,54,293,MI - Grand Rapids
42,1992-1993,1992-10-18,1993-04-17,182,0,69,314,383,104,192,296,679,56,273,MI - Grand Rapids
43,1993-1994,1993-11-06,1994-05-01,177,0,141,442,583,118,342,460,1043,55,462,MI - Grand Rapids
44,1994-1995,1994-11-28,1995-04-09,133,0,70,268,338,86,208,294,632,44,248,MI - Grand Rapids
45,1995-1996,1995-11-03,1996-04-09,159,0,135,444,579,122,216,338,917,61,379,MI - Grand Rapids
46,1996-1997,1996-11-09,1997-04-13,156,0,101,330,431,140,225,365,796,63,398,MI - Grand Rapids
47,1997-1998,1997-10-26,1998-03-19,145,0,47,202,249,94,178,272,521,47,211,MI - Grand Rapids
48,1998-1999,1998-11-11,1999-03-15,125,0,79,273,352,109,218,327,679,36,293,MI - Grand Rapids
49,1999-2000,1999-11-03,2000-04-11,161,0,59,281,340,79,152,231,571,36,210,MI - Grand Rapids
50,2000-2001,2000-10-07,2001-04-17,193,0,97,356,453,154,331,485,938,69,400,MI - Grand Rapids
51,2001-2002,2001-10-25,2002-04-22,180,0,42,234,276,147,179,326,602,43,275,MI - Grand Rapids
52,2002-2003,2002-11-05,2003-04-08,155,0,124,404,528,138,219,357,885,58,398,MI - Grand Rapids
53,2003-2004,2003-11-24,2004-04-27,156,0,81,297,378,108,311,419,797,44,269,MI - Grand Rapids
54,2004-2005,2004-11-24,2005-04-24,152,0,92,322,414,128,239,367,781,55,332,MI - Grand Rapids
55,2005-2006,2005-11-16,2006-03-25,130,0,59,239,298,105,144,249,547,56,274,MI - Grand Rapids
56,2006-2007,2006-10-12,2007-04-13,184,0,91,295,386,124,325,449,835,51,336,MI - Grand Rapids
57,2007-2008,2007-11-21,2008-03-28,129,0,76,299,375,160,343,503,878,64,356,MI - Grand Rapids
58,2008-2009,2008-11-09,2009-03-29,141,0,106,355,461,151,325,476,937,59,396,MI - Grand Rapids
59,2009-2010,2009-11-27,2010-03-21,115,0,63,218,281,106,328,434,715,42,208,MI - Grand Rapids
60,2010-2011,2010-11-05,2011-04-18,165,0,88,312,400,116,362,478,878,53,292,MI - Grand Rapids
61,2011-2012,2011-11-10,2012-03-09,121,0,24,157,181,77,92,169,350,32,146,MI - Grand Rapids
62,2012-2013,2012-11-12,2013-04-25,165,0,60,277,337,109,190,299,636,57,285,MI - Grand Rapids
63,2013-2014,2013-11-11,2014-04-15,156,0,164,461,625,170,689,859,1484,75,568,MI - Grand Rapids
64,2014-2015,2014-11-12,2015-04-22,162,0,130,407,537,121,334,455,992,48,346,MI - Grand Rapids
65,2015-2016,2015-11-21,2016-04-10,142,0,49,210,259,90,133,223,482,38,220,MI - Grand Rapids
66,2016-2017,2016-11-19,2017-04-06,139,0,61,215,276,88,139,227,503,40,227,MI - Grand Rapids
67,2017-2018,2017-10-31,2018-04-18,170,0,100,345,445,115,223,338,783,54,367,MI - Grand Rapids
68,2018-2019,2018-11-09,2019-04-15,158,0,94,315,409,124,230,354,763,57,345,MI - Grand Rapids
69,2019-2020,2019-10-30,2020-04-16,170,0,35,225,260,86,129,215,475,43,187,MI - Grand Rapids
18,1968-1969,1968-10-03,1969-05-17,227,1,199,764,963,419,1467,1886,2849,100,993,MI - Herman
19,1969-1970,1969-10-13,1970-05-05,205,0,236,893,1129,315,1259,1574,2703,115,1115,MI - Herman
20,1970-1971,1970-09-28,1971-05-12,227,0,241,843,1084,382,1510,1892,2976,107,1071,MI - Herman
21,1971-1972,1971-11-03,1972-05-07,187,0,252,902,1154,390,1577,1967,3121,109,1165,MI - Herman
22,1972-1973,1972-10-15,1973-05-13,211,0,186,698,884,270,1110,1380,2264,96,801,MI - Herman
23,1973-1974,1973-10-16,1974-05-06,203,0,226,834,1060,276,1167,1443,2503,99,919,MI - Herman
24,1974-1975,1974-09-21,1975-04-29,221,1,177,724,901,406,1425,1831,2732,101,961,MI - Herman
25,1975-1976,1975-09-13,1976-05-03,234,1,200,762,962,419,1357,1776,2738,96,1069,MI - Herman
26,1976-1977,1976-10-13,1977-04-24,194,2,308,896,1204,358,1386,1744,2948,117,1275,MI - Herman
27,1977-1978,1977-10-12,1978-04-30,201,3,239,798,1037,339,1390,1729,2766,104,1040,MI - Herman
28,1978-1979,1978-10-15,1979-05-05,203,2,318,902,1220,413,1689,2102,3322,102,1225,MI - Herman
29,1979-1980,1979-10-09,1980-04-25,200,0,218,783,1001,347,1364,1711,2712,108,981,MI - Herman
30,1980-1981,1980-10-11,1981-05-09,211,0,229,716,945,354,1188,1542,2487,98,1001,MI - Herman
31,1981-1982,1981-10-01,1982-05-01,213,0,267,858,1125,393,1502,1895,3020,112,1148,MI - Herman
32,1982-1983,1982-10-17,1983-04-29,195,2,166,580,746,405,1283,1688,2434,93,865,MI - Herman
33,1983-1984,1983-10-14,1984-05-09,209,9,255,807,1062,364,1324,1688,2750,90,969,MI - Herman
34,1984-1985,1984-09-26,1985-04-19,206,11,249,715,964,399,1245,1644,2608,87,1023,MI - Herman
35,1985-1986,1985-10-01,1986-05-01,213,3,275,718,993,433,1513,1946,2939,109,1205,MI - Herman
36,1986-1987,1986-10-14,1987-04-07,176,6,157,489,646,233,918,1151,1797,68,616,MI - Herman
37,1987-1988,1987-10-02,1988-04-23,205,4,218,665,883,423,1500,1923,2806,97,1009,MI - Herman
38,1988-1989,1988-10-12,1989-05-06,207,0,229,739,968,321,1390,1711,2679,100,885,MI - Herman
39,1989-1990,1989-09-23,1990-05-11,231,8,204,700,904,310,1072,1382,2286,87,834,MI - Herman
40,1990-1991,1990-10-07,1991-05-07,213,0,199,663,862,209,867,1076,1938,66,607,MI - Herman
41,1991-1992,1991-10-06,1992-04-25,203,0,182,643,825,249,1320,1569,2394,65,641,MI - Herman
42,1992-1993,1992-10-14,1993-04-23,192,5,207,675,882,264,1256,1520,2402,77,687,MI - Herman
43,1993-1994,1993-10-21,1994-04-29,191,16,271,774,1045,218,1091,1309,2354,59,572,MI - Herman
46,1996-1997,1996-10-10,1997-05-17,220,8,291,772,1063,558,1654,2212,3275,96,1161,MI - Herman
47,1997-1998,1997-10-21,1998-04-17,179,9,172,491,663,240,969,1209,1872,54,525,MI - Herman
49,1999-2000,1999-10-22,2000-04-20,182,9,145,568,713,208,921,1129,1842,71,569,MI - Herman
52,2002-2003,2002-10-13,2003-04-22,192,19,272,787,1059,276,1143,1419,2478,86,895,MI - Herman
53,2003-2004,2003-09-30,2004-05-02,216,10,213,673,886,296,1209,1505,2391,107,897,MI - Herman
56,2006-2007,2006-10-12,2007-05-20,221,1,274,777,1051,322,1097,1419,2470,85,936,MI - Herman
57,2007-2008,2007-10-24,2008-04-27,187,0,279,801,1080,269,1354,1623,2703,96,912,MI - Herman
58,2008-2009,2008-10-27,2009-05-10,196,0,274,828,1102,294,1326,1620,2722,94,992,MI - Herman
59,2009-2010,2009-10-10,2010-05-09,212,9,148,548,696,264,1158,1422,2118,84,650,MI - Herman
60,2010-2011,2010-10-28,2011-05-03,188,1,268,717,985,294,1450,1744,2729,104,981,MI - Herman
61,2011-2012,2011-10-19,2012-04-26,191,3,151,530,681,284,1167,1451,2132,80,688,MI - Herman
63,2013-2014,2013-10-21,2014-05-16,208,1,464,1036,1500,392,2074,2466,3966,119,1345,MI - Herman
64,2014-2015,2014-10-31,2015-05-19,201,1,367,913,1280,326,1770,2096,3376,107,1140,MI - Herman
66,2016-2017,2016-11-19,2017-05-02,165,9,229,565,794,248,920,1168,1962,76,751,MI - Herman
67,2017-2018,2017-10-25,2018-05-01,189,15,311,746,1057,290,1445,1735,2792,80,834,MI - Herman
68,2018-2019,2018-10-05,2019-05-02,210,1,313,721,1034,368,1653,2021,3055,93,943,MI - Herman
69,2019-2020,2019-10-13,2020-05-09,210,8,224,607,831,321,1507,1828,2659,83,762,MI - Herman
0,1950-1951,1950-11-11,1951-04-18,159,0,132,477,609,101,882,983,1592,45,301,MI - Houghton Lake
3,1953-1954,1953-11-26,1954-05-05,161,5,79,404,483,70,344,414,897,43,243,MI - Houghton Lake
4,1954-1955,1954-10-29,1955-03-31,154,13,95,469,564,74,597,671,1235,37,224,MI - Houghton Lake
5,1955-1956,1955-10-24,1956-04-07,167,5,94,556,650,105,758,863,1513,49,318,MI - Houghton Lake
6,1956-1957,1956-11-08,1957-04-07,151,10,102,470,572,91,301,392,964,46,301,MI - Houghton Lake
7,1957-1958,1957-11-09,1958-03-19,131,1,96,388,484,73,429,502,986,41,258,MI - Houghton Lake
8,1958-1959,1958-11-26,1959-04-09,135,4,175,585,760,105,866,971,1731,40,322,MI - Houghton Lake
9,1959-1960,1959-11-02,1960-04-09,160,1,97,522,619,126,731,857,1476,55,347,MI - Houghton Lake
10,1960-1961,1960-11-06,1961-04-17,163,0,123,451,574,68,282,350,924,35,237,MI - Houghton Lake
11,1961-1962,1961-11-08,1962-03-28,141,1,140,479,619,96,752,848,1467,40,278,MI - Houghton Lake
12,1962-1963,1962-10-23,1963-04-30,190,1,189,595,784,115,740,855,1639,42,344,MI - Houghton Lake
13,1963-1964,1963-11-02,1964-04-08,159,2,92,436,528,65,283,348,876,32,195,MI - Houghton Lake
14,1964-1965,1964-10-05,1965-04-20,198,0,163,609,772,144,450,594,1366,78,546,MI - Houghton Lake
15,1965-1966,1965-10-28,1966-05-07,192,0,120,486,606,110,234,344,950,71,431,MI - Houghton Lake
16,1966-1967,1966-11-02,1967-04-07,157,0,133,560,693,130,508,638,1331,66,473,MI - Houghton Lake
17,1967-1968,1967-09-29,1968-04-25,210,0,154,551,705,89,231,320,1025,54,358,MI - Houghton Lake
18,1968-1969,1968-10-25,1969-05-11,199,0,132,572,704,148,579,727,1431,73,500,MI - Houghton Lake
19,1969-1970,1969-10-21,1970-04-09,171,0,158,651,809,169,709,878,1687,84,637,MI - Houghton Lake
20,1970-1971,1970-11-14,1971-04-24,162,0,163,579,742,190,646,836,1578,83,598,MI - Houghton Lake
21,1971-1972,1971-11-04,1972-04-11,160,0,151,591,742,150,534,684,1426,79,529,MI - Houghton Lake
22,1972-1973,1972-10-17,1973-05-16,212,0,118,452,570,121,364,485,1055,65,405,MI - Houghton Lake
23,1973-1974,1973-11-06,1974-05-06,182,0,150,531,681,109,353,462,1143,66,421,MI - Houghton Lake
24,1974-1975,1974-11-12,1975-04-05,145,0,110,454,564,112,395,507,1071,71,385,MI - Houghton Lake
25,1975-1976,1975-11-13,1976-05-03,173,0,127,492,619,148,500,648,1267,81,526,MI - Houghton Lake
26,1976-1977,1976-10-16,1977-04-07,174,0,218,641,859,122,567,689,1548,85,627,MI - Houghton Lake
27,1977-1978,1977-11-10,1978-04-20,162,0,165,658,823,149,840,989,1812,71,532,MI - Houghton Lake
28,1978-1979,1978-11-19,1979-05-05,168,0,202,605,807,144,786,930,1737,73,555,MI - Houghton Lake
29,1979-1980,1979-10-10,1980-04-24,198,0,122,536,658,107,319,426,1084,75,418,MI - Houghton Lake
30,1980-1981,1980-10-03,1981-04-05,185,0,130,523,653,125,457,582,1235,71,503,MI - Houghton Lake
31,1981-1982,1981-10-18,1982-04-17,182,0,165,578,743,156,705,861,1604,73,563,MI - Houghton Lake
32,1982-1983,1982-10-21,1983-05-07,199,0,80,370,450,84,254,338,788,49,218,MI - Houghton Lake
33,1983-1984,1983-11-11,1984-05-01,173,0,168,540,708,104,403,507,1215,68,435,MI - Houghton Lake
34,1984-1985,1984-11-02,1985-04-17,167,0,133,500,633,125,498,623,1256,65,458,MI - Houghton Lake
35,1985-1986,1985-11-09,1986-04-21,164,0,167,512,679,122,687,809,1488,70,523,MI - Houghton Lake
36,1986-1987,1986-11-11,1987-04-03,144,0,76,409,485,68,319,387,872,48,247,MI - Houghton Lake
37,1987-1988,1987-10-22,1988-04-27,189,0,125,493,618,121,376,497,1115,76,437,MI - Houghton Lake
38,1988-1989,1988-11-06,1989-04-12,158,1,131,490,621,112,322,434,1055,72,447,MI - Houghton Lake
39,1989-1990,1989-10-19,1990-05-11,205,0,129,547,676,107,429,536,1212,70,397,MI - Houghton Lake
40,1990-1991,1990-11-05,1991-04-10,157,0,103,417,520,102,277,379,899,57,346,MI - Houghton Lake
41,1991-1992,1991-11-02,1992-04-12,163,0,102,422,524,109,298,407,931,60,367,MI - Houghton Lake
42,1992-1993,1992-10-16,1993-04-17,184,1,116,485,601,105,380,485,1086,64,336,MI - Houghton Lake
43,1993-1994,1993-10-30,1994-05-01,184,0,185,604,789,110,391,501,1290,62,445,MI - Houghton Lake
44,1994-1995,1994-11-22,1995-04-07,137,0,94,377,471,77,292,369,840,51,292,MI - Houghton Lake
45,1995-1996,1995-11-04,1996-05-12,191,2,166,642,808,185,650,835,1643,81,575,MI - Houghton Lake
49,1999-2000,1999-11-29,2000-04-08,132,0,100,380,480,64,261,325,805,34,243,MI - Houghton Lake
50,2000-2001,2000-11-15,2001-04-17,154,0,132,483,615,90,623,713,1328,42,311,MI - Houghton Lake
51,2001-2002,2001-10-07,2002-04-22,198,2,76,367,443,83,196,279,722,34,211,MI - Houghton Lake
52,2002-2003,2002-11-06,2003-04-10,156,1,175,560,735,68,312,380,1115,37,310,MI - Houghton Lake
53,2003-2004,2003-10-02,2004-03-23,174,1,130,474,604,131,559,690,1294,59,417,MI - Houghton Lake
54,2004-2005,2004-11-24,2005-04-24,152,0,145,484,629,110,602,712,1341,49,347,MI - Houghton Lake
55,2005-2006,2005-11-16,2006-04-04,140,0,97,365,462,100,567,667,1129,43,244,MI - Houghton Lake
56,2006-2007,2006-10-12,2007-04-13,184,0,123,426,549,113,459,572,1121,49,349,MI - Houghton Lake
57,2007-2008,2007-11-08,2008-04-04,149,3,133,491,624,112,772,884,1508,47,316,MI - Houghton Lake
58,2008-2009,2008-11-10,2009-04-07,149,3,175,558,733,148,877,1025,1758,54,430,MI - Houghton Lake
59,2009-2010,2009-11-30,2010-03-11,102,0,98,330,428,50,476,526,954,34,198,MI - Houghton Lake
60,2010-2011,2010-11-18,2011-04-21,155,3,148,522,670,135,757,892,1562,55,402,MI - Houghton Lake
61,2011-2012,2011-11-17,2012-03-31,136,0,58,279,337,108,497,605,942,34,222,MI - Houghton Lake
62,2012-2013,2012-11-02,2013-05-12,192,0,106,424,530,99,518,617,1147,55,325,MI - Houghton Lake
63,2013-2014,2013-11-12,2014-04-15,155,0,246,693,939,99,914,1013,1952,53,472,MI - Houghton Lake
64,2014-2015,2014-11-12,2015-04-05,145,0,191,606,797,71,504,575,1372,41,321,MI - Houghton Lake
65,2015-2016,2015-11-21,2016-04-13,145,0,86,333,419,87,483,570,989,38,233,MI - Houghton Lake
66,2016-2017,2016-10-26,2017-03-30,156,0,97,344,441,110,447,557,998,46,288,MI - Houghton Lake
67,2017-2018,2017-11-09,2018-04-20,163,0,155,496,651,86,330,416,1067,47,319,MI - Houghton Lake
68,2018-2019,2018-11-09,2019-04-15,158,0,163,525,688,127,544,671,1359,60,393,MI - Houghton Lake
69,2019-2020,2019-10-31,2020-05-10,193,0,83,397,480,82,429,511,991,33,210,MI - Houghton Lake
1,1951-1952,1951-11-01,1952-04-14,166,4,158,670,828,93,666,759,1587,40,291,MI - Iron Mountain
2,1952-1953,1952-11-23,1953-04-26,155,0,108,481,589,81,545,626,1215,41,241,MI - Iron Mountain
3,1953-1954,1953-11-23,1954-05-04,163,0,131,533,664,83,349,432,1096,42,286,MI - Iron Mountain
4,1954-1955,1954-10-30,1955-04-05,158,0,157,591,748,93,680,773,1521,38,244,MI - Iron Mountain
5,1955-1956,1955-11-07,1956-04-29,175,0,161,694,855,89,872,961,1816,46,306,MI - Iron Mountain
8,1958-1959,1958-11-25,1959-03-28,124,0,238,741,979,76,648,724,1703,33,289,MI - Iron Mountain
9,1959-1960,1959-10-24,1960-05-06,196,0,145,678,823,115,900,1015,1838,53,346,MI - Iron Mountain
10,1960-1961,1960-11-10,1961-03-29,140,1,148,553,701,68,249,317,1018,21,178,MI - Iron Mountain
11,1961-1962,1961-11-08,1962-04-03,147,0,197,663,860,137,984,1121,1981,39,362,MI - Iron Mountain
12,1962-1963,1962-11-04,1963-03-23,140,0,233,696,929,66,435,501,1430,30,272,MI - Iron Mountain
13,1963-1964,1963-11-24,1964-03-31,129,0,120,564,684,45,355,400,1084,23,144,MI - Iron Mountain
14,1964-1965,1964-11-19,1965-04-26,159,1,190,731,921,114,735,849,1770,38,315,MI - Iron Mountain
15,1965-1966,1965-09-26,1966-04-26,213,1,129,578,707,90,507,597,1304,35,210,MI - Iron Mountain
16,1966-1967,1966-11-02,1967-05-11,191,1,158,659,817,123,670,793,1610,39,343,MI - Iron Mountain
17,1967-1968,1967-11-05,1968-04-25,173,0,157,618,775,56,385,441,1216,26,189,MI - Iron Mountain
18,1968-1969,1968-11-17,1969-04-02,137,1,129,583,712,117,862,979,1691,32,269,MI - Iron Mountain
19,1969-1970,1969-10-21,1970-03-29,160,0,165,683,848,87,678,765,1613,36,286,MI - Iron Mountain
20,1970-1971,1970-11-14,1971-04-08,146,1,183,677,860,151,1149,1300,2160,43,386,MI - Iron Mountain
21,1971-1972,1971-11-07,1972-04-23,169,1,188,755,943,163,1101,1264,2207,38,359,MI - Iron Mountain
22,1972-1973,1972-11-14,1973-04-10,148,2,139,527,666,74,516,590,1256,34,237,MI - Iron Mountain
23,1973-1974,1973-11-05,1974-04-04,151,6,173,619,792,85,641,726,1518,30,217,MI - Iron Mountain
24,1974-1975,1974-11-14,1975-04-13,151,3,113,598,711,111,735,846,1557,31,239,MI - Iron Mountain
25,1975-1976,1975-11-20,1976-04-01,134,0,150,577,727,122,621,743,1470,38,316,MI - Iron Mountain
26,1976-1977,1976-10-19,1977-04-09,173,0,226,773,999,123,660,783,1782,39,363,MI - Iron Mountain
27,1977-1978,1977-11-11,1978-04-20,161,1,176,704,880,95,700,795,1675,33,267,MI - Iron Mountain
28,1978-1979,1978-11-12,1979-05-06,176,4,247,794,1041,137,1052,1189,2230,37,355,MI - Iron Mountain
29,1979-1980,1979-10-23,1980-04-10,171,2,137,614,751,68,342,410,1161,25,156,MI - Iron Mountain
30,1980-1981,1980-11-08,1981-05-01,175,0,148,568,716,61,364,425,1141,27,222,MI - Iron Mountain
31,1981-1982,1981-11-19,1982-04-20,153,5,178,682,860,89,805,894,1754,33,276,MI - Iron Mountain
32,1982-1983,1982-11-05,1983-04-16,163,3,100,440,540,68,367,435,975,28,141,MI - Iron Mountain
33,1983-1984,1983-11-10,1984-03-25,137,15,183,683,866,73,674,747,1613,42,319,MI - Iron Mountain
34,1984-1985,1984-11-03,1985-04-17,166,2,175,682,857,110,547,657,1514,46,389,MI - Iron Mountain
35,1985-1986,1985-11-09,1986-03-29,141,4,204,748,952,111,949,1060,2012,52,438,MI - Iron Mountain
37,1987-1988,1987-11-18,1988-04-27,162,6,157,683,840,86,598,684,1524,39,322,MI - Iron Mountain
38,1988-1989,1988-11-06,1989-04-12,158,13,165,742,907,98,660,758,1665,44,364,MI - Iron Mountain
39,1989-1990,1989-10-20,1990-05-11,204,7,152,739,891,91,478,569,1460,44,331,MI - Iron Mountain
40,1990-1991,1990-11-09,1991-04-13,156,3,147,682,829,62,361,423,1252,21,209,MI - Iron Mountain
41,1991-1992,1991-11-02,1992-04-15,166,0,116,620,736,99,786,885,1621,37,284,MI - Iron Mountain
42,1992-1993,1992-10-16,1993-04-18,185,8,132,686,818,121,745,866,1684,48,330,MI - Iron Mountain
44,1994-1995,1994-11-23,1995-04-07,136,7,128,508,636,57,339,396,1032,24,164,MI - Iron Mountain
45,1995-1996,1995-10-21,1996-05-06,199,9,233,913,1146,165,1128,1293,2439,56,458,MI - Iron Mountain
46,1996-1997,1996-11-01,1997-05-17,198,10,178,667,845,133,1041,1174,2019,54,417,MI - Iron Mountain
47,1997-1998,1997-10-23,1998-04-17,177,4,95,434,529,97,581,678,1207,32,235,MI - Iron Mountain
48,1998-1999,1998-11-13,1999-03-26,134,5,144,522,666,75,706,781,1447,31,274,MI - Iron Mountain
49,1999-2000,1999-12-01,2000-04-18,140,16,121,569,690,89,564,653,1343,37,270,MI - Iron Mountain
50,2000-2001,2000-11-14,2001-04-17,155,5,171,614,785,84,810,894,1679,47,336,MI - Iron Mountain
51,2001-2002,2001-10-26,2002-04-29,186,6,82,451,533,98,338,436,969,40,231,MI - Iron Mountain
52,2002-2003,2002-10-22,2003-04-18,179,8,204,717,921,80,354,434,1355,29,242,MI - Iron Mountain
53,2003-2004,2003-10-28,2004-04-02,158,12,148,598,746,121,780,901,1647,39,309,MI - Iron Mountain
54,2004-2005,2004-11-27,2005-03-29,123,9,152,576,728,72,597,669,1397,33,274,MI - Iron Mountain
55,2005-2006,2005-11-16,2006-03-29,134,5,111,505,616,91,729,820,1436,40,251,MI - Iron Mountain
56,2006-2007,2006-10-14,2007-04-12,181,4,150,550,700,64,273,337,1037,22,166,MI - Iron Mountain
57,2007-2008,2007-11-08,2008-04-15,160,7,169,707,876,109,869,978,1854,39,291,MI - Iron Mountain
58,2008-2009,2008-10-27,2009-04-21,177,2,205,754,959,93,629,722,1681,48,406,MI - Iron Mountain
59,2009-2010,2009-10-13,2010-05-08,208,3,117,529,646,59,558,617,1263,30,196,MI - Iron Mountain
60,2010-2011,2010-11-15,2011-04-18,155,5,172,566,738,66,462,528,1266,33,227,MI - Iron Mountain
61,2011-2012,2011-11-10,2012-03-13,125,0,85,388,473,68,434,502,975,25,168,MI - Iron Mountain
62,2012-2013,2012-11-13,2013-04-25,164,0,148,605,753,94,746,840,1593,34,246,MI - Iron Mountain
63,2013-2014,2013-11-12,2014-04-19,159,0,316,909,1225,107,1023,1130,2355,41,387,MI - Iron Mountain
64,2014-2015,2014-11-06,2015-04-23,169,4,232,750,982,91,864,955,1937,31,249,MI - Iron Mountain
65,2015-2016,2015-11-13,2016-04-14,154,0,112,439,551,71,413,484,1035,33,206,MI - Iron Mountain
67,2017-2018,2017-11-04,2018-04-20,168,0,199,695,894,94,666,760,1654,34,286,MI - Iron Mountain
68,2018-2019,2018-11-09,2019-04-15,158,6,213,683,896,112,865,977,1873,36,341,MI - Iron Mountain
69,2019-2020,2019-10-29,2020-04-17,172,0,110,541,651,110,958,1068,1719,34,262,MI - Iron Mountain
0,1950-1951,1950-10-22,1951-04-22,183,13,253,704,957,215,1201,1416,2373,69,607,MI - Ironwood
1,1951-1952,1951-10-28,1952-05-11,197,9,189,659,848,173,997,1170,2018,52,414,MI - Ironwood
2,1952-1953,1952-10-06,1953-05-12,219,0,133,522,655,183,840,1023,1678,59,443,MI - Ironwood
4,1954-1955,1954-10-29,1955-04-09,163,10,195,591,786,173,1171,1344,2130,69,550,MI - Ironwood
5,1955-1956,1955-11-03,1956-05-02,182,1,187,714,901,167,1235,1402,2303,61,495,MI - Ironwood
6,1956-1957,1956-11-07,1957-04-15,160,3,214,721,935,219,1242,1461,2396,70,637,MI - Ironwood
7,1957-1958,1957-10-25,1958-04-05,163,0,192,602,794,194,1260,1454,2248,54,527,MI - Ironwood
8,1958-1959,1958-11-05,1959-04-11,158,1,285,775,1060,126,1061,1187,2247,57,568,MI - Ironwood
9,1959-1960,1959-10-26,1960-05-09,197,0,191,740,931,226,1122,1348,2279,72,639,MI - Ironwood
10,1960-1961,1960-11-05,1961-05-10,187,0,180,640,820,190,907,1097,1917,63,537,MI - Ironwood
11,1961-1962,1961-10-19,1962-04-14,178,0,256,691,947,159,983,1142,2089,69,596,MI - Ironwood
12,1962-1963,1962-10-23,1963-05-22,212,0,289,793,1082,186,952,1138,2220,68,661,MI - Ironwood
13,1963-1964,1963-11-01,1964-04-15,167,1,173,678,851,276,1234,1510,2361,72,736,MI - Ironwood
14,1964-1965,1964-10-05,1965-05-28,236,3,270,893,1163,249,1274,1523,2686,86,857,MI - Ironwood
15,1965-1966,1965-09-25,1966-05-02,220,1,206,698,904,250,1162,1412,2316,76,648,MI - Ironwood
16,1966-1967,1966-10-15,1967-05-11,209,0,215,745,960,347,1125,1472,2432,93,900,MI - Ironwood
17,1967-1968,1967-10-09,1968-04-26,201,2,214,689,903,214,798,1012,1915,68,625,MI - Ironwood
18,1968-1969,1968-10-28,1969-04-28,183,0,194,700,894,287,1317,1604,2498,69,677,MI - Ironwood
19,1969-1970,1969-10-13,1970-05-02,202,4,220,772,992,218,1056,1274,2266,84,733,MI - Ironwood
20,1970-1971,1970-10-10,1971-05-20,223,0,243,786,1029,359,1468,1827,2856,87,910,MI - Ironwood
21,1971-1972,1971-11-02,1972-04-28,179,0,241,853,1094,275,1201,1476,2570,80,759,MI - Ironwood
22,1972-1973,1972-10-17,1973-05-04,200,0,178,617,795,196,922,1118,1913,75,587,MI - Ironwood
23,1973-1974,1973-11-04,1974-04-23,171,4,242,795,1037,148,943,1091,2128,47,432,MI - Ironwood
24,1974-1975,1974-10-01,1975-04-20,202,0,184,735,919,271,1242,1513,2432,65,641,MI - Ironwood
25,1975-1976,1975-11-10,1976-05-04,177,2,217,705,922,343,1367,1710,2632,70,789,MI - Ironwood
26,1976-1977,1976-10-09,1977-04-09,183,3,314,895,1209,282,1179,1461,2670,89,1048,MI - Ironwood
27,1977-1978,1977-10-08,1978-04-20,195,0,248,835,1083,243,1149,1392,2475,79,819,MI - Ironwood
28,1978-1979,1978-11-11,1979-05-05,176,0,324,932,1256,212,1205,1417,2673,71,753,MI - Ironwood
29,1979-1980,1979-10-09,1980-04-24,199,1,212,851,1063,213,1195,1408,2471,80,693,MI - Ironwood
30,1980-1981,1980-10-12,1981-04-24,195,1,210,867,1077,222,998,1220,2297,69,796,MI - Ironwood
31,1981-1982,1981-10-18,1982-04-20,185,3,272,868,1140,264,1250,1514,2654,81,860,MI - Ironwood
32,1982-1983,1982-10-20,1983-04-29,192,3,142,652,794,283,1092,1375,2169,86,706,MI - Ironwood
33,1983-1984,1983-10-14,1984-05-09,209,3,262,887,1149,243,1030,1273,2422,76,757,MI - Ironwood
34,1984-1985,1984-10-30,1985-04-10,163,6,235,733,968,245,761,1006,1974,63,703,MI - Ironwood
35,1985-1986,1985-11-09,1986-04-21,164,13,263,714,977,247,1252,1499,2476,75,799,MI - Ironwood
36,1986-1987,1986-10-14,1987-04-05,174,8,143,545,688,163,701,864,1552,56,464,MI - Ironwood
37,1987-1988,1987-10-02,1988-04-23,205,8,241,705,946,239,1014,1253,2199,69,665,MI - Ironwood
39,1989-1990,1989-09-23,1990-05-10,230,14,243,805,1048,333,1025,1358,2406,82,915,MI - Ironwood
40,1990-1991,1990-10-18,1991-05-01,196,8,245,728,973,181,604,785,1758,66,639,MI - Ironwood
41,1991-1992,1991-10-06,1992-04-14,192,6,213,680,893,271,1201,1472,2365,81,797,MI - Ironwood
42,1992-1993,1992-10-14,1993-04-14,183,7,231,731,962,235,924,1159,2121,87,723,MI - Ironwood
43,1993-1994,1993-10-27,1994-04-29,185,15,348,873,1221,228,795,1023,2244,91,889,MI - Ironwood
44,1994-1995,1994-10-25,1995-04-26,184,16,203,648,851,225,614,839,1690,79,723,MI - Ironwood
47,1997-1998,1997-10-14,1998-04-02,171,19,152,502,654,203,796,999,1653,70,555,MI - Ironwood
50,2000-2001,2000-10-06,2001-04-24,201,15,255,734,989,432,1483,1915,2904,107,1173,MI - Ironwood
52,2002-2003,2002-10-19,2003-04-22,186,20,281,787,1068,295,818,1113,2181,88,887,MI - Ironwood
54,2004-2005,2004-10-16,2005-05-03,200,9,215,667,882,253,907,1160,2042,78,750,MI - Ironwood
56,2006-2007,2006-10-12,2007-04-14,185,20,223,656,879,285,834,1119,1998,62,675,MI - Ironwood
58,2008-2009,2008-10-28,2009-04-23,178,4,297,817,1114,273,883,1156,2270,79,873,MI - Ironwood
59,2009-2010,2009-10-13,2010-05-08,208,11,190,613,803,239,744,983,1786,56,604,MI - Ironwood
67,2017-2018,2017-10-28,2018-04-23,178,9,297,798,1095,245,1183,1428,2523,68,738,MI - Ironwood
68,2018-2019,2018-10-13,2019-05-09,209,5,298,776,1074,265,1033,1298,2372,78,814,MI - Ironwood
69,2019-2020,2019-10-31,2020-04-18,171,0,194,645,839,241,1180,1421,2260,65,597,MI - Ironwood
0,1950-1951,1950-11-04,1951-04-16,164,0,114,368,482,79,182,261,743,52,312,MI - Lansing
1,1951-1952,1951-11-02,1952-04-12,163,0,91,361,452,135,245,380,832,57,340,MI - Lansing
2,1952-1953,1952-10-19,1953-04-19,183,0,49,258,307,46,36,82,389,37,137,MI - Lansing
3,1953-1954,1953-11-25,1954-05-04,161,0,61,291,352,84,184,268,620,46,220,MI - Lansing
5,1955-1956,1955-11-03,1956-04-17,167,0,75,347,422,88,154,242,664,51,233,MI - Lansing
8,1958-1959,1958-11-24,1959-04-10,138,0,119,428,547,84,342,426,973,56,335,MI - Lansing
9,1959-1960,1959-11-06,1960-04-09,156,0,77,412,489,89,331,420,909,61,305,MI - Lansing
10,1960-1961,1960-11-06,1961-04-18,164,0,93,400,493,57,114,171,664,38,223,MI - Lansing
11,1961-1962,1961-12-01,1962-04-19,140,0,125,410,535,79,334,413,948,45,301,MI - Lansing
12,1962-1963,1962-10-25,1963-04-30,188,0,167,518,685,74,389,463,1148,50,334,MI - Lansing
13,1963-1964,1963-12-01,1964-04-08,130,0,75,357,432,59,138,197,629,37,187,MI - Lansing
14,1964-1965,1964-11-19,1965-04-17,150,0,113,427,540,100,213,313,853,50,326,MI - Lansing
15,1965-1966,1965-11-28,1966-04-07,131,0,98,354,452,61,167,228,680,37,228,MI - Lansing
16,1966-1967,1966-11-02,1967-03-24,143,0,97,416,513,125,506,631,1144,49,320,MI - Lansing
17,1967-1968,1967-10-27,1968-04-25,182,0,94,418,512,75,122,197,709,40,232,MI - Lansing
18,1968-1969,1968-11-09,1969-03-30,142,0,80,402,482,61,140,201,683,43,240,MI - Lansing
19,1969-1970,1969-11-14,1970-04-07,145,0,106,458,564,111,232,343,907,54,362,MI - Lansing
20,1970-1971,1970-11-22,1971-04-03,133,0,109,372,481,104,303,407,888,54,311,MI - Lansing
21,1971-1972,1971-11-03,1972-04-07,157,0,90,411,501,105,191,296,797,64,338,MI - Lansing
22,1972-1973,1972-11-13,1973-04-11,150,0,83,327,410,108,298,406,816,43,237,MI - Lansing
23,1973-1974,1973-12-01,1974-04-07,128,0,92,350,442,99,281,380,822,47,310,MI - Lansing
24,1974-1975,1974-10-19,1975-04-12,176,0,53,341,394,105,236,341,735,50,235,MI - Lansing
25,1975-1976,1975-11-24,1976-04-26,155,0,76,372,448,111,365,476,924,54,324,MI - Lansing
26,1976-1977,1976-10-21,1977-04-25,187,0,167,529,696,104,385,489,1185,66,477,MI - Lansing
27,1977-1978,1977-11-11,1978-03-30,140,0,159,544,703,115,577,692,1395,57,394,MI - Lansing
28,1978-1979,1978-11-20,1979-04-06,138,0,153,432,585,101,428,529,1114,58,390,MI - Lansing
29,1979-1980,1979-11-08,1980-04-25,170,0,95,406,501,63,80,143,644,46,259,MI - Lansing
30,1980-1981,1980-11-27,1981-03-20,114,0,99,369,468,67,204,271,739,39,266,MI - Lansing
31,1981-1982,1981-10-21,1982-04-11,173,0,129,474,603,99,363,462,1065,51,374,MI - Lansing
32,1982-1983,1982-11-05,1983-04-18,165,0,49,267,316,59,72,131,447,33,146,MI - Lansing
33,1983-1984,1983-10-14,1984-04-17,187,0,147,470,617,86,277,363,980,55,360,MI - Lansing
34,1984-1985,1984-11-11,1985-04-08,149,0,106,382,488,92,313,405,893,49,317,MI - Lansing
35,1985-1986,1985-11-09,1986-03-20,132,0,118,388,506,106,321,427,933,58,388,MI - Lansing
36,1986-1987,1986-11-12,1987-04-02,142,0,45,300,345,61,109,170,515,35,155,MI - Lansing
37,1987-1988,1987-10-21,1988-04-15,178,0,92,399,491,74,170,244,735,44,270,MI - Lansing
38,1988-1989,1988-11-06,1989-04-10,156,0,75,347,422,69,84,153,575,43,250,MI - Lansing
39,1989-1990,1989-10-19,1990-04-11,175,0,96,396,492,86,203,289,781,41,248,MI - Lansing
40,1990-1991,1990-11-11,1991-04-01,142,0,71,317,388,61,139,200,588,38,226,MI - Lansing
41,1991-1992,1991-10-19,1992-04-14,179,0,61,360,421,88,138,226,647,46,248,MI - Lansing
42,1992-1993,1992-10-20,1993-04-17,180,0,69,350,419,114,209,323,742,61,311,MI - Lansing
43,1993-1994,1993-11-06,1994-05-01,177,0,139,491,630,87,218,305,935,51,385,MI - Lansing
44,1994-1995,1994-11-01,1995-04-09,160,0,74,349,423,81,251,332,755,42,234,MI - Lansing
45,1995-1996,1995-11-03,1996-04-06,156,0,128,491,619,69,137,206,825,46,268,MI - Lansing
48,1998-1999,1998-12-01,1999-03-17,107,0,83,334,417,85,244,329,746,35,296,MI - Lansing
54,2004-2005,2004-11-24,2005-04-24,152,0,85,327,412,110,275,385,797,48,272,MI - Lansing
55,2005-2006,2005-11-16,2006-04-08,144,0,62,255,317,77,159,236,553,47,211,MI - Lansing
56,2006-2007,2006-10-12,2007-04-11,182,0,97,319,416,60,184,244,660,44,248,MI - Lansing
57,2007-2008,2007-11-21,2008-03-28,129,0,90,335,425,105,245,350,775,43,258,MI - Lansing
58,2008-2009,2008-11-09,2009-04-07,150,0,117,395,512,111,312,423,935,57,359,MI - Lansing
59,2009-2010,2009-12-01,2010-03-21,111,0,77,261,338,64,287,351,689,33,177,MI - Lansing
60,2010-2011,2010-11-26,2011-04-18,144,0,110,370,480,82,349,431,911,37,227,MI - Lansing
61,2011-2012,2011-11-10,2012-03-05,117,0,36,182,218,61,86,147,365,29,133,MI - Lansing
62,2012-2013,2012-10-30,2013-04-19,172,0,67,312,379,55,117,172,551,41,194,MI - Lansing
63,2013-2014,2013-11-11,2014-04-15,156,0,184,516,700,106,600,706,1406,52,425,MI - Lansing
64,2014-2015,2014-11-15,2015-03-27,133,0,140,423,563,58,325,383,946,34,248,MI - Lansing
65,2015-2016,2015-11-21,2016-04-10,142,0,53,231,284,80,132,212,496,33,191,MI - Lansing
66,2016-2017,2016-11-20,2017-04-06,138,0,61,223,284,53,97,150,434,31,153,MI - Lansing
67,2017-2018,2017-11-09,2018-04-17,160,0,103,371,474,80,187,267,741,38,235,MI - Lansing
69,2019-2020,2019-10-31,2020-04-17,170,0,42,256,298,73,137,210,508,38,185,MI - Lansing
0,1950-1951,1950-11-09,1951-04-21,164,0,188,479,667,198,1131,1329,1996,69,492,MI - Marquette
1,1951-1952,1951-10-19,1952-04-14,179,0,165,487,652,139,829,968,1620,66,413,MI - Marquette
2,1952-1953,1952-10-19,1953-04-28,192,0,112,350,462,188,778,966,1428,83,448,MI - Marquette
3,1953-1954,1953-11-04,1954-05-09,187,0,132,389,521,140,819,959,1480,75,445,MI - Marquette
4,1954-1955,1954-10-17,1955-04-05,171,0,139,392,531,132,711,843,1374,83,459,MI - Marquette
5,1955-1956,1955-10-24,1956-04-28,188,0,147,454,601,136,990,1126,1727,72,422,MI - Marquette
6,1956-1957,1956-09-19,1957-05-15,239,0,178,521,699,169,938,1107,1806,84,556,MI - Marquette
7,1957-1958,1957-10-24,1958-04-25,184,0,142,381,523,184,771,955,1478,92,551,MI - Marquette
8,1958-1959,1958-09-30,1959-04-28,211,0,232,565,797,158,900,1058,1855,78,598,MI - Marquette
9,1959-1960,1959-10-13,1960-05-10,211,0,149,465,614,274,1079,1353,1967,108,662,MI - Marquette
10,1960-1961,1960-10-19,1961-05-02,196,0,166,440,606,173,722,895,1501,73,485,MI - Marquette
11,1961-1962,1961-11-06,1962-05-08,184,0,201,505,706,174,1128,1302,2008,76,564,MI - Marquette
12,1962-1963,1962-10-23,1963-05-22,212,0,243,603,846,135,820,955,1801,72,553,MI - Marquette
13,1963-1964,1963-11-01,1964-04-14,166,0,132,427,559,149,948,1097,1656,77,487,MI - Marquette
14,1964-1965,1964-10-05,1965-04-23,201,0,208,549,757,164,1164,1328,2085,82,586,MI - Marquette
15,1965-1966,1965-10-28,1966-05-08,193,0,148,410,558,158,714,872,1430,82,458,MI - Marquette
16,1966-1967,1966-10-29,1967-05-11,195,0,169,494,663,203,1120,1323,1986,94,626,MI - Marquette
17,1967-1968,1967-10-27,1968-04-26,183,0,174,480,654,136,638,774,1428,63,445,MI - Marquette
18,1968-1969,1968-10-28,1969-05-11,196,0,141,393,534,180,1110,1290,1824,84,490,MI - Marquette
19,1969-1970,1969-10-21,1970-05-05,197,0,181,500,681,160,1067,1227,1908,80,534,MI - Marquette
20,1970-1971,1970-10-16,1971-05-12,209,0,189,465,654,218,1187,1405,2059,93,643,MI - Marquette
21,1971-1972,1971-11-04,1972-05-05,184,0,200,562,762,196,1269,1465,2227,81,572,MI - Marquette
22,1972-1973,1972-10-17,1973-05-16,212,0,145,406,551,127,843,970,1521,66,390,MI - Marquette
23,1973-1974,1973-11-05,1974-05-06,183,0,196,471,667,143,965,1108,1775,78,491,MI - Marquette
24,1974-1975,1974-09-21,1975-04-20,212,0,125,372,497,192,812,1004,1501,86,478,MI - Marquette
25,1975-1976,1975-10-01,1976-05-05,218,1,166,433,599,222,818,1040,1639,90,625,MI - Marquette
26,1976-1977,1976-10-16,1977-04-27,194,0,241,556,797,201,959,1160,1957,90,633,MI - Marquette
27,1977-1978,1977-11-10,1978-04-20,162,0,178,457,635,177,976,1153,1788,73,518,MI - Marquette
28,1978-1979,1978-10-23,1979-04-23,183,0,294,719,1013,224,1476,1700,2713,82,763,MI - Marquette
29,1979-1980,1979-10-09,1980-05-08,213,0,204,678,882,218,1006,1224,2106,94,733,MI - Marquette
30,1980-1981,1980-09-26,1981-04-25,212,0,214,661,875,252,885,1137,2012,101,829,MI - Marquette
31,1981-1982,1981-10-01,1982-04-25,207,5,239,778,1017,327,1392,1719,2736,98,922,MI - Marquette
32,1982-1983,1982-10-15,1983-04-24,192,0,163,538,701,285,921,1206,1907,83,655,MI - Marquette
33,1983-1984,1983-10-14,1984-05-01,201,6,241,756,997,290,1262,1552,2549,73,748,MI - Marquette
34,1984-1985,1984-11-02,1985-04-19,169,0,219,686,905,322,1011,1333,2238,85,840,MI - Marquette
35,1985-1986,1985-11-03,1986-05-01,180,0,242,717,959,298,1332,1630,2589,90,895,MI - Marquette
36,1986-1987,1986-10-14,1987-05-22,221,0,127,582,709,162,682,844,1553,68,518,MI - Marquette
37,1987-1988,1987-10-02,1988-04-23,205,0,212,697,909,300,1137,1437,2346,92,776,MI - Marquette
38,1988-1989,1988-10-04,1989-05-06,215,0,221,757,978,328,1096,1424,2402,108,906,MI - Marquette
39,1989-1990,1989-09-22,1990-05-13,234,0,196,703,899,341,1132,1473,2372,100,862,MI - Marquette
40,1990-1991,1990-10-18,1991-05-03,198,3,195,642,837,200,551,751,1588,83,674,MI - Marquette
41,1991-1992,1991-10-05,1992-04-24,203,0,174,658,832,293,1390,1683,2515,85,774,MI - Marquette
42,1992-1993,1992-10-15,1993-04-23,191,0,184,655,839,252,1030,1282,2121,95,710,MI - Marquette
43,1993-1994,1993-09-29,1994-05-01,215,0,294,777,1071,223,1067,1290,2361,91,810,MI - Marquette
44,1994-1995,1994-11-19,1995-04-25,158,3,174,507,681,241,611,852,1533,76,634,MI - Marquette
45,1995-1996,1995-10-20,1996-05-11,205,3,284,845,1129,333,1571,1904,3033,107,938,MI - Marquette
46,1996-1997,1996-10-09,1997-05-19,223,0,219,705,924,392,1761,2153,3077,106,973,MI - Marquette
47,1997-1998,1997-10-20,1998-04-18,181,0,147,476,623,258,1162,1420,2043,74,586,MI - Marquette
48,1998-1999,1998-10-21,1999-04-17,179,0,182,538,720,228,1013,1241,1961,71,603,MI - Marquette
49,1999-2000,1999-10-17,2000-04-20,187,0,157,574,731,225,828,1053,1784,82,677,MI - Marquette
50,2000-2001,2000-10-06,2001-04-24,201,0,235,629,864,374,1391,1765,2629,104,987,MI - Marquette
51,2001-2002,2001-10-06,2002-05-24,231,0,146,550,696,449,1183,1632,2328,102,904,MI - Marquette
52,2002-2003,2002-10-13,2003-04-22,192,0,273,787,1060,261,1026,1287,2347,91,836,MI - Marquette
53,2003-2004,2003-09-30,2004-04-29,213,1,196,621,817,313,1208,1521,2338,111,879,MI - Marquette
54,2004-2005,2004-10-04,2005-05-02,211,0,205,660,865,314,1196,1510,2375,98,901,MI - Marquette
55,2005-2006,2005-10-07,2006-05-11,217,0,164,544,708,281,1171,1452,2160,93,698,MI - Marquette
56,2006-2007,2006-10-11,2007-04-21,193,0,209,585,794,330,805,1135,1929,83,817,MI - Marquette
57,2007-2008,2007-10-24,2008-04-21,181,3,227,688,915,292,1257,1549,2464,88,761,MI - Marquette
58,2008-2009,2008-10-27,2009-05-09,195,0,264,723,987,344,1254,1598,2585,96,959,MI - Marquette
59,2009-2010,2009-10-12,2010-05-09,210,0,163,517,680,233,1078,1311,1991,72,582,MI - Marquette
60,2010-2011,2010-11-04,2011-04-28,176,3,226,604,830,224,1019,1243,2073,92,766,MI - Marquette
61,2011-2012,2011-11-09,2012-04-26,170,0,117,430,547,222,873,1095,1642,73,533,MI - Marquette
62,2012-2013,2012-10-06,2013-05-12,219,0,207,619,826,311,1376,1687,2513,114,864,MI - Marquette
63,2013-2014,2013-10-21,2014-05-16,208,0,376,909,1285,291,1372,1663,2948,117,1160,MI - Marquette
64,2014-2015,2014-10-30,2015-05-19,202,0,310,793,1103,263,1366,1629,2732,100,966,MI - Marquette
65,2015-2016,2015-10-17,2016-05-14,211,0,166,500,666,234,862,1096,1762,94,687,MI - Marquette
66,2016-2017,2016-11-19,2017-05-02,165,0,183,511,694,230,762,992,1686,76,631,MI - Marquette
67,2017-2018,2017-10-24,2018-04-30,189,0,266,751,1017,252,1176,1428,2445,96,842,MI - Marquette
68,2018-2019,2018-10-05,2019-05-19,227,1,278,775,1053,338,1479,1817,2870,106,1021,MI - Marquette
69,2019-2020,2019-10-12,2020-05-10,212,0,176,612,788,308,1631,1939,2727,103,757,MI - Marquette
0,1950-1951,1950-11-10,1951-04-16,158,0,104,340,444,124,359,483,927,60,377,MI - Muskegon
1,1951-1952,1951-11-01,1952-04-12,164,0,85,330,415,149,264,413,828,63,380,MI - Muskegon
2,1952-1953,1952-10-17,1953-04-20,186,0,41,247,288,76,72,148,436,42,183,MI - Muskegon
3,1953-1954,1953-11-25,1954-05-05,162,0,45,252,297,128,170,298,595,56,285,MI - Muskegon
4,1954-1955,1954-11-01,1955-03-28,148,0,63,282,345,121,196,317,662,52,282,MI - Muskegon
5,1955-1956,1955-11-03,1956-04-17,167,0,70,339,409,144,199,343,752,71,359,MI - Muskegon
6,1956-1957,1956-11-22,1957-04-06,136,0,68,280,348,97,145,242,590,56,301,MI - Muskegon
7,1957-1958,1957-11-08,1958-03-16,129,0,81,275,356,124,445,569,925,54,340,MI - Muskegon
8,1958-1959,1958-11-21,1959-04-09,140,0,128,410,538,185,685,870,1408,73,534,MI - Muskegon
9,1959-1960,1959-11-06,1960-04-09,156,0,78,322,400,161,443,604,1004,72,383,MI - Muskegon
10,1960-1961,1960-11-09,1961-04-28,171,0,82,312,394,121,210,331,725,50,319,MI - Muskegon
11,1961-1962,1961-11-08,1962-04-15,159,0,117,338,455,211,500,711,1166,66,489,MI - Muskegon
12,1962-1963,1962-10-23,1963-04-30,190,0,152,421,573,229,754,983,1556,77,618,MI - Muskegon
13,1963-1964,1963-11-30,1964-04-08,131,0,65,282,347,187,383,570,917,58,402,MI - Muskegon
14,1964-1965,1964-11-19,1965-04-17,150,0,104,324,428,228,389,617,1045,66,503,MI - Muskegon
15,1965-1966,1965-11-13,1966-04-07,146,0,87,312,399,168,264,432,831,62,434,MI - Muskegon
16,1966-1967,1966-11-01,1967-04-22,173,0,78,316,394,188,429,617,1011,72,432,MI - Muskegon
17,1967-1968,1967-10-27,1968-04-24,181,0,91,302,393,118,249,367,760,57,346,MI - Muskegon
18,1968-1969,1968-11-16,1969-03-31,136,0,86,308,394,164,340,504,898,63,391,MI - Muskegon
19,1969-1970,1969-11-13,1970-04-03,142,0,116,374,490,201,484,685,1175,75,515,MI - Muskegon
20,1970-1971,1970-11-22,1971-04-23,153,0,111,367,478,186,470,656,1134,77,490,MI - Muskegon
21,1971-1972,1971-11-03,1972-04-07,157,0,93,352,445,168,283,451,896,76,450,MI - Muskegon
22,1972-1973,1972-10-18,1973-04-12,177,0,67,266,333,112,226,338,671,52,274,MI - Muskegon
23,1973-1974,1973-11-09,1974-03-31,143,0,108,316,424,149,323,472,896,53,378,MI - Muskegon
24,1974-1975,1974-10-19,1975-04-06,170,0,53,269,322,137,280,417,739,67,310,MI - Muskegon
25,1975-1976,1975-11-24,1976-04-25,154,0,56,259,315,130,422,552,867,65,333,MI - Muskegon
26,1976-1977,1976-11-03,1977-04-07,156,0,166,423,589,196,720,916,1505,80,618,MI - Muskegon
27,1977-1978,1977-11-11,1978-03-31,141,0,142,436,578,229,753,982,1560,66,544,MI - Muskegon
28,1978-1979,1978-11-20,1979-04-28,160,0,178,416,594,183,706,889,1483,75,584,MI - Muskegon
29,1979-1980,1979-11-09,1980-04-24,168,0,95,320,415,109,184,293,708,54,312,MI - Muskegon
30,1980-1981,1980-10-25,1981-03-19,146,0,94,314,408,149,419,568,976,55,403,MI - Muskegon
31,1981-1982,1981-10-19,1982-04-12,176,0,125,408,533,252,617,869,1402,66,568,MI - Muskegon
32,1982-1983,1982-11-04,1983-03-28,145,0,49,209,258,57,85,142,400,33,129,MI - Muskegon
33,1983-1984,1983-11-11,1984-04-22,164,0,131,369,500,146,525,671,1171,71,481,MI - Muskegon
34,1984-1985,1984-12-01,1985-04-09,130,0,97,296,393,171,511,682,1075,55,409,MI - Muskegon
35,1985-1986,1985-11-08,1986-03-20,133,0,95,305,400,157,458,615,1015,62,403,MI - Muskegon
36,1986-1987,1986-11-11,1987-04-04,145,0,35,252,287,92,147,239,526,39,225,MI - Muskegon
37,1987-1988,1987-11-20,1988-03-30,132,0,77,297,374,132,258,390,764,55,358,MI - Muskegon
38,1988-1989,1988-10-25,1989-04-09,167,0,65,307,372,125,204,329,701,51,312,MI - Muskegon
39,1989-1990,1989-10-19,1990-04-12,176,0,79,298,377,192,293,485,862,64,424,MI - Muskegon
40,1990-1991,1990-11-05,1991-04-10,157,0,52,256,308,104,144,248,556,51,289,MI - Muskegon
41,1991-1992,1991-11-02,1992-04-14,165,0,43,259,302,121,192,313,615,49,262,MI - Muskegon
42,1992-1993,1992-10-18,1993-04-17,182,0,61,299,360,145,280,425,785,65,332,MI - Muskegon
43,1993-1994,1993-10-29,1994-03-29,152,0,130,395,525,178,501,679,1204,51,488,MI - Muskegon
44,1994-1995,1994-11-28,1995-04-09,133,0,64,243,307,130,268,398,705,48,292,MI - Muskegon
45,1995-1996,1995-11-04,1996-04-09,158,0,135,426,561,172,337,509,1070,74,519,MI - Muskegon
50,2000-2001,2000-11-16,2001-03-28,133,0,74,289,363,132,342,474,837,44,286,MI - Muskegon
51,2001-2002,2001-12-01,2002-04-04,125,1,36,183,219,78,137,215,434,34,173,MI - Muskegon
52,2002-2003,2002-11-21,2003-04-07,138,0,88,317,405,87,361,448,853,46,280,MI - Muskegon
53,2003-2004,2003-11-24,2004-03-21,119,0,75,248,323,96,391,487,810,42,258,MI - Muskegon
54,2004-2005,2004-11-24,2005-04-24,152,0,79,308,387,132,364,496,883,52,348,MI - Muskegon
55,2005-2006,2005-11-16,2006-03-24,129,0,54,203,257,112,190,302,559,47,251,MI - Muskegon
56,2006-2007,2006-10-23,2007-04-13,173,0,82,248,330,124,405,529,859,51,311,MI - Muskegon
57,2007-2008,2007-11-23,2008-03-28,127,0,80,287,367,152,453,605,972,59,376,MI - Muskegon
58,2008-2009,2008-11-17,2009-03-29,133,0,99,333,432,197,389,586,1018,53,426,MI - Muskegon
59,2009-2010,2009-12-01,2010-03-20,110,0,59,212,271,102,386,488,759,39,215,MI - Muskegon
60,2010-2011,2010-12-01,2011-04-18,139,0,78,279,357,151,493,644,1001,55,341,MI - Muskegon
61,2011-2012,2011-11-10,2012-03-09,121,0,21,132,153,79,102,181,334,29,143,MI - Muskegon
62,2012-2013,2012-11-12,2013-03-22,131,0,56,236,292,142,278,420,712,52,302,MI - Muskegon
63,2013-2014,2013-11-11,2014-04-15,156,0,149,423,572,192,824,1016,1588,72,557,MI - Muskegon
64,2014-2015,2014-11-13,2015-03-28,136,0,112,349,461,133,510,643,1104,45,349,MI - Muskegon
65,2015-2016,2015-11-21,2016-04-08,140,0,43,187,230,90,235,325,555,34,204,MI - Muskegon
66,2016-2017,2016-11-19,2017-03-17,119,0,49,169,218,72,141,213,431,32,177,MI - Muskegon
67,2017-2018,2017-11-10,2018-04-19,161,0,85,299,384,139,331,470,854,48,356,MI - Muskegon
68,2018-2019,2018-11-09,2019-04-15,158,0,79,290,369,110,256,366,735,51,296,MI - Muskegon
69,2019-2020,2019-11-06,2020-03-23,139,0,26,188,214,83,171,254,468,39,171,MI - Muskegon
2,1952-1953,1952-10-20,1953-03-17,149,4,28,212,240,32,23,55,295,17,86,MI - Port Huron
5,1955-1956,1955-11-19,1956-03-25,128,1,65,269,334,43,120,163,497,19,95,MI - Port Huron
6,1956-1957,1956-11-11,1957-03-27,137,0,62,271,333,44,114,158,491,21,96,MI - Port Huron
7,1957-1958,1957-10-26,1958-03-09,135,0,61,244,305,32,30,62,367,16,80,MI - Port Huron
8,1958-1959,1958-11-27,1959-03-29,123,3,98,376,474,59,177,236,710,24,162,MI - Port Huron
9,1959-1960,1959-11-13,1960-03-27,136,6,72,287,359,75,241,316,675,26,148,MI - Port Huron
10,1960-1961,1960-11-07,1961-04-17,162,2,82,311,393,75,254,329,722,15,149,MI - Port Huron
11,1961-1962,1961-12-01,1962-03-06,96,0,93,288,381,37,109,146,527,15,95,MI - Port Huron
12,1962-1963,1962-12-01,1963-03-21,111,0,130,367,497,49,269,318,815,21,143,MI - Port Huron
13,1963-1964,1963-12-01,1964-04-04,126,0,61,283,344,47,121,168,512,20,134,MI - Port Huron
14,1964-1965,1964-11-20,1965-04-17,149,0,87,336,423,125,227,352,775,33,244,MI - Port Huron
15,1965-1966,1965-10-28,1966-03-27,151,1,76,257,333,46,156,202,535,16,98,MI - Port Huron
16,1966-1967,1966-11-29,1967-03-23,115,0,66,302,368,86,335,421,789,28,170,MI - Port Huron
17,1967-1968,1967-11-16,1968-03-26,132,0,82,331,413,67,166,233,646,18,146,MI - Port Huron
18,1968-1969,1968-11-17,1969-03-30,134,0,76,289,365,50,100,150,515,19,114,MI - Port Huron
19,1969-1970,1969-10-23,1970-04-03,163,2,102,385,487,64,209,273,760,28,175,MI - Port Huron
20,1970-1971,1970-11-23,1971-04-03,132,1,95,311,406,65,173,238,644,25,139,MI - Port Huron
21,1971-1972,1971-11-09,1972-04-08,152,1,83,349,432,67,131,198,630,28,169,MI - Port Huron
22,1972-1973,1972-10-19,1973-03-23,156,2,49,243,292,68,151,219,511,24,130,MI - Port Huron
23,1973-1974,1973-12-01,1974-04-08,129,1,88,287,375,68,212,280,655,29,218,MI - Port Huron
27,1977-1978,1977-11-11,1978-03-25,135,17,119,386,505,77,389,466,971,25,179,MI - Port Huron
28,1978-1979,1978-11-26,1979-04-09,135,7,124,378,502,48,230,278,780,20,157,MI - Port Huron
29,1979-1980,1979-11-29,1980-03-21,114,11,77,289,366,33,61,94,460,19,112,MI - Port Huron
30,1980-1981,1980-11-11,1981-03-19,129,12,95,346,441,45,179,224,665,21,150,MI - Port Huron
31,1981-1982,1981-11-21,1982-04-08,139,17,116,397,513,88,389,477,990,26,210,MI - Port Huron
32,1982-1983,1982-11-26,1983-04-18,144,14,42,200,242,21,29,50,292,14,53,MI - Port Huron
33,1983-1984,1983-11-30,1984-03-23,115,13,116,329,445,56,248,304,749,27,150,MI - Port Huron
34,1984-1985,1984-11-12,1985-04-08,148,7,73,317,390,76,218,294,684,28,198,MI - Port Huron
35,1985-1986,1985-11-22,1986-04-22,152,10,96,353,449,65,222,287,736,27,176,MI - Port Huron
36,1986-1987,1986-11-13,1987-04-03,142,6,43,279,322,34,114,148,470,16,70,MI - Port Huron
37,1987-1988,1987-11-21,1988-03-21,122,5,62,345,407,41,103,144,551,17,108,MI - Port Huron
38,1988-1989,1988-12-01,1989-03-22,112,4,65,332,397,36,52,88,485,20,131,MI - Port Huron
39,1989-1990,1989-11-18,1990-04-03,137,1,78,391,469,56,168,224,693,28,191,MI - Port Huron
40,1990-1991,1990-12-01,1991-03-16,106,1,66,307,373,55,154,209,582,22,173,MI - Port Huron
41,1991-1992,1991-11-03,1992-04-02,152,1,57,324,381,70,145,215,596,24,178,MI - Port Huron
42,1992-1993,1992-11-14,1993-04-01,139,20,62,277,339,39,135,174,513,16,91,MI - Port Huron
43,1993-1994,1993-11-07,1994-03-29,143,18,131,384,515,28,131,159,674,15,123,MI - Port Huron
44,1994-1995,1994-12-01,1995-04-05,126,14,57,258,315,25,85,110,425,13,68,MI - Port Huron
47,1997-1998,1997-11-15,1998-03-23,129,1,20,162,182,38,98,136,318,13,63,MI - Port Huron
49,1999-2000,1999-11-30,2000-03-11,103,10,48,193,241,48,126,174,415,15,102,MI - Port Huron
50,2000-2001,2000-11-22,2001-03-26,125,14,83,302,385,80,362,442,827,29,197,MI - Port Huron
51,2001-2002,2001-12-01,2002-04-06,127,4,35,185,220,37,65,102,322,21,95,MI - Port Huron
52,2002-2003,2002-11-24,2003-04-07,135,5,110,366,476,102,203,305,781,36,245,MI - Port Huron
53,2003-2004,2003-12-01,2004-04-03,125,3,82,282,364,68,243,311,675,33,195,MI - Port Huron
54,2004-2005,2004-11-24,2005-04-24,152,19,91,324,415,108,243,351,766,46,298,MI - Port Huron
55,2005-2006,2005-11-17,2006-04-04,139,14,52,231,283,47,109,156,439,24,111,MI - Port Huron
57,2007-2008,2007-12-01,2008-03-27,118,3,62,262,324,106,233,339,663,28,194,MI - Port Huron
58,2008-2009,2008-11-18,2009-03-12,115,1,98,315,413,88,247,335,748,29,227,MI - Port Huron
59,2009-2010,2009-12-01,2010-03-26,116,0,57,201,258,40,136,176,434,16,92,MI - Port Huron
60,2010-2011,2010-12-01,2011-04-18,139,1,100,309,409,94,399,493,902,30,204,MI - Port Huron
61,2011-2012,2011-12-01,2012-03-05,96,0,23,139,162,19,28,47,209,10,58,MI - Port Huron
62,2012-2013,2012-12-01,2013-03-20,110,0,56,206,262,36,113,149,411,17,109,MI - Port Huron
63,2013-2014,2013-11-12,2014-04-15,155,1,163,460,623,87,368,455,1078,36,307,MI - Port Huron
67,2017-2018,2017-11-10,2018-03-17,128,7,98,265,363,68,194,262,625,27,183,MI - Port Huron
68,2018-2019,2018-11-12,2019-03-31,140,4,73,255,328,36,79,115,443,18,103,MI - Port Huron
69,2019-2020,2019-11-11,2020-03-21,132,0,27,149,176,32,55,87,263,11,54,MI - Port Huron
0,1950-1951,1950-11-11,1951-04-18,159,0,115,400,515,72,197,269,784,43,259,MI - Saginaw
1,1951-1952,1951-11-02,1952-04-06,157,3,93,408,501,126,264,390,891,45,300,MI - Saginaw
2,1952-1953,1952-11-27,1953-03-17,111,0,56,233,289,36,55,91,380,24,103,MI - Saginaw
3,1953-1954,1953-11-26,1954-04-03,129,0,70,319,389,79,168,247,636,36,192,MI - Saginaw
4,1954-1955,1954-11-27,1955-03-28,122,3,86,349,435,75,224,299,734,36,194,MI - Saginaw
5,1955-1956,1955-11-02,1956-04-08,159,0,96,391,487,71,161,232,719,44,209,MI - Saginaw
6,1956-1957,1956-11-10,1957-03-27,138,0,97,357,454,63,124,187,641,40,224,MI - Saginaw
7,1957-1958,1957-11-22,1958-03-10,109,0,99,312,411,44,251,295,706,22,135,MI - Saginaw
8,1958-1959,1958-11-24,1959-04-02,130,0,157,485,642,73,414,487,1129,34,243,MI - Saginaw
9,1959-1960,1959-11-12,1960-03-29,139,0,96,355,451,81,368,449,900,39,215,MI - Saginaw
10,1960-1961,1960-11-09,1961-04-16,159,0,119,376,495,51,113,164,659,23,153,MI - Saginaw
11,1961-1962,1961-11-22,1962-04-13,143,0,154,423,577,73,399,472,1049,40,250,MI - Saginaw
12,1962-1963,1962-11-19,1963-04-30,163,0,209,505,714,64,393,457,1171,32,235,MI - Saginaw
13,1963-1964,1963-12-01,1964-04-08,130,0,93,336,429,43,101,144,573,32,164,MI - Saginaw
14,1964-1965,1964-11-19,1965-04-18,151,0,125,402,527,97,246,343,870,37,254,MI - Saginaw
15,1965-1966,1965-11-17,1966-04-07,142,0,91,309,400,60,186,246,646,29,166,MI - Saginaw
16,1966-1967,1966-11-02,1967-04-07,157,0,111,362,473,126,461,587,1060,38,253,MI - Saginaw
17,1967-1968,1967-10-27,1968-04-25,182,3,114,365,479,72,121,193,672,23,176,MI - Saginaw
18,1968-1969,1968-11-19,1969-03-30,132,3,81,299,380,64,193,257,637,31,160,MI - Saginaw
19,1969-1970,1969-11-15,1970-04-06,143,0,143,454,597,73,197,270,867,37,258,MI - Saginaw
20,1970-1971,1970-11-23,1971-04-24,153,0,112,350,462,88,306,394,856,36,196,MI - Saginaw
21,1971-1972,1971-11-09,1972-04-07,151,0,119,359,478,90,227,317,795,35,217,MI - Saginaw
22,1972-1973,1972-11-15,1973-04-11,148,0,106,297,403,92,184,276,679,27,172,MI - Saginaw
23,1973-1974,1973-12-01,1974-04-08,129,3,110,323,433,66,159,225,658,34,208,MI - Saginaw
24,1974-1975,1974-11-14,1975-04-10,148,0,60,281,341,68,116,184,525,26,118,MI - Saginaw
25,1975-1976,1975-11-25,1976-03-18,115,0,101,310,411,86,378,464,875,34,225,MI - Saginaw
26,1976-1977,1976-11-22,1977-03-22,121,0,165,418,583,35,202,237,820,24,148,MI - Saginaw
27,1977-1978,1977-11-13,1978-03-26,134,0,184,505,689,81,459,540,1229,31,256,MI - Saginaw
28,1978-1979,1978-11-20,1979-04-08,140,3,182,452,634,87,436,523,1157,36,247,MI - Saginaw
29,1979-1980,1979-11-09,1980-04-24,168,0,97,346,443,43,37,80,523,21,102,MI - Saginaw
30,1980-1981,1980-11-27,1981-03-19,113,0,122,365,487,62,308,370,857,19,143,MI - Saginaw
31,1981-1982,1981-11-20,1982-04-11,143,0,154,426,580,70,273,343,923,28,226,MI - Saginaw
32,1982-1983,1982-11-14,1983-04-17,155,0,61,256,317,35,65,100,417,13,68,MI - Saginaw
33,1983-1984,1983-11-11,1984-03-22,133,3,144,399,543,41,198,239,782,20,111,MI - Saginaw
34,1984-1985,1984-11-11,1985-04-17,158,0,110,356,466,98,405,503,969,30,251,MI - Saginaw
35,1985-1986,1985-11-09,1986-03-20,132,3,130,365,495,76,223,299,794,30,185,MI - Saginaw
36,1986-1987,1986-11-13,1987-03-14,122,0,58,262,320,39,110,149,469,15,78,MI - Saginaw
37,1987-1988,1987-11-20,1988-03-21,123,0,99,334,433,58,121,179,612,26,157,MI - Saginaw
38,1988-1989,1988-12-01,1989-03-25,115,6,97,327,424,68,97,165,589,19,153,MI - Saginaw
39,1989-1990,1989-10-19,1990-04-06,170,9,104,373,477,69,160,229,706,27,180,MI - Saginaw
40,1990-1991,1990-12-01,1991-03-29,119,0,85,274,359,52,126,178,537,20,126,MI - Saginaw
41,1991-1992,1991-11-02,1992-04-02,153,3,75,323,398,73,110,183,581,29,186,MI - Saginaw
42,1992-1993,1992-10-20,1993-04-11,174,0,84,332,416,72,161,233,649,34,172,MI - Saginaw
43,1993-1994,1993-11-06,1994-05-01,177,6,168,468,636,48,189,237,873,31,221,MI - Saginaw
44,1994-1995,1994-12-01,1995-04-08,129,0,84,292,376,42,155,197,573,23,116,MI - Saginaw
45,1995-1996,1995-11-09,1996-04-09,153,0,132,466,598,99,308,407,1005,48,298,MI - Saginaw
46,1996-1997,1996-11-02,1997-04-13,163,0,87,342,429,116,274,390,819,62,310,MI - Saginaw
47,1997-1998,1997-10-27,1998-03-21,146,0,32,224,256,60,151,211,467,32,128,MI - Saginaw
48,1998-1999,1998-12-01,1999-03-16,106,0,84,289,373,81,229,310,683,36,251,MI - Saginaw
49,1999-2000,1999-12-01,2000-04-11,133,0,74,316,390,72,247,319,709,37,217,MI - Saginaw
50,2000-2001,2000-11-14,2001-04-17,155,4,102,368,470,102,428,530,1000,54,338,MI - Saginaw
52,2002-2003,2002-11-21,2003-04-09,140,13,131,437,568,73,91,164,732,49,308,MI - Saginaw
61,2011-2012,2011-11-29,2012-03-30,123,3,31,183,214,72,93,165,379,34,159,MI - Saginaw
62,2012-2013,2012-10-30,2013-04-24,177,6,66,300,366,72,174,246,612,39,194,MI - Saginaw
63,2013-2014,2013-11-23,2014-04-16,145,5,191,521,712,97,686,783,1495,52,395,MI - Saginaw
64,2014-2015,2014-11-15,2015-04-22,159,1,134,426,560,61,359,420,980,36,247,MI - Saginaw
65,2015-2016,2015-11-21,2016-04-10,142,3,50,213,263,79,155,234,497,31,177,MI - Saginaw
66,2016-2017,2016-10-26,2017-03-22,148,3,69,244,313,55,103,158,471,27,147,MI - Saginaw
67,2017-2018,2017-11-10,2018-04-17,159,9,110,377,487,64,199,263,750,35,219,MI - Saginaw
68,2018-2019,2018-11-09,2019-04-15,158,7,103,344,447,76,137,213,660,40,223,MI - Saginaw
69,2019-2020,2019-11-06,2020-04-21,168,4,39,247,286,56,123,179,465,27,125,MI - Saginaw
0,1950-1951,1950-10-22,1951-04-21,182,0,201,568,769,171,998,1169,1938,82,558,MI - Sault Ste Marie
1,1951-1952,1951-10-28,1952-04-14,170,0,189,596,785,159,636,795,1580,77,557,MI - Sault Ste Marie
2,1952-1953,1952-10-16,1953-04-27,194,0,138,446,584,169,690,859,1443,83,473,MI - Sault Ste Marie
3,1953-1954,1953-11-03,1954-05-07,186,0,169,549,718,109,613,722,1440,72,480,MI - Sault Ste Marie
4,1954-1955,1954-11-21,1955-04-07,138,0,184,532,716,120,636,756,1472,66,467,MI - Sault Ste Marie
5,1955-1956,1955-10-24,1956-04-29,189,0,193,633,826,165,1135,1300,2126,83,532,MI - Sault Ste Marie
6,1956-1957,1956-09-20,1957-04-16,209,1,207,680,887,153,912,1065,1952,82,612,MI - Sault Ste Marie
7,1957-1958,1957-10-25,1958-04-08,166,0,178,494,672,119,788,907,1579,68,404,MI - Sault Ste Marie
8,1958-1959,1958-11-06,1959-04-13,159,0,268,721,989,150,1213,1363,2352,71,619,MI - Sault Ste Marie
9,1959-1960,1959-10-18,1960-04-27,193,0,197,580,777,141,806,947,1724,83,512,MI - Sault Ste Marie
10,1960-1961,1960-10-20,1961-05-02,195,0,201,593,794,120,709,829,1623,82,556,MI - Sault Ste Marie
11,1961-1962,1961-09-28,1962-05-08,223,0,233,638,871,173,1001,1174,2045,83,645,MI - Sault Ste Marie
12,1962-1963,1962-10-23,1963-05-22,212,0,282,740,1022,141,859,1000,2022,73,696,MI - Sault Ste Marie
13,1963-1964,1963-11-01,1964-04-16,168,0,169,565,734,204,993,1197,1931,85,618,MI - Sault Ste Marie
14,1964-1965,1964-09-27,1965-04-23,209,0,234,684,918,237,998,1235,2153,93,731,MI - Sault Ste Marie
15,1965-1966,1965-09-25,1966-05-28,246,0,172,528,700,179,469,648,1348,102,604,MI - Sault Ste Marie
16,1966-1967,1966-10-11,1967-05-11,213,0,223,695,918,164,857,1021,1939,90,662,MI - Sault Ste Marie
17,1967-1968,1967-10-26,1968-04-26,184,0,213,641,854,181,859,1040,1894,87,682,MI - Sault Ste Marie
18,1968-1969,1968-10-25,1969-04-04,162,0,179,580,759,165,752,917,1676,79,583,MI - Sault Ste Marie
19,1969-1970,1969-10-21,1970-05-05,197,0,242,731,973,167,976,1143,2116,82,609,MI - Sault Ste Marie
20,1970-1971,1970-10-15,1971-05-12,210,0,256,706,962,210,1113,1323,2285,88,785,MI - Sault Ste Marie
21,1971-1972,1971-11-03,1972-04-26,176,0,229,677,906,250,1251,1501,2407,101,844,MI - Sault Ste Marie
22,1972-1973,1972-10-14,1973-05-17,216,0,163,506,669,146,707,853,1522,77,467,MI - Sault Ste Marie
23,1973-1974,1973-10-16,1974-05-05,202,0,234,651,885,168,951,1119,2004,83,574,MI - Sault Ste Marie
24,1974-1975,1974-10-01,1975-04-19,201,0,165,607,772,185,1096,1281,2053,79,586,MI - Sault Ste Marie
25,1975-1976,1975-11-12,1976-05-05,176,0,204,648,852,205,936,1141,1993,96,801,MI - Sault Ste Marie
26,1976-1977,1976-10-16,1977-04-12,179,3,288,752,1040,258,1271,1529,2569,115,965,MI - Sault Ste Marie
27,1977-1978,1977-11-10,1978-04-18,160,3,230,680,910,186,1112,1298,2208,85,662,MI - Sault Ste Marie
28,1978-1979,1978-11-12,1979-05-05,175,3,289,711,1000,228,1207,1435,2435,86,830,MI - Sault Ste Marie
29,1979-1980,1979-10-10,1980-04-23,197,0,192,612,804,167,723,890,1694,80,566,MI - Sault Ste Marie
30,1980-1981,1980-10-12,1981-04-23,194,0,232,737,969,208,947,1155,2124,80,750,MI - Sault Ste Marie
31,1981-1982,1981-10-01,1982-04-26,208,0,249,801,1050,242,1153,1395,2445,91,784,MI - Sault Ste Marie
32,1982-1983,1982-11-05,1983-04-17,164,0,146,515,661,136,510,646,1307,67,437,MI - Sault Ste Marie
33,1983-1984,1983-11-10,1984-05-01,174,0,252,681,933,159,913,1072,2005,77,701,MI - Sault Ste Marie
34,1984-1985,1984-09-26,1985-04-19,206,0,208,644,852,224,964,1188,2040,83,683,MI - Sault Ste Marie
35,1985-1986,1985-10-16,1986-05-01,198,0,222,655,877,222,1188,1410,2287,87,753,MI - Sault Ste Marie
36,1986-1987,1986-11-09,1987-04-03,146,0,112,443,555,145,797,942,1497,61,454,MI - Sault Ste Marie
37,1987-1988,1987-10-10,1988-04-23,197,0,195,619,814,204,907,1111,1925,84,641,MI - Sault Ste Marie
38,1988-1989,1988-10-25,1989-04-14,172,0,193,622,815,211,1012,1223,2038,104,744,MI - Sault Ste Marie
39,1989-1990,1989-09-23,1990-05-11,231,0,194,664,858,232,1260,1492,2350,98,673,MI - Sault Ste Marie
40,1990-1991,1990-10-18,1991-04-16,181,0,155,550,705,165,731,896,1601,81,578,MI - Sault Ste Marie
41,1991-1992,1991-09-26,1992-05-01,219,0,180,609,789,175,1039,1214,2003,78,559,MI - Sault Ste Marie
42,1992-1993,1992-10-13,1993-04-20,190,0,162,598,760,154,785,939,1699,72,478,MI - Sault Ste Marie
43,1993-1994,1993-10-02,1994-04-17,198,0,290,771,1061,167,915,1082,2143,86,706,MI - Sault Ste Marie
44,1994-1995,1994-11-22,1995-04-25,155,0,148,479,627,146,564,710,1337,65,494,MI - Sault Ste Marie
45,1995-1996,1995-10-29,1996-05-01,186,0,271,773,1044,322,1513,1835,2879,99,905,MI - Sault Ste Marie
48,1998-1999,1998-11-07,1999-04-07,152,2,155,457,612,136,860,996,1608,63,481,MI - Sault Ste Marie
49,1999-2000,1999-11-16,2000-04-17,154,0,136,450,586,164,667,831,1417,71,526,MI - Sault Ste Marie
50,2000-2001,2000-11-14,2001-04-25,163,0,200,559,759,166,1120,1286,2045,89,665,MI - Sault Ste Marie
51,2001-2002,2001-10-26,2002-05-11,198,0,96,417,513,184,815,999,1512,82,504,MI - Sault Ste Marie
52,2002-2003,2002-10-14,2003-04-15,184,0,205,620,825,178,1000,1178,2003,84,664,MI - Sault Ste Marie
53,2003-2004,2003-10-02,2004-04-27,209,0,181,536,717,187,1058,1245,1962,87,626,MI - Sault Ste Marie
54,2004-2005,2004-11-07,2005-05-01,176,18,192,573,765,125,864,989,1754,64,478,MI - Sault Ste Marie
55,2005-2006,2005-11-06,2006-04-04,150,0,144,428,572,167,904,1071,1643,74,493,MI - Sault Ste Marie
56,2006-2007,2006-10-13,2007-04-14,184,0,171,511,682,166,680,846,1528,76,632,MI - Sault Ste Marie
57,2007-2008,2007-10-27,2008-04-15,172,2,167,534,701,210,1005,1215,1916,88,631,MI - Sault Ste Marie
58,2008-2009,2008-10-28,2009-05-16,201,0,219,602,821,187,1130,1317,2138,84,683,MI - Sault Ste Marie
59,2009-2010,2009-10-12,2010-05-08,209,0,124,415,539,124,626,750,1289,56,354,MI - Sault Ste Marie
60,2010-2011,2010-10-21,2011-04-21,183,0,189,559,748,128,717,845,1593,68,441,MI - Sault Ste Marie
61,2011-2012,2011-11-10,2012-04-17,160,0,80,341,421,127,512,639,1060,59,343,MI - Sault Ste Marie
62,2012-2013,2012-10-10,2013-05-13,216,0,154,494,648,244,1130,1374,2022,98,669,MI - Sault Ste Marie
63,2013-2014,2013-10-22,2014-04-26,187,2,323,785,1108,207,1249,1456,2564,109,947,MI - Sault Ste Marie
64,2014-2015,2014-11-07,2015-04-23,168,2,244,704,948,234,1335,1569,2517,87,734,MI - Sault Ste Marie
65,2015-2016,2015-10-16,2016-05-15,213,0,109,382,491,150,574,724,1215,82,479,MI - Sault Ste Marie
66,2016-2017,2016-11-19,2017-04-27,160,0,115,370,485,194,891,1085,1570,79,533,MI - Sault Ste Marie
67,2017-2018,2017-10-31,2018-04-26,178,0,189,579,768,185,1105,1290,2058,83,582,MI - Sault Ste Marie
68,2018-2019,2018-10-12,2019-05-01,202,0,198,577,775,225,1351,1576,2351,100,709,MI - Sault Ste Marie
69,2019-2020,2019-11-01,2020-05-09,191,0,105,436,541,213,1041,1254,1795,96,570,MI - Sault Ste Marie
0,1950-1951,1950-11-09,1951-04-09,152,13,255,788,1043,101,826,927,1970,26,285,MN - Austin
1,1951-1952,1951-11-01,1952-04-13,165,3,161,619,780,93,493,586,1366,34,272,MN - Austin
2,1952-1953,1952-11-24,1953-04-15,143,1,122,499,621,52,476,528,1149,28,182,MN - Austin
3,1953-1954,1953-11-22,1954-05-03,163,0,103,466,569,40,63,103,672,25,154,MN - Austin
4,1954-1955,1954-11-01,1955-03-28,148,13,150,544,694,44,312,356,1050,26,189,MN - Austin
5,1955-1956,1955-10-29,1956-04-29,184,15,205,802,1007,71,611,682,1689,28,238,MN - Austin
6,1956-1957,1956-11-15,1957-04-05,142,5,126,529,655,40,111,151,806,23,154,MN - Austin
7,1957-1958,1957-11-16,1958-03-20,125,1,139,456,595,37,211,248,843,18,108,MN - Austin
8,1958-1959,1958-11-24,1959-03-27,124,7,208,669,877,76,464,540,1417,22,237,MN - Austin
9,1959-1960,1959-11-05,1960-03-25,142,5,163,585,748,47,232,279,1027,21,163,MN - Austin
10,1960-1961,1960-11-29,1961-04-17,140,0,128,521,649,63,243,306,955,21,175,MN - Austin
11,1961-1962,1961-09-30,1962-04-17,200,6,223,677,900,112,721,833,1733,34,286,MN - Austin
12,1962-1963,1962-11-17,1963-03-20,124,11,228,633,861,45,218,263,1124,21,218,MN - Austin
13,1963-1964,1963-11-23,1964-03-31,130,0,143,525,668,47,140,187,855,25,172,MN - Austin
14,1964-1965,1964-11-19,1965-04-05,138,7,239,703,942,84,441,525,1467,33,304,MN - Austin
15,1965-1966,1965-11-18,1966-04-11,145,0,184,539,723,43,219,262,985,15,138,MN - Austin
16,1966-1967,1966-11-02,1967-03-20,139,1,149,545,694,59,326,385,1079,19,177,MN - Austin
21,1971-1972,1971-11-07,1972-04-08,154,1,238,666,904,64,405,469,1373,22,200,MN - Austin
23,1973-1974,1973-11-05,1974-04-14,161,6,179,523,702,38,307,345,1047,16,114,MN - Austin
26,1976-1977,1976-10-24,1977-04-04,163,19,223,709,932,29,189,218,1150,14,123,MN - Austin
27,1977-1978,1977-11-21,1978-04-20,151,14,253,680,933,40,590,630,1563,17,149,MN - Austin
35,1985-1986,1985-11-09,1986-03-20,132,5,222,584,806,64,840,904,1710,16,148,MN - Austin
36,1986-1987,1986-11-09,1987-03-29,141,9,75,320,395,27,58,85,480,8,52,MN - Austin
37,1987-1988,1987-12-01,1988-04-27,149,8,156,477,633,71,432,503,1136,18,144,MN - Austin
43,1993-1994,1993-10-29,1994-04-05,159,9,277,686,963,78,563,641,1604,30,330,MN - Austin
49,1999-2000,1999-10-01,2000-04-07,190,19,109,489,598,58,132,190,788,22,191,MN - Austin
50,2000-2001,2000-11-08,2001-04-16,160,5,279,741,1020,98,834,932,1952,38,350,MN - Austin
51,2001-2002,2001-10-24,2002-04-21,180,1,107,414,521,43,124,167,688,21,147,MN - Austin
52,2002-2003,2002-10-24,2003-04-09,168,14,173,606,779,58,151,209,988,25,188,MN - Austin
56,2006-2007,2006-10-12,2007-04-13,184,6,184,574,758,99,429,528,1286,23,243,MN - Austin
57,2007-2008,2007-11-22,2008-03-24,124,16,229,596,825,43,423,466,1291,26,226,MN - Austin
58,2008-2009,2008-11-07,2009-04-05,150,8,232,663,895,66,354,420,1315,27,265,MN - Austin
59,2009-2010,2009-10-13,2010-03-14,153,3,213,567,780,59,550,609,1389,25,219,MN - Austin
60,2010-2011,2010-11-13,2011-04-20,159,6,236,635,871,77,569,646,1517,29,243,MN - Austin
61,2011-2012,2011-11-21,2012-03-06,107,2,83,341,424,28,102,130,554,16,116,MN - Austin
62,2012-2013,2012-11-13,2013-05-05,174,5,174,552,726,72,316,388,1114,30,184,MN - Austin
63,2013-2014,2013-11-11,2014-04-30,171,0,320,794,1114,88,553,641,1755,41,428,MN - Austin
64,2014-2015,2014-11-11,2015-03-28,138,0,232,591,823,49,316,365,1188,23,180,MN - Austin
65,2015-2016,2015-11-21,2016-03-26,127,0,131,376,507,52,319,371,878,17,109,MN - Austin
66,2016-2017,2016-11-20,2017-03-19,120,0,132,393,525,69,266,335,860,14,128,MN - Austin
67,2017-2018,2017-11-01,2018-04-21,172,4,235,618,853,78,316,394,1247,24,232,MN - Austin
68,2018-2019,2018-11-08,2019-04-14,158,2,258,621,879,96,493,589,1468,27,292,MN - Austin
69,2019-2020,2019-10-31,2020-04-17,170,10,142,502,644,54,427,481,1125,16,126,MN - Austin
0,1950-1951,1950-11-09,1951-04-13,156,8,231,767,998,100,591,691,1689,23,306,MN - Canby
1,1951-1952,1951-10-22,1952-04-06,168,3,207,672,879,98,533,631,1510,27,267,MN - Canby
2,1952-1953,1952-11-24,1953-04-03,131,1,127,474,601,70,442,512,1113,19,197,MN - Canby
3,1953-1954,1953-11-21,1954-05-03,164,2,141,509,650,60,359,419,1069,16,130,MN - Canby
4,1954-1955,1954-11-29,1955-03-26,118,5,135,509,644,32,209,241,885,10,102,MN - Canby
5,1955-1956,1955-11-07,1956-04-08,154,3,254,729,983,51,514,565,1548,18,192,MN - Canby
6,1956-1957,1956-11-15,1957-04-11,148,3,156,572,728,54,158,212,940,12,141,MN - Canby
7,1957-1958,1957-10-25,1958-04-06,164,1,132,493,625,35,165,200,825,12,80,MN - Canby
8,1958-1959,1958-11-18,1959-04-12,146,0,191,649,840,39,137,176,1016,13,134,MN - Canby
9,1959-1960,1959-10-12,1960-04-06,178,2,197,641,838,64,504,568,1406,13,132,MN - Canby
10,1960-1961,1960-11-09,1961-04-17,160,0,125,539,664,30,112,142,806,10,80,MN - Canby
11,1961-1962,1961-11-03,1962-04-12,161,0,224,691,915,88,505,593,1508,23,231,MN - Canby
12,1962-1963,1962-11-17,1963-04-23,158,1,170,568,738,36,194,230,968,12,114,MN - Canby
13,1963-1964,1963-11-24,1964-03-31,129,0,150,532,682,33,213,246,928,8,87,MN - Canby
14,1964-1965,1964-11-19,1965-04-24,157,6,256,751,1007,89,589,678,1685,24,275,MN - Canby
15,1965-1966,1965-11-13,1966-04-28,167,2,204,611,815,58,232,290,1105,15,157,MN - Canby
16,1966-1967,1966-11-02,1967-04-17,167,6,162,628,790,58,371,429,1219,17,221,MN - Canby
17,1967-1968,1967-11-04,1968-04-14,163,0,155,570,725,24,91,115,840,9,55,MN - Canby
19,1969-1970,1969-10-13,1970-04-23,193,0,194,653,847,68,508,576,1423,18,153,MN - Canby
20,1970-1971,1970-10-09,1971-03-23,166,4,205,608,813,50,289,339,1152,22,163,MN - Canby
21,1971-1972,1971-10-29,1972-04-22,177,0,218,666,884,57,509,566,1450,30,216,MN - Canby
22,1972-1973,1972-11-12,1973-02-28,109,0,166,462,628,26,262,288,916,11,108,MN - Canby
23,1973-1974,1973-11-04,1974-03-26,143,0,198,568,766,40,321,361,1127,13,134,MN - Canby
24,1974-1975,1974-11-13,1975-03-31,139,0,155,568,723,78,540,618,1341,23,221,MN - Canby
25,1975-1976,1975-11-12,1976-03-21,131,1,153,535,688,79,685,764,1452,18,195,MN - Canby
26,1976-1977,1976-10-18,1977-03-13,147,0,221,651,872,55,316,371,1243,18,176,MN - Canby
27,1977-1978,1977-12-01,1978-04-20,141,0,275,652,927,57,653,710,1637,25,216,MN - Canby
28,1978-1979,1978-11-12,1979-04-12,152,1,311,806,1117,100,871,971,2088,31,338,MN - Canby
29,1979-1980,1979-10-22,1980-03-28,159,6,136,566,702,44,218,262,964,23,152,MN - Canby
30,1980-1981,1980-11-14,1981-03-06,113,0,124,455,579,17,60,77,656,10,98,MN - Canby
31,1981-1982,1981-11-19,1982-04-20,153,4,261,673,934,97,711,808,1742,29,310,MN - Canby
32,1982-1983,1982-10-20,1983-04-16,179,4,122,491,613,89,425,514,1127,22,147,MN - Canby
33,1983-1984,1983-11-09,1984-03-30,143,5,259,607,866,97,716,813,1679,26,236,MN - Canby
34,1984-1985,1984-10-31,1985-03-31,152,7,208,587,795,56,246,302,1097,16,158,MN - Canby
35,1985-1986,1985-11-09,1986-03-23,135,2,253,639,892,76,735,811,1703,24,247,MN - Canby
36,1986-1987,1986-11-09,1987-03-30,142,0,72,414,486,24,60,84,570,9,51,MN - Canby
37,1987-1988,1987-11-21,1988-04-27,159,5,188,581,769,62,530,592,1361,18,172,MN - Canby
38,1988-1989,1988-11-12,1989-04-09,149,2,192,633,825,75,380,455,1280,22,229,MN - Canby
39,1989-1990,1989-11-01,1990-03-24,144,0,147,547,694,45,128,173,867,15,120,MN - Canby
40,1990-1991,1990-10-18,1991-03-30,164,1,169,545,714,48,251,299,1013,19,123,MN - Canby
41,1991-1992,1991-10-30,1992-04-22,176,0,97,469,566,47,215,262,828,15,125,MN - Canby
42,1992-1993,1992-10-16,1993-04-14,181,0,215,613,828,72,554,626,1454,26,186,MN - Canby
43,1993-1994,1993-10-30,1994-05-01,184,4,277,662,939,92,630,722,1661,35,381,MN - Canby
44,1994-1995,1994-11-28,1995-04-19,143,2,141,435,576,62,144,206,782,20,133,MN - Canby
45,1995-1996,1995-10-24,1996-04-15,175,7,283,711,994,98,479,577,1571,27,303,MN - Canby
46,1996-1997,1996-10-31,1997-04-12,164,2,286,702,988,105,980,1085,2073,32,343,MN - Canby
47,1997-1998,1997-11-03,1998-04-05,154,1,126,423,549,67,286,353,902,27,168,MN - Canby
48,1998-1999,1998-11-06,1999-04-06,152,2,132,460,592,62,298,360,952,22,216,MN - Canby
49,1999-2000,1999-12-01,2000-04-17,139,2,88,429,517,38,174,212,729,19,137,MN - Canby
50,2000-2001,2000-11-09,2001-04-06,149,3,240,690,930,90,931,1021,1951,30,259,MN - Canby
51,2001-2002,2001-11-26,2002-04-28,154,4,119,443,562,79,385,464,1026,21,169,MN - Canby
52,2002-2003,2002-10-16,2003-04-05,172,6,155,585,740,42,162,204,944,15,113,MN - Canby
53,2003-2004,2003-11-04,2004-03-17,135,2,162,499,661,57,300,357,1018,20,198,MN - Canby
54,2004-2005,2004-12-01,2005-03-21,111,3,125,444,569,23,77,100,669,16,127,MN - Canby
55,2005-2006,2005-11-17,2006-03-22,126,4,139,414,553,43,208,251,804,16,121,MN - Canby
57,2007-2008,2007-11-22,2008-04-28,159,0,220,649,869,72,328,400,1269,20,164,MN - Canby
60,2010-2011,2010-11-21,2011-04-16,147,8,274,662,936,130,829,959,1895,34,376,MN - Canby
61,2011-2012,2011-11-20,2012-03-08,110,1,75,341,416,30,84,114,530,11,84,MN - Canby
62,2012-2013,2012-10-25,2013-04-27,185,3,206,682,888,120,757,877,1765,28,251,MN - Canby
63,2013-2014,2013-11-05,2014-04-17,164,0,283,791,1074,81,325,406,1480,28,292,MN - Canby
64,2014-2015,2014-11-10,2015-03-23,134,0,213,562,775,39,190,229,1004,16,135,MN - Canby
65,2015-2016,2015-11-20,2016-03-24,126,5,139,375,514,58,309,367,881,18,149,MN - Canby
66,2016-2017,2016-11-18,2017-05-01,165,2,156,465,621,64,257,321,942,11,138,MN - Canby
67,2017-2018,2017-10-28,2018-04-23,178,4,203,637,840,119,344,463,1303,20,239,MN - Canby
68,2018-2019,2018-11-07,2019-04-17,162,1,282,676,958,129,760,889,1847,31,408,MN - Canby
69,2019-2020,2019-11-07,2020-04-04,150,0,158,479,637,72,585,657,1294,17,143,MN - Canby
0,1950-1951,1950-10-22,1951-05-05,196,0,365,876,1241,161,1271,1432,2673,65,558,MN - Duluth
1,1951-1952,1951-10-22,1952-04-15,177,0,286,814,1100,122,1044,1166,2266,62,522,MN - Duluth
2,1952-1953,1952-10-15,1953-04-28,196,0,209,666,875,115,740,855,1730,58,459,MN - Duluth
3,1953-1954,1953-11-04,1954-05-08,186,0,233,740,973,125,932,1057,2030,62,514,MN - Duluth
4,1954-1955,1954-10-29,1955-04-07,161,0,253,719,972,137,871,1008,1980,62,504,MN - Duluth
5,1955-1956,1955-10-28,1956-05-10,196,0,290,893,1183,160,1443,1603,2786,70,549,MN - Duluth
6,1956-1957,1956-11-07,1957-04-16,161,0,301,834,1135,135,1005,1140,2275,69,614,MN - Duluth
7,1957-1958,1957-10-24,1958-04-29,188,0,226,660,886,80,664,744,1630,45,297,MN - Duluth
8,1958-1959,1958-10-10,1959-04-18,191,0,346,858,1204,76,647,723,1927,51,449,MN - Duluth
9,1959-1960,1959-10-11,1960-04-29,202,0,242,795,1037,121,858,979,2016,68,530,MN - Duluth
10,1960-1961,1960-11-02,1961-05-10,190,0,227,678,905,112,603,715,1620,55,368,MN - Duluth
11,1961-1962,1961-11-03,1962-05-08,187,0,340,805,1145,107,922,1029,2174,60,537,MN - Duluth
12,1962-1963,1962-10-24,1963-05-19,208,0,326,804,1130,94,545,639,1769,63,564,MN - Duluth
13,1963-1964,1963-11-23,1964-04-14,144,0,224,663,887,91,673,764,1651,48,384,MN - Duluth
14,1964-1965,1964-11-18,1965-05-28,192,0,344,946,1290,164,1285,1449,2739,58,572,MN - Duluth
15,1965-1966,1965-11-09,1966-05-13,186,0,278,761,1039,140,1104,1244,2283,67,509,MN - Duluth
16,1966-1967,1966-10-15,1967-05-10,208,0,281,860,1141,130,1034,1164,2305,63,517,MN - Duluth
17,1967-1968,1967-10-09,1968-05-18,223,0,258,773,1031,71,365,436,1467,49,318,MN - Duluth
18,1968-1969,1968-11-06,1969-04-29,175,0,274,736,1010,182,1325,1507,2517,65,588,MN - Duluth
19,1969-1970,1969-10-12,1970-05-01,202,0,305,844,1149,150,1060,1210,2359,71,586,MN - Duluth
20,1970-1971,1970-10-10,1971-05-19,222,0,318,836,1154,177,1109,1286,2440,68,619,MN - Duluth
21,1971-1972,1971-10-28,1972-04-26,182,0,380,893,1273,166,1136,1302,2575,71,650,MN - Duluth
22,1972-1973,1972-10-17,1973-05-02,198,0,288,706,994,82,656,738,1732,49,322,MN - Duluth
23,1973-1974,1973-11-03,1974-05-14,193,0,325,792,1117,113,971,1084,2201,57,453,MN - Duluth
24,1974-1975,1974-09-21,1975-04-28,220,0,268,740,1008,161,1208,1369,2377,72,562,MN - Duluth
25,1975-1976,1975-10-25,1976-04-05,164,0,294,713,1007,144,1025,1169,2176,67,596,MN - Duluth
26,1976-1977,1976-10-18,1977-04-06,171,0,358,823,1181,77,519,596,1777,53,498,MN - Duluth
27,1977-1978,1977-10-10,1978-04-23,196,0,324,763,1087,116,668,784,1871,61,493,MN - Duluth
28,1978-1979,1978-11-09,1979-05-06,179,0,398,887,1285,151,1135,1286,2571,83,696,MN - Duluth
29,1979-1980,1979-10-22,1980-04-12,174,0,245,695,940,93,638,731,1671,56,357,MN - Duluth
30,1980-1981,1980-10-22,1981-04-30,191,0,249,683,932,64,283,347,1279,42,328,MN - Duluth
31,1981-1982,1981-10-21,1982-04-21,183,0,357,855,1212,155,1131,1286,2498,63,618,MN - Duluth
32,1982-1983,1982-10-19,1983-04-22,186,0,207,600,807,139,887,1026,1833,58,333,MN - Duluth
33,1983-1984,1983-11-08,1984-05-08,183,0,333,755,1088,163,1188,1351,2439,60,581,MN - Duluth
34,1984-1985,1984-10-30,1985-04-08,161,0,282,710,992,109,484,593,1585,53,489,MN - Duluth
35,1985-1986,1985-09-30,1986-04-03,186,0,337,808,1145,137,1020,1157,2302,60,576,MN - Duluth
36,1986-1987,1986-10-12,1987-04-02,173,0,165,565,730,73,451,524,1254,45,269,MN - Duluth
37,1987-1988,1987-10-20,1988-04-23,187,0,269,772,1041,89,694,783,1824,47,343,MN - Duluth
38,1988-1989,1988-10-18,1989-05-06,201,0,298,845,1143,178,1128,1306,2449,70,586,MN - Duluth
39,1989-1990,1989-10-31,1990-05-09,191,0,259,788,1047,99,516,615,1662,63,513,MN - Duluth
40,1990-1991,1990-10-17,1991-05-06,202,0,253,723,976,103,611,714,1690,57,476,MN - Duluth
41,1991-1992,1991-09-18,1992-04-24,220,0,210,664,874,156,1227,1383,2257,56,464,MN - Duluth
42,1992-1993,1992-10-13,1993-04-29,199,0,230,688,918,156,1144,1300,2218,80,539,MN - Duluth
43,1993-1994,1993-10-28,1994-04-30,185,0,354,839,1193,173,1177,1350,2543,70,663,MN - Duluth
44,1994-1995,1994-10-24,1995-04-21,180,0,208,604,812,144,823,967,1779,62,427,MN - Duluth
45,1995-1996,1995-09-21,1996-04-25,218,0,369,917,1286,208,1328,1536,2822,89,747,MN - Duluth
46,1996-1997,1996-10-30,1997-05-14,197,0,324,795,1119,193,1295,1488,2607,85,802,MN - Duluth
47,1997-1998,1997-10-13,1998-04-03,173,0,162,479,641,129,667,796,1437,67,421,MN - Duluth
48,1998-1999,1998-11-05,1999-04-11,158,0,213,569,782,141,633,774,1556,60,483,MN - Duluth
49,1999-2000,1999-11-23,2000-04-20,150,0,170,538,708,94,330,424,1132,52,383,MN - Duluth
50,2000-2001,2000-11-07,2001-04-24,169,0,303,733,1036,151,1016,1167,2203,71,599,MN - Duluth
51,2001-2002,2001-10-05,2002-05-07,215,0,170,575,745,141,390,531,1276,69,460,MN - Duluth
52,2002-2003,2002-10-16,2003-04-17,184,0,297,748,1045,98,257,355,1400,53,399,MN - Duluth
53,2003-2004,2003-10-27,2004-04-26,183,0,239,661,900,164,821,985,1885,60,506,MN - Duluth
54,2004-2005,2004-11-25,2005-05-01,158,0,237,652,889,139,956,1095,1984,55,494,MN - Duluth
55,2005-2006,2005-10-07,2006-03-31,176,0,178,517,695,138,816,954,1649,61,449,MN - Duluth
56,2006-2007,2006-10-11,2007-05-20,222,0,238,636,874,120,464,584,1458,41,316,MN - Duluth
57,2007-2008,2007-11-05,2008-05-11,189,0,306,727,1033,134,910,1044,2077,64,461,MN - Duluth
58,2008-2009,2008-10-26,2009-04-07,164,0,328,780,1108,126,689,815,1923,61,590,MN - Duluth
59,2009-2010,2009-10-10,2010-05-08,211,0,209,602,811,107,799,906,1717,39,347,MN - Duluth
60,2010-2011,2010-10-26,2011-04-28,185,0,289,707,996,149,945,1094,2090,69,552,MN - Duluth
61,2011-2012,2011-11-15,2012-04-16,154,0,123,419,542,82,266,348,890,41,248,MN - Duluth
62,2012-2013,2012-09-21,2013-04-30,222,0,229,702,931,202,932,1134,2065,77,632,MN - Duluth
63,2013-2014,2013-10-21,2014-04-30,192,0,416,960,1376,194,1252,1446,2822,66,670,MN - Duluth
64,2014-2015,2014-10-30,2015-04-21,174,0,288,663,951,85,582,667,1618,50,331,MN - Duluth
65,2015-2016,2015-11-12,2016-05-13,184,0,168,505,673,128,644,772,1445,64,408,MN - Duluth
66,2016-2017,2016-11-18,2017-05-01,165,0,195,522,717,107,585,692,1409,54,380,MN - Duluth
67,2017-2018,2017-10-27,2018-04-27,183,0,302,786,1088,142,829,971,2059,63,548,MN - Duluth
68,2018-2019,2018-10-10,2019-05-20,223,0,273,720,993,164,903,1067,2060,69,564,MN - Duluth
69,2019-2020,2019-10-11,2020-04-20,193,0,195,630,825,143,1159,1302,2127,61,399,MN - Duluth
7,1957-1958,1957-11-08,1958-04-28,172,0,170,555,725,56,490,546,1271,35,181,MN - Grand Marais
8,1958-1959,1958-11-18,1959-03-28,131,0,289,728,1017,56,625,681,1698,23,224,MN - Grand Marais
9,1959-1960,1959-11-04,1960-04-26,175,0,171,618,789,63,562,625,1414,26,190,MN - Grand Marais
10,1960-1961,1960-11-10,1961-04-12,154,1,200,574,774,63,490,553,1327,28,194,MN - Grand Marais
11,1961-1962,1961-11-08,1962-05-08,182,4,233,665,898,71,782,853,1751,34,286,MN - Grand Marais
12,1962-1963,1962-10-24,1963-05-22,211,0,284,776,1060,59,491,550,1610,35,337,MN - Grand Marais
13,1963-1964,1963-11-23,1964-04-14,144,0,169,586,755,76,516,592,1347,33,234,MN - Grand Marais
14,1964-1965,1964-11-18,1965-04-18,152,0,270,746,1016,95,964,1059,2075,44,358,MN - Grand Marais
15,1965-1966,1965-11-09,1966-05-02,175,0,198,605,803,121,963,1084,1887,41,277,MN - Grand Marais
16,1966-1967,1966-10-15,1967-05-02,200,0,238,743,981,95,910,1005,1986,40,332,MN - Grand Marais
17,1967-1968,1967-10-28,1968-04-24,180,0,203,647,850,58,346,404,1254,26,196,MN - Grand Marais
18,1968-1969,1968-11-12,1969-04-11,151,3,177,581,758,103,1118,1221,1979,34,277,MN - Grand Marais
19,1969-1970,1969-10-13,1970-04-20,190,0,222,711,933,111,1077,1188,2121,39,290,MN - Grand Marais
20,1970-1971,1970-11-13,1971-04-13,152,0,232,644,876,95,925,1020,1896,33,257,MN - Grand Marais
21,1971-1972,1971-11-06,1972-04-22,169,5,263,768,1031,100,995,1095,2126,40,348,MN - Grand Marais
22,1972-1973,1972-11-13,1973-04-05,144,0,168,500,668,41,606,647,1315,16,112,MN - Grand Marais
23,1973-1974,1973-11-05,1974-04-17,164,2,200,583,783,87,784,871,1654,44,298,MN - Grand Marais
24,1974-1975,1974-11-13,1975-04-17,156,3,132,521,653,66,890,956,1609,35,210,MN - Grand Marais
25,1975-1976,1975-11-12,1976-04-10,151,1,163,545,708,123,1082,1205,1913,51,370,MN - Grand Marais
26,1976-1977,1976-10-19,1977-03-25,158,2,248,657,905,41,522,563,1468,25,225,MN - Grand Marais
27,1977-1978,1977-11-11,1978-04-12,153,1,204,582,786,72,605,677,1463,22,174,MN - Grand Marais
28,1978-1979,1978-11-11,1979-05-06,177,1,313,749,1062,96,1147,1243,2305,36,285,MN - Grand Marais
29,1979-1980,1979-10-23,1980-04-09,170,0,157,558,715,68,617,685,1400,28,192,MN - Grand Marais
30,1980-1981,1980-11-08,1981-04-04,148,1,172,535,707,73,594,667,1374,22,178,MN - Grand Marais
31,1981-1982,1981-10-22,1982-04-14,175,3,227,642,869,75,956,1031,1900,21,172,MN - Grand Marais
32,1982-1983,1982-11-04,1983-04-18,166,6,111,439,550,55,576,631,1181,25,121,MN - Grand Marais
33,1983-1984,1983-11-11,1984-04-30,172,2,215,607,822,49,725,774,1596,25,189,MN - Grand Marais
34,1984-1985,1984-11-02,1985-04-13,163,2,198,580,778,58,432,490,1268,22,169,MN - Grand Marais
35,1985-1986,1985-11-09,1986-04-08,151,8,218,598,816,70,1023,1093,1909,28,227,MN - Grand Marais
39,1989-1990,1989-11-02,1990-04-06,156,12,170,608,778,75,821,896,1674,21,178,MN - Grand Marais
40,1990-1991,1990-11-24,1991-04-07,135,5,167,534,701,97,946,1043,1744,22,214,MN - Grand Marais
41,1991-1992,1991-11-01,1992-04-06,158,10,131,497,628,114,1056,1170,1798,22,230,MN - Grand Marais
42,1992-1993,1992-10-20,1993-03-31,163,12,150,547,697,49,676,725,1422,18,160,MN - Grand Marais
48,1998-1999,1998-12-01,1999-04-04,125,15,128,446,574,75,660,735,1309,18,161,MN - Grand Marais
49,1999-2000,1999-11-23,2000-04-15,145,13,85,435,520,50,411,461,981,19,138,MN - Grand Marais
51,2001-2002,2001-11-28,2002-03-28,121,16,80,415,495,21,100,121,616,9,64,MN - Grand Marais
52,2002-2003,2002-11-12,2003-04-17,157,16,169,578,747,26,177,203,950,18,81,MN - Grand Marais
53,2003-2004,2003-10-27,2004-04-03,160,9,110,510,620,62,635,697,1317,23,158,MN - Grand Marais
54,2004-2005,2004-12-01,2005-04-04,125,8,128,518,646,91,885,976,1622,19,186,MN - Grand Marais
55,2005-2006,2005-11-17,2006-04-03,138,19,72,391,463,61,421,482,945,22,129,MN - Grand Marais
57,2007-2008,2007-11-08,2008-04-19,164,19,162,681,843,87,1078,1165,2008,15,139,MN - Grand Marais
58,2008-2009,2008-11-16,2009-04-20,156,9,229,720,949,109,1082,1191,2140,28,275,MN - Grand Marais
59,2009-2010,2009-11-30,2010-03-26,117,5,137,469,606,24,306,330,936,8,58,MN - Grand Marais
60,2010-2011,2010-11-14,2011-04-18,156,4,175,667,842,77,805,882,1724,24,197,MN - Grand Marais
62,2012-2013,2012-11-23,2013-04-28,157,7,196,712,908,107,471,578,1486,35,288,MN - Grand Marais
65,2015-2016,2015-11-21,2016-04-13,145,0,148,487,635,62,327,389,1024,26,158,MN - Grand Marais
66,2016-2017,2016-11-19,2017-04-27,160,6,166,503,669,81,531,612,1281,32,245,MN - Grand Marais
67,2017-2018,2017-11-04,2018-04-18,166,3,244,716,960,85,731,816,1776,25,260,MN - Grand Marais
68,2018-2019,2018-11-05,2019-04-17,164,12,256,667,923,99,884,983,1906,34,316,MN - Grand Marais
69,2019-2020,2019-10-31,2020-04-09,162,1,137,558,695,103,814,917,1612,35,255,MN - Grand Marais
0,1950-1951,1950-11-08,1951-04-15,159,0,317,947,1264,115,1083,1198,2462,37,367,MN - Grand Rapids
1,1951-1952,1951-10-22,1952-04-11,173,1,243,852,1095,85,992,1077,2172,39,324,MN - Grand Rapids
2,1952-1953,1952-10-16,1953-04-25,192,4,188,753,941,58,648,706,1647,21,193,MN - Grand Rapids
3,1953-1954,1953-11-20,1954-05-05,167,3,215,790,1005,122,1013,1135,2140,36,350,MN - Grand Rapids
4,1954-1955,1954-11-01,1955-04-08,159,0,215,788,1003,97,838,935,1938,28,243,MN - Grand Rapids
5,1955-1956,1955-10-28,1956-04-19,175,3,261,968,1229,115,1280,1395,2624,38,295,MN - Grand Rapids
6,1956-1957,1956-11-15,1957-04-17,154,0,252,881,1133,84,909,993,2126,30,285,MN - Grand Rapids
7,1957-1958,1957-10-25,1958-04-29,187,0,176,690,866,39,422,461,1327,21,122,MN - Grand Rapids
8,1958-1959,1958-10-01,1959-05-14,226,2,297,945,1242,43,673,716,1958,23,205,MN - Grand Rapids
9,1959-1960,1959-10-11,1960-04-26,199,1,216,837,1053,52,561,613,1666,27,179,MN - Grand Rapids
10,1960-1961,1960-10-19,1961-05-10,204,0,202,742,944,75,177,252,1196,26,163,MN - Grand Rapids
11,1961-1962,1961-11-03,1962-04-28,177,0,275,827,1102,88,821,909,2011,48,396,MN - Grand Rapids
12,1962-1963,1962-10-24,1963-05-19,208,0,288,836,1124,70,371,441,1565,34,296,MN - Grand Rapids
13,1963-1964,1963-11-23,1964-04-14,144,3,204,738,942,58,542,600,1542,30,254,MN - Grand Rapids
14,1964-1965,1964-11-18,1965-04-20,154,0,337,968,1305,97,1096,1193,2498,35,349,MN - Grand Rapids
15,1965-1966,1965-11-09,1966-05-11,184,1,279,837,1116,134,980,1114,2230,42,336,MN - Grand Rapids
16,1966-1967,1966-11-01,1967-05-11,192,0,268,903,1171,84,845,929,2100,41,312,MN - Grand Rapids
17,1967-1968,1967-10-29,1968-05-18,203,0,244,804,1048,69,426,495,1543,33,235,MN - Grand Rapids
18,1968-1969,1968-11-06,1969-06-02,209,0,276,779,1055,109,1133,1242,2297,45,385,MN - Grand Rapids
19,1969-1970,1969-10-21,1970-05-15,207,0,272,880,1152,111,931,1042,2194,54,415,MN - Grand Rapids
20,1970-1971,1970-10-10,1971-05-20,223,5,296,918,1214,149,1151,1300,2514,55,489,MN - Grand Rapids
21,1971-1972,1971-10-29,1972-04-23,178,3,331,935,1266,115,1085,1200,2466,55,470,MN - Grand Rapids
22,1972-1973,1972-10-18,1973-04-16,181,4,235,764,999,49,503,552,1551,31,224,MN - Grand Rapids
46,1996-1997,1996-10-31,1997-05-14,196,13,303,881,1184,137,1153,1290,2474,61,655,MN - Grand Rapids
47,1997-1998,1997-10-13,1998-04-02,172,0,123,517,640,62,526,588,1228,44,251,MN - Grand Rapids
48,1998-1999,1998-11-05,1999-04-16,163,1,189,604,793,82,624,706,1499,45,360,MN - Grand Rapids
49,1999-2000,1999-11-23,2000-04-13,143,0,141,571,712,45,279,324,1036,35,267,MN - Grand Rapids
50,2000-2001,2000-11-07,2001-04-23,168,1,266,809,1075,116,1027,1143,2218,69,570,MN - Grand Rapids
51,2001-2002,2001-10-24,2002-05-02,191,0,151,607,758,93,518,611,1369,61,408,MN - Grand Rapids
52,2002-2003,2002-10-12,2003-04-17,188,0,254,794,1048,73,514,587,1635,53,364,MN - Grand Rapids
53,2003-2004,2003-10-27,2004-03-29,155,0,211,684,895,120,859,979,1874,65,522,MN - Grand Rapids
54,2004-2005,2004-11-08,2005-05-01,175,1,201,754,955,90,853,943,1898,52,436,MN - Grand Rapids
55,2005-2006,2005-11-15,2006-03-28,134,0,147,514,661,85,726,811,1472,54,360,MN - Grand Rapids
56,2006-2007,2006-10-11,2007-04-08,180,0,210,665,875,75,327,402,1277,42,287,MN - Grand Rapids
57,2007-2008,2007-11-06,2008-04-26,173,3,265,824,1089,101,879,980,2069,48,413,MN - Grand Rapids
58,2008-2009,2008-11-08,2009-04-24,168,0,293,862,1155,105,794,899,2054,59,561,MN - Grand Rapids
59,2009-2010,2009-10-10,2010-05-07,210,0,197,677,874,53,555,608,1482,33,238,MN - Grand Rapids
60,2010-2011,2010-11-13,2011-04-27,166,0,277,784,1061,118,917,1035,2096,55,527,MN - Grand Rapids
61,2011-2012,2011-11-09,2012-04-21,165,0,134,505,639,76,307,383,1022,42,260,MN - Grand Rapids
62,2012-2013,2012-10-10,2013-04-26,199,0,231,808,1039,143,937,1080,2119,64,531,MN - Grand Rapids
63,2013-2014,2013-10-20,2014-04-25,188,0,428,1112,1540,136,1071,1207,2747,66,734,MN - Grand Rapids
64,2014-2015,2014-11-08,2015-04-21,165,0,295,759,1054,62,479,541,1595,42,375,MN - Grand Rapids
65,2015-2016,2015-11-19,2016-05-13,177,0,176,545,721,79,510,589,1310,41,282,MN - Grand Rapids
66,2016-2017,2016-11-18,2017-05-01,165,0,202,620,822,102,609,711,1533,45,362,MN - Grand Rapids
67,2017-2018,2017-10-26,2018-04-17,174,0,283,875,1158,102,829,931,2089,50,425,MN - Grand Rapids
68,2018-2019,2018-10-05,2019-05-02,210,0,301,890,1191,135,962,1097,2288,71,607,MN - Grand Rapids
69,2019-2020,2019-10-12,2020-04-20,192,0,205,744,949,96,896,992,1941,46,335,MN - Grand Rapids
0,1950-1951,1950-10-02,1951-04-23,204,0,433,1079,1512,133,1178,1311,2823,71,661,MN - International Falls
1,1951-1952,1951-09-26,1952-04-09,197,0,358,984,1342,99,758,857,2199,68,574,MN - International Falls
2,1952-1953,1952-10-04,1953-05-12,221,0,271,912,1183,105,648,753,1936,75,634,MN - International Falls
3,1953-1954,1953-11-04,1954-05-08,186,0,321,952,1273,144,1029,1173,2446,76,728,MN - International Falls
4,1954-1955,1954-10-29,1955-04-06,160,0,316,964,1280,116,886,1002,2282,62,583,MN - International Falls
5,1955-1956,1955-10-29,1956-05-02,187,0,355,1108,1463,143,1234,1377,2840,80,728,MN - International Falls
6,1956-1957,1956-11-07,1957-04-15,160,0,369,1078,1447,94,746,840,2287,60,540,MN - International Falls
7,1957-1958,1957-10-24,1958-05-02,191,0,248,798,1046,77,321,398,1444,61,435,MN - International Falls
8,1958-1959,1958-10-01,1959-05-14,226,0,431,1198,1629,90,949,1039,2668,55,568,MN - International Falls
9,1959-1960,1959-10-11,1960-04-29,202,0,306,960,1266,82,813,895,2161,53,403,MN - International Falls
10,1960-1961,1960-10-18,1961-04-29,194,0,289,873,1162,90,693,783,1945,53,390,MN - International Falls
11,1961-1962,1961-11-02,1962-05-08,188,0,378,994,1372,103,903,1006,2378,62,594,MN - International Falls
12,1962-1963,1962-10-25,1963-04-20,178,0,393,995,1388,60,508,568,1956,48,539,MN - International Falls
13,1963-1964,1963-11-11,1964-04-14,156,0,305,920,1225,74,771,845,2070,45,369,MN - International Falls
14,1964-1965,1964-09-14,1965-05-28,257,0,442,1194,1636,88,1017,1105,2741,58,576,MN - International Falls
15,1965-1966,1965-11-07,1966-05-02,177,0,378,1033,1411,148,1358,1506,2917,56,493,MN - International Falls
16,1966-1967,1966-11-01,1967-05-03,184,0,403,1127,1530,88,885,973,2503,53,489,MN - International Falls
17,1967-1968,1967-10-09,1968-05-17,222,0,343,994,1337,103,715,818,2155,55,451,MN - International Falls
18,1968-1969,1968-10-23,1969-06-02,223,0,347,946,1293,99,1103,1202,2495,55,544,MN - International Falls
19,1969-1970,1969-10-17,1970-05-25,221,0,373,1066,1439,113,1084,1197,2636,71,620,MN - International Falls
20,1970-1971,1970-10-07,1971-05-01,207,0,411,1057,1468,87,935,1022,2490,51,490,MN - International Falls
21,1971-1972,1971-10-29,1972-04-23,178,0,446,1091,1537,112,1158,1270,2807,63,518,MN - International Falls
22,1972-1973,1972-10-14,1973-04-16,185,0,294,864,1158,56,509,565,1723,41,287,MN - International Falls
23,1973-1974,1973-11-03,1974-05-14,193,0,375,1012,1387,96,934,1030,2417,56,490,MN - International Falls
24,1974-1975,1974-09-21,1975-05-01,223,0,298,931,1229,142,1195,1337,2566,66,537,MN - International Falls
25,1975-1976,1975-10-24,1976-05-02,192,0,348,986,1334,128,973,1101,2435,69,721,MN - International Falls
26,1976-1977,1976-10-07,1977-04-08,184,0,449,1076,1525,109,550,659,2184,68,708,MN - International Falls
27,1977-1978,1977-11-09,1978-04-16,159,0,462,1075,1537,109,1105,1214,2751,56,546,MN - International Falls
28,1978-1979,1978-10-15,1979-05-05,203,0,530,1245,1775,120,1311,1431,3206,65,724,MN - International Falls
29,1979-1980,1979-10-11,1980-04-14,187,0,332,963,1295,107,871,978,2273,64,572,MN - International Falls
30,1980-1981,1980-10-22,1981-04-01,162,0,307,822,1129,75,729,804,1933,44,400,MN - International Falls
31,1981-1982,1981-09-30,1982-04-21,204,0,437,1076,1513,137,1171,1308,2821,65,676,MN - International Falls
32,1982-1983,1982-11-02,1983-05-04,184,0,237,701,938,82,420,502,1440,49,325,MN - International Falls
33,1983-1984,1983-10-12,1984-05-08,210,0,409,968,1377,97,958,1055,2432,55,588,MN - International Falls
34,1984-1985,1984-10-17,1985-04-13,179,0,396,1001,1397,107,799,906,2303,55,573,MN - International Falls
35,1985-1986,1985-10-01,1986-05-01,213,0,402,977,1379,132,1125,1257,2636,63,682,MN - International Falls
36,1986-1987,1986-10-13,1987-04-03,173,0,200,691,891,96,524,620,1511,58,464,MN - International Falls
37,1987-1988,1987-10-09,1988-04-09,184,0,308,906,1214,78,536,614,1828,47,372,MN - International Falls
38,1988-1989,1988-10-24,1989-05-06,195,0,374,1044,1418,163,1210,1373,2791,70,722,MN - International Falls
39,1989-1990,1989-11-01,1990-04-30,181,0,334,961,1295,112,453,565,1860,72,695,MN - International Falls
40,1990-1991,1990-10-17,1991-05-04,200,0,323,939,1262,141,842,983,2245,61,639,MN - International Falls
41,1991-1992,1991-10-14,1992-05-23,223,0,263,824,1087,174,938,1112,2199,74,703,MN - International Falls
42,1992-1993,1992-09-27,1993-04-29,215,0,331,908,1239,150,888,1038,2277,72,678,MN - International Falls
43,1993-1994,1993-09-27,1994-04-29,215,0,404,1001,1405,129,549,678,2083,77,795,MN - International Falls
44,1994-1995,1994-10-24,1995-04-17,176,0,261,775,1036,112,579,691,1727,61,554,MN - International Falls
45,1995-1996,1995-10-20,1996-04-28,192,0,471,1214,1685,178,1274,1452,3137,76,779,MN - International Falls
46,1996-1997,1996-10-02,1997-05-14,225,1,406,1067,1473,139,1130,1269,2742,85,792,MN - International Falls
47,1997-1998,1997-10-14,1998-04-08,177,0,180,607,787,95,386,481,1268,65,469,MN - International Falls
48,1998-1999,1998-11-03,1999-04-16,165,2,276,775,1051,104,447,551,1602,45,428,MN - International Falls
49,1999-2000,1999-11-27,2000-04-14,140,0,194,672,866,48,263,311,1177,26,214,MN - International Falls
50,2000-2001,2000-11-03,2001-04-23,172,0,341,903,1244,104,748,852,2096,49,409,MN - International Falls
53,2003-2004,2003-09-29,2004-04-10,195,0,313,916,1229,117,768,885,2114,58,490,MN - International Falls
54,2004-2005,2004-11-07,2005-05-01,176,0,308,909,1217,97,737,834,2051,52,511,MN - International Falls
55,2005-2006,2005-10-18,2006-05-04,199,0,229,720,949,93,750,843,1792,61,480,MN - International Falls
56,2006-2007,2006-10-11,2007-04-10,182,0,288,824,1112,74,377,451,1563,48,390,MN - International Falls
57,2007-2008,2007-11-04,2008-05-04,183,0,345,995,1340,157,994,1151,2491,88,824,MN - International Falls
58,2008-2009,2008-10-26,2009-05-16,203,0,394,1112,1506,199,1089,1288,2794,81,899,MN - International Falls
59,2009-2010,2009-10-09,2010-03-25,168,0,256,814,1070,75,777,852,1922,36,269,MN - International Falls
60,2010-2011,2010-10-28,2011-05-01,186,0,348,980,1328,132,1074,1206,2534,65,641,MN - International Falls
61,2011-2012,2011-11-09,2012-04-22,166,0,155,592,747,117,547,664,1411,66,462,MN - International Falls
62,2012-2013,2012-10-05,2013-04-30,208,0,309,1037,1346,157,1148,1305,2651,83,824,MN - International Falls
63,2013-2014,2013-10-19,2014-04-25,189,0,496,1284,1780,167,1194,1361,3141,87,1004,MN - International Falls
64,2014-2015,2014-10-30,2015-04-22,175,0,342,928,1270,114,708,822,2092,71,672,MN - International Falls
65,2015-2016,2015-11-12,2016-04-10,151,0,217,637,854,83,593,676,1530,53,361,MN - International Falls
66,2016-2017,2016-11-18,2017-04-28,162,3,255,700,955,106,732,838,1793,53,437,MN - International Falls
67,2017-2018,2017-10-26,2018-04-20,177,0,352,1069,1421,99,875,974,2395,49,520,MN - International Falls
68,2018-2019,2018-10-10,2019-05-02,205,1,356,1020,1376,115,936,1051,2427,57,536,MN - International Falls
69,2019-2020,2019-10-12,2020-04-14,186,0,248,854,1102,106,1028,1134,2236,56,496,MN - International Falls
0,1950-1951,1950-11-08,1951-04-15,159,0,280,705,985,129,802,931,1916,50,461,MN - Minneapolis-St Paul
1,1951-1952,1951-10-30,1952-04-09,163,0,213,604,817,121,542,663,1480,46,370,MN - Minneapolis-St Paul
2,1952-1953,1952-10-16,1953-04-25,192,0,158,517,675,68,509,577,1252,33,232,MN - Minneapolis-St Paul
3,1953-1954,1953-11-21,1954-05-03,164,0,142,481,623,53,81,134,757,36,237,MN - Minneapolis-St Paul
4,1954-1955,1954-10-31,1955-03-27,148,0,178,521,699,63,437,500,1199,42,287,MN - Minneapolis-St Paul
5,1955-1956,1955-10-29,1956-04-29,184,0,249,696,945,80,629,709,1654,53,361,MN - Minneapolis-St Paul
6,1956-1957,1956-11-15,1957-04-12,149,0,170,547,717,69,107,176,893,38,290,MN - Minneapolis-St Paul
7,1957-1958,1957-11-08,1958-04-06,150,0,151,427,578,40,91,131,709,26,144,MN - Minneapolis-St Paul
8,1958-1959,1958-11-05,1959-03-21,137,0,222,568,790,41,58,99,889,34,245,MN - Minneapolis-St Paul
9,1959-1960,1959-10-08,1960-03-26,171,0,177,556,733,60,169,229,962,40,254,MN - Minneapolis-St Paul
10,1960-1961,1960-11-09,1961-04-18,161,0,164,582,746,69,115,184,930,30,225,MN - Minneapolis-St Paul
11,1961-1962,1961-09-30,1962-04-15,198,0,265,725,990,126,677,803,1793,52,463,MN - Minneapolis-St Paul
12,1962-1963,1962-11-18,1963-04-23,157,0,252,661,913,59,244,303,1216,33,339,MN - Minneapolis-St Paul
13,1963-1964,1963-11-23,1964-04-14,144,0,180,546,726,50,193,243,969,29,187,MN - Minneapolis-St Paul
14,1964-1965,1964-11-19,1965-04-25,158,0,279,720,999,108,631,739,1738,43,376,MN - Minneapolis-St Paul
15,1965-1966,1965-11-11,1966-04-08,149,0,205,544,749,63,260,323,1072,31,264,MN - Minneapolis-St Paul
16,1966-1967,1966-10-15,1967-05-01,199,0,212,672,884,122,716,838,1722,50,422,MN - Minneapolis-St Paul
17,1967-1968,1967-10-27,1968-04-23,180,0,177,558,735,40,139,179,914,31,187,MN - Minneapolis-St Paul
18,1968-1969,1968-11-06,1969-04-28,174,0,220,594,814,110,783,893,1707,54,416,MN - Minneapolis-St Paul
19,1969-1970,1969-10-12,1970-04-20,191,0,229,650,879,106,765,871,1750,53,418,MN - Minneapolis-St Paul
20,1970-1971,1970-11-03,1971-05-19,198,0,230,615,845,89,532,621,1466,50,362,MN - Minneapolis-St Paul
21,1971-1972,1971-11-06,1972-04-21,168,0,268,680,948,101,695,796,1744,50,400,MN - Minneapolis-St Paul
22,1972-1973,1972-11-07,1973-04-16,161,0,189,496,685,60,374,434,1119,26,191,MN - Minneapolis-St Paul
23,1973-1974,1973-11-04,1974-04-07,155,0,210,580,790,80,473,553,1343,43,298,MN - Minneapolis-St Paul
24,1974-1975,1974-11-13,1975-04-13,152,0,183,560,743,101,690,791,1534,53,373,MN - Minneapolis-St Paul
25,1975-1976,1975-11-09,1976-05-02,176,0,155,503,658,83,418,501,1159,34,253,MN - Minneapolis-St Paul
26,1976-1977,1976-10-18,1977-04-05,170,0,253,693,946,74,315,389,1335,42,316,MN - Minneapolis-St Paul
27,1977-1978,1977-10-10,1978-04-20,193,0,288,697,985,84,517,601,1586,48,391,MN - Minneapolis-St Paul
28,1978-1979,1978-11-12,1979-04-06,146,0,303,717,1020,104,908,1012,2032,49,430,MN - Minneapolis-St Paul
29,1979-1980,1979-11-01,1980-04-12,164,0,169,544,713,84,251,335,1048,47,291,MN - Minneapolis-St Paul
30,1980-1981,1980-11-13,1981-04-05,144,0,147,459,606,39,82,121,727,28,194,MN - Minneapolis-St Paul
31,1981-1982,1981-10-24,1982-04-20,179,0,269,657,926,137,783,920,1846,47,422,MN - Minneapolis-St Paul
32,1982-1983,1982-10-19,1983-04-20,184,0,109,401,510,113,437,550,1060,41,225,MN - Minneapolis-St Paul
33,1983-1984,1983-11-09,1984-05-01,175,0,276,604,880,142,786,928,1808,47,398,MN - Minneapolis-St Paul
34,1984-1985,1984-10-29,1985-04-03,157,0,197,571,768,105,391,496,1264,39,356,MN - Minneapolis-St Paul
35,1985-1986,1985-09-24,1986-04-14,203,0,252,641,893,110,795,905,1798,44,364,MN - Minneapolis-St Paul
36,1986-1987,1986-11-08,1987-03-14,127,0,86,359,445,34,68,102,547,23,122,MN - Minneapolis-St Paul
37,1987-1988,1987-10-24,1988-04-23,183,0,185,527,712,66,320,386,1098,35,229,MN - Minneapolis-St Paul
38,1988-1989,1988-10-23,1989-05-05,195,0,193,621,814,106,374,480,1294,42,326,MN - Minneapolis-St Paul
39,1989-1990,1989-11-02,1990-04-16,166,0,145,531,676,57,112,169,845,34,255,MN - Minneapolis-St Paul
40,1990-1991,1990-11-03,1991-05-05,184,0,162,528,690,75,308,383,1073,48,310,MN - Minneapolis-St Paul
41,1991-1992,1991-10-30,1992-04-10,164,0,122,445,567,128,692,820,1387,41,329,MN - Minneapolis-St Paul
42,1992-1993,1992-10-15,1993-04-15,183,0,170,550,720,83,428,511,1231,50,255,MN - Minneapolis-St Paul
43,1993-1994,1993-11-04,1994-04-29,177,0,239,609,848,94,356,450,1298,47,387,MN - Minneapolis-St Paul
44,1994-1995,1994-11-27,1995-04-18,143,0,129,420,549,52,138,190,739,30,174,MN - Minneapolis-St Paul
45,1995-1996,1995-10-24,1996-04-26,186,0,234,665,899,89,464,553,1452,46,348,MN - Minneapolis-St Paul
46,1996-1997,1996-10-31,1997-04-10,162,18,248,651,899,114,745,859,1758,52,467,MN - Minneapolis-St Paul
47,1997-1998,1997-11-02,1998-03-23,142,0,104,372,476,77,241,318,794,44,268,MN - Minneapolis-St Paul
48,1998-1999,1998-11-06,1999-03-16,131,0,143,421,564,80,259,339,903,26,280,MN - Minneapolis-St Paul
49,1999-2000,1999-11-23,2000-04-12,142,0,105,371,476,53,250,303,779,23,147,MN - Minneapolis-St Paul
50,2000-2001,2000-11-07,2001-04-04,149,0,238,619,857,124,793,917,1774,53,426,MN - Minneapolis-St Paul
51,2001-2002,2001-10-24,2002-04-28,187,0,103,358,461,98,205,303,764,39,245,MN - Minneapolis-St Paul
52,2002-2003,2002-10-20,2003-04-05,168,0,173,515,688,58,154,212,900,35,242,MN - Minneapolis-St Paul
53,2003-2004,2003-11-03,2004-03-21,140,0,160,450,610,99,324,423,1033,38,321,MN - Minneapolis-St Paul
54,2004-2005,2004-11-27,2005-03-22,116,0,133,407,540,44,137,181,721,28,170,MN - Minneapolis-St Paul
55,2005-2006,2005-11-15,2006-03-26,132,0,115,376,491,70,239,309,800,31,186,MN - Minneapolis-St Paul
56,2006-2007,2006-11-02,2007-04-12,162,0,150,434,584,57,213,270,854,24,164,MN - Minneapolis-St Paul
57,2007-2008,2007-11-21,2008-04-26,158,0,219,573,792,74,428,502,1294,41,275,MN - Minneapolis-St Paul
58,2008-2009,2008-11-07,2009-04-05,150,0,222,605,827,72,320,392,1219,39,320,MN - Minneapolis-St Paul
59,2009-2010,2009-10-10,2010-03-10,152,0,171,441,612,60,547,607,1219,28,198,MN - Minneapolis-St Paul
60,2010-2011,2010-11-13,2011-04-20,159,0,214,533,747,135,698,833,1580,51,416,MN - Minneapolis-St Paul
61,2011-2012,2011-11-17,2012-03-08,113,0,69,274,343,43,71,114,457,29,153,MN - Minneapolis-St Paul
62,2012-2013,2012-11-12,2013-05-03,173,0,160,488,648,105,398,503,1151,47,299,MN - Minneapolis-St Paul
63,2013-2014,2013-11-05,2014-04-16,163,0,306,726,1032,109,679,788,1820,49,431,MN - Minneapolis-St Paul
64,2014-2015,2014-11-10,2015-04-10,152,0,216,510,726,59,205,264,990,42,277,MN - Minneapolis-St Paul
65,2015-2016,2015-11-20,2016-04-08,141,0,112,319,431,58,210,268,699,31,168,MN - Minneapolis-St Paul
66,2016-2017,2016-11-18,2017-04-11,145,0,129,351,480,48,139,187,667,21,154,MN - Minneapolis-St Paul
67,2017-2018,2017-10-27,2018-04-21,177,0,199,558,757,118,371,489,1246,42,307,MN - Minneapolis-St Paul
68,2018-2019,2018-10-14,2019-04-14,183,0,212,547,759,114,408,522,1281,46,351,MN - Minneapolis-St Paul
69,2019-2020,2019-11-01,2020-04-14,166,0,121,425,546,80,450,530,1076,36,210,MN - Minneapolis-St Paul
1,1951-1952,1951-10-22,1952-04-10,172,13,255,790,1045,108,551,659,1704,26,271,MN - Morris
3,1953-1954,1953-11-22,1954-05-03,163,17,184,627,811,52,361,413,1224,18,131,MN - Morris
4,1954-1955,1954-11-26,1955-03-26,121,2,173,589,762,48,244,292,1054,17,145,MN - Morris
5,1955-1956,1955-11-03,1956-04-10,160,10,371,887,1258,86,584,670,1928,25,247,MN - Morris
6,1956-1957,1956-11-15,1957-04-12,149,2,235,693,928,62,167,229,1157,32,320,MN - Morris
7,1957-1958,1957-10-26,1958-04-06,163,1,214,579,793,39,147,186,979,27,195,MN - Morris
8,1958-1959,1958-11-18,1959-03-17,120,1,281,692,973,32,139,171,1144,23,218,MN - Morris
9,1959-1960,1959-10-09,1960-04-09,184,2,252,764,1016,73,289,362,1378,40,326,MN - Morris
10,1960-1961,1960-10-20,1961-04-28,191,0,202,647,849,46,144,190,1039,26,201,MN - Morris
11,1961-1962,1961-11-03,1962-04-15,164,1,328,774,1102,84,484,568,1670,40,365,MN - Morris
12,1962-1963,1962-11-05,1963-04-23,170,1,275,711,986,55,136,191,1177,20,170,MN - Morris
14,1964-1965,1964-10-29,1965-04-20,174,0,406,935,1341,89,415,504,1845,38,418,MN - Morris
15,1965-1966,1965-09-26,1966-04-30,217,0,299,740,1039,81,252,333,1372,34,301,MN - Morris
16,1966-1967,1966-11-02,1967-05-03,183,2,289,835,1124,94,491,585,1709,40,429,MN - Morris
17,1967-1968,1967-10-27,1968-04-14,171,0,250,710,960,37,183,220,1180,27,230,MN - Morris
18,1968-1969,1968-11-08,1969-04-02,146,2,357,775,1132,118,925,1043,2175,49,492,MN - Morris
19,1969-1970,1969-10-13,1970-04-23,193,0,312,811,1123,96,612,708,1831,49,454,MN - Morris
20,1970-1971,1970-10-08,1971-04-28,203,0,311,776,1087,85,439,524,1611,49,391,MN - Morris
21,1971-1972,1971-10-29,1972-04-22,177,0,350,840,1190,103,647,750,1940,50,487,MN - Morris
22,1972-1973,1972-10-18,1973-04-25,190,0,252,646,898,49,493,542,1440,32,263,MN - Morris
23,1973-1974,1973-11-04,1974-04-01,149,0,284,763,1047,55,465,520,1567,37,330,MN - Morris
24,1974-1975,1974-11-06,1975-04-19,165,2,244,750,994,113,860,973,1967,50,460,MN - Morris
25,1975-1976,1975-10-25,1976-04-04,163,0,235,677,912,83,633,716,1628,43,382,MN - Morris
26,1976-1977,1976-10-19,1977-04-04,168,0,323,907,1230,79,471,550,1780,49,527,MN - Morris
27,1977-1978,1977-11-09,1978-04-20,163,0,398,841,1239,107,996,1103,2342,62,684,MN - Morris
28,1978-1979,1978-11-10,1979-04-11,153,0,437,980,1417,94,881,975,2392,60,615,MN - Morris
29,1979-1980,1979-10-22,1980-03-30,161,0,219,686,905,74,398,472,1377,44,377,MN - Morris
30,1980-1981,1980-11-15,1981-03-07,113,0,177,562,739,39,138,177,916,22,247,MN - Morris
31,1981-1982,1981-10-21,1982-04-10,172,0,362,895,1257,96,684,780,2037,47,533,MN - Morris
32,1982-1983,1982-11-03,1983-04-16,165,1,157,515,672,61,284,345,1017,32,169,MN - Morris
33,1983-1984,1983-11-09,1984-04-28,172,3,315,722,1037,103,742,845,1882,52,513,MN - Morris
34,1984-1985,1984-10-30,1985-03-21,143,9,277,686,963,86,467,553,1516,38,406,MN - Morris
35,1985-1986,1985-10-16,1986-03-30,166,1,334,802,1136,105,1041,1146,2282,41,433,MN - Morris
36,1986-1987,1986-10-12,1987-03-30,170,0,118,507,625,43,144,187,812,24,158,MN - Morris
37,1987-1988,1987-10-20,1988-03-26,159,0,243,671,914,49,465,514,1428,29,261,MN - Morris
38,1988-1989,1988-10-28,1989-04-18,173,2,271,809,1080,93,758,851,1931,46,453,MN - Morris
39,1989-1990,1989-11-01,1990-05-02,183,0,192,703,895,64,217,281,1176,36,279,MN - Morris
40,1990-1991,1990-10-18,1991-04-23,188,0,216,712,928,77,338,415,1343,38,344,MN - Morris
41,1991-1992,1991-10-30,1992-04-22,176,0,153,582,735,55,480,535,1270,31,232,MN - Morris
42,1992-1993,1992-10-16,1993-04-12,179,0,284,761,1045,86,848,934,1979,48,397,MN - Morris
43,1993-1994,1993-10-30,1994-04-30,183,0,356,827,1183,105,896,1001,2184,53,604,MN - Morris
44,1994-1995,1994-11-18,1995-04-14,148,1,222,584,806,96,681,777,1583,43,367,MN - Morris
45,1995-1996,1995-10-24,1996-04-14,174,2,362,838,1200,99,893,992,2192,39,370,MN - Morris
46,1996-1997,1996-10-31,1997-04-11,163,4,370,854,1224,121,1220,1341,2565,46,510,MN - Morris
47,1997-1998,1997-11-02,1998-04-02,152,0,186,478,664,70,312,382,1046,37,273,MN - Morris
48,1998-1999,1998-11-06,1999-04-16,162,1,178,532,710,59,318,377,1087,26,277,MN - Morris
49,1999-2000,1999-12-01,2000-04-16,138,5,149,486,635,43,244,287,922,23,199,MN - Morris
50,2000-2001,2000-11-08,2001-04-07,151,4,343,841,1184,81,884,965,2149,35,326,MN - Morris
51,2001-2002,2001-10-25,2002-04-06,164,1,172,511,683,65,237,302,985,32,250,MN - Morris
52,2002-2003,2002-10-17,2003-04-05,171,1,231,693,924,39,127,166,1090,29,245,MN - Morris
53,2003-2004,2003-11-02,2004-03-22,142,0,235,630,865,69,296,365,1230,38,362,MN - Morris
54,2004-2005,2004-11-27,2005-03-19,113,6,207,531,738,39,202,241,979,23,184,MN - Morris
55,2005-2006,2005-11-16,2006-03-26,131,1,202,540,742,58,475,533,1275,35,272,MN - Morris
56,2006-2007,2006-10-12,2007-04-13,184,1,224,668,892,58,213,271,1163,25,215,MN - Morris
57,2007-2008,2007-11-07,2008-04-30,176,1,322,822,1144,83,482,565,1709,33,302,MN - Morris
58,2008-2009,2008-11-07,2009-04-03,148,2,341,835,1176,89,480,569,1745,44,465,MN - Morris
59,2009-2010,2009-10-10,2010-03-26,168,1,277,639,916,59,516,575,1491,31,262,MN - Morris
60,2010-2011,2010-10-27,2011-04-16,172,12,339,798,1137,105,873,978,2115,53,565,MN - Morris
61,2011-2012,2011-11-17,2012-03-11,116,7,116,459,575,39,108,147,722,25,189,MN - Morris
62,2012-2013,2012-10-25,2013-04-25,183,1,271,777,1048,95,684,779,1827,53,439,MN - Morris
63,2013-2014,2013-10-29,2014-04-18,172,3,377,919,1296,58,507,565,1861,37,363,MN - Morris
64,2014-2015,2014-11-10,2015-03-28,139,0,271,656,927,54,272,326,1253,31,293,MN - Morris
65,2015-2016,2015-11-20,2016-04-09,142,0,166,469,635,44,242,286,921,30,213,MN - Morris
66,2016-2017,2016-11-18,2017-05-01,165,0,193,531,724,41,192,233,957,26,218,MN - Morris
67,2017-2018,2017-10-27,2018-04-17,173,7,271,750,1021,69,206,275,1296,35,311,MN - Morris
68,2018-2019,2018-10-12,2019-04-16,187,0,362,831,1193,100,653,753,1946,45,543,MN - Morris
69,2019-2020,2019-10-12,2020-04-15,187,0,215,670,885,50,459,509,1394,33,230,MN - Morris
0,1950-1951,1950-11-09,1951-04-15,158,0,268,796,1064,112,699,811,1875,44,431,MN - Rochester
1,1951-1952,1951-11-01,1952-04-14,166,0,195,622,817,104,418,522,1339,41,326,MN - Rochester
2,1952-1953,1952-10-16,1953-04-19,186,1,140,547,687,71,480,551,1238,38,248,MN - Rochester
3,1953-1954,1953-11-22,1954-05-03,163,0,119,488,607,41,95,136,743,25,150,MN - Rochester
4,1954-1955,1954-10-29,1955-03-28,151,1,171,531,702,54,261,315,1017,34,219,MN - Rochester
5,1955-1956,1955-10-29,1956-04-30,185,0,227,765,992,102,567,669,1661,49,352,MN - Rochester
6,1956-1957,1956-11-15,1957-04-11,148,0,159,558,717,47,76,123,840,33,224,MN - Rochester
7,1957-1958,1957-11-08,1958-03-16,129,1,148,444,592,38,125,163,755,21,102,MN - Rochester
8,1958-1959,1958-11-23,1959-03-27,125,0,231,661,892,65,363,428,1320,33,289,MN - Rochester
9,1959-1960,1959-10-26,1960-04-08,166,0,162,571,733,50,184,234,967,33,222,MN - Rochester
10,1960-1961,1960-11-09,1961-04-18,161,0,161,498,659,61,156,217,876,35,214,MN - Rochester
11,1961-1962,1961-09-30,1962-04-16,199,0,272,691,963,120,590,710,1673,54,447,MN - Rochester
12,1962-1963,1962-10-24,1963-04-23,182,0,261,645,906,74,268,342,1248,47,415,MN - Rochester
13,1963-1964,1963-11-23,1964-04-07,137,1,173,542,715,51,118,169,884,32,212,MN - Rochester
14,1964-1965,1964-11-18,1965-04-26,160,0,293,718,1011,82,328,410,1421,47,395,MN - Rochester
15,1965-1966,1965-11-18,1966-05-11,175,0,216,569,785,61,215,276,1061,37,304,MN - Rochester
16,1966-1967,1966-10-15,1967-05-01,199,0,194,606,800,79,314,393,1193,45,339,MN - Rochester
17,1967-1968,1967-11-04,1968-04-23,172,0,165,583,748,27,30,57,805,25,159,MN - Rochester
18,1968-1969,1968-10-27,1969-04-28,184,0,214,639,853,78,670,748,1601,47,301,MN - Rochester
19,1969-1970,1969-10-15,1970-04-20,188,0,224,704,928,102,714,816,1744,47,407,MN - Rochester
20,1970-1971,1970-10-31,1971-04-03,155,0,239,637,876,100,699,799,1675,44,335,MN - Rochester
21,1971-1972,1971-11-06,1972-04-22,169,0,233,668,901,71,457,528,1429,46,352,MN - Rochester
22,1972-1973,1972-10-22,1973-05-02,193,0,198,564,762,84,332,416,1178,36,259,MN - Rochester
23,1973-1974,1973-11-05,1974-04-04,151,0,219,575,794,69,450,519,1313,40,304,MN - Rochester
24,1974-1975,1974-11-13,1975-04-10,149,0,186,594,780,88,640,728,1508,57,382,MN - Rochester
25,1975-1976,1975-11-10,1976-05-02,175,0,128,516,644,54,169,223,867,35,206,MN - Rochester
26,1976-1977,1976-10-18,1977-04-05,170,0,280,796,1076,67,239,306,1382,45,350,MN - Rochester
27,1977-1978,1977-11-09,1978-04-20,163,0,312,748,1060,80,606,686,1746,47,441,MN - Rochester
28,1978-1979,1978-11-12,1979-04-07,147,3,376,823,1199,108,865,973,2172,50,498,MN - Rochester
29,1979-1980,1979-10-22,1980-04-12,174,0,167,545,712,91,269,360,1072,51,309,MN - Rochester
30,1980-1981,1980-11-14,1981-04-04,142,0,146,460,606,46,114,160,766,26,221,MN - Rochester
31,1981-1982,1981-10-22,1982-04-20,181,3,276,672,948,99,689,788,1736,45,400,MN - Rochester
32,1982-1983,1982-10-20,1983-04-18,181,0,115,431,546,99,385,484,1030,49,263,MN - Rochester
33,1983-1984,1983-11-09,1984-04-30,174,0,285,636,921,97,636,733,1654,45,349,MN - Rochester
34,1984-1985,1984-11-02,1985-04-08,158,0,203,561,764,109,306,415,1179,52,404,MN - Rochester
35,1985-1986,1985-11-08,1986-04-15,159,0,272,674,946,95,776,871,1817,50,438,MN - Rochester
36,1986-1987,1986-11-09,1987-03-30,142,0,113,414,527,41,156,197,724,26,158,MN - Rochester
37,1987-1988,1987-10-20,1988-04-29,193,0,214,595,809,99,424,523,1332,41,325,MN - Rochester
38,1988-1989,1988-11-05,1989-05-06,183,0,191,608,799,81,263,344,1143,39,332,MN - Rochester
39,1989-1990,1989-10-30,1990-04-05,158,0,152,544,696,62,177,239,935,39,294,MN - Rochester
40,1990-1991,1990-10-17,1991-04-23,189,0,177,556,733,79,456,535,1268,50,312,MN - Rochester
41,1991-1992,1991-10-05,1992-03-30,178,0,144,457,601,97,344,441,1042,48,327,MN - Rochester
42,1992-1993,1992-10-19,1993-04-20,184,0,211,599,810,102,608,710,1520,55,331,MN - Rochester
43,1993-1994,1993-11-05,1994-04-28,175,0,266,654,920,85,393,478,1398,45,414,MN - Rochester
44,1994-1995,1994-11-27,1995-04-21,146,0,155,439,594,55,113,168,762,34,209,MN - Rochester
45,1995-1996,1995-10-30,1996-04-15,169,0,250,677,927,93,350,443,1370,43,333,MN - Rochester
46,1996-1997,1996-10-31,1997-05-15,197,0,263,656,919,143,694,837,1756,73,607,MN - Rochester
47,1997-1998,1997-11-02,1998-03-21,140,0,132,374,506,65,194,259,765,33,190,MN - Rochester
48,1998-1999,1998-11-04,1999-03-14,131,0,157,421,578,71,298,369,947,30,306,MN - Rochester
49,1999-2000,1999-10-01,2000-04-11,194,0,122,441,563,63,261,324,887,30,203,MN - Rochester
50,2000-2001,2000-11-08,2001-04-16,160,3,278,680,958,106,660,766,1724,47,403,MN - Rochester
51,2001-2002,2001-11-30,2002-04-27,149,0,107,377,484,58,122,180,664,31,192,MN - Rochester
52,2002-2003,2002-10-24,2003-04-08,167,0,184,574,758,46,116,162,920,28,193,MN - Rochester
53,2003-2004,2003-11-03,2004-03-21,140,0,153,463,616,68,304,372,988,30,200,MN - Rochester
54,2004-2005,2004-11-27,2005-04-01,126,0,148,440,588,84,243,327,915,29,204,MN - Rochester
55,2005-2006,2005-11-15,2006-03-27,133,0,128,403,531,63,200,263,794,29,188,MN - Rochester
56,2006-2007,2006-10-12,2007-04-13,184,0,173,486,659,88,329,417,1076,24,192,MN - Rochester
57,2007-2008,2007-11-17,2008-04-12,148,1,228,563,791,72,486,558,1349,43,324,MN - Rochester
58,2008-2009,2008-10-26,2009-04-05,162,0,210,628,838,79,450,529,1367,38,314,MN - Rochester
59,2009-2010,2009-10-11,2010-03-14,155,0,203,502,705,83,703,786,1491,36,272,MN - Rochester
60,2010-2011,2010-11-12,2011-04-20,160,0,225,555,780,114,789,903,1683,44,356,MN - Rochester
61,2011-2012,2011-11-19,2012-03-04,107,0,70,293,363,39,85,124,487,27,148,MN - Rochester
62,2012-2013,2012-11-12,2013-05-05,175,0,151,514,665,115,425,540,1205,43,287,MN - Rochester
63,2013-2014,2013-11-11,2014-04-30,171,0,319,757,1076,94,625,719,1795,45,434,MN - Rochester
64,2014-2015,2014-11-10,2015-04-09,151,0,238,580,818,73,443,516,1334,36,263,MN - Rochester
65,2015-2016,2015-10-28,2016-04-08,164,0,131,378,509,73,333,406,915,33,198,MN - Rochester
66,2016-2017,2016-11-19,2017-03-16,118,0,146,387,533,76,363,439,972,25,205,MN - Rochester
67,2017-2018,2017-10-27,2018-04-20,176,0,213,612,825,99,305,404,1229,44,357,MN - Rochester
68,2018-2019,2018-10-14,2019-04-27,196,0,249,628,877,133,533,666,1543,45,410,MN - Rochester
69,2019-2020,2019-10-12,2020-04-17,189,0,154,516,670,95,408,503,1173,42,273,MN - Rochester
0,1950-1951,1950-11-08,1951-04-15,159,0,309,876,1185,133,805,938,2123,61,601,MN - St Cloud
1,1951-1952,1951-10-30,1952-04-09,163,0,260,806,1066,90,763,853,1919,51,449,MN - St Cloud
2,1952-1953,1952-10-15,1953-04-19,187,0,184,646,830,76,355,431,1261,34,259,MN - St Cloud
3,1953-1954,1953-11-22,1954-05-03,163,0,193,667,860,65,363,428,1288,36,293,MN - St Cloud
4,1954-1955,1954-11-01,1955-03-27,147,0,209,691,900,52,318,370,1270,35,301,MN - St Cloud
5,1955-1956,1955-10-30,1956-04-08,162,0,295,870,1165,85,783,868,2033,46,393,MN - St Cloud
6,1956-1957,1956-11-15,1957-04-12,149,0,216,725,941,67,190,257,1198,32,300,MN - St Cloud
7,1957-1958,1957-10-25,1958-04-06,164,0,172,579,751,43,184,227,978,28,169,MN - St Cloud
8,1958-1959,1958-11-23,1959-04-11,140,0,258,733,991,33,28,61,1052,25,225,MN - St Cloud
9,1959-1960,1959-10-12,1960-04-08,180,0,211,750,961,52,269,321,1282,36,260,MN - St Cloud
10,1960-1961,1960-11-09,1961-04-25,168,0,172,622,794,46,65,111,905,30,211,MN - St Cloud
11,1961-1962,1961-11-02,1962-04-08,158,0,269,755,1024,92,650,742,1766,44,383,MN - St Cloud
12,1962-1963,1962-11-07,1963-04-23,168,0,257,702,959,62,144,206,1165,40,366,MN - St Cloud
13,1963-1964,1963-11-23,1964-04-14,144,0,207,662,869,53,245,298,1167,26,184,MN - St Cloud
14,1964-1965,1964-10-28,1965-04-26,181,0,329,910,1239,132,892,1024,2263,47,476,MN - St Cloud
15,1965-1966,1965-11-13,1966-04-29,168,0,257,671,928,52,224,276,1204,36,277,MN - St Cloud
16,1966-1967,1966-10-15,1967-04-06,174,0,247,791,1038,82,683,765,1803,40,351,MN - St Cloud
17,1967-1968,1967-10-27,1968-04-08,165,0,219,671,890,32,211,243,1133,25,174,MN - St Cloud
18,1968-1969,1968-11-07,1969-04-27,172,0,270,722,992,102,915,1017,2009,49,412,MN - St Cloud
19,1969-1970,1969-10-12,1970-04-23,194,0,267,801,1068,77,686,763,1831,47,403,MN - St Cloud
20,1970-1971,1970-10-09,1971-05-19,223,0,270,765,1035,90,463,553,1588,43,338,MN - St Cloud
21,1971-1972,1971-10-28,1972-04-22,178,0,300,820,1120,78,625,703,1823,46,374,MN - St Cloud
22,1972-1973,1972-10-18,1973-03-20,154,0,217,640,857,38,437,475,1332,17,147,MN - St Cloud
23,1973-1974,1973-11-04,1974-04-22,170,0,234,763,997,55,394,449,1446,38,271,MN - St Cloud
24,1974-1975,1974-11-04,1975-04-19,167,0,215,753,968,95,852,947,1915,48,390,MN - St Cloud
25,1975-1976,1975-11-11,1976-05-02,174,0,225,735,960,81,698,779,1739,30,261,MN - St Cloud
26,1976-1977,1976-10-18,1977-04-05,170,0,299,873,1172,50,254,304,1476,31,304,MN - St Cloud
27,1977-1978,1977-11-09,1978-04-20,163,0,306,824,1130,68,428,496,1626,38,339,MN - St Cloud
28,1978-1979,1978-11-12,1979-05-04,174,0,368,962,1330,104,899,1003,2333,52,527,MN - St Cloud
29,1979-1980,1979-11-08,1980-04-09,154,0,193,694,887,71,339,410,1297,38,275,MN - St Cloud
30,1980-1981,1980-11-24,1981-04-04,132,0,166,534,700,33,55,88,788,24,185,MN - St Cloud
31,1981-1982,1981-10-23,1982-04-06,166,0,322,836,1158,86,634,720,1878,45,439,MN - St Cloud
32,1982-1983,1982-10-19,1983-04-14,178,0,149,553,702,89,410,499,1201,43,222,MN - St Cloud
33,1983-1984,1983-10-12,1984-04-30,202,0,290,763,1053,95,798,893,1946,40,361,MN - St Cloud
34,1984-1985,1984-10-30,1985-04-01,154,0,232,702,934,74,233,307,1241,35,322,MN - St Cloud
35,1985-1986,1985-11-08,1986-03-28,141,0,305,749,1054,89,808,897,1951,42,418,MN - St Cloud
36,1986-1987,1986-10-14,1987-03-29,167,0,112,509,621,29,60,89,710,19,118,MN - St Cloud
37,1987-1988,1987-10-20,1988-04-09,173,0,215,678,893,60,354,414,1307,42,303,MN - St Cloud
38,1988-1989,1988-10-23,1989-04-18,178,5,237,792,1029,98,647,745,1774,40,362,MN - St Cloud
39,1989-1990,1989-11-02,1990-04-29,179,0,181,692,873,57,146,203,1076,32,267,MN - St Cloud
40,1990-1991,1990-11-25,1991-05-05,162,0,191,633,824,73,271,344,1168,34,277,MN - St Cloud
41,1991-1992,1991-10-30,1992-04-12,166,0,158,584,742,85,492,577,1319,35,296,MN - St Cloud
42,1992-1993,1992-10-15,1993-04-14,182,0,210,718,928,93,572,665,1593,44,296,MN - St Cloud
43,1993-1994,1993-10-30,1994-04-30,183,0,289,784,1073,101,607,708,1781,49,471,MN - St Cloud
44,1994-1995,1994-11-26,1995-04-18,144,0,167,612,779,67,513,580,1359,29,218,MN - St Cloud
45,1995-1996,1995-09-21,1996-04-14,207,0,315,864,1179,98,655,753,1932,47,375,MN - St Cloud
49,1999-2000,1999-11-23,2000-04-16,146,0,131,523,654,42,224,266,920,19,147,MN - St Cloud
50,2000-2001,2000-11-08,2001-04-06,150,3,301,776,1077,88,874,962,2039,47,415,MN - St Cloud
51,2001-2002,2001-10-24,2002-04-28,187,0,138,510,648,90,307,397,1045,26,217,MN - St Cloud
52,2002-2003,2002-10-17,2003-04-16,182,0,216,680,896,53,120,173,1069,32,253,MN - St Cloud
53,2003-2004,2003-11-03,2004-03-21,140,0,204,577,781,78,304,382,1163,41,326,MN - St Cloud
54,2004-2005,2004-11-25,2005-05-01,158,0,167,548,715,55,219,274,989,34,205,MN - St Cloud
55,2005-2006,2005-11-15,2006-03-23,129,0,143,469,612,57,347,404,1016,35,208,MN - St Cloud
56,2006-2007,2006-11-01,2007-04-11,162,0,176,557,733,51,170,221,954,26,176,MN - St Cloud
57,2007-2008,2007-11-21,2008-04-26,158,0,268,727,995,82,587,669,1664,36,285,MN - St Cloud
58,2008-2009,2008-11-09,2009-04-05,148,0,265,788,1053,85,569,654,1707,35,363,MN - St Cloud
59,2009-2010,2009-10-10,2010-03-13,155,0,205,574,779,48,517,565,1344,26,184,MN - St Cloud
60,2010-2011,2010-11-13,2011-04-20,159,0,270,695,965,107,719,826,1791,49,453,MN - St Cloud
61,2011-2012,2011-11-16,2012-03-11,117,0,84,394,478,46,152,198,676,24,145,MN - St Cloud
62,2012-2013,2012-10-25,2013-04-23,181,0,200,704,904,124,716,840,1744,50,382,MN - St Cloud
63,2013-2014,2013-10-20,2014-04-19,182,0,357,904,1261,117,844,961,2222,50,537,MN - St Cloud
64,2014-2015,2014-11-10,2015-04-10,152,0,236,599,835,57,213,270,1105,34,255,MN - St Cloud
65,2015-2016,2015-10-28,2016-04-08,164,0,136,419,555,55,206,261,816,33,204,MN - St Cloud
66,2016-2017,2016-11-18,2017-05-01,165,0,158,467,625,49,188,237,862,26,203,MN - St Cloud
67,2017-2018,2017-10-27,2018-04-20,176,0,238,737,975,94,374,468,1443,39,333,MN - St Cloud
68,2018-2019,2018-11-06,2019-05-09,185,0,274,747,1021,98,596,694,1715,40,363,MN - St Cloud
69,2019-2020,2019-10-11,2020-04-14,187,0,175,600,775,73,526,599,1374,37,253,MN - St Cloud
0,1950-1951,1950-11-10,1951-04-13,155,3,270,766,1036,133,852,985,2021,40,424,MN - Winnebago
1,1951-1952,1951-11-01,1952-04-13,165,1,197,631,828,93,464,557,1385,32,284,MN - Winnebago
2,1952-1953,1952-11-25,1953-04-16,143,1,150,487,637,72,610,682,1319,24,213,MN - Winnebago
3,1953-1954,1953-11-23,1954-05-03,162,0,137,521,658,42,87,129,787,22,154,MN - Winnebago
4,1954-1955,1954-11-02,1955-03-29,148,0,176,566,742,66,368,434,1176,27,247,MN - Winnebago
5,1955-1956,1955-11-04,1956-05-01,180,0,271,780,1051,98,646,744,1795,35,329,MN - Winnebago
6,1956-1957,1956-11-16,1957-04-12,148,0,161,579,740,55,128,183,923,24,215,MN - Winnebago
7,1957-1958,1957-10-26,1958-04-07,164,0,148,492,640,43,152,195,835,21,123,MN - Winnebago
8,1958-1959,1958-11-24,1959-03-29,126,1,222,664,886,70,293,363,1249,23,238,MN - Winnebago
9,1959-1960,1959-10-13,1960-03-27,167,0,184,615,799,66,295,361,1160,20,176,MN - Winnebago
10,1960-1961,1960-11-10,1961-04-18,160,0,155,550,705,79,326,405,1110,20,190,MN - Winnebago
11,1961-1962,1961-10-01,1962-04-16,198,0,252,713,965,116,770,886,1851,35,338,MN - Winnebago
12,1962-1963,1962-11-18,1963-04-23,157,1,233,593,826,65,385,450,1276,34,326,MN - Winnebago
13,1963-1964,1963-11-24,1964-03-30,128,1,168,555,723,45,146,191,914,21,177,MN - Winnebago
14,1964-1965,1964-11-20,1965-04-26,158,0,300,784,1084,108,683,791,1875,30,339,MN - Winnebago
15,1965-1966,1965-11-17,1966-05-12,177,3,226,615,841,56,243,299,1140,21,196,MN - Winnebago
16,1966-1967,1966-10-15,1967-03-22,159,1,198,658,856,90,511,601,1457,30,316,MN - Winnebago
17,1967-1968,1967-10-27,1968-04-04,161,0,186,606,792,27,71,98,890,14,109,MN - Winnebago
18,1968-1969,1968-11-08,1969-04-03,147,0,261,687,948,93,841,934,1882,27,244,MN - Winnebago
19,1969-1970,1969-10-27,1970-04-14,170,0,255,739,994,80,740,820,1814,18,187,MN - Winnebago
20,1970-1971,1970-10-10,1971-04-02,175,0,246,698,944,82,591,673,1617,22,210,MN - Winnebago
21,1971-1972,1971-11-07,1972-04-08,154,1,241,671,912,77,493,570,1482,32,289,MN - Winnebago
22,1972-1973,1972-10-18,1973-04-10,175,0,195,537,732,78,457,535,1267,25,229,MN - Winnebago
23,1973-1974,1973-11-05,1974-04-05,152,0,215,589,804,60,406,466,1270,26,268,MN - Winnebago
24,1974-1975,1974-11-05,1975-04-13,160,0,199,618,817,89,789,878,1695,29,232,MN - Winnebago
25,1975-1976,1975-11-10,1976-03-22,134,0,157,471,628,43,114,157,785,20,134,MN - Winnebago
26,1976-1977,1976-10-19,1977-04-05,169,0,242,700,942,57,274,331,1273,25,248,MN - Winnebago
27,1977-1978,1977-10-11,1978-04-21,193,1,311,753,1064,90,649,739,1803,33,355,MN - Winnebago
28,1978-1979,1978-11-12,1979-04-07,147,0,367,826,1193,105,965,1070,2263,37,382,MN - Winnebago
29,1979-1980,1979-11-09,1980-04-10,154,3,174,563,737,55,234,289,1026,23,180,MN - Winnebago
30,1980-1981,1980-11-14,1981-04-04,142,0,144,513,657,27,75,102,759,15,150,MN - Winnebago
31,1981-1982,1981-10-24,1982-04-11,170,3,284,723,1007,96,680,776,1783,30,290,MN - Winnebago
32,1982-1983,1982-10-20,1983-04-18,181,15,132,476,608,103,612,715,1323,30,219,MN - Winnebago
33,1983-1984,1983-11-09,1984-05-01,175,1,270,707,977,136,1055,1191,2168,31,326,MN - Winnebago
34,1984-1985,1984-11-02,1985-04-05,155,3,199,536,735,90,297,387,1122,28,228,MN - Winnebago
36,1986-1987,1986-11-02,1987-03-29,148,1,90,402,492,24,60,84,576,15,83,MN - Winnebago
37,1987-1988,1987-11-18,1988-04-27,162,1,219,593,812,64,504,568,1380,23,221,MN - Winnebago
39,1989-1990,1989-11-15,1990-03-19,125,9,156,531,687,19,76,95,782,10,84,MN - Winnebago
40,1990-1991,1990-11-04,1991-03-30,147,0,197,572,769,51,336,387,1156,20,188,MN - Winnebago
41,1991-1992,1991-10-19,1992-04-13,178,3,137,465,602,69,320,389,991,29,207,MN - Winnebago
42,1992-1993,1992-11-02,1993-04-01,151,1,236,592,828,69,521,590,1418,29,206,MN - Winnebago
43,1993-1994,1993-10-30,1994-04-29,182,0,288,695,983,87,495,582,1565,31,369,MN - Winnebago
44,1994-1995,1994-11-28,1995-04-11,135,0,156,465,621,35,162,197,818,12,95,MN - Winnebago
45,1995-1996,1995-11-01,1996-04-15,167,1,260,674,934,59,346,405,1339,20,191,MN - Winnebago
46,1996-1997,1996-10-31,1997-04-09,161,1,282,666,948,70,654,724,1672,28,262,MN - Winnebago
47,1997-1998,1997-11-03,1998-03-19,137,0,148,406,554,60,250,310,864,27,186,MN - Winnebago
48,1998-1999,1998-11-07,1999-04-16,161,1,149,450,599,63,313,376,975,21,214,MN - Winnebago
49,1999-2000,1999-12-01,2000-04-08,130,4,91,413,504,50,240,290,794,21,164,MN - Winnebago
50,2000-2001,2000-11-08,2001-04-02,146,9,268,719,987,83,766,849,1836,32,326,MN - Winnebago
51,2001-2002,2001-11-30,2002-04-04,126,8,109,404,513,33,124,157,670,14,85,MN - Winnebago
54,2004-2005,2004-11-27,2005-03-25,119,18,132,424,556,39,113,152,708,14,107,MN - Winnebago
55,2005-2006,2005-11-16,2006-03-25,130,14,126,434,560,61,275,336,896,27,199,MN - Winnebago
57,2007-2008,2007-11-22,2008-04-01,132,6,227,589,816,52,460,512,1328,27,226,MN - Winnebago
58,2008-2009,2008-11-07,2009-04-05,150,2,203,644,847,76,398,474,1321,27,261,MN - Winnebago
59,2009-2010,2009-10-12,2010-03-15,155,1,219,569,788,87,721,808,1596,28,261,MN - Winnebago
61,2011-2012,2011-11-20,2012-03-05,107,18,72,324,396,27,93,120,516,12,90,MN - Winnebago
62,2012-2013,2012-11-12,2013-05-02,172,1,162,574,736,77,275,352,1088,19,139,MN - Winnebago
63,2013-2014,2013-11-06,2014-04-05,151,3,290,749,1039,81,514,595,1634,29,324,MN - Winnebago
64,2014-2015,2014-11-11,2015-03-25,135,1,209,560,769,56,311,367,1136,16,166,MN - Winnebago
65,2015-2016,2015-11-21,2016-03-25,126,0,127,369,496,58,352,410,906,19,140,MN - Winnebago
66,2016-2017,2016-11-20,2017-03-18,119,0,134,393,527,59,306,365,892,12,128,MN - Winnebago
67,2017-2018,2017-11-07,2018-04-22,167,0,228,637,865,147,573,720,1585,29,354,MN - Winnebago
68,2018-2019,2018-10-14,2019-04-28,197,0,248,652,900,116,650,766,1666,29,342,MN - Winnebago
69,2019-2020,2019-10-31,2020-04-15,168,0,131,492,623,71,555,626,1249,17,150,MN - Winnebago
0,1950-1951,1950-11-24,1951-03-20,117,4,10,94,104,10,26,36,140,8,27,MS - Cleveland
1,1951-1952,1951-12-01,1952-02-29,91,0,0,32,32,3,0,3,35,1,4,MS - Cleveland
2,1952-1953,1952-12-01,1953-02-28,90,0,0,36,36,0,0,0,36,0,0,MS - Cleveland
3,1953-1954,1953-12-01,1954-02-28,90,0,1,47,48,4,1,5,53,3,8,MS - Cleveland
4,1954-1955,1954-12-01,1955-02-28,90,12,0,59,59,1,1,2,61,1,3,MS - Cleveland
5,1955-1956,1955-12-01,1956-03-08,99,4,0,62,62,2,0,2,64,2,4,MS - Cleveland
6,1956-1957,1956-12-01,1957-02-28,90,1,1,29,30,0,0,0,30,0,0,MS - Cleveland
7,1957-1958,1957-12-01,1958-02-28,90,2,4,75,79,4,3,7,86,1,5,MS - Cleveland
8,1958-1959,1958-12-01,1959-02-28,90,3,5,73,78,10,14,24,102,2,19,MS - Cleveland
9,1959-1960,1959-12-01,1960-03-06,97,11,5,72,77,14,1,15,92,6,21,MS - Cleveland
10,1960-1961,1960-12-01,1961-02-28,90,7,5,91,96,3,0,3,99,2,8,MS - Cleveland
11,1961-1962,1961-12-01,1962-02-28,90,6,8,81,89,14,24,38,127,2,29,MS - Cleveland
12,1962-1963,1962-12-01,1963-02-28,90,1,6,117,123,6,3,9,132,3,16,MS - Cleveland
13,1963-1964,1963-12-01,1964-02-29,91,4,6,101,107,2,26,28,135,1,5,MS - Cleveland
14,1964-1965,1964-12-01,1965-03-08,98,1,4,65,69,13,6,19,88,6,24,MS - Cleveland
15,1965-1966,1965-12-01,1966-02-28,90,5,4,80,84,33,34,67,151,5,41,MS - Cleveland
16,1966-1967,1966-12-01,1967-03-07,97,3,2,71,73,1,2,3,76,1,2,MS - Cleveland
17,1967-1968,1967-12-01,1968-03-24,115,3,4,83,87,25,25,50,137,5,36,MS - Cleveland
18,1968-1969,1968-12-01,1969-02-28,90,1,2,64,66,1,0,1,67,1,1,MS - Cleveland
19,1969-1970,1969-12-01,1970-02-28,90,5,7,75,82,5,3,8,90,3,15,MS - Cleveland
20,1970-1971,1970-12-01,1971-04-07,128,3,5,79,84,9,7,16,100,4,16,MS - Cleveland
21,1971-1972,1971-12-01,1972-02-29,91,1,4,47,51,0,0,0,51,0,0,MS - Cleveland
22,1972-1973,1972-12-01,1973-02-28,90,1,5,75,80,3,1,4,84,2,6,MS - Cleveland
23,1973-1974,1973-12-01,1974-02-28,90,0,5,54,59,0,0,0,59,0,0,MS - Cleveland
24,1974-1975,1974-12-01,1975-02-28,90,0,1,58,59,8,7,15,74,2,15,MS - Cleveland
25,1975-1976,1975-11-23,1976-02-29,99,1,2,78,80,2,1,3,83,1,3,MS - Cleveland
26,1976-1977,1976-11-29,1977-02-28,92,0,12,118,130,5,10,15,145,2,13,MS - Cleveland
27,1977-1978,1977-12-01,1978-02-28,90,0,17,114,131,14,13,27,158,7,34,MS - Cleveland
28,1978-1979,1978-12-01,1979-02-28,90,3,13,98,111,3,1,4,115,2,6,MS - Cleveland
29,1979-1980,1979-12-01,1980-03-02,93,2,4,66,70,3,4,7,77,1,6,MS - Cleveland
30,1980-1981,1980-12-01,1981-02-28,90,0,2,79,81,0,0,0,81,0,0,MS - Cleveland
31,1981-1982,1981-12-01,1982-02-28,90,2,8,86,94,4,9,13,107,1,8,MS - Cleveland
32,1982-1983,1982-12-01,1983-02-28,90,3,1,41,42,1,1,2,44,1,3,MS - Cleveland
33,1983-1984,1983-12-01,1984-03-11,102,20,18,102,120,2,6,8,128,2,4,MS - Cleveland
34,1984-1985,1984-12-01,1985-02-28,90,13,7,87,94,10,9,19,113,5,31,MS - Cleveland
35,1985-1986,1985-12-01,1986-02-28,90,2,2,71,73,2,0,2,75,1,3,MS - Cleveland
36,1986-1987,1986-12-01,1987-02-28,90,12,1,31,32,1,0,1,33,1,3,MS - Cleveland
54,2004-2005,2004-12-01,2005-02-28,90,0,2,50,52,0,0,0,52,0,0,MS - Cleveland
55,2005-2006,2005-12-01,2006-02-28,90,0,3,55,58,1,0,1,59,1,2,MS - Cleveland
56,2006-2007,2006-12-01,2007-02-28,90,0,3,63,66,1,0,1,67,1,2,MS - Cleveland
57,2007-2008,2007-12-01,2008-03-08,99,2,2,56,58,7,4,11,69,1,9,MS - Cleveland
58,2008-2009,2008-12-01,2009-03-01,91,0,1,63,64,1,1,2,66,1,2,MS - Cleveland
59,2009-2010,2009-12-01,2010-02-28,90,4,7,84,91,5,0,5,96,5,17,MS - Cleveland
60,2010-2011,2010-12-01,2011-02-28,90,0,7,84,91,13,15,28,119,2,20,MS - Cleveland
61,2011-2012,2011-12-01,2012-02-29,91,0,1,35,36,1,0,1,37,1,2,MS - Cleveland
62,2012-2013,2012-12-01,2013-02-28,90,0,2,36,38,0,0,0,38,0,0,MS - Cleveland
63,2013-2014,2013-12-01,2014-03-05,95,0,15,107,122,4,0,4,126,4,16,MS - Cleveland
64,2014-2015,2014-12-01,2015-03-06,96,1,5,71,76,14,11,25,101,4,23,MS - Cleveland
65,2015-2016,2015-12-01,2016-02-29,91,0,1,36,37,1,0,1,38,1,2,MS - Cleveland
66,2016-2017,2016-12-01,2017-02-28,90,0,4,40,44,0,0,0,44,0,0,MS - Cleveland
67,2017-2018,2017-12-01,2018-02-28,90,1,13,79,92,5,7,12,104,3,17,MS - Cleveland
68,2018-2019,2018-11-14,2019-03-05,112,0,2,36,38,2,0,2,40,2,5,MS - Cleveland
69,2019-2020,2019-11-13,2020-02-29,109,0,1,33,34,2,0,2,36,2,4,MS - Cleveland
0,1950-1951,1950-11-24,1951-03-20,117,3,11,108,119,17,40,57,176,7,48,MS - Oxford
1,1951-1952,1951-12-01,1952-02-29,91,1,1,37,38,0,2,2,40,0,0,MS - Oxford
2,1952-1953,1952-12-01,1953-02-28,90,0,1,40,41,0,0,0,41,0,0,MS - Oxford
3,1953-1954,1953-12-01,1954-02-28,90,3,1,45,46,0,6,6,52,0,0,MS - Oxford
4,1954-1955,1954-12-01,1955-02-28,90,1,0,58,58,4,2,6,64,2,7,MS - Oxford
5,1955-1956,1955-12-01,1956-02-29,91,2,0,61,61,3,0,3,64,1,5,MS - Oxford
6,1956-1957,1956-12-01,1957-02-28,90,5,2,33,35,0,0,0,35,0,0,MS - Oxford
7,1957-1958,1957-12-01,1958-02-28,90,4,5,97,102,4,0,4,106,1,5,MS - Oxford
8,1958-1959,1958-12-01,1959-02-28,90,6,3,91,94,6,0,6,100,2,15,MS - Oxford
9,1959-1960,1959-12-01,1960-03-02,93,15,0,60,60,9,0,9,69,2,11,MS - Oxford
10,1960-1961,1960-12-01,1961-02-28,90,1,6,121,127,0,0,0,127,0,0,MS - Oxford
11,1961-1962,1961-12-01,1962-03-06,96,0,14,95,109,11,20,31,140,2,20,MS - Oxford
12,1962-1963,1962-12-01,1963-02-28,90,0,17,165,182,5,1,6,188,3,11,MS - Oxford
13,1963-1964,1963-12-01,1964-02-29,91,9,9,164,173,11,5,16,189,2,19,MS - Oxford
14,1964-1965,1964-12-01,1965-02-28,90,0,5,116,121,6,5,11,132,2,15,MS - Oxford
15,1965-1966,1965-12-01,1966-02-28,90,0,12,123,135,22,31,53,188,4,33,MS - Oxford
16,1966-1967,1966-12-01,1967-02-28,90,1,3,120,123,0,1,1,124,0,0,MS - Oxford
17,1967-1968,1967-12-01,1968-03-23,114,0,7,154,161,29,26,55,216,6,43,MS - Oxford
18,1968-1969,1968-12-01,1969-02-28,90,0,1,109,110,0,0,0,110,0,0,MS - Oxford
19,1969-1970,1969-12-01,1970-02-28,90,0,11,142,153,0,1,1,154,0,0,MS - Oxford
20,1970-1971,1970-11-25,1971-02-28,96,0,10,122,132,4,5,9,141,1,7,MS - Oxford
21,1971-1972,1971-12-01,1972-02-29,91,0,4,90,94,0,0,0,94,0,0,MS - Oxford
22,1972-1973,1972-12-01,1973-02-28,90,0,6,96,102,2,1,3,105,2,4,MS - Oxford
23,1973-1974,1973-12-01,1974-02-28,90,0,6,78,84,0,0,0,84,0,0,MS - Oxford
24,1974-1975,1974-12-01,1975-02-28,90,0,3,82,85,5,6,11,96,2,12,MS - Oxford
25,1975-1976,1975-12-01,1976-02-29,91,0,4,119,123,0,0,0,123,0,0,MS - Oxford
26,1976-1977,1976-11-29,1977-02-28,92,0,18,212,230,4,4,8,238,3,20,MS - Oxford
27,1977-1978,1977-12-01,1978-03-04,94,2,17,196,213,10,4,14,227,5,23,MS - Oxford
28,1978-1979,1978-12-01,1979-02-28,90,4,11,162,173,0,5,5,178,0,0,MS - Oxford
29,1979-1980,1979-12-01,1980-03-03,94,3,9,122,131,5,2,7,138,3,10,MS - Oxford
30,1980-1981,1980-12-01,1981-02-28,90,1,4,164,168,0,0,0,168,0,0,MS - Oxford
31,1981-1982,1981-12-01,1982-02-28,90,1,14,148,162,4,9,13,175,1,7,MS - Oxford
32,1982-1983,1982-12-01,1983-02-28,90,1,0,90,90,3,2,5,95,1,4,MS - Oxford
33,1983-1984,1983-12-01,1984-03-10,101,2,18,192,210,6,4,10,220,2,9,MS - Oxford
34,1984-1985,1984-12-01,1985-02-28,90,1,18,156,174,26,40,66,240,6,50,MS - Oxford
35,1985-1986,1985-12-01,1986-02-28,90,1,10,156,166,4,4,8,174,2,12,MS - Oxford
36,1986-1987,1986-12-01,1987-02-28,90,8,1,83,84,0,0,0,84,0,0,MS - Oxford
39,1989-1990,1989-12-01,1990-02-28,90,3,12,83,95,0,1,1,96,0,0,MS - Oxford
40,1990-1991,1990-12-01,1991-02-28,90,9,1,62,63,0,0,0,63,0,0,MS - Oxford
42,1992-1993,1992-12-01,1993-03-14,104,4,1,81,82,0,0,0,82,0,0,MS - Oxford
44,1994-1995,1994-12-01,1995-02-28,90,15,0,58,58,6,3,9,67,3,12,MS - Oxford
46,1996-1997,1996-12-01,1997-02-28,90,1,3,84,87,0,0,0,87,0,0,MS - Oxford
47,1997-1998,1997-12-01,1998-02-28,90,3,0,55,55,4,5,9,64,1,5,MS - Oxford
48,1998-1999,1998-12-01,1999-02-28,90,0,6,68,74,2,0,2,76,2,8,MS - Oxford
49,1999-2000,1999-12-01,2000-02-29,91,9,0,83,83,7,5,12,95,1,8,MS - Oxford
50,2000-2001,2000-12-01,2001-02-28,90,1,5,134,139,3,1,4,143,2,12,MS - Oxford
51,2001-2002,2001-12-01,2002-02-28,90,5,0,70,70,0,0,0,70,0,0,MS - Oxford
52,2002-2003,2002-12-01,2003-02-28,90,0,2,102,104,1,0,1,105,1,2,MS - Oxford
53,2003-2004,2003-12-01,2004-02-29,91,0,0,83,83,2,1,3,86,1,2,MS - Oxford
54,2004-2005,2004-12-01,2005-02-28,90,0,2,69,71,1,0,1,72,1,4,MS - Oxford
55,2005-2006,2005-12-01,2006-02-28,90,11,1,89,90,1,0,1,91,1,2,MS - Oxford
56,2006-2007,2006-12-01,2007-02-28,90,12,0,85,85,1,1,2,87,1,2,MS - Oxford
58,2008-2009,2008-12-01,2009-03-01,91,8,2,80,82,3,2,5,87,1,4,MS - Oxford
59,2009-2010,2009-12-01,2010-02-28,90,7,7,111,118,4,4,8,126,4,18,MS - Oxford
65,2015-2016,2015-12-01,2016-02-29,91,0,0,63,63,3,3,6,69,2,5,MS - Oxford
66,2016-2017,2016-12-01,2017-02-28,90,4,2,58,60,1,0,1,61,1,3,MS - Oxford
67,2017-2018,2017-12-01,2018-02-28,90,2,7,109,116,4,2,6,122,4,20,MS - Oxford
68,2018-2019,2018-11-15,2019-02-28,106,2,1,70,71,1,1,2,73,1,2,MS - Oxford
69,2019-2020,2019-12-01,2020-02-29,91,2,0,51,51,1,1,2,53,1,3,MS - Oxford
0,1950-1951,1950-11-25,1951-02-28,96,19,9,85,94,5,3,8,102,2,12,MS - Tupelo
1,1951-1952,1951-12-01,1952-02-29,91,6,1,33,34,0,0,0,34,0,0,MS - Tupelo
2,1952-1953,1952-12-01,1953-02-28,90,6,1,25,26,0,0,0,26,0,0,MS - Tupelo
3,1953-1954,1953-12-01,1954-02-28,90,0,2,47,49,0,0,0,49,0,0,MS - Tupelo
4,1954-1955,1954-12-01,1955-02-28,90,4,1,52,53,0,0,0,53,0,0,MS - Tupelo
5,1955-1956,1955-12-01,1956-02-29,91,1,0,45,45,0,0,0,45,0,0,MS - Tupelo
6,1956-1957,1956-12-01,1957-02-28,90,6,1,26,27,0,0,0,27,0,0,MS - Tupelo
8,1958-1959,1958-12-01,1959-02-28,90,18,3,68,71,0,0,0,71,0,0,MS - Tupelo
10,1960-1961,1960-12-01,1961-02-28,90,8,5,87,92,0,0,0,92,0,0,MS - Tupelo
11,1961-1962,1961-12-01,1962-02-28,90,17,8,63,71,0,0,0,71,0,0,MS - Tupelo
12,1962-1963,1962-12-01,1963-02-28,90,1,12,142,154,0,0,0,154,0,0,MS - Tupelo
13,1963-1964,1963-12-01,1964-02-29,91,7,8,101,109,0,8,8,117,0,0,MS - Tupelo
14,1964-1965,1964-12-01,1965-02-28,90,4,5,85,90,0,0,0,90,0,0,MS - Tupelo
15,1965-1966,1965-12-01,1966-02-28,90,9,5,74,79,0,0,0,79,0,0,MS - Tupelo
16,1966-1967,1966-12-01,1967-02-28,90,0,1,70,71,0,0,0,71,0,0,MS - Tupelo
17,1967-1968,1967-12-01,1968-03-22,113,13,3,80,83,9,4,13,96,1,10,MS - Tupelo
18,1968-1969,1968-12-01,1969-02-28,90,0,2,59,61,0,0,0,61,0,0,MS - Tupelo
19,1969-1970,1969-11-14,1970-02-28,107,5,7,138,145,4,0,4,149,2,8,MS - Tupelo
21,1971-1972,1971-12-01,1972-02-29,91,0,1,65,66,0,0,0,66,0,0,MS - Tupelo
22,1972-1973,1972-12-01,1973-02-28,90,1,4,89,93,0,0,0,93,0,0,MS - Tupelo
23,1973-1974,1973-12-01,1974-02-28,90,0,0,64,64,0,0,0,64,0,0,MS - Tupelo
24,1974-1975,1974-12-01,1975-02-28,90,0,1,77,78,2,0,2,80,1,3,MS - Tupelo
25,1975-1976,1975-12-01,1976-02-29,91,0,0,103,103,0,0,0,103,0,0,MS - Tupelo
26,1976-1977,1976-12-01,1977-02-28,90,4,7,187,194,3,0,3,197,1,9,MS - Tupelo
28,1978-1979,1978-12-01,1979-02-28,90,0,3,146,149,2,1,3,152,1,3,MS - Tupelo
30,1980-1981,1980-12-01,1981-02-28,90,4,0,139,139,0,0,0,139,0,0,MS - Tupelo
32,1982-1983,1982-12-01,1983-02-28,90,5,0,65,65,3,0,3,68,2,5,MS - Tupelo
33,1983-1984,1983-12-01,1984-03-10,101,0,16,118,134,9,6,15,149,6,17,MS - Tupelo
34,1984-1985,1984-12-01,1985-02-28,90,0,11,104,115,14,29,43,158,8,43,MS - Tupelo
35,1985-1986,1985-12-01,1986-02-28,90,0,7,95,102,3,2,5,107,2,9,MS - Tupelo
36,1986-1987,1986-12-01,1987-04-02,123,0,1,47,48,3,0,3,51,3,3,MS - Tupelo
37,1987-1988,1987-12-01,1988-02-29,91,0,8,90,98,12,24,36,134,3,22,MS - Tupelo
38,1988-1989,1988-12-01,1989-02-28,90,0,4,48,52,2,1,3,55,2,5,MS - Tupelo
39,1989-1990,1989-12-01,1990-02-28,90,0,12,69,81,1,0,1,82,1,2,MS - Tupelo
40,1990-1991,1990-12-01,1991-02-28,90,0,2,49,51,1,0,1,52,1,5,MS - Tupelo
41,1991-1992,1991-12-01,1992-02-29,91,0,0,38,38,1,0,1,39,1,2,MS - Tupelo
42,1992-1993,1992-12-01,1993-03-13,103,0,0,38,38,3,0,3,41,2,5,MS - Tupelo
43,1993-1994,1993-12-01,1994-02-28,90,0,4,84,88,1,0,1,89,1,3,MS - Tupelo
44,1994-1995,1994-12-01,1995-02-28,90,0,0,58,58,6,2,8,66,4,13,MS - Tupelo
45,1995-1996,1995-12-01,1996-03-08,99,0,14,105,119,3,6,9,128,2,10,MS - Tupelo
46,1996-1997,1996-12-01,1997-02-28,90,0,6,67,73,3,2,5,78,3,11,MS - Tupelo
47,1997-1998,1997-12-01,1998-02-28,90,0,0,37,37,5,3,8,45,3,7,MS - Tupelo
48,1998-1999,1998-12-01,1999-02-28,90,0,5,47,52,2,3,5,57,2,4,MS - Tupelo
49,1999-2000,1999-12-01,2000-02-29,91,0,0,61,61,6,2,8,69,2,9,MS - Tupelo
50,2000-2001,2000-12-01,2001-05-26,177,0,7,116,123,0,3,3,126,0,0,MS - Tupelo
51,2001-2002,2001-12-01,2002-02-28,90,0,0,49,49,0,0,0,49,0,0,MS - Tupelo
52,2002-2003,2002-12-01,2003-02-28,90,0,3,86,89,0,0,0,89,0,0,MS - Tupelo
53,2003-2004,2003-12-01,2004-02-29,91,1,0,73,73,0,0,0,73,0,0,MS - Tupelo
54,2004-2005,2004-12-01,2005-02-28,90,0,2,58,60,0,0,0,60,0,0,MS - Tupelo
55,2005-2006,2005-12-01,2006-02-28,90,6,1,50,51,0,0,0,51,0,0,MS - Tupelo
56,2006-2007,2006-12-01,2007-02-28,90,0,0,65,65,1,0,1,66,1,3,MS - Tupelo
57,2007-2008,2007-12-01,2008-03-08,99,0,3,66,69,5,2,7,76,3,10,MS - Tupelo
58,2008-2009,2008-12-01,2009-03-01,91,0,2,71,73,1,0,1,74,1,2,MS - Tupelo
59,2009-2010,2009-12-01,2010-02-28,90,0,4,99,103,2,0,2,105,2,6,MS - Tupelo
60,2010-2011,2010-12-01,2011-02-28,90,0,5,96,101,16,20,36,137,5,23,MS - Tupelo
61,2011-2012,2011-12-01,2012-02-29,91,0,0,47,47,0,0,0,47,0,0,MS - Tupelo
62,2012-2013,2012-12-01,2013-02-28,90,0,0,42,42,0,0,0,42,0,0,MS - Tupelo
63,2013-2014,2013-12-01,2014-02-28,90,0,7,110,117,1,1,2,119,1,2,MS - Tupelo
64,2014-2015,2014-12-01,2015-03-05,95,0,2,75,77,11,5,16,93,2,14,MS - Tupelo
65,2015-2016,2015-12-01,2016-02-29,91,0,0,51,51,0,0,0,51,0,0,MS - Tupelo
66,2016-2017,2016-12-01,2017-02-28,90,1,2,41,43,0,0,0,43,0,0,MS - Tupelo
67,2017-2018,2017-12-01,2018-02-28,90,0,5,92,97,1,0,1,98,1,6,MS - Tupelo
68,2018-2019,2018-12-01,2019-02-28,90,0,0,32,32,0,0,0,32,0,0,MS - Tupelo
69,2019-2020,2019-12-01,2020-02-29,91,0,0,25,25,1,0,1,26,1,2,MS - Tupelo
0,1950-1951,1950-11-10,1951-03-13,124,1,33,267,300,18,40,58,358,6,52,MO - Appleton City
1,1951-1952,1951-10-31,1952-03-26,148,4,18,214,232,39,51,90,322,15,80,MO - Appleton City
2,1952-1953,1952-11-26,1953-04-18,144,0,9,158,167,11,9,20,187,8,29,MO - Appleton City
3,1953-1954,1953-11-07,1954-03-03,117,0,12,173,185,9,14,23,208,5,20,MO - Appleton City
4,1954-1955,1954-12-01,1955-03-27,117,0,13,180,193,36,52,88,281,6,52,MO - Appleton City
5,1955-1956,1955-11-28,1956-03-16,110,0,20,222,242,33,44,77,319,12,67,MO - Appleton City
6,1956-1957,1956-12-01,1957-04-12,133,0,25,173,198,13,27,40,238,6,32,MO - Appleton City
7,1957-1958,1957-12-01,1958-03-17,107,0,23,191,214,33,51,84,298,8,47,MO - Appleton City
8,1958-1959,1958-11-27,1959-02-28,94,19,32,207,239,31,58,89,328,8,65,MO - Appleton City
9,1959-1960,1959-11-14,1960-03-20,128,0,38,252,290,44,137,181,471,16,85,MO - Appleton City
11,1961-1962,1961-11-19,1962-03-01,103,0,43,222,265,32,82,114,379,10,76,MO - Appleton City
12,1962-1963,1962-12-01,1963-02-28,90,0,34,256,290,10,16,26,316,5,37,MO - Appleton City
13,1963-1964,1963-12-01,1964-03-05,96,1,32,231,263,23,53,76,339,6,39,MO - Appleton City
14,1964-1965,1964-11-21,1965-03-26,126,0,28,278,306,38,49,87,393,13,89,MO - Appleton City
15,1965-1966,1965-12-01,1966-03-27,117,0,23,200,223,7,9,16,239,5,24,MO - Appleton City
16,1966-1967,1966-12-01,1967-02-28,90,0,15,190,205,8,17,25,230,3,17,MO - Appleton City
17,1967-1968,1967-12-01,1968-03-21,112,0,30,208,238,26,49,75,313,9,55,MO - Appleton City
18,1968-1969,1968-12-01,1969-03-11,101,0,16,207,223,27,50,77,300,5,40,MO - Appleton City
19,1969-1970,1969-11-14,1970-04-04,142,0,36,273,309,33,40,73,382,14,71,MO - Appleton City
20,1970-1971,1970-11-23,1971-03-25,123,0,19,223,242,19,18,37,279,7,35,MO - Appleton City
21,1971-1972,1971-11-23,1972-03-29,128,0,20,171,191,21,20,41,232,9,45,MO - Appleton City
22,1972-1973,1972-11-19,1973-04-09,142,0,41,212,253,37,80,117,370,11,71,MO - Appleton City
23,1973-1974,1973-12-01,1974-03-24,114,0,33,193,226,44,103,147,373,12,86,MO - Appleton City
24,1974-1975,1974-11-29,1975-03-13,105,0,9,181,190,42,56,98,288,11,62,MO - Appleton City
25,1975-1976,1975-11-25,1976-03-16,113,1,15,176,191,27,30,57,248,6,42,MO - Appleton City
26,1976-1977,1976-11-28,1977-02-28,93,0,40,302,342,29,149,178,520,10,75,MO - Appleton City
27,1977-1978,1977-11-26,1978-03-25,120,0,65,330,395,36,175,211,606,13,75,MO - Appleton City
28,1978-1979,1978-12-01,1979-02-28,90,0,67,313,380,47,268,315,695,16,137,MO - Appleton City
29,1979-1980,1979-11-29,1980-03-13,106,1,26,232,258,29,50,79,337,7,52,MO - Appleton City
30,1980-1981,1980-11-27,1981-02-28,94,5,15,197,212,12,15,27,239,4,37,MO - Appleton City
31,1981-1982,1981-12-01,1982-04-07,128,1,32,258,290,18,35,53,343,7,40,MO - Appleton City
32,1982-1983,1982-12-01,1983-02-28,90,1,7,109,116,9,10,19,135,5,17,MO - Appleton City
33,1983-1984,1983-12-01,1984-03-20,111,10,66,284,350,28,113,141,491,11,96,MO - Appleton City
34,1984-1985,1984-11-18,1985-02-28,103,0,35,250,285,34,145,179,464,11,72,MO - Appleton City
35,1985-1986,1985-11-28,1986-02-28,93,12,29,224,253,18,21,39,292,7,46,MO - Appleton City
36,1986-1987,1986-11-12,1987-02-28,109,6,16,168,184,26,68,94,278,7,45,MO - Appleton City
37,1987-1988,1987-11-29,1988-03-17,110,3,31,260,291,42,64,106,397,11,83,MO - Appleton City
38,1988-1989,1988-11-20,1989-03-06,107,1,24,202,226,23,23,46,272,6,44,MO - Appleton City
39,1989-1990,1989-12-01,1990-03-24,114,0,39,201,240,19,49,68,308,8,59,MO - Appleton City
40,1990-1991,1990-12-01,1991-02-28,90,2,48,208,256,14,37,51,307,5,51,MO - Appleton City
41,1991-1992,1991-11-02,1992-03-19,139,0,13,177,190,7,6,13,203,4,14,MO - Appleton City
42,1992-1993,1992-11-07,1993-03-18,132,5,39,237,276,40,73,113,389,12,79,MO - Appleton City
43,1993-1994,1993-11-26,1994-02-28,95,2,42,229,271,11,29,40,311,2,20,MO - Appleton City
44,1994-1995,1994-12-01,1995-03-09,99,1,24,192,216,24,52,76,292,6,43,MO - Appleton City
45,1995-1996,1995-11-12,1996-03-09,119,13,69,294,363,18,66,84,447,7,64,MO - Appleton City
46,1996-1997,1996-11-25,1997-02-28,96,6,51,227,278,20,62,82,360,5,45,MO - Appleton City
47,1997-1998,1997-12-01,1998-03-20,110,6,15,149,164,15,11,26,190,8,38,MO - Appleton City
48,1998-1999,1998-12-01,1999-03-14,104,7,34,160,194,10,14,24,218,5,25,MO - Appleton City
49,1999-2000,1999-12-01,2000-03-12,103,16,12,149,161,26,20,46,207,6,49,MO - Appleton City
50,2000-2001,2000-11-09,2001-03-01,113,11,63,309,372,27,74,101,473,9,72,MO - Appleton City
51,2001-2002,2001-11-29,2002-03-26,118,19,19,197,216,14,5,19,235,6,30,MO - Appleton City
54,2004-2005,2004-12-01,2005-02-28,90,12,24,138,162,0,5,5,167,0,0,MO - Appleton City
55,2005-2006,2005-12-01,2006-02-28,90,7,19,155,174,0,3,3,177,0,0,MO - Appleton City
57,2007-2008,2007-12-01,2008-02-29,91,19,26,204,230,4,2,6,236,3,12,MO - Appleton City
58,2008-2009,2008-12-01,2009-03-02,92,4,37,214,251,11,9,20,271,4,31,MO - Appleton City
59,2009-2010,2009-12-01,2010-03-22,112,8,60,255,315,40,125,165,480,12,93,MO - Appleton City
65,2015-2016,2015-12-01,2016-02-29,91,0,16,120,136,0,0,0,136,0,0,MO - Appleton City
66,2016-2017,2016-12-01,2017-03-15,105,0,22,150,172,3,4,7,179,2,16,MO - Appleton City
67,2017-2018,2017-12-01,2018-04-16,137,0,48,244,292,5,8,13,305,3,23,MO - Appleton City
68,2018-2019,2018-11-13,2019-03-06,114,0,48,237,285,18,36,54,339,8,47,MO - Appleton City
69,2019-2020,2019-11-13,2020-02-29,109,0,25,156,181,19,26,45,226,8,43,MO - Appleton City
0,1950-1951,1950-11-10,1951-04-12,154,0,66,305,371,29,35,64,435,15,104,MO - Columbia
1,1951-1952,1951-10-31,1952-03-15,137,0,39,226,265,41,61,102,367,19,97,MO - Columbia
2,1952-1953,1952-11-25,1953-04-17,144,0,17,155,172,26,19,45,217,12,44,MO - Columbia
3,1953-1954,1953-12-01,1954-03-04,94,0,23,159,182,11,15,26,208,5,25,MO - Columbia
4,1954-1955,1954-10-30,1955-03-27,149,0,27,207,234,31,22,53,287,17,81,MO - Columbia
5,1955-1956,1955-11-27,1956-03-19,114,0,35,230,265,34,45,79,344,15,66,MO - Columbia
6,1956-1957,1956-11-29,1957-04-12,135,0,32,203,235,17,26,43,278,11,39,MO - Columbia
7,1957-1958,1957-11-29,1958-03-20,112,0,44,227,271,41,64,105,376,13,67,MO - Columbia
8,1958-1959,1958-11-26,1959-03-15,110,0,61,256,317,33,69,102,419,15,89,MO - Columbia
9,1959-1960,1959-11-06,1960-03-26,142,0,64,288,352,64,185,249,601,24,149,MO - Columbia
10,1960-1961,1960-11-09,1961-04-09,152,0,32,226,258,29,50,79,337,16,96,MO - Columbia
11,1961-1962,1961-11-18,1962-04-01,135,0,68,278,346,51,76,127,473,28,137,MO - Columbia
12,1962-1963,1962-12-01,1963-02-28,90,0,79,288,367,15,40,55,422,11,80,MO - Columbia
13,1963-1964,1963-12-01,1964-03-26,117,0,54,256,310,38,83,121,431,12,64,MO - Columbia
14,1964-1965,1964-11-19,1965-03-27,129,0,52,295,347,44,84,128,475,20,127,MO - Columbia
15,1965-1966,1965-11-29,1966-03-06,98,0,42,201,243,21,26,47,290,10,51,MO - Columbia
16,1966-1967,1966-11-04,1967-03-19,136,0,34,226,260,15,17,32,292,11,45,MO - Columbia
17,1967-1968,1967-11-22,1968-03-21,121,0,45,236,281,28,36,64,345,19,88,MO - Columbia
18,1968-1969,1968-11-11,1969-03-26,136,0,34,231,265,28,43,71,336,12,55,MO - Columbia
19,1969-1970,1969-11-14,1970-04-04,142,0,67,280,347,33,56,89,436,21,78,MO - Columbia
20,1970-1971,1970-11-23,1971-04-06,135,0,44,223,267,21,10,31,298,13,39,MO - Columbia
21,1971-1972,1971-11-23,1972-03-31,130,0,35,192,227,33,26,59,286,20,80,MO - Columbia
22,1972-1973,1972-11-18,1973-04-10,144,0,61,218,279,38,79,117,396,16,92,MO - Columbia
23,1973-1974,1973-12-01,1974-03-25,115,0,67,228,295,56,125,181,476,18,117,MO - Columbia
24,1974-1975,1974-11-04,1975-03-14,131,0,38,222,260,39,78,117,377,13,69,MO - Columbia
25,1975-1976,1975-11-25,1976-03-17,114,0,29,186,215,44,48,92,307,17,84,MO - Columbia
26,1976-1977,1976-10-30,1977-04-05,158,0,102,397,499,55,197,252,751,23,168,MO - Columbia
27,1977-1978,1977-11-09,1978-03-28,140,0,100,364,464,83,253,336,800,32,191,MO - Columbia
28,1978-1979,1978-12-01,1979-03-27,117,0,100,333,433,60,256,316,749,27,196,MO - Columbia
29,1979-1980,1979-11-27,1980-04-15,141,0,52,249,301,43,89,132,433,17,105,MO - Columbia
30,1980-1981,1980-11-26,1981-02-28,95,0,48,211,259,26,37,63,322,11,74,MO - Columbia
31,1981-1982,1981-12-01,1982-04-08,129,0,68,284,352,47,130,177,529,19,135,MO - Columbia
32,1982-1983,1982-11-23,1983-03-21,119,0,24,132,156,10,5,15,171,10,37,MO - Columbia
33,1983-1984,1983-11-12,1984-03-20,130,0,89,289,378,50,124,174,552,27,169,MO - Columbia
34,1984-1985,1984-11-17,1985-02-28,104,0,62,273,335,38,127,165,500,17,119,MO - Columbia
35,1985-1986,1985-11-24,1986-02-28,97,0,50,249,299,17,33,50,349,7,52,MO - Columbia
36,1986-1987,1986-11-12,1987-02-28,109,0,22,157,179,31,78,109,288,8,51,MO - Columbia
37,1987-1988,1987-11-29,1988-03-18,111,0,50,235,285,46,77,123,408,14,89,MO - Columbia
38,1988-1989,1988-11-20,1989-03-20,121,0,41,246,287,43,82,125,412,17,119,MO - Columbia
39,1989-1990,1989-11-15,1990-03-26,132,0,52,242,294,38,68,106,400,19,127,MO - Columbia
40,1990-1991,1990-11-05,1991-02-28,116,0,46,196,242,24,44,68,310,14,92,MO - Columbia
41,1991-1992,1991-11-02,1992-03-19,139,0,19,174,193,20,26,46,239,9,40,MO - Columbia
42,1992-1993,1992-11-03,1993-03-19,137,0,41,244,285,48,83,131,416,18,97,MO - Columbia
43,1993-1994,1993-11-06,1994-04-06,152,0,52,270,322,20,17,37,359,16,77,MO - Columbia
44,1994-1995,1994-12-01,1995-03-08,98,0,35,183,218,43,88,131,349,14,90,MO - Columbia
45,1995-1996,1995-11-05,1996-03-20,137,3,68,288,356,35,57,92,448,24,140,MO - Columbia
50,2000-2001,2000-11-10,2001-02-28,111,1,64,294,358,21,25,46,404,12,73,MO - Columbia
51,2001-2002,2001-12-01,2002-03-05,95,0,23,157,180,12,19,31,211,4,22,MO - Columbia
52,2002-2003,2002-12-01,2003-03-09,99,0,46,236,282,26,29,55,337,12,69,MO - Columbia
53,2003-2004,2003-12-01,2004-02-29,91,0,39,191,230,17,29,46,276,7,45,MO - Columbia
54,2004-2005,2004-11-24,2005-02-28,97,0,27,143,170,20,9,29,199,9,46,MO - Columbia
55,2005-2006,2005-12-01,2006-02-28,90,0,20,141,161,6,6,12,173,3,18,MO - Columbia
56,2006-2007,2006-11-30,2007-03-17,108,0,44,206,250,37,88,125,375,12,84,MO - Columbia
57,2007-2008,2007-12-01,2008-02-29,91,0,26,183,209,21,25,46,255,11,51,MO - Columbia
58,2008-2009,2008-11-21,2009-03-01,101,0,49,243,292,8,6,14,306,7,41,MO - Columbia
59,2009-2010,2009-12-01,2010-03-20,110,0,54,244,298,29,52,81,379,12,72,MO - Columbia
60,2010-2011,2010-12-01,2011-03-27,117,0,60,252,312,73,187,260,572,16,145,MO - Columbia
61,2011-2012,2011-12-01,2012-02-29,91,0,9,122,131,10,10,20,151,5,21,MO - Columbia
62,2012-2013,2012-12-01,2013-03-28,118,0,23,177,200,51,112,163,363,12,70,MO - Columbia
65,2015-2016,2015-12-01,2016-02-29,91,4,19,122,141,14,10,24,165,6,41,MO - Columbia
66,2016-2017,2016-12-01,2017-03-14,104,0,26,142,168,4,2,6,174,3,17,MO - Columbia
67,2017-2018,2017-12-01,2018-04-08,129,0,52,228,280,11,9,20,300,9,43,MO - Columbia
68,2018-2019,2018-11-08,2019-04-14,158,0,36,215,251,41,65,106,357,14,82,MO - Columbia
69,2019-2020,2019-10-31,2020-02-29,122,0,19,149,168,28,47,75,243,14,56,MO - Columbia
0,1950-1951,1950-11-10,1951-04-11,153,5,64,392,456,16,25,41,497,9,51,MO - Conception
1,1951-1952,1951-11-02,1952-03-25,145,8,62,341,403,30,74,104,507,11,80,MO - Conception
2,1952-1953,1952-11-27,1953-03-08,102,5,33,230,263,19,75,94,357,9,44,MO - Conception
3,1953-1954,1953-12-01,1954-03-30,120,5,22,259,281,8,7,15,296,3,23,MO - Conception
4,1954-1955,1954-12-01,1955-03-26,116,10,35,293,328,28,137,165,493,7,55,MO - Conception
5,1955-1956,1955-11-16,1956-03-15,121,10,51,335,386,23,50,73,459,11,61,MO - Conception
6,1956-1957,1956-11-21,1957-04-11,142,6,51,312,363,22,60,82,445,13,81,MO - Conception
8,1958-1959,1958-11-27,1959-03-15,109,6,68,322,390,39,75,114,504,11,89,MO - Conception
9,1959-1960,1959-11-05,1960-03-27,144,8,87,382,469,68,330,398,867,14,125,MO - Conception
10,1960-1961,1960-12-01,1961-04-02,123,10,31,266,297,12,3,15,312,6,35,MO - Conception
12,1962-1963,1962-12-01,1963-02-28,90,12,99,319,418,15,27,42,460,7,58,MO - Conception
13,1963-1964,1963-12-01,1964-03-26,117,15,62,315,377,33,43,76,453,10,76,MO - Conception
14,1964-1965,1964-11-19,1965-03-27,129,2,100,462,562,58,124,182,744,18,154,MO - Conception
15,1965-1966,1965-11-30,1966-03-24,115,0,69,323,392,11,14,25,417,7,41,MO - Conception
16,1966-1967,1966-12-01,1967-04-24,145,1,63,364,427,24,106,130,557,6,53,MO - Conception
17,1967-1968,1967-12-01,1968-03-23,114,0,72,325,397,20,95,115,512,7,55,MO - Conception
18,1968-1969,1968-11-09,1969-03-30,142,1,84,406,490,19,63,82,572,10,69,MO - Conception
19,1969-1970,1969-11-15,1970-04-03,140,0,90,404,494,33,59,92,586,14,94,MO - Conception
21,1971-1972,1971-11-29,1972-04-04,128,1,60,323,383,24,32,56,439,10,67,MO - Conception
22,1972-1973,1972-11-14,1973-04-10,148,2,104,321,425,33,118,151,576,13,94,MO - Conception
23,1973-1974,1973-12-01,1974-03-24,114,1,97,312,409,31,99,130,539,11,117,MO - Conception
24,1974-1975,1974-11-29,1975-04-03,126,0,41,264,305,54,96,150,455,16,97,MO - Conception
25,1975-1976,1975-11-26,1976-03-16,112,1,46,277,323,38,59,97,420,11,77,MO - Conception
26,1976-1977,1976-11-13,1977-04-04,143,5,125,468,593,30,154,184,777,13,108,MO - Conception
27,1977-1978,1977-11-22,1978-03-26,125,2,172,508,680,64,259,323,1003,19,187,MO - Conception
28,1978-1979,1978-11-21,1979-04-04,135,1,167,522,689,66,316,382,1071,19,213,MO - Conception
29,1979-1980,1979-11-29,1980-04-12,136,1,69,368,437,42,93,135,572,14,97,MO - Conception
30,1980-1981,1980-12-01,1981-02-28,90,1,55,281,336,14,32,46,382,4,46,MO - Conception
38,1988-1989,1988-12-01,1989-03-06,96,7,66,285,351,17,54,71,422,7,77,MO - Conception
40,1990-1991,1990-11-05,1991-03-03,119,8,87,301,388,24,83,107,495,7,58,MO - Conception
41,1991-1992,1991-11-02,1992-04-22,173,16,40,245,285,20,32,52,337,5,34,MO - Conception
43,1993-1994,1993-10-31,1994-03-02,123,16,89,317,406,19,36,55,461,9,65,MO - Conception
44,1994-1995,1994-12-01,1995-03-10,100,15,45,263,308,17,48,65,373,4,38,MO - Conception
45,1995-1996,1995-11-05,1996-03-26,143,19,90,358,448,42,121,163,611,13,103,MO - Conception
46,1996-1997,1996-10-23,1997-04-14,174,15,104,347,451,50,88,138,589,12,88,MO - Conception
47,1997-1998,1997-11-03,1998-03-15,133,9,50,230,280,45,92,137,417,11,78,MO - Conception
48,1998-1999,1998-11-07,1999-03-22,136,17,64,243,307,38,67,105,412,10,88,MO - Conception
51,2001-2002,2001-11-28,2002-03-26,119,4,39,243,282,23,46,69,351,5,39,MO - Conception
55,2005-2006,2005-11-17,2006-03-22,126,1,54,301,355,20,27,47,402,6,53,MO - Conception
56,2006-2007,2006-11-30,2007-03-04,95,5,90,302,392,21,78,99,491,5,44,MO - Conception
57,2007-2008,2007-11-22,2008-03-15,115,12,119,420,539,58,212,270,809,18,142,MO - Conception
58,2008-2009,2008-11-22,2009-04-03,133,1,97,413,510,21,50,71,581,8,66,MO - Conception
59,2009-2010,2009-11-17,2010-03-21,125,0,116,380,496,65,297,362,858,17,148,MO - Conception
64,2014-2015,2014-11-12,2015-03-06,115,5,81,359,440,24,45,69,509,8,67,MO - Conception
65,2015-2016,2015-11-28,2016-02-29,94,14,41,183,224,10,26,36,260,4,31,MO - Conception
66,2016-2017,2016-12-01,2017-03-14,104,0,47,224,271,5,10,15,286,2,26,MO - Conception
67,2017-2018,2017-12-01,2018-04-16,137,2,103,338,441,22,46,68,509,8,66,MO - Conception
68,2018-2019,2018-11-09,2019-03-09,121,10,104,353,457,56,162,218,675,18,154,MO - Conception
69,2019-2020,2019-10-31,2020-04-18,171,10,48,279,327,21,52,73,400,14,76,MO - Conception
0,1950-1951,1950-11-10,1951-03-20,131,0,56,267,323,14,20,34,357,9,68,MO - Kansas City
1,1951-1952,1951-10-31,1952-03-21,143,0,41,219,260,32,43,75,335,14,73,MO - Kansas City
2,1952-1953,1952-11-24,1953-03-08,105,0,17,139,156,32,43,75,231,11,51,MO - Kansas City
3,1953-1954,1953-11-07,1954-03-29,143,0,27,177,204,18,23,41,245,7,41,MO - Kansas City
4,1954-1955,1954-12-01,1955-03-27,117,0,24,180,204,32,48,80,284,14,86,MO - Kansas City
5,1955-1956,1955-11-15,1956-03-15,122,0,42,240,282,41,53,94,376,21,103,MO - Kansas City
6,1956-1957,1956-12-01,1957-04-12,133,0,36,172,208,21,38,59,267,13,72,MO - Kansas City
7,1957-1958,1957-12-01,1958-03-17,107,0,40,186,226,43,89,132,358,12,73,MO - Kansas City
8,1958-1959,1958-11-26,1959-04-08,134,0,58,219,277,43,64,107,384,16,104,MO - Kansas City
9,1959-1960,1959-11-05,1960-04-30,178,0,63,261,324,87,216,303,627,28,180,MO - Kansas City
10,1960-1961,1960-11-09,1961-04-09,152,0,27,201,228,22,15,37,265,14,62,MO - Kansas City
11,1961-1962,1961-11-18,1962-04-01,135,0,64,269,333,73,238,311,644,19,142,MO - Kansas City
12,1962-1963,1962-12-01,1963-03-05,95,0,64,264,328,22,34,56,384,13,93,MO - Kansas City
13,1963-1964,1963-12-01,1964-03-26,117,0,45,202,247,36,66,102,349,11,71,MO - Kansas City
14,1964-1965,1964-11-18,1965-03-26,129,0,50,272,322,43,62,105,427,22,111,MO - Kansas City
15,1965-1966,1965-12-01,1966-03-27,117,0,28,189,217,16,11,27,244,10,41,MO - Kansas City
16,1966-1967,1966-12-01,1967-03-19,109,0,23,201,224,22,74,96,320,9,40,MO - Kansas City
17,1967-1968,1967-11-03,1968-02-29,119,0,47,208,255,24,56,80,335,17,83,MO - Kansas City
18,1968-1969,1968-11-10,1969-03-11,122,0,41,228,269,24,52,76,345,12,57,MO - Kansas City
19,1969-1970,1969-11-14,1970-04-02,140,0,46,220,266,26,20,46,312,16,68,MO - Kansas City
20,1970-1971,1970-11-23,1971-03-26,124,0,45,203,248,27,31,58,306,12,47,MO - Kansas City
21,1971-1972,1971-11-23,1972-03-31,130,0,37,200,237,20,16,36,273,17,75,MO - Kansas City
22,1972-1973,1972-11-16,1973-04-09,145,0,78,236,314,34,81,115,429,17,98,MO - Kansas City
23,1973-1974,1973-12-01,1974-04-04,125,3,74,231,305,24,74,98,403,15,108,MO - Kansas City
24,1974-1975,1974-11-04,1975-04-04,152,0,48,257,305,35,55,90,395,23,98,MO - Kansas City
25,1975-1976,1975-11-21,1976-03-16,117,0,44,218,262,33,43,76,338,16,89,MO - Kansas City
26,1976-1977,1976-11-12,1977-04-05,145,0,88,360,448,31,154,185,633,18,114,MO - Kansas City
27,1977-1978,1977-11-26,1978-03-26,121,0,125,394,519,47,168,215,734,22,146,MO - Kansas City
28,1978-1979,1978-11-19,1979-04-04,137,0,140,390,530,50,262,312,842,25,203,MO - Kansas City
29,1979-1980,1979-11-28,1980-03-24,118,0,60,275,335,35,99,134,469,16,107,MO - Kansas City
30,1980-1981,1980-12-01,1981-03-17,107,0,42,233,275,17,41,58,333,7,46,MO - Kansas City
31,1981-1982,1981-11-19,1982-04-08,141,0,98,354,452,46,87,133,585,21,155,MO - Kansas City
32,1982-1983,1982-11-04,1983-04-09,157,0,27,201,228,36,46,82,310,19,79,MO - Kansas City
33,1983-1984,1983-11-23,1984-03-20,119,0,118,329,447,40,100,140,587,22,182,MO - Kansas City
34,1984-1985,1984-11-27,1985-03-31,125,0,66,320,386,40,179,219,605,16,115,MO - Kansas City
35,1985-1986,1985-11-20,1986-02-28,101,0,62,268,330,22,49,71,401,15,100,MO - Kansas City
36,1986-1987,1986-11-10,1987-02-28,111,0,24,175,199,28,49,77,276,14,65,MO - Kansas City
37,1987-1988,1987-11-28,1988-03-17,111,0,51,269,320,41,54,95,415,14,93,MO - Kansas City
38,1988-1989,1988-11-20,1989-03-05,106,0,40,215,255,16,10,26,281,13,77,MO - Kansas City
39,1989-1990,1989-11-16,1990-03-26,131,0,59,275,334,30,54,84,418,12,100,MO - Kansas City
40,1990-1991,1990-11-05,1991-03-13,129,0,54,259,313,30,56,86,399,16,124,MO - Kansas City
41,1991-1992,1991-11-01,1992-04-21,173,0,16,180,196,16,16,32,228,10,34,MO - Kansas City
42,1992-1993,1992-11-03,1993-04-03,152,0,51,266,317,52,122,174,491,19,106,MO - Kansas City
43,1993-1994,1993-11-25,1994-04-06,133,0,51,265,316,30,29,59,375,17,92,MO - Kansas City
44,1994-1995,1994-12-01,1995-03-09,99,0,30,200,230,16,26,42,272,13,62,MO - Kansas City
45,1995-1996,1995-11-02,1996-04-14,165,10,81,336,417,34,59,93,510,20,107,MO - Kansas City
46,1996-1997,1996-10-22,1997-04-11,172,0,73,297,370,44,34,78,448,16,97,MO - Kansas City
47,1997-1998,1997-10-26,1998-03-13,139,0,23,158,181,31,59,90,271,15,67,MO - Kansas City
48,1998-1999,1998-12-01,1999-03-23,113,3,48,184,232,21,30,51,283,13,82,MO - Kansas City
49,1999-2000,1999-12-01,2000-03-19,110,0,14,160,174,18,24,42,216,10,40,MO - Kansas City
50,2000-2001,2000-11-08,2001-03-16,129,0,75,340,415,34,114,148,563,15,104,MO - Kansas City
51,2001-2002,2001-11-28,2002-03-04,97,0,21,175,196,13,17,30,226,8,38,MO - Kansas City
52,2002-2003,2002-11-25,2003-03-09,105,0,47,244,291,16,22,38,329,10,57,MO - Kansas City
53,2003-2004,2003-12-01,2004-02-29,91,0,48,196,244,30,52,82,326,12,76,MO - Kansas City
54,2004-2005,2004-11-23,2005-02-28,98,0,36,176,212,22,19,41,253,9,38,MO - Kansas City
55,2005-2006,2005-12-01,2006-03-21,111,0,29,145,174,21,24,45,219,9,55,MO - Kansas City
56,2006-2007,2006-11-29,2007-03-03,95,0,49,209,258,17,33,50,308,12,70,MO - Kansas City
57,2007-2008,2007-11-21,2008-03-07,108,0,52,281,333,39,60,99,432,19,108,MO - Kansas City
58,2008-2009,2008-11-29,2009-03-29,121,0,49,280,329,23,29,52,381,13,75,MO - Kansas City
59,2009-2010,2009-11-17,2010-03-21,125,0,68,255,323,65,153,218,541,25,158,MO - Kansas City
60,2010-2011,2010-12-01,2011-03-27,117,0,64,289,353,57,133,190,543,17,141,MO - Kansas City
61,2011-2012,2011-12-01,2012-03-08,99,0,9,148,157,9,3,12,169,7,17,MO - Kansas City
62,2012-2013,2012-12-01,2013-05-02,153,0,28,210,238,48,95,143,381,15,80,MO - Kansas City
63,2013-2014,2013-11-22,2014-04-14,144,0,87,379,466,39,125,164,630,19,139,MO - Kansas City
64,2014-2015,2014-11-11,2015-03-05,115,0,58,278,336,26,32,58,394,18,113,MO - Kansas City
65,2015-2016,2015-12-01,2016-03-27,118,0,21,158,179,12,19,31,210,9,42,MO - Kansas City
66,2016-2017,2016-12-01,2017-03-11,101,0,31,171,202,8,11,19,221,5,35,MO - Kansas City
67,2017-2018,2017-12-01,2018-04-15,136,0,59,270,329,14,12,26,355,9,49,MO - Kansas City
68,2018-2019,2018-10-14,2019-03-06,144,0,54,290,344,43,94,137,481,22,125,MO - Kansas City
69,2019-2020,2019-10-28,2020-02-29,125,0,19,177,196,26,29,55,251,15,68,MO - Kansas City
1,1951-1952,1951-11-03,1952-03-05,124,7,29,210,239,33,23,56,295,9,54,MO - Rolla
2,1952-1953,1952-11-28,1953-04-18,142,8,13,128,141,12,8,20,161,6,24,MO - Rolla
3,1953-1954,1953-12-01,1954-03-05,95,3,22,149,171,10,10,20,191,5,23,MO - Rolla
4,1954-1955,1954-12-01,1955-03-27,117,1,15,162,177,19,21,40,217,7,39,MO - Rolla
5,1955-1956,1955-11-29,1956-03-16,109,3,28,205,233,19,33,52,285,9,45,MO - Rolla
6,1956-1957,1956-12-01,1957-04-12,133,5,23,162,185,6,8,14,199,4,16,MO - Rolla
7,1957-1958,1957-12-01,1958-03-18,108,11,41,207,248,22,16,38,286,8,44,MO - Rolla
8,1958-1959,1958-11-27,1959-02-28,94,4,54,220,274,15,20,35,309,6,50,MO - Rolla
12,1962-1963,1962-12-01,1963-03-01,91,1,62,268,330,10,15,25,355,4,41,MO - Rolla
13,1963-1964,1963-12-01,1964-03-10,101,0,48,213,261,27,29,56,317,6,43,MO - Rolla
16,1966-1967,1966-11-03,1967-03-08,126,10,37,202,239,11,8,19,258,7,30,MO - Rolla
21,1971-1972,1971-11-24,1972-02-29,98,17,28,143,171,15,11,26,197,7,36,MO - Rolla
23,1973-1974,1973-12-01,1974-03-25,115,4,44,202,246,36,90,126,372,8,64,MO - Rolla
24,1974-1975,1974-12-01,1975-04-03,124,12,21,174,195,18,32,50,245,4,25,MO - Rolla
29,1979-1980,1979-11-11,1980-04-15,157,1,46,246,292,41,86,127,419,17,95,MO - Rolla
30,1980-1981,1980-11-17,1981-02-28,104,0,35,224,259,26,41,67,326,11,64,MO - Rolla
31,1981-1982,1981-11-21,1982-04-08,139,7,61,299,360,34,108,142,502,14,93,MO - Rolla
32,1982-1983,1982-11-25,1983-04-18,145,2,20,149,169,15,9,24,193,12,46,MO - Rolla
33,1983-1984,1983-11-29,1984-03-13,106,3,82,283,365,41,134,175,540,20,153,MO - Rolla
34,1984-1985,1984-11-19,1985-02-28,102,6,53,243,296,36,133,169,465,17,107,MO - Rolla
35,1985-1986,1985-11-29,1986-03-01,93,3,42,218,260,24,43,67,327,11,70,MO - Rolla
36,1986-1987,1986-11-14,1987-03-11,118,3,23,142,165,24,58,82,247,13,54,MO - Rolla
37,1987-1988,1987-12-01,1988-03-18,109,1,43,223,266,36,59,95,361,16,94,MO - Rolla
38,1988-1989,1988-11-20,1989-03-21,122,1,31,215,246,58,89,147,393,16,131,MO - Rolla
39,1989-1990,1989-11-16,1990-03-25,130,2,44,219,263,27,68,95,358,10,64,MO - Rolla
40,1990-1991,1990-12-01,1991-03-15,105,0,34,178,212,31,73,104,316,19,116,MO - Rolla
41,1991-1992,1991-11-03,1992-03-20,139,10,15,155,170,13,12,25,195,8,31,MO - Rolla
42,1992-1993,1992-11-07,1993-04-17,162,4,27,222,249,43,44,87,336,23,91,MO - Rolla
43,1993-1994,1993-10-30,1994-04-07,160,4,42,226,268,33,38,71,339,20,99,MO - Rolla
44,1994-1995,1994-12-01,1995-03-09,99,0,26,170,196,23,33,56,252,13,69,MO - Rolla
45,1995-1996,1995-11-05,1996-03-25,142,0,57,275,332,56,97,153,485,28,178,MO - Rolla
46,1996-1997,1996-11-26,1997-02-28,95,0,49,202,251,38,75,113,364,19,123,MO - Rolla
47,1997-1998,1997-11-03,1998-03-21,139,0,19,145,164,49,44,93,257,28,112,MO - Rolla
48,1998-1999,1998-12-01,1999-03-14,104,4,31,155,186,28,54,82,268,16,88,MO - Rolla
49,1999-2000,1999-12-01,2000-03-13,104,0,14,132,146,24,39,63,209,11,52,MO - Rolla
50,2000-2001,2000-12-01,2001-03-17,107,3,50,257,307,29,116,145,452,19,116,MO - Rolla
51,2001-2002,2001-11-28,2002-03-26,119,3,23,156,179,24,21,45,224,13,66,MO - Rolla
52,2002-2003,2002-12-01,2003-04-09,130,3,47,229,276,51,80,131,407,27,150,MO - Rolla
53,2003-2004,2003-11-29,2004-05-03,157,0,30,188,218,20,25,45,263,16,78,MO - Rolla
54,2004-2005,2004-11-25,2005-03-09,105,0,24,144,168,28,15,43,211,15,71,MO - Rolla
55,2005-2006,2005-11-30,2006-02-28,91,2,18,146,164,13,3,16,180,11,57,MO - Rolla
56,2006-2007,2006-12-01,2007-04-04,125,2,38,178,216,30,39,69,285,17,94,MO - Rolla
57,2007-2008,2007-11-22,2008-04-13,144,10,24,211,235,27,16,43,278,20,86,MO - Rolla
58,2008-2009,2008-11-30,2009-04-07,129,4,33,251,284,36,25,61,345,21,104,MO - Rolla
59,2009-2010,2009-12-01,2010-02-28,90,4,50,227,277,38,81,119,396,17,115,MO - Rolla
63,2013-2014,2013-11-25,2014-03-25,121,0,61,320,381,40,70,110,491,20,138,MO - Rolla
64,2014-2015,2014-11-14,2015-03-29,136,0,41,245,286,34,35,69,355,20,107,MO - Rolla
65,2015-2016,2015-11-22,2016-03-21,121,0,19,127,146,16,15,31,177,11,53,MO - Rolla
66,2016-2017,2016-12-01,2017-03-15,105,0,22,137,159,8,6,14,173,7,35,MO - Rolla
67,2017-2018,2017-12-01,2018-04-02,123,0,45,215,260,18,8,26,286,15,63,MO - Rolla
68,2018-2019,2018-11-09,2019-04-15,158,0,31,208,239,47,45,92,331,26,119,MO - Rolla
69,2019-2020,2019-10-31,2020-03-23,145,0,16,143,159,28,30,58,217,17,67,MO - Rolla
0,1950-1951,1950-11-10,1951-03-20,131,2,69,336,405,29,61,90,495,15,106,MO - Shelbina
2,1952-1953,1952-11-27,1953-04-18,143,11,14,198,212,17,30,47,259,7,36,MO - Shelbina
3,1953-1954,1953-12-01,1954-03-03,93,0,20,194,214,6,16,22,236,2,15,MO - Shelbina
4,1954-1955,1954-12-01,1955-03-27,117,2,28,230,258,30,46,76,334,11,89,MO - Shelbina
5,1955-1956,1955-11-28,1956-03-16,110,0,40,298,338,24,42,66,404,10,61,MO - Shelbina
6,1956-1957,1956-11-23,1957-04-12,141,1,32,262,294,18,40,58,352,9,48,MO - Shelbina
7,1957-1958,1957-12-01,1958-03-20,110,0,44,255,299,26,87,113,412,11,55,MO - Shelbina
8,1958-1959,1958-11-27,1959-03-06,100,9,61,316,377,14,134,148,525,3,25,MO - Shelbina
9,1959-1960,1959-11-06,1960-03-27,143,0,58,351,409,52,215,267,676,14,96,MO - Shelbina
10,1960-1961,1960-12-01,1961-04-09,130,18,39,271,310,33,106,139,449,9,74,MO - Shelbina
11,1961-1962,1961-11-19,1962-03-21,123,3,69,324,393,50,183,233,626,16,114,MO - Shelbina
12,1962-1963,1962-12-01,1963-03-02,92,1,85,350,435,26,101,127,562,10,102,MO - Shelbina
13,1963-1964,1963-12-01,1964-03-27,118,0,55,329,384,38,86,124,508,12,91,MO - Shelbina
14,1964-1965,1964-11-19,1965-03-28,130,0,55,360,415,66,151,217,632,21,158,MO - Shelbina
15,1965-1966,1965-12-01,1966-03-06,96,0,35,233,268,7,4,11,279,5,24,MO - Shelbina
16,1966-1967,1966-12-01,1967-03-08,98,0,26,255,281,19,69,88,369,5,37,MO - Shelbina
17,1967-1968,1967-12-01,1968-02-29,91,0,42,252,294,17,47,64,358,7,59,MO - Shelbina
19,1969-1970,1969-11-14,1970-04-02,140,3,66,356,422,27,105,132,554,10,51,MO - Shelbina
21,1971-1972,1971-12-01,1972-03-29,120,4,41,247,288,17,43,60,348,7,43,MO - Shelbina
22,1972-1973,1972-11-19,1973-04-09,142,2,53,246,299,16,26,42,341,5,29,MO - Shelbina
23,1973-1974,1973-12-01,1974-03-24,114,1,57,244,301,45,107,152,453,12,111,MO - Shelbina
24,1974-1975,1974-11-14,1975-04-03,141,0,23,250,273,47,83,130,403,15,89,MO - Shelbina
25,1975-1976,1975-11-26,1976-03-23,119,1,29,231,260,47,50,97,357,15,94,MO - Shelbina
26,1976-1977,1976-11-28,1977-03-22,115,5,98,397,495,39,207,246,741,14,126,MO - Shelbina
28,1978-1979,1978-11-21,1979-03-25,125,0,101,428,529,65,371,436,965,22,224,MO - Shelbina
29,1979-1980,1979-11-29,1980-04-14,138,3,41,293,334,36,100,136,470,10,68,MO - Shelbina
30,1980-1981,1980-11-27,1981-02-28,94,16,35,261,296,13,8,21,317,6,31,MO - Shelbina
38,1988-1989,1988-11-20,1989-02-28,101,1,32,176,208,15,47,62,270,8,43,MO - Shelbina
39,1989-1990,1989-12-01,1990-03-26,116,0,50,208,258,29,79,108,366,9,68,MO - Shelbina
40,1990-1991,1990-11-05,1991-02-28,116,0,43,215,258,13,21,34,292,6,44,MO - Shelbina
41,1991-1992,1991-11-02,1992-03-19,139,2,18,174,192,17,23,40,232,7,37,MO - Shelbina
43,1993-1994,1993-11-26,1994-03-03,98,13,58,239,297,22,71,93,390,7,45,MO - Shelbina
44,1994-1995,1994-12-01,1995-03-08,98,7,37,205,242,19,63,82,324,6,44,MO - Shelbina
45,1995-1996,1995-11-05,1996-03-08,125,12,54,297,351,22,65,87,438,12,77,MO - Shelbina
51,2001-2002,2001-12-01,2002-03-26,116,15,24,229,253,8,4,12,265,4,24,MO - Shelbina
53,2003-2004,2003-11-29,2004-03-16,109,6,60,258,318,23,90,113,431,12,83,MO - Shelbina
54,2004-2005,2004-11-25,2005-03-01,97,14,44,203,247,16,13,29,276,7,47,MO - Shelbina
55,2005-2006,2005-11-17,2006-03-20,124,5,43,252,295,18,21,39,334,10,72,MO - Shelbina
56,2006-2007,2006-12-01,2007-03-18,108,7,66,282,348,38,161,199,547,11,92,MO - Shelbina
57,2007-2008,2007-11-23,2008-03-04,103,6,67,308,375,34,78,112,487,15,98,MO - Shelbina
58,2008-2009,2008-11-22,2009-03-12,111,4,64,327,391,16,31,47,438,10,69,MO - Shelbina
59,2009-2010,2009-12-01,2010-03-21,111,3,81,320,401,34,149,183,584,14,89,MO - Shelbina
61,2011-2012,2011-12-01,2012-02-29,91,6,17,169,186,10,10,20,206,4,22,MO - Shelbina
62,2012-2013,2012-12-01,2013-03-27,117,1,44,277,321,54,122,176,497,12,84,MO - Shelbina
63,2013-2014,2013-11-24,2014-03-17,114,3,124,473,597,48,128,176,773,18,148,MO - Shelbina
64,2014-2015,2014-11-12,2015-03-06,115,4,73,332,405,30,56,86,491,12,83,MO - Shelbina
65,2015-2016,2015-12-01,2016-02-29,91,4,37,179,216,11,16,27,243,5,36,MO - Shelbina
66,2016-2017,2016-12-01,2017-03-11,101,1,37,208,245,8,10,18,263,5,33,MO - Shelbina
67,2017-2018,2017-12-01,2018-04-09,130,5,80,331,411,14,19,33,444,9,63,MO - Shelbina
68,2018-2019,2018-11-09,2019-03-08,120,7,77,322,399,38,75,113,512,18,99,MO - Shelbina
69,2019-2020,2019-10-31,2020-02-29,122,14,41,226,267,28,48,76,343,12,61,MO - Shelbina
0,1950-1951,1950-11-10,1951-04-12,154,0,43,250,293,23,30,53,346,15,100,MO - Springfield
1,1951-1952,1951-10-31,1952-03-15,137,0,26,186,212,37,36,73,285,18,92,MO - Springfield
2,1952-1953,1952-11-09,1953-04-18,161,0,14,141,155,13,4,17,172,11,37,MO - Springfield
3,1953-1954,1953-12-01,1954-03-04,94,0,24,139,163,13,8,21,184,8,43,MO - Springfield
4,1954-1955,1954-12-01,1955-03-26,116,0,16,166,182,19,18,37,219,10,44,MO - Springfield
5,1955-1956,1955-11-28,1956-04-23,148,0,30,198,228,29,32,61,289,17,72,MO - Springfield
6,1956-1957,1956-11-26,1957-04-13,139,0,23,156,179,14,8,22,201,7,30,MO - Springfield
7,1957-1958,1957-11-29,1958-03-24,116,0,29,186,215,36,24,60,275,15,66,MO - Springfield
8,1958-1959,1958-11-27,1959-03-11,105,0,34,212,246,22,29,51,297,10,58,MO - Springfield
9,1959-1960,1959-11-06,1960-03-21,137,0,42,245,287,49,115,164,451,25,128,MO - Springfield
10,1960-1961,1960-12-01,1961-02-28,90,0,20,187,207,24,23,47,254,10,60,MO - Springfield
11,1961-1962,1961-12-01,1962-03-05,95,0,41,205,246,23,37,60,306,14,81,MO - Springfield
12,1962-1963,1962-11-17,1963-03-01,105,0,40,249,289,15,10,25,314,10,53,MO - Springfield
13,1963-1964,1963-12-01,1964-03-10,101,0,33,226,259,17,12,29,288,11,55,MO - Springfield
14,1964-1965,1964-11-21,1965-03-26,126,1,25,235,260,23,26,49,309,12,51,MO - Springfield
15,1965-1966,1965-12-01,1966-03-05,95,0,21,182,203,16,19,35,238,12,52,MO - Springfield
16,1966-1967,1966-12-01,1967-03-08,98,0,18,224,242,18,35,53,295,10,53,MO - Springfield
17,1967-1968,1967-11-03,1968-03-21,140,0,25,212,237,38,36,74,311,17,79,MO - Springfield
18,1968-1969,1968-11-10,1969-03-10,121,0,11,203,214,22,21,43,257,10,39,MO - Springfield
19,1969-1970,1969-11-14,1970-03-28,135,0,41,262,303,63,126,189,492,17,115,MO - Springfield
20,1970-1971,1970-11-23,1971-04-06,135,0,25,220,245,30,21,51,296,11,49,MO - Springfield
21,1971-1972,1971-11-23,1972-02-29,99,0,15,143,158,9,3,12,170,6,28,MO - Springfield
22,1972-1973,1972-11-16,1973-04-09,145,0,36,191,227,34,60,94,321,17,86,MO - Springfield
23,1973-1974,1973-12-01,1974-03-25,115,0,29,174,203,35,50,85,288,17,90,MO - Springfield
24,1974-1975,1974-11-29,1975-03-16,108,0,13,165,178,45,69,114,292,10,69,MO - Springfield
25,1975-1976,1975-11-25,1976-03-16,113,0,14,157,171,18,12,30,201,8,40,MO - Springfield
26,1976-1977,1976-11-11,1977-04-05,146,0,46,324,370,34,123,157,527,17,105,MO - Springfield
27,1977-1978,1977-11-26,1978-03-25,120,0,83,324,407,49,194,243,650,28,163,MO - Springfield
28,1978-1979,1978-12-01,1979-02-28,90,0,69,304,373,43,217,260,633,19,157,MO - Springfield
29,1979-1980,1979-11-29,1980-04-14,138,0,21,178,199,38,62,100,299,15,64,MO - Springfield
30,1980-1981,1980-11-17,1981-02-28,104,0,17,183,200,24,22,46,246,9,41,MO - Springfield
31,1981-1982,1981-12-01,1982-03-06,96,0,39,222,261,39,86,125,386,15,83,MO - Springfield
32,1982-1983,1982-12-01,1983-03-27,117,0,7,113,120,10,11,21,141,6,18,MO - Springfield
33,1983-1984,1983-11-28,1984-03-31,125,0,67,250,317,47,139,186,503,18,136,MO - Springfield
34,1984-1985,1984-11-18,1985-02-28,103,0,36,221,257,38,128,166,423,16,103,MO - Springfield
35,1985-1986,1985-11-28,1986-02-28,93,0,28,200,228,24,34,58,286,14,83,MO - Springfield
36,1986-1987,1986-11-12,1987-02-28,109,0,14,142,156,19,37,56,212,10,40,MO - Springfield
37,1987-1988,1987-11-29,1988-03-18,111,0,33,218,251,39,56,95,346,17,91,MO - Springfield
38,1988-1989,1988-11-20,1989-03-11,112,0,26,202,228,42,67,109,337,13,98,MO - Springfield
39,1989-1990,1989-12-01,1990-03-24,114,0,30,185,215,23,24,47,262,12,62,MO - Springfield
40,1990-1991,1990-12-01,1991-02-28,90,0,25,143,168,23,60,83,251,12,74,MO - Springfield
41,1991-1992,1991-11-02,1992-03-19,139,0,7,130,137,7,13,20,157,2,10,MO - Springfield
42,1992-1993,1992-11-07,1993-04-04,149,0,22,174,196,35,50,85,281,15,60,MO - Springfield
43,1993-1994,1993-10-29,1994-04-06,160,0,25,213,238,29,21,50,288,20,101,MO - Springfield
44,1994-1995,1994-12-01,1995-03-03,93,0,14,132,146,28,45,73,219,9,49,MO - Springfield
45,1995-1996,1995-11-10,1996-03-08,120,0,48,244,292,35,70,105,397,13,78,MO - Springfield
46,1996-1997,1996-11-24,1997-02-28,97,0,41,174,215,23,51,74,289,12,64,MO - Springfield
47,1997-1998,1997-11-12,1998-03-21,130,0,9,128,137,26,15,41,178,16,49,MO - Springfield
48,1998-1999,1998-12-01,1999-03-16,106,0,23,146,169,31,35,66,235,7,47,MO - Springfield
49,1999-2000,1999-12-01,2000-03-11,102,0,8,126,134,13,15,28,162,6,27,MO - Springfield
50,2000-2001,2000-12-01,2001-02-28,90,0,42,222,264,34,149,183,447,13,88,MO - Springfield
52,2002-2003,2002-12-01,2003-03-28,118,0,31,216,247,53,85,138,385,14,88,MO - Springfield
53,2003-2004,2003-12-01,2004-02-29,91,0,19,150,169,23,24,47,216,8,52,MO - Springfield
54,2004-2005,2004-12-01,2005-03-09,99,0,11,132,143,11,4,15,158,8,26,MO - Springfield
55,2005-2006,2005-12-01,2006-02-28,90,0,12,133,145,4,2,6,151,4,22,MO - Springfield
56,2006-2007,2006-11-30,2007-02-28,91,0,23,163,186,26,53,79,265,8,57,MO - Springfield
57,2007-2008,2007-11-24,2008-03-05,103,0,16,173,189,19,16,35,224,9,37,MO - Springfield
58,2008-2009,2008-11-30,2009-03-28,119,0,25,197,222,15,15,30,252,12,54,MO - Springfield
59,2009-2010,2009-12-01,2010-03-22,112,0,43,227,270,33,45,78,348,19,116,MO - Springfield
60,2010-2011,2010-11-25,2011-03-28,124,0,37,230,267,33,76,109,376,14,88,MO - Springfield
61,2011-2012,2011-12-01,2012-02-29,91,0,5,111,116,5,1,6,122,4,14,MO - Springfield
62,2012-2013,2012-12-01,2013-05-04,155,0,10,162,172,22,12,34,206,12,40,MO - Springfield
63,2013-2014,2013-11-24,2014-03-16,113,0,44,274,318,52,88,140,458,20,142,MO - Springfield
64,2014-2015,2014-11-12,2015-03-05,114,0,23,205,228,24,35,59,287,10,56,MO - Springfield
65,2015-2016,2015-12-01,2016-02-29,91,0,8,104,112,4,4,8,120,2,9,MO - Springfield
66,2016-2017,2016-12-01,2017-03-14,104,0,14,118,132,4,3,7,139,3,16,MO - Springfield
67,2017-2018,2017-12-01,2018-04-07,128,0,30,205,235,9,13,22,257,6,29,MO - Springfield
68,2018-2019,2018-11-12,2019-03-05,114,0,17,158,175,13,5,18,193,11,55,MO - Springfield
69,2019-2020,2019-11-11,2020-02-29,111,0,8,124,132,15,2,17,149,11,33,MO - Springfield
0,1950-1951,1950-11-23,1951-03-20,118,0,54,231,285,38,40,78,363,19,114,MO - St Louis
1,1951-1952,1951-11-04,1952-03-15,133,0,26,172,198,30,22,52,250,15,57,MO - St Louis
2,1952-1953,1952-11-27,1953-03-07,101,0,16,110,126,19,11,30,156,10,44,MO - St Louis
3,1953-1954,1953-12-01,1954-03-04,94,0,19,130,149,4,1,5,154,3,12,MO - St Louis
4,1954-1955,1954-12-01,1955-03-27,117,0,21,161,182,10,5,15,197,7,32,MO - St Louis
5,1955-1956,1955-11-28,1956-03-16,110,0,27,185,212,30,48,78,290,12,56,MO - St Louis
6,1956-1957,1956-11-22,1957-04-12,142,0,31,164,195,19,7,26,221,15,43,MO - St Louis
7,1957-1958,1957-12-01,1958-03-17,107,0,43,184,227,37,57,94,321,10,53,MO - St Louis
8,1958-1959,1958-11-26,1959-03-11,106,0,55,225,280,17,19,36,316,9,45,MO - St Louis
9,1959-1960,1959-11-06,1960-03-23,139,0,51,220,271,55,122,177,448,22,116,MO - St Louis
10,1960-1961,1960-12-01,1961-02-28,90,0,34,212,246,34,91,125,371,12,76,MO - St Louis
11,1961-1962,1961-11-18,1962-03-05,108,0,45,217,262,35,72,107,369,16,85,MO - St Louis
12,1962-1963,1962-12-01,1963-03-09,99,0,71,292,363,14,29,43,406,11,53,MO - St Louis
13,1963-1964,1963-12-01,1964-03-20,111,0,50,229,279,48,93,141,420,18,94,MO - St Louis
14,1964-1965,1964-11-19,1965-03-26,128,0,51,278,329,37,45,82,411,16,99,MO - St Louis
15,1965-1966,1965-11-29,1966-03-06,98,0,42,198,240,16,33,49,289,7,42,MO - St Louis
16,1966-1967,1966-12-01,1967-03-19,109,0,28,194,222,11,3,14,236,10,39,MO - St Louis
17,1967-1968,1967-11-30,1968-03-21,113,0,46,238,284,34,42,76,360,17,93,MO - St Louis
18,1968-1969,1968-12-01,1969-03-26,116,0,30,199,229,19,13,32,261,11,44,MO - St Louis
19,1969-1970,1969-11-14,1970-04-04,142,0,54,259,313,35,96,131,444,22,92,MO - St Louis
20,1970-1971,1970-11-15,1971-04-06,143,0,36,252,288,17,6,23,311,11,47,MO - St Louis
21,1971-1972,1971-11-23,1972-03-29,128,0,29,197,226,15,9,24,250,11,45,MO - St Louis
22,1972-1973,1972-11-19,1973-04-09,142,0,39,193,232,23,19,42,274,14,59,MO - St Louis
23,1973-1974,1973-12-01,1974-03-25,115,0,52,219,271,66,132,198,469,19,134,MO - St Louis
24,1974-1975,1974-11-30,1975-03-13,104,0,26,170,196,39,32,71,267,14,80,MO - St Louis
25,1975-1976,1975-11-26,1976-03-17,113,0,36,186,222,35,48,83,305,12,65,MO - St Louis
26,1976-1977,1976-11-23,1977-04-05,134,0,94,340,434,57,212,269,703,27,195,MO - St Louis
27,1977-1978,1977-11-26,1978-03-26,121,0,110,358,468,95,419,514,982,34,232,MO - St Louis
28,1978-1979,1978-12-01,1979-03-27,117,1,98,316,414,39,199,238,652,20,145,MO - St Louis
29,1979-1980,1979-11-28,1980-04-15,140,0,42,199,241,39,91,130,371,17,86,MO - St Louis
30,1980-1981,1980-11-17,1981-03-05,109,0,33,199,232,28,44,72,304,11,59,MO - St Louis
31,1981-1982,1981-12-01,1982-04-08,129,0,69,284,353,53,185,238,591,19,135,MO - St Louis
32,1982-1983,1982-11-24,1983-04-18,146,0,16,121,137,13,2,15,152,9,26,MO - St Louis
33,1983-1984,1983-12-01,1984-03-14,105,0,82,250,332,36,103,139,471,21,130,MO - St Louis
34,1984-1985,1984-11-18,1985-02-28,103,0,53,210,263,17,34,51,314,13,68,MO - St Louis
35,1985-1986,1985-11-24,1986-03-20,117,0,38,215,253,20,28,48,301,8,62,MO - St Louis
36,1986-1987,1986-11-13,1987-02-28,108,0,21,134,155,34,74,108,263,10,62,MO - St Louis
37,1987-1988,1987-12-01,1988-03-18,109,0,43,187,230,31,48,79,309,16,81,MO - St Louis
38,1988-1989,1988-11-20,1989-03-10,111,0,25,159,184,34,67,101,285,12,81,MO - St Louis
39,1989-1990,1989-12-01,1990-03-26,116,0,44,164,208,39,64,103,311,14,103,MO - St Louis
40,1990-1991,1990-12-01,1991-03-14,104,0,38,146,184,29,59,88,272,18,93,MO - St Louis
41,1991-1992,1991-11-02,1992-03-19,139,0,12,117,129,20,23,43,172,10,43,MO - St Louis
42,1992-1993,1992-12-01,1993-04-01,122,0,30,161,191,46,77,123,314,17,82,MO - St Louis
43,1993-1994,1993-11-26,1994-04-06,132,0,47,178,225,21,24,45,270,16,70,MO - St Louis
44,1994-1995,1994-12-01,1995-03-08,98,0,25,121,146,13,11,24,170,11,38,MO - St Louis
45,1995-1996,1995-11-05,1996-03-20,137,0,54,226,280,43,104,147,427,20,116,MO - St Louis
46,1996-1997,1996-11-25,1997-04-18,145,0,56,199,255,36,65,101,356,16,86,MO - St Louis
47,1997-1998,1997-11-03,1998-03-20,138,0,18,117,135,31,23,54,189,18,60,MO - St Louis
48,1998-1999,1998-12-01,1999-03-08,98,0,32,134,166,24,84,108,274,12,68,MO - St Louis
49,1999-2000,1999-12-01,2000-03-12,103,0,11,124,135,19,21,40,175,9,40,MO - St Louis
50,2000-2001,2000-12-01,2001-02-28,90,0,56,218,274,34,115,149,423,21,129,MO - St Louis
51,2001-2002,2001-11-28,2002-03-26,119,0,16,115,131,19,25,44,175,9,32,MO - St Louis
52,2002-2003,2002-11-24,2003-03-09,106,0,35,184,219,44,66,110,329,19,94,MO - St Louis
53,2003-2004,2003-12-01,2004-02-29,91,0,25,132,157,15,25,40,197,11,42,MO - St Louis
54,2004-2005,2004-11-24,2005-03-11,108,0,21,128,149,21,24,45,194,15,50,MO - St Louis
55,2005-2006,2005-12-01,2006-03-22,112,0,19,122,141,17,13,30,171,10,38,MO - St Louis
56,2006-2007,2006-11-30,2007-03-03,94,0,31,148,179,21,42,63,242,13,69,MO - St Louis
57,2007-2008,2007-12-01,2008-03-09,100,0,25,172,197,46,52,98,295,16,88,MO - St Louis
58,2008-2009,2008-11-21,2009-04-06,137,0,38,199,237,24,26,50,287,16,73,MO - St Louis
59,2009-2010,2009-12-01,2010-02-28,90,0,40,173,213,30,35,65,278,21,98,MO - St Louis
60,2010-2011,2010-11-25,2011-03-27,123,0,44,189,233,55,105,160,393,22,108,MO - St Louis
61,2011-2012,2011-12-01,2012-02-29,91,0,5,81,86,10,10,20,106,7,22,MO - St Louis
62,2012-2013,2012-12-01,2013-03-28,118,0,11,139,150,45,41,86,236,17,72,MO - St Louis
63,2013-2014,2013-11-24,2014-03-25,122,0,60,276,336,42,85,127,463,19,107,MO - St Louis
64,2014-2015,2014-11-13,2015-03-05,113,0,33,208,241,27,35,62,303,18,90,MO - St Louis
65,2015-2016,2015-12-01,2016-03-20,111,0,19,98,117,17,13,30,147,11,54,MO - St Louis
66,2016-2017,2016-12-01,2017-03-14,104,0,20,107,127,8,3,11,138,7,31,MO - St Louis
67,2017-2018,2017-12-01,2018-04-01,122,0,49,196,245,14,9,23,268,11,53,MO - St Louis
68,2018-2019,2018-11-12,2019-03-07,116,0,30,181,211,36,42,78,289,15,82,MO - St Louis
69,2019-2020,2019-11-11,2020-02-29,111,0,13,115,128,23,27,50,178,14,48,MO - St Louis
0,1950-1951,1950-11-09,1951-04-04,147,12,110,537,647,36,180,216,863,18,166,MO - Unionville
1,1951-1952,1951-11-02,1952-03-25,145,5,72,347,419,32,169,201,620,14,114,MO - Unionville
2,1952-1953,1952-11-27,1953-03-10,104,17,40,237,277,2,104,106,383,1,4,MO - Unionville
4,1954-1955,1954-12-01,1955-03-28,118,1,69,311,380,41,125,166,546,15,111,MO - Unionville
5,1955-1956,1955-11-03,1956-03-16,135,0,73,374,447,45,66,111,558,16,120,MO - Unionville
6,1956-1957,1956-11-22,1957-03-27,126,1,64,306,370,39,82,121,491,13,110,MO - Unionville
7,1957-1958,1957-12-01,1958-03-09,99,0,71,273,344,44,144,188,532,15,105,MO - Unionville
8,1958-1959,1958-11-26,1959-03-16,111,1,93,345,438,70,183,253,691,17,170,MO - Unionville
9,1959-1960,1959-11-06,1960-03-27,143,2,88,391,479,89,327,416,895,19,167,MO - Unionville
10,1960-1961,1960-11-30,1961-04-09,131,1,53,284,337,39,62,101,438,12,90,MO - Unionville
11,1961-1962,1961-11-19,1962-03-21,123,0,124,407,531,99,416,515,1046,22,218,MO - Unionville
12,1962-1963,1962-10-25,1963-03-13,140,2,110,395,505,49,116,165,670,20,186,MO - Unionville
13,1963-1964,1963-12-01,1964-03-26,117,0,77,325,402,40,105,145,547,12,106,MO - Unionville
14,1964-1965,1964-11-21,1965-03-26,126,0,93,407,500,68,145,213,713,19,185,MO - Unionville
15,1965-1966,1965-11-29,1966-03-06,98,1,67,267,334,12,9,21,355,5,39,MO - Unionville
16,1966-1967,1966-11-02,1967-04-24,174,2,48,337,385,26,70,96,481,8,60,MO - Unionville
17,1967-1968,1967-10-27,1968-03-22,148,1,65,320,385,18,46,64,449,8,55,MO - Unionville
18,1968-1969,1968-11-10,1969-03-30,141,1,78,362,440,43,85,128,568,14,93,MO - Unionville
19,1969-1970,1969-11-14,1970-04-03,141,0,88,376,464,45,112,157,621,12,83,MO - Unionville
20,1970-1971,1970-11-23,1971-03-23,121,0,93,340,433,38,164,202,635,11,65,MO - Unionville
21,1971-1972,1971-11-24,1972-03-29,127,0,69,295,364,36,77,113,477,13,110,MO - Unionville
22,1972-1973,1972-11-14,1973-04-13,151,0,94,310,404,76,169,245,649,15,149,MO - Unionville
23,1973-1974,1973-11-09,1974-03-24,136,0,87,292,379,35,91,126,505,13,132,MO - Unionville
24,1974-1975,1974-11-14,1975-04-04,142,0,57,314,371,67,101,168,539,21,145,MO - Unionville
25,1975-1976,1975-11-21,1976-02-29,101,3,50,238,288,38,45,83,371,10,84,MO - Unionville
26,1976-1977,1976-11-12,1977-03-22,131,0,127,443,570,36,154,190,760,12,106,MO - Unionville
27,1977-1978,1977-11-25,1978-03-27,123,2,158,478,636,93,383,476,1112,23,226,MO - Unionville
28,1978-1979,1978-11-20,1979-04-04,136,2,179,522,701,61,449,510,1211,16,174,MO - Unionville
36,1986-1987,1986-10-13,1987-02-28,139,18,19,245,264,20,35,55,319,10,47,MO - Unionville
37,1987-1988,1987-12-01,1988-03-14,105,19,49,362,411,32,81,113,524,7,77,MO - Unionville
39,1989-1990,1989-12-01,1990-02-28,90,5,50,342,392,18,96,114,506,11,121,MO - Unionville
41,1991-1992,1991-11-03,1992-02-29,119,19,34,240,274,14,1,15,289,4,27,MO - Unionville
55,2005-2006,2005-11-17,2006-03-22,126,14,57,247,304,24,33,57,361,12,75,MO - Unionville
56,2006-2007,2006-12-01,2007-04-12,133,5,80,318,398,39,48,87,485,17,119,MO - Unionville
57,2007-2008,2007-11-22,2008-04-13,144,1,100,413,513,78,229,307,820,28,187,MO - Unionville
58,2008-2009,2008-11-22,2009-03-29,128,3,86,391,477,44,70,114,591,20,153,MO - Unionville
59,2009-2010,2009-12-01,2010-03-21,111,6,116,368,484,83,287,370,854,28,227,MO - Unionville
60,2010-2011,2010-11-30,2011-03-25,116,12,89,344,433,55,199,254,687,11,99,MO - Unionville
61,2011-2012,2011-12-01,2012-03-03,94,0,31,201,232,19,18,37,269,9,39,MO - Unionville
62,2012-2013,2012-11-27,2013-05-03,158,0,57,333,390,59,145,204,594,15,102,MO - Unionville
63,2013-2014,2013-11-23,2014-03-12,110,14,149,479,628,50,152,202,830,12,124,MO - Unionville
64,2014-2015,2014-11-12,2015-03-06,115,0,109,396,505,36,75,111,616,11,95,MO - Unionville
65,2015-2016,2015-11-21,2016-03-25,126,0,48,223,271,23,43,66,337,9,62,MO - Unionville
66,2016-2017,2016-12-01,2017-03-15,105,0,54,245,299,17,25,42,341,8,56,MO - Unionville
67,2017-2018,2017-12-01,2018-04-16,137,5,111,384,495,30,70,100,595,11,88,MO - Unionville
0,1950-1951,1950-09-29,1951-05-31,245,0,150,518,668,109,235,344,1012,50,393,MT - Billings
1,1951-1952,1951-10-17,1952-04-21,188,0,135,501,636,79,267,346,982,42,302,MT - Billings
2,1952-1953,1952-10-13,1953-05-12,212,0,38,292,330,58,67,125,455,31,145,MT - Billings
3,1953-1954,1953-12-01,1954-05-04,155,0,93,381,474,97,189,286,760,37,286,MT - Billings
4,1954-1955,1954-10-23,1955-04-10,170,0,69,417,486,130,225,355,841,39,321,MT - Billings
5,1955-1956,1955-10-22,1956-05-04,196,0,160,550,710,124,258,382,1092,46,378,MT - Billings
6,1956-1957,1956-10-31,1957-04-11,163,0,149,478,627,76,141,217,844,38,340,MT - Billings
7,1957-1958,1957-09-18,1958-04-28,223,0,48,289,337,98,91,189,526,42,238,MT - Billings
8,1958-1959,1958-11-04,1959-04-25,173,0,104,418,522,88,201,289,811,38,329,MT - Billings
9,1959-1960,1959-10-07,1960-04-27,204,0,113,429,542,86,142,228,770,41,322,MT - Billings
10,1960-1961,1960-11-07,1961-04-26,171,0,38,265,303,46,38,84,387,24,125,MT - Billings
11,1961-1962,1961-09-29,1962-03-29,182,0,183,508,691,107,255,362,1053,46,385,MT - Billings
12,1962-1963,1962-09-07,1963-04-22,228,0,101,377,478,95,158,253,731,41,374,MT - Billings
13,1963-1964,1963-10-30,1964-05-03,187,0,85,383,468,96,131,227,695,36,249,MT - Billings
14,1964-1965,1964-11-14,1965-05-06,174,0,146,558,704,82,210,292,996,42,370,MT - Billings
15,1965-1966,1965-09-15,1966-04-29,227,0,127,480,607,81,189,270,877,39,308,MT - Billings
16,1966-1967,1966-11-06,1967-05-10,186,0,72,377,449,103,156,259,708,48,308,MT - Billings
17,1967-1968,1967-11-01,1968-04-21,173,0,83,334,417,68,169,237,654,36,204,MT - Billings
18,1968-1969,1968-11-04,1969-04-29,177,0,212,543,755,57,256,313,1068,35,300,MT - Billings
19,1969-1970,1969-10-10,1970-04-30,203,0,95,425,520,94,113,207,727,40,264,MT - Billings
20,1970-1971,1970-09-11,1971-04-27,229,0,132,480,612,75,164,239,851,43,345,MT - Billings
21,1971-1972,1971-10-01,1972-04-19,202,0,155,552,707,114,356,470,1177,42,343,MT - Billings
22,1972-1973,1972-09-24,1973-05-01,220,0,162,436,598,93,205,298,896,41,335,MT - Billings
23,1973-1974,1973-10-09,1974-05-13,217,0,111,336,447,86,187,273,720,39,284,MT - Billings
24,1974-1975,1974-10-05,1975-05-25,233,0,115,458,573,94,271,365,938,48,320,MT - Billings
25,1975-1976,1975-10-13,1976-04-27,198,0,105,402,507,100,266,366,873,39,287,MT - Billings
26,1976-1977,1976-10-17,1977-04-17,183,0,75,387,462,80,166,246,708,42,282,MT - Billings
27,1977-1978,1977-10-09,1978-03-19,162,0,245,562,807,126,628,754,1561,50,583,MT - Billings
28,1978-1979,1978-11-09,1979-05-09,182,0,271,641,912,115,805,920,1832,53,460,MT - Billings
29,1979-1980,1979-10-20,1980-04-11,175,0,113,390,503,88,150,238,741,39,255,MT - Billings
30,1980-1981,1980-10-15,1981-05-12,210,0,55,294,349,99,78,177,526,33,224,MT - Billings
31,1981-1982,1981-10-11,1982-05-09,211,0,153,505,658,100,150,250,908,52,382,MT - Billings
32,1982-1983,1982-09-14,1983-05-13,242,0,31,264,295,71,77,148,443,34,150,MT - Billings
33,1983-1984,1983-09-18,1984-04-28,224,0,147,380,527,82,225,307,834,47,310,MT - Billings
34,1984-1985,1984-09-23,1985-04-06,196,0,145,530,675,108,286,394,1069,38,258,MT - Billings
35,1985-1986,1985-09-23,1986-05-09,229,0,178,458,636,107,303,410,1046,47,424,MT - Billings
36,1986-1987,1986-11-06,1987-05-20,196,0,55,302,357,55,121,176,533,32,160,MT - Billings
37,1987-1988,1987-10-09,1988-05-01,206,0,81,371,452,55,121,176,628,26,181,MT - Billings
38,1988-1989,1988-10-26,1989-04-28,185,0,154,470,624,109,288,397,1021,52,417,MT - Billings
39,1989-1990,1989-10-02,1990-04-30,211,0,80,373,453,103,198,301,754,51,316,MT - Billings
40,1990-1991,1990-10-06,1991-05-03,210,0,117,424,541,89,160,249,790,41,289,MT - Billings
41,1991-1992,1991-10-03,1992-04-23,204,0,32,272,304,51,93,144,448,23,111,MT - Billings
42,1992-1993,1992-10-13,1993-04-20,190,0,155,478,633,73,180,253,886,44,317,MT - Billings
43,1993-1994,1993-10-07,1994-04-28,204,0,92,388,480,76,115,191,671,41,310,MT - Billings
44,1994-1995,1994-11-17,1995-05-13,178,0,72,313,385,71,101,172,557,28,177,MT - Billings
45,1995-1996,1995-09-19,1996-05-10,235,3,168,504,672,101,175,276,948,51,414,MT - Billings
46,1996-1997,1996-10-20,1997-04-15,178,0,194,528,722,139,295,434,1156,53,489,MT - Billings
47,1997-1998,1997-10-24,1998-03-30,158,0,72,322,394,75,102,177,571,28,200,MT - Billings
48,1998-1999,1998-11-03,1999-04-14,163,0,59,290,349,76,97,173,522,35,221,MT - Billings
49,1999-2000,1999-10-01,2000-05-12,225,0,30,266,296,58,101,159,455,32,162,MT - Billings
50,2000-2001,2000-09-21,2001-04-21,213,1,106,459,565,92,160,252,817,45,290,MT - Billings
51,2001-2002,2001-10-14,2002-05-23,222,0,93,404,497,92,105,197,694,42,315,MT - Billings
52,2002-2003,2002-10-21,2003-04-03,165,0,82,362,444,76,111,187,631,36,272,MT - Billings
53,2003-2004,2003-10-30,2004-05-12,196,0,76,346,422,61,131,192,614,37,206,MT - Billings
54,2004-2005,2004-11-19,2005-05-12,175,0,84,316,400,79,97,176,576,32,237,MT - Billings
55,2005-2006,2005-10-04,2006-04-23,202,0,69,311,380,58,81,139,519,28,196,MT - Billings
56,2006-2007,2006-10-11,2007-04-19,191,0,87,371,458,94,113,207,665,37,253,MT - Billings
57,2007-2008,2007-11-19,2008-05-02,166,6,58,371,429,52,78,130,559,29,173,MT - Billings
58,2008-2009,2008-10-09,2009-04-24,198,0,117,373,490,111,207,318,808,49,343,MT - Billings
59,2009-2010,2009-10-05,2010-05-06,214,0,123,400,523,81,247,328,851,39,290,MT - Billings
60,2010-2011,2010-11-17,2011-05-01,166,0,155,445,600,110,272,382,982,50,356,MT - Billings
61,2011-2012,2011-11-05,2012-05-26,204,0,42,281,323,62,69,131,454,28,187,MT - Billings
62,2012-2013,2012-10-03,2013-04-22,202,0,56,352,408,65,73,138,546,37,186,MT - Billings
63,2013-2014,2013-10-04,2014-05-07,216,0,147,442,589,149,310,459,1048,48,417,MT - Billings
64,2014-2015,2014-11-09,2015-04-15,158,0,90,330,420,85,177,262,682,37,298,MT - Billings
65,2015-2016,2015-11-20,2016-04-28,161,0,49,233,282,43,131,174,456,23,128,MT - Billings
66,2016-2017,2016-10-11,2017-04-10,182,0,144,383,527,104,327,431,958,37,324,MT - Billings
67,2017-2018,2017-11-01,2018-04-23,174,0,142,472,614,153,406,559,1173,52,474,MT - Billings
68,2018-2019,2018-09-30,2019-05-18,231,0,147,483,630,100,260,360,990,52,440,MT - Billings
69,2019-2020,2019-09-29,2020-04-16,201,0,62,367,429,84,94,178,607,48,270,MT - Billings
1,1951-1952,1951-10-17,1952-05-21,218,4,116,624,740,171,886,1057,1797,57,428,MT - Bozeman
3,1953-1954,1953-11-17,1954-05-01,166,12,74,404,478,94,282,376,854,24,193,MT - Bozeman
5,1955-1956,1955-11-01,1956-04-08,160,17,156,594,750,92,755,847,1597,37,276,MT - Bozeman
8,1958-1959,1958-11-05,1959-05-05,182,5,84,462,546,118,423,541,1087,47,318,MT - Bozeman
10,1960-1961,1960-11-04,1961-04-27,175,2,28,404,432,126,253,379,811,36,222,MT - Bozeman
11,1961-1962,1961-09-23,1962-04-28,218,0,153,633,786,131,757,888,1674,49,343,MT - Bozeman
12,1962-1963,1962-11-16,1963-04-21,157,8,108,438,546,110,307,417,963,37,305,MT - Bozeman
13,1963-1964,1963-10-30,1964-05-23,207,1,72,518,590,159,604,763,1353,65,369,MT - Bozeman
14,1964-1965,1964-08-29,1965-05-09,254,0,79,520,599,162,335,497,1096,63,383,MT - Bozeman
15,1965-1966,1965-09-15,1966-05-22,250,1,55,480,535,120,320,440,975,56,319,MT - Bozeman
16,1966-1967,1966-10-02,1967-05-13,224,0,54,450,504,179,384,563,1067,71,393,MT - Bozeman
17,1967-1968,1967-10-23,1968-06-29,251,0,98,563,661,186,690,876,1537,68,478,MT - Bozeman
18,1968-1969,1968-09-21,1969-06-28,281,6,142,625,767,142,770,912,1679,50,395,MT - Bozeman
19,1969-1970,1969-10-03,1970-05-14,224,0,58,444,502,131,279,410,912,59,301,MT - Bozeman
20,1970-1971,1970-10-06,1971-05-18,225,0,81,477,558,128,412,540,1098,66,353,MT - Bozeman
21,1971-1972,1971-09-16,1972-05-01,229,5,103,506,609,144,396,540,1149,67,402,MT - Bozeman
22,1972-1973,1972-09-25,1973-06-17,266,0,147,588,735,164,454,618,1353,53,375,MT - Bozeman
23,1973-1974,1973-09-14,1974-06-07,267,0,95,439,534,147,373,520,1054,54,357,MT - Bozeman
24,1974-1975,1974-09-27,1975-05-25,241,3,95,548,643,184,670,854,1497,75,437,MT - Bozeman
25,1975-1976,1975-10-08,1976-06-14,251,0,81,474,555,180,486,666,1221,68,416,MT - Bozeman
26,1976-1977,1976-10-17,1977-05-28,224,0,54,413,467,100,343,443,910,55,300,MT - Bozeman
27,1977-1978,1977-11-17,1978-05-05,170,0,103,424,527,93,525,618,1145,43,273,MT - Bozeman
28,1978-1979,1978-09-12,1979-06-07,269,3,209,707,916,151,744,895,1811,64,472,MT - Bozeman
29,1979-1980,1979-10-20,1980-05-25,219,0,106,496,602,155,662,817,1419,49,354,MT - Bozeman
30,1980-1981,1980-10-15,1981-06-14,243,0,38,348,386,103,209,312,698,39,183,MT - Bozeman
31,1981-1982,1981-10-04,1982-06-08,248,7,104,501,605,194,514,708,1313,72,434,MT - Bozeman
32,1982-1983,1982-09-14,1983-05-13,242,3,45,374,419,143,304,447,866,61,279,MT - Bozeman
33,1983-1984,1983-09-19,1984-05-25,250,3,135,496,631,178,518,696,1327,68,418,MT - Bozeman
34,1984-1985,1984-09-23,1985-04-24,214,0,107,601,708,132,655,787,1495,58,380,MT - Bozeman
35,1985-1986,1985-09-23,1986-05-22,242,0,131,520,651,129,571,700,1351,51,352,MT - Bozeman
36,1986-1987,1986-11-06,1987-04-19,165,0,49,394,443,71,388,459,902,38,209,MT - Bozeman
37,1987-1988,1987-11-16,1988-05-01,168,0,73,428,501,104,463,567,1068,44,230,MT - Bozeman
38,1988-1989,1988-09-11,1989-05-29,261,0,144,556,700,139,647,786,1486,68,422,MT - Bozeman
39,1989-1990,1989-09-10,1990-05-15,248,1,51,407,458,134,475,609,1067,47,261,MT - Bozeman
40,1990-1991,1990-10-06,1991-05-10,217,2,99,472,571,149,422,571,1142,53,366,MT - Bozeman
41,1991-1992,1991-10-22,1992-04-23,185,0,37,363,400,74,282,356,756,28,142,MT - Bozeman
42,1992-1993,1992-08-24,1993-04-26,246,0,133,569,702,125,607,732,1434,54,347,MT - Bozeman
43,1993-1994,1993-10-08,1994-04-28,203,5,48,421,469,106,339,445,914,40,227,MT - Bozeman
44,1994-1995,1994-10-03,1995-04-30,210,3,87,469,556,160,782,942,1498,41,289,MT - Bozeman
45,1995-1996,1995-10-21,1996-05-10,203,6,122,499,621,110,294,404,1025,57,361,MT - Bozeman
46,1996-1997,1996-09-26,1997-05-03,220,3,103,536,639,230,969,1199,1838,71,483,MT - Bozeman
47,1997-1998,1997-10-11,1998-04-18,190,3,51,498,549,133,724,857,1406,48,300,MT - Bozeman
49,1999-2000,1999-09-27,2000-05-11,228,13,12,373,385,93,143,236,621,41,177,MT - Bozeman
51,2001-2002,2001-10-05,2002-06-11,250,6,54,534,588,113,429,542,1130,48,305,MT - Bozeman
52,2002-2003,2002-10-28,2003-05-19,204,4,51,466,517,117,308,425,942,50,260,MT - Bozeman
53,2003-2004,2003-10-30,2004-04-28,182,8,54,484,538,104,616,720,1258,39,229,MT - Bozeman
54,2004-2005,2004-11-03,2005-05-12,191,11,52,405,457,113,116,229,686,51,277,MT - Bozeman
55,2005-2006,2005-10-02,2006-04-26,207,6,61,436,497,132,599,731,1228,48,250,MT - Bozeman
56,2006-2007,2006-10-16,2007-05-29,226,10,64,472,536,150,503,653,1189,59,333,MT - Bozeman
57,2007-2008,2007-10-06,2008-06-11,250,12,61,520,581,171,494,665,1246,73,401,MT - Bozeman
58,2008-2009,2008-10-11,2009-05-13,215,11,80,493,573,197,547,744,1317,69,448,MT - Bozeman
59,2009-2010,2009-09-30,2010-05-22,235,9,91,538,629,180,856,1036,1665,67,394,MT - Bozeman
60,2010-2011,2010-10-26,2011-05-01,188,6,130,505,635,192,658,850,1485,65,450,MT - Bozeman
61,2011-2012,2011-10-26,2012-05-26,214,14,31,393,424,116,241,357,781,49,239,MT - Bozeman
62,2012-2013,2012-10-03,2013-05-01,211,0,73,445,518,116,520,636,1154,59,330,MT - Bozeman
63,2013-2014,2013-10-03,2014-05-07,217,1,126,530,656,127,675,802,1458,50,408,MT - Bozeman
64,2014-2015,2014-11-10,2015-04-16,158,10,74,383,457,100,310,410,867,36,233,MT - Bozeman
65,2015-2016,2015-11-03,2016-05-10,190,0,65,368,433,115,457,572,1005,46,249,MT - Bozeman
66,2016-2017,2016-10-11,2017-05-18,220,3,122,473,595,128,476,604,1199,54,362,MT - Bozeman
67,2017-2018,2017-10-03,2018-04-23,203,9,86,516,602,207,819,1026,1628,70,446,MT - Bozeman
68,2018-2019,2018-10-05,2019-05-02,210,9,145,617,762,140,869,1009,1771,57,469,MT - Bozeman
69,2019-2020,2019-09-29,2020-05-11,226,7,73,481,554,155,440,595,1149,71,415,MT - Bozeman
0,1950-1951,1950-09-30,1951-06-01,245,4,115,763,878,93,360,453,1331,49,386,MT - Busby
1,1951-1952,1951-10-15,1952-04-08,177,6,142,807,949,67,503,570,1519,42,333,MT - Busby
2,1952-1953,1952-11-16,1953-05-12,178,10,28,477,505,57,118,175,680,36,190,MT - Busby
3,1953-1954,1953-11-18,1954-04-02,136,2,72,548,620,46,154,200,820,20,168,MT - Busby
4,1954-1955,1954-09-30,1955-04-11,194,15,58,638,696,89,196,285,981,47,285,MT - Busby
5,1955-1956,1955-10-22,1956-05-03,195,5,133,873,1006,91,640,731,1737,48,395,MT - Busby
6,1956-1957,1956-11-01,1957-04-11,162,0,131,685,816,73,248,321,1137,37,345,MT - Busby
7,1957-1958,1957-10-24,1958-04-23,182,17,32,477,509,41,61,102,611,27,162,MT - Busby
16,1966-1967,1966-11-07,1967-05-03,178,1,47,591,638,123,350,473,1111,61,386,MT - Busby
17,1967-1968,1967-10-24,1968-05-06,196,0,105,689,794,84,495,579,1373,52,330,MT - Busby
18,1968-1969,1968-11-05,1969-05-03,180,1,194,865,1059,91,673,764,1823,44,402,MT - Busby
24,1974-1975,1974-12-01,1975-04-29,150,3,81,577,658,93,407,500,1158,31,237,MT - Busby
25,1975-1976,1975-10-14,1976-05-14,214,0,110,676,786,77,784,861,1647,37,275,MT - Busby
26,1976-1977,1976-10-17,1977-04-04,170,6,75,634,709,96,767,863,1572,41,324,MT - Busby
27,1977-1978,1977-10-09,1978-03-28,171,3,178,768,946,97,902,999,1945,40,395,MT - Busby
28,1978-1979,1978-09-18,1979-05-09,234,0,239,1015,1254,107,967,1074,2328,45,412,MT - Busby
29,1979-1980,1979-11-05,1980-03-26,143,3,88,586,674,58,129,187,861,29,221,MT - Busby
30,1980-1981,1980-10-16,1981-03-31,167,4,48,479,527,46,136,182,709,24,150,MT - Busby
31,1981-1982,1981-10-20,1982-04-18,181,0,133,737,870,87,374,461,1331,38,317,MT - Busby
32,1982-1983,1982-09-14,1983-05-12,241,14,27,562,589,84,368,452,1041,25,186,MT - Busby
33,1983-1984,1983-09-19,1984-04-30,225,5,150,672,822,90,397,487,1309,37,289,MT - Busby
34,1984-1985,1984-09-23,1985-04-05,195,5,154,925,1079,110,894,1004,2083,34,291,MT - Busby
35,1985-1986,1985-09-23,1986-05-10,230,1,144,672,816,128,633,761,1577,36,374,MT - Busby
36,1986-1987,1986-11-06,1987-04-09,155,5,36,459,495,55,102,157,652,25,139,MT - Busby
37,1987-1988,1987-10-09,1988-05-01,206,8,70,549,619,79,342,421,1040,25,214,MT - Busby
38,1988-1989,1988-10-27,1989-04-28,184,2,165,747,912,108,562,670,1582,34,385,MT - Busby
39,1989-1990,1989-10-02,1990-04-29,210,3,89,607,696,118,420,538,1234,41,335,MT - Busby
40,1990-1991,1990-10-06,1991-05-03,210,1,113,704,817,82,221,303,1120,34,292,MT - Busby
41,1991-1992,1991-10-22,1992-05-16,208,3,32,500,532,65,134,199,731,19,137,MT - Busby
42,1992-1993,1992-10-15,1993-04-19,187,3,163,823,986,89,560,649,1635,31,305,MT - Busby
43,1993-1994,1993-10-08,1994-04-28,203,2,98,669,767,120,381,501,1268,40,371,MT - Busby
44,1994-1995,1994-11-17,1995-05-13,178,0,78,521,599,62,246,308,907,16,134,MT - Busby
45,1995-1996,1995-10-30,1996-05-09,193,1,159,706,865,94,212,306,1171,37,319,MT - Busby
46,1996-1997,1996-10-20,1997-04-14,177,4,186,769,955,125,803,928,1883,40,420,MT - Busby
47,1997-1998,1997-10-24,1998-04-15,174,0,59,526,585,59,164,223,808,24,178,MT - Busby
48,1998-1999,1998-11-07,1999-04-10,155,0,56,443,499,70,205,275,774,23,144,MT - Busby
49,1999-2000,1999-10-01,2000-05-12,225,3,24,482,506,71,175,246,752,20,142,MT - Busby
50,2000-2001,2000-09-22,2001-04-21,212,1,123,785,908,94,706,800,1708,30,249,MT - Busby
51,2001-2002,2001-11-25,2002-04-20,147,3,70,547,617,68,132,200,817,23,190,MT - Busby
52,2002-2003,2002-10-22,2003-04-04,165,0,66,557,623,86,230,316,939,27,239,MT - Busby
53,2003-2004,2003-10-30,2004-03-10,133,0,85,532,617,56,392,448,1065,21,142,MT - Busby
54,2004-2005,2004-11-23,2005-05-12,171,1,71,443,514,51,69,120,634,18,132,MT - Busby
56,2006-2007,2006-10-11,2007-04-09,181,1,72,567,639,108,323,431,1070,24,221,MT - Busby
57,2007-2008,2007-11-20,2008-05-02,165,1,79,661,740,69,317,386,1126,26,221,MT - Busby
58,2008-2009,2008-10-10,2009-05-12,215,6,114,593,707,85,296,381,1088,24,207,MT - Busby
59,2009-2010,2009-10-05,2010-05-06,214,2,122,705,827,64,349,413,1240,24,215,MT - Busby
60,2010-2011,2010-11-13,2011-04-22,161,3,128,645,773,95,582,677,1450,32,302,MT - Busby
61,2011-2012,2011-11-06,2012-03-19,135,1,35,450,485,52,192,244,729,20,152,MT - Busby
62,2012-2013,2012-10-03,2013-04-22,202,4,63,597,660,95,388,483,1143,44,284,MT - Busby
63,2013-2014,2013-10-04,2014-05-07,216,0,137,708,845,120,484,604,1449,46,417,MT - Busby
64,2014-2015,2014-11-10,2015-04-15,157,1,84,539,623,71,284,355,978,29,233,MT - Busby
65,2015-2016,2015-11-04,2016-04-28,177,4,53,485,538,69,314,383,921,35,211,MT - Busby
66,2016-2017,2016-10-11,2017-04-25,197,0,137,638,775,85,520,605,1380,35,287,MT - Busby
67,2017-2018,2017-10-26,2018-04-24,181,0,128,736,864,156,811,967,1831,56,495,MT - Busby
68,2018-2019,2018-10-13,2019-05-01,201,2,107,692,799,94,316,410,1209,43,352,MT - Busby
69,2019-2020,2019-10-01,2020-04-15,198,0,45,581,626,73,201,274,900,37,211,MT - Busby
0,1950-1951,1950-09-30,1951-04-21,204,0,327,997,1324,84,472,556,1880,46,525,MT - Glasgow
1,1951-1952,1951-09-24,1952-04-07,197,0,319,929,1248,102,477,579,1827,53,511,MT - Glasgow
2,1952-1953,1952-11-23,1953-05-12,171,0,124,614,738,61,137,198,936,36,238,MT - Glasgow
3,1953-1954,1953-12-01,1954-05-03,154,1,203,626,829,78,258,336,1165,40,401,MT - Glasgow
4,1954-1955,1954-11-29,1955-04-25,148,0,173,634,807,70,318,388,1195,41,381,MT - Glasgow
5,1955-1956,1955-11-01,1956-05-05,187,0,382,971,1353,57,435,492,1845,37,396,MT - Glasgow
6,1956-1957,1956-11-14,1957-04-11,149,0,276,734,1010,42,268,310,1320,31,390,MT - Glasgow
7,1957-1958,1957-09-18,1958-03-27,191,0,126,523,649,35,72,107,756,30,170,MT - Glasgow
8,1958-1959,1958-11-04,1959-04-17,165,0,325,792,1117,62,458,520,1637,37,380,MT - Glasgow
9,1959-1960,1959-10-06,1960-04-28,206,0,274,732,1006,52,305,357,1363,39,328,MT - Glasgow
10,1960-1961,1960-10-29,1961-04-10,164,0,133,532,665,35,87,122,787,27,194,MT - Glasgow
11,1961-1962,1961-10-22,1962-03-29,159,0,314,794,1108,51,157,208,1316,43,418,MT - Glasgow
12,1962-1963,1962-10-15,1963-04-22,190,0,185,568,753,38,64,102,855,29,181,MT - Glasgow
13,1963-1964,1963-11-12,1964-04-17,158,0,163,564,727,37,67,104,831,31,257,MT - Glasgow
14,1964-1965,1964-10-28,1965-04-19,174,3,426,962,1388,67,693,760,2148,45,507,MT - Glasgow
15,1965-1966,1965-09-26,1966-05-12,229,0,322,804,1126,37,319,356,1482,26,277,MT - Glasgow
16,1966-1967,1966-10-21,1967-05-10,202,0,239,762,1001,98,416,514,1515,54,449,MT - Glasgow
17,1967-1968,1967-11-02,1968-05-10,191,0,204,643,847,32,97,129,976,21,172,MT - Glasgow
18,1968-1969,1968-11-07,1969-04-30,175,0,431,908,1339,74,582,656,1995,49,601,MT - Glasgow
19,1969-1970,1969-10-10,1970-04-30,203,0,201,683,884,62,195,257,1141,45,297,MT - Glasgow
20,1970-1971,1970-09-13,1971-05-18,248,0,290,802,1092,83,580,663,1755,57,565,MT - Glasgow
21,1971-1972,1971-10-15,1972-04-17,186,4,321,798,1119,62,354,416,1535,46,539,MT - Glasgow
22,1972-1973,1972-09-24,1973-04-22,211,1,213,640,853,39,202,241,1094,23,153,MT - Glasgow
23,1973-1974,1973-11-01,1974-04-28,179,0,227,671,898,57,203,260,1158,47,370,MT - Glasgow
24,1974-1975,1974-10-31,1975-04-30,182,0,165,627,792,47,106,153,945,41,267,MT - Glasgow
25,1975-1976,1975-10-08,1976-04-17,193,0,168,619,787,53,164,217,1004,37,309,MT - Glasgow
26,1976-1977,1976-10-22,1977-04-03,164,0,192,669,861,40,215,255,1116,35,298,MT - Glasgow
27,1977-1978,1977-10-10,1978-04-12,185,0,452,878,1330,67,579,646,1976,50,549,MT - Glasgow
28,1978-1979,1978-11-10,1979-05-07,179,0,466,1004,1470,90,788,878,2348,61,675,MT - Glasgow
29,1979-1980,1979-11-07,1980-04-02,148,0,205,644,849,40,145,185,1034,32,261,MT - Glasgow
30,1980-1981,1980-10-16,1981-03-27,163,0,118,446,564,31,46,77,641,22,156,MT - Glasgow
31,1981-1982,1981-10-12,1982-04-09,180,0,361,829,1190,78,414,492,1682,50,538,MT - Glasgow
32,1982-1983,1982-09-28,1983-05-15,230,0,128,522,650,56,291,347,997,32,184,MT - Glasgow
33,1983-1984,1983-09-29,1984-05-07,222,0,258,621,879,53,192,245,1124,44,348,MT - Glasgow
34,1984-1985,1984-09-23,1985-04-06,196,0,301,767,1068,57,237,294,1362,41,345,MT - Glasgow
35,1985-1986,1985-09-24,1986-04-16,205,0,308,755,1063,83,572,655,1718,52,526,MT - Glasgow
36,1986-1987,1986-11-08,1987-04-11,155,0,80,423,503,44,90,134,637,23,119,MT - Glasgow
37,1987-1988,1987-10-19,1988-04-08,173,0,164,602,766,28,111,139,905,19,165,MT - Glasgow
38,1988-1989,1988-10-27,1989-04-03,159,0,286,769,1055,63,468,531,1586,36,377,MT - Glasgow
39,1989-1990,1989-11-11,1990-04-30,171,0,147,589,736,46,123,169,905,35,284,MT - Glasgow
40,1990-1991,1990-10-07,1991-05-04,210,0,229,682,911,65,256,321,1232,41,307,MT - Glasgow
41,1991-1992,1991-10-23,1992-04-11,172,0,75,497,572,21,15,36,608,19,113,MT - Glasgow
42,1992-1993,1992-10-14,1993-03-28,166,0,280,735,1015,44,317,361,1376,35,364,MT - Glasgow
43,1993-1994,1993-10-07,1994-04-25,201,0,266,704,970,76,499,575,1545,43,464,MT - Glasgow
44,1994-1995,1994-11-02,1995-04-12,162,3,189,602,791,47,137,184,975,24,194,MT - Glasgow
45,1995-1996,1995-10-31,1996-04-12,165,8,377,886,1263,64,373,437,1700,43,426,MT - Glasgow
46,1996-1997,1996-10-20,1997-04-09,172,0,386,897,1283,91,639,730,2013,51,627,MT - Glasgow
47,1997-1998,1997-10-13,1998-03-24,163,3,149,526,675,34,52,86,761,23,163,MT - Glasgow
48,1998-1999,1998-11-03,1999-05-12,191,0,168,531,699,92,277,369,1068,52,417,MT - Glasgow
49,1999-2000,1999-10-02,2000-05-12,224,0,95,511,606,48,77,125,731,28,186,MT - Glasgow
50,2000-2001,2000-11-05,2001-04-13,160,0,266,742,1008,64,489,553,1561,37,346,MT - Glasgow
51,2001-2002,2001-10-23,2002-05-23,213,3,199,721,920,61,158,219,1139,38,314,MT - Glasgow
52,2002-2003,2002-10-21,2003-04-06,168,0,197,668,865,55,128,183,1048,39,366,MT - Glasgow
53,2003-2004,2003-10-29,2004-05-12,197,0,270,719,989,105,762,867,1856,42,465,MT - Glasgow
54,2004-2005,2004-10-16,2005-04-30,197,0,167,606,773,52,157,209,982,29,255,MT - Glasgow
55,2005-2006,2005-11-03,2006-04-23,172,0,127,479,606,50,120,170,776,37,262,MT - Glasgow
56,2006-2007,2006-10-16,2007-04-11,178,0,164,615,779,63,103,166,945,38,333,MT - Glasgow
57,2007-2008,2007-11-21,2008-05-02,164,0,165,662,827,42,106,148,975,29,298,MT - Glasgow
58,2008-2009,2008-10-11,2009-05-13,215,0,277,805,1082,85,247,332,1414,29,328,MT - Glasgow
59,2009-2010,2009-10-09,2010-05-05,209,0,308,752,1060,50,384,434,1494,27,285,MT - Glasgow
60,2010-2011,2010-10-26,2011-04-18,175,0,364,851,1215,162,786,948,2163,58,681,MT - Glasgow
61,2011-2012,2011-11-05,2012-04-06,154,0,100,454,554,42,93,135,689,23,185,MT - Glasgow
62,2012-2013,2012-10-05,2013-04-20,198,0,192,674,866,93,309,402,1268,45,366,MT - Glasgow
63,2013-2014,2013-10-28,2014-03-31,155,0,261,776,1037,57,185,242,1279,40,385,MT - Glasgow
64,2014-2015,2014-11-09,2015-04-07,150,0,181,561,742,72,170,242,984,32,285,MT - Glasgow
65,2015-2016,2015-11-20,2016-04-25,158,1,122,440,562,42,280,322,884,24,157,MT - Glasgow
66,2016-2017,2016-10-05,2017-03-15,162,0,238,576,814,60,238,298,1112,30,328,MT - Glasgow
67,2017-2018,2017-10-03,2018-04-17,197,0,309,862,1171,100,400,500,1671,43,448,MT - Glasgow
68,2018-2019,2018-10-03,2019-03-22,171,0,267,686,953,78,312,390,1343,42,475,MT - Glasgow
69,2019-2020,2019-10-08,2020-04-15,191,0,143,570,713,69,173,242,955,46,306,MT - Glasgow
0,1950-1951,1950-09-29,1951-05-31,245,0,185,586,771,104,253,357,1128,48,456,MT - Great Falls
1,1951-1952,1951-09-26,1952-04-07,195,0,178,563,741,103,402,505,1246,52,473,MT - Great Falls
2,1952-1953,1952-11-05,1953-05-12,189,0,53,321,374,79,115,194,568,39,236,MT - Great Falls
3,1953-1954,1953-12-01,1954-05-02,153,0,151,454,605,84,158,242,847,49,400,MT - Great Falls
4,1954-1955,1954-09-28,1955-05-16,231,0,99,423,522,111,177,288,810,45,347,MT - Great Falls
5,1955-1956,1955-10-22,1956-05-04,196,0,207,599,806,90,175,265,1071,48,478,MT - Great Falls
6,1956-1957,1956-10-27,1957-04-25,181,0,196,528,724,92,218,310,1034,56,534,MT - Great Falls
7,1957-1958,1957-09-18,1958-04-26,221,0,85,328,413,115,183,298,711,55,359,MT - Great Falls
8,1958-1959,1958-10-09,1959-04-24,198,0,136,464,600,110,284,394,994,49,386,MT - Great Falls
9,1959-1960,1959-09-28,1960-05-05,221,0,133,469,602,97,189,286,888,47,393,MT - Great Falls
10,1960-1961,1960-11-03,1961-04-28,177,0,51,308,359,48,37,85,444,31,160,MT - Great Falls
11,1961-1962,1961-09-26,1962-04-11,198,0,230,618,848,91,205,296,1144,52,458,MT - Great Falls
12,1962-1963,1962-09-07,1963-04-20,226,0,97,407,504,65,130,195,699,35,299,MT - Great Falls
13,1963-1964,1963-11-20,1964-04-25,158,0,111,394,505,89,170,259,764,42,318,MT - Great Falls
14,1964-1965,1964-11-14,1965-06-06,205,0,212,630,842,97,289,386,1228,52,454,MT - Great Falls
15,1965-1966,1965-09-15,1966-04-28,226,0,153,498,651,95,185,280,931,51,412,MT - Great Falls
16,1966-1967,1966-10-12,1967-05-11,212,0,117,509,626,156,183,339,965,63,471,MT - Great Falls
17,1967-1968,1967-10-23,1968-04-21,182,0,109,430,539,74,136,210,749,44,297,MT - Great Falls
18,1968-1969,1968-09-20,1969-06-12,266,0,333,764,1097,96,372,468,1565,52,614,MT - Great Falls
19,1969-1970,1969-10-10,1970-05-12,215,0,133,470,603,98,130,228,831,54,339,MT - Great Falls
20,1970-1971,1970-09-11,1971-04-26,228,0,164,562,726,100,135,235,961,59,473,MT - Great Falls
21,1971-1972,1971-10-15,1972-05-06,205,0,179,644,823,105,216,321,1144,55,533,MT - Great Falls
22,1972-1973,1972-09-24,1973-05-01,220,0,156,494,650,102,133,235,885,49,377,MT - Great Falls
23,1973-1974,1973-09-14,1974-04-28,227,0,143,459,602,102,187,289,891,55,434,MT - Great Falls
24,1974-1975,1974-09-11,1975-05-20,252,0,149,549,698,124,274,398,1096,63,496,MT - Great Falls
25,1975-1976,1975-10-07,1976-04-28,205,0,117,460,577,107,109,216,793,50,392,MT - Great Falls
26,1976-1977,1976-10-17,1977-05-17,213,0,57,391,448,87,164,251,699,36,254,MT - Great Falls
27,1977-1978,1977-10-09,1978-04-21,195,0,301,683,984,121,520,641,1625,67,710,MT - Great Falls
28,1978-1979,1978-11-08,1979-05-07,181,0,269,690,959,115,466,581,1540,62,570,MT - Great Falls
29,1979-1980,1979-10-21,1980-04-11,174,0,128,485,613,56,92,148,761,38,306,MT - Great Falls
30,1980-1981,1980-10-15,1981-04-03,171,0,99,364,463,61,88,149,612,30,217,MT - Great Falls
31,1981-1982,1981-10-11,1982-05-29,231,0,217,675,892,149,275,424,1316,62,542,MT - Great Falls
32,1982-1983,1982-09-14,1983-05-13,242,0,45,360,405,72,94,166,571,38,209,MT - Great Falls
33,1983-1984,1983-09-18,1984-05-06,232,0,168,501,669,126,274,400,1069,57,443,MT - Great Falls
34,1984-1985,1984-09-22,1985-04-25,216,0,199,634,833,104,236,340,1173,54,414,MT - Great Falls
35,1985-1986,1985-09-22,1986-05-11,232,0,212,538,750,111,286,397,1147,52,531,MT - Great Falls
36,1986-1987,1986-10-02,1987-05-20,231,0,39,315,354,62,106,168,522,33,188,MT - Great Falls
37,1987-1988,1987-10-15,1988-04-25,194,0,81,380,461,66,71,137,598,33,237,MT - Great Falls
38,1988-1989,1988-09-11,1989-05-29,261,0,169,530,699,164,251,415,1114,61,573,MT - Great Falls
39,1989-1990,1989-09-10,1990-04-29,232,0,81,407,488,93,116,209,697,47,338,MT - Great Falls
40,1990-1991,1990-10-05,1991-05-04,212,0,135,502,637,102,140,242,879,53,437,MT - Great Falls
41,1991-1992,1991-10-03,1992-05-16,227,0,42,345,387,61,65,126,513,35,195,MT - Great Falls
42,1992-1993,1992-08-22,1993-04-19,241,0,203,556,759,100,175,275,1034,55,473,MT - Great Falls
43,1993-1994,1993-10-07,1994-04-27,203,0,102,475,577,87,116,203,780,53,380,MT - Great Falls
44,1994-1995,1994-10-02,1995-05-26,237,0,110,525,635,73,102,175,810,35,246,MT - Great Falls
45,1995-1996,1995-10-21,1996-05-10,203,0,201,667,868,104,187,291,1159,51,506,MT - Great Falls
46,1996-1997,1996-10-16,1997-05-07,204,3,243,670,913,115,209,324,1237,54,553,MT - Great Falls
47,1997-1998,1997-10-24,1998-06-02,222,0,89,420,509,61,107,168,677,35,254,MT - Great Falls
48,1998-1999,1998-10-10,1999-06-08,242,0,68,420,488,83,99,182,670,33,249,MT - Great Falls
49,1999-2000,1999-10-01,2000-06-01,245,0,42,381,423,67,79,146,569,33,187,MT - Great Falls
50,2000-2001,2000-09-21,2001-05-20,242,0,131,563,694,90,155,245,939,49,362,MT - Great Falls
51,2001-2002,2001-10-04,2002-05-23,232,0,133,532,665,87,174,261,926,39,321,MT - Great Falls
52,2002-2003,2002-10-11,2003-05-18,220,0,99,472,571,77,109,186,757,38,301,MT - Great Falls
53,2003-2004,2003-10-29,2004-05-23,208,0,116,476,592,71,172,243,835,37,286,MT - Great Falls
54,2004-2005,2004-10-16,2005-04-30,197,0,105,471,576,86,149,235,811,41,352,MT - Great Falls
55,2005-2006,2005-10-04,2006-05-09,218,0,87,377,464,96,143,239,703,45,313,MT - Great Falls
56,2006-2007,2006-09-16,2007-04-19,216,0,95,426,521,106,160,266,787,48,375,MT - Great Falls
57,2007-2008,2007-11-04,2008-06-11,221,0,83,486,569,104,156,260,829,43,337,MT - Great Falls
58,2008-2009,2008-10-11,2009-06-07,240,0,139,529,668,169,222,391,1059,64,548,MT - Great Falls
59,2009-2010,2009-10-07,2010-05-05,211,0,120,468,588,115,236,351,939,44,357,MT - Great Falls
60,2010-2011,2010-09-17,2011-05-01,227,0,186,603,789,156,307,463,1252,58,514,MT - Great Falls
61,2011-2012,2011-10-25,2012-05-27,216,0,50,365,415,66,47,113,528,36,226,MT - Great Falls
62,2012-2013,2012-10-02,2013-04-30,211,0,71,406,477,111,171,282,759,47,315,MT - Great Falls
63,2013-2014,2013-10-27,2014-05-11,197,0,167,599,766,116,212,328,1094,60,539,MT - Great Falls
64,2014-2015,2014-10-02,2015-04-15,196,0,108,456,564,89,219,308,872,40,312,MT - Great Falls
65,2015-2016,2015-10-03,2016-04-28,209,0,62,367,429,73,169,242,671,32,190,MT - Great Falls
66,2016-2017,2016-10-10,2017-04-10,183,0,191,503,694,77,186,263,957,45,416,MT - Great Falls
67,2017-2018,2017-10-02,2018-04-13,194,0,185,611,796,156,328,484,1280,58,559,MT - Great Falls
68,2018-2019,2018-09-30,2019-05-18,231,0,211,634,845,117,363,480,1325,58,559,MT - Great Falls
69,2019-2020,2019-09-28,2020-05-12,228,0,95,532,627,143,154,297,924,47,380,MT - Great Falls
0,1950-1951,1950-10-20,1951-04-21,184,0,262,795,1057,64,241,305,1362,36,447,MT - Havre
1,1951-1952,1951-09-24,1952-03-24,183,0,300,765,1065,97,425,522,1587,56,594,MT - Havre
2,1952-1953,1952-11-16,1953-05-12,178,0,90,485,575,60,121,181,756,34,228,MT - Havre
3,1953-1954,1953-12-01,1954-05-01,152,0,201,558,759,78,197,275,1034,41,396,MT - Havre
4,1954-1955,1954-09-28,1955-04-15,200,0,129,564,693,88,173,261,954,32,305,MT - Havre
5,1955-1956,1955-10-31,1956-05-02,185,0,298,851,1149,68,297,365,1514,49,486,MT - Havre
6,1956-1957,1956-10-27,1957-04-10,166,0,232,665,897,65,323,388,1285,40,439,MT - Havre
7,1957-1958,1957-09-18,1958-03-22,186,0,103,470,573,53,155,208,781,27,216,MT - Havre
8,1958-1959,1958-11-04,1959-03-05,122,0,241,595,836,73,305,378,1214,26,275,MT - Havre
9,1959-1960,1959-10-05,1960-04-27,206,0,179,603,782,79,150,229,1011,33,313,MT - Havre
10,1960-1961,1960-10-29,1961-04-10,164,0,101,461,562,30,106,136,698,17,144,MT - Havre
11,1961-1962,1961-10-21,1962-03-23,154,0,277,822,1099,38,180,218,1317,24,237,MT - Havre
12,1962-1963,1962-11-15,1963-04-17,154,0,148,545,693,27,98,125,818,17,154,MT - Havre
13,1963-1964,1963-11-19,1964-04-21,155,0,137,554,691,47,98,145,836,34,286,MT - Havre
14,1964-1965,1964-11-14,1965-04-16,154,0,367,907,1274,82,531,613,1887,55,651,MT - Havre
15,1965-1966,1965-09-15,1966-04-29,227,0,288,803,1091,72,333,405,1496,45,464,MT - Havre
16,1966-1967,1966-11-05,1967-05-11,188,0,205,719,924,113,272,385,1309,53,432,MT - Havre
17,1967-1968,1967-11-02,1968-04-13,164,0,173,592,765,53,84,137,902,39,302,MT - Havre
18,1968-1969,1968-11-16,1969-04-26,162,0,459,997,1456,83,603,686,2142,51,741,MT - Havre
19,1969-1970,1969-10-10,1970-04-29,202,0,186,718,904,74,189,263,1167,48,380,MT - Havre
20,1970-1971,1970-10-06,1971-04-17,194,0,267,816,1083,102,481,583,1666,52,593,MT - Havre
21,1971-1972,1971-10-15,1972-04-30,199,0,331,872,1203,96,419,515,1718,56,671,MT - Havre
22,1972-1973,1972-09-23,1973-04-30,220,0,176,635,811,70,162,232,1043,33,232,MT - Havre
23,1973-1974,1973-10-30,1974-05-13,196,0,177,631,808,69,171,240,1048,42,348,MT - Havre
24,1974-1975,1974-10-04,1975-04-29,208,0,155,714,869,103,218,321,1190,45,387,MT - Havre
25,1975-1976,1975-10-08,1976-04-01,177,0,129,520,649,57,134,191,840,35,339,MT - Havre
26,1976-1977,1976-10-22,1977-05-17,208,0,110,599,709,82,210,292,1001,34,253,MT - Havre
27,1977-1978,1977-11-18,1978-04-11,145,0,357,750,1107,108,768,876,1983,57,587,MT - Havre
28,1978-1979,1978-10-30,1979-05-07,190,0,416,960,1376,114,825,939,2315,57,609,MT - Havre
29,1979-1980,1979-11-08,1980-04-02,147,0,139,617,756,35,71,106,862,25,190,MT - Havre
30,1980-1981,1980-10-16,1981-03-30,166,0,115,459,574,47,78,125,699,32,244,MT - Havre
31,1981-1982,1981-10-11,1982-05-31,233,19,326,868,1194,145,435,580,1774,61,690,MT - Havre
32,1982-1983,1982-09-29,1983-04-27,211,0,78,499,577,63,68,131,708,32,207,MT - Havre
33,1983-1984,1983-11-20,1984-04-26,159,0,236,620,856,61,284,345,1201,38,338,MT - Havre
34,1984-1985,1984-10-16,1985-04-25,192,0,267,785,1052,87,259,346,1398,42,414,MT - Havre
35,1985-1986,1985-09-28,1986-05-09,224,0,253,680,933,80,321,401,1334,40,476,MT - Havre
36,1986-1987,1986-10-30,1987-03-29,151,0,59,454,513,48,72,120,633,26,175,MT - Havre
37,1987-1988,1987-11-16,1988-03-29,135,0,117,515,632,33,38,71,703,20,189,MT - Havre
38,1988-1989,1988-10-26,1989-05-29,216,0,251,694,945,79,276,355,1300,42,428,MT - Havre
39,1989-1990,1989-11-11,1990-04-29,170,0,115,507,622,72,192,264,886,34,276,MT - Havre
40,1990-1991,1990-10-16,1991-05-03,200,0,187,641,828,64,147,211,1039,42,354,MT - Havre
41,1991-1992,1991-10-26,1992-04-12,170,0,63,496,559,42,71,113,672,22,154,MT - Havre
42,1992-1993,1992-10-14,1993-04-24,193,0,249,731,980,68,284,352,1332,43,457,MT - Havre
43,1993-1994,1993-10-29,1994-04-25,179,0,201,658,859,94,359,453,1312,49,485,MT - Havre
44,1994-1995,1994-11-01,1995-04-29,180,0,162,629,791,60,218,278,1069,31,248,MT - Havre
45,1995-1996,1995-09-20,1996-04-11,205,1,317,867,1184,83,288,371,1555,50,552,MT - Havre
46,1996-1997,1996-10-29,1997-04-10,164,8,299,801,1100,76,311,387,1487,36,421,MT - Havre
47,1997-1998,1997-11-07,1998-03-22,136,0,126,514,640,22,60,82,722,15,116,MT - Havre
48,1998-1999,1998-11-07,1999-05-10,185,1,122,458,580,59,147,206,786,32,218,MT - Havre
54,2004-2005,2004-10-17,2005-03-24,159,1,136,583,719,33,84,117,836,19,156,MT - Havre
55,2005-2006,2005-11-08,2006-03-26,139,0,120,440,560,55,133,188,748,26,184,MT - Havre
56,2006-2007,2006-10-16,2007-04-19,186,0,132,601,733,59,142,201,934,29,265,MT - Havre
57,2007-2008,2007-11-20,2008-04-21,154,0,119,629,748,36,49,85,833,24,229,MT - Havre
58,2008-2009,2008-11-13,2009-05-13,182,0,200,683,883,66,375,441,1324,34,320,MT - Havre
59,2009-2010,2009-10-09,2010-05-05,209,0,271,776,1047,65,527,592,1639,32,318,MT - Havre
60,2010-2011,2010-11-16,2011-04-17,153,0,338,764,1102,123,622,745,1847,49,567,MT - Havre
61,2011-2012,2011-11-18,2012-03-24,128,0,65,418,483,28,41,69,552,14,145,MT - Havre
62,2012-2013,2012-10-24,2013-04-29,188,0,114,583,697,79,244,323,1020,27,234,MT - Havre
63,2013-2014,2013-10-27,2014-03-28,153,1,213,695,908,73,233,306,1214,31,294,MT - Havre
64,2014-2015,2014-11-09,2015-04-06,149,3,142,503,645,35,150,185,830,18,193,MT - Havre
65,2015-2016,2015-11-20,2016-04-26,159,2,101,431,532,31,125,156,688,18,141,MT - Havre
66,2016-2017,2016-10-09,2017-03-13,156,0,196,535,731,56,199,255,986,29,294,MT - Havre
67,2017-2018,2017-10-02,2018-04-08,189,0,306,867,1173,133,828,961,2134,47,553,MT - Havre
68,2018-2019,2018-10-03,2019-05-18,228,0,246,794,1040,57,311,368,1408,32,391,MT - Havre
69,2019-2020,2019-09-28,2020-04-13,199,1,140,629,769,105,211,316,1085,39,333,MT - Havre
0,1950-1951,1950-09-30,1951-06-07,251,0,172,672,844,99,296,395,1239,56,404,MT - Helena
1,1951-1952,1951-09-26,1952-04-03,191,0,194,688,882,89,392,481,1363,50,423,MT - Helena
2,1952-1953,1952-11-15,1953-05-11,178,0,74,414,488,64,159,223,711,34,200,MT - Helena
3,1953-1954,1953-12-01,1954-04-30,151,0,88,426,514,74,147,221,735,35,250,MT - Helena
4,1954-1955,1954-09-29,1955-05-16,230,0,137,629,766,88,227,315,1081,40,313,MT - Helena
5,1955-1956,1955-09-21,1956-05-04,227,0,220,719,939,104,300,404,1343,58,471,MT - Helena
6,1956-1957,1956-10-27,1957-04-11,167,0,200,659,859,77,237,314,1173,41,448,MT - Helena
7,1957-1958,1957-09-18,1958-04-27,222,0,49,406,455,99,134,233,688,44,247,MT - Helena
8,1958-1959,1958-10-09,1959-04-24,198,0,142,598,740,77,315,392,1132,36,284,MT - Helena
9,1959-1960,1959-10-07,1960-04-29,206,0,155,593,748,110,209,319,1067,36,299,MT - Helena
10,1960-1961,1960-10-29,1961-04-27,181,0,36,417,453,47,26,73,526,25,131,MT - Helena
11,1961-1962,1961-10-21,1962-04-09,171,0,178,616,794,74,141,215,1009,45,366,MT - Helena
12,1962-1963,1962-09-07,1963-04-21,227,0,113,461,574,43,86,129,703,33,252,MT - Helena
13,1963-1964,1963-11-10,1964-05-04,177,0,99,532,631,98,309,407,1038,47,312,MT - Helena
14,1964-1965,1964-11-13,1965-05-06,175,0,102,552,654,85,175,260,914,44,311,MT - Helena
15,1965-1966,1965-09-15,1966-04-28,226,0,74,502,576,61,49,110,686,40,237,MT - Helena
16,1966-1967,1966-11-06,1967-05-12,188,0,54,431,485,125,176,301,786,43,280,MT - Helena
17,1967-1968,1967-11-01,1968-04-07,159,0,129,519,648,74,269,343,991,36,288,MT - Helena
18,1968-1969,1968-09-20,1969-06-12,266,0,257,784,1041,113,541,654,1695,50,550,MT - Helena
19,1969-1970,1969-10-10,1970-05-12,215,0,84,547,631,76,115,191,822,37,239,MT - Helena
20,1970-1971,1970-10-05,1971-04-18,196,0,133,580,713,63,140,203,916,36,263,MT - Helena
21,1971-1972,1971-10-15,1972-04-16,185,0,157,614,771,80,256,336,1107,47,368,MT - Helena
22,1972-1973,1972-09-27,1973-04-20,206,0,181,654,835,47,99,146,981,30,265,MT - Helena
23,1973-1974,1973-09-14,1974-05-15,244,0,125,478,603,73,187,260,863,36,293,MT - Helena
24,1974-1975,1974-10-05,1975-05-20,228,0,139,579,718,91,281,372,1090,47,327,MT - Helena
25,1975-1976,1975-10-13,1976-04-28,199,0,111,487,598,73,63,136,734,46,267,MT - Helena
26,1976-1977,1976-11-21,1977-05-17,178,0,65,403,468,54,102,156,624,27,156,MT - Helena
27,1977-1978,1977-10-10,1978-04-07,180,0,160,541,701,90,386,476,1177,49,375,MT - Helena
28,1978-1979,1978-11-09,1979-04-24,167,0,283,734,1017,120,572,692,1709,54,490,MT - Helena
29,1979-1980,1979-10-20,1980-04-10,174,0,127,545,672,67,174,241,913,35,261,MT - Helena
30,1980-1981,1980-10-15,1981-04-03,171,0,57,403,460,30,36,66,526,21,126,MT - Helena
31,1981-1982,1981-10-11,1982-05-29,231,0,132,546,678,92,200,292,970,47,315,MT - Helena
32,1982-1983,1982-09-13,1983-05-13,243,0,66,418,484,66,117,183,667,31,155,MT - Helena
33,1983-1984,1983-09-18,1984-05-05,231,0,163,524,687,54,134,188,875,33,201,MT - Helena
34,1984-1985,1984-09-23,1985-04-04,194,0,203,694,897,73,206,279,1176,44,288,MT - Helena
35,1985-1986,1985-09-06,1986-05-11,248,0,217,675,892,98,352,450,1342,49,446,MT - Helena
36,1986-1987,1986-11-05,1987-05-21,198,0,87,505,592,51,108,159,751,26,148,MT - Helena
37,1987-1988,1987-10-15,1988-04-25,194,0,85,496,581,42,48,90,671,29,173,MT - Helena
38,1988-1989,1988-09-17,1989-05-29,255,0,199,635,834,123,359,482,1316,58,477,MT - Helena
39,1989-1990,1989-10-28,1990-05-15,200,0,69,446,515,55,78,133,648,34,199,MT - Helena
40,1990-1991,1990-10-06,1991-05-03,210,0,127,533,660,79,186,265,925,45,388,MT - Helena
41,1991-1992,1991-10-26,1992-04-12,170,0,75,460,535,58,221,279,814,21,148,MT - Helena
42,1992-1993,1992-08-22,1993-04-12,234,0,203,639,842,92,383,475,1317,41,347,MT - Helena
43,1993-1994,1993-10-07,1994-04-26,202,0,69,488,557,56,61,117,674,33,221,MT - Helena
44,1994-1995,1994-11-05,1995-05-13,190,0,98,523,621,49,67,116,737,29,191,MT - Helena
49,1999-2000,1999-12-01,2000-03-08,99,7,38,288,326,24,33,57,383,14,85,MT - Helena
54,2004-2005,2004-11-03,2005-03-24,142,0,95,391,486,47,110,157,643,27,207,MT - Helena
55,2005-2006,2005-11-14,2006-04-17,155,0,82,350,432,31,117,148,580,17,96,MT - Helena
56,2006-2007,2006-10-17,2007-04-04,170,0,83,396,479,34,47,81,560,23,133,MT - Helena
57,2007-2008,2007-11-19,2008-04-24,158,0,76,422,498,53,93,146,644,30,185,MT - Helena
58,2008-2009,2008-10-12,2009-06-08,240,0,104,448,552,66,104,170,722,33,265,MT - Helena
59,2009-2010,2009-10-07,2010-05-05,211,0,146,508,654,47,271,318,972,28,188,MT - Helena
60,2010-2011,2010-11-16,2011-04-30,166,0,160,525,685,54,170,224,909,27,260,MT - Helena
61,2011-2012,2011-11-05,2012-03-19,136,0,45,369,414,59,109,168,582,20,154,MT - Helena
62,2012-2013,2012-10-23,2013-04-22,182,0,69,412,481,59,170,229,710,19,143,MT - Helena
65,2015-2016,2015-11-04,2016-02-29,118,0,83,323,406,30,214,244,650,17,86,MT - Helena
66,2016-2017,2016-10-11,2017-03-12,153,0,180,511,691,76,350,426,1117,26,261,MT - Helena
67,2017-2018,2017-10-02,2018-04-13,194,0,159,578,737,97,387,484,1221,47,389,MT - Helena
68,2018-2019,2018-10-09,2019-04-28,202,0,173,611,784,84,336,420,1204,43,356,MT - Helena
69,2019-2020,2019-09-29,2020-04-15,200,0,56,418,474,63,95,158,632,32,194,MT - Helena
2,1952-1953,1952-11-26,1953-04-14,140,1,17,190,207,137,262,399,606,47,203,MT - Heron
3,1953-1954,1953-11-20,1954-04-29,161,5,37,268,305,130,797,927,1232,40,235,MT - Heron
4,1954-1955,1954-11-27,1955-04-11,136,7,51,317,368,189,892,1081,1449,56,318,MT - Heron
5,1955-1956,1955-10-28,1956-04-08,164,11,102,400,502,236,1281,1517,2019,74,438,MT - Heron
6,1956-1957,1956-10-24,1957-04-08,167,6,109,424,533,205,1099,1304,1837,54,400,MT - Heron
7,1957-1958,1957-10-22,1958-03-18,148,13,18,212,230,80,494,574,804,39,138,MT - Heron
8,1958-1959,1958-11-04,1959-05-05,183,6,53,321,374,119,878,997,1371,50,235,MT - Heron
9,1959-1960,1959-11-04,1960-04-15,164,1,85,408,493,157,1059,1216,1709,47,302,MT - Heron
10,1960-1961,1960-10-28,1961-05-05,190,4,29,248,277,95,313,408,685,36,154,MT - Heron
11,1961-1962,1961-10-21,1962-04-28,190,6,93,440,533,154,1119,1273,1806,43,284,MT - Heron
12,1962-1963,1962-11-16,1963-04-17,153,5,64,271,335,53,196,249,584,23,133,MT - Heron
13,1963-1964,1963-11-21,1964-05-03,165,0,34,330,364,203,1233,1436,1800,65,327,MT - Heron
14,1964-1965,1964-11-11,1965-04-16,157,1,54,364,418,190,1045,1235,1653,58,347,MT - Heron
15,1965-1966,1965-11-23,1966-03-30,128,0,35,250,285,133,799,932,1217,50,251,MT - Heron
16,1966-1967,1966-10-21,1967-03-29,160,0,18,234,252,121,626,747,999,46,213,MT - Heron
17,1967-1968,1967-11-26,1968-04-14,141,0,52,253,305,79,541,620,925,35,174,MT - Heron
18,1968-1969,1968-11-08,1969-04-04,148,1,102,387,489,176,1109,1285,1774,58,399,MT - Heron
19,1969-1970,1969-11-17,1970-05-11,176,3,49,286,335,92,614,706,1041,36,176,MT - Heron
20,1970-1971,1970-11-20,1971-04-11,143,3,56,317,373,184,1011,1195,1568,60,365,MT - Heron
21,1971-1972,1971-10-31,1972-04-17,170,0,77,381,458,248,1154,1402,1860,71,488,MT - Heron
22,1972-1973,1972-11-23,1973-04-18,147,18,82,335,417,63,377,440,857,30,154,MT - Heron
23,1973-1974,1973-11-01,1974-04-02,153,3,56,259,315,148,572,720,1035,53,273,MT - Heron
24,1974-1975,1974-11-23,1975-05-24,183,1,45,325,370,184,1071,1255,1625,57,325,MT - Heron
25,1975-1976,1975-10-23,1976-04-06,167,0,50,347,397,138,881,1019,1416,54,253,MT - Heron
26,1976-1977,1976-11-25,1977-03-21,117,7,43,240,283,59,412,471,754,25,102,MT - Heron
27,1977-1978,1977-11-15,1978-05-04,171,0,67,281,348,168,1001,1169,1517,49,291,MT - Heron
28,1978-1979,1978-11-09,1979-04-02,145,0,140,490,630,154,1098,1252,1882,62,360,MT - Heron
29,1979-1980,1979-11-23,1980-04-07,137,0,60,284,344,119,462,581,925,42,237,MT - Heron
30,1980-1981,1980-11-17,1981-04-13,148,0,22,177,199,66,127,193,392,26,116,MT - Heron
31,1981-1982,1981-11-25,1982-04-15,142,3,68,308,376,161,838,999,1375,57,338,MT - Heron
32,1982-1983,1982-10-18,1983-04-11,176,0,31,248,279,81,451,532,811,30,138,MT - Heron
33,1983-1984,1983-11-23,1984-05-03,163,8,82,311,393,93,647,740,1133,39,181,MT - Heron
34,1984-1985,1984-10-18,1985-05-11,206,2,82,454,536,199,1055,1254,1790,64,374,MT - Heron
35,1985-1986,1985-10-31,1986-05-13,195,2,94,374,468,112,734,846,1314,41,246,MT - Heron
36,1986-1987,1986-11-07,1987-03-27,141,1,34,236,270,80,557,637,907,47,156,MT - Heron
37,1987-1988,1987-11-16,1988-04-03,140,5,52,300,352,84,478,562,914,37,188,MT - Heron
38,1988-1989,1988-11-12,1989-04-03,143,2,63,325,388,156,753,909,1297,55,296,MT - Heron
39,1989-1990,1989-11-13,1990-04-26,165,3,28,234,262,135,616,751,1013,44,218,MT - Heron
40,1990-1991,1990-11-03,1991-04-11,160,6,88,339,427,161,717,878,1305,47,311,MT - Heron
41,1991-1992,1991-10-25,1992-04-07,166,15,22,205,227,79,312,391,618,33,134,MT - Heron
42,1992-1993,1992-11-09,1993-04-05,148,0,100,380,480,125,1027,1152,1632,36,237,MT - Heron
43,1993-1994,1993-11-13,1994-03-21,129,0,47,239,286,79,374,453,739,33,142,MT - Heron
44,1994-1995,1994-10-30,1995-04-15,168,1,57,267,324,108,446,554,878,46,205,MT - Heron
45,1995-1996,1995-11-06,1996-05-03,180,0,79,311,390,119,386,505,895,43,242,MT - Heron
46,1996-1997,1996-11-04,1997-03-31,148,4,79,320,399,231,1609,1840,2239,69,408,MT - Heron
47,1997-1998,1997-11-17,1998-03-10,114,7,34,168,202,70,273,343,545,37,134,MT - Heron
48,1998-1999,1998-11-10,1999-05-08,180,0,30,240,270,101,596,697,967,57,183,MT - Heron
49,1999-2000,1999-10-31,2000-04-14,167,1,20,193,213,130,678,808,1021,42,195,MT - Heron
50,2000-2001,2000-11-08,2001-04-13,157,5,54,308,362,115,801,916,1278,48,224,MT - Heron
51,2001-2002,2001-11-26,2002-04-04,130,0,45,252,297,191,799,990,1287,59,338,MT - Heron
52,2002-2003,2002-10-30,2003-05-17,200,1,17,202,219,65,181,246,465,34,108,MT - Heron
53,2003-2004,2003-10-31,2004-03-31,153,1,51,264,315,138,903,1041,1356,50,259,MT - Heron
54,2004-2005,2004-10-31,2005-04-18,170,1,31,265,296,59,127,186,482,32,129,MT - Heron
55,2005-2006,2005-11-06,2006-05-08,184,12,33,284,317,76,305,381,698,40,146,MT - Heron
56,2006-2007,2006-10-30,2007-04-03,156,3,46,269,315,103,487,590,905,44,201,MT - Heron
57,2007-2008,2007-11-23,2008-04-25,155,1,54,303,357,243,1391,1634,1991,62,374,MT - Heron
58,2008-2009,2008-11-22,2009-04-14,144,0,71,312,383,186,1004,1190,1573,51,355,MT - Heron
59,2009-2010,2009-10-29,2010-04-08,162,5,25,197,222,38,61,99,321,23,82,MT - Heron
60,2010-2011,2010-11-18,2011-04-29,163,10,57,261,318,171,911,1082,1400,62,308,MT - Heron
61,2011-2012,2011-11-07,2012-04-08,154,0,29,244,273,156,605,761,1034,51,249,MT - Heron
62,2012-2013,2012-10-24,2013-05-22,211,1,33,216,249,134,601,735,984,63,243,MT - Heron
63,2013-2014,2013-11-03,2014-04-28,177,0,74,307,381,123,661,784,1165,51,258,MT - Heron
64,2014-2015,2014-11-11,2015-03-09,119,1,35,195,230,75,413,488,718,23,116,MT - Heron
65,2015-2016,2015-11-05,2016-03-25,142,0,28,161,189,108,383,491,680,37,158,MT - Heron
66,2016-2017,2016-11-30,2017-04-10,132,1,88,292,380,166,946,1112,1492,48,287,MT - Heron
67,2017-2018,2017-11-02,2018-04-17,167,0,52,253,305,218,889,1107,1412,58,326,MT - Heron
68,2018-2019,2018-11-09,2019-04-02,145,0,52,285,337,143,675,818,1155,55,300,MT - Heron
69,2019-2020,2019-10-28,2020-04-05,161,8,24,223,247,134,537,671,918,58,229,MT - Heron
0,1950-1951,1950-11-01,1951-05-01,182,0,91,473,564,104,319,423,987,53,294,MT - Kalispell
1,1951-1952,1951-10-16,1952-04-06,174,0,132,526,658,157,809,966,1624,69,503,MT - Kalispell
2,1952-1953,1952-11-23,1953-04-12,141,0,29,238,267,67,176,243,510,39,153,MT - Kalispell
3,1953-1954,1953-12-01,1954-04-29,150,0,69,342,411,86,307,393,804,47,260,MT - Kalispell
4,1954-1955,1954-11-27,1955-04-26,151,0,93,418,511,83,396,479,990,54,275,MT - Kalispell
5,1955-1956,1955-10-30,1956-05-02,186,0,162,552,714,125,814,939,1653,68,442,MT - Kalispell
6,1956-1957,1956-10-25,1957-04-07,165,0,168,520,688,95,427,522,1210,51,373,MT - Kalispell
7,1957-1958,1957-10-21,1958-04-21,183,0,36,309,345,81,343,424,769,54,198,MT - Kalispell
8,1958-1959,1958-10-10,1959-04-23,196,0,101,431,532,116,561,677,1209,57,315,MT - Kalispell
9,1959-1960,1959-10-28,1960-04-21,177,0,179,644,823,138,634,772,1595,60,430,MT - Kalispell
10,1960-1961,1960-10-28,1961-05-06,191,0,78,344,422,93,151,244,666,50,208,MT - Kalispell
11,1961-1962,1961-10-20,1962-06-04,228,0,143,576,719,131,562,693,1412,60,405,MT - Kalispell
12,1962-1963,1962-11-16,1963-05-03,169,0,107,387,494,76,179,255,749,48,300,MT - Kalispell
13,1963-1964,1963-11-06,1964-05-22,199,0,62,505,567,124,679,803,1370,73,388,MT - Kalispell
14,1964-1965,1964-10-27,1965-05-02,188,0,109,527,636,131,523,654,1290,74,469,MT - Kalispell
15,1965-1966,1965-09-15,1966-05-22,250,0,78,450,528,94,392,486,1014,61,314,MT - Kalispell
16,1966-1967,1966-11-06,1967-05-12,188,0,48,343,391,97,194,291,682,59,262,MT - Kalispell
17,1967-1968,1967-11-20,1968-05-06,169,0,86,374,460,76,150,226,686,41,260,MT - Kalispell
18,1968-1969,1968-09-19,1969-04-29,223,0,178,647,825,134,785,919,1744,64,498,MT - Kalispell
19,1969-1970,1969-10-24,1970-05-11,200,0,84,452,536,115,429,544,1080,59,308,MT - Kalispell
20,1970-1971,1970-10-25,1971-03-30,157,0,102,430,532,119,252,371,903,64,403,MT - Kalispell
21,1971-1972,1971-10-26,1972-04-29,187,0,130,540,670,151,485,636,1306,84,521,MT - Kalispell
22,1972-1973,1972-09-25,1973-04-13,201,0,124,501,625,72,169,241,866,46,255,MT - Kalispell
23,1973-1974,1973-10-02,1974-04-27,208,0,97,371,468,108,144,252,720,75,366,MT - Kalispell
24,1974-1975,1974-10-04,1975-05-24,233,0,101,534,635,110,365,475,1110,62,355,MT - Kalispell
25,1975-1976,1975-10-22,1976-04-20,182,0,77,415,492,93,233,326,818,54,241,MT - Kalispell
26,1976-1977,1976-11-12,1977-04-20,160,0,81,366,447,71,140,211,658,42,192,MT - Kalispell
27,1977-1978,1977-11-07,1978-04-23,168,0,140,467,607,131,596,727,1334,63,392,MT - Kalispell
28,1978-1979,1978-10-21,1979-04-19,181,0,250,746,996,123,616,739,1735,70,519,MT - Kalispell
29,1979-1980,1979-10-19,1980-04-05,170,0,114,460,574,104,289,393,967,51,312,MT - Kalispell
30,1980-1981,1980-10-21,1981-04-13,175,0,50,306,356,79,104,183,539,40,183,MT - Kalispell
31,1981-1982,1981-11-17,1982-05-03,168,0,130,508,638,108,466,574,1212,60,407,MT - Kalispell
32,1982-1983,1982-11-07,1983-04-26,171,0,65,314,379,73,127,200,579,43,171,MT - Kalispell
33,1983-1984,1983-11-07,1984-04-23,169,0,139,436,575,78,233,311,886,46,278,MT - Kalispell
34,1984-1985,1984-10-19,1985-04-19,183,0,184,612,796,96,563,659,1455,57,404,MT - Kalispell
35,1985-1986,1985-10-06,1986-04-29,206,0,163,543,706,98,561,659,1365,52,354,MT - Kalispell
36,1986-1987,1986-11-07,1987-04-12,157,0,81,377,458,97,281,378,836,46,227,MT - Kalispell
37,1987-1988,1987-11-16,1988-04-25,162,0,86,381,467,74,258,332,799,48,231,MT - Kalispell
38,1988-1989,1988-11-06,1989-04-16,162,0,124,447,571,107,252,359,930,71,366,MT - Kalispell
39,1989-1990,1989-10-30,1990-05-08,191,0,59,318,377,100,181,281,658,56,253,MT - Kalispell
40,1990-1991,1990-10-05,1991-04-26,204,0,139,489,628,140,463,603,1231,54,389,MT - Kalispell
41,1991-1992,1991-10-25,1992-04-11,170,0,50,290,340,69,143,212,552,41,155,MT - Kalispell
42,1992-1993,1992-09-13,1993-04-13,213,0,158,539,697,95,563,658,1355,47,327,MT - Kalispell
43,1993-1994,1993-11-17,1994-04-14,149,6,80,369,449,90,229,319,768,38,230,MT - Kalispell
44,1994-1995,1994-10-29,1995-06-06,221,5,87,405,492,67,2,69,561,37,186,MT - Kalispell
45,1995-1996,1995-11-01,1996-05-03,185,15,138,473,611,108,278,386,997,38,279,MT - Kalispell
46,1996-1997,1996-10-19,1997-04-08,172,9,154,511,665,217,1648,1865,2530,80,565,MT - Kalispell
47,1997-1998,1997-11-16,1998-04-12,148,0,53,298,351,49,93,142,493,35,159,MT - Kalispell
48,1998-1999,1998-11-06,1999-05-10,186,0,49,303,352,82,72,154,506,48,176,MT - Kalispell
54,2004-2005,2004-10-18,2005-04-14,179,0,70,370,440,50,93,143,583,27,154,MT - Kalispell
55,2005-2006,2005-11-06,2006-04-02,148,1,78,364,442,70,245,315,757,41,195,MT - Kalispell
56,2006-2007,2006-10-29,2007-04-03,157,0,107,384,491,68,289,357,848,34,204,MT - Kalispell
57,2007-2008,2007-11-21,2008-06-10,203,3,66,395,461,94,268,362,823,50,267,MT - Kalispell
58,2008-2009,2008-12-01,2009-04-03,124,0,105,394,499,142,789,931,1430,39,319,MT - Kalispell
59,2009-2010,2009-10-11,2010-05-05,207,0,78,400,478,62,181,243,721,32,181,MT - Kalispell
60,2010-2011,2010-11-16,2011-04-19,155,0,127,422,549,85,364,449,998,51,289,MT - Kalispell
61,2011-2012,2011-11-16,2012-03-23,129,0,38,302,340,54,76,130,470,33,142,MT - Kalispell
62,2012-2013,2012-10-23,2013-05-23,213,0,38,344,382,36,78,114,496,31,115,MT - Kalispell
63,2013-2014,2013-11-03,2014-03-31,149,0,126,433,559,109,236,345,904,44,285,MT - Kalispell
64,2014-2015,2014-11-09,2015-03-03,115,0,80,358,438,91,288,379,817,29,198,MT - Kalispell
65,2015-2016,2015-11-24,2016-03-17,115,0,57,253,310,65,315,380,690,32,171,MT - Kalispell
66,2016-2017,2016-10-10,2017-03-17,159,0,146,504,650,125,647,772,1422,46,362,MT - Kalispell
67,2017-2018,2017-11-02,2018-04-05,155,11,102,401,503,123,564,687,1190,42,279,MT - Kalispell
68,2018-2019,2018-11-07,2019-04-27,172,3,107,506,613,101,413,514,1127,45,310,MT - Kalispell
69,2019-2020,2019-10-28,2020-04-03,159,1,38,345,383,67,111,178,561,40,185,MT - Kalispell
0,1950-1951,1950-10-02,1951-05-01,212,0,90,453,543,96,275,371,914,62,315,MT - Missoula
1,1951-1952,1951-10-29,1952-03-24,148,0,111,501,612,102,556,658,1270,56,353,MT - Missoula
2,1952-1953,1952-11-22,1953-05-25,185,0,38,296,334,60,88,148,482,38,143,MT - Missoula
3,1953-1954,1953-12-01,1954-04-28,149,0,42,292,334,60,139,199,533,35,189,MT - Missoula
4,1954-1955,1954-11-30,1955-05-14,166,1,79,453,532,75,205,280,812,57,276,MT - Missoula
5,1955-1956,1955-10-30,1956-04-24,178,0,145,547,692,127,429,556,1248,75,472,MT - Missoula
6,1956-1957,1956-10-23,1957-03-25,154,0,135,452,587,70,180,250,837,49,339,MT - Missoula
7,1957-1958,1957-10-22,1958-04-28,189,0,21,269,290,68,82,150,440,51,142,MT - Missoula
8,1958-1959,1958-11-14,1959-05-16,184,0,69,355,424,96,267,363,787,56,263,MT - Missoula
9,1959-1960,1959-10-28,1960-04-25,181,0,130,499,629,88,328,416,1045,54,332,MT - Missoula
10,1960-1961,1960-10-29,1961-05-05,189,0,92,426,518,73,224,297,815,42,171,MT - Missoula
11,1961-1962,1961-10-20,1962-03-23,155,0,155,510,665,94,213,307,972,56,302,MT - Missoula
12,1962-1963,1962-11-22,1963-05-03,163,0,129,386,515,86,196,282,797,38,291,MT - Missoula
13,1963-1964,1963-11-10,1964-05-04,177,0,104,499,603,107,435,542,1145,63,340,MT - Missoula
14,1964-1965,1964-10-17,1965-04-16,182,0,116,535,651,131,407,538,1189,67,405,MT - Missoula
15,1965-1966,1965-09-15,1966-04-27,225,0,62,373,435,96,174,270,705,53,250,MT - Missoula
16,1966-1967,1966-10-22,1967-05-11,202,0,29,268,297,75,50,125,422,51,168,MT - Missoula
17,1967-1968,1967-10-28,1968-04-21,177,0,94,385,479,74,187,261,740,47,248,MT - Missoula
18,1968-1969,1968-11-08,1969-03-28,141,0,119,489,608,110,533,643,1251,61,398,MT - Missoula
19,1969-1970,1969-11-16,1970-05-11,177,0,63,359,422,93,204,297,719,52,231,MT - Missoula
20,1970-1971,1970-10-25,1971-04-24,182,0,74,372,446,79,146,225,671,59,299,MT - Missoula
21,1971-1972,1971-10-27,1972-04-29,186,0,102,434,536,141,402,543,1079,93,427,MT - Missoula
22,1972-1973,1972-09-24,1973-04-14,203,0,123,437,560,42,108,150,710,28,141,MT - Missoula
23,1973-1974,1973-10-31,1974-04-02,154,0,87,333,420,93,199,292,712,51,290,MT - Missoula
24,1974-1975,1974-10-05,1975-04-28,206,0,78,439,517,100,279,379,896,61,283,MT - Missoula
25,1975-1976,1975-10-21,1976-04-26,189,0,69,361,430,81,146,227,657,47,208,MT - Missoula
26,1976-1977,1976-10-05,1977-04-20,198,0,78,466,544,58,107,165,709,38,169,MT - Missoula
27,1977-1978,1977-10-31,1978-05-24,206,0,96,355,451,101,340,441,892,51,258,MT - Missoula
28,1978-1979,1978-11-09,1979-04-20,163,0,230,570,800,103,652,755,1555,56,415,MT - Missoula
29,1979-1980,1979-11-03,1980-05-23,203,0,115,391,506,90,209,299,805,46,271,MT - Missoula
30,1980-1981,1980-11-14,1981-03-30,137,0,39,243,282,31,19,50,332,22,88,MT - Missoula
31,1981-1982,1981-10-20,1982-04-19,182,0,117,425,542,110,391,501,1043,59,337,MT - Missoula
32,1982-1983,1982-10-17,1983-03-07,142,0,76,277,353,47,74,121,474,33,126,MT - Missoula
33,1983-1984,1983-09-19,1984-03-25,189,0,135,401,536,65,304,369,905,35,201,MT - Missoula
34,1984-1985,1984-10-18,1985-04-22,187,0,115,447,562,61,171,232,794,44,218,MT - Missoula
35,1985-1986,1985-10-06,1986-05-14,221,0,143,499,642,71,306,377,1019,46,261,MT - Missoula
36,1986-1987,1986-11-07,1987-04-12,157,0,89,386,475,56,237,293,768,35,148,MT - Missoula
37,1987-1988,1987-11-16,1988-05-31,198,0,94,369,463,56,138,194,657,37,189,MT - Missoula
38,1988-1989,1988-11-10,1989-04-17,159,0,122,444,566,89,162,251,817,52,287,MT - Missoula
39,1989-1990,1989-10-28,1990-04-28,183,0,51,316,367,47,79,126,493,32,130,MT - Missoula
40,1990-1991,1990-10-06,1991-04-29,206,3,114,445,559,76,178,254,813,47,294,MT - Missoula
41,1991-1992,1991-10-26,1992-04-09,167,0,53,304,357,45,80,125,482,27,107,MT - Missoula
42,1992-1993,1992-11-04,1993-04-07,155,0,153,499,652,68,312,380,1032,35,238,MT - Missoula
43,1993-1994,1993-11-04,1994-03-23,140,0,49,331,380,44,59,103,483,27,130,MT - Missoula
44,1994-1995,1994-10-31,1995-03-26,147,0,69,325,394,40,90,130,524,24,110,MT - Missoula
45,1995-1996,1995-11-06,1996-05-02,179,0,100,366,466,83,178,261,727,50,258,MT - Missoula
46,1996-1997,1996-10-16,1997-04-09,176,0,105,409,514,178,642,820,1334,76,426,MT - Missoula
47,1997-1998,1997-11-19,1998-04-07,140,0,49,279,328,56,131,187,515,31,134,MT - Missoula
48,1998-1999,1998-11-08,1999-05-09,183,1,50,301,351,72,64,136,487,46,163,MT - Missoula
49,1999-2000,1999-10-15,2000-04-06,175,0,33,272,305,50,102,152,457,32,124,MT - Missoula
50,2000-2001,2000-11-04,2001-06-04,213,6,112,469,581,68,376,444,1025,39,217,MT - Missoula
51,2001-2002,2001-10-25,2002-05-08,196,0,68,368,436,89,156,245,681,48,246,MT - Missoula
52,2002-2003,2002-10-29,2003-04-05,159,0,51,287,338,60,58,118,456,36,129,MT - Missoula
53,2003-2004,2003-10-30,2004-03-07,130,0,97,343,440,72,204,276,716,42,233,MT - Missoula
54,2004-2005,2004-11-21,2005-04-14,145,0,58,295,353,48,117,165,518,32,164,MT - Missoula
55,2005-2006,2005-11-05,2006-04-17,164,0,75,326,401,41,97,138,539,27,106,MT - Missoula
56,2006-2007,2006-10-30,2007-05-04,187,0,57,313,370,38,40,78,448,29,120,MT - Missoula
57,2007-2008,2007-11-18,2008-06-11,207,0,59,336,395,89,121,210,605,57,221,MT - Missoula
58,2008-2009,2008-12-01,2009-04-28,149,0,85,332,417,72,184,256,673,38,211,MT - Missoula
59,2009-2010,2009-10-09,2010-04-13,187,0,67,355,422,41,21,62,484,31,119,MT - Missoula
60,2010-2011,2010-11-14,2011-04-19,157,0,124,400,524,102,334,436,960,49,274,MT - Missoula
61,2011-2012,2011-11-01,2012-05-02,184,0,38,339,377,76,161,237,614,44,179,MT - Missoula
62,2012-2013,2012-10-22,2013-04-30,191,0,51,316,367,81,210,291,658,46,207,MT - Missoula
63,2013-2014,2013-11-03,2014-05-11,190,0,105,392,497,102,212,314,811,44,283,MT - Missoula
64,2014-2015,2014-11-10,2015-04-12,154,0,78,332,410,52,168,220,630,24,135,MT - Missoula
65,2015-2016,2015-11-05,2016-03-17,134,0,77,300,377,51,254,305,682,31,153,MT - Missoula
66,2016-2017,2016-10-11,2017-05-17,219,0,128,441,569,105,475,580,1149,49,307,MT - Missoula
67,2017-2018,2017-10-02,2018-04-02,183,0,70,348,418,86,282,368,786,45,209,MT - Missoula
68,2018-2019,2018-11-06,2019-04-28,174,0,113,449,562,99,490,589,1151,56,337,MT - Missoula
69,2019-2020,2019-09-29,2020-04-15,200,0,38,342,380,67,107,174,554,43,161,MT - Missoula
0,1950-1951,1950-11-09,1951-03-10,122,2,39,429,468,18,24,42,510,8,80,NE - Culbertson
1,1951-1952,1951-11-01,1952-04-09,161,4,34,452,486,49,99,148,634,12,100,NE - Culbertson
2,1952-1953,1952-11-22,1953-03-03,102,0,24,305,329,29,147,176,505,11,75,NE - Culbertson
3,1953-1954,1953-11-06,1954-03-31,146,1,29,328,357,40,183,223,580,8,57,NE - Culbertson
4,1954-1955,1954-11-29,1955-03-26,118,4,31,394,425,45,194,239,664,15,109,NE - Culbertson
5,1955-1956,1955-11-15,1956-04-04,142,0,53,440,493,50,171,221,714,21,154,NE - Culbertson
6,1956-1957,1956-11-15,1957-04-07,144,0,35,367,402,39,60,99,501,17,104,NE - Culbertson
7,1957-1958,1957-10-25,1958-03-30,157,0,29,433,462,63,225,288,750,25,160,NE - Culbertson
8,1958-1959,1958-11-17,1959-04-12,147,0,66,419,485,52,142,194,679,19,163,NE - Culbertson
9,1959-1960,1959-10-01,1960-03-21,173,1,80,555,635,69,298,367,1002,24,212,NE - Culbertson
10,1960-1961,1960-11-28,1961-04-11,135,0,31,366,397,38,104,142,539,16,87,NE - Culbertson
11,1961-1962,1961-11-16,1962-03-14,119,0,95,456,551,36,139,175,726,15,152,NE - Culbertson
12,1962-1963,1962-11-16,1963-03-15,120,0,77,394,471,51,156,207,678,15,126,NE - Culbertson
13,1963-1964,1963-12-01,1964-04-05,127,0,52,432,484,38,96,134,618,13,99,NE - Culbertson
14,1964-1965,1964-11-19,1965-03-28,130,0,57,552,609,61,171,232,841,14,143,NE - Culbertson
20,1970-1971,1970-11-23,1971-03-27,125,0,56,448,504,36,112,148,652,9,72,NE - Culbertson
21,1971-1972,1971-10-30,1972-02-29,123,2,46,394,440,18,27,45,485,6,38,NE - Culbertson
22,1972-1973,1972-10-31,1973-04-09,161,2,97,450,547,39,124,163,710,12,100,NE - Culbertson
23,1973-1974,1973-11-05,1974-04-05,152,0,85,465,550,53,220,273,823,17,133,NE - Culbertson
24,1974-1975,1974-11-30,1975-04-02,124,0,37,454,491,37,65,102,593,12,89,NE - Culbertson
25,1975-1976,1975-11-19,1976-03-30,133,0,62,420,482,66,194,260,742,14,129,NE - Culbertson
26,1976-1977,1976-11-27,1977-04-03,128,0,48,472,520,27,38,65,585,8,62,NE - Culbertson
27,1977-1978,1977-11-22,1978-03-07,106,3,106,494,600,30,133,163,763,10,88,NE - Culbertson
28,1978-1979,1978-11-12,1979-03-03,112,0,123,506,629,27,109,136,765,13,100,NE - Culbertson
29,1979-1980,1979-11-21,1980-04-05,137,2,60,425,485,87,219,306,791,14,134,NE - Culbertson
30,1980-1981,1980-10-28,1981-03-22,146,0,33,439,472,27,35,62,534,10,64,NE - Culbertson
32,1982-1983,1982-11-23,1983-04-14,143,2,35,343,378,59,178,237,615,15,100,NE - Culbertson
33,1983-1984,1983-11-09,1984-04-30,174,6,127,554,681,87,316,403,1084,22,248,NE - Culbertson
34,1984-1985,1984-11-27,1985-03-31,125,20,72,436,508,44,164,208,716,14,139,NE - Culbertson
35,1985-1986,1985-09-29,1986-04-27,211,9,67,439,506,49,130,179,685,17,111,NE - Culbertson
36,1986-1987,1986-10-12,1987-04-13,184,3,25,394,419,58,80,138,557,18,106,NE - Culbertson
37,1987-1988,1987-11-16,1988-04-02,139,3,66,460,526,53,203,256,782,16,125,NE - Culbertson
39,1989-1990,1989-12-01,1990-03-25,115,3,57,383,440,24,113,137,577,7,78,NE - Culbertson
40,1990-1991,1990-10-08,1991-03-30,174,1,66,443,509,49,64,113,622,19,111,NE - Culbertson
41,1991-1992,1991-10-29,1992-03-19,143,6,21,301,322,42,69,111,433,12,86,NE - Culbertson
42,1992-1993,1992-11-24,1993-04-20,148,19,100,497,597,78,287,365,962,19,173,NE - Culbertson
43,1993-1994,1993-11-14,1994-04-30,168,3,63,429,492,91,159,250,742,22,186,NE - Culbertson
44,1994-1995,1994-11-04,1995-04-18,166,1,46,388,434,64,125,189,623,21,150,NE - Culbertson
45,1995-1996,1995-09-21,1996-04-15,208,1,69,557,626,38,31,69,695,17,128,NE - Culbertson
46,1996-1997,1996-11-14,1997-04-13,151,2,72,474,546,43,55,98,644,15,117,NE - Culbertson
47,1997-1998,1997-10-25,1998-04-01,159,1,37,355,392,41,53,94,486,16,90,NE - Culbertson
48,1998-1999,1998-11-07,1999-04-03,148,0,39,367,406,41,46,87,493,15,99,NE - Culbertson
49,1999-2000,1999-11-23,2000-04-16,146,5,15,339,354,30,35,65,419,8,62,NE - Culbertson
50,2000-2001,2000-11-07,2001-03-16,130,16,61,428,489,66,191,257,746,20,150,NE - Culbertson
51,2001-2002,2001-11-27,2002-03-25,119,4,35,396,431,25,42,67,498,9,77,NE - Culbertson
52,2002-2003,2002-10-23,2003-04-08,168,2,50,440,490,47,78,125,615,15,114,NE - Culbertson
53,2003-2004,2003-11-23,2004-04-12,142,2,39,392,431,38,65,103,534,13,104,NE - Culbertson
56,2006-2007,2006-11-27,2007-04-06,131,13,63,387,450,35,235,270,720,6,68,NE - Culbertson
58,2008-2009,2008-11-11,2009-04-05,146,17,45,429,474,20,23,43,517,8,57,NE - Culbertson
59,2009-2010,2009-10-10,2010-03-11,153,9,68,418,486,46,127,173,659,12,102,NE - Culbertson
60,2010-2011,2010-11-21,2011-04-16,147,1,59,450,509,38,67,105,614,11,117,NE - Culbertson
62,2012-2013,2012-12-01,2013-05-02,153,14,43,402,445,52,188,240,685,13,109,NE - Culbertson
63,2013-2014,2013-11-22,2014-04-14,144,0,85,488,573,44,105,149,722,15,140,NE - Culbertson
64,2014-2015,2014-11-12,2015-03-04,113,0,54,393,447,21,77,98,545,7,54,NE - Culbertson
65,2015-2016,2015-11-12,2016-02-29,110,1,20,262,282,39,77,116,398,10,66,NE - Culbertson
66,2016-2017,2016-11-18,2017-05-01,165,8,38,348,386,17,19,36,422,6,41,NE - Culbertson
67,2017-2018,2017-12-01,2018-04-15,136,1,70,442,512,48,139,187,699,13,124,NE - Culbertson
68,2018-2019,2018-11-08,2019-04-12,156,1,77,462,539,45,124,169,708,12,103,NE - Culbertson
69,2019-2020,2019-10-29,2020-04-17,172,0,25,418,443,42,42,84,527,16,99,NE - Culbertson
0,1950-1951,1950-11-09,1951-03-20,132,0,86,443,529,29,48,77,606,16,140,NE - Grand Island
1,1951-1952,1951-11-01,1952-04-11,163,0,90,434,524,57,125,182,706,27,175,NE - Grand Island
2,1952-1953,1952-11-22,1953-03-07,106,0,52,311,363,46,192,238,601,20,124,NE - Grand Island
3,1953-1954,1953-11-06,1954-05-02,178,0,57,352,409,36,64,100,509,14,93,NE - Grand Island
4,1954-1955,1954-12-01,1955-03-28,118,0,67,381,448,39,130,169,617,18,133,NE - Grand Island
5,1955-1956,1955-11-02,1956-04-23,174,0,115,505,620,42,145,187,807,28,222,NE - Grand Island
6,1956-1957,1956-11-15,1957-04-11,148,0,78,396,474,30,50,80,554,17,102,NE - Grand Island
7,1957-1958,1957-10-24,1958-03-24,152,0,65,408,473,46,133,179,652,29,173,NE - Grand Island
8,1958-1959,1958-11-17,1959-04-10,145,0,94,448,542,45,70,115,657,21,164,NE - Grand Island
9,1959-1960,1959-11-05,1960-04-02,150,0,135,519,654,70,344,414,1068,29,253,NE - Grand Island
10,1960-1961,1960-11-09,1961-04-11,154,0,46,386,432,24,32,56,488,14,75,NE - Grand Island
11,1961-1962,1961-11-02,1962-04-08,158,0,155,536,691,65,275,340,1031,30,219,NE - Grand Island
12,1962-1963,1962-11-16,1963-03-14,119,0,127,451,578,35,126,161,739,23,186,NE - Grand Island
13,1963-1964,1963-12-01,1964-04-05,127,0,79,392,471,27,71,98,569,20,112,NE - Grand Island
14,1964-1965,1964-11-21,1965-03-27,127,0,120,521,641,54,136,190,831,24,208,NE - Grand Island
15,1965-1966,1965-11-26,1966-04-20,146,0,84,391,475,24,45,69,544,21,138,NE - Grand Island
16,1966-1967,1966-10-14,1967-05-04,203,0,63,444,507,40,86,126,633,18,134,NE - Grand Island
17,1967-1968,1967-11-02,1968-04-04,155,0,63,406,469,21,31,52,521,15,68,NE - Grand Island
18,1968-1969,1968-11-06,1969-03-30,145,0,139,466,605,83,439,522,1127,30,223,NE - Grand Island
19,1969-1970,1969-10-12,1970-04-01,172,0,95,433,528,45,126,171,699,26,127,NE - Grand Island
20,1970-1971,1970-10-08,1971-04-05,180,0,85,438,523,57,96,153,676,24,145,NE - Grand Island
21,1971-1972,1971-11-17,1972-04-03,139,0,76,377,453,25,34,59,512,18,129,NE - Grand Island
22,1972-1973,1972-10-28,1973-04-10,165,0,124,367,491,71,177,248,739,31,182,NE - Grand Island
23,1973-1974,1973-11-08,1974-04-04,148,0,107,405,512,70,310,380,892,25,264,NE - Grand Island
24,1974-1975,1974-11-29,1975-04-18,141,0,95,414,509,58,280,338,847,25,174,NE - Grand Island
25,1975-1976,1975-11-19,1976-03-30,133,0,78,338,416,52,108,160,576,20,123,NE - Grand Island
26,1976-1977,1976-11-12,1977-04-04,144,0,70,455,525,44,36,80,605,17,115,NE - Grand Island
27,1977-1978,1977-11-08,1978-03-12,125,0,159,518,677,64,218,282,959,33,287,NE - Grand Island
28,1978-1979,1978-11-15,1979-04-02,139,0,222,596,818,73,361,434,1252,31,287,NE - Grand Island
29,1979-1980,1979-10-22,1980-03-30,161,0,92,398,490,53,139,192,682,25,155,NE - Grand Island
30,1980-1981,1980-10-27,1981-03-07,132,0,47,337,384,27,27,54,438,8,65,NE - Grand Island
31,1981-1982,1981-10-24,1982-04-28,187,0,145,515,660,56,195,251,911,26,232,NE - Grand Island
32,1982-1983,1982-10-19,1983-04-14,178,0,55,344,399,64,139,203,602,29,153,NE - Grand Island
33,1983-1984,1983-11-09,1984-04-29,173,0,160,429,589,110,416,526,1115,27,258,NE - Grand Island
34,1984-1985,1984-11-09,1985-04-01,144,0,93,405,498,33,92,125,623,17,117,NE - Grand Island
35,1985-1986,1985-09-29,1986-03-12,165,0,94,383,477,33,74,107,584,18,111,NE - Grand Island
36,1986-1987,1986-11-01,1987-04-03,154,0,25,303,328,42,43,85,413,16,85,NE - Grand Island
37,1987-1988,1987-10-10,1988-03-17,160,0,94,424,518,50,160,210,728,20,170,NE - Grand Island
38,1988-1989,1988-11-15,1989-03-20,126,0,78,385,463,33,55,88,551,20,151,NE - Grand Island
39,1989-1990,1989-10-30,1990-04-12,165,0,66,397,463,40,58,98,561,20,157,NE - Grand Island
40,1990-1991,1990-11-06,1991-03-28,143,0,79,384,463,33,57,90,553,20,173,NE - Grand Island
41,1991-1992,1991-10-29,1992-04-21,176,0,32,259,291,45,62,107,398,17,85,NE - Grand Island
43,1993-1994,1993-10-31,1994-04-30,182,0,102,466,568,55,139,194,762,23,189,NE - Grand Island
44,1994-1995,1994-11-09,1995-04-12,155,0,67,348,415,32,92,124,539,13,104,NE - Grand Island
47,1997-1998,1997-10-25,1998-03-31,158,0,63,326,389,47,73,120,509,16,102,NE - Grand Island
48,1998-1999,1998-11-03,1999-03-12,130,0,59,282,341,28,35,63,404,13,75,NE - Grand Island
49,1999-2000,1999-12-01,2000-04-15,137,0,27,282,309,24,24,48,357,10,60,NE - Grand Island
50,2000-2001,2000-11-07,2001-03-12,126,0,120,459,579,61,186,247,826,19,170,NE - Grand Island
51,2001-2002,2001-11-27,2002-03-25,119,0,46,331,377,39,71,110,487,10,80,NE - Grand Island
52,2002-2003,2002-10-23,2003-04-08,168,0,68,386,454,47,53,100,554,17,131,NE - Grand Island
53,2003-2004,2003-11-05,2004-03-05,122,0,88,346,434,46,164,210,644,12,105,NE - Grand Island
54,2004-2005,2004-11-28,2005-03-25,118,0,67,303,370,30,105,135,505,11,81,NE - Grand Island
55,2005-2006,2005-11-16,2006-03-29,134,0,57,286,343,41,151,192,535,10,94,NE - Grand Island
56,2006-2007,2006-11-15,2007-04-05,142,1,74,339,413,20,55,75,488,12,91,NE - Grand Island
57,2007-2008,2007-11-21,2008-04-11,143,0,74,397,471,28,241,269,740,18,100,NE - Grand Island
58,2008-2009,2008-11-29,2009-04-05,128,0,75,383,458,34,82,116,574,20,158,NE - Grand Island
59,2009-2010,2009-10-09,2010-03-19,162,0,116,394,510,64,471,535,1045,23,166,NE - Grand Island
60,2010-2011,2010-11-20,2011-04-15,147,0,102,423,525,51,170,221,746,24,189,NE - Grand Island
61,2011-2012,2011-12-01,2012-02-29,91,0,27,241,268,26,107,133,401,8,52,NE - Grand Island
62,2012-2013,2012-11-26,2013-05-01,157,0,55,344,399,53,146,199,598,20,123,NE - Grand Island
63,2013-2014,2013-11-21,2014-04-14,145,0,102,446,548,34,36,70,618,22,160,NE - Grand Island
64,2014-2015,2014-11-10,2015-04-09,151,0,73,415,488,35,52,87,575,16,117,NE - Grand Island
65,2015-2016,2015-11-11,2016-03-24,135,0,44,243,287,54,129,183,470,21,133,NE - Grand Island
66,2016-2017,2016-11-18,2017-05-01,165,0,54,302,356,19,10,29,385,16,86,NE - Grand Island
67,2017-2018,2017-10-31,2018-04-15,167,0,105,430,535,52,130,182,717,23,191,NE - Grand Island
68,2018-2019,2018-10-14,2019-04-11,180,0,107,413,520,55,139,194,714,31,207,NE - Grand Island
69,2019-2020,2019-10-28,2020-04-17,173,0,38,306,344,48,59,107,451,23,107,NE - Grand Island
0,1950-1951,1950-11-08,1951-03-20,133,5,52,372,424,25,38,63,487,10,88,NE - Holdrege
2,1952-1953,1952-11-22,1953-03-04,103,1,35,245,280,45,161,206,486,10,73,NE - Holdrege
4,1954-1955,1954-12-01,1955-03-26,116,1,45,315,360,45,220,265,625,16,127,NE - Holdrege
5,1955-1956,1955-11-02,1956-04-23,174,0,86,426,512,44,129,173,685,21,142,NE - Holdrege
6,1956-1957,1956-11-15,1957-04-11,148,0,59,348,407,50,45,95,502,20,118,NE - Holdrege
7,1957-1958,1957-10-25,1958-03-28,155,1,58,328,386,70,253,323,709,27,180,NE - Holdrege
8,1958-1959,1958-11-17,1959-04-10,145,3,77,351,428,73,108,181,609,26,204,NE - Holdrege
9,1959-1960,1959-11-05,1960-04-17,165,0,108,403,511,77,334,411,922,26,205,NE - Holdrege
10,1960-1961,1960-11-29,1961-04-11,134,12,30,283,313,42,30,72,385,15,92,NE - Holdrege
11,1961-1962,1961-11-16,1962-03-18,123,1,112,403,515,55,188,243,758,20,175,NE - Holdrege
12,1962-1963,1962-11-16,1963-03-14,119,0,85,340,425,36,125,161,586,14,117,NE - Holdrege
13,1963-1964,1963-12-01,1964-04-05,127,0,58,346,404,50,96,146,550,22,139,NE - Holdrege
14,1964-1965,1964-11-20,1965-03-27,128,0,59,469,528,31,108,139,667,9,88,NE - Holdrege
15,1965-1966,1965-11-26,1966-04-12,138,0,71,368,439,24,78,102,541,17,110,NE - Holdrege
16,1966-1967,1966-10-14,1967-05-03,202,0,46,417,463,46,159,205,668,17,128,NE - Holdrege
17,1967-1968,1967-11-02,1968-04-04,155,1,44,395,439,21,44,65,504,14,92,NE - Holdrege
18,1968-1969,1968-11-14,1969-03-30,137,0,100,439,539,61,406,467,1006,24,184,NE - Holdrege
19,1969-1970,1969-10-12,1970-04-13,184,0,53,429,482,55,110,165,647,22,138,NE - Holdrege
20,1970-1971,1970-10-09,1971-03-27,170,2,58,424,482,43,139,182,664,19,128,NE - Holdrege
21,1971-1972,1971-11-18,1972-02-29,104,0,48,330,378,20,30,50,428,12,103,NE - Holdrege
22,1972-1973,1972-10-31,1973-04-10,162,0,97,374,471,47,134,181,652,20,114,NE - Holdrege
23,1973-1974,1973-11-20,1974-04-04,136,0,86,367,453,41,219,260,713,18,153,NE - Holdrege
24,1974-1975,1974-11-29,1975-04-19,142,0,48,401,449,37,165,202,651,15,101,NE - Holdrege
25,1975-1976,1975-11-20,1976-03-16,118,0,70,353,423,60,202,262,685,20,170,NE - Holdrege
26,1976-1977,1976-11-12,1977-04-04,144,0,48,450,498,27,29,56,554,8,61,NE - Holdrege
27,1977-1978,1977-11-21,1978-03-11,111,0,130,488,618,42,218,260,878,13,144,NE - Holdrege
28,1978-1979,1978-11-14,1979-04-02,140,0,141,518,659,43,141,184,843,18,150,NE - Holdrege
29,1979-1980,1979-10-31,1980-04-04,157,5,81,399,480,72,175,247,727,22,145,NE - Holdrege
30,1980-1981,1980-10-27,1981-03-22,147,5,46,326,372,19,18,37,409,8,46,NE - Holdrege
31,1981-1982,1981-11-19,1982-04-08,141,13,112,362,474,43,133,176,650,17,144,NE - Holdrege
33,1983-1984,1983-11-09,1984-04-30,174,11,140,429,569,110,474,584,1153,28,249,NE - Holdrege
37,1987-1988,1987-10-11,1988-03-17,159,11,84,362,446,34,119,153,599,14,97,NE - Holdrege
39,1989-1990,1989-11-29,1990-04-06,129,0,76,356,432,32,95,127,559,9,98,NE - Holdrege
40,1990-1991,1990-11-03,1991-03-28,146,6,93,390,483,25,57,82,565,11,74,NE - Holdrege
41,1991-1992,1991-10-30,1992-04-21,175,6,35,265,300,34,69,103,403,9,62,NE - Holdrege
42,1992-1993,1992-11-04,1993-03-19,136,5,128,462,590,67,359,426,1016,20,177,NE - Holdrege
43,1993-1994,1993-10-30,1994-04-30,183,3,99,444,543,60,174,234,777,16,143,NE - Holdrege
45,1995-1996,1995-10-24,1996-04-16,176,7,109,495,604,33,51,84,688,11,72,NE - Holdrege
46,1996-1997,1996-11-12,1997-04-12,152,1,105,424,529,27,40,67,596,13,101,NE - Holdrege
47,1997-1998,1997-10-26,1998-03-19,145,11,69,307,376,42,48,90,466,13,88,NE - Holdrege
48,1998-1999,1998-11-04,1999-03-13,130,9,52,286,338,29,44,73,411,9,73,NE - Holdrege
49,1999-2000,1999-12-01,2000-04-16,138,11,24,259,283,27,41,68,351,10,61,NE - Holdrege
50,2000-2001,2000-11-07,2001-03-16,130,20,107,420,527,68,216,284,811,19,161,NE - Holdrege
51,2001-2002,2001-11-28,2002-03-25,118,6,45,315,360,27,60,87,447,7,69,NE - Holdrege
52,2002-2003,2002-10-24,2003-04-08,167,6,54,386,440,38,51,89,529,21,123,NE - Holdrege
53,2003-2004,2003-11-23,2004-04-12,142,6,81,353,434,35,124,159,593,11,89,NE - Holdrege
54,2004-2005,2004-11-29,2005-02-28,92,4,61,232,293,18,55,73,366,6,59,NE - Holdrege
55,2005-2006,2005-11-29,2006-03-27,119,18,56,269,325,44,76,120,445,9,88,NE - Holdrege
57,2007-2008,2007-11-22,2008-03-08,108,18,74,378,452,36,108,144,596,13,100,NE - Holdrege
58,2008-2009,2008-10-23,2009-04-05,165,0,72,427,499,33,66,99,598,15,133,NE - Holdrege
59,2009-2010,2009-10-11,2010-03-20,161,8,98,423,521,45,202,247,768,13,101,NE - Holdrege
60,2010-2011,2010-11-21,2011-03-29,129,0,101,474,575,62,125,187,762,20,198,NE - Holdrege
61,2011-2012,2011-12-01,2012-02-29,91,0,37,298,335,27,88,115,450,6,53,NE - Holdrege
62,2012-2013,2012-12-01,2013-04-18,139,0,64,427,491,35,138,173,664,11,76,NE - Holdrege
63,2013-2014,2013-11-22,2014-04-14,144,0,114,518,632,41,62,103,735,18,153,NE - Holdrege
64,2014-2015,2014-11-12,2015-03-05,114,0,84,418,502,23,63,86,588,11,87,NE - Holdrege
65,2015-2016,2015-11-26,2016-03-24,120,0,38,269,307,44,132,176,483,13,79,NE - Holdrege
66,2016-2017,2016-12-01,2017-05-01,152,0,52,329,381,23,21,44,425,8,73,NE - Holdrege
67,2017-2018,2017-11-01,2018-04-16,167,5,98,486,584,49,94,143,727,14,130,NE - Holdrege
68,2018-2019,2018-10-14,2019-04-12,181,7,110,484,594,63,183,246,840,19,146,NE - Holdrege
69,2019-2020,2019-10-29,2020-04-17,172,0,41,419,460,44,71,115,575,13,101,NE - Holdrege
0,1950-1951,1950-11-08,1951-04-12,156,0,85,449,534,25,50,75,609,14,99,NE - Lincoln
1,1951-1952,1951-11-02,1952-04-09,160,0,87,406,493,45,141,186,679,21,135,NE - Lincoln
2,1952-1953,1952-11-25,1953-03-08,104,0,52,289,341,39,181,220,561,18,110,NE - Lincoln
3,1953-1954,1953-11-07,1954-03-29,143,0,49,329,378,15,8,23,401,10,62,NE - Lincoln
4,1954-1955,1954-12-01,1955-03-26,116,0,54,304,358,36,125,161,519,17,115,NE - Lincoln
5,1955-1956,1955-11-02,1956-04-06,157,0,89,395,484,37,113,150,634,24,160,NE - Lincoln
6,1956-1957,1956-11-15,1957-04-11,148,0,61,298,359,50,57,107,466,21,122,NE - Lincoln
7,1957-1958,1957-10-26,1958-03-16,142,0,56,275,331,56,130,186,517,23,128,NE - Lincoln
8,1958-1959,1958-11-17,1959-03-26,130,0,79,341,420,48,115,163,583,20,146,NE - Lincoln
9,1959-1960,1959-11-05,1960-04-02,150,0,129,419,548,79,395,474,1022,28,237,NE - Lincoln
10,1960-1961,1960-11-09,1961-04-09,152,0,48,302,350,28,28,56,406,21,98,NE - Lincoln
11,1961-1962,1961-11-15,1962-04-01,138,0,138,408,546,49,189,238,784,30,225,NE - Lincoln
12,1962-1963,1962-11-19,1963-03-13,115,0,105,346,451,42,79,121,572,26,178,NE - Lincoln
13,1963-1964,1963-12-01,1964-03-27,118,0,82,323,405,25,37,62,467,19,113,NE - Lincoln
14,1964-1965,1964-11-21,1965-03-27,127,3,111,436,547,65,140,205,752,24,202,NE - Lincoln
15,1965-1966,1965-11-29,1966-03-27,119,0,84,310,394,22,9,31,425,18,93,NE - Lincoln
16,1966-1967,1966-11-09,1967-05-03,176,0,62,338,400,36,79,115,515,19,128,NE - Lincoln
17,1967-1968,1967-11-04,1968-03-22,140,0,70,308,378,14,30,44,422,12,84,NE - Lincoln
18,1968-1969,1968-11-08,1969-03-30,143,0,109,384,493,61,249,310,803,27,145,NE - Lincoln
19,1969-1970,1969-11-14,1970-04-01,139,0,92,349,441,42,178,220,661,23,125,NE - Lincoln
20,1970-1971,1970-10-09,1971-04-01,175,0,89,356,445,70,207,277,722,22,153,NE - Lincoln
21,1971-1972,1971-11-22,1972-04-03,134,0,69,310,379,33,52,85,464,18,92,NE - Lincoln
22,1972-1973,1972-11-13,1973-04-16,155,0,98,363,461,48,120,168,629,24,129,NE - Lincoln
23,1973-1974,1973-12-01,1974-04-03,124,0,114,396,510,52,243,295,805,24,257,NE - Lincoln
24,1974-1975,1974-11-13,1975-04-03,142,0,94,450,544,61,295,356,900,22,140,NE - Lincoln
25,1975-1976,1975-11-20,1976-03-30,132,0,62,342,404,34,37,71,475,19,97,NE - Lincoln
26,1976-1977,1976-10-18,1977-04-04,169,1,90,553,643,33,44,77,720,13,91,NE - Lincoln
27,1977-1978,1977-11-09,1978-03-16,128,0,181,574,755,50,234,284,1039,30,261,NE - Lincoln
28,1978-1979,1978-11-16,1979-04-02,138,0,205,566,771,53,254,307,1078,29,241,NE - Lincoln
29,1979-1980,1979-10-22,1980-04-11,173,1,76,394,470,37,121,158,628,22,121,NE - Lincoln
30,1980-1981,1980-10-27,1981-03-05,130,0,44,335,379,16,22,38,417,6,42,NE - Lincoln
31,1981-1982,1981-11-19,1982-04-28,161,0,145,488,633,51,214,265,898,27,193,NE - Lincoln
32,1982-1983,1982-11-23,1983-04-14,143,0,44,277,321,54,142,196,517,21,118,NE - Lincoln
33,1983-1984,1983-11-09,1984-04-29,173,0,158,456,614,73,356,429,1043,33,266,NE - Lincoln
34,1984-1985,1984-11-09,1985-04-02,145,0,84,417,501,34,87,121,622,15,90,NE - Lincoln
35,1985-1986,1985-09-29,1986-04-15,199,0,97,414,511,30,97,127,638,18,129,NE - Lincoln
36,1986-1987,1986-11-01,1987-04-02,153,0,22,301,323,25,30,55,378,14,58,NE - Lincoln
37,1987-1988,1987-10-10,1988-03-17,160,0,68,382,450,29,36,65,515,21,126,NE - Lincoln
38,1988-1989,1988-11-15,1989-03-17,123,0,62,361,423,31,77,108,531,15,121,NE - Lincoln
39,1989-1990,1989-11-16,1990-04-12,148,0,69,387,456,32,58,90,546,20,139,NE - Lincoln
40,1990-1991,1990-11-27,1991-03-27,121,0,79,369,448,42,134,176,624,20,171,NE - Lincoln
41,1991-1992,1991-10-31,1992-04-23,176,0,26,247,273,33,69,102,375,13,58,NE - Lincoln
42,1992-1993,1992-11-05,1993-03-19,135,3,105,432,537,42,200,242,779,22,154,NE - Lincoln
43,1993-1994,1993-10-30,1994-04-30,183,0,93,467,560,32,77,109,669,17,124,NE - Lincoln
44,1994-1995,1994-11-28,1995-04-12,136,6,62,347,409,34,95,129,538,14,116,NE - Lincoln
45,1995-1996,1995-11-10,1996-04-14,157,0,107,486,593,49,114,163,756,24,190,NE - Lincoln
47,1997-1998,1997-10-26,1998-03-23,149,1,56,319,375,73,127,200,575,26,157,NE - Lincoln
48,1998-1999,1998-12-01,1999-03-23,113,0,60,278,338,36,97,133,471,18,126,NE - Lincoln
49,1999-2000,1999-12-01,2000-02-29,91,0,24,243,267,20,26,46,313,8,51,NE - Lincoln
50,2000-2001,2000-11-06,2001-03-11,126,0,110,460,570,62,259,321,891,27,201,NE - Lincoln
51,2001-2002,2001-11-27,2002-03-27,121,0,43,331,374,42,82,124,498,14,99,NE - Lincoln
52,2002-2003,2002-10-23,2003-04-08,168,0,63,427,490,46,70,116,606,20,136,NE - Lincoln
53,2003-2004,2003-11-23,2004-02-29,99,0,85,325,410,53,212,265,675,14,125,NE - Lincoln
54,2004-2005,2004-11-28,2005-02-28,93,0,60,276,336,23,90,113,449,9,76,NE - Lincoln
55,2005-2006,2005-11-15,2006-03-26,132,0,47,321,368,28,53,81,449,12,89,NE - Lincoln
56,2006-2007,2006-11-29,2007-03-07,99,0,70,307,377,46,140,186,563,16,126,NE - Lincoln
57,2007-2008,2007-11-21,2008-03-07,108,0,74,386,460,37,121,158,618,21,136,NE - Lincoln
58,2008-2009,2008-12-01,2009-03-11,101,0,68,375,443,34,69,103,546,17,151,NE - Lincoln
59,2009-2010,2009-10-10,2010-03-20,162,0,118,421,539,63,380,443,982,27,203,NE - Lincoln
60,2010-2011,2010-11-22,2011-03-26,125,0,92,413,505,44,115,159,664,21,159,NE - Lincoln
61,2011-2012,2011-12-01,2012-02-29,91,0,25,261,286,27,75,102,388,9,60,NE - Lincoln
62,2012-2013,2012-12-01,2013-05-02,153,0,57,365,422,47,94,141,563,23,110,NE - Lincoln
63,2013-2014,2013-11-21,2014-04-13,144,0,111,508,619,36,58,94,713,23,169,NE - Lincoln
64,2014-2015,2014-11-10,2015-03-04,115,0,69,374,443,35,56,91,534,16,119,NE - Lincoln
65,2015-2016,2015-11-27,2016-02-29,95,0,34,208,242,31,58,89,331,12,61,NE - Lincoln
66,2016-2017,2016-12-01,2017-03-14,104,0,41,256,297,13,10,23,320,9,48,NE - Lincoln
67,2017-2018,2017-12-01,2018-04-16,137,0,88,383,471,36,94,130,601,24,147,NE - Lincoln
68,2018-2019,2018-10-14,2019-03-12,150,0,100,427,527,78,201,279,806,28,212,NE - Lincoln
69,2019-2020,2019-10-28,2020-04-17,173,0,37,345,382,30,22,52,434,20,86,NE - Lincoln
0,1950-1951,1950-11-09,1951-04-12,155,0,126,530,656,32,71,103,759,15,96,NE - Norfolk
1,1951-1952,1951-11-01,1952-04-12,164,0,134,501,635,49,181,230,865,25,181,NE - Norfolk
2,1952-1953,1952-11-25,1953-04-15,142,1,79,420,499,41,277,318,817,19,138,NE - Norfolk
3,1953-1954,1953-11-06,1954-05-02,178,0,80,421,501,35,66,101,602,19,97,NE - Norfolk
4,1954-1955,1954-11-01,1955-03-29,149,0,78,448,526,33,131,164,690,19,129,NE - Norfolk
5,1955-1956,1955-10-23,1956-04-12,173,0,163,626,789,44,264,308,1097,28,237,NE - Norfolk
6,1956-1957,1956-11-15,1957-04-08,145,0,104,462,566,29,66,95,661,16,109,NE - Norfolk
7,1957-1958,1957-11-15,1958-04-23,160,0,100,422,522,38,144,182,704,20,113,NE - Norfolk
8,1958-1959,1958-11-17,1959-04-20,155,0,116,526,642,46,79,125,767,22,151,NE - Norfolk
9,1959-1960,1959-11-04,1960-04-03,152,0,189,588,777,89,577,666,1443,29,271,NE - Norfolk
10,1960-1961,1960-11-09,1961-04-09,152,0,72,436,508,41,106,147,655,21,129,NE - Norfolk
11,1961-1962,1961-09-30,1962-04-12,195,0,191,617,808,70,413,483,1291,36,289,NE - Norfolk
12,1962-1963,1962-11-18,1963-03-18,121,0,134,447,581,40,132,172,753,29,229,NE - Norfolk
13,1963-1964,1963-11-13,1964-04-05,145,0,117,490,607,39,94,133,740,25,161,NE - Norfolk
14,1964-1965,1964-11-21,1965-04-25,156,0,150,588,738,50,213,263,1001,23,204,NE - Norfolk
15,1965-1966,1965-11-26,1966-04-19,145,0,127,469,596,34,118,152,748,16,144,NE - Norfolk
16,1966-1967,1966-10-14,1967-03-17,155,1,87,491,578,25,112,137,715,13,95,NE - Norfolk
17,1967-1968,1967-10-26,1968-03-22,149,0,104,453,557,18,58,76,633,14,86,NE - Norfolk
18,1968-1969,1968-11-06,1969-03-31,146,0,178,539,717,74,586,660,1377,28,238,NE - Norfolk
19,1969-1970,1969-10-12,1970-04-13,184,0,134,523,657,55,221,276,933,25,177,NE - Norfolk
20,1970-1971,1970-10-08,1971-04-01,176,0,134,494,628,38,105,143,771,27,167,NE - Norfolk
21,1971-1972,1971-11-06,1972-04-03,150,0,120,480,600,38,135,173,773,25,157,NE - Norfolk
22,1972-1973,1972-11-13,1973-04-08,147,0,128,406,534,44,218,262,796,19,144,NE - Norfolk
23,1973-1974,1973-11-04,1974-04-04,152,0,119,434,553,44,194,238,791,23,200,NE - Norfolk
24,1974-1975,1974-11-13,1975-04-18,157,0,107,478,585,57,354,411,996,27,170,NE - Norfolk
25,1975-1976,1975-11-19,1976-03-29,132,0,100,377,477,51,241,292,769,23,144,NE - Norfolk
26,1976-1977,1976-10-18,1977-04-04,169,0,110,545,655,40,39,79,734,25,149,NE - Norfolk
27,1977-1978,1977-11-08,1978-03-18,131,0,219,589,808,66,256,322,1130,35,287,NE - Norfolk
28,1978-1979,1978-11-11,1979-04-02,143,0,245,654,899,85,581,666,1565,43,342,NE - Norfolk
29,1979-1980,1979-10-22,1980-04-03,165,0,98,434,532,40,86,126,658,28,167,NE - Norfolk
30,1980-1981,1980-10-26,1981-02-28,126,0,64,355,419,17,23,40,459,10,73,NE - Norfolk
31,1981-1982,1981-10-24,1982-04-09,168,0,163,549,712,71,275,346,1058,27,247,NE - Norfolk
32,1982-1983,1982-10-19,1983-04-15,179,0,57,346,403,73,197,270,673,32,156,NE - Norfolk
33,1983-1984,1983-11-09,1984-04-30,174,0,170,499,669,121,536,657,1326,36,283,NE - Norfolk
34,1984-1985,1984-10-18,1985-04-06,171,0,109,448,557,32,44,76,633,21,135,NE - Norfolk
35,1985-1986,1985-09-28,1986-04-15,200,0,129,471,600,53,107,160,760,31,218,NE - Norfolk
36,1986-1987,1986-10-11,1987-03-31,172,0,35,339,374,28,39,67,441,16,73,NE - Norfolk
37,1987-1988,1987-11-27,1988-04-26,152,0,115,423,538,36,110,146,684,20,138,NE - Norfolk
38,1988-1989,1988-11-15,1989-04-09,146,0,97,439,536,38,58,96,632,23,183,NE - Norfolk
39,1989-1990,1989-11-16,1990-04-13,149,0,93,454,547,35,76,111,658,20,183,NE - Norfolk
40,1990-1991,1990-10-17,1991-03-30,165,0,107,456,563,52,116,168,731,25,185,NE - Norfolk
41,1991-1992,1991-10-28,1992-04-22,178,1,41,322,363,37,79,116,479,20,101,NE - Norfolk
42,1992-1993,1992-11-01,1993-04-14,165,0,130,478,608,71,276,347,955,39,265,NE - Norfolk
43,1993-1994,1993-10-30,1994-04-30,183,0,124,506,630,49,170,219,849,26,185,NE - Norfolk
44,1994-1995,1994-11-27,1995-04-12,137,0,80,359,439,43,154,197,636,17,123,NE - Norfolk
45,1995-1996,1995-10-23,1996-04-15,176,0,136,509,645,51,129,180,825,27,183,NE - Norfolk
46,1996-1997,1996-11-10,1997-04-14,156,1,170,492,662,60,108,168,830,30,237,NE - Norfolk
47,1997-1998,1997-10-25,1998-04-01,159,0,76,360,436,37,58,95,531,27,148,NE - Norfolk
48,1998-1999,1998-11-10,1999-03-22,133,0,70,329,399,31,81,112,511,13,88,NE - Norfolk
49,1999-2000,1999-11-23,2000-03-18,117,0,34,292,326,18,21,39,365,13,57,NE - Norfolk
50,2000-2001,2000-11-06,2001-03-25,140,0,148,505,653,49,236,285,938,27,184,NE - Norfolk
51,2001-2002,2001-11-27,2002-03-21,115,0,63,336,399,27,57,84,483,10,73,NE - Norfolk
52,2002-2003,2002-10-22,2003-04-09,170,0,75,434,509,47,97,144,653,21,143,NE - Norfolk
53,2003-2004,2003-11-05,2004-03-17,134,0,95,364,459,48,168,216,675,20,146,NE - Norfolk
54,2004-2005,2004-11-28,2005-03-25,118,0,68,328,396,21,65,86,482,10,65,NE - Norfolk
55,2005-2006,2005-11-15,2006-03-27,133,0,66,322,388,54,140,194,582,16,136,NE - Norfolk
56,2006-2007,2006-11-29,2007-03-07,99,0,97,327,424,37,124,161,585,16,131,NE - Norfolk
57,2007-2008,2007-11-22,2008-04-25,156,0,113,489,602,53,227,280,882,30,215,NE - Norfolk
58,2008-2009,2008-11-08,2009-04-05,149,0,101,468,569,59,189,248,817,32,241,NE - Norfolk
59,2009-2010,2009-10-10,2010-03-19,161,0,156,443,599,77,522,599,1198,31,262,NE - Norfolk
60,2010-2011,2010-11-20,2011-04-19,151,0,133,471,604,60,195,255,859,24,195,NE - Norfolk
61,2011-2012,2011-11-19,2012-02-29,103,0,38,301,339,27,42,69,408,13,77,NE - Norfolk
62,2012-2013,2012-11-11,2013-04-24,165,0,78,438,516,44,90,134,650,22,118,NE - Norfolk
63,2013-2014,2013-11-05,2014-04-14,161,0,141,563,704,32,44,76,780,21,138,NE - Norfolk
64,2014-2015,2014-11-10,2015-04-09,151,0,97,450,547,33,88,121,668,18,130,NE - Norfolk
65,2015-2016,2015-11-11,2016-03-28,139,0,57,291,348,76,193,269,617,24,145,NE - Norfolk
66,2016-2017,2016-11-18,2017-05-01,165,0,75,344,419,46,77,123,542,20,138,NE - Norfolk
67,2017-2018,2017-12-01,2018-04-18,139,0,132,453,585,62,164,226,811,22,190,NE - Norfolk
68,2018-2019,2018-10-14,2019-04-02,171,0,147,512,659,50,173,223,882,25,206,NE - Norfolk
69,2019-2020,2019-11-10,2020-04-16,159,0,54,377,431,48,76,124,555,22,127,NE - Norfolk
0,1950-1951,1950-11-08,1951-03-18,131,0,68,444,512,21,18,39,551,16,137,NE - North Platte
1,1951-1952,1951-10-21,1952-04-09,172,0,78,480,558,52,71,123,681,28,179,NE - North Platte
2,1952-1953,1952-11-22,1953-04-17,147,0,49,415,464,33,69,102,566,16,105,NE - North Platte
3,1953-1954,1953-11-06,1954-05-02,178,0,52,412,464,40,57,97,561,21,107,NE - North Platte
4,1954-1955,1954-11-29,1955-03-27,119,0,69,465,534,55,123,178,712,26,201,NE - North Platte
5,1955-1956,1955-11-02,1956-04-28,179,0,102,575,677,55,90,145,822,32,237,NE - North Platte
6,1956-1957,1956-10-25,1957-04-12,170,0,73,498,571,51,41,92,663,28,186,NE - North Platte
7,1957-1958,1957-10-24,1958-04-26,185,0,58,482,540,73,213,286,826,32,207,NE - North Platte
8,1958-1959,1958-10-26,1959-04-19,176,0,70,526,596,60,78,138,734,29,191,NE - North Platte
9,1959-1960,1959-10-01,1960-04-27,210,0,113,600,713,61,216,277,990,30,227,NE - North Platte
10,1960-1961,1960-11-22,1961-04-14,144,0,36,426,462,61,70,131,593,20,130,NE - North Platte
11,1961-1962,1961-11-02,1962-03-29,148,0,113,553,666,50,112,162,828,28,228,NE - North Platte
12,1962-1963,1962-11-15,1963-04-02,139,0,96,451,547,45,137,182,729,24,178,NE - North Platte
13,1963-1964,1963-11-21,1964-04-05,137,0,66,503,569,41,68,109,678,22,143,NE - North Platte
14,1964-1965,1964-11-26,1965-03-27,122,0,73,541,614,35,119,154,768,16,137,NE - North Platte
15,1965-1966,1965-11-26,1966-05-12,168,0,103,495,598,54,149,203,801,25,231,NE - North Platte
16,1966-1967,1966-10-14,1967-05-05,204,0,61,519,580,46,88,134,714,23,152,NE - North Platte
17,1967-1968,1967-11-02,1968-04-07,158,0,66,574,640,21,28,49,689,13,94,NE - North Platte
18,1968-1969,1968-11-05,1969-03-29,145,0,132,544,676,50,211,261,937,26,189,NE - North Platte
19,1969-1970,1969-10-11,1970-04-12,184,0,57,516,573,69,55,124,697,26,169,NE - North Platte
20,1970-1971,1970-10-08,1971-04-27,202,0,87,569,656,67,80,147,803,28,178,NE - North Platte
21,1971-1972,1971-10-29,1972-04-03,158,0,57,504,561,23,19,42,603,17,108,NE - North Platte
22,1972-1973,1972-10-28,1973-04-09,164,0,124,493,617,44,94,138,755,27,179,NE - North Platte
23,1973-1974,1973-11-03,1974-04-03,152,0,102,481,583,49,168,217,800,30,224,NE - North Platte
24,1974-1975,1974-11-28,1975-04-18,142,0,65,496,561,33,49,82,643,22,124,NE - North Platte
25,1975-1976,1975-10-23,1976-03-15,145,0,103,534,637,53,195,248,885,23,203,NE - North Platte
26,1976-1977,1976-10-27,1977-04-04,160,0,63,592,655,39,31,70,725,17,99,NE - North Platte
27,1977-1978,1977-11-08,1978-03-16,129,0,156,608,764,61,167,228,992,38,317,NE - North Platte
28,1978-1979,1978-11-11,1979-04-12,153,0,210,682,892,57,238,295,1187,32,257,NE - North Platte
29,1979-1980,1979-10-21,1980-04-05,168,0,66,420,486,96,164,260,746,31,215,NE - North Platte
30,1980-1981,1980-10-27,1981-04-03,159,0,44,452,496,10,4,14,510,9,55,NE - North Platte
31,1981-1982,1981-11-18,1982-04-07,141,0,87,492,579,45,69,114,693,27,201,NE - North Platte
32,1982-1983,1982-10-19,1983-04-14,178,0,44,397,441,44,80,124,565,25,104,NE - North Platte
33,1983-1984,1983-11-08,1984-05-07,182,0,154,562,716,87,238,325,1041,39,277,NE - North Platte
34,1984-1985,1984-10-18,1985-03-30,164,0,100,522,622,34,121,155,777,18,136,NE - North Platte
35,1985-1986,1985-09-28,1986-03-16,170,0,109,468,577,57,177,234,811,21,152,NE - North Platte
36,1986-1987,1986-10-11,1987-04-12,184,0,21,410,431,40,27,67,498,22,104,NE - North Platte
37,1987-1988,1987-10-10,1988-04-22,196,0,85,534,619,62,187,249,868,27,175,NE - North Platte
38,1988-1989,1988-11-15,1989-04-09,146,0,72,503,575,37,46,83,658,21,159,NE - North Platte
39,1989-1990,1989-12-01,1990-04-05,126,0,62,395,457,28,44,72,529,17,137,NE - North Platte
40,1990-1991,1990-10-08,1991-03-29,173,0,73,487,560,38,49,87,647,19,127,NE - North Platte
41,1991-1992,1991-10-28,1992-04-02,158,0,23,339,362,32,47,79,441,14,72,NE - North Platte
42,1992-1993,1992-11-03,1993-04-20,169,0,111,559,670,60,231,291,961,31,235,NE - North Platte
43,1993-1994,1993-11-14,1994-04-30,168,0,69,452,521,52,79,131,652,23,153,NE - North Platte
44,1994-1995,1994-11-03,1995-04-18,167,0,52,434,486,50,95,145,631,25,145,NE - North Platte
45,1995-1996,1995-09-20,1996-04-14,208,2,71,577,648,30,27,57,705,19,119,NE - North Platte
46,1996-1997,1996-11-11,1997-04-12,153,1,86,508,594,34,66,100,694,19,135,NE - North Platte
47,1997-1998,1997-10-24,1998-04-01,160,2,49,445,494,43,51,94,588,22,125,NE - North Platte
48,1998-1999,1998-11-02,1999-04-15,165,0,42,427,469,33,31,64,533,18,107,NE - North Platte
49,1999-2000,1999-11-22,2000-04-15,146,0,18,397,415,28,17,45,460,19,104,NE - North Platte
50,2000-2001,2000-09-23,2001-04-23,213,0,74,556,630,52,116,168,798,22,133,NE - North Platte
51,2001-2002,2001-11-25,2002-04-02,129,0,45,511,556,28,29,57,613,12,84,NE - North Platte
52,2002-2003,2002-10-22,2003-04-07,168,0,46,493,539,44,52,96,635,18,109,NE - North Platte
53,2003-2004,2003-11-22,2004-04-12,143,0,50,447,497,24,42,66,563,16,112,NE - North Platte
54,2004-2005,2004-11-28,2005-04-28,152,0,48,392,440,37,65,102,542,14,90,NE - North Platte
55,2005-2006,2005-11-27,2006-04-25,150,0,49,399,448,30,60,90,538,14,94,NE - North Platte
56,2006-2007,2006-10-17,2007-04-07,173,0,83,535,618,62,238,300,918,21,181,NE - North Platte
57,2007-2008,2007-11-21,2008-05-02,164,0,49,533,582,50,80,130,712,24,167,NE - North Platte
58,2008-2009,2008-10-23,2009-04-10,170,0,60,535,595,54,68,122,717,26,165,NE - North Platte
59,2009-2010,2009-10-09,2010-04-07,181,0,87,493,580,86,146,232,812,32,210,NE - North Platte
60,2010-2011,2010-11-20,2011-04-15,147,0,78,492,570,59,125,184,754,25,194,NE - North Platte
61,2011-2012,2011-11-02,2012-02-29,120,0,22,415,437,25,40,65,502,12,71,NE - North Platte
62,2012-2013,2012-10-06,2013-05-01,208,0,43,582,625,48,60,108,733,24,137,NE - North Platte
63,2013-2014,2013-11-05,2014-04-13,160,0,98,569,667,41,71,112,779,23,177,NE - North Platte
64,2014-2015,2014-11-11,2015-04-09,150,0,67,490,557,35,62,97,654,17,135,NE - North Platte
65,2015-2016,2015-11-11,2016-04-30,172,0,25,368,393,51,76,127,520,22,108,NE - North Platte
66,2016-2017,2016-11-17,2017-04-30,165,0,47,407,454,34,47,81,535,16,112,NE - North Platte
67,2017-2018,2017-10-31,2018-04-15,167,0,82,545,627,70,198,268,895,27,217,NE - North Platte
68,2018-2019,2018-10-14,2019-04-30,199,0,82,546,628,62,153,215,843,26,183,NE - North Platte
69,2019-2020,2019-10-28,2020-04-17,173,0,20,440,460,53,56,109,569,27,141,NE - North Platte
0,1950-1951,1950-11-03,1951-04-12,161,0,108,453,561,34,62,96,657,20,116,NE - Omaha
1,1951-1952,1951-11-02,1952-04-09,160,0,106,407,513,57,194,251,764,24,166,NE - Omaha
2,1952-1953,1952-11-24,1953-04-15,143,0,61,296,357,52,163,215,572,27,142,NE - Omaha
3,1953-1954,1953-12-01,1954-03-30,120,0,54,306,360,14,11,25,385,11,73,NE - Omaha
4,1954-1955,1954-12-01,1955-03-28,118,0,60,342,402,37,131,168,570,21,147,NE - Omaha
5,1955-1956,1955-11-02,1956-04-06,157,0,101,444,545,27,80,107,652,18,119,NE - Omaha
6,1956-1957,1956-11-15,1957-04-05,142,0,79,334,413,44,80,124,537,15,115,NE - Omaha
7,1957-1958,1957-10-26,1958-03-10,136,0,73,314,387,52,108,160,547,21,111,NE - Omaha
8,1958-1959,1958-11-18,1959-04-20,154,0,99,410,509,44,69,113,622,23,164,NE - Omaha
9,1959-1960,1959-11-05,1960-03-28,145,0,133,452,585,86,458,544,1129,37,276,NE - Omaha
10,1960-1961,1960-11-09,1961-04-11,154,0,57,316,373,35,46,81,454,24,101,NE - Omaha
11,1961-1962,1961-11-05,1962-04-12,159,0,152,463,615,86,332,418,1033,43,328,NE - Omaha
12,1962-1963,1962-11-18,1963-03-13,116,0,119,370,489,57,162,219,708,25,213,NE - Omaha
13,1963-1964,1963-12-01,1964-03-29,120,0,88,386,474,45,80,125,599,26,165,NE - Omaha
14,1964-1965,1964-11-21,1965-03-27,127,0,110,461,571,84,198,282,853,33,260,NE - Omaha
15,1965-1966,1965-11-26,1966-03-24,119,0,71,324,395,23,21,44,439,15,80,NE - Omaha
16,1966-1967,1966-11-09,1967-05-03,176,0,49,356,405,28,87,115,520,19,104,NE - Omaha
17,1967-1968,1967-10-26,1968-03-22,149,0,68,376,444,20,73,93,537,10,87,NE - Omaha
18,1968-1969,1968-11-09,1969-03-30,142,0,110,412,522,62,209,271,793,37,210,NE - Omaha
19,1969-1970,1969-11-14,1970-03-27,134,0,96,405,501,47,224,271,772,25,166,NE - Omaha
20,1970-1971,1970-10-09,1971-04-01,175,0,96,405,501,61,229,290,791,21,131,NE - Omaha
21,1971-1972,1971-11-22,1972-04-03,134,0,79,382,461,44,59,103,564,27,159,NE - Omaha
22,1972-1973,1972-11-13,1973-04-10,149,0,106,348,454,55,151,206,660,25,152,NE - Omaha
23,1973-1974,1973-11-08,1974-04-04,148,0,103,376,479,52,176,228,707,25,211,NE - Omaha
24,1974-1975,1974-11-14,1975-04-04,142,0,71,408,479,85,311,396,875,31,177,NE - Omaha
25,1975-1976,1975-11-23,1976-03-12,111,0,48,289,337,30,46,76,413,15,82,NE - Omaha
26,1976-1977,1976-10-18,1977-04-04,169,1,95,493,588,39,61,100,688,23,133,NE - Omaha
27,1977-1978,1977-11-09,1978-03-18,130,0,197,547,744,66,255,321,1065,32,258,NE - Omaha
28,1978-1979,1978-11-16,1979-04-03,139,0,223,561,784,68,313,381,1165,36,280,NE - Omaha
29,1979-1980,1979-10-22,1980-04-11,173,0,92,371,463,46,88,134,597,24,157,NE - Omaha
30,1980-1981,1980-10-27,1981-03-04,129,0,66,307,373,23,32,55,428,9,62,NE - Omaha
31,1981-1982,1981-10-24,1982-04-09,168,0,163,468,631,55,252,307,938,30,229,NE - Omaha
32,1982-1983,1982-10-19,1983-04-15,179,0,60,295,355,74,156,230,585,29,159,NE - Omaha
33,1983-1984,1983-11-09,1984-04-29,173,0,176,434,610,87,391,478,1088,41,282,NE - Omaha
34,1984-1985,1984-11-09,1985-04-02,145,0,96,376,472,42,80,122,594,21,142,NE - Omaha
35,1985-1986,1985-09-29,1986-04-28,212,0,124,422,546,35,133,168,714,25,152,NE - Omaha
36,1986-1987,1986-11-10,1987-04-05,147,0,31,247,278,35,61,96,374,13,76,NE - Omaha
37,1987-1988,1987-10-10,1988-03-17,160,0,91,360,451,32,59,91,542,23,140,NE - Omaha
38,1988-1989,1988-11-15,1989-03-17,123,0,80,330,410,30,72,102,512,17,136,NE - Omaha
39,1989-1990,1989-11-16,1990-03-23,128,0,84,324,408,36,69,105,513,19,146,NE - Omaha
40,1990-1991,1990-11-06,1991-03-27,142,0,110,357,467,50,195,245,712,24,210,NE - Omaha
41,1991-1992,1991-10-31,1992-04-24,177,0,39,248,287,39,68,107,394,16,75,NE - Omaha
42,1992-1993,1992-11-02,1993-04-20,170,0,112,382,494,67,276,343,837,36,216,NE - Omaha
43,1993-1994,1993-10-30,1994-04-30,183,0,107,431,538,41,68,109,647,26,178,NE - Omaha
44,1994-1995,1994-11-27,1995-04-12,137,0,64,329,393,45,138,183,576,21,122,NE - Omaha
48,1998-1999,1998-12-01,1999-04-16,137,0,70,275,345,41,139,180,525,17,117,NE - Omaha
49,1999-2000,1999-12-01,2000-02-29,91,0,32,230,262,21,28,49,311,12,70,NE - Omaha
50,2000-2001,2000-11-06,2001-03-11,126,0,117,429,546,58,198,256,802,30,193,NE - Omaha
51,2001-2002,2001-11-28,2002-03-26,119,0,49,291,340,32,49,81,421,14,76,NE - Omaha
52,2002-2003,2002-10-23,2003-04-08,168,0,77,397,474,48,86,134,608,23,144,NE - Omaha
53,2003-2004,2003-11-23,2004-03-17,116,3,94,317,411,68,244,312,723,15,123,NE - Omaha
54,2004-2005,2004-11-28,2005-02-28,93,1,64,262,326,29,114,143,469,8,77,NE - Omaha
55,2005-2006,2005-11-15,2006-03-24,130,0,55,273,328,32,59,91,419,16,101,NE - Omaha
56,2006-2007,2006-11-29,2007-03-07,99,0,92,316,408,45,121,166,574,21,169,NE - Omaha
57,2007-2008,2007-11-21,2008-03-07,108,0,95,410,505,41,198,239,744,26,189,NE - Omaha
58,2008-2009,2008-11-21,2009-04-05,136,0,90,406,496,33,79,112,608,19,166,NE - Omaha
59,2009-2010,2009-10-10,2010-03-20,162,0,130,403,533,72,475,547,1080,30,238,NE - Omaha
60,2010-2011,2010-11-12,2011-03-28,137,0,102,388,490,54,184,238,728,28,186,NE - Omaha
61,2011-2012,2011-11-02,2012-02-29,120,0,34,241,275,35,73,108,383,14,77,NE - Omaha
62,2012-2013,2012-12-01,2013-05-02,153,0,60,314,374,55,138,193,567,24,118,NE - Omaha
63,2013-2014,2013-11-21,2014-04-13,144,0,124,483,607,38,48,86,693,29,167,NE - Omaha
64,2014-2015,2014-11-10,2015-03-05,116,0,84,361,445,23,42,65,510,15,96,NE - Omaha
65,2015-2016,2015-11-27,2016-03-01,96,0,45,206,251,42,74,116,367,16,87,NE - Omaha
66,2016-2017,2016-12-01,2017-03-13,103,0,44,226,270,20,15,35,305,13,69,NE - Omaha
67,2017-2018,2017-12-01,2018-04-16,137,0,105,359,464,34,96,130,594,25,189,NE - Omaha
68,2018-2019,2018-10-14,2019-03-12,150,0,112,400,512,77,261,338,850,30,215,NE - Omaha
69,2019-2020,2019-10-28,2020-04-17,173,0,46,294,340,43,61,104,444,28,118,NE - Omaha
0,1950-1951,1950-11-08,1951-06-02,207,0,54,516,570,41,40,81,651,26,199,NE - Scottsbluff
1,1951-1952,1951-10-21,1952-04-08,171,8,55,499,554,60,49,109,663,31,190,NE - Scottsbluff
2,1952-1953,1952-10-14,1953-04-17,186,0,42,431,473,64,112,176,649,23,154,NE - Scottsbluff
3,1953-1954,1953-11-06,1954-05-02,178,1,32,428,460,51,67,118,578,22,120,NE - Scottsbluff
4,1954-1955,1954-10-25,1955-04-14,172,0,63,520,583,67,167,234,817,31,222,NE - Scottsbluff
5,1955-1956,1955-09-25,1956-04-29,218,0,76,566,642,65,114,179,821,34,217,NE - Scottsbluff
6,1956-1957,1956-11-01,1957-04-13,164,0,52,481,533,72,99,171,704,26,192,NE - Scottsbluff
7,1957-1958,1957-10-24,1958-04-26,185,0,33,435,468,62,105,167,635,33,179,NE - Scottsbluff
8,1958-1959,1958-11-16,1959-05-07,173,0,74,477,551,82,146,228,779,37,246,NE - Scottsbluff
9,1959-1960,1959-10-01,1960-04-28,211,0,80,523,603,47,65,112,715,28,199,NE - Scottsbluff
10,1960-1961,1960-10-29,1961-05-13,197,0,37,474,511,61,85,146,657,29,146,NE - Scottsbluff
11,1961-1962,1961-10-29,1962-03-30,153,0,102,542,644,47,80,127,771,33,238,NE - Scottsbluff
12,1962-1963,1962-11-15,1963-04-22,159,0,74,438,512,48,113,161,673,27,191,NE - Scottsbluff
13,1963-1964,1963-11-21,1964-04-05,137,0,57,470,527,41,47,88,615,27,173,NE - Scottsbluff
14,1964-1965,1964-11-15,1965-05-09,176,0,65,497,562,43,87,130,692,29,165,NE - Scottsbluff
15,1965-1966,1965-09-16,1966-05-11,238,0,82,505,587,38,105,143,730,24,157,NE - Scottsbluff
16,1966-1967,1966-11-08,1967-05-05,179,0,32,404,436,39,38,77,513,25,136,NE - Scottsbluff
17,1967-1968,1967-11-01,1968-04-18,170,0,54,510,564,52,98,150,714,29,179,NE - Scottsbluff
18,1968-1969,1968-11-14,1969-04-08,146,0,54,460,514,47,71,118,632,30,171,NE - Scottsbluff
19,1969-1970,1969-10-04,1970-04-23,202,0,39,462,501,98,83,181,682,40,212,NE - Scottsbluff
20,1970-1971,1970-10-06,1971-04-27,204,0,62,479,541,63,83,146,687,33,179,NE - Scottsbluff
21,1971-1972,1971-10-28,1972-04-27,183,0,43,466,509,34,20,54,563,20,109,NE - Scottsbluff
22,1972-1973,1972-10-27,1973-04-26,182,0,110,513,623,82,159,241,864,43,264,NE - Scottsbluff
23,1973-1974,1973-10-11,1974-04-13,185,0,84,468,552,87,213,300,852,31,241,NE - Scottsbluff
24,1974-1975,1974-09-11,1975-04-19,221,0,49,534,583,70,79,149,732,33,203,NE - Scottsbluff
25,1975-1976,1975-10-23,1976-04-28,189,0,64,416,480,75,149,224,704,29,197,NE - Scottsbluff
26,1976-1977,1976-10-26,1977-04-04,161,0,37,449,486,46,68,114,600,26,147,NE - Scottsbluff
27,1977-1978,1977-10-10,1978-05-07,210,0,105,482,587,83,208,291,878,39,276,NE - Scottsbluff
28,1978-1979,1978-10-22,1979-05-10,201,0,139,586,725,92,227,319,1044,48,324,NE - Scottsbluff
29,1979-1980,1979-10-29,1980-05-12,197,0,65,438,503,113,226,339,842,47,291,NE - Scottsbluff
30,1980-1981,1980-10-16,1981-04-03,170,0,25,337,362,39,37,76,438,21,101,NE - Scottsbluff
31,1981-1982,1981-10-20,1982-04-05,168,0,66,474,540,35,28,63,603,29,202,NE - Scottsbluff
32,1982-1983,1982-10-09,1983-05-12,216,0,21,425,446,64,50,114,560,29,127,NE - Scottsbluff
33,1983-1984,1983-11-08,1984-05-07,182,0,118,475,593,93,175,268,861,40,271,NE - Scottsbluff
34,1984-1985,1984-09-24,1985-04-26,215,0,67,600,667,46,69,115,782,27,138,NE - Scottsbluff
35,1985-1986,1985-09-23,1986-05-09,229,0,107,518,625,113,304,417,1042,45,318,NE - Scottsbluff
36,1986-1987,1986-10-10,1987-04-20,193,0,37,445,482,78,83,161,643,36,201,NE - Scottsbluff
37,1987-1988,1987-10-09,1988-04-24,199,0,86,567,653,89,198,287,940,33,266,NE - Scottsbluff
38,1988-1989,1988-11-15,1989-04-09,146,0,87,523,610,45,92,137,747,19,192,NE - Scottsbluff
39,1989-1990,1989-10-15,1990-05-09,207,0,68,484,552,82,149,231,783,29,214,NE - Scottsbluff
40,1990-1991,1990-10-06,1991-04-13,190,0,75,523,598,61,61,122,720,36,245,NE - Scottsbluff
41,1991-1992,1991-10-28,1992-03-18,143,0,19,374,393,40,69,109,502,18,104,NE - Scottsbluff
42,1992-1993,1992-10-06,1993-04-13,190,0,111,596,707,96,309,405,1112,42,322,NE - Scottsbluff
43,1993-1994,1993-09-13,1994-04-29,229,0,59,484,543,70,86,156,699,34,226,NE - Scottsbluff
44,1994-1995,1994-11-03,1995-04-26,175,0,53,431,484,67,131,198,682,26,178,NE - Scottsbluff
45,1995-1996,1995-09-20,1996-04-27,221,0,89,580,669,51,94,145,814,26,181,NE - Scottsbluff
47,1997-1998,1997-10-24,1998-04-14,173,2,36,431,467,39,36,75,542,21,117,NE - Scottsbluff
48,1998-1999,1998-11-02,1999-04-10,160,0,39,382,421,49,42,91,512,22,115,NE - Scottsbluff
49,1999-2000,1999-11-22,2000-04-16,147,0,12,324,336,41,51,92,428,17,89,NE - Scottsbluff
50,2000-2001,2000-09-23,2001-04-23,213,0,60,533,593,53,59,112,705,20,132,NE - Scottsbluff
51,2001-2002,2001-11-25,2002-04-20,147,0,37,447,484,18,35,53,537,13,89,NE - Scottsbluff
52,2002-2003,2002-10-23,2003-04-07,167,0,40,440,480,63,97,160,640,21,150,NE - Scottsbluff
53,2003-2004,2003-10-30,2004-04-11,165,0,38,419,457,55,162,217,674,19,133,NE - Scottsbluff
54,2004-2005,2004-11-01,2005-05-11,192,0,33,424,457,61,97,158,615,24,153,NE - Scottsbluff
55,2005-2006,2005-11-14,2006-04-25,163,0,59,414,473,57,88,145,618,18,144,NE - Scottsbluff
56,2006-2007,2006-10-17,2007-04-07,173,0,53,486,539,47,89,136,675,19,124,NE - Scottsbluff
57,2007-2008,2007-11-20,2008-05-02,165,0,66,522,588,66,227,293,881,33,203,NE - Scottsbluff
58,2008-2009,2008-11-05,2009-04-25,172,0,49,462,511,60,73,133,644,25,163,NE - Scottsbluff
59,2009-2010,2009-10-08,2010-05-12,217,0,64,485,549,112,151,263,812,38,244,NE - Scottsbluff
60,2010-2011,2010-11-09,2011-04-14,157,0,59,430,489,70,111,181,670,30,204,NE - Scottsbluff
61,2011-2012,2011-11-01,2012-02-29,121,0,16,407,423,39,21,60,483,26,135,NE - Scottsbluff
62,2012-2013,2012-10-05,2013-05-01,209,0,38,505,543,66,69,135,678,33,171,NE - Scottsbluff
63,2013-2014,2013-10-04,2014-05-12,221,0,92,527,619,97,167,264,883,36,317,NE - Scottsbluff
64,2014-2015,2014-11-03,2015-05-11,190,0,66,464,530,76,223,299,829,29,206,NE - Scottsbluff
65,2015-2016,2015-11-11,2016-04-30,172,0,40,383,423,54,147,201,624,24,122,NE - Scottsbluff
66,2016-2017,2016-11-17,2017-05-18,183,0,58,416,474,61,99,160,634,20,151,NE - Scottsbluff
67,2017-2018,2017-10-31,2018-04-21,173,18,67,470,537,68,87,155,692,28,219,NE - Scottsbluff
68,2018-2019,2018-10-08,2019-05-21,226,0,51,524,575,102,102,204,779,33,231,NE - Scottsbluff
69,2019-2020,2019-10-09,2020-04-17,192,11,29,451,480,71,67,138,618,33,183,NE - Scottsbluff
0,1950-1951,1950-11-09,1951-04-21,164,1,117,593,710,24,19,43,753,15,132,NE - Valentine
1,1951-1952,1951-10-18,1952-03-27,162,0,139,561,700,66,488,554,1254,30,240,NE - Valentine
2,1952-1953,1952-11-17,1953-04-16,151,1,69,426,495,72,308,380,875,25,190,NE - Valentine
3,1953-1954,1953-11-06,1954-05-03,179,0,77,409,486,41,76,117,603,18,100,NE - Valentine
4,1954-1955,1954-11-30,1955-03-26,117,1,81,416,497,46,184,230,727,20,165,NE - Valentine
5,1955-1956,1955-11-12,1956-05-01,172,0,159,670,829,52,250,302,1131,31,288,NE - Valentine
6,1956-1957,1956-11-02,1957-04-13,163,0,115,581,696,43,126,169,865,23,171,NE - Valentine
7,1957-1958,1957-11-03,1958-04-25,174,1,73,495,568,31,141,172,740,26,168,NE - Valentine
8,1958-1959,1958-11-17,1959-04-21,156,0,109,600,709,42,117,159,868,24,181,NE - Valentine
9,1959-1960,1959-10-29,1960-04-28,183,1,134,643,777,56,222,278,1055,26,202,NE - Valentine
10,1960-1961,1960-11-09,1961-04-08,151,0,71,466,537,30,65,95,632,17,118,NE - Valentine
11,1961-1962,1961-11-04,1962-04-01,149,1,159,637,796,48,269,317,1113,25,209,NE - Valentine
12,1962-1963,1962-11-16,1963-04-03,139,0,114,529,643,39,103,142,785,24,235,NE - Valentine
13,1963-1964,1963-11-21,1964-04-07,139,0,93,509,602,37,68,105,707,25,186,NE - Valentine
14,1964-1965,1964-11-20,1965-03-30,131,0,144,625,769,29,87,116,885,23,239,NE - Valentine
15,1965-1966,1965-11-25,1966-04-21,148,4,136,552,688,35,215,250,938,22,215,NE - Valentine
16,1966-1967,1966-11-01,1967-05-01,182,1,77,507,584,29,85,114,698,19,164,NE - Valentine
17,1967-1968,1967-11-01,1968-04-08,160,0,98,576,674,45,114,159,833,24,200,NE - Valentine
18,1968-1969,1968-11-06,1969-03-31,146,0,171,639,810,47,380,427,1237,32,256,NE - Valentine
19,1969-1970,1969-10-12,1970-04-23,194,0,99,579,678,59,112,171,849,24,193,NE - Valentine
20,1970-1971,1970-10-07,1971-04-27,203,0,141,623,764,67,239,306,1070,31,237,NE - Valentine
21,1971-1972,1971-10-28,1972-04-03,159,0,109,576,685,36,107,143,828,25,184,NE - Valentine
22,1972-1973,1972-10-30,1973-04-08,161,0,136,508,644,55,172,227,871,26,197,NE - Valentine
23,1973-1974,1973-11-01,1974-04-15,166,1,102,490,592,44,71,115,707,22,158,NE - Valentine
24,1974-1975,1974-11-13,1975-04-04,143,0,88,528,616,52,85,137,753,25,178,NE - Valentine
25,1975-1976,1975-10-23,1976-03-24,154,1,97,496,593,51,105,156,749,20,179,NE - Valentine
26,1976-1977,1976-10-26,1977-04-05,162,2,98,628,726,110,129,239,965,34,267,NE - Valentine
27,1977-1978,1977-10-10,1978-04-22,195,0,207,742,949,74,203,277,1226,42,353,NE - Valentine
28,1978-1979,1978-11-10,1979-05-10,182,0,239,819,1058,83,548,631,1689,38,340,NE - Valentine
29,1979-1980,1979-10-31,1980-04-11,164,0,89,570,659,79,131,210,869,28,253,NE - Valentine
30,1980-1981,1980-10-27,1981-03-29,154,0,56,455,511,26,30,56,567,13,113,NE - Valentine
31,1981-1982,1981-10-20,1982-04-20,183,0,141,637,778,81,194,275,1053,40,384,NE - Valentine
32,1982-1983,1982-10-19,1983-04-13,177,0,39,420,459,31,49,80,539,18,87,NE - Valentine
33,1983-1984,1983-11-08,1984-05-07,182,0,168,641,809,71,266,337,1146,30,246,NE - Valentine
34,1984-1985,1984-09-25,1985-04-05,193,0,100,649,749,29,44,73,822,23,161,NE - Valentine
35,1985-1986,1985-09-28,1986-04-27,212,0,143,637,780,109,440,549,1329,35,297,NE - Valentine
36,1986-1987,1986-10-11,1987-03-29,170,0,39,455,494,54,70,124,618,23,116,NE - Valentine
37,1987-1988,1987-10-09,1988-04-27,202,0,113,681,794,88,443,531,1325,28,238,NE - Valentine
38,1988-1989,1988-11-15,1989-03-20,126,0,117,557,674,48,102,150,824,22,219,NE - Valentine
39,1989-1990,1989-11-15,1990-03-24,130,0,89,485,574,37,86,123,697,18,149,NE - Valentine
40,1990-1991,1990-10-07,1991-04-19,195,0,103,608,711,46,86,132,843,21,156,NE - Valentine
41,1991-1992,1991-10-18,1992-03-18,153,0,42,421,463,38,76,114,577,14,82,NE - Valentine
42,1992-1993,1992-11-02,1993-04-19,169,0,131,624,755,66,212,278,1033,26,211,NE - Valentine
43,1993-1994,1993-10-08,1994-04-30,205,0,131,618,749,52,108,160,909,29,215,NE - Valentine
44,1994-1995,1994-11-04,1995-04-21,169,0,65,464,529,71,101,172,701,22,145,NE - Valentine
46,1996-1997,1996-10-17,1997-04-13,179,1,166,628,794,57,206,263,1057,24,227,NE - Valentine
47,1997-1998,1997-10-24,1998-03-19,147,1,75,442,517,33,66,99,616,14,102,NE - Valentine
48,1998-1999,1998-11-03,1999-04-15,164,0,55,391,446,50,46,96,542,21,124,NE - Valentine
49,1999-2000,1999-11-18,2000-04-15,150,0,26,399,425,26,33,59,484,15,81,NE - Valentine
50,2000-2001,2000-11-06,2001-04-23,169,5,89,537,626,48,165,213,839,22,164,NE - Valentine
51,2001-2002,2001-11-25,2002-05-01,158,0,78,491,569,56,106,162,731,15,123,NE - Valentine
52,2002-2003,2002-10-23,2003-04-08,168,0,82,534,616,57,79,136,752,25,222,NE - Valentine
53,2003-2004,2003-10-31,2004-04-10,163,0,78,458,536,40,83,123,659,14,115,NE - Valentine
54,2004-2005,2004-11-28,2005-04-12,136,0,61,396,457,40,71,111,568,14,101,NE - Valentine
55,2005-2006,2005-11-16,2006-04-24,160,0,78,432,510,66,128,194,704,24,162,NE - Valentine
56,2006-2007,2006-10-17,2007-04-06,172,0,87,527,614,39,115,154,768,22,126,NE - Valentine
57,2007-2008,2007-11-21,2008-05-02,164,0,70,542,612,52,77,129,741,22,140,NE - Valentine
58,2008-2009,2008-11-06,2009-04-10,156,0,88,560,648,52,79,131,779,25,192,NE - Valentine
59,2009-2010,2009-10-11,2010-03-12,153,0,107,482,589,35,80,115,704,29,182,NE - Valentine
60,2010-2011,2010-11-11,2011-04-20,161,0,131,572,703,78,193,271,974,36,293,NE - Valentine
61,2011-2012,2011-11-01,2012-03-06,127,0,25,412,437,28,36,64,501,15,69,NE - Valentine
62,2012-2013,2012-10-24,2013-05-01,190,0,77,509,586,82,110,192,778,35,213,NE - Valentine
65,2015-2016,2015-11-20,2016-04-27,160,0,52,389,441,54,200,254,695,19,133,NE - Valentine
66,2016-2017,2016-10-06,2017-04-10,187,3,84,478,562,64,140,204,766,23,197,NE - Valentine
67,2017-2018,2017-11-06,2018-04-18,164,0,107,527,634,70,133,203,837,37,253,NE - Valentine
68,2018-2019,2018-10-14,2019-04-30,199,0,122,560,682,69,211,280,962,31,219,NE - Valentine
69,2019-2020,2019-10-10,2020-04-16,190,0,34,464,498,58,144,202,700,25,139,NE - Valentine
0,1950-1951,1950-12-01,1951-03-30,120,0,12,266,278,36,42,78,356,19,92,NV - Battle Mountain
1,1951-1952,1951-11-24,1952-03-20,118,0,40,392,432,71,222,293,725,25,141,NV - Battle Mountain
2,1952-1953,1952-12-01,1953-05-26,177,0,3,332,335,30,26,56,391,16,60,NV - Battle Mountain
3,1953-1954,1953-11-20,1954-03-30,131,0,3,361,364,26,14,40,404,14,59,NV - Battle Mountain
4,1954-1955,1954-12-01,1955-04-18,139,0,26,539,565,19,91,110,675,9,52,NV - Battle Mountain
5,1955-1956,1955-11-14,1956-04-11,150,0,22,349,371,50,95,145,516,22,112,NV - Battle Mountain
6,1956-1957,1956-11-01,1957-03-22,142,0,19,494,513,15,22,37,550,10,62,NV - Battle Mountain
7,1957-1958,1957-11-04,1958-03-06,123,0,2,289,291,10,4,14,305,6,25,NV - Battle Mountain
8,1958-1959,1958-11-14,1959-04-18,156,0,7,411,418,21,5,26,444,15,62,NV - Battle Mountain
9,1959-1960,1959-12-01,1960-05-21,173,0,22,421,443,30,39,69,512,15,84,NV - Battle Mountain
10,1960-1961,1960-11-14,1961-04-23,161,0,3,413,416,22,4,26,442,16,50,NV - Battle Mountain
11,1961-1962,1961-10-27,1962-03-12,137,0,52,466,518,55,161,216,734,28,139,NV - Battle Mountain
12,1962-1963,1962-11-16,1963-05-11,177,6,11,435,446,26,5,31,477,12,47,NV - Battle Mountain
13,1963-1964,1963-12-01,1964-04-23,145,0,9,300,309,43,27,70,379,15,71,NV - Battle Mountain
14,1964-1965,1964-11-12,1965-05-08,178,0,25,344,369,68,59,127,496,19,108,NV - Battle Mountain
15,1965-1966,1965-12-01,1966-03-03,93,2,14,284,298,30,43,73,371,11,50,NV - Battle Mountain
16,1966-1967,1966-12-01,1967-04-28,149,0,10,312,322,74,88,162,484,20,115,NV - Battle Mountain
17,1967-1968,1967-11-30,1968-02-29,92,0,16,273,289,29,26,55,344,9,62,NV - Battle Mountain
18,1968-1969,1968-11-15,1969-03-10,116,1,12,272,284,104,106,210,494,25,178,NV - Battle Mountain
20,1970-1971,1970-12-01,1971-04-26,147,0,25,327,352,56,91,147,499,19,121,NV - Battle Mountain
21,1971-1972,1971-10-16,1972-02-29,137,0,32,376,408,43,129,172,580,14,78,NV - Battle Mountain
23,1973-1974,1973-11-21,1974-04-27,158,3,9,307,316,31,4,35,351,13,57,NV - Battle Mountain
24,1974-1975,1974-12-01,1975-04-26,147,1,23,335,358,32,49,81,439,13,67,NV - Battle Mountain
25,1975-1976,1975-11-27,1976-04-26,152,0,11,343,354,45,28,73,427,17,88,NV - Battle Mountain
26,1976-1977,1976-11-27,1977-05-17,172,0,7,521,528,18,22,40,568,7,34,NV - Battle Mountain
27,1977-1978,1977-11-20,1978-04-08,140,0,3,196,199,37,31,68,267,13,59,NV - Battle Mountain
28,1978-1979,1978-11-11,1979-03-17,127,0,28,388,416,46,47,93,509,16,76,NV - Battle Mountain
29,1979-1980,1979-10-31,1980-02-29,122,0,5,313,318,30,29,59,377,10,51,NV - Battle Mountain
30,1980-1981,1980-12-01,1981-03-30,120,0,1,315,316,16,0,16,332,7,29,NV - Battle Mountain
31,1981-1982,1981-10-12,1982-04-01,172,10,14,370,384,11,3,14,398,9,31,NV - Battle Mountain
36,1986-1987,1986-12-01,1987-03-19,109,6,12,411,423,46,71,117,540,12,78,NV - Battle Mountain
39,1989-1990,1989-12-01,1990-03-12,102,6,5,276,281,18,9,27,308,10,37,NV - Battle Mountain
40,1990-1991,1990-11-26,1991-05-17,173,13,53,454,507,24,88,112,619,12,51,NV - Battle Mountain
42,1992-1993,1992-11-20,1993-03-07,108,6,60,461,521,78,437,515,1036,25,162,NV - Battle Mountain
43,1993-1994,1993-11-23,1994-02-28,98,4,2,318,320,16,60,76,396,9,32,NV - Battle Mountain
44,1994-1995,1994-11-02,1995-04-14,164,10,5,265,270,32,39,71,341,16,68,NV - Battle Mountain
45,1995-1996,1995-12-01,1996-04-20,142,13,7,239,246,43,88,131,377,15,68,NV - Battle Mountain
46,1996-1997,1996-11-17,1997-02-28,104,6,6,201,207,54,45,99,306,12,81,NV - Battle Mountain
47,1997-1998,1997-12-01,1998-03-29,119,7,3,223,226,20,4,24,250,11,37,NV - Battle Mountain
48,1998-1999,1998-10-29,1999-04-08,162,12,20,323,343,39,39,78,421,18,81,NV - Battle Mountain
49,1999-2000,1999-12-01,2000-03-19,110,9,0,243,243,24,4,28,271,12,39,NV - Battle Mountain
50,2000-2001,2000-11-14,2001-04-11,149,12,5,376,381,21,18,39,420,12,42,NV - Battle Mountain
51,2001-2002,2001-11-26,2002-03-08,103,5,5,244,249,20,9,29,278,11,48,NV - Battle Mountain
52,2002-2003,2002-12-01,2003-04-14,135,7,1,250,251,7,3,10,261,5,14,NV - Battle Mountain
53,2003-2004,2003-10-30,2004-02-29,123,5,18,299,317,61,70,131,448,20,91,NV - Battle Mountain
54,2004-2005,2004-11-27,2005-03-02,96,5,27,326,353,54,284,338,691,17,103,NV - Battle Mountain
55,2005-2006,2005-11-28,2006-04-17,141,10,6,236,242,22,7,29,271,16,56,NV - Battle Mountain
56,2006-2007,2006-11-28,2007-04-18,142,12,27,435,462,33,91,124,586,13,58,NV - Battle Mountain
57,2007-2008,2007-12-01,2008-06-04,187,12,11,332,343,16,11,27,370,11,39,NV - Battle Mountain
58,2008-2009,2008-12-01,2009-04-15,136,2,8,198,206,49,85,134,340,18,85,NV - Battle Mountain
59,2009-2010,2009-12-01,2010-05-28,179,2,10,206,216,26,37,63,279,14,49,NV - Battle Mountain
60,2010-2011,2010-11-10,2011-04-08,150,0,9,175,184,33,27,60,244,18,56,NV - Battle Mountain
61,2011-2012,2011-11-06,2012-03-06,122,0,0,232,232,18,6,24,256,8,30,NV - Battle Mountain
62,2012-2013,2012-10-25,2013-03-08,135,4,18,295,313,32,137,169,482,13,50,NV - Battle Mountain
63,2013-2014,2013-11-21,2014-03-30,130,12,6,191,197,19,78,97,294,7,34,NV - Battle Mountain
64,2014-2015,2014-11-13,2015-02-28,108,3,3,128,131,3,0,3,134,3,6,NV - Battle Mountain
66,2016-2017,2016-11-27,2017-05-13,168,6,17,209,226,32,62,94,320,13,57,NV - Battle Mountain
67,2017-2018,2017-12-01,2018-03-25,115,0,2,186,188,20,28,48,236,11,39,NV - Battle Mountain
68,2018-2019,2018-12-01,2019-03-04,94,3,1,161,162,26,45,71,233,13,45,NV - Battle Mountain
69,2019-2020,2019-09-29,2020-03-01,155,5,1,211,212,13,9,22,234,7,21,NV - Battle Mountain
0,1950-1951,1950-11-14,1951-05-01,169,0,23,357,380,73,92,165,545,30,153,NV - Elko
1,1951-1952,1951-11-11,1952-03-26,137,1,85,580,665,78,414,492,1157,54,276,NV - Elko
2,1952-1953,1952-11-14,1953-05-28,196,0,13,420,433,46,40,86,519,33,113,NV - Elko
3,1953-1954,1953-10-18,1954-03-30,164,0,26,471,497,60,146,206,703,28,139,NV - Elko
4,1954-1955,1954-12-01,1955-05-14,165,0,76,608,684,46,253,299,983,28,174,NV - Elko
5,1955-1956,1955-11-01,1956-04-11,163,0,48,496,544,114,257,371,915,45,294,NV - Elko
6,1956-1957,1956-10-23,1957-04-18,178,0,42,595,637,38,94,132,769,27,143,NV - Elko
7,1957-1958,1957-11-03,1958-04-03,152,0,5,432,437,63,46,109,546,33,139,NV - Elko
8,1958-1959,1958-11-15,1959-05-23,190,0,17,436,453,38,17,55,508,27,110,NV - Elko
9,1959-1960,1959-12-01,1960-05-21,173,0,44,467,511,47,89,136,647,33,169,NV - Elko
10,1960-1961,1960-11-13,1961-04-25,164,0,4,456,460,40,15,55,515,27,96,NV - Elko
11,1961-1962,1961-10-09,1962-05-15,219,0,66,532,598,86,165,251,849,48,238,NV - Elko
12,1962-1963,1962-11-16,1963-05-11,177,0,21,512,533,57,18,75,608,32,125,NV - Elko
13,1963-1964,1963-10-12,1964-05-05,207,0,43,680,723,99,310,409,1132,55,321,NV - Elko
14,1964-1965,1964-11-10,1965-05-07,179,0,23,457,480,77,61,138,618,44,203,NV - Elko
15,1965-1966,1965-10-15,1966-04-17,185,0,60,576,636,71,92,163,799,37,198,NV - Elko
16,1966-1967,1966-10-13,1967-05-12,212,0,46,520,566,107,295,402,968,44,218,NV - Elko
17,1967-1968,1967-11-29,1968-04-21,145,0,24,335,359,73,141,214,573,29,150,NV - Elko
18,1968-1969,1968-11-15,1969-04-07,144,0,29,391,420,101,186,287,707,49,249,NV - Elko
19,1969-1970,1969-10-03,1970-05-10,220,0,29,547,576,44,62,106,682,31,103,NV - Elko
20,1970-1971,1970-10-24,1971-05-22,211,0,52,408,460,110,129,239,699,52,250,NV - Elko
21,1971-1972,1971-10-01,1972-04-12,195,0,60,492,552,77,101,178,730,44,234,NV - Elko
22,1972-1973,1972-10-28,1973-04-19,174,0,87,481,568,60,41,101,669,35,173,NV - Elko
23,1973-1974,1973-11-20,1974-04-27,159,0,30,276,306,43,31,74,380,25,104,NV - Elko
24,1974-1975,1974-12-01,1975-05-19,170,0,50,403,453,83,108,191,644,35,164,NV - Elko
25,1975-1976,1975-10-07,1976-04-15,192,0,20,471,491,47,15,62,553,32,143,NV - Elko
26,1976-1977,1976-11-14,1977-05-17,185,0,13,479,492,25,26,51,543,19,55,NV - Elko
27,1977-1978,1977-11-19,1978-02-28,102,0,11,171,182,33,23,56,238,15,54,NV - Elko
28,1978-1979,1978-11-10,1979-05-07,179,0,35,413,448,48,47,95,543,29,118,NV - Elko
29,1979-1980,1979-10-31,1980-05-11,194,0,12,320,332,61,31,92,424,36,124,NV - Elko
30,1980-1981,1980-10-26,1981-05-16,203,0,1,349,350,22,4,26,376,17,42,NV - Elko
31,1981-1982,1981-11-27,1982-04-02,127,0,34,328,362,61,74,135,497,32,149,NV - Elko
32,1982-1983,1982-09-30,1983-05-06,219,0,25,351,376,83,153,236,612,35,131,NV - Elko
33,1983-1984,1983-11-19,1984-04-27,161,0,70,424,494,103,244,347,841,47,230,NV - Elko
34,1984-1985,1984-10-16,1985-04-25,192,0,46,523,569,56,93,149,718,39,164,NV - Elko
35,1985-1986,1985-10-21,1986-05-06,198,0,27,395,422,47,47,94,516,25,114,NV - Elko
36,1986-1987,1986-11-07,1987-03-24,138,0,21,497,518,30,18,48,566,15,80,NV - Elko
37,1987-1988,1987-11-25,1988-05-30,188,0,41,513,554,41,104,145,699,22,109,NV - Elko
38,1988-1989,1988-11-14,1989-03-26,133,0,93,581,674,80,311,391,1065,38,233,NV - Elko
39,1989-1990,1989-10-27,1990-05-24,210,0,14,544,558,44,27,71,629,25,106,NV - Elko
40,1990-1991,1990-11-19,1991-05-18,181,0,70,561,631,49,123,172,803,31,171,NV - Elko
41,1991-1992,1991-10-28,1992-03-17,142,0,10,399,409,28,22,50,459,16,55,NV - Elko
51,2001-2002,2001-11-24,2002-05-01,159,0,65,462,527,80,228,308,835,44,239,NV - Elko
52,2002-2003,2002-11-09,2003-05-09,182,0,4,340,344,34,13,47,391,25,78,NV - Elko
53,2003-2004,2003-10-30,2004-04-21,175,0,66,440,506,84,314,398,904,37,166,NV - Elko
54,2004-2005,2004-10-18,2005-04-20,185,0,61,455,516,95,409,504,1020,36,173,NV - Elko
55,2005-2006,2005-11-26,2006-04-17,143,0,21,297,318,73,55,128,446,41,155,NV - Elko
56,2006-2007,2006-11-13,2007-04-18,157,0,49,476,525,40,127,167,692,24,107,NV - Elko
57,2007-2008,2007-10-05,2008-04-20,199,0,50,574,624,85,370,455,1079,45,247,NV - Elko
58,2008-2009,2008-11-04,2009-04-24,172,0,22,399,421,66,134,200,621,34,167,NV - Elko
59,2009-2010,2009-10-05,2010-05-11,219,0,45,565,610,87,379,466,1076,45,212,NV - Elko
60,2010-2011,2010-10-26,2011-05-15,202,0,38,387,425,75,117,192,617,42,173,NV - Elko
61,2011-2012,2011-10-06,2012-04-06,184,0,6,504,510,46,38,84,594,20,98,NV - Elko
62,2012-2013,2012-10-24,2013-04-16,175,0,75,471,546,63,301,364,910,32,177,NV - Elko
63,2013-2014,2013-10-28,2014-05-10,195,0,29,402,431,40,47,87,518,28,105,NV - Elko
64,2014-2015,2014-11-13,2015-05-07,176,0,13,300,313,27,13,40,353,20,74,NV - Elko
65,2015-2016,2015-11-02,2016-04-23,174,0,60,426,486,97,388,485,971,48,237,NV - Elko
66,2016-2017,2016-11-16,2017-03-31,136,0,46,328,374,85,223,308,682,41,194,NV - Elko
67,2017-2018,2017-11-17,2018-04-12,147,0,14,339,353,47,41,88,441,26,116,NV - Elko
68,2018-2019,2018-11-24,2019-05-22,180,0,42,324,366,85,230,315,681,46,183,NV - Elko
69,2019-2020,2019-11-26,2020-03-25,121,0,9,235,244,48,78,126,370,33,104,NV - Elko
0,1950-1951,1950-11-09,1951-04-29,172,0,24,467,491,23,14,37,528,19,102,NV - Ely
1,1951-1952,1951-11-12,1952-04-10,151,0,89,707,796,122,681,803,1599,52,366,NV - Ely
2,1952-1953,1952-11-14,1953-05-24,192,0,31,557,588,43,97,140,728,26,132,NV - Ely
3,1953-1954,1953-10-23,1954-06-05,226,0,18,546,564,63,74,137,701,24,145,NV - Ely
4,1954-1955,1954-10-23,1955-06-01,222,0,68,734,802,82,286,368,1170,35,237,NV - Ely
5,1955-1956,1955-11-13,1956-05-27,197,0,42,542,584,87,207,294,878,32,225,NV - Ely
6,1956-1957,1956-10-28,1957-05-19,204,0,32,620,652,65,81,146,798,36,187,NV - Ely
7,1957-1958,1957-10-03,1958-04-24,204,0,14,543,557,103,83,186,743,43,202,NV - Ely
8,1958-1959,1958-09-23,1959-05-19,239,0,21,577,598,61,65,126,724,30,146,NV - Ely
9,1959-1960,1959-09-30,1960-05-18,232,0,52,672,724,72,198,270,994,44,246,NV - Ely
10,1960-1961,1960-10-09,1961-05-13,217,0,14,567,581,74,57,131,712,38,161,NV - Ely
11,1961-1962,1961-10-07,1962-04-09,185,0,43,624,667,75,137,212,879,36,207,NV - Ely
12,1962-1963,1962-11-16,1963-05-11,177,0,25,546,571,51,29,80,651,20,107,NV - Ely
13,1963-1964,1963-11-06,1964-05-07,184,0,40,696,736,114,173,287,1023,39,261,NV - Ely
14,1964-1965,1964-11-09,1965-05-24,197,0,37,565,602,90,153,243,845,43,245,NV - Ely
15,1965-1966,1965-10-15,1966-04-18,186,0,43,624,667,48,180,228,895,21,130,NV - Ely
16,1966-1967,1966-11-08,1967-06-01,206,0,19,508,527,82,117,199,726,35,196,NV - Ely
17,1967-1968,1967-11-21,1968-05-14,176,0,37,548,585,88,221,309,894,36,210,NV - Ely
18,1968-1969,1968-10-14,1969-04-24,193,0,31,559,590,93,184,277,867,38,216,NV - Ely
19,1969-1970,1969-10-04,1970-04-30,209,0,14,553,567,65,21,86,653,39,156,NV - Ely
20,1970-1971,1970-11-06,1971-05-31,207,0,50,560,610,98,206,304,914,36,227,NV - Ely
21,1971-1972,1971-09-30,1972-05-20,234,0,39,668,707,67,106,173,880,41,230,NV - Ely
22,1972-1973,1972-10-30,1973-05-05,188,0,49,678,727,92,220,312,1039,43,221,NV - Ely
23,1973-1974,1973-10-08,1974-05-19,224,0,28,602,630,71,83,154,784,35,194,NV - Ely
24,1974-1975,1974-10-29,1975-05-21,205,0,37,612,649,107,92,199,848,55,293,NV - Ely
25,1975-1976,1975-10-07,1976-04-18,195,0,22,632,654,91,159,250,904,44,251,NV - Ely
26,1976-1977,1976-11-14,1977-05-18,186,0,12,685,697,53,47,100,797,23,121,NV - Ely
27,1977-1978,1977-09-16,1978-05-16,243,0,11,470,481,95,81,176,657,45,182,NV - Ely
28,1978-1979,1978-09-17,1979-06-17,274,0,46,729,775,113,281,394,1169,50,276,NV - Ely
29,1979-1980,1979-10-28,1980-06-02,219,0,8,504,512,90,63,153,665,47,185,NV - Ely
30,1980-1981,1980-10-14,1981-05-20,219,0,6,504,510,76,106,182,692,29,130,NV - Ely
31,1981-1982,1981-10-11,1982-06-05,238,0,23,571,594,93,106,199,793,52,238,NV - Ely
32,1982-1983,1982-09-27,1983-05-16,232,0,13,554,567,110,165,275,842,53,221,NV - Ely
33,1983-1984,1983-11-19,1984-04-25,159,0,19,501,520,68,157,225,745,33,192,NV - Ely
34,1984-1985,1984-10-11,1985-05-10,212,0,38,697,735,89,290,379,1114,42,243,NV - Ely
35,1985-1986,1985-10-08,1986-05-07,212,0,21,501,522,86,117,203,725,40,208,NV - Ely
36,1986-1987,1986-09-24,1987-03-23,181,0,26,533,559,54,109,163,722,25,116,NV - Ely
37,1987-1988,1987-11-06,1988-05-29,206,0,33,576,609,63,210,273,882,28,167,NV - Ely
38,1988-1989,1988-11-14,1989-05-30,198,0,61,653,714,86,333,419,1133,28,219,NV - Ely
39,1989-1990,1989-10-25,1990-06-01,220,0,19,626,645,54,96,150,795,22,120,NV - Ely
40,1990-1991,1990-10-07,1991-05-30,236,0,31,710,741,63,57,120,861,32,143,NV - Ely
41,1991-1992,1991-10-26,1992-06-14,233,0,12,526,538,50,96,146,684,28,109,NV - Ely
42,1992-1993,1992-10-30,1993-05-05,188,0,38,704,742,96,487,583,1325,52,292,NV - Ely
43,1993-1994,1993-11-11,1994-04-28,169,0,19,621,640,57,113,170,810,34,165,NV - Ely
44,1994-1995,1994-10-15,1995-06-07,236,0,37,531,568,106,87,193,761,59,264,NV - Ely
51,2001-2002,2001-11-24,2002-04-20,148,0,51,573,624,70,198,268,892,27,183,NV - Ely
52,2002-2003,2002-10-01,2003-05-09,221,0,15,542,557,85,59,144,701,32,157,NV - Ely
53,2003-2004,2003-10-31,2004-04-22,175,0,42,525,567,66,283,349,916,28,136,NV - Ely
54,2004-2005,2004-10-18,2005-05-16,211,0,22,452,474,103,130,233,707,51,213,NV - Ely
58,2008-2009,2008-10-11,2009-04-25,197,0,33,556,589,82,172,254,843,33,211,NV - Ely
59,2009-2010,2009-10-04,2010-05-24,233,0,37,744,781,155,590,745,1526,49,317,NV - Ely
60,2010-2011,2010-11-08,2011-05-30,204,0,46,543,589,152,433,585,1174,38,258,NV - Ely
61,2011-2012,2011-10-05,2012-04-12,191,0,12,528,540,71,100,171,711,26,148,NV - Ely
62,2012-2013,2012-10-23,2013-04-18,178,0,55,553,608,92,366,458,1066,29,193,NV - Ely
63,2013-2014,2013-10-13,2014-05-10,210,0,25,542,567,71,206,277,844,23,125,NV - Ely
64,2014-2015,2014-11-02,2015-04-14,164,0,14,394,408,28,45,73,481,17,75,NV - Ely
65,2015-2016,2015-11-03,2016-04-28,178,0,59,586,645,139,523,662,1307,39,287,NV - Ely
66,2016-2017,2016-11-16,2017-05-18,184,4,32,495,527,97,299,396,923,34,213,NV - Ely
67,2017-2018,2017-09-21,2018-05-12,234,0,12,581,593,67,102,169,762,27,157,NV - Ely
68,2018-2019,2018-11-28,2019-05-22,176,0,38,447,485,104,233,337,822,50,251,NV - Ely
69,2019-2020,2019-11-21,2020-04-19,151,0,19,432,451,72,117,189,640,32,177,NV - Ely
0,1950-1951,1950-12-01,1951-02-28,90,0,0,37,37,0,0,0,37,0,0,NV - Las Vegas
1,1951-1952,1951-12-01,1952-02-29,91,0,0,60,60,0,0,0,60,0,0,NV - Las Vegas
2,1952-1953,1952-12-01,1953-02-28,90,0,0,30,30,0,0,0,30,0,0,NV - Las Vegas
3,1953-1954,1953-12-01,1954-02-28,90,0,0,42,42,0,0,0,42,0,0,NV - Las Vegas
4,1954-1955,1954-12-01,1955-02-28,90,0,0,68,68,2,0,2,70,1,3,NV - Las Vegas
5,1955-1956,1955-12-01,1956-02-29,91,0,0,37,37,0,0,0,37,0,0,NV - Las Vegas
6,1956-1957,1956-12-01,1957-02-28,90,0,0,50,50,2,0,2,52,1,4,NV - Las Vegas
7,1957-1958,1957-12-01,1958-02-28,90,0,0,32,32,0,0,0,32,0,0,NV - Las Vegas
8,1958-1959,1958-11-16,1959-02-28,105,0,0,41,41,2,0,2,43,1,3,NV - Las Vegas
9,1959-1960,1959-12-01,1960-02-29,91,0,0,36,36,1,0,1,37,1,2,NV - Las Vegas
10,1960-1961,1960-12-01,1961-02-28,90,0,0,32,32,0,0,0,32,0,0,NV - Las Vegas
11,1961-1962,1961-12-01,1962-02-28,90,0,0,48,48,0,0,0,48,0,0,NV - Las Vegas
12,1962-1963,1962-12-01,1963-02-28,90,0,2,59,61,0,0,0,61,0,0,NV - Las Vegas
13,1963-1964,1963-12-01,1964-02-29,91,0,0,65,65,0,0,0,65,0,0,NV - Las Vegas
14,1964-1965,1964-11-15,1965-02-28,106,0,0,44,44,6,3,9,53,2,8,NV - Las Vegas
15,1965-1966,1965-12-01,1966-02-28,90,0,0,39,39,0,0,0,39,0,0,NV - Las Vegas
16,1966-1967,1966-12-01,1967-02-28,90,0,0,35,35,0,0,0,35,0,0,NV - Las Vegas
17,1967-1968,1967-12-01,1968-02-29,91,0,0,40,40,3,2,5,45,1,4,NV - Las Vegas
18,1968-1969,1968-12-01,1969-02-28,90,0,0,43,43,0,0,0,43,0,0,NV - Las Vegas
19,1969-1970,1969-12-01,1970-02-28,90,0,0,42,42,0,0,0,42,0,0,NV - Las Vegas
20,1970-1971,1970-12-01,1971-02-28,90,0,0,48,48,0,0,0,48,0,0,NV - Las Vegas
21,1971-1972,1971-12-01,1972-02-29,91,0,0,59,59,0,0,0,59,0,0,NV - Las Vegas
22,1972-1973,1972-12-01,1973-02-28,90,0,1,50,51,2,0,2,53,2,4,NV - Las Vegas
23,1973-1974,1973-12-01,1974-02-28,90,0,2,40,42,18,10,28,70,3,22,NV - Las Vegas
24,1974-1975,1974-12-01,1975-02-28,90,0,0,31,31,0,0,0,31,0,0,NV - Las Vegas
25,1975-1976,1975-12-01,1976-03-03,94,0,0,27,27,1,0,1,28,1,1,NV - Las Vegas
26,1976-1977,1976-12-01,1977-02-28,90,0,0,38,38,0,0,0,38,0,0,NV - Las Vegas
27,1977-1978,1977-12-01,1978-02-28,90,0,0,2,2,0,0,0,2,0,0,NV - Las Vegas
28,1978-1979,1978-12-01,1979-02-28,90,0,0,44,44,15,9,24,68,4,21,NV - Las Vegas
29,1979-1980,1979-12-01,1980-02-29,91,0,0,15,15,0,0,0,15,0,0,NV - Las Vegas
30,1980-1981,1980-12-01,1981-02-28,90,0,0,9,9,0,0,0,9,0,0,NV - Las Vegas
31,1981-1982,1981-12-01,1982-02-28,90,0,0,25,25,0,0,0,25,0,0,NV - Las Vegas
32,1982-1983,1982-12-01,1983-02-28,90,0,0,13,13,0,0,0,13,0,0,NV - Las Vegas
33,1983-1984,1983-12-01,1984-02-29,91,0,0,17,17,0,0,0,17,0,0,NV - Las Vegas
34,1984-1985,1984-12-01,1985-02-28,90,0,0,36,36,0,0,0,36,0,0,NV - Las Vegas
35,1985-1986,1985-12-01,1986-02-28,90,0,0,14,14,0,0,0,14,0,0,NV - Las Vegas
36,1986-1987,1986-12-01,1987-02-28,90,0,0,26,26,1,0,1,27,1,1,NV - Las Vegas
37,1987-1988,1987-12-01,1988-02-29,91,0,0,27,27,0,0,0,27,0,0,NV - Las Vegas
38,1988-1989,1988-12-01,1989-02-28,90,0,0,42,42,1,0,1,43,1,2,NV - Las Vegas
39,1989-1990,1989-12-01,1990-02-28,90,0,0,31,31,2,0,2,33,1,2,NV - Las Vegas
40,1990-1991,1990-12-01,1991-02-28,90,0,0,51,51,0,0,0,51,0,0,NV - Las Vegas
41,1991-1992,1991-12-01,1992-02-29,91,0,0,9,9,0,0,0,9,0,0,NV - Las Vegas
42,1992-1993,1992-12-01,1993-02-28,90,0,0,17,17,0,0,0,17,0,0,NV - Las Vegas
43,1993-1994,1993-12-01,1994-02-28,90,0,0,21,21,0,0,0,21,0,0,NV - Las Vegas
44,1994-1995,1994-12-01,1995-02-28,90,0,0,7,7,0,0,0,7,0,0,NV - Las Vegas
45,1995-1996,1995-12-01,1996-02-29,91,0,0,18,18,0,0,0,18,0,0,NV - Las Vegas
46,1996-1997,1996-12-01,1997-02-28,90,0,0,12,12,0,0,0,12,0,0,NV - Las Vegas
47,1997-1998,1997-12-01,1998-02-28,90,0,0,8,8,0,0,0,8,0,0,NV - Las Vegas
48,1998-1999,1998-12-01,1999-02-28,90,0,0,14,14,2,0,2,16,1,3,NV - Las Vegas
49,1999-2000,1999-12-01,2000-02-29,91,0,0,8,8,0,0,0,8,0,0,NV - Las Vegas
50,2000-2001,2000-12-01,2001-02-28,90,0,0,4,4,0,0,0,4,0,0,NV - Las Vegas
51,2001-2002,2001-12-01,2002-02-28,90,0,0,21,21,0,0,0,21,0,0,NV - Las Vegas
52,2002-2003,2002-12-01,2003-02-28,90,0,0,11,11,0,0,0,11,0,0,NV - Las Vegas
53,2003-2004,2003-12-01,2004-02-29,91,0,0,9,9,2,1,3,12,1,3,NV - Las Vegas
54,2004-2005,2004-12-01,2005-02-28,90,0,0,2,2,0,0,0,2,0,0,NV - Las Vegas
55,2005-2006,2005-12-01,2006-02-28,90,0,0,3,3,0,0,0,3,0,0,NV - Las Vegas
56,2006-2007,2006-12-01,2007-02-28,90,0,0,15,15,0,0,0,15,0,0,NV - Las Vegas
57,2007-2008,2007-12-01,2008-02-29,91,0,0,13,13,0,0,0,13,0,0,NV - Las Vegas
58,2008-2009,2008-12-01,2009-02-28,90,0,0,7,7,4,4,8,15,1,5,NV - Las Vegas
59,2009-2010,2009-12-01,2010-02-28,90,0,0,5,5,0,0,0,5,0,0,NV - Las Vegas
60,2010-2011,2010-12-01,2011-02-28,90,0,0,9,9,0,0,0,9,0,0,NV - Las Vegas
61,2011-2012,2011-12-01,2012-02-29,91,0,0,3,3,0,0,0,3,0,0,NV - Las Vegas
62,2012-2013,2012-12-01,2013-02-28,90,0,0,16,16,0,0,0,16,0,0,NV - Las Vegas
63,2013-2014,2013-12-01,2014-02-28,90,0,0,8,8,0,0,0,8,0,0,NV - Las Vegas
64,2014-2015,2014-12-01,2015-02-28,90,0,0,5,5,0,0,0,5,0,0,NV - Las Vegas
65,2015-2016,2015-12-01,2016-02-29,91,0,0,8,8,0,0,0,8,0,0,NV - Las Vegas
66,2016-2017,2016-12-01,2017-02-28,90,0,0,5,5,0,0,0,5,0,0,NV - Las Vegas
67,2017-2018,2017-12-01,2018-02-28,90,0,0,1,1,0,0,0,1,0,0,NV - Las Vegas
68,2018-2019,2018-12-01,2019-02-28,90,0,0,5,5,2,0,2,7,2,3,NV - Las Vegas
69,2019-2020,2019-12-01,2020-02-29,91,0,0,2,2,0,0,0,2,0,0,NV - Las Vegas
0,1950-1951,1950-12-01,1951-03-29,119,0,5,236,241,24,19,43,284,11,53,NV - Reno
1,1951-1952,1951-11-20,1952-03-23,125,0,16,317,333,85,134,219,552,28,147,NV - Reno
2,1952-1953,1952-11-15,1953-04-10,147,0,2,307,309,24,10,34,343,13,47,NV - Reno
3,1953-1954,1953-11-19,1954-04-30,163,0,0,313,313,39,15,54,367,15,70,NV - Reno
4,1954-1955,1954-12-01,1955-05-31,182,0,12,392,404,35,29,64,468,18,87,NV - Reno
5,1955-1956,1955-11-13,1956-04-14,154,0,16,324,340,54,67,121,461,19,97,NV - Reno
6,1956-1957,1956-10-23,1957-04-20,180,0,10,449,459,16,4,20,479,12,46,NV - Reno
7,1957-1958,1957-10-20,1958-04-07,170,0,0,279,279,50,11,61,340,26,85,NV - Reno
8,1958-1959,1958-11-14,1959-05-02,170,0,5,329,334,40,37,77,411,10,70,NV - Reno
9,1959-1960,1959-12-01,1960-04-22,144,0,12,321,333,33,50,83,416,18,75,NV - Reno
10,1960-1961,1960-10-09,1961-04-23,197,0,0,398,398,13,1,14,412,9,20,NV - Reno
11,1961-1962,1961-11-15,1962-05-16,183,0,25,388,413,70,39,109,522,21,131,NV - Reno
12,1962-1963,1962-12-01,1963-04-21,142,0,5,323,328,16,6,22,350,11,36,NV - Reno
13,1963-1964,1963-11-20,1964-05-06,169,0,1,356,357,59,27,86,443,19,90,NV - Reno
14,1964-1965,1964-11-12,1965-03-27,136,0,14,252,266,34,32,66,332,16,80,NV - Reno
15,1965-1966,1965-11-24,1966-03-01,98,0,8,264,272,24,11,35,307,14,58,NV - Reno
16,1966-1967,1966-12-01,1967-05-31,182,0,2,223,225,60,46,106,331,19,84,NV - Reno
17,1967-1968,1967-12-01,1968-03-16,107,0,9,253,262,30,22,52,314,11,50,NV - Reno
18,1968-1969,1968-11-14,1969-04-24,162,0,7,263,270,68,45,113,383,21,113,NV - Reno
19,1969-1970,1969-12-01,1970-04-27,148,0,2,246,248,13,6,19,267,9,26,NV - Reno
20,1970-1971,1970-10-25,1971-05-21,209,0,28,346,374,73,86,159,533,27,138,NV - Reno
21,1971-1972,1971-10-16,1972-04-13,181,0,25,421,446,54,126,180,626,19,101,NV - Reno
22,1972-1973,1972-12-01,1973-04-17,138,0,41,327,368,58,87,145,513,28,155,NV - Reno
23,1973-1974,1973-11-13,1974-04-24,163,0,15,261,276,44,52,96,372,21,88,NV - Reno
24,1974-1975,1974-12-01,1975-05-20,171,0,13,339,352,67,46,113,465,32,127,NV - Reno
25,1975-1976,1975-11-27,1976-04-15,141,0,5,362,367,40,31,71,438,16,80,NV - Reno
26,1976-1977,1976-12-01,1977-05-16,167,0,1,349,350,16,1,17,367,13,34,NV - Reno
27,1977-1978,1977-11-21,1978-05-24,185,0,0,169,169,22,8,30,199,15,43,NV - Reno
28,1978-1979,1978-10-31,1979-05-07,189,0,26,375,401,53,70,123,524,30,115,NV - Reno
29,1979-1980,1979-10-20,1980-04-02,166,0,2,263,265,36,12,48,313,19,60,NV - Reno
30,1980-1981,1980-12-01,1981-03-29,119,0,1,200,201,10,2,12,213,6,16,NV - Reno
31,1981-1982,1981-10-11,1982-05-09,211,0,10,277,287,42,48,90,377,23,79,NV - Reno
32,1982-1983,1982-09-29,1983-05-10,224,0,1,280,281,37,15,52,333,23,64,NV - Reno
33,1983-1984,1983-11-13,1984-03-16,125,0,7,175,182,26,29,55,237,15,52,NV - Reno
34,1984-1985,1984-10-16,1985-03-28,164,0,6,300,306,36,15,51,357,23,78,NV - Reno
35,1985-1986,1985-10-08,1986-04-01,176,0,13,217,230,36,47,83,313,12,68,NV - Reno
36,1986-1987,1986-11-29,1987-03-23,115,0,5,210,215,24,11,35,250,14,51,NV - Reno
37,1987-1988,1987-11-24,1988-02-29,98,0,8,213,221,28,27,55,276,16,62,NV - Reno
38,1988-1989,1988-11-23,1989-04-24,153,0,25,281,306,53,132,185,491,22,129,NV - Reno
39,1989-1990,1989-12-01,1990-03-11,101,0,6,241,247,46,75,121,368,15,87,NV - Reno
40,1990-1991,1990-11-25,1991-05-09,166,0,25,316,341,19,22,41,382,16,45,NV - Reno
41,1991-1992,1991-11-14,1992-02-29,108,0,1,189,190,15,2,17,207,8,23,NV - Reno
42,1992-1993,1992-12-01,1993-02-28,90,0,20,223,243,72,150,222,465,26,156,NV - Reno
43,1993-1994,1993-12-01,1994-02-28,90,0,0,142,142,11,4,15,157,9,18,NV - Reno
44,1994-1995,1994-11-03,1995-06-07,217,0,1,172,173,44,36,80,253,22,74,NV - Reno
54,2004-2005,2004-11-27,2005-02-28,94,1,12,163,175,67,209,276,451,10,84,NV - Reno
55,2005-2006,2005-12-01,2006-04-17,138,0,0,141,141,35,19,54,195,20,65,NV - Reno
56,2006-2007,2006-12-01,2007-04-17,138,0,5,192,197,14,5,19,216,9,26,NV - Reno
57,2007-2008,2007-09-28,2008-03-16,171,0,6,181,187,40,32,72,259,18,72,NV - Reno
58,2008-2009,2008-10-10,2009-04-03,176,0,3,180,183,25,13,38,221,16,48,NV - Reno
59,2009-2010,2009-10-27,2010-04-21,177,0,15,199,214,52,153,205,419,17,86,NV - Reno
60,2010-2011,2010-11-20,2011-04-07,139,0,7,176,183,50,39,89,272,21,82,NV - Reno
61,2011-2012,2011-12-01,2012-05-25,177,0,1,187,188,13,7,20,208,8,21,NV - Reno
62,2012-2013,2012-11-10,2013-03-06,117,0,12,187,199,15,23,38,237,11,41,NV - Reno
63,2013-2014,2013-11-20,2014-02-28,101,0,12,184,196,13,27,40,236,10,33,NV - Reno
64,2014-2015,2014-12-01,2015-02-28,90,0,2,84,86,4,1,5,91,3,7,NV - Reno
65,2015-2016,2015-11-09,2016-03-29,142,0,8,147,155,46,36,82,237,19,69,NV - Reno
66,2016-2017,2016-11-27,2017-03-05,99,0,4,125,129,39,43,82,211,14,59,NV - Reno
67,2017-2018,2017-12-01,2018-04-19,140,0,2,163,165,37,20,57,222,12,51,NV - Reno
68,2018-2019,2018-12-01,2019-03-23,113,0,1,115,116,41,29,70,186,18,60,NV - Reno
69,2019-2020,2019-11-28,2020-04-06,131,0,1,124,125,25,15,40,165,14,40,NV - Reno
0,1950-1951,1950-11-14,1951-03-29,136,0,12,264,276,32,14,46,322,21,90,NV - Winnemucca
1,1951-1952,1951-11-20,1952-03-20,122,0,27,313,340,78,37,115,455,33,155,NV - Winnemucca
2,1952-1953,1952-12-01,1953-05-25,176,0,2,312,314,13,5,18,332,8,30,NV - Winnemucca
3,1953-1954,1953-11-20,1954-03-29,130,0,2,327,329,21,7,28,357,15,56,NV - Winnemucca
4,1954-1955,1954-12-01,1955-04-25,146,0,25,506,531,34,139,173,704,19,103,NV - Winnemucca
5,1955-1956,1955-11-13,1956-04-14,154,0,17,335,352,51,52,103,455,22,109,NV - Winnemucca
6,1956-1957,1956-10-30,1957-03-31,153,0,17,477,494,33,75,108,602,13,76,NV - Winnemucca
7,1957-1958,1957-11-04,1958-04-07,155,0,1,340,341,33,11,44,385,16,57,NV - Winnemucca
8,1958-1959,1958-11-14,1959-02-28,107,0,7,279,286,30,34,64,350,14,67,NV - Winnemucca
9,1959-1960,1959-12-01,1960-05-04,156,0,17,424,441,28,58,86,527,21,115,NV - Winnemucca
10,1960-1961,1960-11-14,1961-04-24,162,0,1,404,405,12,2,14,419,12,29,NV - Winnemucca
11,1961-1962,1961-10-28,1962-05-20,205,0,31,500,531,65,169,234,765,25,138,NV - Winnemucca
12,1962-1963,1962-11-16,1963-04-19,155,0,15,443,458,27,8,35,493,17,62,NV - Winnemucca
13,1963-1964,1963-11-20,1964-05-02,165,0,5,406,411,65,70,135,546,32,131,NV - Winnemucca
14,1964-1965,1964-11-11,1965-05-24,195,0,15,364,379,44,49,93,472,28,114,NV - Winnemucca
15,1965-1966,1965-11-24,1966-03-03,100,0,7,298,305,28,31,59,364,18,74,NV - Winnemucca
16,1966-1967,1966-12-01,1967-04-27,148,0,2,279,281,48,41,89,370,22,87,NV - Winnemucca
17,1967-1968,1967-11-28,1968-03-17,111,0,11,277,288,26,41,67,355,13,62,NV - Winnemucca
18,1968-1969,1968-11-14,1969-04-24,162,0,8,291,299,68,96,164,463,37,154,NV - Winnemucca
19,1969-1970,1969-10-18,1970-05-10,205,0,8,475,483,34,31,65,548,15,59,NV - Winnemucca
20,1970-1971,1970-10-25,1971-05-21,209,0,19,424,443,47,21,68,511,31,119,NV - Winnemucca
21,1971-1972,1971-09-30,1972-04-13,197,0,20,478,498,64,96,160,658,34,152,NV - Winnemucca
22,1972-1973,1972-10-28,1973-04-19,174,0,53,430,483,60,90,150,633,33,175,NV - Winnemucca
23,1973-1974,1973-11-17,1974-04-27,162,0,11,299,310,51,33,84,394,31,125,NV - Winnemucca
24,1974-1975,1974-12-01,1975-05-20,171,0,23,345,368,53,59,112,480,33,127,NV - Winnemucca
25,1975-1976,1975-11-10,1976-04-25,168,0,6,355,361,34,8,42,403,20,72,NV - Winnemucca
26,1976-1977,1976-12-01,1977-05-17,168,0,4,473,477,23,14,37,514,15,42,NV - Winnemucca
27,1977-1978,1977-11-19,1978-05-24,187,0,2,184,186,38,13,51,237,23,68,NV - Winnemucca
28,1978-1979,1978-11-10,1979-05-07,179,0,23,420,443,55,48,103,546,36,139,NV - Winnemucca
29,1979-1980,1979-11-22,1980-04-02,133,0,5,270,275,16,8,24,299,15,52,NV - Winnemucca
30,1980-1981,1980-12-01,1981-03-29,119,0,1,317,318,13,1,14,332,12,29,NV - Winnemucca
31,1981-1982,1981-11-26,1982-04-06,132,0,15,233,248,50,19,69,317,31,111,NV - Winnemucca
32,1982-1983,1982-11-09,1983-05-11,184,0,6,288,294,34,53,87,381,19,59,NV - Winnemucca
33,1983-1984,1983-11-19,1984-04-27,161,0,33,299,332,52,87,139,471,36,143,NV - Winnemucca
34,1984-1985,1984-10-15,1985-04-25,193,0,37,529,566,57,222,279,845,32,159,NV - Winnemucca
35,1985-1986,1985-11-08,1986-05-05,179,0,24,307,331,44,50,94,425,24,98,NV - Winnemucca
36,1986-1987,1986-09-26,1987-04-18,205,0,7,479,486,27,14,41,527,19,68,NV - Winnemucca
37,1987-1988,1987-11-24,1988-05-06,165,0,15,377,392,24,57,81,473,15,61,NV - Winnemucca
38,1988-1989,1988-11-15,1989-04-24,161,0,40,420,460,41,125,166,626,26,129,NV - Winnemucca
39,1989-1990,1989-10-27,1990-03-11,136,0,11,391,402,28,37,65,467,16,73,NV - Winnemucca
40,1990-1991,1990-11-25,1991-04-25,152,0,58,479,537,37,89,126,663,18,78,NV - Winnemucca
41,1991-1992,1991-10-23,1992-03-16,146,1,7,289,296,16,3,19,315,14,42,NV - Winnemucca
42,1992-1993,1992-11-19,1993-04-11,144,1,28,368,396,57,172,229,625,30,158,NV - Winnemucca
43,1993-1994,1993-11-13,1994-04-25,164,0,3,391,394,26,13,39,433,16,55,NV - Winnemucca
44,1994-1995,1994-11-12,1995-06-06,207,0,12,266,278,36,30,66,344,22,73,NV - Winnemucca
51,2001-2002,2001-11-24,2002-04-18,146,0,10,298,308,34,28,62,370,20,83,NV - Winnemucca
52,2002-2003,2002-12-01,2003-05-09,160,0,3,256,259,13,1,14,273,11,29,NV - Winnemucca
53,2003-2004,2003-10-30,2004-02-29,123,0,12,251,263,47,48,95,358,26,89,NV - Winnemucca
54,2004-2005,2004-10-26,2005-03-28,154,0,28,333,361,45,217,262,623,25,92,NV - Winnemucca
55,2005-2006,2005-11-26,2006-04-17,143,0,9,282,291,42,31,73,364,21,86,NV - Winnemucca
56,2006-2007,2006-11-11,2007-04-18,159,0,18,450,468,28,50,78,546,12,62,NV - Winnemucca
57,2007-2008,2007-11-27,2008-04-20,146,0,16,340,356,37,42,79,435,26,100,NV - Winnemucca
58,2008-2009,2008-10-11,2009-04-16,188,0,15,425,440,53,73,126,566,24,141,NV - Winnemucca
59,2009-2010,2009-11-12,2010-05-11,181,0,12,388,400,38,60,98,498,24,89,NV - Winnemucca
60,2010-2011,2010-11-10,2011-04-29,171,0,20,318,338,61,99,160,498,30,121,NV - Winnemucca
61,2011-2012,2011-11-04,2012-03-19,137,0,1,454,455,36,24,60,515,17,76,NV - Winnemucca
62,2012-2013,2012-10-23,2013-02-28,129,0,47,417,464,35,151,186,650,20,84,NV - Winnemucca
63,2013-2014,2013-10-28,2014-04-02,157,0,32,415,447,32,106,138,585,13,76,NV - Winnemucca
64,2014-2015,2014-11-13,2015-04-25,164,0,3,289,292,9,2,11,303,6,18,NV - Winnemucca
65,2015-2016,2015-11-25,2016-03-28,125,0,18,239,257,34,45,79,336,23,86,NV - Winnemucca
66,2016-2017,2016-11-27,2017-05-13,168,0,25,286,311,30,63,93,404,22,83,NV - Winnemucca
67,2017-2018,2017-12-01,2018-04-19,140,0,3,307,310,44,38,82,392,20,92,NV - Winnemucca
68,2018-2019,2018-11-29,2019-04-30,153,0,15,240,255,62,102,164,419,31,126,NV - Winnemucca
69,2019-2020,2019-09-29,2020-06-07,253,0,4,439,443,22,11,33,476,17,55,NV - Winnemucca
0,1950-1951,1950-11-22,1951-03-30,129,11,105,485,590,92,289,381,971,29,220,NH - Berlin
1,1951-1952,1951-11-02,1952-03-31,151,14,117,603,720,135,687,822,1542,24,271,NH - Berlin
3,1953-1954,1953-11-06,1954-04-18,164,17,110,539,649,171,417,588,1237,32,337,NH - Berlin
5,1955-1956,1955-11-18,1956-04-03,138,7,166,663,829,147,713,860,1689,34,302,NH - Berlin
8,1958-1959,1958-11-22,1959-04-29,159,19,170,733,903,122,600,722,1625,44,384,NH - Berlin
9,1959-1960,1959-10-19,1960-04-10,175,10,99,538,637,162,701,863,1500,52,354,NH - Berlin
10,1960-1961,1960-12-01,1961-04-17,138,1,135,644,779,143,648,791,1570,40,340,NH - Berlin
12,1962-1963,1962-10-25,1963-05-11,199,6,137,679,816,147,701,848,1664,39,304,NH - Berlin
13,1963-1964,1963-10-30,1964-04-06,160,0,121,645,766,157,455,612,1378,46,374,NH - Berlin
14,1964-1965,1964-10-21,1965-04-18,180,0,146,676,822,107,515,622,1444,53,417,NH - Berlin
15,1965-1966,1965-11-02,1966-05-11,191,7,111,602,713,145,613,758,1471,37,290,NH - Berlin
16,1966-1967,1966-11-05,1967-05-08,185,0,148,686,834,112,615,727,1561,41,311,NH - Berlin
17,1967-1968,1967-11-15,1968-03-25,132,1,185,700,885,123,671,794,1679,45,413,NH - Berlin
20,1970-1971,1970-12-01,1971-04-18,139,0,194,704,898,215,1097,1312,2210,62,585,NH - Berlin
24,1974-1975,1974-11-22,1975-04-17,147,1,101,589,690,132,791,923,1613,31,246,NH - Berlin
25,1975-1976,1975-11-26,1976-04-26,153,2,155,705,860,122,549,671,1531,29,303,NH - Berlin
26,1976-1977,1976-10-28,1977-04-08,163,1,192,676,868,127,793,920,1788,27,275,NH - Berlin
27,1977-1978,1977-11-15,1978-05-01,168,1,180,718,898,170,1181,1351,2249,30,334,NH - Berlin
28,1978-1979,1978-11-21,1979-04-11,142,0,191,608,799,132,793,925,1724,32,315,NH - Berlin
32,1982-1983,1982-11-16,1983-04-13,149,12,84,498,582,80,361,441,1023,19,147,NH - Berlin
33,1983-1984,1983-11-05,1984-04-10,158,8,126,602,728,134,759,893,1621,24,247,NH - Berlin
34,1984-1985,1984-11-14,1985-04-07,145,11,111,565,676,119,563,682,1358,32,256,NH - Berlin
35,1985-1986,1985-11-16,1986-03-26,131,6,139,553,692,98,837,935,1627,20,195,NH - Berlin
36,1986-1987,1986-11-05,1987-04-30,177,18,126,590,716,160,1192,1352,2068,25,274,NH - Berlin
37,1987-1988,1987-11-06,1988-04-17,164,2,122,604,726,113,763,876,1602,23,225,NH - Berlin
38,1988-1989,1988-11-30,1989-04-11,133,12,131,559,690,64,208,272,962,24,162,NH - Berlin
39,1989-1990,1989-11-05,1990-04-06,153,2,170,626,796,124,590,714,1510,31,285,NH - Berlin
40,1990-1991,1990-11-09,1991-03-27,139,7,98,467,565,90,465,555,1120,20,183,NH - Berlin
41,1991-1992,1991-11-12,1992-04-18,159,2,153,610,763,96,440,536,1299,21,190,NH - Berlin
42,1992-1993,1992-11-06,1993-04-11,157,3,149,646,795,154,711,865,1660,34,364,NH - Berlin
44,1994-1995,1994-11-24,1995-04-16,144,1,116,512,628,96,526,622,1250,22,198,NH - Berlin
45,1995-1996,1995-11-10,1996-04-18,161,1,183,617,800,192,812,1004,1804,43,382,NH - Berlin
46,1996-1997,1996-11-14,1997-04-13,151,1,119,513,632,112,521,633,1265,28,236,NH - Berlin
47,1997-1998,1997-10-27,1998-03-28,153,5,76,474,550,138,643,781,1331,32,245,NH - Berlin
48,1998-1999,1998-11-18,1999-03-31,134,2,86,453,539,110,520,630,1169,26,258,NH - Berlin
49,1999-2000,1999-11-13,2000-04-12,152,2,125,468,593,95,391,486,1079,26,214,NH - Berlin
50,2000-2001,2000-10-29,2001-04-23,177,5,144,627,771,180,1020,1200,1971,35,326,NH - Berlin
51,2001-2002,2001-11-05,2002-05-14,191,1,63,432,495,105,548,653,1148,29,193,NH - Berlin
52,2002-2003,2002-11-02,2003-04-09,159,5,190,690,880,109,802,911,1791,29,218,NH - Berlin
53,2003-2004,2003-10-23,2004-04-06,167,13,174,599,773,127,816,943,1716,24,246,NH - Berlin
54,2004-2005,2004-11-05,2005-04-03,150,3,154,600,754,132,574,706,1460,27,308,NH - Berlin
55,2005-2006,2005-10-26,2006-04-07,164,3,118,461,579,73,272,345,924,22,165,NH - Berlin
56,2006-2007,2006-11-21,2007-04-19,150,5,153,550,703,120,468,588,1291,24,236,NH - Berlin
57,2007-2008,2007-11-17,2008-04-10,146,7,118,564,682,169,913,1082,1764,39,355,NH - Berlin
58,2008-2009,2008-11-19,2009-03-27,129,6,163,624,787,145,782,927,1714,26,300,NH - Berlin
59,2009-2010,2009-10-13,2010-04-29,199,16,118,442,560,122,558,680,1240,26,206,NH - Berlin
60,2010-2011,2010-11-26,2011-04-17,143,9,131,611,742,181,914,1095,1837,34,353,NH - Berlin
61,2011-2012,2011-10-30,2012-03-28,151,1,58,430,488,84,345,429,917,21,160,NH - Berlin
62,2012-2013,2012-11-25,2013-04-13,140,1,96,437,533,135,684,819,1352,34,277,NH - Berlin
63,2013-2014,2013-11-13,2014-04-16,155,1,181,705,886,118,704,822,1708,28,290,NH - Berlin
64,2014-2015,2014-11-14,2015-04-10,148,4,184,734,918,151,804,955,1873,39,392,NH - Berlin
65,2015-2016,2015-11-25,2016-04-07,135,0,78,425,503,53,174,227,730,19,155,NH - Berlin
66,2016-2017,2016-11-21,2017-04-09,140,1,118,493,611,183,758,941,1552,43,371,NH - Berlin
67,2017-2018,2017-11-10,2018-04-20,162,0,156,596,752,161,726,887,1639,49,412,NH - Berlin
68,2018-2019,2018-10-18,2019-04-13,178,0,159,692,851,187,1002,1189,2040,57,466,NH - Berlin
69,2019-2020,2019-11-09,2020-05-09,183,0,101,553,654,146,637,783,1437,49,350,NH - Berlin
0,1950-1951,1950-12-01,1951-03-26,116,0,45,333,378,52,132,184,562,24,166,NH - Concord
1,1951-1952,1951-11-01,1952-04-01,153,0,60,465,525,127,740,867,1392,36,288,NH - Concord
2,1952-1953,1952-10-28,1953-04-20,175,0,33,360,393,54,160,214,607,27,135,NH - Concord
3,1953-1954,1953-11-07,1954-04-01,146,3,62,377,439,58,125,183,622,29,178,NH - Concord
4,1954-1955,1954-11-24,1955-04-03,131,0,65,382,447,62,110,172,619,27,153,NH - Concord
5,1955-1956,1955-11-11,1956-04-24,166,0,79,500,579,129,578,707,1286,47,302,NH - Concord
6,1956-1957,1956-11-10,1957-04-10,152,0,73,503,576,109,435,544,1120,29,252,NH - Concord
7,1957-1958,1957-12-01,1958-04-28,149,3,56,348,404,95,487,582,986,33,174,NH - Concord
8,1958-1959,1958-11-28,1959-04-01,125,0,85,537,622,101,472,573,1195,30,237,NH - Concord
9,1959-1960,1959-11-18,1960-03-31,135,0,39,377,416,86,551,637,1053,34,193,NH - Concord
10,1960-1961,1960-12-01,1961-04-14,135,0,85,544,629,86,590,676,1305,24,184,NH - Concord
11,1961-1962,1961-11-20,1962-04-13,145,0,74,457,531,99,641,740,1271,32,237,NH - Concord
12,1962-1963,1962-11-18,1963-04-23,157,0,82,520,602,87,636,723,1325,31,190,NH - Concord
13,1963-1964,1963-12-01,1964-03-29,120,0,74,460,534,102,477,579,1113,29,242,NH - Concord
14,1964-1965,1964-12-01,1965-04-18,139,0,88,436,524,60,215,275,799,30,186,NH - Concord
15,1965-1966,1965-11-18,1966-05-08,172,0,51,487,538,93,456,549,1087,27,159,NH - Concord
16,1966-1967,1966-12-01,1967-04-19,140,0,68,491,559,113,615,728,1287,34,230,NH - Concord
17,1967-1968,1967-11-15,1968-03-17,124,0,95,503,598,85,441,526,1124,27,203,NH - Concord
18,1968-1969,1968-11-10,1969-04-06,148,3,80,482,562,118,768,886,1448,33,208,NH - Concord
19,1969-1970,1969-10-22,1970-04-03,164,0,113,564,677,85,498,583,1260,34,243,NH - Concord
20,1970-1971,1970-12-01,1971-04-16,137,0,121,541,662,133,956,1089,1751,39,307,NH - Concord
21,1971-1972,1971-11-09,1972-04-20,164,0,79,526,605,140,588,728,1333,43,302,NH - Concord
22,1972-1973,1972-11-05,1973-04-11,158,0,102,457,559,88,609,697,1256,35,240,NH - Concord
23,1973-1974,1973-12-01,1974-04-11,132,0,80,420,500,59,184,243,743,26,158,NH - Concord
24,1974-1975,1974-11-21,1975-04-06,137,0,57,484,541,100,545,645,1186,36,228,NH - Concord
25,1975-1976,1975-11-24,1976-03-20,118,0,124,533,657,106,428,534,1191,34,332,NH - Concord
26,1976-1977,1976-11-09,1977-04-08,151,0,136,628,764,123,570,693,1457,34,305,NH - Concord
27,1977-1978,1977-11-27,1978-04-01,126,0,134,559,693,118,584,702,1395,31,297,NH - Concord
28,1978-1979,1978-11-21,1979-04-11,142,0,118,467,585,112,521,633,1218,32,245,NH - Concord
29,1979-1980,1979-10-10,1980-03-17,160,0,71,458,529,41,56,97,626,14,90,NH - Concord
30,1980-1981,1980-11-17,1981-03-27,131,0,103,521,624,81,168,249,873,28,205,NH - Concord
31,1981-1982,1981-12-01,1982-04-12,133,0,110,539,649,131,841,972,1621,43,332,NH - Concord
32,1982-1983,1982-11-24,1983-03-28,125,0,53,333,386,56,123,179,565,22,119,NH - Concord
33,1983-1984,1983-12-01,1984-04-01,123,0,93,452,545,112,402,514,1059,34,254,NH - Concord
34,1984-1985,1984-11-20,1985-04-18,150,0,80,425,505,71,199,270,775,28,193,NH - Concord
35,1985-1986,1985-11-16,1986-03-21,126,0,73,441,514,73,409,482,996,31,189,NH - Concord
36,1986-1987,1986-11-06,1987-04-29,175,0,54,472,526,118,601,719,1245,32,214,NH - Concord
37,1987-1988,1987-11-06,1988-04-16,163,0,71,474,545,96,407,503,1048,33,194,NH - Concord
38,1988-1989,1988-11-20,1989-04-08,140,0,68,443,511,50,57,107,618,32,164,NH - Concord
39,1989-1990,1989-11-20,1990-03-31,132,0,98,492,590,92,335,427,1017,29,229,NH - Concord
40,1990-1991,1990-11-12,1991-04-02,142,0,49,369,418,48,119,167,585,21,109,NH - Concord
41,1991-1992,1991-11-11,1992-04-18,160,0,69,445,514,54,100,154,668,36,209,NH - Concord
42,1992-1993,1992-11-17,1993-04-27,162,0,84,496,580,142,442,584,1164,41,307,NH - Concord
43,1993-1994,1993-11-20,1994-03-28,129,0,129,546,675,124,605,729,1404,41,369,NH - Concord
44,1994-1995,1994-11-24,1995-04-05,133,0,57,372,429,51,131,182,611,23,131,NH - Concord
45,1995-1996,1995-11-09,1996-04-11,155,0,107,496,603,156,460,616,1219,49,372,NH - Concord
46,1996-1997,1996-11-14,1997-04-09,147,2,60,380,440,107,343,450,890,39,244,NH - Concord
47,1997-1998,1997-11-14,1998-03-26,133,0,29,318,347,88,317,405,752,31,169,NH - Concord
48,1998-1999,1998-11-16,1999-03-16,121,0,52,347,399,60,185,245,644,26,161,NH - Concord
49,1999-2000,1999-12-01,2000-03-21,112,1,69,357,426,71,234,305,731,18,146,NH - Concord
51,2001-2002,2001-12-01,2002-04-26,147,0,23,296,319,48,161,209,528,20,95,NH - Concord
52,2002-2003,2002-10-23,2003-04-09,169,0,111,597,708,127,828,955,1663,42,294,NH - Concord
53,2003-2004,2003-12-01,2004-03-23,114,3,96,401,497,78,385,463,960,23,171,NH - Concord
54,2004-2005,2004-11-02,2005-04-02,152,0,86,464,550,116,556,672,1222,34,295,NH - Concord
55,2005-2006,2005-11-23,2006-03-20,118,0,57,359,416,71,314,385,801,19,137,NH - Concord
56,2006-2007,2006-12-01,2007-04-15,136,0,78,383,461,73,291,364,825,23,147,NH - Concord
57,2007-2008,2007-11-20,2008-04-14,147,0,55,440,495,167,1235,1402,1897,37,293,NH - Concord
59,2009-2010,2009-12-01,2010-03-05,95,2,56,272,328,74,420,494,822,19,126,NH - Concord
60,2010-2011,2010-12-01,2011-04-23,144,2,73,452,525,116,737,853,1378,26,238,NH - Concord
61,2011-2012,2011-10-27,2012-03-11,137,0,30,308,338,68,204,272,610,19,122,NH - Concord
62,2012-2013,2012-11-08,2013-04-12,156,0,54,386,440,122,462,584,1024,35,241,NH - Concord
63,2013-2014,2013-11-24,2014-04-16,144,0,110,539,649,118,816,934,1583,36,314,NH - Concord
64,2014-2015,2014-11-17,2015-04-11,146,0,103,519,622,132,773,905,1527,37,305,NH - Concord
65,2015-2016,2015-12-01,2016-04-05,127,0,36,265,301,42,213,255,556,18,102,NH - Concord
66,2016-2017,2016-11-20,2017-04-09,141,0,49,359,408,123,742,865,1273,36,254,NH - Concord
67,2017-2018,2017-11-13,2018-04-16,155,0,80,404,484,125,599,724,1208,30,220,NH - Concord
68,2018-2019,2018-11-14,2019-04-09,147,0,70,426,496,76,461,537,1033,32,177,NH - Concord
69,2019-2020,2019-11-12,2020-05-09,180,0,43,363,406,68,410,478,884,30,154,NH - Concord
1,1951-1952,1951-11-01,1952-03-20,141,0,40,349,389,131,383,514,903,26,195,NH - Durham
2,1952-1953,1952-11-09,1953-04-14,157,1,17,276,293,48,115,163,456,20,91,NH - Durham
3,1953-1954,1953-11-07,1954-04-01,146,2,41,303,344,44,91,135,479,21,124,NH - Durham
4,1954-1955,1954-11-25,1955-03-27,123,3,42,310,352,73,208,281,633,27,151,NH - Durham
5,1955-1956,1955-10-25,1956-04-23,182,1,54,431,485,152,668,820,1305,44,260,NH - Durham
6,1956-1957,1956-11-18,1957-04-09,143,2,51,394,445,102,429,531,976,31,224,NH - Durham
7,1957-1958,1957-12-01,1958-03-28,118,3,33,278,311,68,374,442,753,14,102,NH - Durham
9,1959-1960,1959-11-29,1960-04-03,127,3,25,347,372,92,620,712,1084,24,159,NH - Durham
10,1960-1961,1960-12-01,1961-04-14,135,1,65,490,555,111,678,789,1344,18,177,NH - Durham
11,1961-1962,1961-11-20,1962-04-16,148,1,53,436,489,87,652,739,1228,23,174,NH - Durham
12,1962-1963,1962-10-26,1963-03-26,152,2,53,462,515,85,621,706,1221,30,172,NH - Durham
14,1964-1965,1964-12-01,1965-03-29,119,1,60,379,439,47,199,246,685,20,127,NH - Durham
15,1965-1966,1965-12-01,1966-03-28,118,1,33,339,372,93,531,624,996,19,150,NH - Durham
16,1966-1967,1966-12-01,1967-04-08,129,1,46,407,453,120,496,616,1069,34,234,NH - Durham
17,1967-1968,1967-11-15,1968-03-18,125,19,61,486,547,80,460,540,1087,15,148,NH - Durham
18,1968-1969,1968-11-13,1969-03-30,138,14,42,421,463,107,720,827,1290,21,161,NH - Durham
19,1969-1970,1969-10-22,1970-03-31,161,0,60,466,526,92,355,447,973,22,159,NH - Durham
20,1970-1971,1970-12-01,1971-04-07,128,8,81,487,568,138,915,1053,1621,31,255,NH - Durham
21,1971-1972,1971-11-11,1972-04-20,162,1,50,453,503,142,404,546,1049,24,221,NH - Durham
22,1972-1973,1972-11-14,1973-04-05,143,2,50,310,360,75,475,550,910,17,120,NH - Durham
24,1974-1975,1974-11-22,1975-04-05,135,7,24,348,372,68,295,363,735,20,103,NH - Durham
25,1975-1976,1975-11-24,1976-03-20,118,0,59,416,475,117,419,536,1011,24,199,NH - Durham
26,1976-1977,1976-11-10,1977-03-25,136,0,70,487,557,112,586,698,1255,19,180,NH - Durham
27,1977-1978,1977-11-28,1978-03-26,119,0,68,448,516,131,567,698,1214,21,225,NH - Durham
28,1978-1979,1978-11-21,1979-04-10,141,4,77,430,507,84,343,427,934,20,148,NH - Durham
29,1979-1980,1979-10-11,1980-03-17,159,1,41,428,469,36,53,89,558,9,57,NH - Durham
30,1980-1981,1980-11-18,1981-03-21,124,0,63,477,540,56,119,175,715,14,102,NH - Durham
31,1981-1982,1981-12-01,1982-04-12,133,6,66,467,533,130,659,789,1322,27,232,NH - Durham
32,1982-1983,1982-11-26,1983-03-01,96,6,35,284,319,74,252,326,645,13,108,NH - Durham
33,1983-1984,1983-12-01,1984-03-31,122,12,54,387,441,94,229,323,764,18,161,NH - Durham
34,1984-1985,1984-11-20,1985-04-16,148,0,47,419,466,53,143,196,662,17,130,NH - Durham
35,1985-1986,1985-11-22,1986-03-13,112,8,45,403,448,45,290,335,783,17,106,NH - Durham
36,1986-1987,1986-11-11,1987-03-24,134,1,35,395,430,84,649,733,1163,15,136,NH - Durham
37,1987-1988,1987-11-11,1988-03-21,132,2,45,368,413,68,335,403,816,13,105,NH - Durham
38,1988-1989,1988-12-01,1989-03-30,120,1,46,352,398,22,57,79,477,10,60,NH - Durham
39,1989-1990,1989-11-22,1990-03-11,110,2,75,395,470,60,338,398,868,14,118,NH - Durham
40,1990-1991,1990-11-13,1991-03-25,133,2,27,300,327,40,112,152,479,9,71,NH - Durham
41,1991-1992,1991-12-01,1992-04-18,140,1,51,373,424,39,119,158,582,13,97,NH - Durham
42,1992-1993,1992-11-17,1993-04-02,137,4,68,407,475,83,405,488,963,21,152,NH - Durham
43,1993-1994,1993-12-01,1994-03-19,109,0,98,415,513,67,489,556,1069,18,161,NH - Durham
44,1994-1995,1994-11-24,1995-03-07,104,0,39,284,323,29,174,203,526,8,65,NH - Durham
45,1995-1996,1995-11-29,1996-03-18,111,0,83,384,467,110,549,659,1126,24,226,NH - Durham
46,1996-1997,1996-11-15,1997-04-03,140,14,36,286,322,48,131,179,501,14,90,NH - Durham
47,1997-1998,1997-11-14,1998-03-23,130,2,19,256,275,50,221,271,546,12,79,NH - Durham
48,1998-1999,1998-12-01,1999-03-16,106,8,34,268,302,45,129,174,476,8,75,NH - Durham
49,1999-2000,1999-12-01,2000-03-19,110,3,50,286,336,34,181,215,551,9,74,NH - Durham
64,2014-2015,2014-11-18,2015-04-09,143,15,86,450,536,68,635,703,1239,23,161,NH - Durham
65,2015-2016,2015-12-01,2016-04-04,126,10,27,225,252,36,125,161,413,9,49,NH - Durham
67,2017-2018,2017-12-01,2018-04-15,136,3,85,364,449,87,316,403,852,16,150,NH - Durham
68,2018-2019,2018-11-15,2019-03-15,121,0,50,384,434,49,153,202,636,13,99,NH - Durham
69,2019-2020,2019-11-13,2020-03-24,133,4,32,319,351,52,202,254,605,13,83,NH - Durham
0,1950-1951,1950-12-01,1951-03-23,113,1,39,297,336,58,142,200,536,26,150,NH - Keene
1,1951-1952,1951-11-01,1952-03-20,141,0,40,396,436,125,435,560,996,38,243,NH - Keene
2,1952-1953,1952-10-29,1953-04-20,174,0,21,338,359,64,156,220,579,23,118,NH - Keene
3,1953-1954,1953-11-06,1954-04-01,147,5,38,338,376,61,137,198,574,24,141,NH - Keene
4,1954-1955,1954-11-29,1955-03-28,120,1,54,334,388,69,116,185,573,31,153,NH - Keene
5,1955-1956,1955-11-11,1956-04-26,168,0,65,490,555,141,471,612,1167,48,263,NH - Keene
6,1956-1957,1956-11-18,1957-04-10,144,0,53,450,503,116,354,470,973,36,247,NH - Keene
7,1957-1958,1957-12-01,1958-03-23,113,2,48,334,382,108,510,618,1000,27,189,NH - Keene
8,1958-1959,1958-11-03,1959-04-07,156,0,72,532,604,109,345,454,1058,41,255,NH - Keene
9,1959-1960,1959-11-29,1960-04-09,133,0,42,371,413,98,480,578,991,31,176,NH - Keene
10,1960-1961,1960-10-25,1961-04-17,175,3,76,631,707,99,628,727,1434,29,220,NH - Keene
11,1961-1962,1961-11-20,1962-04-14,146,4,58,435,493,124,652,776,1269,35,234,NH - Keene
12,1962-1963,1962-10-26,1963-03-28,154,1,64,578,642,111,718,829,1471,36,256,NH - Keene
15,1965-1966,1965-11-02,1966-05-08,188,1,46,450,496,84,349,433,929,34,201,NH - Keene
16,1966-1967,1966-11-06,1967-05-26,202,2,53,485,538,147,652,799,1337,39,255,NH - Keene
17,1967-1968,1967-11-10,1968-03-17,129,0,77,480,557,85,446,531,1088,34,207,NH - Keene
18,1968-1969,1968-11-11,1969-03-31,141,1,69,433,502,134,764,898,1400,35,222,NH - Keene
19,1969-1970,1969-10-23,1970-04-03,163,0,74,540,614,102,646,748,1362,36,234,NH - Keene
20,1970-1971,1970-12-01,1971-04-17,138,0,92,509,601,140,868,1008,1609,45,286,NH - Keene
21,1971-1972,1971-11-11,1972-04-14,156,4,62,462,524,134,425,559,1083,38,262,NH - Keene
23,1973-1974,1973-12-01,1974-04-11,132,2,60,377,437,72,236,308,745,21,152,NH - Keene
24,1974-1975,1974-11-21,1975-04-09,140,10,38,372,410,120,533,653,1063,34,211,NH - Keene
25,1975-1976,1975-11-26,1976-03-20,116,5,73,407,480,95,472,567,1047,28,209,NH - Keene
26,1976-1977,1976-11-11,1977-03-28,138,1,85,505,590,111,573,684,1274,32,245,NH - Keene
27,1977-1978,1977-11-28,1978-04-08,132,0,80,484,564,114,669,783,1347,27,221,NH - Keene
28,1978-1979,1978-11-21,1979-04-10,141,1,93,438,531,84,484,568,1099,29,159,NH - Keene
29,1979-1980,1979-12-01,1980-03-17,108,1,47,357,404,27,95,122,526,8,49,NH - Keene
30,1980-1981,1980-12-01,1981-03-27,117,1,75,463,538,38,221,259,797,19,122,NH - Keene
32,1982-1983,1982-11-26,1983-04-17,143,8,39,319,358,50,166,216,574,18,98,NH - Keene
33,1983-1984,1983-11-26,1984-03-31,127,10,60,404,464,95,402,497,961,23,159,NH - Keene
34,1984-1985,1984-11-18,1985-04-01,135,9,46,386,432,62,262,324,756,21,137,NH - Keene
35,1985-1986,1985-11-17,1986-03-21,125,5,61,407,468,65,358,423,891,24,139,NH - Keene
36,1986-1987,1986-11-12,1987-04-29,169,11,43,413,456,86,489,575,1031,19,124,NH - Keene
37,1987-1988,1987-11-11,1988-03-23,134,4,50,395,445,75,371,446,891,19,135,NH - Keene
38,1988-1989,1988-12-01,1989-04-02,123,3,48,365,413,50,68,118,531,23,117,NH - Keene
39,1989-1990,1989-11-20,1990-03-14,115,4,71,426,497,66,367,433,930,21,147,NH - Keene
40,1990-1991,1990-11-12,1991-03-24,133,2,43,332,375,37,136,173,548,15,82,NH - Keene
41,1991-1992,1991-12-01,1992-04-18,140,1,75,495,570,45,118,163,733,25,159,NH - Keene
42,1992-1993,1992-11-18,1993-04-07,141,2,79,528,607,117,509,626,1233,24,218,NH - Keene
43,1993-1994,1993-12-01,1994-04-06,127,0,128,599,727,97,774,871,1598,30,289,NH - Keene
44,1994-1995,1994-11-23,1995-04-06,135,2,59,414,473,35,184,219,692,12,73,NH - Keene
45,1995-1996,1995-11-14,1996-04-11,150,7,109,540,649,135,621,756,1405,34,298,NH - Keene
46,1996-1997,1996-11-16,1997-04-03,139,2,57,411,468,114,376,490,958,24,216,NH - Keene
47,1997-1998,1997-11-15,1998-03-25,131,0,26,377,403,60,463,523,926,18,115,NH - Keene
48,1998-1999,1998-12-01,1999-03-21,111,7,45,381,426,54,356,410,836,13,117,NH - Keene
49,1999-2000,1999-12-01,2000-03-20,111,5,67,402,469,69,291,360,829,18,157,NH - Keene
51,2001-2002,2001-12-01,2002-04-23,144,3,11,309,320,58,198,256,576,19,96,NH - Keene
53,2003-2004,2003-10-23,2004-03-24,154,5,90,467,557,92,483,575,1132,36,236,NH - Keene
54,2004-2005,2004-11-09,2005-03-25,137,6,79,479,558,111,347,458,1016,32,267,NH - Keene
55,2005-2006,2005-11-24,2006-03-21,118,2,50,386,436,94,294,388,824,31,216,NH - Keene
56,2006-2007,2006-12-01,2007-04-16,137,7,76,419,495,70,233,303,798,21,149,NH - Keene
58,2008-2009,2008-11-20,2009-03-24,125,2,80,496,576,111,638,749,1325,34,284,NH - Keene
59,2009-2010,2009-12-01,2010-03-08,98,3,56,303,359,63,370,433,792,24,126,NH - Keene
62,2012-2013,2012-11-28,2013-04-13,137,0,50,363,413,76,316,392,805,31,171,NH - Keene
63,2013-2014,2013-11-14,2014-04-16,154,1,109,571,680,99,572,671,1351,35,270,NH - Keene
64,2014-2015,2014-11-14,2015-04-09,147,1,107,586,693,112,577,689,1382,41,362,NH - Keene
65,2015-2016,2015-12-01,2016-04-05,127,4,37,281,318,40,98,138,456,21,105,NH - Keene
66,2016-2017,2016-11-21,2017-04-03,134,2,53,411,464,106,469,575,1039,33,244,NH - Keene
67,2017-2018,2017-11-12,2018-04-20,160,0,98,512,610,110,520,630,1240,37,259,NH - Keene
68,2018-2019,2018-11-15,2019-04-06,143,0,80,474,554,71,253,324,878,29,162,NH - Keene
69,2019-2020,2019-11-09,2020-05-09,183,0,52,426,478,79,271,350,828,30,159,NH - Keene
0,1950-1951,1950-09-17,1951-06-07,264,6,416,949,1365,228,1054,1282,2647,107,930,NH - Mount Washington
1,1951-1952,1951-09-07,1952-06-20,288,4,471,1081,1552,260,1178,1438,2990,101,1020,NH - Mount Washington
2,1952-1953,1952-08-23,1953-06-11,293,11,455,969,1424,399,1527,1926,3350,109,1168,NH - Mount Washington
3,1953-1954,1953-09-09,1954-06-06,271,1,439,1003,1442,283,759,1042,2484,131,1353,NH - Mount Washington
4,1954-1955,1954-09-12,1955-05-20,251,2,463,1020,1483,446,1280,1726,3209,139,1532,NH - Mount Washington
5,1955-1956,1955-09-08,1956-05-28,264,2,578,1184,1762,322,1574,1896,3658,121,1232,NH - Mount Washington
6,1956-1957,1956-09-08,1957-06-07,273,2,516,1102,1618,276,572,848,2466,108,1143,NH - Mount Washington
7,1957-1958,1957-07-01,1958-06-18,353,0,445,997,1442,478,1004,1482,2924,121,1353,NH - Mount Washington
8,1958-1959,1958-09-11,1959-06-20,283,3,586,1273,1859,342,841,1183,3042,131,1524,NH - Mount Washington
9,1959-1960,1959-09-14,1960-05-15,245,5,511,1012,1523,373,734,1107,2630,111,1259,NH - Mount Washington
10,1960-1961,1960-10-04,1961-06-15,255,2,569,1161,1730,299,602,901,2631,95,1066,NH - Mount Washington
11,1961-1962,1961-10-15,1962-05-10,208,0,503,1053,1556,270,855,1125,2681,84,937,NH - Mount Washington
12,1962-1963,1962-07-05,1963-05-23,323,3,549,1219,1768,365,1008,1373,3141,102,1172,NH - Mount Washington
13,1963-1964,1963-09-21,1964-06-06,260,0,541,1126,1667,346,607,953,2620,112,1276,NH - Mount Washington
14,1964-1965,1964-08-14,1965-06-19,310,0,547,1203,1750,277,527,804,2554,117,1178,NH - Mount Washington
15,1965-1966,1965-08-29,1966-06-02,278,0,542,1162,1704,409,1120,1529,3233,128,1314,NH - Mount Washington
16,1966-1967,1966-09-23,1967-06-01,252,2,518,1165,1683,367,427,794,2477,127,1319,NH - Mount Washington
17,1967-1968,1967-09-02,1968-06-21,294,0,552,1168,1720,303,197,500,2220,108,1196,NH - Mount Washington
18,1968-1969,1968-09-13,1969-05-26,256,0,530,1100,1630,747,1329,2076,3706,134,1789,NH - Mount Washington
19,1969-1970,1969-09-29,1970-05-09,223,0,550,1145,1695,560,1420,1980,3675,112,1540,NH - Mount Washington
20,1970-1971,1970-09-01,1971-05-27,269,0,565,1155,1720,539,1481,2020,3740,134,1651,NH - Mount Washington
21,1971-1972,1971-08-23,1972-06-11,294,0,542,1164,1706,522,1257,1779,3485,136,1793,NH - Mount Washington
22,1972-1973,1972-10-01,1973-06-17,260,0,464,1041,1505,591,1306,1897,3402,128,1618,NH - Mount Washington
23,1973-1974,1973-09-08,1974-05-29,264,0,501,1126,1627,512,955,1467,3094,144,1616,NH - Mount Washington
24,1974-1975,1974-09-22,1975-06-09,261,0,550,1115,1665,612,1359,1971,3636,142,1793,NH - Mount Washington
25,1975-1976,1975-09-13,1976-06-03,265,0,461,1123,1584,434,662,1096,2680,125,1462,NH - Mount Washington
26,1976-1977,1976-08-30,1977-06-10,285,0,658,1305,1963,678,1389,2067,4030,164,2165,NH - Mount Washington
27,1977-1978,1977-09-23,1978-06-15,266,0,620,1190,1810,528,1548,2076,3886,134,1692,NH - Mount Washington
28,1978-1979,1978-09-29,1979-06-25,270,0,525,1112,1637,296,521,817,2454,111,1261,NH - Mount Washington
29,1979-1980,1979-07-05,1980-06-11,343,0,530,1088,1618,222,408,630,2248,116,1085,NH - Mount Washington
30,1980-1981,1980-09-26,1981-05-19,236,0,571,1209,1780,311,937,1248,3028,132,1473,NH - Mount Washington
31,1981-1982,1981-09-09,1982-05-04,238,1,551,1148,1699,375,1221,1596,3295,142,1654,NH - Mount Washington
32,1982-1983,1982-08-21,1983-05-28,281,3,391,919,1310,266,588,854,2164,107,1013,NH - Mount Washington
33,1983-1984,1983-09-17,1984-05-28,255,1,489,1058,1547,534,1061,1595,3142,127,1454,NH - Mount Washington
34,1984-1985,1984-09-06,1985-06-26,294,2,521,1114,1635,463,618,1081,2716,118,1514,NH - Mount Washington
35,1985-1986,1985-09-12,1986-06-25,287,0,491,1080,1571,391,637,1028,2599,116,1343,NH - Mount Washington
36,1986-1987,1986-08-24,1987-05-06,256,6,492,1029,1521,467,1032,1499,3020,95,1260,NH - Mount Washington
37,1987-1988,1987-08-24,1988-06-30,312,0,507,1137,1644,531,896,1427,3071,138,1631,NH - Mount Washington
38,1988-1989,1988-07-01,1989-05-28,332,0,535,1162,1697,404,705,1109,2806,123,1300,NH - Mount Washington
39,1989-1990,1989-09-24,1990-06-06,256,0,539,1160,1699,439,430,869,2568,123,1443,NH - Mount Washington
40,1990-1991,1990-09-17,1991-06-05,262,6,401,970,1371,403,446,849,2220,104,1222,NH - Mount Washington
41,1991-1992,1991-09-20,1992-05-29,253,3,511,1137,1648,352,696,1048,2696,113,1290,NH - Mount Washington
42,1992-1993,1992-09-01,1993-06-07,280,5,482,1064,1546,286,447,733,2279,101,1113,NH - Mount Washington
43,1993-1994,1993-09-11,1994-06-03,266,3,543,1247,1790,372,671,1043,2833,118,1333,NH - Mount Washington
44,1994-1995,1994-09-05,1995-05-28,266,0,435,999,1434,265,497,762,2196,95,949,NH - Mount Washington
45,1995-1996,1995-09-15,1996-05-30,259,1,552,1153,1705,486,878,1364,3069,132,1587,NH - Mount Washington
46,1996-1997,1996-09-24,1997-06-06,256,11,521,1154,1675,594,1062,1656,3331,147,1711,NH - Mount Washington
47,1997-1998,1997-09-04,1998-06-08,278,7,368,891,1259,390,557,947,2206,103,1080,NH - Mount Washington
48,1998-1999,1998-09-23,1999-05-27,247,0,430,1015,1445,352,670,1022,2467,118,1193,NH - Mount Washington
49,1999-2000,1999-09-17,2000-06-07,265,3,421,1026,1447,357,537,894,2341,112,1150,NH - Mount Washington
50,2000-2001,2000-08-20,2001-06-01,286,0,533,1120,1653,396,1187,1583,3236,117,1373,NH - Mount Washington
51,2001-2002,2001-09-14,2002-06-02,262,0,398,976,1374,443,946,1389,2763,121,1317,NH - Mount Washington
52,2002-2003,2002-09-11,2003-06-01,264,0,563,1223,1786,349,797,1146,2932,122,1346,NH - Mount Washington
53,2003-2004,2003-09-30,2004-06-03,248,5,532,1134,1666,276,576,852,2518,100,1095,NH - Mount Washington
54,2004-2005,2004-09-19,2005-05-29,253,2,491,1025,1516,369,1027,1396,2912,120,1324,NH - Mount Washington
55,2005-2006,2005-09-30,2006-05-26,239,2,466,985,1451,475,1404,1879,3330,134,1465,NH - Mount Washington
56,2006-2007,2006-09-21,2007-06-22,275,0,476,1076,1552,349,856,1205,2757,127,1362,NH - Mount Washington
57,2007-2008,2007-07-01,2008-05-28,333,1,471,1064,1535,344,855,1199,2734,129,1339,NH - Mount Washington
58,2008-2009,2008-10-02,2009-06-07,249,0,493,1099,1592,327,1133,1460,3052,116,1283,NH - Mount Washington
60,2010-2011,2010-07-01,2011-06-02,337,16,509,1069,1578,338,1340,1678,3256,129,1341,NH - Mount Washington
61,2011-2012,2011-09-15,2012-06-08,268,0,380,880,1260,336,1137,1473,2733,135,1265,NH - Mount Washington
62,2012-2013,2012-09-15,2013-06-18,277,0,472,1000,1472,444,1169,1613,3085,136,1524,NH - Mount Washington
63,2013-2014,2013-09-08,2014-05-30,265,3,571,1191,1762,455,1123,1578,3340,142,1651,NH - Mount Washington
64,2014-2015,2014-08-07,2015-05-24,291,0,566,1200,1766,454,1235,1689,3455,150,1750,NH - Mount Washington
65,2015-2016,2015-10-03,2016-06-14,256,0,371,959,1330,308,745,1053,2383,121,1130,NH - Mount Washington
66,2016-2017,2016-09-24,2017-06-28,278,0,450,1005,1455,550,1050,1600,3055,135,1546,NH - Mount Washington
67,2017-2018,2017-09-01,2018-06-05,278,0,477,1065,1542,477,963,1440,2982,117,1385,NH - Mount Washington
68,2018-2019,2018-10-13,2019-06-04,235,0,550,1170,1720,448,1150,1598,3318,143,1661,NH - Mount Washington
69,2019-2020,2019-08-10,2020-06-02,298,0,453,1007,1460,440,1138,1578,3038,153,1502,NH - Mount Washington
24,1974-1975,1974-11-21,1975-04-18,149,0,56,505,561,153,958,1111,1672,44,306,NH - North Conway
25,1975-1976,1975-11-25,1976-04-26,154,0,113,583,696,161,829,990,1686,49,421,NH - North Conway
26,1976-1977,1976-10-25,1977-04-10,168,3,113,590,703,146,841,987,1690,48,366,NH - North Conway
27,1977-1978,1977-11-24,1978-04-20,148,0,104,581,685,165,1225,1390,2075,44,367,NH - North Conway
28,1978-1979,1978-11-21,1979-04-11,142,0,113,524,637,148,905,1053,1690,43,328,NH - North Conway
29,1979-1980,1979-10-10,1980-04-05,179,0,81,490,571,75,202,277,848,25,157,NH - North Conway
30,1980-1981,1980-11-17,1981-04-15,150,0,116,539,655,78,326,404,1059,35,262,NH - North Conway
31,1981-1982,1981-11-27,1982-04-16,141,1,118,564,682,152,1083,1235,1917,50,358,NH - North Conway
32,1982-1983,1982-11-15,1983-04-21,158,0,61,404,465,95,240,335,800,31,187,NH - North Conway
33,1983-1984,1983-11-16,1984-03-31,137,6,94,489,583,124,662,786,1369,38,287,NH - North Conway
34,1984-1985,1984-11-20,1985-04-06,138,1,87,485,572,109,703,812,1384,31,258,NH - North Conway
35,1985-1986,1985-11-13,1986-04-11,150,2,78,521,599,125,774,899,1498,39,269,NH - North Conway
36,1986-1987,1986-11-06,1987-04-29,175,1,62,507,569,137,947,1084,1653,29,237,NH - North Conway
37,1987-1988,1987-10-24,1988-04-17,177,1,73,536,609,101,676,777,1386,35,225,NH - North Conway
38,1988-1989,1988-11-14,1989-04-16,154,4,92,529,621,93,485,578,1199,44,264,NH - North Conway
39,1989-1990,1989-11-20,1990-04-06,138,6,104,562,666,126,628,754,1420,35,286,NH - North Conway
40,1990-1991,1990-11-12,1991-03-28,137,1,65,419,484,89,417,506,990,28,199,NH - North Conway
41,1991-1992,1991-12-01,1992-04-19,141,0,88,494,582,101,425,526,1108,31,248,NH - North Conway
42,1992-1993,1992-11-17,1993-04-10,145,2,99,546,645,139,592,731,1376,40,335,NH - North Conway
43,1993-1994,1993-11-21,1994-04-11,142,2,126,579,705,134,850,984,1689,38,351,NH - North Conway
44,1994-1995,1994-11-24,1995-04-06,134,0,67,436,503,92,324,416,919,32,216,NH - North Conway
45,1995-1996,1995-11-15,1996-04-17,155,0,111,539,650,173,817,990,1640,58,410,NH - North Conway
46,1996-1997,1996-11-15,1997-04-13,150,3,84,470,554,155,829,984,1538,42,334,NH - North Conway
47,1997-1998,1997-10-27,1998-03-28,153,1,40,393,433,126,718,844,1277,37,237,NH - North Conway
48,1998-1999,1998-11-15,1999-03-31,137,1,50,397,447,115,749,864,1311,32,233,NH - North Conway
49,1999-2000,1999-11-13,2000-04-22,162,4,81,415,496,104,456,560,1056,31,216,NH - North Conway
50,2000-2001,2000-11-24,2001-04-17,145,1,84,509,593,151,900,1051,1644,37,288,NH - North Conway
51,2001-2002,2001-11-30,2002-04-29,151,6,27,321,348,97,418,515,863,35,179,NH - North Conway
52,2002-2003,2002-10-27,2003-04-08,164,2,129,581,710,120,754,874,1584,48,303,NH - North Conway
53,2003-2004,2003-11-09,2004-03-24,137,9,118,469,587,77,523,600,1187,27,193,NH - North Conway
54,2004-2005,2004-11-21,2005-04-02,133,8,100,470,570,114,657,771,1341,40,303,NH - North Conway
55,2005-2006,2005-11-10,2006-04-05,147,3,64,393,457,71,285,356,813,30,169,NH - North Conway
56,2006-2007,2006-12-01,2007-04-19,140,1,109,433,542,116,576,692,1234,29,221,NH - North Conway
57,2007-2008,2007-11-21,2008-04-21,153,0,92,505,597,209,1487,1696,2293,66,469,NH - North Conway
58,2008-2009,2008-11-20,2009-04-08,140,0,118,538,656,159,959,1118,1774,38,368,NH - North Conway
59,2009-2010,2009-12-01,2010-04-29,150,0,63,337,400,72,542,614,1014,26,140,NH - North Conway
60,2010-2011,2010-11-22,2011-04-24,154,0,97,498,595,128,646,774,1369,43,306,NH - North Conway
61,2011-2012,2011-10-30,2012-03-28,151,0,59,389,448,105,487,592,1040,30,224,NH - North Conway
62,2012-2013,2012-11-08,2013-04-13,157,0,78,425,503,118,626,744,1247,38,269,NH - North Conway
63,2013-2014,2013-11-10,2014-04-16,158,0,152,612,764,146,984,1130,1894,49,410,NH - North Conway
64,2014-2015,2014-11-14,2015-04-14,152,0,148,619,767,135,893,1028,1795,48,394,NH - North Conway
65,2015-2016,2015-12-01,2016-04-27,149,0,48,347,395,64,305,369,764,27,150,NH - North Conway
66,2016-2017,2016-11-25,2017-04-10,137,1,76,396,472,176,934,1110,1582,39,334,NH - North Conway
67,2017-2018,2017-11-11,2018-04-18,159,0,108,480,588,150,663,813,1401,35,279,NH - North Conway
68,2018-2019,2018-10-28,2019-04-11,166,0,99,566,665,137,1136,1273,1938,37,285,NH - North Conway
69,2019-2020,2019-11-09,2020-05-09,183,0,53,412,465,110,511,621,1086,37,211,NH - North Conway
0,1950-1951,1950-12-01,1951-03-22,112,0,13,135,148,8,4,12,160,7,27,NJ - Atlantic City
1,1951-1952,1951-12-01,1952-03-03,94,0,9,112,121,24,13,37,158,6,33,NJ - Atlantic City
2,1952-1953,1952-11-30,1953-03-09,100,0,5,84,89,19,10,29,118,5,27,NJ - Atlantic City
3,1953-1954,1953-11-06,1954-03-11,126,0,10,120,130,22,24,46,176,7,35,NJ - Atlantic City
4,1954-1955,1954-12-01,1955-03-18,108,0,18,146,164,13,14,27,191,7,23,NJ - Atlantic City
5,1955-1956,1955-11-19,1956-04-24,158,0,15,195,210,33,40,73,283,15,57,NJ - Atlantic City
6,1956-1957,1956-12-01,1957-02-28,90,2,14,112,126,8,14,22,148,5,29,NJ - Atlantic City
7,1957-1958,1957-12-01,1958-03-23,113,1,26,180,206,46,95,141,347,12,71,NJ - Atlantic City
8,1958-1959,1958-12-01,1959-04-13,134,0,27,227,254,14,27,41,295,7,36,NJ - Atlantic City
9,1959-1960,1959-11-18,1960-03-22,126,0,15,164,179,35,43,78,257,16,73,NJ - Atlantic City
10,1960-1961,1960-12-01,1961-03-10,100,0,32,211,243,51,120,171,414,18,114,NJ - Atlantic City
11,1961-1962,1961-12-01,1962-03-09,99,0,14,168,182,25,21,46,228,12,47,NJ - Atlantic City
12,1962-1963,1962-12-01,1963-02-28,90,0,28,202,230,16,4,20,250,11,39,NJ - Atlantic City
13,1963-1964,1963-12-01,1964-03-30,121,0,15,173,188,56,59,115,303,17,88,NJ - Atlantic City
14,1964-1965,1964-12-01,1965-04-02,123,0,24,251,275,30,40,70,345,14,87,NJ - Atlantic City
15,1965-1966,1965-12-01,1966-02-28,90,0,25,203,228,32,74,106,334,12,79,NJ - Atlantic City
16,1966-1967,1966-12-01,1967-03-23,113,0,18,201,219,69,80,149,368,21,123,NJ - Atlantic City
17,1967-1968,1967-11-16,1968-03-13,119,0,44,270,314,29,22,51,365,14,68,NJ - Atlantic City
18,1968-1969,1968-12-01,1969-03-13,103,0,19,235,254,41,47,88,342,8,53,NJ - Atlantic City
19,1969-1970,1969-12-01,1970-02-28,90,0,24,172,196,22,43,65,261,12,54,NJ - Atlantic City
20,1970-1971,1970-12-01,1971-03-23,113,0,18,173,191,18,11,29,220,11,41,NJ - Atlantic City
21,1971-1972,1971-12-01,1972-03-10,101,0,13,161,174,15,10,25,199,8,36,NJ - Atlantic City
22,1972-1973,1972-12-01,1973-02-28,90,0,10,111,121,1,0,1,122,1,5,NJ - Atlantic City
23,1973-1974,1973-11-05,1974-02-28,116,0,8,129,137,16,21,37,174,4,21,NJ - Atlantic City
24,1974-1975,1974-11-25,1975-03-10,106,0,4,132,136,13,3,16,152,8,25,NJ - Atlantic City
25,1975-1976,1975-12-01,1976-03-11,102,0,19,181,200,17,12,29,229,11,45,NJ - Atlantic City
26,1976-1977,1976-11-30,1977-02-28,91,0,53,273,326,18,24,42,368,10,54,NJ - Atlantic City
27,1977-1978,1977-12-01,1978-03-17,107,0,38,248,286,35,85,120,406,12,63,NJ - Atlantic City
28,1978-1979,1978-11-27,1979-02-28,94,0,42,231,273,63,90,153,426,16,135,NJ - Atlantic City
29,1979-1980,1979-12-01,1980-03-03,94,0,22,198,220,22,21,43,263,9,58,NJ - Atlantic City
30,1980-1981,1980-12-01,1981-02-28,90,0,47,268,315,5,3,8,323,3,16,NJ - Atlantic City
31,1981-1982,1981-12-01,1982-04-10,131,0,24,214,238,23,26,49,287,12,48,NJ - Atlantic City
32,1982-1983,1982-12-01,1983-04-20,141,0,12,146,158,29,40,69,227,5,41,NJ - Atlantic City
33,1983-1984,1983-11-25,1984-03-13,110,0,28,215,243,14,12,26,269,10,48,NJ - Atlantic City
34,1984-1985,1984-12-01,1985-04-09,130,0,22,185,207,22,34,56,263,8,48,NJ - Atlantic City
35,1985-1986,1985-12-01,1986-03-08,98,0,21,203,224,27,36,63,287,12,69,NJ - Atlantic City
36,1986-1987,1986-12-01,1987-04-05,126,0,9,200,209,45,88,133,342,10,67,NJ - Atlantic City
37,1987-1988,1987-11-21,1988-02-29,101,0,19,198,217,12,23,35,252,4,28,NJ - Atlantic City
38,1988-1989,1988-12-01,1989-03-11,101,0,18,175,193,28,32,60,253,8,53,NJ - Atlantic City
39,1989-1990,1989-11-22,1990-04-07,137,0,24,227,251,31,45,76,327,12,69,NJ - Atlantic City
40,1990-1991,1990-12-01,1991-02-28,90,0,6,139,145,14,5,19,164,6,27,NJ - Atlantic City
41,1991-1992,1991-12-01,1992-02-29,91,0,8,157,165,5,2,7,172,4,18,NJ - Atlantic City
42,1992-1993,1992-12-01,1993-03-18,108,0,7,184,191,14,10,24,215,8,29,NJ - Atlantic City
43,1993-1994,1993-12-01,1994-03-02,92,0,30,213,243,14,15,29,272,9,50,NJ - Atlantic City
44,1994-1995,1994-12-01,1995-02-28,90,0,9,145,154,2,0,2,156,2,7,NJ - Atlantic City
54,2004-2005,2004-12-01,2005-03-09,99,1,20,175,195,25,36,61,256,16,71,NJ - Atlantic City
55,2005-2006,2005-12-01,2006-02-28,90,1,5,118,123,19,20,39,162,6,30,NJ - Atlantic City
56,2006-2007,2006-12-01,2007-03-09,99,0,14,148,162,11,7,18,180,8,33,NJ - Atlantic City
57,2007-2008,2007-12-01,2008-02-29,91,0,3,121,124,14,11,25,149,5,23,NJ - Atlantic City
58,2008-2009,2008-12-01,2009-03-20,110,0,17,162,179,21,26,47,226,10,41,NJ - Atlantic City
59,2009-2010,2009-12-01,2010-02-28,90,0,12,132,144,77,164,241,385,17,111,NJ - Atlantic City
60,2010-2011,2010-12-01,2011-02-28,90,0,13,169,182,56,90,146,328,15,96,NJ - Atlantic City
61,2011-2012,2011-12-01,2012-02-29,91,0,3,90,93,7,2,9,102,5,13,NJ - Atlantic City
62,2012-2013,2012-11-07,2013-03-25,139,0,10,147,157,25,7,32,189,17,61,NJ - Atlantic City
63,2013-2014,2013-12-01,2014-03-26,116,0,32,238,270,60,60,120,390,23,136,NJ - Atlantic City
64,2014-2015,2014-12-01,2015-03-20,110,0,25,228,253,33,31,64,317,13,87,NJ - Atlantic City
65,2015-2016,2015-12-01,2016-04-09,131,0,11,125,136,40,20,60,196,13,61,NJ - Atlantic City
66,2016-2017,2016-12-01,2017-03-15,105,0,7,114,121,14,9,23,144,5,23,NJ - Atlantic City
67,2017-2018,2017-12-01,2018-03-22,112,0,24,170,194,47,49,96,290,12,75,NJ - Atlantic City
68,2018-2019,2018-12-01,2019-03-06,96,0,11,131,142,23,17,40,182,7,42,NJ - Atlantic City
69,2019-2020,2019-12-01,2020-02-29,91,0,1,82,83,1,1,2,85,1,2,NJ - Atlantic City
4,1954-1955,1954-12-01,1955-02-28,90,20,9,82,91,8,2,10,101,3,11,NJ - Cape May
5,1955-1956,1955-12-01,1956-02-29,91,13,8,85,93,0,0,0,93,0,0,NJ - Cape May
16,1966-1967,1966-12-01,1967-03-19,109,19,7,99,106,25,21,46,152,5,33,NJ - Cape May
18,1968-1969,1968-12-01,1969-03-12,102,18,19,132,151,30,5,35,186,6,40,NJ - Cape May
19,1969-1970,1969-12-01,1970-02-28,90,8,22,144,166,8,7,15,181,3,18,NJ - Cape May
20,1970-1971,1970-12-01,1971-02-28,90,2,22,122,144,2,0,2,146,1,3,NJ - Cape May
21,1971-1972,1971-12-01,1972-04-08,130,0,8,122,130,9,5,14,144,4,16,NJ - Cape May
22,1972-1973,1972-12-01,1973-02-28,90,9,14,88,102,0,1,1,103,0,0,NJ - Cape May
24,1974-1975,1974-12-01,1975-03-02,92,2,1,71,72,7,5,12,84,3,12,NJ - Cape May
25,1975-1976,1975-12-01,1976-03-17,108,0,12,117,129,12,7,19,148,10,28,NJ - Cape May
26,1976-1977,1976-11-12,1977-02-28,109,0,39,186,225,22,17,39,264,12,52,NJ - Cape May
27,1977-1978,1977-12-01,1978-03-16,106,0,39,169,208,46,169,215,423,10,68,NJ - Cape May
28,1978-1979,1978-11-27,1979-02-28,94,0,33,146,179,53,94,147,326,15,107,NJ - Cape May
29,1979-1980,1979-12-01,1980-03-04,95,0,20,104,124,23,28,51,175,11,55,NJ - Cape May
30,1980-1981,1980-12-01,1981-03-20,110,0,28,158,186,8,1,9,195,7,16,NJ - Cape May
31,1981-1982,1981-12-01,1982-04-09,130,1,23,153,176,27,46,73,249,12,60,NJ - Cape May
32,1982-1983,1982-12-01,1983-02-28,90,0,7,78,85,25,39,64,149,4,33,NJ - Cape May
35,1985-1986,1985-12-01,1986-03-08,98,1,16,122,138,28,38,66,204,13,63,NJ - Cape May
36,1986-1987,1986-12-01,1987-03-13,103,3,9,112,121,45,110,155,276,10,65,NJ - Cape May
37,1987-1988,1987-11-11,1988-02-29,111,1,15,120,135,11,4,15,150,8,29,NJ - Cape May
38,1988-1989,1988-12-01,1989-03-10,100,0,13,100,113,30,44,74,187,9,47,NJ - Cape May
39,1989-1990,1989-11-22,1990-04-07,137,1,21,141,162,28,52,80,242,14,58,NJ - Cape May
40,1990-1991,1990-12-01,1991-02-28,90,2,5,68,73,9,3,12,85,4,12,NJ - Cape May
41,1991-1992,1991-12-01,1992-03-19,110,0,6,94,100,5,0,5,105,4,12,NJ - Cape May
42,1992-1993,1992-12-01,1993-03-18,108,0,8,109,117,17,13,30,147,7,33,NJ - Cape May
43,1993-1994,1993-12-01,1994-03-02,92,1,25,143,168,13,15,28,196,8,44,NJ - Cape May
44,1994-1995,1994-12-01,1995-02-28,90,0,8,85,93,1,0,1,94,1,3,NJ - Cape May
45,1995-1996,1995-12-01,1996-04-09,131,1,24,156,180,66,121,187,367,16,107,NJ - Cape May
46,1996-1997,1996-11-28,1997-02-28,93,0,11,77,88,6,7,13,101,3,9,NJ - Cape May
47,1997-1998,1997-12-01,1998-02-28,90,1,0,48,48,3,3,6,54,1,4,NJ - Cape May
48,1998-1999,1998-12-01,1999-03-15,105,2,8,91,99,9,7,16,115,7,22,NJ - Cape May
49,1999-2000,1999-12-01,2000-02-29,91,1,10,98,108,15,66,81,189,6,25,NJ - Cape May
50,2000-2001,2000-12-01,2001-03-26,116,0,6,122,128,28,47,75,203,9,45,NJ - Cape May
51,2001-2002,2001-12-01,2002-04-06,127,0,0,57,57,10,0,10,67,5,14,NJ - Cape May
52,2002-2003,2002-12-01,2003-02-28,90,1,14,112,126,56,93,149,275,16,83,NJ - Cape May
53,2003-2004,2003-12-01,2004-02-29,91,0,19,118,137,22,22,44,181,12,50,NJ - Cape May
54,2004-2005,2004-12-01,2005-03-08,98,0,13,108,121,21,17,38,159,14,62,NJ - Cape May
55,2005-2006,2005-12-01,2006-03-01,91,0,3,72,75,13,10,23,98,6,21,NJ - Cape May
56,2006-2007,2006-12-01,2007-04-08,129,2,13,110,123,14,9,23,146,8,32,NJ - Cape May
57,2007-2008,2007-12-01,2008-02-29,91,0,4,82,86,13,10,23,109,6,21,NJ - Cape May
58,2008-2009,2008-12-01,2009-03-05,95,0,14,115,129,17,25,42,171,6,29,NJ - Cape May
59,2009-2010,2009-12-01,2010-02-28,90,3,9,96,105,74,153,227,332,15,102,NJ - Cape May
60,2010-2011,2010-12-01,2011-02-28,90,0,12,126,138,45,69,114,252,14,77,NJ - Cape May
61,2011-2012,2011-12-01,2012-02-29,91,0,1,57,58,5,1,6,64,5,11,NJ - Cape May
62,2012-2013,2012-12-01,2013-03-25,115,0,6,73,79,17,13,30,109,9,33,NJ - Cape May
63,2013-2014,2013-12-01,2014-03-26,116,0,22,162,184,61,60,121,305,22,118,NJ - Cape May
64,2014-2015,2014-12-01,2015-03-20,110,0,21,167,188,35,52,87,275,13,81,NJ - Cape May
65,2015-2016,2015-12-01,2016-03-21,112,0,9,80,89,33,16,49,138,13,53,NJ - Cape May
66,2016-2017,2016-12-01,2017-03-15,105,1,5,77,82,15,13,28,110,4,21,NJ - Cape May
67,2017-2018,2017-12-01,2018-03-21,111,0,19,120,139,28,49,77,216,10,51,NJ - Cape May
68,2018-2019,2018-12-01,2019-03-06,96,0,8,91,99,15,11,26,125,6,29,NJ - Cape May
69,2019-2020,2019-12-01,2020-02-29,91,0,1,61,62,1,0,1,63,1,2,NJ - Cape May
0,1950-1951,1950-11-28,1951-03-03,96,2,17,141,158,14,10,24,182,7,37,NJ - New Brunswick
1,1951-1952,1951-12-01,1952-03-04,95,9,9,139,148,18,33,51,199,4,27,NJ - New Brunswick
2,1952-1953,1952-11-30,1953-03-08,99,0,3,122,125,18,12,30,155,9,33,NJ - New Brunswick
3,1953-1954,1953-11-06,1954-04-01,147,6,9,195,204,21,47,68,272,6,31,NJ - New Brunswick
4,1954-1955,1954-12-01,1955-03-18,108,0,13,183,196,17,10,27,223,8,41,NJ - New Brunswick
5,1955-1956,1955-11-19,1956-04-08,142,0,12,211,223,38,54,92,315,12,65,NJ - New Brunswick
6,1956-1957,1956-12-01,1957-04-04,125,0,13,164,177,31,25,56,233,13,56,NJ - New Brunswick
7,1957-1958,1957-11-23,1958-03-23,121,1,26,176,202,62,98,160,362,13,88,NJ - New Brunswick
8,1958-1959,1958-12-01,1959-03-28,118,4,23,227,250,15,10,25,275,8,31,NJ - New Brunswick
9,1959-1960,1959-11-29,1960-03-22,115,1,12,178,190,39,70,109,299,13,68,NJ - New Brunswick
10,1960-1961,1960-12-01,1961-02-28,90,0,44,240,284,82,264,346,630,14,148,NJ - New Brunswick
11,1961-1962,1961-12-01,1962-03-10,100,5,16,204,220,41,109,150,370,15,71,NJ - New Brunswick
12,1962-1963,1962-10-26,1963-03-01,127,0,32,243,275,32,38,70,345,12,62,NJ - New Brunswick
13,1963-1964,1963-12-01,1964-03-22,113,0,21,191,212,52,141,193,405,14,82,NJ - New Brunswick
15,1965-1966,1965-12-01,1966-02-28,90,1,19,146,165,34,110,144,309,8,52,NJ - New Brunswick
16,1966-1967,1966-12-01,1967-03-24,114,6,15,189,204,81,116,197,401,19,118,NJ - New Brunswick
17,1967-1968,1967-11-30,1968-03-13,105,0,26,201,227,26,69,95,322,9,46,NJ - New Brunswick
18,1968-1969,1968-12-01,1969-03-27,117,2,32,201,233,51,146,197,430,16,77,NJ - New Brunswick
19,1969-1970,1969-12-01,1970-04-01,122,2,46,251,297,46,171,217,514,24,105,NJ - New Brunswick
20,1970-1971,1970-12-01,1971-04-07,128,1,39,213,252,33,55,88,340,16,62,NJ - New Brunswick
21,1971-1972,1971-12-01,1972-04-08,130,1,20,199,219,32,51,83,302,14,63,NJ - New Brunswick
22,1972-1973,1972-10-19,1973-02-28,133,0,20,152,172,7,1,8,180,6,14,NJ - New Brunswick
23,1973-1974,1973-12-01,1974-04-10,131,15,21,171,192,36,75,111,303,13,76,NJ - New Brunswick
24,1974-1975,1974-11-26,1975-03-15,110,0,9,122,131,33,42,75,206,12,55,NJ - New Brunswick
25,1975-1976,1975-12-01,1976-03-18,109,0,35,198,233,38,64,102,335,14,75,NJ - New Brunswick
26,1976-1977,1976-12-01,1977-03-21,111,0,65,268,333,45,230,275,608,21,111,NJ - New Brunswick
27,1977-1978,1977-11-28,1978-03-17,110,0,56,270,326,80,275,355,681,21,141,NJ - New Brunswick
28,1978-1979,1978-11-27,1979-03-16,110,0,56,238,294,45,99,144,438,16,105,NJ - New Brunswick
29,1979-1980,1979-12-01,1980-04-01,123,3,25,211,236,31,35,66,302,12,68,NJ - New Brunswick
30,1980-1981,1980-11-18,1981-03-08,111,0,47,290,337,29,75,104,441,11,73,NJ - New Brunswick
31,1981-1982,1981-12-01,1982-04-10,131,2,42,253,295,46,128,174,469,16,99,NJ - New Brunswick
32,1982-1983,1982-12-01,1983-04-20,141,0,16,165,181,45,105,150,331,7,64,NJ - New Brunswick
33,1983-1984,1983-11-26,1984-03-31,127,0,43,249,292,59,124,183,475,20,109,NJ - New Brunswick
34,1984-1985,1984-12-01,1985-02-28,90,0,31,168,199,38,76,114,313,16,93,NJ - New Brunswick
35,1985-1986,1985-11-17,1986-04-23,158,0,30,230,260,36,65,101,361,18,85,NJ - New Brunswick
36,1986-1987,1986-12-01,1987-03-13,103,0,19,186,205,63,154,217,422,16,101,NJ - New Brunswick
37,1987-1988,1987-11-07,1988-03-21,136,1,34,238,272,36,101,137,409,14,74,NJ - New Brunswick
38,1988-1989,1988-12-01,1989-03-21,111,4,24,197,221,19,22,41,262,9,41,NJ - New Brunswick
39,1989-1990,1989-11-23,1990-04-08,137,0,32,227,259,32,23,55,314,19,80,NJ - New Brunswick
40,1990-1991,1990-12-01,1991-03-31,121,0,10,155,165,34,28,62,227,14,64,NJ - New Brunswick
41,1991-1992,1991-12-01,1992-03-24,115,1,17,191,208,15,15,30,238,10,47,NJ - New Brunswick
42,1992-1993,1992-12-01,1993-03-24,114,0,13,212,225,46,83,129,354,19,85,NJ - New Brunswick
43,1993-1994,1993-12-01,1994-03-19,109,3,61,264,325,74,224,298,623,24,167,NJ - New Brunswick
44,1994-1995,1994-12-01,1995-02-28,90,0,15,160,175,24,68,92,267,9,52,NJ - New Brunswick
45,1995-1996,1995-11-29,1996-04-10,134,1,50,268,318,110,271,381,699,31,212,NJ - New Brunswick
46,1996-1997,1996-11-29,1997-04-01,124,2,16,168,184,24,25,49,233,8,36,NJ - New Brunswick
47,1997-1998,1997-12-01,1998-03-23,113,0,3,117,120,6,3,9,129,5,11,NJ - New Brunswick
48,1998-1999,1998-12-01,1999-03-17,107,0,12,180,192,21,29,50,242,7,39,NJ - New Brunswick
49,1999-2000,1999-12-01,2000-04-10,132,4,25,173,198,24,92,116,314,8,40,NJ - New Brunswick
50,2000-2001,2000-12-01,2001-03-07,97,1,15,208,223,60,187,247,470,15,100,NJ - New Brunswick
51,2001-2002,2001-12-01,2002-03-18,108,0,3,119,122,8,10,18,140,4,16,NJ - New Brunswick
52,2002-2003,2002-11-27,2003-04-09,134,1,39,258,297,70,172,242,539,18,120,NJ - New Brunswick
53,2003-2004,2003-12-01,2004-03-20,111,0,37,217,254,53,120,173,427,15,96,NJ - New Brunswick
54,2004-2005,2004-12-01,2005-03-24,114,4,26,206,232,56,128,184,416,16,111,NJ - New Brunswick
55,2005-2006,2005-12-01,2006-04-06,127,3,9,160,169,42,72,114,283,8,59,NJ - New Brunswick
56,2006-2007,2006-12-01,2007-03-20,110,4,28,177,205,18,23,41,246,10,43,NJ - New Brunswick
57,2007-2008,2007-12-01,2008-03-01,92,1,7,137,144,16,16,32,176,10,36,NJ - New Brunswick
58,2008-2009,2008-10-29,2009-03-20,143,0,25,233,258,37,53,90,348,18,91,NJ - New Brunswick
59,2009-2010,2009-12-01,2010-03-05,95,0,14,159,173,72,180,252,425,16,103,NJ - New Brunswick
60,2010-2011,2010-12-01,2011-03-24,114,2,19,222,241,78,313,391,632,16,121,NJ - New Brunswick
61,2011-2012,2011-10-30,2012-02-29,123,2,5,126,131,10,14,24,155,5,19,NJ - New Brunswick
62,2012-2013,2012-11-08,2013-03-09,122,0,14,148,162,36,36,72,234,13,62,NJ - New Brunswick
63,2013-2014,2013-11-25,2014-04-16,143,0,47,301,348,76,226,302,650,22,154,NJ - New Brunswick
64,2014-2015,2014-11-27,2015-03-21,115,2,41,261,302,59,233,292,594,22,135,NJ - New Brunswick
65,2015-2016,2015-12-01,2016-03-21,112,7,13,132,145,53,84,137,282,12,76,NJ - New Brunswick
66,2016-2017,2016-12-01,2017-03-20,110,0,13,139,152,31,56,87,239,11,62,NJ - New Brunswick
67,2017-2018,2017-12-01,2018-04-03,124,0,30,201,231,62,85,147,378,17,104,NJ - New Brunswick
68,2018-2019,2018-11-16,2019-03-08,113,0,12,165,177,23,21,44,221,8,37,NJ - New Brunswick
69,2019-2020,2019-12-01,2020-02-29,91,0,3,101,104,6,4,10,114,4,11,NJ - New Brunswick
0,1950-1951,1950-12-01,1951-03-22,112,0,18,128,146,22,20,42,188,17,58,NJ - Newark
1,1951-1952,1951-12-01,1952-03-13,104,0,12,121,133,27,23,50,183,13,44,NJ - Newark
2,1952-1953,1952-10-20,1953-03-08,140,0,3,102,105,21,15,36,141,12,37,NJ - Newark
3,1953-1954,1953-11-06,1954-04-01,147,0,17,147,164,21,44,65,229,10,48,NJ - Newark
4,1954-1955,1954-12-01,1955-03-26,116,0,17,146,163,20,17,37,200,13,49,NJ - Newark
5,1955-1956,1955-11-19,1956-04-08,142,0,19,187,206,59,52,111,317,19,98,NJ - Newark
6,1956-1957,1956-11-23,1957-04-05,134,0,18,149,167,37,27,64,231,17,77,NJ - Newark
7,1957-1958,1957-12-01,1958-03-23,113,0,31,146,177,87,115,202,379,19,129,NJ - Newark
8,1958-1959,1958-11-30,1959-04-12,134,0,31,209,240,32,28,60,300,20,72,NJ - Newark
9,1959-1960,1959-11-29,1960-03-26,119,0,8,140,148,54,78,132,280,20,94,NJ - Newark
10,1960-1961,1960-12-01,1961-03-31,121,0,41,211,252,102,265,367,619,20,161,NJ - Newark
11,1961-1962,1961-11-20,1962-03-10,111,0,28,172,200,50,55,105,305,24,95,NJ - Newark
12,1962-1963,1962-11-18,1963-03-20,123,0,42,211,253,36,61,97,350,21,81,NJ - Newark
13,1963-1964,1963-12-01,1964-03-22,113,0,25,156,181,66,112,178,359,25,121,NJ - Newark
14,1964-1965,1964-12-01,1965-04-02,123,0,32,167,199,37,78,115,314,15,70,NJ - Newark
15,1965-1966,1965-12-01,1966-02-28,90,0,20,123,143,25,68,93,236,12,56,NJ - Newark
16,1966-1967,1966-12-01,1967-03-25,115,0,22,154,176,80,122,202,378,24,135,NJ - Newark
17,1967-1968,1967-11-30,1968-03-13,105,0,32,175,207,25,50,75,282,16,74,NJ - Newark
18,1968-1969,1968-11-12,1969-03-11,120,0,24,159,183,44,93,137,320,17,69,NJ - Newark
19,1969-1970,1969-12-01,1970-04-01,122,0,35,196,231,43,138,181,412,25,117,NJ - Newark
20,1970-1971,1970-12-01,1971-04-06,127,0,31,144,175,39,45,84,259,21,71,NJ - Newark
21,1971-1972,1971-12-01,1972-03-14,105,0,18,136,154,28,34,62,216,16,56,NJ - Newark
22,1972-1973,1972-12-01,1973-03-18,108,0,14,102,116,7,0,7,123,7,15,NJ - Newark
23,1973-1974,1973-12-01,1974-04-10,131,0,21,127,148,31,60,91,239,14,66,NJ - Newark
24,1974-1975,1974-12-01,1975-03-15,105,0,8,93,101,28,24,52,153,12,55,NJ - Newark
25,1975-1976,1975-12-01,1976-03-12,103,0,29,163,192,30,49,79,271,15,73,NJ - Newark
26,1976-1977,1976-11-30,1977-03-20,111,0,64,242,306,38,94,132,438,19,90,NJ - Newark
27,1977-1978,1977-11-27,1978-03-17,111,0,51,228,279,86,204,290,569,19,126,NJ - Newark
28,1978-1979,1978-11-27,1979-02-28,94,0,46,168,214,53,84,137,351,14,97,NJ - Newark
29,1979-1980,1979-12-01,1980-04-01,123,0,19,145,164,20,24,44,208,8,34,NJ - Newark
30,1980-1981,1980-11-17,1981-03-11,115,0,52,233,285,30,52,82,367,13,70,NJ - Newark
31,1981-1982,1981-12-01,1982-04-10,131,0,40,192,232,49,105,154,386,19,107,NJ - Newark
32,1982-1983,1982-12-01,1983-04-19,140,0,13,111,124,43,73,116,240,11,61,NJ - Newark
33,1983-1984,1983-11-25,1984-03-31,128,0,39,178,217,43,79,122,339,22,88,NJ - Newark
34,1984-1985,1984-12-01,1985-03-04,94,0,35,159,194,34,70,104,298,16,85,NJ - Newark
35,1985-1986,1985-11-16,1986-04-23,159,0,25,165,190,37,55,92,282,18,76,NJ - Newark
36,1986-1987,1986-12-01,1987-03-13,103,0,14,133,147,47,94,141,288,15,69,NJ - Newark
37,1987-1988,1987-11-10,1988-03-20,132,0,22,159,181,35,89,124,305,15,62,NJ - Newark
38,1988-1989,1988-12-01,1989-03-09,99,0,19,124,143,13,14,27,170,6,28,NJ - Newark
39,1989-1990,1989-11-22,1990-04-07,137,0,22,163,185,23,20,43,228,12,44,NJ - Newark
40,1990-1991,1990-12-01,1991-03-30,120,0,8,100,108,34,31,65,173,12,58,NJ - Newark
41,1991-1992,1991-12-01,1992-03-24,115,0,10,128,138,23,24,47,185,9,44,NJ - Newark
42,1992-1993,1992-12-01,1993-03-22,112,0,10,131,141,41,63,104,245,15,62,NJ - Newark
43,1993-1994,1993-12-01,1994-03-19,109,0,41,202,243,92,188,280,523,25,173,NJ - Newark
44,1994-1995,1994-12-01,1995-02-28,90,0,14,106,120,17,31,48,168,5,32,NJ - Newark
45,1995-1996,1995-11-29,1996-04-10,134,0,42,203,245,113,215,328,573,26,177,NJ - Newark
46,1996-1997,1996-11-28,1997-04-01,125,0,12,124,136,26,9,35,171,14,42,NJ - Newark
47,1997-1998,1997-11-14,1998-03-22,129,0,1,81,82,15,2,17,99,10,22,NJ - Newark
48,1998-1999,1998-12-01,1999-03-15,105,0,16,112,128,20,10,30,158,12,42,NJ - Newark
49,1999-2000,1999-12-01,2000-04-09,131,0,25,121,146,27,51,78,224,9,47,NJ - Newark
50,2000-2001,2000-12-01,2001-03-26,116,0,14,141,155,59,100,159,314,18,94,NJ - Newark
51,2001-2002,2001-12-01,2002-02-28,90,0,2,58,60,6,6,12,72,4,11,NJ - Newark
52,2002-2003,2002-11-27,2003-04-08,133,0,37,200,237,76,121,197,434,21,123,NJ - Newark
53,2003-2004,2003-12-01,2004-03-19,110,0,38,172,210,69,111,180,390,16,113,NJ - Newark
54,2004-2005,2004-12-01,2005-03-24,114,0,30,168,198,63,117,180,378,24,138,NJ - Newark
55,2005-2006,2005-12-01,2006-04-05,126,0,11,118,129,56,64,120,249,14,77,NJ - Newark
56,2006-2007,2006-12-01,2007-03-20,110,0,23,149,172,28,29,57,229,15,61,NJ - Newark
57,2007-2008,2007-11-19,2008-02-29,103,0,7,103,110,22,19,41,151,9,38,NJ - Newark
58,2008-2009,2008-12-01,2009-03-20,110,0,26,155,181,35,52,87,268,14,65,NJ - Newark
59,2009-2010,2009-12-01,2010-03-01,91,0,15,122,137,68,103,171,308,14,89,NJ - Newark
60,2010-2011,2010-12-01,2011-03-24,114,0,17,145,162,92,244,336,498,20,131,NJ - Newark
61,2011-2012,2011-10-29,2012-02-29,124,0,4,68,72,13,10,23,95,4,18,NJ - Newark
62,2012-2013,2012-11-07,2013-03-19,133,0,10,106,116,45,27,72,188,17,74,NJ - Newark
63,2013-2014,2013-11-24,2014-04-16,144,0,43,221,264,85,193,278,542,21,139,NJ - Newark
64,2014-2015,2014-11-26,2015-03-21,116,0,35,220,255,69,209,278,533,25,147,NJ - Newark
65,2015-2016,2015-12-01,2016-03-20,111,0,13,93,106,54,70,124,230,15,81,NJ - Newark
66,2016-2017,2016-12-01,2017-03-20,110,0,14,99,113,42,57,99,212,12,67,NJ - Newark
67,2017-2018,2017-12-01,2018-04-03,124,0,30,153,183,56,55,111,294,15,83,NJ - Newark
68,2018-2019,2018-11-15,2019-03-10,116,0,14,134,148,33,15,48,196,13,51,NJ - Newark
69,2019-2020,2019-12-01,2020-02-29,91,0,2,73,75,11,3,14,89,7,20,NJ - Newark
0,1950-1951,1950-12-01,1951-02-28,90,0,8,124,132,10,6,16,148,4,24,NM - Albuquerque
1,1951-1952,1951-12-01,1952-03-17,108,0,1,144,145,7,6,13,158,2,11,NM - Albuquerque
2,1952-1953,1952-11-23,1953-02-28,98,0,5,150,155,13,5,18,173,9,31,NM - Albuquerque
3,1953-1954,1953-11-18,1954-02-28,103,0,2,124,126,19,12,31,157,9,35,NM - Albuquerque
4,1954-1955,1954-12-01,1955-02-28,90,0,5,169,174,8,0,8,182,3,11,NM - Albuquerque
5,1955-1956,1955-12-01,1956-02-29,91,0,5,117,122,12,7,19,141,6,33,NM - Albuquerque
6,1956-1957,1956-11-20,1957-02-28,101,0,1,112,113,3,0,3,116,2,5,NM - Albuquerque
7,1957-1958,1957-11-22,1958-03-08,107,0,2,132,134,17,4,21,155,7,28,NM - Albuquerque
8,1958-1959,1958-11-16,1959-03-05,110,0,10,157,167,34,51,85,252,10,58,NM - Albuquerque
9,1959-1960,1959-12-01,1960-03-17,108,0,6,152,158,32,16,48,206,13,52,NM - Albuquerque
10,1960-1961,1960-12-01,1961-03-30,120,0,2,158,160,12,6,18,178,8,26,NM - Albuquerque
11,1961-1962,1961-11-14,1962-03-21,128,0,12,218,230,18,4,22,252,11,38,NM - Albuquerque
12,1962-1963,1962-12-01,1963-03-05,95,0,14,188,202,11,8,19,221,6,27,NM - Albuquerque
13,1963-1964,1963-12-01,1964-03-08,99,0,12,249,261,17,15,32,293,11,44,NM - Albuquerque
14,1964-1965,1964-12-01,1965-03-03,93,0,4,138,142,8,3,11,153,5,17,NM - Albuquerque
15,1965-1966,1965-12-01,1966-03-04,94,0,5,208,213,17,11,28,241,9,37,NM - Albuquerque
16,1966-1967,1966-12-01,1967-03-05,95,0,4,199,203,4,1,5,208,2,6,NM - Albuquerque
17,1967-1968,1967-10-29,1968-03-21,145,0,8,163,171,16,6,22,193,11,35,NM - Albuquerque
18,1968-1969,1968-12-01,1969-03-11,101,0,4,200,204,21,15,36,240,12,49,NM - Albuquerque
19,1969-1970,1969-12-01,1970-03-27,117,0,4,165,169,10,1,11,180,5,18,NM - Albuquerque
20,1970-1971,1970-10-15,1971-03-02,139,0,21,226,247,11,12,23,270,7,26,NM - Albuquerque
21,1971-1972,1971-12-01,1972-02-29,91,0,9,178,187,13,24,37,224,5,25,NM - Albuquerque
22,1972-1973,1972-11-12,1973-04-20,160,0,4,214,218,59,21,80,298,22,83,NM - Albuquerque
23,1973-1974,1973-10-30,1974-03-10,132,0,12,242,254,23,17,40,294,11,50,NM - Albuquerque
24,1974-1975,1974-12-01,1975-04-12,133,0,15,234,249,29,22,51,300,19,70,NM - Albuquerque
25,1975-1976,1975-11-29,1976-04-16,140,0,2,219,221,10,0,10,231,8,19,NM - Albuquerque
26,1976-1977,1976-11-27,1977-04-03,128,0,12,276,288,25,50,75,363,11,59,NM - Albuquerque
27,1977-1978,1977-12-01,1978-05-02,153,0,2,127,129,20,7,27,156,10,37,NM - Albuquerque
28,1978-1979,1978-12-01,1979-05-03,154,0,7,183,190,18,13,31,221,10,30,NM - Albuquerque
29,1979-1980,1979-10-30,1980-03-31,154,0,0,173,173,15,10,25,198,12,29,NM - Albuquerque
30,1980-1981,1980-11-15,1981-03-06,112,0,1,181,182,21,6,27,209,8,32,NM - Albuquerque
31,1981-1982,1981-12-01,1982-03-05,95,0,0,145,145,11,4,15,160,8,25,NM - Albuquerque
32,1982-1983,1982-11-26,1983-03-19,114,0,4,162,166,26,13,39,205,13,46,NM - Albuquerque
33,1983-1984,1983-11-19,1984-04-26,160,0,1,203,204,13,4,17,221,7,23,NM - Albuquerque
34,1984-1985,1984-12-01,1985-03-30,120,0,8,143,151,19,5,24,175,15,48,NM - Albuquerque
35,1985-1986,1985-11-14,1986-03-18,125,0,5,134,139,21,20,41,180,10,47,NM - Albuquerque
36,1986-1987,1986-10-12,1987-04-04,175,0,9,200,209,25,21,46,255,13,50,NM - Albuquerque
37,1987-1988,1987-11-15,1988-04-02,140,0,6,179,185,27,8,35,220,13,47,NM - Albuquerque
38,1988-1989,1988-11-19,1989-03-21,123,0,6,192,198,18,10,28,226,10,42,NM - Albuquerque
39,1989-1990,1989-12-01,1990-04-18,139,0,2,179,181,16,4,20,201,11,33,NM - Albuquerque
40,1990-1991,1990-11-07,1991-03-30,144,0,11,189,200,14,14,28,228,8,35,NM - Albuquerque
41,1991-1992,1991-10-30,1992-03-08,131,0,4,148,152,24,7,31,183,16,47,NM - Albuquerque
42,1992-1993,1992-11-04,1993-03-01,118,0,5,145,150,25,26,51,201,13,47,NM - Albuquerque
43,1993-1994,1993-11-14,1994-03-28,135,0,0,166,166,10,3,13,179,7,18,NM - Albuquerque
44,1994-1995,1994-12-01,1995-04-22,143,0,0,70,70,13,2,15,85,7,19,NM - Albuquerque
45,1995-1996,1995-12-01,1996-03-06,97,3,0,93,93,8,2,10,103,7,17,NM - Albuquerque
46,1996-1997,1996-10-21,1997-04-12,174,0,9,153,162,21,9,30,192,13,46,NM - Albuquerque
47,1997-1998,1997-11-14,1998-04-26,164,0,3,162,165,21,10,31,196,14,39,NM - Albuquerque
48,1998-1999,1998-11-09,1999-03-18,130,0,0,115,115,10,4,14,129,5,15,NM - Albuquerque
49,1999-2000,1999-12-01,2000-03-23,114,0,1,110,111,8,1,9,120,6,11,NM - Albuquerque
50,2000-2001,2000-11-07,2001-03-17,131,0,3,136,139,21,3,24,163,12,34,NM - Albuquerque
51,2001-2002,2001-12-01,2002-02-28,90,0,1,119,120,9,2,11,131,6,18,NM - Albuquerque
52,2002-2003,2002-12-01,2003-03-18,108,0,0,86,86,5,2,7,93,3,9,NM - Albuquerque
53,2003-2004,2003-12-01,2004-03-04,95,0,2,120,122,10,3,13,135,7,15,NM - Albuquerque
54,2004-2005,2004-11-29,2005-04-10,133,0,1,88,89,11,3,14,103,7,20,NM - Albuquerque
55,2005-2006,2005-12-01,2006-03-22,112,0,0,114,114,5,0,5,119,4,9,NM - Albuquerque
56,2006-2007,2006-11-30,2007-02-28,91,0,4,139,143,44,52,96,239,14,65,NM - Albuquerque
57,2007-2008,2007-11-22,2008-03-03,103,0,4,144,148,12,1,13,161,11,24,NM - Albuquerque
58,2008-2009,2008-12-01,2009-02-28,90,0,2,78,80,7,2,9,89,5,13,NM - Albuquerque
59,2009-2010,2009-10-29,2010-03-24,147,0,1,150,151,11,0,11,162,11,23,NM - Albuquerque
60,2010-2011,2010-11-25,2011-02-28,96,0,11,149,160,6,1,7,167,5,19,NM - Albuquerque
61,2011-2012,2011-12-01,2012-04-03,125,0,2,118,120,17,8,25,145,12,35,NM - Albuquerque
62,2012-2013,2012-12-01,2013-02-28,90,0,4,153,157,6,3,9,166,4,13,NM - Albuquerque
63,2013-2014,2013-11-23,2014-02-28,98,0,2,123,125,11,6,17,142,8,23,NM - Albuquerque
64,2014-2015,2014-12-01,2015-02-28,90,0,3,106,109,25,9,34,143,14,50,NM - Albuquerque
65,2015-2016,2015-12-01,2016-02-29,91,0,2,113,115,15,11,26,141,10,27,NM - Albuquerque
66,2016-2017,2016-11-28,2017-04-29,153,0,0,86,86,8,2,10,96,7,18,NM - Albuquerque
67,2017-2018,2017-12-01,2018-02-28,90,0,0,101,101,2,0,2,103,2,4,NM - Albuquerque
68,2018-2019,2018-12-01,2019-02-28,90,0,4,118,122,14,8,22,144,7,27,NM - Albuquerque
69,2019-2020,2019-11-27,2020-04-13,139,0,2,110,112,12,3,15,127,9,22,NM - Albuquerque
0,1950-1951,1950-11-09,1951-04-10,153,0,29,331,360,24,6,30,390,14,86,NM - Clayton
1,1951-1952,1951-11-01,1952-04-09,161,0,17,329,346,24,12,36,382,15,77,NM - Clayton
2,1952-1953,1952-11-09,1953-05-13,186,0,21,287,308,30,55,85,393,15,86,NM - Clayton
3,1953-1954,1953-11-18,1954-03-13,116,0,14,223,237,22,26,48,285,16,76,NM - Clayton
4,1954-1955,1954-12-01,1955-04-13,134,0,14,298,312,24,12,36,348,9,61,NM - Clayton
5,1955-1956,1955-11-07,1956-03-15,130,0,16,305,321,10,6,16,337,9,51,NM - Clayton
6,1956-1957,1956-11-02,1957-04-13,163,0,17,292,309,30,20,50,359,15,71,NM - Clayton
7,1957-1958,1957-11-05,1958-04-12,159,0,15,297,312,59,80,139,451,28,133,NM - Clayton
8,1958-1959,1958-11-16,1959-04-20,156,1,25,332,357,58,68,126,483,20,122,NM - Clayton
9,1959-1960,1959-10-30,1960-03-16,139,0,32,340,372,30,39,69,441,20,102,NM - Clayton
10,1960-1961,1960-10-15,1961-04-08,176,0,18,282,300,28,41,69,369,18,79,NM - Clayton
11,1961-1962,1961-11-14,1962-03-30,137,0,43,333,376,31,45,76,452,11,92,NM - Clayton
12,1962-1963,1962-11-17,1963-03-12,116,1,39,314,353,14,17,31,384,8,41,NM - Clayton
13,1963-1964,1963-12-01,1964-04-07,129,0,18,333,351,21,34,55,406,12,66,NM - Clayton
14,1964-1965,1964-11-04,1965-03-26,143,0,24,311,335,26,39,65,400,17,87,NM - Clayton
15,1965-1966,1965-12-01,1966-03-22,112,0,17,254,271,21,37,58,329,11,66,NM - Clayton
16,1966-1967,1966-10-17,1967-03-07,142,0,11,287,298,14,11,25,323,12,57,NM - Clayton
17,1967-1968,1967-10-29,1968-03-13,137,0,23,293,316,31,43,74,390,16,90,NM - Clayton
18,1968-1969,1968-11-07,1969-05-08,183,0,16,301,317,40,33,73,390,19,96,NM - Clayton
19,1969-1970,1969-10-11,1970-04-30,202,0,19,337,356,41,36,77,433,19,92,NM - Clayton
20,1970-1971,1970-10-07,1971-04-05,181,0,28,344,372,34,29,63,435,21,97,NM - Clayton
21,1971-1972,1971-09-17,1972-04-15,212,1,12,280,292,28,29,57,349,12,71,NM - Clayton
22,1972-1973,1972-10-31,1973-04-08,160,0,36,324,360,66,96,162,522,28,146,NM - Clayton
23,1973-1974,1973-11-20,1974-03-10,111,2,24,244,268,27,42,69,337,14,85,NM - Clayton
24,1974-1975,1974-11-28,1975-04-12,136,0,16,300,316,28,29,57,373,20,100,NM - Clayton
25,1975-1976,1975-11-18,1976-03-29,133,1,17,244,261,16,13,29,290,11,47,NM - Clayton
26,1976-1977,1976-11-12,1977-04-21,161,0,21,313,334,19,20,39,373,13,85,NM - Clayton
27,1977-1978,1977-11-01,1978-05-04,185,0,32,305,337,40,45,85,422,23,130,NM - Clayton
28,1978-1979,1978-11-11,1979-05-03,174,0,51,346,397,47,65,112,509,25,167,NM - Clayton
29,1979-1980,1979-10-29,1980-04-25,180,0,15,309,324,32,32,64,388,20,84,NM - Clayton
30,1980-1981,1980-11-14,1981-04-04,142,0,13,217,230,19,23,42,272,11,56,NM - Clayton
31,1981-1982,1981-12-01,1982-04-10,131,1,27,267,294,23,36,59,353,11,76,NM - Clayton
32,1982-1983,1982-11-23,1983-05-02,161,0,23,249,272,71,151,222,494,24,131,NM - Clayton
33,1983-1984,1983-11-22,1984-03-31,131,0,64,352,416,48,80,128,544,21,129,NM - Clayton
35,1985-1986,1985-11-30,1986-02-28,91,0,29,193,222,18,31,49,271,11,81,NM - Clayton
37,1987-1988,1987-11-15,1988-04-02,140,0,29,320,349,58,79,137,486,24,143,NM - Clayton
38,1988-1989,1988-11-15,1989-04-10,147,0,33,297,330,24,14,38,368,20,112,NM - Clayton
39,1989-1990,1989-12-01,1990-05-03,154,0,25,265,290,65,86,151,441,18,135,NM - Clayton
40,1990-1991,1990-10-08,1991-05-05,210,1,27,296,323,38,32,70,393,19,110,NM - Clayton
41,1991-1992,1991-10-30,1992-04-01,155,0,13,209,222,24,24,48,270,11,60,NM - Clayton
54,2004-2005,2004-11-01,2005-05-02,183,0,12,203,215,64,72,136,351,23,113,NM - Clayton
55,2005-2006,2005-11-27,2006-03-23,117,0,11,225,236,13,5,18,254,8,41,NM - Clayton
56,2006-2007,2006-11-29,2007-04-13,136,0,31,233,264,70,262,332,596,18,140,NM - Clayton
57,2007-2008,2007-11-23,2008-04-17,147,0,10,255,265,26,14,40,305,18,70,NM - Clayton
58,2008-2009,2008-11-27,2009-03-28,122,0,10,196,206,29,17,46,252,9,60,NM - Clayton
59,2009-2010,2009-10-25,2010-03-20,147,0,17,248,265,48,124,172,437,19,96,NM - Clayton
60,2010-2011,2010-12-01,2011-05-01,152,0,22,230,252,23,26,49,301,15,78,NM - Clayton
61,2011-2012,2011-10-26,2012-02-29,127,0,13,202,215,44,77,121,336,15,85,NM - Clayton
62,2012-2013,2012-12-01,2013-04-23,144,0,19,240,259,30,36,66,325,16,84,NM - Clayton
63,2013-2014,2013-11-22,2014-04-13,143,1,32,269,301,19,10,29,330,13,90,NM - Clayton
64,2014-2015,2014-11-11,2015-03-04,114,0,31,220,251,42,35,77,328,22,137,NM - Clayton
65,2015-2016,2015-11-17,2016-05-01,167,0,8,205,213,41,35,76,289,17,78,NM - Clayton
66,2016-2017,2016-12-01,2017-04-30,151,1,11,193,204,37,12,49,253,14,65,NM - Clayton
67,2017-2018,2017-11-07,2018-02-28,114,0,11,229,240,2,0,2,242,2,10,NM - Clayton
68,2018-2019,2018-10-14,2019-04-11,180,3,20,305,325,24,15,39,364,16,67,NM - Clayton
69,2019-2020,2019-10-28,2020-04-14,170,0,12,251,263,22,8,30,293,15,69,NM - Clayton
2,1952-1953,1952-11-09,1953-05-13,186,20,37,296,333,51,62,113,446,30,138,NM - Los Alamos
3,1953-1954,1953-11-19,1954-03-31,133,3,18,228,246,45,62,107,353,19,95,NM - Los Alamos
4,1954-1955,1954-12-01,1955-04-07,128,0,28,285,313,40,49,89,402,14,78,NM - Los Alamos
5,1955-1956,1955-11-08,1956-04-03,148,1,14,225,239,72,108,180,419,20,133,NM - Los Alamos
6,1956-1957,1956-11-02,1957-04-24,174,0,11,271,282,54,21,75,357,27,101,NM - Los Alamos
7,1957-1958,1957-10-23,1958-04-15,175,2,19,373,392,182,259,441,833,44,293,NM - Los Alamos
8,1958-1959,1958-10-30,1959-04-08,161,0,15,286,301,58,71,129,430,17,104,NM - Los Alamos
9,1959-1960,1959-10-30,1960-05-01,185,2,36,356,392,128,202,330,722,32,236,NM - Los Alamos
10,1960-1961,1960-10-15,1961-04-11,179,2,13,334,347,127,187,314,661,26,196,NM - Los Alamos
11,1961-1962,1961-10-29,1962-05-28,212,7,26,347,373,98,331,429,802,31,185,NM - Los Alamos
12,1962-1963,1962-11-17,1963-03-19,123,0,31,316,347,92,189,281,628,22,181,NM - Los Alamos
13,1963-1964,1963-11-21,1964-04-07,139,0,32,389,421,73,106,179,600,30,177,NM - Los Alamos
14,1964-1965,1964-11-18,1965-04-27,161,0,27,346,373,79,128,207,580,29,180,NM - Los Alamos
15,1965-1966,1965-10-17,1966-04-19,185,1,31,350,381,56,162,218,599,22,130,NM - Los Alamos
16,1966-1967,1966-10-17,1967-03-06,141,0,18,248,266,24,43,67,333,10,49,NM - Los Alamos
17,1967-1968,1967-10-29,1968-04-23,178,0,20,316,336,111,243,354,690,33,200,NM - Los Alamos
18,1968-1969,1968-11-16,1969-05-07,173,0,21,308,329,82,81,163,492,31,167,NM - Los Alamos
19,1969-1970,1969-10-12,1970-05-02,203,0,28,321,349,72,108,180,529,28,154,NM - Los Alamos
20,1970-1971,1970-09-22,1971-04-20,211,0,35,362,397,47,83,130,527,21,116,NM - Los Alamos
21,1971-1972,1971-09-18,1972-03-28,193,1,16,308,324,67,216,283,607,19,128,NM - Los Alamos
26,1976-1977,1976-11-12,1977-04-04,144,2,26,433,459,49,420,469,928,15,105,NM - Los Alamos
27,1977-1978,1977-11-07,1978-05-08,183,18,15,268,283,50,41,91,374,13,83,NM - Los Alamos
28,1978-1979,1978-10-25,1979-03-20,147,5,33,358,391,103,369,472,863,18,152,NM - Los Alamos
31,1981-1982,1981-11-28,1982-05-05,159,14,21,286,307,124,187,311,618,29,203,NM - Los Alamos
33,1983-1984,1983-11-18,1984-04-26,161,15,19,385,404,99,143,242,646,35,185,NM - Los Alamos
34,1984-1985,1984-10-15,1985-04-27,195,14,24,341,365,174,350,524,889,47,280,NM - Los Alamos
35,1985-1986,1985-11-14,1986-05-17,185,6,12,251,263,73,103,176,439,21,124,NM - Los Alamos
36,1986-1987,1986-10-11,1987-04-07,179,3,24,342,366,210,382,592,958,40,308,NM - Los Alamos
37,1987-1988,1987-11-15,1988-04-22,160,1,42,350,392,115,289,404,796,31,223,NM - Los Alamos
38,1988-1989,1988-11-15,1989-03-20,126,2,24,300,324,76,105,181,505,25,152,NM - Los Alamos
39,1989-1990,1989-11-30,1990-05-03,155,1,20,298,318,61,117,178,496,21,118,NM - Los Alamos
40,1990-1991,1990-11-03,1991-03-30,148,5,36,358,394,56,228,284,678,23,125,NM - Los Alamos
41,1991-1992,1991-10-30,1992-03-09,132,0,24,314,338,66,267,333,671,19,117,NM - Los Alamos
42,1992-1993,1992-11-03,1993-03-29,147,7,27,349,376,113,650,763,1139,25,183,NM - Los Alamos
45,1995-1996,1995-11-04,1996-03-15,133,0,18,261,279,60,193,253,532,17,124,NM - Los Alamos
46,1996-1997,1996-10-21,1997-04-24,186,0,36,384,420,114,368,482,902,30,225,NM - Los Alamos
47,1997-1998,1997-10-25,1998-04-26,184,5,21,374,395,78,364,442,837,27,149,NM - Los Alamos
48,1998-1999,1998-12-01,1999-04-04,125,12,6,232,238,30,20,50,288,7,45,NM - Los Alamos
49,1999-2000,1999-10-16,2000-04-01,169,8,8,274,282,23,10,33,315,12,43,NM - Los Alamos
50,2000-2001,2000-11-03,2001-03-17,135,8,20,299,319,95,291,386,705,26,159,NM - Los Alamos
51,2001-2002,2001-11-27,2002-03-03,97,4,19,277,296,20,49,69,365,5,41,NM - Los Alamos
52,2002-2003,2002-11-04,2003-03-28,145,6,13,239,252,37,139,176,428,12,66,NM - Los Alamos
53,2003-2004,2003-11-12,2004-04-11,152,2,25,296,321,91,238,329,650,23,148,NM - Los Alamos
54,2004-2005,2004-11-13,2005-04-10,149,4,21,247,268,95,136,231,499,29,167,NM - Los Alamos
55,2005-2006,2005-12-01,2006-03-23,113,3,7,219,226,11,2,13,239,6,23,NM - Los Alamos
56,2006-2007,2006-11-30,2007-03-05,96,6,31,253,284,63,421,484,768,17,110,NM - Los Alamos
57,2007-2008,2007-10-22,2008-04-17,179,15,36,344,380,64,291,355,735,21,124,NM - Los Alamos
58,2008-2009,2008-11-27,2009-04-17,142,13,14,233,247,74,330,404,651,18,120,NM - Los Alamos
59,2009-2010,2009-10-26,2010-05-02,189,7,33,369,402,89,709,798,1200,33,165,NM - Los Alamos
62,2012-2013,2012-11-11,2013-03-08,118,0,32,294,326,28,120,148,474,10,63,NM - Los Alamos
63,2013-2014,2013-10-15,2014-03-26,163,0,20,258,278,29,37,66,344,14,70,NM - Los Alamos
64,2014-2015,2014-11-16,2015-04-26,162,4,18,223,241,62,64,126,367,23,118,NM - Los Alamos
65,2015-2016,2015-11-05,2016-05-01,179,0,20,243,263,67,176,243,506,26,116,NM - Los Alamos
66,2016-2017,2016-11-21,2017-05-19,180,0,12,206,218,47,109,156,374,24,86,NM - Los Alamos
67,2017-2018,2017-12-01,2018-03-27,117,0,4,179,183,11,1,12,195,5,26,NM - Los Alamos
68,2018-2019,2018-10-16,2019-03-31,167,0,35,287,322,91,373,464,786,22,166,NM - Los Alamos
69,2019-2020,2019-10-24,2020-04-13,173,0,15,278,293,46,90,136,429,20,90,NM - Los Alamos
0,1950-1951,1950-12-01,1951-02-28,90,0,7,187,194,5,1,6,200,4,22,NM - Roswell
1,1951-1952,1951-11-01,1952-02-29,121,0,3,149,152,13,8,21,173,7,26,NM - Roswell
2,1952-1953,1952-11-24,1953-02-28,97,0,1,141,142,11,3,14,156,4,18,NM - Roswell
3,1953-1954,1953-12-01,1954-02-28,90,0,2,155,157,6,4,10,167,4,14,NM - Roswell
4,1954-1955,1954-12-01,1955-03-21,111,0,0,174,174,6,4,10,184,4,15,NM - Roswell
5,1955-1956,1955-11-07,1956-03-07,122,0,7,184,191,23,40,63,254,8,55,NM - Roswell
6,1956-1957,1956-12-01,1957-02-28,90,0,0,105,105,0,0,0,105,0,0,NM - Roswell
7,1957-1958,1957-11-21,1958-04-13,144,0,1,146,147,17,9,26,173,9,31,NM - Roswell
8,1958-1959,1958-12-01,1959-03-04,94,0,4,161,165,5,0,5,170,3,14,NM - Roswell
9,1959-1960,1959-12-01,1960-03-01,92,0,3,147,150,16,12,28,178,8,38,NM - Roswell
10,1960-1961,1960-12-01,1961-03-19,109,0,14,260,274,38,63,101,375,10,61,NM - Roswell
11,1961-1962,1961-11-13,1962-03-14,122,0,11,231,242,22,25,47,289,6,47,NM - Roswell
12,1962-1963,1962-11-19,1963-02-28,102,2,13,238,251,17,12,29,280,10,60,NM - Roswell
13,1963-1964,1963-12-01,1964-03-08,99,0,1,288,289,21,21,42,331,8,39,NM - Roswell
14,1964-1965,1964-12-01,1965-03-03,93,0,3,162,165,18,11,29,194,9,43,NM - Roswell
15,1965-1966,1965-12-01,1966-02-28,90,0,9,214,223,12,13,25,248,5,30,NM - Roswell
16,1966-1967,1966-12-01,1967-03-05,95,0,0,211,211,5,0,5,216,3,8,NM - Roswell
17,1967-1968,1967-11-27,1968-03-21,116,0,9,179,188,35,24,59,247,16,77,NM - Roswell
18,1968-1969,1968-11-26,1969-03-24,119,0,0,195,195,29,12,41,236,8,39,NM - Roswell
19,1969-1970,1969-12-01,1970-03-27,117,0,11,164,175,27,30,57,232,11,43,NM - Roswell
20,1970-1971,1970-10-16,1971-03-02,138,0,7,185,192,10,5,15,207,6,26,NM - Roswell
21,1971-1972,1971-12-01,1972-02-29,91,0,2,153,155,13,9,22,177,8,31,NM - Roswell
22,1972-1973,1972-10-31,1973-04-08,160,1,8,155,163,32,20,52,215,14,58,NM - Roswell
23,1973-1974,1973-12-01,1974-03-20,110,0,3,161,164,3,0,3,167,2,9,NM - Roswell
24,1974-1975,1974-12-01,1975-03-29,119,0,3,129,132,13,9,22,154,7,26,NM - Roswell
25,1975-1976,1975-12-01,1976-03-30,121,0,0,114,114,7,1,8,122,5,10,NM - Roswell
26,1976-1977,1976-10-27,1977-03-05,130,0,7,174,181,17,12,29,210,12,50,NM - Roswell
27,1977-1978,1977-12-01,1978-03-03,93,0,4,102,106,10,3,13,119,7,23,NM - Roswell
28,1978-1979,1978-11-16,1979-02-28,105,0,19,148,167,24,23,47,214,9,59,NM - Roswell
29,1979-1980,1979-10-30,1980-04-13,167,0,10,155,165,28,37,65,230,9,46,NM - Roswell
30,1980-1981,1980-11-15,1981-02-28,106,0,5,120,125,25,42,67,192,8,38,NM - Roswell
31,1981-1982,1981-12-01,1982-03-05,95,0,9,130,139,17,18,35,174,7,41,NM - Roswell
32,1982-1983,1982-11-24,1983-04-07,135,0,10,112,122,38,33,71,193,14,61,NM - Roswell
33,1983-1984,1983-12-01,1984-03-06,97,0,22,137,159,14,7,21,180,6,47,NM - Roswell
34,1984-1985,1984-12-01,1985-02-28,90,0,10,113,123,15,14,29,152,11,51,NM - Roswell
35,1985-1986,1985-12-01,1986-02-28,90,0,7,123,130,16,23,39,169,5,36,NM - Roswell
36,1986-1987,1986-11-13,1987-03-29,137,0,6,125,131,27,25,52,183,11,52,NM - Roswell
37,1987-1988,1987-12-01,1988-02-29,91,0,8,143,151,44,55,99,250,8,66,NM - Roswell
38,1988-1989,1988-12-01,1989-03-21,111,0,5,129,134,13,12,25,159,6,29,NM - Roswell
39,1989-1990,1989-12-01,1990-03-14,104,0,3,143,146,5,3,8,154,2,7,NM - Roswell
40,1990-1991,1990-11-07,1991-02-28,114,0,3,100,103,6,2,8,111,5,17,NM - Roswell
41,1991-1992,1991-10-30,1992-02-29,123,0,2,113,115,13,6,19,134,8,31,NM - Roswell
42,1992-1993,1992-12-01,1993-02-28,90,0,1,90,91,7,14,21,112,3,17,NM - Roswell
43,1993-1994,1993-10-29,1994-03-27,150,0,1,180,181,6,2,8,189,5,17,NM - Roswell
44,1994-1995,1994-12-01,1995-02-28,90,0,1,56,57,2,1,3,60,2,5,NM - Roswell
45,1995-1996,1995-11-28,1996-04-05,130,0,3,111,114,11,2,13,127,8,23,NM - Roswell
50,2000-2001,2000-11-07,2001-02-28,114,3,4,152,156,25,39,64,220,7,37,NM - Roswell
54,2004-2005,2004-11-13,2005-03-15,123,0,5,80,85,25,23,48,133,5,40,NM - Roswell
55,2005-2006,2005-12-01,2006-03-22,112,0,1,111,112,1,0,1,113,1,2,NM - Roswell
56,2006-2007,2006-11-29,2007-04-07,130,0,2,147,149,23,24,47,196,10,41,NM - Roswell
57,2007-2008,2007-11-23,2008-03-07,106,0,0,131,131,22,16,38,169,6,30,NM - Roswell
58,2008-2009,2008-12-01,2009-03-27,117,0,0,157,157,1,0,1,158,1,2,NM - Roswell
59,2009-2010,2009-12-01,2010-03-20,110,0,5,144,149,25,13,38,187,9,46,NM - Roswell
60,2010-2011,2010-12-01,2011-02-28,90,0,10,182,192,4,3,7,199,2,21,NM - Roswell
61,2011-2012,2011-12-01,2012-02-29,91,0,6,122,128,21,37,58,186,6,34,NM - Roswell
62,2012-2013,2012-12-01,2013-02-28,90,0,3,124,127,5,3,8,135,4,13,NM - Roswell
63,2013-2014,2013-11-23,2014-02-28,98,0,8,149,157,9,6,15,172,5,17,NM - Roswell
64,2014-2015,2014-11-13,2015-02-28,108,0,11,143,154,25,26,51,205,10,62,NM - Roswell
65,2015-2016,2015-12-01,2016-02-29,91,0,5,131,136,26,74,100,236,4,38,NM - Roswell
66,2016-2017,2016-12-01,2017-02-28,90,0,4,107,111,3,4,7,118,1,10,NM - Roswell
67,2017-2018,2017-12-01,2018-02-28,90,0,2,139,141,0,0,0,141,0,0,NM - Roswell
68,2018-2019,2018-12-01,2019-03-04,94,0,4,95,99,8,5,13,112,3,14,NM - Roswell
69,2019-2020,2019-11-27,2020-02-29,95,1,0,75,75,7,2,9,84,3,10,NM - Roswell
0,1950-1951,1950-11-23,1951-04-03,132,0,68,312,380,77,159,236,616,38,216,NY - Albany
1,1951-1952,1951-11-01,1952-03-20,141,0,69,361,430,96,256,352,782,37,223,NY - Albany
2,1952-1953,1952-10-28,1953-04-20,175,0,38,285,323,74,125,199,522,34,175,NY - Albany
3,1953-1954,1953-11-07,1954-04-04,149,0,66,331,397,69,122,191,588,27,159,NY - Albany
4,1954-1955,1954-11-29,1955-04-04,127,0,83,327,410,59,80,139,549,33,150,NY - Albany
5,1955-1956,1955-11-11,1956-04-23,165,0,99,421,520,114,261,375,895,41,259,NY - Albany
6,1956-1957,1956-11-10,1957-04-12,154,0,71,390,461,105,175,280,741,38,247,NY - Albany
7,1957-1958,1957-10-27,1958-03-24,149,0,85,333,418,109,292,401,819,32,241,NY - Albany
8,1958-1959,1958-11-03,1959-03-31,149,0,111,475,586,95,142,237,823,42,262,NY - Albany
9,1959-1960,1959-11-17,1960-04-08,144,0,80,353,433,101,291,392,825,47,253,NY - Albany
10,1960-1961,1960-11-06,1961-04-13,159,0,112,478,590,110,478,588,1178,30,246,NY - Albany
11,1961-1962,1961-11-20,1962-04-13,145,0,91,380,471,96,296,392,863,37,239,NY - Albany
12,1962-1963,1962-11-13,1963-03-25,133,0,108,464,572,113,422,535,1107,50,318,NY - Albany
13,1963-1964,1963-12-01,1964-03-31,122,0,96,410,506,113,350,463,969,38,282,NY - Albany
14,1964-1965,1964-11-22,1965-04-19,149,0,97,421,518,71,177,248,766,35,223,NY - Albany
15,1965-1966,1965-11-29,1966-05-09,162,0,60,368,428,99,195,294,722,37,226,NY - Albany
16,1966-1967,1966-12-01,1967-05-07,158,0,78,434,512,123,271,394,906,47,315,NY - Albany
17,1967-1968,1967-11-09,1968-03-16,129,0,102,450,552,71,167,238,790,35,250,NY - Albany
18,1968-1969,1968-11-12,1969-04-19,159,0,86,433,519,98,405,503,1022,46,253,NY - Albany
19,1969-1970,1969-11-20,1970-04-02,134,0,120,534,654,129,534,663,1317,47,403,NY - Albany
20,1970-1971,1970-12-01,1971-04-24,145,0,108,499,607,163,646,809,1416,49,366,NY - Albany
21,1971-1972,1971-11-22,1972-04-11,142,0,65,437,502,127,254,381,883,41,280,NY - Albany
22,1972-1973,1972-11-14,1973-04-04,142,0,59,351,410,102,194,296,706,31,191,NY - Albany
23,1973-1974,1973-11-06,1974-04-11,157,0,85,417,502,89,217,306,808,38,256,NY - Albany
24,1974-1975,1974-11-21,1975-04-06,137,0,49,365,414,88,212,300,714,42,221,NY - Albany
25,1975-1976,1975-11-14,1976-03-20,128,0,83,399,482,82,259,341,823,37,268,NY - Albany
26,1976-1977,1976-11-05,1977-05-09,186,0,110,476,586,108,293,401,987,45,296,NY - Albany
27,1977-1978,1977-11-13,1978-04-03,142,0,106,418,524,136,509,645,1169,48,319,NY - Albany
28,1978-1979,1978-11-21,1979-04-10,141,0,113,397,510,93,314,407,917,38,252,NY - Albany
29,1979-1980,1979-12-01,1980-03-17,108,0,73,345,418,44,48,92,510,16,114,NY - Albany
30,1980-1981,1980-11-17,1981-03-21,125,0,115,459,574,74,184,258,832,33,242,NY - Albany
31,1981-1982,1981-11-07,1982-04-11,156,0,113,464,577,147,361,508,1085,45,332,NY - Albany
32,1982-1983,1982-11-26,1983-05-09,165,0,54,285,339,109,173,282,621,24,172,NY - Albany
33,1983-1984,1983-11-25,1984-03-31,128,0,105,382,487,98,190,288,775,38,241,NY - Albany
34,1984-1985,1984-11-12,1985-04-01,141,0,73,326,399,66,119,185,584,33,198,NY - Albany
35,1985-1986,1985-11-16,1986-04-23,159,0,80,376,456,94,280,374,830,41,233,NY - Albany
36,1986-1987,1986-11-05,1987-04-28,175,0,59,386,445,111,408,519,964,28,182,NY - Albany
37,1987-1988,1987-10-04,1988-04-16,196,0,73,396,469,115,190,305,774,35,207,NY - Albany
38,1988-1989,1988-12-01,1989-04-10,131,0,62,356,418,36,36,72,490,26,136,NY - Albany
39,1989-1990,1989-11-20,1990-03-30,131,0,86,380,466,85,139,224,690,32,207,NY - Albany
40,1990-1991,1990-11-11,1991-03-30,140,0,44,278,322,47,83,130,452,24,115,NY - Albany
41,1991-1992,1991-11-11,1992-04-16,158,0,55,365,420,54,46,100,520,34,175,NY - Albany
42,1992-1993,1992-11-17,1993-04-26,161,1,63,381,444,134,351,485,929,42,273,NY - Albany
43,1993-1994,1993-11-01,1994-03-30,150,0,129,473,602,129,420,549,1151,45,371,NY - Albany
44,1994-1995,1994-11-23,1995-04-05,134,0,51,297,348,52,99,151,499,25,125,NY - Albany
45,1995-1996,1995-11-08,1996-04-08,153,19,123,415,538,125,335,460,998,44,317,NY - Albany
46,1996-1997,1996-11-13,1997-04-19,158,0,61,323,384,96,111,207,591,43,242,NY - Albany
47,1997-1998,1997-11-14,1998-03-23,130,0,33,247,280,78,185,263,543,32,150,NY - Albany
48,1998-1999,1998-12-01,1999-03-22,112,0,61,297,358,64,140,204,562,29,182,NY - Albany
49,1999-2000,1999-11-29,2000-04-11,135,0,75,313,388,91,215,306,694,24,180,NY - Albany
50,2000-2001,2000-10-29,2001-03-30,153,0,73,369,442,117,313,430,872,41,227,NY - Albany
51,2001-2002,2001-12-01,2002-05-18,169,0,17,231,248,75,113,188,436,31,138,NY - Albany
52,2002-2003,2002-10-23,2003-04-10,170,0,116,451,567,154,594,748,1315,55,352,NY - Albany
53,2003-2004,2003-11-25,2004-04-05,133,0,107,362,469,104,283,387,856,40,255,NY - Albany
54,2004-2005,2004-11-12,2005-03-24,133,0,90,369,459,114,232,346,805,41,288,NY - Albany
55,2005-2006,2005-10-23,2006-03-15,144,0,45,276,321,56,97,153,474,36,167,NY - Albany
56,2006-2007,2006-12-01,2007-04-16,137,0,78,325,403,75,195,270,673,30,189,NY - Albany
57,2007-2008,2007-11-20,2008-03-29,131,0,54,299,353,92,200,292,645,36,207,NY - Albany
58,2008-2009,2008-11-21,2009-03-12,112,0,82,331,413,77,239,316,729,26,177,NY - Albany
59,2009-2010,2009-12-01,2010-03-26,116,0,62,239,301,74,106,180,481,31,144,NY - Albany
60,2010-2011,2010-11-08,2011-04-01,145,0,91,364,455,118,434,552,1007,35,268,NY - Albany
61,2011-2012,2011-10-27,2012-03-09,135,0,22,221,243,39,35,74,317,21,91,NY - Albany
62,2012-2013,2012-11-07,2013-04-02,147,0,45,295,340,79,147,226,566,32,173,NY - Albany
63,2013-2014,2013-11-23,2014-04-16,145,0,110,440,550,111,273,384,934,39,279,NY - Albany
64,2014-2015,2014-11-14,2015-03-30,137,0,107,440,547,112,360,472,1019,43,300,NY - Albany
65,2015-2016,2015-12-01,2016-04-06,128,0,31,209,240,29,22,51,291,17,80,NY - Albany
66,2016-2017,2016-10-27,2017-04-01,157,0,37,271,308,93,150,243,551,36,176,NY - Albany
67,2017-2018,2017-12-01,2018-04-07,128,0,77,311,388,106,258,364,752,30,196,NY - Albany
68,2018-2019,2018-11-13,2019-04-06,145,0,61,322,383,80,181,261,644,37,181,NY - Albany
69,2019-2020,2019-11-12,2020-04-22,163,0,26,224,250,80,106,186,436,33,135,NY - Albany
1,1951-1952,1951-11-01,1952-04-08,160,3,96,380,476,122,198,320,796,64,360,NY - Binghamton
2,1952-1953,1952-10-20,1953-04-21,184,0,67,295,362,120,112,232,594,68,329,NY - Binghamton
3,1953-1954,1953-11-05,1954-04-04,151,0,88,335,423,104,105,209,632,58,345,NY - Binghamton
4,1954-1955,1954-11-01,1955-04-07,158,0,117,379,496,147,262,409,905,79,448,NY - Binghamton
5,1955-1956,1955-11-10,1956-04-23,166,0,133,448,581,189,405,594,1175,95,620,NY - Binghamton
6,1956-1957,1956-11-09,1957-04-14,157,0,96,387,483,141,198,339,822,77,430,NY - Binghamton
7,1957-1958,1957-10-27,1958-04-13,169,0,127,380,507,167,511,678,1185,77,469,NY - Binghamton
8,1958-1959,1958-10-26,1959-03-31,157,0,125,442,567,127,262,389,956,73,461,NY - Binghamton
9,1959-1960,1959-11-02,1960-04-11,162,0,103,346,449,159,442,601,1050,74,407,NY - Binghamton
10,1960-1961,1960-10-21,1961-04-18,180,5,150,420,570,148,494,642,1212,64,405,NY - Binghamton
11,1961-1962,1961-11-08,1962-05-08,182,0,136,432,568,106,222,328,896,65,371,NY - Binghamton
12,1962-1963,1962-10-26,1963-05-01,188,0,158,455,613,143,496,639,1252,61,409,NY - Binghamton
13,1963-1964,1963-11-02,1964-04-04,155,0,144,397,541,163,486,649,1190,74,509,NY - Binghamton
14,1964-1965,1964-11-22,1965-04-20,150,0,118,386,504,120,194,314,818,61,375,NY - Binghamton
15,1965-1966,1965-10-04,1966-05-10,219,0,115,364,479,140,214,354,833,76,417,NY - Binghamton
16,1966-1967,1966-11-29,1967-05-08,161,0,122,355,477,135,286,421,898,69,459,NY - Binghamton
17,1967-1968,1967-11-08,1968-03-24,138,0,147,420,567,105,229,334,901,64,452,NY - Binghamton
18,1968-1969,1968-10-26,1969-04-24,181,0,135,373,508,97,171,268,776,67,373,NY - Binghamton
19,1969-1970,1969-10-23,1970-04-11,171,0,139,417,556,180,653,833,1389,87,534,NY - Binghamton
20,1970-1971,1970-10-17,1971-04-26,192,0,159,419,578,166,636,802,1380,68,456,NY - Binghamton
21,1971-1972,1971-11-07,1972-04-10,156,0,110,396,506,167,314,481,987,85,501,NY - Binghamton
22,1972-1973,1972-10-18,1973-05-18,213,0,101,357,458,110,161,271,729,62,320,NY - Binghamton
23,1973-1974,1973-11-09,1974-04-12,155,0,91,329,420,126,265,391,811,49,321,NY - Binghamton
24,1974-1975,1974-10-02,1975-04-08,189,0,109,371,480,119,258,377,857,77,387,NY - Binghamton
25,1975-1976,1975-11-14,1976-04-27,166,0,111,382,493,125,315,440,933,61,400,NY - Binghamton
26,1976-1977,1976-10-22,1977-05-09,200,0,181,488,669,134,370,504,1173,82,558,NY - Binghamton
27,1977-1978,1977-11-11,1978-04-21,162,0,185,446,631,180,605,785,1416,77,568,NY - Binghamton
28,1978-1979,1978-11-20,1979-04-10,142,0,155,394,549,125,347,472,1021,63,400,NY - Binghamton
29,1979-1980,1979-10-26,1980-04-16,174,0,108,342,450,103,133,236,686,59,337,NY - Binghamton
30,1980-1981,1980-10-13,1981-03-21,160,0,146,433,579,111,269,380,959,73,434,NY - Binghamton
31,1981-1982,1981-11-07,1982-04-12,157,3,126,424,550,125,341,466,1016,61,378,NY - Binghamton
32,1982-1983,1982-10-16,1983-05-08,205,0,57,294,351,128,220,348,699,49,278,NY - Binghamton
33,1983-1984,1983-11-04,1984-04-04,153,0,120,375,495,116,288,404,899,67,389,NY - Binghamton
34,1984-1985,1984-11-12,1985-04-09,149,0,90,335,425,107,219,326,751,67,378,NY - Binghamton
35,1985-1986,1985-11-15,1986-04-23,160,0,129,370,499,124,440,564,1063,73,463,NY - Binghamton
36,1986-1987,1986-11-05,1987-04-28,175,0,72,311,383,119,412,531,914,48,256,NY - Binghamton
37,1987-1988,1987-11-06,1988-04-23,170,0,110,381,491,141,301,442,933,74,455,NY - Binghamton
38,1988-1989,1988-10-22,1989-05-08,199,0,94,385,479,93,108,201,680,66,355,NY - Binghamton
39,1989-1990,1989-10-21,1990-04-18,180,0,108,400,508,130,218,348,856,75,415,NY - Binghamton
40,1990-1991,1990-10-28,1991-04-22,177,0,65,291,356,114,120,234,590,65,328,NY - Binghamton
41,1991-1992,1991-11-07,1992-04-03,149,0,77,327,404,99,141,240,644,65,351,NY - Binghamton
42,1992-1993,1992-10-18,1993-04-26,191,0,104,418,522,182,460,642,1164,79,449,NY - Binghamton
43,1993-1994,1993-10-10,1994-04-07,180,0,160,470,630,192,807,999,1629,69,550,NY - Binghamton
44,1994-1995,1994-11-23,1995-04-09,138,0,81,320,401,89,156,245,646,51,301,NY - Binghamton
45,1995-1996,1995-11-09,1996-05-12,186,15,170,475,645,193,440,633,1278,75,523,NY - Binghamton
46,1996-1997,1996-11-02,1997-04-19,169,0,89,359,448,141,179,320,768,71,390,NY - Binghamton
47,1997-1998,1997-11-12,1998-03-26,135,3,62,244,306,142,257,399,705,57,309,NY - Binghamton
48,1998-1999,1998-11-21,1999-04-12,143,0,75,313,388,117,168,285,673,52,337,NY - Binghamton
49,1999-2000,1999-11-04,2000-04-11,160,0,95,323,418,127,277,404,822,56,388,NY - Binghamton
50,2000-2001,2000-10-09,2001-04-04,178,0,120,388,508,173,394,567,1075,80,495,NY - Binghamton
51,2001-2002,2001-10-27,2002-05-18,204,0,37,261,298,98,98,196,494,50,236,NY - Binghamton
52,2002-2003,2002-11-01,2003-04-10,161,0,159,439,598,181,555,736,1334,76,510,NY - Binghamton
53,2003-2004,2003-10-02,2004-04-05,187,0,136,395,531,160,396,556,1087,71,496,NY - Binghamton
54,2004-2005,2004-11-08,2005-04-04,148,0,112,373,485,146,342,488,973,58,417,NY - Binghamton
55,2005-2006,2005-10-25,2006-04-05,163,0,95,322,417,118,178,296,713,64,360,NY - Binghamton
56,2006-2007,2006-12-01,2007-04-19,140,0,105,320,425,116,242,358,783,54,366,NY - Binghamton
57,2007-2008,2007-11-09,2008-04-04,148,0,77,315,392,114,210,324,716,62,305,NY - Binghamton
58,2008-2009,2008-10-28,2009-04-08,163,0,119,396,515,120,310,430,945,71,433,NY - Binghamton
59,2009-2010,2009-10-15,2010-05-09,207,0,94,295,389,128,372,500,889,65,383,NY - Binghamton
60,2010-2011,2010-11-25,2011-04-06,133,3,129,369,498,177,454,631,1129,74,473,NY - Binghamton
61,2011-2012,2011-10-27,2012-04-27,184,0,34,228,262,70,59,129,391,44,186,NY - Binghamton
62,2012-2013,2012-11-04,2013-04-03,151,0,88,294,382,122,279,401,783,74,376,NY - Binghamton
63,2013-2014,2013-11-11,2014-04-16,157,0,166,469,635,142,345,487,1122,68,466,NY - Binghamton
64,2014-2015,2014-11-07,2015-04-24,169,0,156,474,630,149,552,701,1331,75,501,NY - Binghamton
65,2015-2016,2015-10-17,2016-04-12,179,0,64,275,339,59,62,121,460,43,224,NY - Binghamton
66,2016-2017,2016-10-27,2017-04-07,163,0,84,295,379,203,332,535,914,64,439,NY - Binghamton
67,2017-2018,2017-11-10,2018-04-20,162,2,120,382,502,144,306,450,952,63,448,NY - Binghamton
68,2018-2019,2018-10-18,2019-04-05,170,0,104,376,480,143,303,446,926,76,425,NY - Binghamton
69,2019-2020,2019-11-07,2020-05-12,188,0,61,304,365,126,264,390,755,65,312,NY - Binghamton
0,1950-1951,1950-11-03,1951-03-26,144,3,82,265,347,113,152,265,612,57,305,NY - Buffalo
1,1951-1952,1951-11-02,1952-04-11,162,0,65,291,356,127,147,274,630,59,311,NY - Buffalo
2,1952-1953,1952-10-19,1953-04-20,184,0,37,205,242,92,91,183,425,44,204,NY - Buffalo
3,1953-1954,1953-11-07,1954-04-05,150,0,65,253,318,129,125,254,572,55,315,NY - Buffalo
4,1954-1955,1954-10-31,1955-04-07,159,0,77,264,341,132,146,278,619,65,360,NY - Buffalo
5,1955-1956,1955-11-17,1956-04-23,159,0,80,318,398,167,167,334,732,74,417,NY - Buffalo
6,1956-1957,1956-11-23,1957-04-13,142,0,67,267,334,164,243,407,741,58,366,NY - Buffalo
7,1957-1958,1957-11-09,1958-04-08,151,0,88,278,366,180,293,473,839,64,398,NY - Buffalo
8,1958-1959,1958-11-24,1959-04-04,132,0,118,397,515,167,206,373,888,66,463,NY - Buffalo
9,1959-1960,1959-11-12,1960-04-09,150,1,90,311,401,168,337,505,906,64,368,NY - Buffalo
10,1960-1961,1960-10-24,1961-04-18,177,0,136,391,527,156,402,558,1085,65,455,NY - Buffalo
11,1961-1962,1961-11-08,1962-04-15,159,3,103,362,465,153,258,411,876,68,452,NY - Buffalo
12,1962-1963,1962-10-26,1963-05-01,188,0,134,426,560,145,608,753,1313,74,498,NY - Buffalo
13,1963-1964,1963-11-24,1964-04-09,138,0,87,303,390,121,341,462,852,69,346,NY - Buffalo
14,1964-1965,1964-11-19,1965-04-19,152,0,102,327,429,111,222,333,762,66,386,NY - Buffalo
15,1965-1966,1965-10-28,1966-05-09,194,0,93,314,407,159,299,458,865,74,415,NY - Buffalo
16,1966-1967,1966-11-03,1967-05-07,186,0,102,343,445,113,184,297,742,77,422,NY - Buffalo
17,1967-1968,1967-11-05,1968-04-25,173,0,119,345,464,121,280,401,865,66,398,NY - Buffalo
18,1968-1969,1968-11-12,1969-04-19,159,0,99,325,424,126,193,319,743,72,400,NY - Buffalo
19,1969-1970,1969-10-22,1970-04-10,171,0,118,400,518,181,396,577,1095,91,555,NY - Buffalo
20,1970-1971,1970-11-15,1971-04-25,162,0,103,343,446,152,258,410,856,78,435,NY - Buffalo
21,1971-1972,1971-11-04,1972-04-09,158,0,84,358,442,164,255,419,861,81,455,NY - Buffalo
22,1972-1973,1972-10-15,1973-05-05,203,3,73,288,361,128,199,327,688,65,326,NY - Buffalo
23,1973-1974,1973-11-05,1974-05-07,184,0,94,318,412,142,249,391,803,78,413,NY - Buffalo
24,1974-1975,1974-11-13,1975-04-13,152,0,57,248,305,144,216,360,665,68,299,NY - Buffalo
25,1975-1976,1975-11-13,1976-04-27,167,0,90,314,404,129,316,445,849,69,362,NY - Buffalo
26,1976-1977,1976-10-21,1977-05-08,200,0,156,422,578,288,811,1099,1677,99,775,NY - Buffalo
27,1977-1978,1977-11-11,1978-05-01,172,0,149,411,560,220,629,849,1409,80,594,NY - Buffalo
28,1978-1979,1978-11-20,1979-04-12,144,0,147,371,518,147,463,610,1128,66,484,NY - Buffalo
29,1979-1980,1979-11-15,1980-04-16,154,0,94,291,385,110,176,286,671,53,330,NY - Buffalo
30,1980-1981,1980-11-17,1981-03-27,131,0,105,330,435,101,276,377,812,66,382,NY - Buffalo
31,1981-1982,1981-11-06,1982-04-12,158,0,123,376,499,168,410,578,1077,67,447,NY - Buffalo
32,1982-1983,1982-11-05,1983-04-25,172,0,54,250,304,87,117,204,508,41,194,NY - Buffalo
33,1983-1984,1983-11-03,1984-04-07,157,0,130,358,488,192,521,713,1201,71,467,NY - Buffalo
34,1984-1985,1984-11-12,1985-04-09,149,0,86,293,379,155,362,517,896,59,378,NY - Buffalo
35,1985-1986,1985-11-22,1986-04-22,152,0,98,300,398,179,343,522,920,76,470,NY - Buffalo
36,1986-1987,1986-11-11,1987-04-04,145,0,53,264,317,105,180,285,602,50,242,NY - Buffalo
37,1987-1988,1987-11-05,1988-04-19,167,0,77,290,367,92,109,201,568,51,267,NY - Buffalo
38,1988-1989,1988-10-25,1989-05-07,195,0,82,298,380,111,115,226,606,58,310,NY - Buffalo
39,1989-1990,1989-11-03,1990-04-12,161,0,88,315,403,149,230,379,782,68,390,NY - Buffalo
40,1990-1991,1990-11-11,1991-04-02,143,0,44,223,267,97,110,207,474,57,262,NY - Buffalo
41,1991-1992,1991-10-06,1992-04-04,182,0,62,305,367,149,168,317,684,64,364,NY - Buffalo
42,1992-1993,1992-10-20,1993-04-17,180,0,61,316,377,146,290,436,813,62,325,NY - Buffalo
43,1993-1994,1993-10-30,1994-04-07,160,0,120,386,506,161,391,552,1058,60,425,NY - Buffalo
44,1994-1995,1994-11-23,1995-04-10,139,0,66,281,347,112,182,294,641,44,275,NY - Buffalo
45,1995-1996,1995-11-04,1996-04-17,166,0,141,394,535,220,406,626,1161,84,552,NY - Buffalo
46,1996-1997,1996-11-09,1997-04-19,162,0,67,296,363,156,167,323,686,74,394,NY - Buffalo
47,1997-1998,1997-10-22,1998-03-26,156,0,42,186,228,123,192,315,543,54,246,NY - Buffalo
48,1998-1999,1998-11-11,1999-04-12,153,0,77,261,338,145,273,418,756,43,314,NY - Buffalo
49,1999-2000,1999-11-03,2000-04-12,162,0,75,256,331,104,208,312,643,54,294,NY - Buffalo
50,2000-2001,2000-11-14,2001-04-17,155,0,91,299,390,239,440,679,1069,88,519,NY - Buffalo
51,2001-2002,2001-10-25,2002-04-06,164,0,38,184,222,186,309,495,717,45,292,NY - Buffalo
52,2002-2003,2002-11-01,2003-04-09,160,0,127,372,499,168,375,543,1042,69,448,NY - Buffalo
53,2003-2004,2003-11-13,2004-04-27,167,0,98,311,409,156,360,516,925,65,411,NY - Buffalo
54,2004-2005,2004-11-08,2005-04-24,168,0,97,347,444,157,308,465,909,62,407,NY - Buffalo
55,2005-2006,2005-11-16,2006-04-04,140,0,59,232,291,117,156,273,564,58,292,NY - Buffalo
56,2006-2007,2006-10-12,2007-04-15,186,1,94,277,371,140,164,304,675,60,376,NY - Buffalo
57,2007-2008,2007-11-06,2008-03-29,145,0,64,272,336,157,221,378,714,66,351,NY - Buffalo
58,2008-2009,2008-10-29,2009-04-08,162,0,102,333,435,152,242,394,829,69,427,NY - Buffalo
59,2009-2010,2009-12-01,2010-03-26,116,0,82,243,325,117,316,433,758,50,302,NY - Buffalo
60,2010-2011,2010-11-26,2011-04-18,144,0,104,322,426,161,411,572,998,66,403,NY - Buffalo
61,2011-2012,2011-12-01,2012-04-24,146,0,22,162,184,62,53,115,299,36,152,NY - Buffalo
62,2012-2013,2012-11-25,2013-04-02,129,0,59,210,269,103,137,240,509,58,269,NY - Buffalo
63,2013-2014,2013-11-11,2014-04-15,156,0,148,419,567,191,304,495,1062,73,572,NY - Buffalo
64,2014-2015,2014-11-13,2015-04-04,143,0,143,410,553,172,526,698,1251,68,519,NY - Buffalo
65,2015-2016,2015-12-01,2016-04-10,132,0,48,205,253,80,97,177,430,35,201,NY - Buffalo
66,2016-2017,2016-11-20,2017-04-08,140,0,54,200,254,109,144,253,507,41,232,NY - Buffalo
67,2017-2018,2017-10-31,2018-04-19,171,0,105,319,424,159,312,471,895,65,435,NY - Buffalo
68,2018-2019,2018-11-09,2019-04-27,170,0,84,315,399,176,230,406,805,61,391,NY - Buffalo
69,2019-2020,2019-11-07,2020-05-09,185,0,33,202,235,104,138,242,477,51,208,NY - Buffalo
0,1950-1951,1950-11-22,1951-04-04,134,0,67,358,425,86,246,332,757,46,265,NY - Cooperstown
1,1951-1952,1951-11-01,1952-03-23,144,0,68,401,469,108,398,506,975,53,302,NY - Cooperstown
3,1953-1954,1953-11-06,1954-04-04,150,0,61,388,449,77,208,285,734,43,271,NY - Cooperstown
4,1954-1955,1954-11-02,1955-04-04,154,0,87,446,533,96,298,394,927,49,266,NY - Cooperstown
5,1955-1956,1955-10-27,1956-05-17,204,0,95,535,630,191,789,980,1610,68,451,NY - Cooperstown
6,1956-1957,1956-11-10,1957-04-14,156,2,65,450,515,123,281,404,919,56,362,NY - Cooperstown
7,1957-1958,1957-10-27,1958-04-12,168,0,80,426,506,125,642,767,1273,52,329,NY - Cooperstown
8,1958-1959,1958-10-27,1959-03-31,156,0,108,534,642,107,386,493,1135,48,336,NY - Cooperstown
9,1959-1960,1959-11-03,1960-04-09,159,1,76,468,544,117,577,694,1238,46,279,NY - Cooperstown
10,1960-1961,1960-10-25,1961-04-17,175,2,105,533,638,110,512,622,1260,38,286,NY - Cooperstown
11,1961-1962,1961-11-09,1962-04-15,158,0,81,464,545,89,362,451,996,35,214,NY - Cooperstown
14,1964-1965,1964-10-11,1965-04-19,191,5,82,496,578,101,297,398,976,41,273,NY - Cooperstown
16,1966-1967,1966-11-30,1967-05-08,160,0,80,436,516,108,442,550,1066,49,309,NY - Cooperstown
17,1967-1968,1967-11-10,1968-03-25,137,0,112,509,621,86,371,457,1078,38,272,NY - Cooperstown
18,1968-1969,1968-11-13,1969-03-31,139,0,103,461,564,101,585,686,1250,40,270,NY - Cooperstown
19,1969-1970,1969-10-23,1970-04-11,171,0,126,584,710,158,884,1042,1752,56,425,NY - Cooperstown
20,1970-1971,1970-11-17,1971-05-05,170,0,109,519,628,200,857,1057,1685,65,471,NY - Cooperstown
21,1971-1972,1971-11-08,1972-04-12,157,0,75,475,550,156,488,644,1194,63,404,NY - Cooperstown
22,1972-1973,1972-11-14,1973-05-19,187,0,66,396,462,113,299,412,874,47,284,NY - Cooperstown
23,1973-1974,1973-11-06,1974-04-12,158,1,78,438,516,108,303,411,927,41,273,NY - Cooperstown
24,1974-1975,1974-10-04,1975-04-12,191,0,61,433,494,116,374,490,984,56,304,NY - Cooperstown
25,1975-1976,1975-11-14,1976-05-20,189,0,92,481,573,136,502,638,1211,56,414,NY - Cooperstown
26,1976-1977,1976-11-06,1977-05-10,186,0,129,555,684,174,633,807,1491,65,506,NY - Cooperstown
27,1977-1978,1977-10-16,1978-04-16,183,0,116,530,646,191,840,1031,1677,75,570,NY - Cooperstown
28,1978-1979,1978-11-21,1979-04-12,143,0,127,491,618,148,654,802,1420,65,437,NY - Cooperstown
29,1979-1980,1979-11-15,1980-04-05,143,0,92,415,507,87,315,402,909,44,280,NY - Cooperstown
30,1980-1981,1980-11-02,1981-04-21,171,0,110,537,647,101,411,512,1159,53,383,NY - Cooperstown
31,1981-1982,1981-10-25,1982-04-12,170,0,108,519,627,123,632,755,1382,62,372,NY - Cooperstown
32,1982-1983,1982-11-27,1983-04-27,152,0,52,370,422,139,328,467,889,35,253,NY - Cooperstown
33,1983-1984,1983-11-12,1984-04-05,146,1,99,447,546,108,403,511,1057,49,324,NY - Cooperstown
34,1984-1985,1984-11-13,1985-04-10,149,0,87,413,500,101,336,437,937,47,328,NY - Cooperstown
35,1985-1986,1985-11-17,1986-04-24,159,1,86,432,518,123,617,740,1258,48,338,NY - Cooperstown
36,1986-1987,1986-11-06,1987-04-28,174,2,58,469,527,135,621,756,1283,42,263,NY - Cooperstown
37,1987-1988,1987-10-04,1988-04-20,200,3,76,455,531,103,343,446,977,48,296,NY - Cooperstown
38,1988-1989,1988-10-13,1989-04-11,181,6,64,457,521,60,116,176,697,40,231,NY - Cooperstown
39,1989-1990,1989-11-13,1990-04-19,158,0,94,465,559,143,364,507,1066,65,419,NY - Cooperstown
40,1990-1991,1990-11-08,1991-04-02,146,1,58,357,415,87,215,302,717,46,281,NY - Cooperstown
41,1991-1992,1991-11-12,1992-04-17,158,4,68,451,519,90,232,322,841,53,361,NY - Cooperstown
42,1992-1993,1992-10-21,1993-04-24,186,0,89,513,602,176,649,825,1427,57,436,NY - Cooperstown
43,1993-1994,1993-10-31,1994-04-18,170,1,155,593,748,189,836,1025,1773,59,518,NY - Cooperstown
44,1994-1995,1994-11-23,1995-04-10,139,1,70,401,471,79,237,316,787,35,243,NY - Cooperstown
45,1995-1996,1995-11-09,1996-05-13,187,5,134,522,656,169,495,664,1320,57,413,NY - Cooperstown
46,1996-1997,1996-11-03,1997-05-02,181,1,68,409,477,160,362,522,999,70,410,NY - Cooperstown
47,1997-1998,1997-11-14,1998-03-25,132,0,48,307,355,117,382,499,854,42,236,NY - Cooperstown
48,1998-1999,1998-12-01,1999-03-26,116,0,69,358,427,86,277,363,790,31,228,NY - Cooperstown
49,1999-2000,1999-11-16,2000-04-14,151,8,94,405,499,110,409,519,1018,31,258,NY - Cooperstown
50,2000-2001,2000-11-18,2001-04-12,146,4,87,464,551,146,720,866,1417,57,395,NY - Cooperstown
51,2001-2002,2001-11-20,2002-05-19,181,2,33,320,353,79,188,267,620,34,168,NY - Cooperstown
52,2002-2003,2002-10-23,2003-04-24,184,10,121,566,687,161,806,967,1654,39,317,NY - Cooperstown
55,2005-2006,2005-10-26,2006-04-04,161,12,66,336,402,85,272,357,759,33,193,NY - Cooperstown
56,2006-2007,2006-11-04,2007-04-18,166,10,76,403,479,140,461,601,1080,38,321,NY - Cooperstown
60,2010-2011,2010-11-08,2011-03-27,140,12,134,395,529,213,543,756,1285,49,464,NY - Cooperstown
61,2011-2012,2011-10-27,2012-03-10,136,13,45,260,305,53,81,134,439,27,150,NY - Cooperstown
62,2012-2013,2012-11-17,2013-04-02,137,3,92,302,394,110,299,409,803,37,268,NY - Cooperstown
64,2014-2015,2014-11-13,2015-04-23,162,1,171,521,692,137,672,809,1501,45,400,NY - Cooperstown
65,2015-2016,2015-11-23,2016-04-07,137,1,62,255,317,40,73,113,430,23,150,NY - Cooperstown
66,2016-2017,2016-11-20,2017-03-30,131,0,89,334,423,165,433,598,1021,36,338,NY - Cooperstown
67,2017-2018,2017-11-08,2018-04-19,163,2,158,442,600,130,410,540,1140,28,253,NY - Cooperstown
68,2018-2019,2018-11-11,2019-04-01,142,6,174,412,586,152,462,614,1200,39,312,NY - Cooperstown
69,2019-2020,2019-11-08,2020-04-26,171,5,109,319,428,97,315,412,840,28,204,NY - Cooperstown
13,1963-1964,1963-12-01,1964-03-13,104,9,27,203,230,56,110,166,396,11,94,NY - Islip
14,1964-1965,1964-12-01,1965-04-02,123,1,35,226,261,58,106,164,425,14,103,NY - Islip
15,1965-1966,1965-12-01,1966-02-28,90,5,16,160,176,24,50,74,250,8,34,NY - Islip
16,1966-1967,1966-12-01,1967-03-27,117,5,32,262,294,78,86,164,458,15,124,NY - Islip
17,1967-1968,1967-11-16,1968-03-14,120,0,63,288,351,34,62,96,447,13,92,NY - Islip
18,1968-1969,1968-12-01,1969-03-30,120,0,33,217,250,63,74,137,387,11,83,NY - Islip
19,1969-1970,1969-12-01,1970-03-30,120,7,43,227,270,42,67,109,379,12,92,NY - Islip
20,1970-1971,1970-12-01,1971-04-07,128,0,32,184,216,29,32,61,277,12,46,NY - Islip
21,1971-1972,1971-12-01,1972-03-12,103,0,18,148,166,24,28,52,218,8,41,NY - Islip
22,1972-1973,1972-12-01,1973-02-28,90,1,19,132,151,7,4,11,162,3,22,NY - Islip
23,1973-1974,1973-12-01,1974-03-30,120,0,23,171,194,50,62,112,306,11,79,NY - Islip
24,1974-1975,1974-11-25,1975-03-11,107,0,8,153,161,21,23,44,205,5,36,NY - Islip
25,1975-1976,1975-12-01,1976-03-11,102,0,31,194,225,43,64,107,332,10,73,NY - Islip
26,1976-1977,1976-11-30,1977-03-18,109,2,61,255,316,41,110,151,467,13,82,NY - Islip
27,1977-1978,1977-11-27,1978-03-19,113,1,58,270,328,95,244,339,667,18,143,NY - Islip
28,1978-1979,1978-11-27,1979-02-28,94,0,60,190,250,43,50,93,343,13,95,NY - Islip
29,1979-1980,1979-12-01,1980-03-14,105,0,23,163,186,14,9,23,209,5,24,NY - Islip
30,1980-1981,1980-12-01,1981-03-17,107,0,35,211,246,31,61,92,338,9,58,NY - Islip
31,1981-1982,1981-12-01,1982-04-09,130,0,29,179,208,51,69,120,328,11,80,NY - Islip
32,1982-1983,1982-12-01,1983-04-20,141,0,21,124,145,46,57,103,248,9,64,NY - Islip
33,1983-1984,1983-12-01,1984-03-30,121,0,42,188,230,40,62,102,332,13,82,NY - Islip
34,1984-1985,1984-12-01,1985-02-28,90,0,31,145,176,38,61,99,275,13,82,NY - Islip
35,1985-1986,1985-12-01,1986-03-21,111,0,25,194,219,27,61,88,307,15,76,NY - Islip
36,1986-1987,1986-12-01,1987-03-21,111,0,20,173,193,35,66,101,294,15,58,NY - Islip
37,1987-1988,1987-11-11,1988-03-21,132,0,27,203,230,29,73,102,332,13,55,NY - Islip
38,1988-1989,1988-12-01,1989-03-09,99,0,23,154,177,29,40,69,246,7,51,NY - Islip
39,1989-1990,1989-11-23,1990-04-07,136,0,34,200,234,30,24,54,288,10,57,NY - Islip
40,1990-1991,1990-12-01,1991-03-15,105,0,10,133,143,18,10,28,171,6,26,NY - Islip
41,1991-1992,1991-12-01,1992-03-23,114,0,14,170,184,21,15,36,220,9,45,NY - Islip
42,1992-1993,1992-12-01,1993-03-18,108,0,12,176,188,40,23,63,251,10,60,NY - Islip
43,1993-1994,1993-12-01,1994-03-19,109,6,50,224,274,54,113,167,441,14,100,NY - Islip
44,1994-1995,1994-12-01,1995-02-28,90,0,10,109,119,8,20,28,147,2,16,NY - Islip
45,1995-1996,1995-11-29,1996-04-11,135,6,37,218,255,107,204,311,566,24,172,NY - Islip
46,1996-1997,1996-11-28,1997-04-01,125,2,15,161,176,20,17,37,213,9,36,NY - Islip
47,1997-1998,1997-12-01,1998-03-22,112,0,2,89,91,4,0,4,95,2,6,NY - Islip
48,1998-1999,1998-12-01,1999-03-17,107,0,14,147,161,28,24,52,213,10,48,NY - Islip
54,2004-2005,2004-12-01,2005-03-24,114,0,37,208,245,83,210,293,538,27,170,NY - Islip
55,2005-2006,2005-11-24,2006-04-05,133,0,13,153,166,48,61,109,275,10,64,NY - Islip
56,2006-2007,2006-12-01,2007-03-20,110,0,24,170,194,16,12,28,222,11,39,NY - Islip
57,2007-2008,2007-12-01,2008-02-29,91,0,8,133,141,19,10,29,170,11,43,NY - Islip
58,2008-2009,2008-11-22,2009-03-20,119,0,26,196,222,51,75,126,348,17,89,NY - Islip
59,2009-2010,2009-12-01,2010-03-05,95,0,22,139,161,76,136,212,373,17,106,NY - Islip
60,2010-2011,2010-12-01,2011-03-24,114,0,25,197,222,76,230,306,528,19,114,NY - Islip
61,2011-2012,2011-10-29,2012-02-29,124,0,5,103,108,8,8,16,124,5,16,NY - Islip
62,2012-2013,2012-11-07,2013-03-21,135,0,20,137,157,69,105,174,331,23,107,NY - Islip
63,2013-2014,2013-11-12,2014-04-16,156,0,42,240,282,91,165,256,538,24,154,NY - Islip
64,2014-2015,2014-12-01,2015-03-29,119,0,39,245,284,88,294,382,666,22,157,NY - Islip
65,2015-2016,2015-12-01,2016-04-03,125,0,14,111,125,51,94,145,270,10,68,NY - Islip
66,2016-2017,2016-12-01,2017-03-15,105,0,14,125,139,54,76,130,269,11,78,NY - Islip
67,2017-2018,2017-12-01,2018-04-02,123,0,35,164,199,91,107,198,397,18,125,NY - Islip
68,2018-2019,2018-11-15,2019-03-10,116,0,18,158,176,21,5,26,202,11,35,NY - Islip
69,2019-2020,2019-11-12,2020-02-29,110,0,5,100,105,13,4,17,122,9,25,NY - Islip
0,1950-1951,1950-11-11,1951-03-26,136,4,71,333,404,135,301,436,840,55,339,NY - Ithaca
3,1953-1954,1953-11-07,1954-04-17,162,1,58,325,383,95,140,235,618,50,293,NY - Ithaca
4,1954-1955,1954-11-02,1955-04-07,157,1,74,365,439,114,269,383,822,56,309,NY - Ithaca
6,1956-1957,1956-11-11,1957-04-14,155,8,75,342,417,96,218,314,731,48,271,NY - Ithaca
7,1957-1958,1957-10-27,1958-04-09,165,2,90,376,466,170,643,813,1279,59,414,NY - Ithaca
8,1958-1959,1958-11-25,1959-03-31,127,3,117,478,595,115,329,444,1039,45,352,NY - Ithaca
9,1959-1960,1959-11-19,1960-04-10,144,3,91,374,465,135,427,562,1027,57,352,NY - Ithaca
10,1960-1961,1960-10-25,1961-04-15,173,1,116,494,610,149,485,634,1244,51,365,NY - Ithaca
11,1961-1962,1961-11-09,1962-04-16,159,0,92,380,472,89,175,264,736,49,268,NY - Ithaca
12,1962-1963,1962-10-27,1963-05-02,188,3,123,502,625,101,439,540,1165,49,341,NY - Ithaca
13,1963-1964,1963-11-03,1964-04-05,155,0,80,389,469,116,393,509,978,59,358,NY - Ithaca
14,1964-1965,1964-10-23,1965-04-19,179,0,84,438,522,98,230,328,850,52,330,NY - Ithaca
15,1965-1966,1965-10-29,1966-05-10,194,0,80,384,464,130,263,393,857,67,406,NY - Ithaca
16,1966-1967,1966-12-01,1967-05-08,159,3,91,373,464,106,211,317,781,62,375,NY - Ithaca
17,1967-1968,1967-11-08,1968-03-25,139,0,112,438,550,77,231,308,858,43,313,NY - Ithaca
18,1968-1969,1968-11-13,1969-04-01,140,0,81,371,452,96,158,254,706,57,313,NY - Ithaca
19,1969-1970,1969-10-23,1970-04-11,171,0,131,515,646,173,615,788,1434,83,585,NY - Ithaca
20,1970-1971,1970-10-17,1971-04-25,191,0,110,447,557,151,503,654,1211,60,436,NY - Ithaca
21,1971-1972,1971-11-07,1972-04-10,156,0,88,449,537,144,344,488,1025,62,424,NY - Ithaca
22,1972-1973,1972-10-19,1973-05-18,212,0,77,377,454,75,158,233,687,41,233,NY - Ithaca
23,1973-1974,1973-11-10,1974-04-11,153,0,94,380,474,118,225,343,817,36,283,NY - Ithaca
24,1974-1975,1974-10-21,1975-04-10,172,3,68,339,407,89,209,298,705,45,225,NY - Ithaca
25,1975-1976,1975-10-31,1976-04-26,179,0,100,411,511,124,335,459,970,49,352,NY - Ithaca
26,1976-1977,1976-11-08,1977-05-10,184,0,150,490,640,132,425,557,1197,60,428,NY - Ithaca
27,1977-1978,1977-11-13,1978-03-26,134,0,131,451,582,180,661,841,1423,52,455,NY - Ithaca
28,1978-1979,1978-11-21,1979-04-10,141,1,150,417,567,112,357,469,1036,46,343,NY - Ithaca
29,1979-1980,1979-11-16,1980-04-17,154,0,106,360,466,62,104,166,632,30,207,NY - Ithaca
30,1980-1981,1980-10-14,1981-03-21,159,0,113,453,566,90,292,382,948,50,334,NY - Ithaca
32,1982-1983,1982-11-27,1983-04-25,150,9,59,322,381,72,158,230,611,29,175,NY - Ithaca
33,1983-1984,1983-11-05,1984-04-04,152,0,119,433,552,114,254,368,920,46,328,NY - Ithaca
34,1984-1985,1984-11-13,1985-04-10,149,2,88,361,449,86,212,298,747,42,266,NY - Ithaca
35,1985-1986,1985-11-26,1986-04-12,138,0,96,347,443,106,304,410,853,51,309,NY - Ithaca
36,1986-1987,1986-11-11,1987-04-01,142,2,79,413,492,97,411,508,1000,37,227,NY - Ithaca
37,1987-1988,1987-11-06,1988-04-20,167,0,81,391,472,105,244,349,821,49,310,NY - Ithaca
39,1989-1990,1989-11-04,1990-04-12,160,0,99,385,484,112,196,308,792,53,327,NY - Ithaca
40,1990-1991,1990-10-29,1991-04-22,176,0,55,308,363,86,128,214,577,49,273,NY - Ithaca
41,1991-1992,1991-11-08,1992-04-03,148,1,75,357,432,85,135,220,652,53,310,NY - Ithaca
42,1992-1993,1992-11-06,1993-04-23,169,6,83,437,520,118,432,550,1070,40,241,NY - Ithaca
43,1993-1994,1993-10-31,1994-04-08,160,2,151,509,660,165,763,928,1588,46,392,NY - Ithaca
44,1994-1995,1994-11-23,1995-04-10,139,4,70,342,412,63,134,197,609,28,174,NY - Ithaca
45,1995-1996,1995-11-12,1996-04-09,150,0,142,470,612,150,387,537,1149,59,419,NY - Ithaca
46,1996-1997,1996-11-03,1997-04-10,159,3,66,329,395,83,106,189,584,44,245,NY - Ithaca
47,1997-1998,1997-11-14,1998-03-25,132,0,43,256,299,115,301,416,715,31,193,NY - Ithaca
48,1998-1999,1998-12-01,1999-03-24,114,0,67,331,398,87,224,311,709,35,253,NY - Ithaca
49,1999-2000,1999-11-16,2000-04-11,148,0,79,334,413,99,222,321,734,37,293,NY - Ithaca
50,2000-2001,2000-11-23,2001-03-30,128,2,85,378,463,124,395,519,982,49,336,NY - Ithaca
51,2001-2002,2001-12-01,2002-04-06,127,0,27,230,257,44,43,87,344,26,126,NY - Ithaca
52,2002-2003,2002-11-02,2003-04-23,173,0,123,466,589,144,455,599,1188,59,465,NY - Ithaca
53,2003-2004,2003-11-08,2004-04-06,151,3,116,404,520,112,405,517,1037,49,363,NY - Ithaca
54,2004-2005,2004-11-09,2005-03-25,137,3,92,400,492,115,406,521,1013,47,326,NY - Ithaca
55,2005-2006,2005-11-19,2006-03-25,127,0,75,297,372,78,191,269,641,51,278,NY - Ithaca
56,2006-2007,2006-11-20,2007-04-19,151,0,102,369,471,106,325,431,902,40,290,NY - Ithaca
57,2007-2008,2007-11-16,2008-03-31,137,0,60,334,394,86,202,288,682,43,225,NY - Ithaca
58,2008-2009,2008-10-30,2009-04-08,161,3,105,430,535,84,286,370,905,39,255,NY - Ithaca
59,2009-2010,2009-10-16,2010-03-27,163,0,90,330,420,123,355,478,898,45,305,NY - Ithaca
60,2010-2011,2010-12-01,2011-03-28,118,0,107,380,487,128,425,553,1040,49,349,NY - Ithaca
61,2011-2012,2011-12-01,2012-04-23,145,0,28,228,256,41,47,88,344,20,123,NY - Ithaca
62,2012-2013,2012-12-01,2013-03-28,118,0,65,265,330,78,185,263,593,39,230,NY - Ithaca
63,2013-2014,2013-11-12,2014-04-16,156,0,146,518,664,97,295,392,1056,49,359,NY - Ithaca
64,2014-2015,2014-11-14,2015-04-06,144,0,158,530,688,103,468,571,1259,50,365,NY - Ithaca
65,2015-2016,2015-11-23,2016-04-06,136,0,63,272,335,41,70,111,446,27,166,NY - Ithaca
66,2016-2017,2016-10-27,2017-04-07,163,0,70,307,377,100,167,267,644,49,291,NY - Ithaca
67,2017-2018,2017-11-10,2018-04-20,162,0,114,418,532,99,209,308,840,53,338,NY - Ithaca
68,2018-2019,2018-11-11,2019-04-01,142,0,88,391,479,92,204,296,775,49,292,NY - Ithaca
69,2019-2020,2019-11-08,2020-05-09,184,0,61,332,393,89,220,309,702,43,215,NY - Ithaca
0,1950-1951,1950-11-23,1951-04-03,132,1,56,255,311,93,257,350,661,32,192,NY - Mohonk Lake
1,1951-1952,1951-11-01,1952-03-24,145,1,54,279,333,92,337,429,762,30,178,NY - Mohonk Lake
2,1952-1953,1952-10-28,1953-03-10,134,1,32,209,241,46,132,178,419,21,97,NY - Mohonk Lake
3,1953-1954,1953-11-06,1954-03-06,121,13,51,225,276,60,182,242,518,20,128,NY - Mohonk Lake
4,1954-1955,1954-11-24,1955-04-03,131,0,66,281,347,48,100,148,495,21,105,NY - Mohonk Lake
5,1955-1956,1955-11-11,1956-04-26,168,3,73,346,419,138,412,550,969,38,248,NY - Mohonk Lake
6,1956-1957,1956-11-18,1957-04-09,143,0,53,288,341,84,169,253,594,33,168,NY - Mohonk Lake
7,1957-1958,1957-12-01,1958-04-12,133,2,66,272,338,139,610,749,1087,25,199,NY - Mohonk Lake
8,1958-1959,1958-10-26,1959-03-30,156,6,88,383,471,79,232,311,782,29,174,NY - Mohonk Lake
9,1959-1960,1959-11-18,1960-04-08,143,3,67,301,368,89,522,611,979,28,176,NY - Mohonk Lake
10,1960-1961,1960-12-01,1961-04-18,139,0,98,368,466,140,719,859,1325,29,247,NY - Mohonk Lake
11,1961-1962,1961-11-20,1962-04-15,147,0,81,330,411,99,570,669,1080,33,201,NY - Mohonk Lake
12,1962-1963,1962-10-26,1963-03-28,154,0,100,392,492,116,769,885,1377,36,243,NY - Mohonk Lake
13,1963-1964,1963-11-30,1964-03-29,121,0,78,288,366,108,585,693,1059,31,218,NY - Mohonk Lake
14,1964-1965,1964-12-01,1965-04-28,149,1,104,404,508,92,622,714,1222,41,244,NY - Mohonk Lake
15,1965-1966,1965-11-02,1966-04-08,158,0,56,290,346,95,388,483,829,28,175,NY - Mohonk Lake
16,1966-1967,1966-11-30,1967-05-06,158,0,74,319,393,170,561,731,1124,40,326,NY - Mohonk Lake
17,1967-1968,1967-11-09,1968-03-16,129,0,98,358,456,63,431,494,950,29,171,NY - Mohonk Lake
18,1968-1969,1968-11-10,1969-03-31,142,0,81,329,410,110,613,723,1133,31,204,NY - Mohonk Lake
19,1969-1970,1969-11-15,1970-04-06,143,3,105,386,491,123,792,915,1406,37,283,NY - Mohonk Lake
20,1970-1971,1970-11-24,1971-04-25,153,0,103,349,452,138,1031,1169,1621,36,241,NY - Mohonk Lake
21,1971-1972,1971-11-10,1972-04-11,154,0,68,348,416,130,391,521,937,45,272,NY - Mohonk Lake
22,1972-1973,1972-10-19,1973-04-11,175,0,54,286,340,66,188,254,594,25,133,NY - Mohonk Lake
23,1973-1974,1973-12-01,1974-04-11,132,0,71,290,361,70,236,306,667,31,185,NY - Mohonk Lake
24,1974-1975,1974-11-22,1975-04-04,134,0,39,247,286,83,431,514,800,32,169,NY - Mohonk Lake
25,1975-1976,1975-11-26,1976-03-19,115,1,87,297,384,83,401,484,868,31,212,NY - Mohonk Lake
26,1976-1977,1976-11-05,1977-05-10,187,0,108,386,494,135,516,651,1145,39,259,NY - Mohonk Lake
27,1977-1978,1977-11-23,1978-05-05,164,0,113,384,497,125,937,1062,1559,40,287,NY - Mohonk Lake
28,1978-1979,1978-11-21,1979-04-14,145,0,104,367,471,90,462,552,1023,36,228,NY - Mohonk Lake
29,1979-1980,1979-10-10,1980-04-01,175,3,66,306,372,56,116,172,544,19,117,NY - Mohonk Lake
30,1980-1981,1980-11-17,1981-03-27,131,3,93,359,452,62,258,320,772,28,192,NY - Mohonk Lake
31,1981-1982,1981-11-25,1982-04-13,140,17,105,380,485,137,790,927,1412,42,304,NY - Mohonk Lake
32,1982-1983,1982-11-26,1983-04-21,147,0,49,254,303,110,315,425,728,24,173,NY - Mohonk Lake
33,1983-1984,1983-11-25,1984-04-05,133,4,86,321,407,116,397,513,920,36,242,NY - Mohonk Lake
34,1984-1985,1984-11-20,1985-04-08,140,8,66,279,345,56,230,286,631,24,134,NY - Mohonk Lake
35,1985-1986,1985-11-16,1986-04-23,159,1,75,326,401,88,467,555,956,30,195,NY - Mohonk Lake
36,1986-1987,1986-11-05,1987-04-28,175,10,56,298,354,96,642,738,1092,25,159,NY - Mohonk Lake
37,1987-1988,1987-10-04,1988-04-15,195,6,57,286,343,113,593,706,1049,25,171,NY - Mohonk Lake
38,1988-1989,1988-12-01,1989-03-24,114,1,47,281,328,23,22,45,373,11,57,NY - Mohonk Lake
39,1989-1990,1989-11-22,1990-03-31,130,0,74,324,398,89,272,361,759,18,155,NY - Mohonk Lake
40,1990-1991,1990-12-01,1991-03-30,120,1,29,217,246,55,147,202,448,19,108,NY - Mohonk Lake
41,1991-1992,1991-11-12,1992-03-26,136,1,51,257,308,44,74,118,426,22,117,NY - Mohonk Lake
42,1992-1993,1992-11-17,1993-04-09,144,0,65,312,377,126,624,750,1127,30,210,NY - Mohonk Lake
43,1993-1994,1993-12-01,1994-04-06,127,0,119,375,494,117,857,974,1468,36,285,NY - Mohonk Lake
44,1994-1995,1994-11-24,1995-04-08,136,0,49,247,296,46,188,234,530,18,99,NY - Mohonk Lake
45,1995-1996,1995-11-13,1996-04-10,150,2,106,369,475,173,676,849,1324,44,353,NY - Mohonk Lake
46,1996-1997,1996-11-14,1997-04-18,156,3,43,278,321,97,288,385,706,26,160,NY - Mohonk Lake
47,1997-1998,1997-11-12,1998-03-25,134,1,28,198,226,69,278,347,573,27,120,NY - Mohonk Lake
48,1998-1999,1998-12-01,1999-04-12,133,0,43,227,270,58,251,309,579,24,143,NY - Mohonk Lake
49,1999-2000,1999-12-01,2000-04-09,131,0,57,239,296,56,333,389,685,18,124,NY - Mohonk Lake
50,2000-2001,2000-11-21,2001-04-10,141,1,53,297,350,144,847,991,1341,36,236,NY - Mohonk Lake
51,2001-2002,2001-12-01,2002-05-18,169,1,12,170,182,51,128,179,361,14,80,NY - Mohonk Lake
52,2002-2003,2002-11-02,2003-04-09,159,1,90,350,440,134,813,947,1387,41,263,NY - Mohonk Lake
53,2003-2004,2003-10-23,2004-03-23,153,1,74,311,385,82,362,444,829,27,172,NY - Mohonk Lake
54,2004-2005,2004-11-12,2005-03-31,140,0,68,296,364,115,546,661,1025,33,237,NY - Mohonk Lake
55,2005-2006,2005-11-24,2006-03-20,117,0,35,216,251,72,237,309,560,19,125,NY - Mohonk Lake
56,2006-2007,2006-12-01,2007-04-15,136,0,49,266,315,58,249,307,622,17,109,NY - Mohonk Lake
57,2007-2008,2007-11-10,2008-04-04,147,3,39,262,301,90,468,558,859,30,162,NY - Mohonk Lake
58,2008-2009,2008-11-19,2009-03-08,110,0,66,278,344,69,446,515,859,27,173,NY - Mohonk Lake
59,2009-2010,2009-10-15,2010-03-20,157,1,52,217,269,114,503,617,886,30,173,NY - Mohonk Lake
62,2012-2013,2012-11-08,2013-03-27,140,3,40,229,269,81,287,368,637,25,151,NY - Mohonk Lake
63,2013-2014,2013-11-25,2014-04-16,143,2,86,364,450,101,507,608,1058,33,244,NY - Mohonk Lake
64,2014-2015,2014-11-14,2015-04-02,140,9,82,382,464,92,514,606,1070,35,233,NY - Mohonk Lake
65,2015-2016,2015-12-01,2016-04-05,127,0,32,178,210,23,19,42,252,10,50,NY - Mohonk Lake
66,2016-2017,2016-10-27,2017-03-29,154,0,27,220,247,95,390,485,732,20,132,NY - Mohonk Lake
67,2017-2018,2017-11-11,2018-04-06,147,2,62,283,345,91,284,375,720,25,162,NY - Mohonk Lake
68,2018-2019,2018-11-15,2019-03-17,123,0,41,262,303,58,224,282,585,15,116,NY - Mohonk Lake
69,2019-2020,2019-11-13,2020-03-24,133,2,22,181,203,36,81,117,320,12,63,NY - Mohonk Lake
0,1950-1951,1950-12-01,1951-03-22,112,2,19,105,124,15,14,29,153,10,36,NY - New York (Central Park)
1,1951-1952,1951-12-01,1952-03-19,110,2,14,110,124,31,29,60,184,14,47,NY - New York (Central Park)
2,1952-1953,1952-10-20,1953-03-08,140,0,2,76,78,24,19,43,121,13,39,NY - New York (Central Park)
3,1953-1954,1953-11-06,1954-04-01,147,0,17,112,129,24,52,76,205,12,49,NY - New York (Central Park)
4,1954-1955,1954-12-01,1955-03-26,116,0,21,128,149,18,16,34,183,13,44,NY - New York (Central Park)
5,1955-1956,1955-11-20,1956-04-09,142,0,24,160,184,49,46,95,279,19,84,NY - New York (Central Park)
6,1956-1957,1956-12-01,1957-04-05,126,0,19,119,138,35,29,64,202,18,72,NY - New York (Central Park)
7,1957-1958,1957-12-01,1958-04-11,132,0,30,128,158,64,103,167,325,16,92,NY - New York (Central Park)
8,1958-1959,1958-11-30,1959-04-12,134,0,33,194,227,24,26,50,277,16,55,NY - New York (Central Park)
9,1959-1960,1959-11-29,1960-03-26,119,0,15,130,145,61,72,133,278,22,109,NY - New York (Central Park)
10,1960-1961,1960-12-01,1961-03-13,103,0,42,170,212,75,254,329,541,19,135,NY - New York (Central Park)
11,1961-1962,1961-12-01,1962-03-06,96,0,17,137,154,28,43,71,225,18,50,NY - New York (Central Park)
12,1962-1963,1962-12-01,1963-03-21,111,0,39,191,230,28,41,69,299,16,59,NY - New York (Central Park)
13,1963-1964,1963-12-01,1964-03-22,113,0,21,126,147,67,120,187,334,23,105,NY - New York (Central Park)
14,1964-1965,1964-11-22,1965-04-02,132,0,31,150,181,38,50,88,269,16,75,NY - New York (Central Park)
15,1965-1966,1965-12-01,1966-02-28,90,0,18,106,124,29,65,94,218,11,51,NY - New York (Central Park)
16,1966-1967,1966-12-01,1967-03-25,115,0,29,157,186,73,112,185,371,21,127,NY - New York (Central Park)
17,1967-1968,1967-11-30,1968-03-13,105,0,41,183,224,30,47,77,301,14,69,NY - New York (Central Park)
18,1968-1969,1968-12-01,1969-03-11,101,0,22,131,153,41,123,164,317,10,54,NY - New York (Central Park)
19,1969-1970,1969-12-01,1970-03-30,120,0,39,185,224,39,104,143,367,15,87,NY - New York (Central Park)
20,1970-1971,1970-12-01,1971-04-06,127,0,39,152,191,23,24,47,238,9,39,NY - New York (Central Park)
21,1971-1972,1971-12-01,1972-03-15,106,0,20,131,151,32,33,65,216,11,57,NY - New York (Central Park)
22,1972-1973,1972-11-22,1973-03-18,117,0,19,109,128,4,5,9,137,3,12,NY - New York (Central Park)
23,1973-1974,1973-12-01,1974-04-10,131,0,27,127,154,35,74,109,263,14,72,NY - New York (Central Park)
24,1974-1975,1974-11-25,1975-03-14,110,0,8,81,89,20,24,44,133,8,34,NY - New York (Central Park)
25,1975-1976,1975-12-01,1976-03-16,107,0,28,141,169,27,34,61,230,12,54,NY - New York (Central Park)
26,1976-1977,1976-11-30,1977-03-18,109,0,67,206,273,36,101,137,410,18,90,NY - New York (Central Park)
27,1977-1978,1977-11-27,1978-03-19,113,0,48,181,229,71,209,280,509,16,100,NY - New York (Central Park)
28,1978-1979,1978-11-27,1979-02-28,94,0,43,145,188,42,65,107,295,11,77,NY - New York (Central Park)
29,1979-1980,1979-12-01,1980-03-15,106,0,20,120,140,17,12,29,169,6,28,NY - New York (Central Park)
30,1980-1981,1980-12-01,1981-03-07,97,0,44,168,212,31,54,85,297,11,60,NY - New York (Central Park)
31,1981-1982,1981-12-01,1982-04-10,131,0,34,145,179,36,72,108,287,13,64,NY - New York (Central Park)
32,1982-1983,1982-12-01,1983-04-19,140,0,17,83,100,38,78,116,216,8,54,NY - New York (Central Park)
33,1983-1984,1983-12-01,1984-03-30,121,0,40,145,185,39,77,116,301,20,80,NY - New York (Central Park)
34,1984-1985,1984-12-01,1985-03-04,94,0,24,102,126,34,63,97,223,13,65,NY - New York (Central Park)
35,1985-1986,1985-12-01,1986-03-08,98,3,24,129,153,25,24,49,202,14,62,NY - New York (Central Park)
36,1986-1987,1986-12-01,1987-03-13,103,0,15,115,130,34,81,115,245,11,51,NY - New York (Central Park)
37,1987-1988,1987-11-11,1988-02-29,111,0,26,130,156,27,73,100,256,10,49,NY - New York (Central Park)
38,1988-1989,1988-12-01,1989-03-09,99,0,20,107,127,12,14,26,153,4,22,NY - New York (Central Park)
39,1989-1990,1989-11-22,1990-04-07,137,0,25,149,174,20,26,46,220,10,38,NY - New York (Central Park)
40,1990-1991,1990-12-01,1991-03-30,120,0,8,80,88,36,32,68,156,9,51,NY - New York (Central Park)
41,1991-1992,1991-12-01,1992-03-25,116,0,10,118,128,20,18,38,166,7,35,NY - New York (Central Park)
42,1992-1993,1992-12-01,1993-03-21,111,0,8,133,141,39,40,79,220,15,62,NY - New York (Central Park)
43,1993-1994,1993-12-01,1994-03-20,110,0,46,194,240,75,237,312,552,23,151,NY - New York (Central Park)
44,1994-1995,1994-12-01,1995-02-28,90,0,12,92,104,17,60,77,181,4,30,NY - New York (Central Park)
50,2000-2001,2000-12-01,2001-03-26,116,13,20,123,143,52,89,141,284,14,81,NY - New York (Central Park)
51,2001-2002,2001-12-01,2002-02-28,90,17,3,46,49,5,4,9,58,2,8,NY - New York (Central Park)
53,2003-2004,2003-12-01,2004-03-18,109,0,39,151,190,59,118,177,367,13,98,NY - New York (Central Park)
54,2004-2005,2004-12-01,2005-03-24,114,0,26,134,160,59,149,208,368,20,114,NY - New York (Central Park)
55,2005-2006,2005-12-01,2006-04-05,126,0,11,96,107,58,68,126,233,9,71,NY - New York (Central Park)
56,2006-2007,2006-12-01,2007-03-20,110,0,25,127,152,22,22,44,196,12,50,NY - New York (Central Park)
57,2007-2008,2007-12-01,2008-02-29,91,0,8,85,93,19,18,37,130,7,32,NY - New York (Central Park)
58,2008-2009,2008-11-22,2009-03-05,104,0,29,141,170,41,63,104,274,13,69,NY - New York (Central Park)
59,2009-2010,2009-12-01,2010-03-03,93,0,20,104,124,71,122,193,317,12,90,NY - New York (Central Park)
60,2010-2011,2010-12-01,2011-03-24,114,0,26,132,158,90,300,390,548,15,124,NY - New York (Central Park)
61,2011-2012,2011-10-29,2012-02-29,124,0,6,51,57,10,6,16,73,3,16,NY - New York (Central Park)
62,2012-2013,2012-11-07,2013-03-19,133,0,18,86,104,40,36,76,180,12,65,NY - New York (Central Park)
63,2013-2014,2013-11-24,2014-03-13,110,0,45,174,219,81,268,349,568,19,139,NY - New York (Central Park)
64,2014-2015,2014-11-26,2015-03-21,116,0,36,187,223,70,285,355,578,19,119,NY - New York (Central Park)
65,2015-2016,2015-12-01,2016-03-21,112,0,13,76,89,46,59,105,194,8,61,NY - New York (Central Park)
66,2016-2017,2016-12-01,2017-03-19,109,0,12,81,93,42,56,98,191,9,59,NY - New York (Central Park)
67,2017-2018,2017-12-01,2018-04-02,123,0,36,125,161,58,60,118,279,14,82,NY - New York (Central Park)
68,2018-2019,2018-11-15,2019-03-07,113,0,19,106,125,32,23,55,180,11,46,NY - New York (Central Park)
69,2019-2020,2019-12-01,2020-02-29,91,0,3,54,57,9,2,11,68,6,17,NY - New York (Central Park)
0,1950-1951,1950-11-23,1951-03-22,120,0,20,106,126,22,16,38,164,15,50,NY - New York (Laguardia)
1,1951-1952,1951-12-01,1952-03-19,110,0,13,102,115,25,16,41,156,14,40,NY - New York (Laguardia)
2,1952-1953,1952-11-30,1953-03-08,99,0,2,65,67,23,12,35,102,14,39,NY - New York (Laguardia)
3,1953-1954,1953-11-06,1954-03-04,119,0,17,93,110,26,48,74,184,8,45,NY - New York (Laguardia)
4,1954-1955,1954-12-01,1955-03-26,116,0,18,123,141,19,16,35,176,12,44,NY - New York (Laguardia)
5,1955-1956,1955-11-19,1956-04-09,143,0,21,150,171,47,41,88,259,16,77,NY - New York (Laguardia)
6,1956-1957,1956-12-01,1957-04-05,126,0,19,110,129,32,29,61,190,15,66,NY - New York (Laguardia)
7,1957-1958,1957-12-01,1958-04-11,132,0,30,117,147,71,92,163,310,18,100,NY - New York (Laguardia)
8,1958-1959,1958-11-30,1959-04-12,134,0,33,180,213,28,27,55,268,15,50,NY - New York (Laguardia)
9,1959-1960,1959-11-18,1960-03-23,127,0,16,115,131,51,67,118,249,18,85,NY - New York (Laguardia)
10,1960-1961,1960-12-01,1961-04-13,134,0,42,170,212,74,218,292,504,20,125,NY - New York (Laguardia)
11,1961-1962,1961-11-20,1962-03-06,107,0,25,131,156,27,24,51,207,17,48,NY - New York (Laguardia)
12,1962-1963,1962-10-26,1963-03-21,147,0,45,186,231,30,32,62,293,18,65,NY - New York (Laguardia)
13,1963-1964,1963-12-01,1964-03-22,113,0,27,118,145,53,83,136,281,22,97,NY - New York (Laguardia)
14,1964-1965,1964-11-22,1965-04-02,132,0,34,126,160,34,38,72,232,16,60,NY - New York (Laguardia)
15,1965-1966,1965-12-01,1966-02-28,90,0,21,86,107,29,39,68,175,13,51,NY - New York (Laguardia)
16,1966-1967,1966-12-01,1967-03-25,115,0,26,129,155,66,83,149,304,24,116,NY - New York (Laguardia)
17,1967-1968,1967-11-30,1968-03-13,105,0,39,176,215,23,25,48,263,14,62,NY - New York (Laguardia)
18,1968-1969,1968-12-01,1969-03-11,101,0,27,140,167,47,58,105,272,17,70,NY - New York (Laguardia)
19,1969-1970,1969-12-01,1970-03-31,121,0,36,171,207,39,49,88,295,20,98,NY - New York (Laguardia)
20,1970-1971,1970-12-01,1971-04-06,127,0,32,120,152,26,20,46,198,14,50,NY - New York (Laguardia)
21,1971-1972,1971-12-01,1972-04-07,129,0,28,136,164,36,30,66,230,15,63,NY - New York (Laguardia)
22,1972-1973,1972-11-22,1973-02-28,99,0,20,98,118,4,0,4,122,4,12,NY - New York (Laguardia)
23,1973-1974,1973-12-01,1974-04-10,131,0,26,113,139,30,43,73,212,15,65,NY - New York (Laguardia)
24,1974-1975,1974-12-01,1975-03-14,104,0,9,74,83,17,17,34,117,8,32,NY - New York (Laguardia)
25,1975-1976,1975-12-01,1976-03-12,103,0,25,117,142,27,40,67,209,16,59,NY - New York (Laguardia)
26,1976-1977,1976-11-30,1977-03-18,109,0,62,197,259,35,79,114,373,18,83,NY - New York (Laguardia)
27,1977-1978,1977-12-01,1978-03-17,107,0,53,164,217,62,150,212,429,16,88,NY - New York (Laguardia)
28,1978-1979,1978-11-27,1979-02-28,94,0,57,165,222,39,50,89,311,14,86,NY - New York (Laguardia)
29,1979-1980,1979-12-01,1980-03-15,106,0,26,120,146,15,13,28,174,7,29,NY - New York (Laguardia)
30,1980-1981,1980-11-17,1981-03-07,111,0,56,181,237,26,41,67,304,12,56,NY - New York (Laguardia)
31,1981-1982,1981-12-01,1982-04-08,129,0,36,153,189,54,53,107,296,18,98,NY - New York (Laguardia)
32,1982-1983,1982-12-01,1983-02-28,90,0,19,80,99,39,63,102,201,7,57,NY - New York (Laguardia)
33,1983-1984,1983-12-01,1984-03-30,121,0,37,153,190,35,60,95,285,14,70,NY - New York (Laguardia)
34,1984-1985,1984-12-01,1985-03-04,94,0,28,102,130,32,56,88,218,13,65,NY - New York (Laguardia)
35,1985-1986,1985-11-16,1986-03-08,113,0,24,125,149,30,44,74,223,13,60,NY - New York (Laguardia)
36,1986-1987,1986-12-01,1987-03-13,103,0,16,105,121,32,50,82,203,12,48,NY - New York (Laguardia)
37,1987-1988,1987-12-01,1988-03-20,111,0,25,118,143,32,68,100,243,11,54,NY - New York (Laguardia)
38,1988-1989,1988-12-01,1989-03-09,99,0,21,100,121,17,13,30,151,7,31,NY - New York (Laguardia)
39,1989-1990,1989-11-22,1990-04-07,137,0,32,128,160,31,36,67,227,13,55,NY - New York (Laguardia)
40,1990-1991,1990-12-01,1991-03-15,105,0,8,74,82,34,28,62,144,11,52,NY - New York (Laguardia)
41,1991-1992,1991-12-01,1992-03-24,115,0,11,97,108,23,22,45,153,12,47,NY - New York (Laguardia)
42,1992-1993,1992-12-01,1993-03-22,112,0,12,129,141,43,65,108,249,17,65,NY - New York (Laguardia)
43,1993-1994,1993-12-01,1994-03-19,109,0,49,190,239,85,198,283,522,25,170,NY - New York (Laguardia)
44,1994-1995,1994-12-01,1995-02-28,90,0,12,89,101,18,44,62,163,5,33,NY - New York (Laguardia)
45,1995-1996,1995-11-29,1996-04-09,133,0,31,145,176,108,219,327,503,23,158,NY - New York (Laguardia)
46,1996-1997,1996-11-28,1997-04-01,125,0,11,90,101,22,14,36,137,16,44,NY - New York (Laguardia)
47,1997-1998,1997-11-14,1998-03-23,130,0,3,46,49,16,4,20,69,11,19,NY - New York (Laguardia)
48,1998-1999,1998-12-01,1999-03-16,106,0,12,88,100,23,11,34,134,13,43,NY - New York (Laguardia)
49,1999-2000,1999-12-01,2000-04-09,131,0,24,98,122,22,57,79,201,9,40,NY - New York (Laguardia)
50,2000-2001,2000-12-01,2001-03-26,116,0,16,110,126,61,100,161,287,19,93,NY - New York (Laguardia)
51,2001-2002,2001-12-01,2002-03-18,108,0,3,47,50,6,5,11,61,4,10,NY - New York (Laguardia)
52,2002-2003,2002-12-01,2003-04-09,130,0,35,159,194,74,138,212,406,20,121,NY - New York (Laguardia)
53,2003-2004,2003-12-01,2004-03-19,110,0,34,139,173,62,120,182,355,16,103,NY - New York (Laguardia)
54,2004-2005,2004-12-01,2005-03-24,114,0,29,133,162,58,110,168,330,22,116,NY - New York (Laguardia)
55,2005-2006,2005-12-01,2006-03-03,93,0,7,65,72,43,49,92,164,8,55,NY - New York (Laguardia)
56,2006-2007,2006-12-01,2007-03-20,110,0,19,103,122,22,25,47,169,12,44,NY - New York (Laguardia)
57,2007-2008,2007-12-01,2008-02-29,91,0,6,69,75,17,19,36,111,7,30,NY - New York (Laguardia)
58,2008-2009,2008-12-01,2009-03-06,96,0,26,124,150,38,57,95,245,14,67,NY - New York (Laguardia)
59,2009-2010,2009-12-01,2010-03-02,92,0,18,97,115,59,99,158,273,14,85,NY - New York (Laguardia)
60,2010-2011,2010-12-01,2011-03-24,114,0,16,108,124,72,177,249,373,17,100,NY - New York (Laguardia)
61,2011-2012,2011-10-29,2012-02-29,124,0,5,45,50,6,8,14,64,2,9,NY - New York (Laguardia)
62,2012-2013,2012-11-07,2013-03-19,133,0,13,69,82,35,23,58,140,15,57,NY - New York (Laguardia)
63,2013-2014,2013-11-23,2014-04-16,145,0,41,184,225,78,146,224,449,23,135,NY - New York (Laguardia)
64,2014-2015,2014-11-26,2015-03-21,116,0,34,179,213,82,201,283,496,25,146,NY - New York (Laguardia)
65,2015-2016,2015-12-01,2016-03-21,112,0,12,64,76,50,57,107,183,10,64,NY - New York (Laguardia)
66,2016-2017,2016-12-01,2017-03-20,110,0,9,63,72,47,60,107,179,10,62,NY - New York (Laguardia)
67,2017-2018,2017-12-01,2018-04-03,124,0,30,109,139,54,53,107,246,16,76,NY - New York (Laguardia)
68,2018-2019,2018-11-15,2019-03-10,116,0,16,105,121,26,12,38,159,11,41,NY - New York (Laguardia)
69,2019-2020,2019-12-01,2020-02-29,91,0,3,51,54,8,2,10,64,7,17,NY - New York (Laguardia)
0,1950-1951,1950-11-21,1951-03-26,126,0,72,254,326,116,272,388,714,58,284,NY - Oswego
1,1951-1952,1951-11-01,1952-03-28,149,0,70,262,332,140,325,465,797,60,323,NY - Oswego
2,1952-1953,1952-10-20,1953-03-10,142,3,39,187,226,74,97,171,397,44,200,NY - Oswego
3,1953-1954,1953-11-07,1954-04-05,150,1,50,260,310,100,197,297,607,31,196,NY - Oswego
8,1958-1959,1958-11-27,1959-03-31,125,17,79,360,439,231,1018,1249,1688,57,470,NY - Oswego
9,1959-1960,1959-11-18,1960-03-29,133,20,71,253,324,151,472,623,947,45,280,NY - Oswego
11,1961-1962,1961-11-21,1962-04-02,133,12,71,270,341,92,196,288,629,26,203,NY - Oswego
12,1962-1963,1962-11-18,1963-03-22,125,0,97,332,429,121,496,617,1046,41,333,NY - Oswego
13,1963-1964,1963-11-30,1964-04-08,131,2,107,338,445,190,338,528,973,40,355,NY - Oswego
14,1964-1965,1964-11-22,1965-04-19,149,0,104,326,430,193,248,441,871,49,427,NY - Oswego
15,1965-1966,1965-11-18,1966-03-29,132,1,70,251,321,213,331,544,865,40,362,NY - Oswego
19,1969-1970,1969-10-22,1970-04-10,171,0,120,414,534,270,734,1004,1538,86,677,NY - Oswego
20,1970-1971,1970-10-17,1971-04-24,190,0,103,355,458,298,807,1105,1563,87,618,NY - Oswego
21,1971-1972,1971-11-07,1972-04-11,157,0,80,356,436,345,745,1090,1526,76,611,NY - Oswego
22,1972-1973,1972-10-19,1973-05-17,211,0,67,294,361,168,288,456,817,65,379,NY - Oswego
23,1973-1974,1973-11-06,1974-04-09,155,1,91,310,401,223,359,582,983,70,480,NY - Oswego
24,1974-1975,1974-10-02,1975-04-13,194,0,55,276,331,221,431,652,983,73,399,NY - Oswego
25,1975-1976,1975-11-14,1976-04-26,165,0,92,344,436,202,520,722,1158,70,509,NY - Oswego
26,1976-1977,1976-10-22,1977-05-09,200,0,123,391,514,353,959,1312,1826,97,764,NY - Oswego
27,1977-1978,1977-11-12,1978-04-21,161,0,136,394,530,327,1067,1394,1924,80,675,NY - Oswego
28,1978-1979,1978-11-20,1979-04-10,142,0,130,350,480,192,510,702,1182,66,498,NY - Oswego
29,1979-1980,1979-11-16,1980-04-16,153,0,92,299,391,160,373,533,924,66,426,NY - Oswego
30,1980-1981,1980-10-21,1981-04-06,168,0,115,381,496,225,569,794,1290,70,573,NY - Oswego
31,1981-1982,1981-11-07,1982-04-11,156,1,96,365,461,222,653,875,1336,75,529,NY - Oswego
32,1982-1983,1982-11-15,1983-04-25,162,3,49,255,304,112,169,281,585,47,245,NY - Oswego
33,1983-1984,1983-11-04,1984-04-02,151,9,110,346,456,209,541,750,1206,78,532,NY - Oswego
34,1984-1985,1984-11-13,1985-04-18,157,6,75,294,369,211,481,692,1061,75,490,NY - Oswego
35,1985-1986,1985-11-16,1986-04-11,147,3,91,304,395,266,711,977,1372,82,576,NY - Oswego
36,1986-1987,1986-11-10,1987-04-02,144,2,61,274,335,137,383,520,855,53,299,NY - Oswego
37,1987-1988,1987-10-09,1988-04-20,195,1,68,305,373,208,433,641,1014,74,437,NY - Oswego
38,1988-1989,1988-10-22,1989-04-11,172,0,76,318,394,165,244,409,803,68,384,NY - Oswego
39,1989-1990,1989-11-12,1990-04-18,158,0,84,349,433,222,434,656,1089,73,506,NY - Oswego
40,1990-1991,1990-11-08,1991-03-15,128,1,50,231,281,167,226,393,674,56,347,NY - Oswego
41,1991-1992,1991-11-07,1992-04-01,147,2,68,303,371,225,523,748,1119,64,480,NY - Oswego
42,1992-1993,1992-11-07,1993-04-22,167,2,71,329,400,246,672,918,1318,70,494,NY - Oswego
43,1993-1994,1993-11-01,1994-04-07,158,0,147,408,555,288,1017,1305,1860,73,675,NY - Oswego
44,1994-1995,1994-11-23,1995-04-09,138,1,71,264,335,139,305,444,779,48,322,NY - Oswego
45,1995-1996,1995-11-04,1996-04-08,157,2,131,373,504,331,685,1016,1520,90,695,NY - Oswego
46,1996-1997,1996-11-02,1997-04-09,159,1,71,271,342,241,506,747,1089,76,471,NY - Oswego
47,1997-1998,1997-10-23,1998-03-26,155,0,39,193,232,152,278,430,662,57,271,NY - Oswego
48,1998-1999,1998-11-06,1999-03-23,138,0,66,242,308,165,417,582,890,46,357,NY - Oswego
49,1999-2000,1999-11-28,2000-04-12,137,0,66,229,295,118,283,401,696,51,287,NY - Oswego
50,2000-2001,2000-10-10,2001-04-02,175,0,79,269,348,291,665,956,1304,84,526,NY - Oswego
51,2001-2002,2001-10-27,2002-04-26,182,5,21,165,186,113,122,235,421,54,218,NY - Oswego
52,2002-2003,2002-11-01,2003-04-23,174,0,112,367,479,253,788,1041,1520,82,580,NY - Oswego
53,2003-2004,2003-11-14,2004-04-05,144,0,111,305,416,257,688,945,1361,67,546,NY - Oswego
54,2004-2005,2004-11-09,2005-03-24,136,1,93,308,401,179,444,623,1024,61,438,NY - Oswego
55,2005-2006,2005-10-28,2006-04-06,161,1,67,219,286,174,282,456,742,66,353,NY - Oswego
56,2006-2007,2006-11-03,2007-04-17,166,4,93,271,364,236,507,743,1107,68,492,NY - Oswego
57,2007-2008,2007-11-18,2008-03-29,133,0,62,247,309,234,498,732,1041,67,433,NY - Oswego
58,2008-2009,2008-11-10,2009-04-08,150,1,102,304,406,222,506,728,1134,67,486,NY - Oswego
59,2009-2010,2009-12-01,2010-03-11,101,0,65,196,261,163,416,579,840,48,323,NY - Oswego
60,2010-2011,2010-11-27,2011-03-27,121,14,93,272,365,256,673,929,1294,63,469,NY - Oswego
63,2013-2014,2013-10-24,2014-04-16,175,1,130,379,509,229,594,823,1332,75,576,NY - Oswego
64,2014-2015,2014-11-14,2015-04-23,161,0,126,395,521,210,728,938,1459,67,499,NY - Oswego
65,2015-2016,2015-10-18,2016-04-11,177,0,36,200,236,117,202,319,555,42,247,NY - Oswego
67,2017-2018,2017-11-11,2018-04-19,160,0,84,294,378,230,460,690,1068,60,459,NY - Oswego
69,2019-2020,2019-11-08,2020-05-09,184,0,42,251,293,81,178,259,552,41,207,NY - Oswego
0,1950-1951,1950-11-21,1951-03-25,125,0,73,293,366,116,240,356,722,63,347,NY - Rochester
1,1951-1952,1951-11-01,1952-03-18,139,0,64,296,360,120,222,342,702,62,328,NY - Rochester
2,1952-1953,1952-11-29,1953-04-20,143,0,39,203,242,70,78,148,390,39,185,NY - Rochester
3,1953-1954,1953-11-07,1954-04-05,150,0,69,277,346,116,171,287,633,51,319,NY - Rochester
4,1954-1955,1954-11-02,1955-04-07,157,0,82,301,383,114,207,321,704,58,344,NY - Rochester
5,1955-1956,1955-11-08,1956-04-23,168,0,90,363,453,174,322,496,949,81,460,NY - Rochester
6,1956-1957,1956-11-13,1957-04-13,152,0,73,315,388,125,229,354,742,63,343,NY - Rochester
7,1957-1958,1957-10-27,1958-04-07,163,0,90,301,391,190,402,592,983,69,455,NY - Rochester
8,1958-1959,1958-11-22,1959-04-04,134,0,119,422,541,203,300,503,1044,69,533,NY - Rochester
9,1959-1960,1959-11-13,1960-04-06,146,0,100,353,453,219,598,817,1270,66,469,NY - Rochester
10,1960-1961,1960-10-24,1961-04-17,176,0,113,389,502,135,331,466,968,65,434,NY - Rochester
11,1961-1962,1961-11-08,1962-04-18,162,0,91,357,448,107,160,267,715,53,315,NY - Rochester
12,1962-1963,1962-10-24,1963-05-01,190,0,128,441,569,124,299,423,992,67,461,NY - Rochester
13,1963-1964,1963-11-30,1964-04-09,132,0,76,336,412,139,308,447,859,61,362,NY - Rochester
14,1964-1965,1964-11-19,1965-04-18,151,0,90,370,460,113,235,348,808,52,320,NY - Rochester
15,1965-1966,1965-10-28,1966-04-06,161,0,75,303,378,164,271,435,813,60,402,NY - Rochester
16,1966-1967,1966-11-04,1967-05-07,185,0,72,317,389,116,228,344,733,62,343,NY - Rochester
17,1967-1968,1967-11-05,1968-03-25,142,0,105,356,461,116,224,340,801,54,389,NY - Rochester
18,1968-1969,1968-11-12,1969-04-19,159,0,77,303,380,123,218,341,721,63,330,NY - Rochester
19,1969-1970,1969-11-14,1970-04-05,143,0,105,403,508,183,481,664,1172,74,500,NY - Rochester
20,1970-1971,1970-10-16,1971-04-10,177,0,111,378,489,204,498,702,1191,78,549,NY - Rochester
21,1971-1972,1971-11-07,1972-04-09,155,0,76,375,451,159,294,453,904,72,430,NY - Rochester
22,1972-1973,1972-10-18,1973-04-11,176,0,67,296,363,116,226,342,705,61,341,NY - Rochester
23,1973-1974,1973-11-05,1974-04-10,157,0,82,323,405,150,242,392,797,63,387,NY - Rochester
24,1974-1975,1974-10-20,1975-04-12,175,0,60,263,323,142,205,347,670,70,330,NY - Rochester
25,1975-1976,1975-11-14,1976-05-19,188,0,83,316,399,136,298,434,833,75,412,NY - Rochester
26,1976-1977,1976-10-27,1977-05-09,195,0,131,406,537,146,497,643,1180,84,516,NY - Rochester
27,1977-1978,1977-11-11,1978-05-01,172,0,108,397,505,233,609,842,1347,72,510,NY - Rochester
28,1978-1979,1978-11-20,1979-04-11,143,0,131,394,525,205,364,569,1094,77,572,NY - Rochester
29,1979-1980,1979-10-26,1980-04-16,174,0,107,332,439,116,123,239,678,66,413,NY - Rochester
30,1980-1981,1980-11-10,1981-04-25,167,0,108,403,511,140,277,417,928,68,453,NY - Rochester
31,1981-1982,1981-10-19,1982-04-11,175,0,117,390,507,190,389,579,1086,74,513,NY - Rochester
32,1982-1983,1982-11-05,1983-04-25,172,0,45,247,292,93,120,213,505,47,233,NY - Rochester
33,1983-1984,1983-11-03,1984-04-07,157,0,116,360,476,178,379,557,1033,72,455,NY - Rochester
34,1984-1985,1984-11-12,1985-04-09,149,0,73,280,353,134,291,425,778,70,387,NY - Rochester
35,1985-1986,1985-11-22,1986-04-22,152,0,95,316,411,118,235,353,764,70,386,NY - Rochester
36,1986-1987,1986-11-11,1987-04-04,145,0,57,305,362,108,196,304,666,57,292,NY - Rochester
37,1987-1988,1987-11-05,1988-04-19,167,0,77,335,412,115,145,260,672,68,356,NY - Rochester
38,1988-1989,1988-10-30,1989-05-08,191,0,77,330,407,132,122,254,661,64,361,NY - Rochester
39,1989-1990,1989-11-03,1990-04-12,161,0,85,334,419,158,261,419,838,72,432,NY - Rochester
40,1990-1991,1990-11-08,1991-04-22,166,0,53,255,308,107,124,231,539,64,296,NY - Rochester
41,1991-1992,1991-11-07,1992-04-03,149,0,66,318,384,172,206,378,762,74,443,NY - Rochester
42,1992-1993,1992-11-02,1993-04-22,172,0,71,352,423,193,404,597,1020,71,425,NY - Rochester
43,1993-1994,1993-10-31,1994-04-08,160,0,133,424,557,182,398,580,1137,75,561,NY - Rochester
44,1994-1995,1994-11-23,1995-04-10,139,0,54,263,317,89,137,226,543,51,266,NY - Rochester
45,1995-1996,1995-11-08,1996-05-12,187,0,122,407,529,192,288,480,1009,87,537,NY - Rochester
46,1996-1997,1996-11-02,1997-04-19,169,0,61,317,378,166,128,294,672,82,421,NY - Rochester
47,1997-1998,1997-10-27,1998-03-26,151,0,36,215,251,139,179,318,569,50,261,NY - Rochester
48,1998-1999,1998-11-04,1999-04-11,159,0,73,300,373,158,264,422,795,45,345,NY - Rochester
49,1999-2000,1999-11-15,2000-04-12,150,0,71,272,343,160,253,413,756,58,392,NY - Rochester
50,2000-2001,2000-11-17,2001-04-02,137,0,75,318,393,187,285,472,865,85,465,NY - Rochester
51,2001-2002,2001-11-20,2002-04-22,154,0,26,193,219,88,73,161,380,43,187,NY - Rochester
52,2002-2003,2002-11-01,2003-04-10,161,0,119,399,518,206,373,579,1097,87,564,NY - Rochester
53,2003-2004,2003-11-13,2004-04-05,145,0,96,327,423,181,352,533,956,69,464,NY - Rochester
54,2004-2005,2004-11-08,2005-03-24,137,0,95,353,448,166,322,488,936,66,469,NY - Rochester
55,2005-2006,2005-11-10,2006-04-04,146,0,52,225,277,114,112,226,503,62,285,NY - Rochester
56,2006-2007,2006-10-12,2007-04-16,187,0,75,268,343,153,231,384,727,63,405,NY - Rochester
57,2007-2008,2007-11-16,2008-03-29,135,0,54,274,328,154,188,342,670,64,340,NY - Rochester
58,2008-2009,2008-10-29,2009-04-07,161,0,90,326,416,155,254,409,825,67,409,NY - Rochester
59,2009-2010,2009-12-01,2010-05-09,160,0,75,248,323,132,243,375,698,51,325,NY - Rochester
60,2010-2011,2010-11-26,2011-03-31,126,0,92,320,412,195,383,578,990,75,490,NY - Rochester
61,2011-2012,2011-11-17,2012-04-24,160,0,25,179,204,88,63,151,355,38,194,NY - Rochester
62,2012-2013,2012-11-05,2013-04-02,149,0,58,239,297,122,164,286,583,63,313,NY - Rochester
63,2013-2014,2013-11-08,2014-04-15,159,0,128,429,557,172,286,458,1015,79,558,NY - Rochester
64,2014-2015,2014-11-13,2015-04-24,163,0,125,428,553,160,412,572,1125,78,561,NY - Rochester
65,2015-2016,2015-11-22,2016-04-10,141,0,45,224,269,99,106,205,474,46,251,NY - Rochester
66,2016-2017,2016-10-27,2017-04-07,163,0,49,214,263,155,173,328,591,56,311,NY - Rochester
67,2017-2018,2017-11-09,2018-04-29,172,0,87,309,396,176,339,515,911,73,441,NY - Rochester
68,2018-2019,2018-10-18,2019-04-27,192,0,67,303,370,149,226,375,745,69,357,NY - Rochester
69,2019-2020,2019-11-07,2020-05-09,185,0,40,242,282,135,222,357,639,64,295,NY - Rochester
0,1950-1951,1950-11-11,1951-03-26,136,0,87,328,415,137,308,445,860,62,354,NY - Syracuse
1,1951-1952,1951-11-01,1952-03-28,149,0,70,312,382,145,282,427,809,66,355,NY - Syracuse
2,1952-1953,1952-10-20,1953-04-18,181,0,42,241,283,115,147,262,545,49,249,NY - Syracuse
3,1953-1954,1953-11-07,1954-04-05,150,0,70,291,361,126,187,313,674,61,369,NY - Syracuse
4,1954-1955,1954-10-31,1955-04-07,159,0,88,329,417,151,249,400,817,62,359,NY - Syracuse
5,1955-1956,1955-10-25,1956-04-19,178,0,109,387,496,210,425,635,1131,88,538,NY - Syracuse
6,1956-1957,1956-11-10,1957-04-14,156,0,69,328,397,119,213,332,729,61,314,NY - Syracuse
7,1957-1958,1957-11-09,1958-04-09,152,0,96,328,424,194,599,793,1217,59,446,NY - Syracuse
8,1958-1959,1958-11-21,1959-03-30,130,0,131,447,578,200,367,567,1145,68,550,NY - Syracuse
9,1959-1960,1959-11-02,1960-04-10,161,0,86,341,427,194,534,728,1155,72,412,NY - Syracuse
10,1960-1961,1960-10-24,1961-04-16,175,0,121,402,523,194,495,689,1212,72,473,NY - Syracuse
11,1961-1962,1961-11-08,1962-04-15,159,1,85,358,443,119,217,336,779,55,310,NY - Syracuse
12,1962-1963,1962-10-24,1963-05-01,190,0,117,447,564,174,558,732,1296,77,509,NY - Syracuse
13,1963-1964,1963-11-02,1964-04-09,160,0,88,378,466,134,347,481,947,71,428,NY - Syracuse
14,1964-1965,1964-10-10,1965-04-18,191,0,90,392,482,142,276,418,900,65,390,NY - Syracuse
15,1965-1966,1965-10-28,1966-05-09,194,0,88,395,483,169,334,503,986,65,439,NY - Syracuse
16,1966-1967,1966-12-01,1967-04-07,128,0,82,335,417,127,356,483,900,59,356,NY - Syracuse
17,1967-1968,1967-11-09,1968-03-25,138,0,101,373,474,117,333,450,924,59,370,NY - Syracuse
18,1968-1969,1968-10-29,1969-03-31,154,0,93,320,413,142,435,577,990,67,347,NY - Syracuse
19,1969-1970,1969-10-22,1970-05-06,197,0,125,425,550,181,577,758,1308,77,529,NY - Syracuse
20,1970-1971,1970-10-16,1971-04-24,191,0,107,373,480,222,679,901,1381,80,538,NY - Syracuse
21,1971-1972,1971-11-07,1972-04-08,154,0,76,371,447,193,383,576,1023,78,455,NY - Syracuse
22,1972-1973,1972-10-17,1973-05-17,213,0,63,310,373,116,184,300,673,58,269,NY - Syracuse
23,1973-1974,1973-11-05,1974-04-11,158,0,88,338,426,184,335,519,945,66,418,NY - Syracuse
24,1974-1975,1974-10-02,1975-04-12,193,1,46,290,336,159,260,419,755,74,329,NY - Syracuse
25,1975-1976,1975-11-14,1976-04-26,165,1,90,365,455,145,357,502,957,65,423,NY - Syracuse
26,1976-1977,1976-10-28,1977-05-09,194,0,126,409,535,212,481,693,1228,90,620,NY - Syracuse
27,1977-1978,1977-11-13,1978-04-15,154,0,107,418,525,233,575,808,1333,79,589,NY - Syracuse
28,1978-1979,1978-11-21,1979-04-11,142,0,121,392,513,168,406,574,1087,63,433,NY - Syracuse
29,1979-1980,1979-10-26,1980-04-16,174,0,87,332,419,138,303,441,860,58,381,NY - Syracuse
30,1980-1981,1980-11-10,1981-04-06,148,0,111,428,539,122,328,450,989,68,442,NY - Syracuse
31,1981-1982,1981-10-19,1982-04-12,176,0,106,414,520,195,369,564,1084,73,493,NY - Syracuse
32,1982-1983,1982-11-15,1983-04-25,162,0,57,323,380,94,140,234,614,41,215,NY - Syracuse
33,1983-1984,1983-11-04,1984-04-01,150,0,128,428,556,165,383,548,1104,65,494,NY - Syracuse
34,1984-1985,1984-11-12,1985-04-18,158,0,69,309,378,169,284,453,831,67,426,NY - Syracuse
35,1985-1986,1985-11-22,1986-04-11,141,0,90,328,418,161,284,445,863,76,458,NY - Syracuse
36,1986-1987,1986-11-11,1987-04-01,142,0,59,332,391,136,289,425,816,50,275,NY - Syracuse
37,1987-1988,1987-11-05,1988-04-20,168,0,80,351,431,168,207,375,806,72,428,NY - Syracuse
38,1988-1989,1988-10-12,1989-04-11,182,0,75,352,427,149,136,285,712,74,406,NY - Syracuse
39,1989-1990,1989-11-12,1990-04-18,158,0,82,383,465,229,310,539,1004,78,536,NY - Syracuse
40,1990-1991,1990-10-28,1991-04-22,177,0,48,290,338,143,165,308,646,61,308,NY - Syracuse
41,1991-1992,1991-11-07,1992-04-03,149,0,68,351,419,235,304,539,958,67,513,NY - Syracuse
42,1992-1993,1992-10-19,1993-04-23,187,0,73,393,466,268,534,802,1268,76,510,NY - Syracuse
43,1993-1994,1993-10-10,1994-04-08,181,4,142,500,642,237,637,874,1516,74,623,NY - Syracuse
44,1994-1995,1994-11-24,1995-04-10,138,0,67,325,392,102,166,268,660,50,324,NY - Syracuse
45,1995-1996,1995-11-04,1996-05-12,191,1,130,418,548,242,372,614,1162,89,596,NY - Syracuse
46,1996-1997,1996-11-02,1997-04-09,159,0,63,297,360,187,146,333,693,75,438,NY - Syracuse
47,1997-1998,1997-10-23,1998-03-25,154,0,39,234,273,193,270,463,736,55,334,NY - Syracuse
48,1998-1999,1998-12-01,1999-03-24,114,0,71,287,358,141,205,346,704,49,352,NY - Syracuse
49,1999-2000,1999-11-15,2000-04-10,148,0,73,298,371,124,217,341,712,50,313,NY - Syracuse
50,2000-2001,2000-11-17,2001-04-02,137,2,87,336,423,277,404,681,1104,87,589,NY - Syracuse
51,2001-2002,2001-10-08,2002-04-26,201,0,16,190,206,99,64,163,369,57,203,NY - Syracuse
52,2002-2003,2002-11-01,2003-04-08,159,0,109,390,499,218,528,746,1245,85,553,NY - Syracuse
53,2003-2004,2003-11-13,2004-04-05,145,0,118,377,495,246,602,848,1343,69,546,NY - Syracuse
54,2004-2005,2004-11-08,2005-03-26,139,0,89,370,459,190,389,579,1038,65,475,NY - Syracuse
55,2005-2006,2005-11-17,2006-03-23,127,0,69,261,330,172,266,438,768,68,397,NY - Syracuse
56,2006-2007,2006-11-03,2007-04-17,166,0,97,324,421,197,393,590,1011,67,501,NY - Syracuse
57,2007-2008,2007-11-16,2008-03-30,136,0,55,293,348,163,252,415,763,65,375,NY - Syracuse
58,2008-2009,2008-10-28,2009-04-07,162,0,109,375,484,214,358,572,1056,71,540,NY - Syracuse
59,2009-2010,2009-11-06,2010-05-09,185,0,74,269,343,152,379,531,874,58,345,NY - Syracuse
60,2010-2011,2010-11-19,2011-04-21,154,0,101,353,454,254,546,800,1254,73,540,NY - Syracuse
61,2011-2012,2011-11-18,2012-03-10,114,0,19,172,191,82,68,150,341,38,180,NY - Syracuse
62,2012-2013,2012-11-24,2013-04-04,132,0,61,254,315,172,301,473,788,68,408,NY - Syracuse
63,2013-2014,2013-11-08,2014-04-16,160,0,133,455,588,194,434,628,1216,75,554,NY - Syracuse
64,2014-2015,2014-11-13,2015-04-24,163,0,153,496,649,175,556,731,1380,76,588,NY - Syracuse
65,2015-2016,2015-10-18,2016-04-08,174,0,49,262,311,116,232,348,659,37,258,NY - Syracuse
66,2016-2017,2016-10-27,2017-04-07,163,0,57,265,322,201,277,478,800,63,397,NY - Syracuse
67,2017-2018,2017-11-10,2018-04-20,162,1,97,381,478,218,447,665,1143,70,516,NY - Syracuse
68,2018-2019,2018-11-10,2019-04-05,147,0,89,363,452,172,372,544,996,74,426,NY - Syracuse
69,2019-2020,2019-11-07,2020-05-09,185,0,41,274,315,133,276,409,724,59,282,NY - Syracuse
0,1950-1951,1950-11-11,1951-04-05,146,1,113,384,497,187,347,534,1031,66,439,NY - Watertown
1,1951-1952,1951-11-02,1952-03-18,138,0,118,406,524,175,297,472,996,57,432,NY - Watertown
3,1953-1954,1953-11-06,1954-04-05,151,13,101,429,530,103,273,376,906,42,297,NY - Watertown
4,1954-1955,1954-11-22,1955-04-08,138,3,129,450,579,137,370,507,1086,42,293,NY - Watertown
5,1955-1956,1955-11-09,1956-04-20,164,5,137,509,646,125,349,474,1120,52,345,NY - Watertown
6,1956-1957,1956-11-23,1957-04-13,142,1,101,450,551,124,306,430,981,52,385,NY - Watertown
7,1957-1958,1957-11-10,1958-03-25,136,4,118,376,494,87,445,532,1026,49,298,NY - Watertown
8,1958-1959,1958-11-25,1959-04-06,133,4,160,559,719,180,551,731,1450,53,510,NY - Watertown
9,1959-1960,1959-11-04,1960-04-10,159,0,138,486,624,193,690,883,1507,60,411,NY - Watertown
10,1960-1961,1960-10-25,1961-04-11,169,1,154,521,675,144,560,704,1379,39,374,NY - Watertown
11,1961-1962,1961-11-09,1962-04-16,159,11,133,471,604,143,385,528,1132,45,340,NY - Watertown
12,1962-1963,1962-10-25,1963-05-01,189,2,161,565,726,236,988,1224,1950,67,606,NY - Watertown
13,1963-1964,1963-11-30,1964-04-09,132,1,126,462,588,123,514,637,1225,47,341,NY - Watertown
15,1965-1966,1965-11-28,1966-04-06,130,0,116,406,522,116,396,512,1034,37,266,NY - Watertown
16,1966-1967,1966-11-05,1967-05-08,185,14,104,453,557,113,343,456,1013,47,311,NY - Watertown
17,1967-1968,1967-11-05,1968-03-26,143,3,147,533,680,109,452,561,1241,37,318,NY - Watertown
18,1968-1969,1968-11-13,1969-04-19,158,0,132,475,607,130,344,474,1081,42,304,NY - Watertown
19,1969-1970,1969-10-22,1970-05-06,197,0,162,615,777,162,824,986,1763,47,387,NY - Watertown
20,1970-1971,1970-11-23,1971-04-25,154,0,144,539,683,211,821,1032,1715,55,486,NY - Watertown
21,1971-1972,1971-11-07,1972-04-10,156,0,107,510,617,152,593,745,1362,55,400,NY - Watertown
22,1972-1973,1972-10-19,1973-04-11,175,1,98,419,517,128,318,446,963,40,298,NY - Watertown
23,1973-1974,1973-11-12,1974-04-10,150,0,132,473,605,135,269,404,1009,46,362,NY - Watertown
24,1974-1975,1974-11-16,1975-04-11,147,0,73,402,475,162,367,529,1004,53,344,NY - Watertown
25,1975-1976,1975-11-14,1976-05-20,189,1,128,540,668,154,424,578,1246,46,421,NY - Watertown
26,1976-1977,1976-10-22,1977-05-09,200,0,166,573,739,318,907,1225,1964,70,757,NY - Watertown
27,1977-1978,1977-11-12,1978-04-01,141,1,153,563,716,215,1021,1236,1952,66,550,NY - Watertown
28,1978-1979,1978-11-21,1979-04-11,142,1,176,524,700,200,679,879,1579,51,466,NY - Watertown
29,1979-1980,1979-11-16,1980-04-05,142,2,117,457,574,105,307,412,986,32,232,NY - Watertown
30,1980-1981,1980-11-12,1981-04-06,146,0,161,559,720,151,445,596,1316,53,447,NY - Watertown
31,1981-1982,1981-11-07,1982-04-10,155,3,143,523,666,138,642,780,1446,55,420,NY - Watertown
32,1982-1983,1982-11-15,1983-04-25,162,19,83,359,442,55,95,150,592,29,149,NY - Watertown
33,1983-1984,1983-11-12,1984-03-31,141,3,148,485,633,237,799,1036,1669,58,507,NY - Watertown
34,1984-1985,1984-11-13,1985-04-04,143,6,115,452,567,213,548,761,1328,47,474,NY - Watertown
35,1985-1986,1985-11-16,1986-04-10,146,8,127,488,615,250,859,1109,1724,58,539,NY - Watertown
36,1986-1987,1986-11-13,1987-04-01,140,0,93,422,515,81,286,367,882,37,239,NY - Watertown
39,1989-1990,1989-11-17,1990-04-06,141,2,122,489,611,139,268,407,1018,42,384,NY - Watertown
40,1990-1991,1990-11-13,1991-03-22,130,7,65,347,412,86,150,236,648,31,222,NY - Watertown
49,1999-2000,1999-11-30,2000-04-12,135,3,104,404,508,98,219,317,825,33,267,NY - Watertown
50,2000-2001,2000-11-19,2001-04-07,140,3,101,464,565,228,668,896,1461,52,438,NY - Watertown
51,2001-2002,2001-12-01,2002-04-29,150,0,42,297,339,172,314,486,825,43,312,NY - Watertown
52,2002-2003,2002-11-03,2003-04-10,159,2,162,593,755,233,654,887,1642,56,519,NY - Watertown
53,2003-2004,2003-11-19,2004-04-05,139,4,129,471,600,131,324,455,1055,37,284,NY - Watertown
58,2008-2009,2008-10-29,2009-04-09,163,9,121,513,634,256,511,767,1401,49,511,NY - Watertown
59,2009-2010,2009-12-01,2010-03-27,117,0,101,353,454,122,399,521,975,34,263,NY - Watertown
60,2010-2011,2010-11-27,2011-03-28,122,2,154,504,658,173,472,645,1303,43,445,NY - Watertown
62,2012-2013,2012-11-26,2013-04-03,129,1,87,370,457,117,313,430,887,35,258,NY - Watertown
63,2013-2014,2013-11-12,2014-04-16,156,7,177,596,773,290,675,965,1738,51,621,NY - Watertown
64,2014-2015,2014-11-14,2015-04-05,143,0,190,611,801,213,723,936,1737,51,535,NY - Watertown
65,2015-2016,2015-11-24,2016-04-06,135,0,75,312,387,75,181,256,643,21,166,NY - Watertown
66,2016-2017,2016-11-21,2017-03-26,126,0,76,319,395,131,225,356,751,26,241,NY - Watertown
68,2018-2019,2018-11-16,2019-04-01,137,0,122,490,612,242,411,653,1265,48,502,NY - Watertown
69,2019-2020,2019-11-08,2020-05-09,184,0,75,394,469,134,356,490,959,32,248,NY - Watertown
0,1950-1951,1950-11-24,1951-02-28,97,0,18,151,169,11,8,19,188,8,45,NC - Asheville
1,1951-1952,1951-11-18,1952-03-24,128,0,4,105,109,13,1,14,123,10,27,NC - Asheville
2,1952-1953,1952-11-21,1953-02-28,100,0,4,73,77,23,5,28,105,10,32,NC - Asheville
3,1953-1954,1953-11-26,1954-03-15,110,0,6,118,124,14,8,22,146,8,25,NC - Asheville
4,1954-1955,1954-11-02,1955-03-27,146,0,9,147,156,15,15,30,186,8,30,NC - Asheville
5,1955-1956,1955-11-10,1956-04-11,154,0,7,139,146,21,5,26,172,15,40,NC - Asheville
6,1956-1957,1956-11-27,1957-03-08,102,0,6,65,71,9,0,9,80,7,18,NC - Asheville
7,1957-1958,1957-11-30,1958-03-21,112,0,29,176,205,28,35,63,268,12,70,NC - Asheville
8,1958-1959,1958-12-01,1959-04-14,135,0,11,144,155,6,6,12,167,4,14,NC - Asheville
9,1959-1960,1959-11-29,1960-04-05,129,0,21,166,187,58,80,138,325,17,99,NC - Asheville
10,1960-1961,1960-12-01,1961-02-28,90,0,11,139,150,8,2,10,160,5,21,NC - Asheville
11,1961-1962,1961-12-01,1962-03-09,99,0,11,99,110,31,29,60,170,12,59,NC - Asheville
12,1962-1963,1962-11-05,1963-02-28,116,0,18,195,213,14,5,19,232,10,39,NC - Asheville
13,1963-1964,1963-11-14,1964-03-30,138,0,12,165,177,43,27,70,247,23,84,NC - Asheville
14,1964-1965,1964-12-01,1965-03-20,110,0,8,163,171,22,22,44,215,9,43,NC - Asheville
15,1965-1966,1965-12-01,1966-03-06,96,0,17,168,185,32,101,133,318,11,61,NC - Asheville
16,1966-1967,1966-11-21,1967-02-28,100,0,5,148,153,16,3,19,172,11,41,NC - Asheville
17,1967-1968,1967-12-01,1968-03-02,93,0,8,158,166,25,35,60,226,13,57,NC - Asheville
18,1968-1969,1968-11-09,1969-03-10,122,0,6,155,161,71,65,136,297,15,87,NC - Asheville
19,1969-1970,1969-12-01,1970-03-23,113,0,15,172,187,27,52,79,266,12,48,NC - Asheville
20,1970-1971,1970-11-24,1971-04-07,135,0,7,156,163,25,21,46,209,12,43,NC - Asheville
21,1971-1972,1971-11-24,1972-03-31,129,0,4,114,118,44,25,69,187,11,55,NC - Asheville
22,1972-1973,1972-11-22,1973-03-21,120,0,7,119,126,15,25,40,166,5,26,NC - Asheville
23,1973-1974,1973-12-01,1974-03-25,115,0,2,91,93,9,1,10,103,6,20,NC - Asheville
24,1974-1975,1974-11-14,1975-03-10,117,0,2,123,125,20,9,29,154,11,36,NC - Asheville
25,1975-1976,1975-11-23,1976-02-29,99,0,6,153,159,15,10,25,184,6,28,NC - Asheville
26,1976-1977,1976-11-22,1977-02-28,99,0,17,244,261,22,56,78,339,10,44,NC - Asheville
27,1977-1978,1977-12-01,1978-03-18,108,0,15,213,228,37,51,88,316,23,91,NC - Asheville
28,1978-1979,1978-12-01,1979-02-28,90,0,3,148,151,33,53,86,237,8,46,NC - Asheville
29,1979-1980,1979-12-01,1980-03-13,104,0,8,133,141,21,20,41,182,11,48,NC - Asheville
30,1980-1981,1980-12-01,1981-03-24,114,0,7,180,187,24,15,39,226,7,32,NC - Asheville
31,1981-1982,1981-12-01,1982-04-08,129,0,10,152,162,30,36,66,228,8,45,NC - Asheville
32,1982-1983,1982-12-01,1983-04-18,139,0,2,107,109,38,29,67,176,16,61,NC - Asheville
33,1983-1984,1983-12-01,1984-02-29,91,0,10,159,169,5,6,11,180,4,15,NC - Asheville
34,1984-1985,1984-12-01,1985-04-08,129,0,12,162,174,13,12,25,199,9,39,NC - Asheville
35,1985-1986,1985-12-01,1986-03-04,94,0,8,175,183,10,5,15,198,7,30,NC - Asheville
36,1986-1987,1986-12-01,1987-04-06,127,0,2,124,126,41,49,90,216,11,59,NC - Asheville
37,1987-1988,1987-11-11,1988-04-12,154,0,8,192,200,23,53,76,276,5,32,NC - Asheville
38,1988-1989,1988-12-01,1989-04-07,128,0,6,119,125,11,5,16,141,6,20,NC - Asheville
39,1989-1990,1989-12-01,1990-02-28,90,0,11,111,122,8,1,9,131,6,18,NC - Asheville
40,1990-1991,1990-12-01,1991-03-08,98,0,1,90,91,6,1,7,98,3,14,NC - Asheville
41,1991-1992,1991-11-09,1992-03-13,126,0,1,104,105,4,0,4,109,3,8,NC - Asheville
42,1992-1993,1992-12-01,1993-03-20,110,0,6,109,115,29,49,78,193,5,46,NC - Asheville
43,1993-1994,1993-12-01,1994-03-03,93,0,9,143,152,20,31,51,203,10,35,NC - Asheville
44,1994-1995,1994-12-01,1995-02-28,90,0,4,94,98,7,3,10,108,4,22,NC - Asheville
45,1995-1996,1995-12-01,1996-03-21,112,0,18,167,185,31,55,86,271,13,70,NC - Asheville
46,1996-1997,1996-11-10,1997-02-28,111,0,8,125,133,12,17,29,162,7,20,NC - Asheville
47,1997-1998,1997-12-01,1998-03-21,111,0,6,96,102,22,23,45,147,7,35,NC - Asheville
48,1998-1999,1998-12-01,1999-03-26,116,0,5,96,101,12,6,18,119,6,18,NC - Asheville
49,1999-2000,1999-11-02,2000-04-04,155,0,8,117,125,11,8,19,144,5,18,NC - Asheville
50,2000-2001,2000-11-19,2001-04-17,150,0,7,156,163,25,15,40,203,9,41,NC - Asheville
51,2001-2002,2001-12-01,2002-03-04,94,0,3,104,107,3,0,3,110,3,7,NC - Asheville
52,2002-2003,2002-12-01,2003-04-10,131,0,4,126,130,26,16,42,172,7,39,NC - Asheville
53,2003-2004,2003-12-01,2004-02-29,91,0,4,132,136,23,10,33,169,9,38,NC - Asheville
54,2004-2005,2004-12-01,2005-04-24,145,0,6,123,129,11,1,12,141,7,24,NC - Asheville
55,2005-2006,2005-12-01,2006-02-28,90,0,1,97,98,4,0,4,102,3,9,NC - Asheville
56,2006-2007,2006-12-01,2007-04-07,128,0,1,129,130,5,1,6,136,3,11,NC - Asheville
57,2007-2008,2007-12-01,2008-02-29,91,0,5,94,99,6,4,10,109,4,15,NC - Asheville
58,2008-2009,2008-12-01,2009-03-02,92,0,8,130,138,9,3,12,150,2,12,NC - Asheville
59,2009-2010,2009-12-01,2010-03-22,112,0,21,151,172,54,75,129,301,9,68,NC - Asheville
60,2010-2011,2010-12-01,2011-02-28,90,0,14,143,157,29,56,85,242,8,55,NC - Asheville
61,2011-2012,2011-12-01,2012-02-29,91,0,2,76,78,0,0,0,78,0,0,NC - Asheville
62,2012-2013,2012-12-01,2013-03-20,110,0,1,82,83,2,0,2,85,2,5,NC - Asheville
63,2013-2014,2013-11-27,2014-03-25,119,0,10,170,180,17,12,29,209,7,35,NC - Asheville
64,2014-2015,2014-11-01,2015-02-28,120,0,10,150,160,18,20,38,198,6,31,NC - Asheville
65,2015-2016,2015-12-01,2016-02-29,91,0,8,90,98,22,34,56,154,5,35,NC - Asheville
66,2016-2017,2016-12-01,2017-03-15,105,0,4,74,78,14,21,35,113,6,25,NC - Asheville
67,2017-2018,2017-12-01,2018-03-14,104,0,10,115,125,20,21,41,166,7,33,NC - Asheville
68,2018-2019,2018-12-01,2019-02-28,90,0,1,59,60,15,25,40,100,3,17,NC - Asheville
69,2019-2020,2019-12-01,2020-02-29,91,0,2,54,56,5,1,6,62,4,8,NC - Asheville
0,1950-1951,1950-11-25,1951-02-28,96,0,4,99,103,1,0,1,104,1,3,NC - Charlotte
1,1951-1952,1951-12-01,1952-02-29,91,0,1,54,55,6,4,10,65,1,7,NC - Charlotte
2,1952-1953,1952-12-01,1953-02-28,90,0,0,41,41,0,0,0,41,0,0,NC - Charlotte
3,1953-1954,1953-12-01,1954-02-28,90,0,0,60,60,5,2,7,67,3,8,NC - Charlotte
4,1954-1955,1954-12-01,1955-02-28,90,0,1,71,72,13,10,23,95,3,16,NC - Charlotte
5,1955-1956,1955-12-01,1956-02-29,91,0,0,68,68,1,1,2,70,1,2,NC - Charlotte
6,1956-1957,1956-12-01,1957-02-28,90,0,0,38,38,0,0,0,38,0,0,NC - Charlotte
7,1957-1958,1957-12-01,1958-02-28,90,0,5,109,114,5,6,11,125,2,7,NC - Charlotte
8,1958-1959,1958-12-01,1959-03-02,92,0,2,92,94,6,8,14,108,3,12,NC - Charlotte
9,1959-1960,1959-12-01,1960-03-14,105,0,3,91,94,32,53,85,179,6,44,NC - Charlotte
10,1960-1961,1960-12-01,1961-02-28,90,0,4,98,102,4,3,7,109,3,12,NC - Charlotte
11,1961-1962,1961-12-01,1962-03-09,99,0,3,76,79,20,19,39,118,6,25,NC - Charlotte
12,1962-1963,1962-12-01,1963-02-28,90,0,5,142,147,3,3,6,153,1,5,NC - Charlotte
13,1963-1964,1963-12-01,1964-02-29,91,0,1,107,108,5,2,7,115,4,11,NC - Charlotte
14,1964-1965,1964-12-01,1965-02-28,90,0,2,79,81,19,17,36,117,4,29,NC - Charlotte
15,1965-1966,1965-12-01,1966-02-28,90,0,4,85,89,17,19,36,125,5,33,NC - Charlotte
16,1966-1967,1966-12-01,1967-02-28,90,0,1,80,81,7,5,12,93,1,8,NC - Charlotte
17,1967-1968,1967-12-01,1968-02-29,91,0,4,87,91,9,10,19,110,5,19,NC - Charlotte
18,1968-1969,1968-11-11,1969-03-02,112,0,4,116,120,26,31,57,177,6,33,NC - Charlotte
19,1969-1970,1969-12-01,1970-02-28,90,0,7,124,131,6,4,10,141,3,15,NC - Charlotte
20,1970-1971,1970-12-01,1971-03-27,117,0,5,108,113,14,12,26,139,6,22,NC - Charlotte
21,1971-1972,1971-12-01,1972-03-26,117,0,2,67,69,15,10,25,94,3,18,NC - Charlotte
22,1972-1973,1972-12-01,1973-02-28,90,0,5,84,89,8,19,27,116,3,17,NC - Charlotte
23,1973-1974,1973-12-01,1974-03-25,115,0,1,61,62,10,3,13,75,4,16,NC - Charlotte
24,1974-1975,1974-12-01,1975-03-10,100,0,0,56,56,3,0,3,59,2,4,NC - Charlotte
25,1975-1976,1975-11-23,1976-02-29,99,0,1,82,83,1,0,1,84,1,1,NC - Charlotte
26,1976-1977,1976-12-01,1977-02-28,90,0,5,142,147,6,2,8,155,4,13,NC - Charlotte
27,1977-1978,1977-12-01,1978-03-17,107,0,1,104,105,9,4,13,118,4,12,NC - Charlotte
28,1978-1979,1978-12-01,1979-02-28,90,0,3,101,104,22,24,46,150,4,30,NC - Charlotte
29,1979-1980,1979-12-01,1980-03-04,95,0,3,89,92,22,15,37,129,8,37,NC - Charlotte
30,1980-1981,1980-12-01,1981-02-28,90,0,5,111,116,3,2,5,121,2,8,NC - Charlotte
31,1981-1982,1981-12-01,1982-04-08,129,0,6,88,94,15,24,39,133,6,27,NC - Charlotte
32,1982-1983,1982-12-01,1983-03-25,115,0,1,65,66,18,7,25,91,4,25,NC - Charlotte
33,1983-1984,1983-12-01,1984-02-29,91,0,5,94,99,7,4,11,110,1,9,NC - Charlotte
34,1984-1985,1984-12-01,1985-02-28,90,0,2,93,95,3,1,4,99,2,11,NC - Charlotte
35,1985-1986,1985-12-01,1986-02-28,90,0,2,96,98,1,0,1,99,1,4,NC - Charlotte
36,1986-1987,1986-12-01,1987-03-12,102,0,0,62,62,11,17,28,90,4,16,NC - Charlotte
37,1987-1988,1987-12-01,1988-02-29,91,0,4,82,86,18,43,61,147,1,23,NC - Charlotte
38,1988-1989,1988-12-01,1989-02-28,90,0,1,41,42,5,4,9,51,2,8,NC - Charlotte
39,1989-1990,1989-12-01,1990-02-28,90,0,5,60,65,1,0,1,66,1,3,NC - Charlotte
40,1990-1991,1990-12-01,1991-02-28,90,0,0,35,35,2,0,2,37,1,2,NC - Charlotte
41,1991-1992,1991-12-01,1992-02-29,91,0,0,32,32,0,0,0,32,0,0,NC - Charlotte
42,1992-1993,1992-12-01,1993-03-14,104,0,0,43,43,2,2,4,47,1,3,NC - Charlotte
43,1993-1994,1993-12-01,1994-02-28,90,0,4,65,69,3,2,5,74,1,3,NC - Charlotte
44,1994-1995,1994-12-01,1995-02-28,90,0,1,52,53,0,0,0,53,0,0,NC - Charlotte
45,1995-1996,1995-12-01,1996-02-29,91,0,5,85,90,4,5,9,99,2,10,NC - Charlotte
46,1996-1997,1996-12-01,1997-02-28,90,0,0,42,42,2,0,2,44,2,3,NC - Charlotte
47,1997-1998,1997-12-01,1998-03-12,102,0,0,30,30,6,3,9,39,3,8,NC - Charlotte
48,1998-1999,1998-12-01,1999-03-09,99,0,1,63,64,3,0,3,67,2,4,NC - Charlotte
49,1999-2000,1999-12-01,2000-02-29,91,0,2,82,84,16,9,25,109,6,25,NC - Charlotte
50,2000-2001,2000-11-19,2001-02-28,102,0,0,105,105,4,0,4,109,2,5,NC - Charlotte
51,2001-2002,2001-12-01,2002-02-28,90,0,2,70,72,5,10,15,87,2,9,NC - Charlotte
52,2002-2003,2002-12-01,2003-02-28,90,0,0,87,87,15,19,34,121,3,24,NC - Charlotte
53,2003-2004,2003-12-01,2004-03-01,92,0,1,99,100,19,19,38,138,4,24,NC - Charlotte
54,2004-2005,2004-12-01,2005-02-28,90,0,3,76,79,1,1,2,81,1,4,NC - Charlotte
55,2005-2006,2005-12-01,2006-02-28,90,0,0,64,64,0,0,0,64,0,0,NC - Charlotte
56,2006-2007,2006-12-01,2007-02-28,90,0,0,70,70,2,0,2,72,1,3,NC - Charlotte
57,2007-2008,2007-12-01,2008-02-29,91,0,0,61,61,2,0,2,63,1,3,NC - Charlotte
58,2008-2009,2008-12-01,2009-03-02,92,0,1,80,81,6,4,10,91,1,7,NC - Charlotte
59,2009-2010,2009-12-01,2010-03-02,92,0,1,106,107,8,11,19,126,4,13,NC - Charlotte
60,2010-2011,2010-12-01,2011-02-28,90,0,1,111,112,9,13,22,134,3,13,NC - Charlotte
61,2011-2012,2011-12-01,2012-02-29,91,0,0,48,48,0,0,0,48,0,0,NC - Charlotte
62,2012-2013,2012-12-01,2013-02-28,90,0,1,50,51,3,3,6,57,1,4,NC - Charlotte
63,2013-2014,2013-12-01,2014-02-28,90,0,4,95,99,12,13,25,124,4,19,NC - Charlotte
64,2014-2015,2014-12-01,2015-02-28,90,0,3,90,93,5,3,8,101,4,10,NC - Charlotte
65,2015-2016,2015-12-01,2016-02-29,91,0,1,67,68,5,7,12,80,2,7,NC - Charlotte
66,2016-2017,2016-12-01,2017-03-12,102,0,2,48,50,5,3,8,58,3,10,NC - Charlotte
67,2017-2018,2017-12-01,2018-03-14,104,0,2,91,93,6,5,11,104,3,10,NC - Charlotte
68,2018-2019,2018-12-01,2019-04-02,123,0,0,42,42,5,3,8,50,3,6,NC - Charlotte
69,2019-2020,2019-12-01,2020-02-29,91,0,0,36,36,1,0,1,37,1,1,NC - Charlotte
0,1950-1951,1950-11-24,1951-02-28,97,0,8,146,154,7,2,9,163,6,22,NC - Greensboro
1,1951-1952,1951-12-01,1952-03-15,106,0,3,95,98,17,5,22,120,6,25,NC - Greensboro
2,1952-1953,1952-12-01,1953-03-03,93,0,1,68,69,0,0,0,69,0,0,NC - Greensboro
3,1953-1954,1953-12-01,1954-02-28,90,0,5,96,101,13,15,28,129,5,22,NC - Greensboro
4,1954-1955,1954-12-01,1955-02-28,90,0,1,113,114,18,17,35,149,5,28,NC - Greensboro
5,1955-1956,1955-12-01,1956-02-29,91,0,1,106,107,6,3,9,116,4,12,NC - Greensboro
6,1956-1957,1956-11-26,1957-02-28,95,0,2,75,77,2,0,2,79,2,8,NC - Greensboro
7,1957-1958,1957-12-01,1958-02-28,90,0,10,144,154,14,19,33,187,4,20,NC - Greensboro
8,1958-1959,1958-12-01,1959-02-28,90,0,8,139,147,13,16,29,176,4,28,NC - Greensboro
9,1959-1960,1959-12-01,1960-03-21,112,0,8,133,141,43,93,136,277,7,57,NC - Greensboro
10,1960-1961,1960-12-01,1961-02-28,90,0,9,150,159,4,3,7,166,4,15,NC - Greensboro
11,1961-1962,1961-12-01,1962-03-10,100,0,5,119,124,34,26,60,184,8,51,NC - Greensboro
12,1962-1963,1962-12-01,1963-02-28,90,0,9,166,175,7,8,15,190,3,13,NC - Greensboro
13,1963-1964,1963-12-01,1964-02-29,91,0,6,139,145,12,10,22,167,8,30,NC - Greensboro
14,1964-1965,1964-11-30,1965-03-20,111,0,4,126,130,16,34,50,180,6,33,NC - Greensboro
15,1965-1966,1965-12-01,1966-02-28,90,0,8,124,132,36,100,136,268,9,65,NC - Greensboro
16,1966-1967,1966-12-01,1967-02-28,90,0,2,97,99,7,8,15,114,3,16,NC - Greensboro
17,1967-1968,1967-12-01,1968-03-02,93,0,3,120,123,14,27,41,164,8,31,NC - Greensboro
18,1968-1969,1968-11-09,1969-03-05,117,0,2,132,134,25,22,47,181,7,34,NC - Greensboro
19,1969-1970,1969-12-01,1970-02-28,90,0,12,135,147,13,6,19,166,9,31,NC - Greensboro
20,1970-1971,1970-11-24,1971-03-27,124,0,15,170,185,13,10,23,208,9,37,NC - Greensboro
21,1971-1972,1971-11-09,1972-03-26,139,0,4,118,122,19,11,30,152,7,32,NC - Greensboro
22,1972-1973,1972-12-01,1973-03-21,111,0,9,117,126,10,23,33,159,3,20,NC - Greensboro
23,1973-1974,1973-12-01,1974-03-26,116,0,4,87,91,18,24,42,133,5,27,NC - Greensboro
24,1974-1975,1974-12-01,1975-03-10,100,0,1,75,76,6,3,9,85,2,9,NC - Greensboro
25,1975-1976,1975-12-01,1976-02-29,91,0,4,102,106,1,0,1,107,1,2,NC - Greensboro
26,1976-1977,1976-12-01,1977-02-28,90,0,9,197,206,16,23,39,245,7,28,NC - Greensboro
27,1977-1978,1977-12-01,1978-03-04,94,0,6,178,184,17,7,24,208,11,35,NC - Greensboro
28,1978-1979,1978-12-01,1979-02-28,90,0,9,137,146,22,48,70,216,4,40,NC - Greensboro
29,1979-1980,1979-12-01,1980-03-04,95,0,6,127,133,26,28,54,187,9,50,NC - Greensboro
30,1980-1981,1980-12-01,1981-03-24,114,0,7,164,171,14,10,24,195,4,22,NC - Greensboro
31,1981-1982,1981-12-01,1982-02-28,90,0,9,125,134,20,33,53,187,7,39,NC - Greensboro
32,1982-1983,1982-12-01,1983-02-28,90,0,5,94,99,10,13,23,122,5,20,NC - Greensboro
33,1983-1984,1983-12-01,1984-02-29,91,0,10,118,128,4,7,11,139,1,6,NC - Greensboro
34,1984-1985,1984-12-01,1985-02-28,90,0,4,116,120,8,6,14,134,3,18,NC - Greensboro
35,1985-1986,1985-12-01,1986-02-28,90,0,5,117,122,3,1,4,126,2,9,NC - Greensboro
36,1986-1987,1986-12-01,1987-03-12,102,0,4,107,111,33,61,94,205,7,45,NC - Greensboro
37,1987-1988,1987-11-11,1988-02-29,111,0,10,132,142,13,48,61,203,2,20,NC - Greensboro
38,1988-1989,1988-12-01,1989-03-08,98,1,3,94,97,19,24,43,140,6,28,NC - Greensboro
39,1989-1990,1989-12-01,1990-02-28,90,0,10,95,105,6,4,10,115,4,12,NC - Greensboro
40,1990-1991,1990-12-01,1991-02-28,90,0,0,57,57,0,0,0,57,0,0,NC - Greensboro
41,1991-1992,1991-12-01,1992-02-29,91,0,0,66,66,0,0,0,66,0,0,NC - Greensboro
42,1992-1993,1992-12-01,1993-03-16,106,0,4,104,108,9,13,22,130,3,16,NC - Greensboro
43,1993-1994,1993-12-01,1994-03-03,93,0,10,124,134,7,3,10,144,5,14,NC - Greensboro
44,1994-1995,1994-12-01,1995-03-03,93,0,3,80,83,2,0,2,85,2,4,NC - Greensboro
45,1995-1996,1995-12-01,1996-03-08,99,0,15,125,140,24,55,79,219,7,47,NC - Greensboro
46,1996-1997,1996-12-01,1997-02-28,90,1,6,85,91,6,4,10,101,3,13,NC - Greensboro
47,1997-1998,1997-12-01,1998-02-28,90,0,1,56,57,8,11,19,76,2,11,NC - Greensboro
48,1998-1999,1998-12-01,1999-02-28,90,0,7,65,72,5,0,5,77,5,15,NC - Greensboro
49,1999-2000,1999-12-01,2000-02-29,91,0,6,89,95,21,71,92,187,6,32,NC - Greensboro
50,2000-2001,2000-11-19,2001-02-28,102,0,2,121,123,8,2,10,133,5,15,NC - Greensboro
51,2001-2002,2001-12-01,2002-02-28,90,0,2,73,75,10,19,29,104,2,16,NC - Greensboro
52,2002-2003,2002-12-01,2003-03-30,120,3,6,100,106,21,19,40,146,8,38,NC - Greensboro
53,2003-2004,2003-12-01,2004-02-29,91,0,4,111,115,27,29,56,171,6,35,NC - Greensboro
54,2004-2005,2004-12-01,2005-03-17,107,0,7,88,95,3,1,4,99,2,6,NC - Greensboro
55,2005-2006,2005-12-01,2006-02-28,90,0,1,59,60,3,0,3,63,3,5,NC - Greensboro
56,2006-2007,2006-12-01,2007-02-28,90,0,0,78,78,2,0,2,80,2,4,NC - Greensboro
57,2007-2008,2007-12-01,2008-02-29,91,0,1,61,62,5,4,9,71,3,8,NC - Greensboro
58,2008-2009,2008-11-21,2009-03-04,104,0,2,100,102,9,11,20,122,5,19,NC - Greensboro
59,2009-2010,2009-12-01,2010-03-03,93,0,3,112,115,23,28,51,166,8,34,NC - Greensboro
60,2010-2011,2010-12-01,2011-02-28,90,0,6,107,113,16,14,30,143,7,26,NC - Greensboro
61,2011-2012,2011-12-01,2012-02-29,91,0,0,49,49,2,2,4,53,1,3,NC - Greensboro
62,2012-2013,2012-12-01,2013-02-28,90,0,1,56,57,6,5,11,68,3,9,NC - Greensboro
63,2013-2014,2013-12-01,2014-03-17,107,0,7,121,128,24,16,40,168,8,39,NC - Greensboro
64,2014-2015,2014-12-01,2015-03-01,91,0,8,103,111,13,15,28,139,5,27,NC - Greensboro
65,2015-2016,2015-12-01,2016-02-29,91,0,5,71,76,7,5,12,88,3,15,NC - Greensboro
66,2016-2017,2016-12-01,2017-02-28,90,0,4,50,54,12,20,32,86,2,17,NC - Greensboro
67,2017-2018,2017-12-01,2018-03-25,115,0,9,120,129,21,19,40,169,7,31,NC - Greensboro
68,2018-2019,2018-12-01,2019-02-28,90,0,1,61,62,19,27,46,108,2,21,NC - Greensboro
69,2019-2020,2019-12-01,2020-02-29,91,0,0,44,44,3,1,4,48,1,4,NC - Greensboro
1,1951-1952,1951-12-01,1952-02-29,91,0,0,40,40,1,0,1,41,1,2,NC - Laurinburg
2,1952-1953,1952-12-01,1953-02-28,90,2,0,36,36,0,0,0,36,0,0,NC - Laurinburg
3,1953-1954,1953-12-01,1954-02-28,90,1,0,51,51,0,0,0,51,0,0,NC - Laurinburg
4,1954-1955,1954-12-01,1955-02-28,90,3,0,70,70,9,0,9,79,2,11,NC - Laurinburg
5,1955-1956,1955-12-01,1956-02-29,91,7,0,66,66,0,0,0,66,0,0,NC - Laurinburg
6,1956-1957,1956-12-01,1957-02-28,90,0,0,37,37,0,0,0,37,0,0,NC - Laurinburg
7,1957-1958,1957-12-01,1958-02-28,90,6,3,92,95,0,1,1,96,0,0,NC - Laurinburg
8,1958-1959,1958-12-01,1959-02-28,90,4,0,87,87,0,6,6,93,0,0,NC - Laurinburg
9,1959-1960,1959-12-01,1960-03-12,103,14,0,75,75,12,0,12,87,4,17,NC - Laurinburg
10,1960-1961,1960-12-01,1961-02-28,90,4,3,97,100,2,0,2,102,1,5,NC - Laurinburg
11,1961-1962,1961-12-01,1962-02-28,90,6,1,63,64,0,3,3,67,0,0,NC - Laurinburg
12,1962-1963,1962-12-01,1963-02-28,90,2,1,112,113,0,0,0,113,0,0,NC - Laurinburg
13,1963-1964,1963-12-01,1964-02-29,91,5,0,95,95,0,0,0,95,0,0,NC - Laurinburg
14,1964-1965,1964-12-01,1965-02-28,90,3,1,65,66,4,3,7,73,2,8,NC - Laurinburg
15,1965-1966,1965-12-01,1966-02-28,90,11,2,72,74,0,0,0,74,0,0,NC - Laurinburg
16,1966-1967,1966-12-01,1967-02-28,90,3,0,67,67,0,2,2,69,0,0,NC - Laurinburg
17,1967-1968,1967-12-01,1968-02-29,91,1,3,93,96,3,1,4,100,2,8,NC - Laurinburg
18,1968-1969,1968-12-01,1969-02-28,90,1,1,81,82,3,2,5,87,1,4,NC - Laurinburg
19,1969-1970,1969-12-01,1970-02-28,90,0,3,95,98,5,1,6,104,4,14,NC - Laurinburg
20,1970-1971,1970-12-01,1971-03-27,117,0,0,88,88,7,1,8,96,3,12,NC - Laurinburg
21,1971-1972,1971-12-01,1972-02-29,91,0,0,44,44,3,2,5,49,1,4,NC - Laurinburg
22,1972-1973,1972-12-01,1973-02-28,90,0,1,73,74,20,23,43,117,4,30,NC - Laurinburg
23,1973-1974,1973-12-01,1974-02-28,90,0,0,43,43,4,3,7,50,1,5,NC - Laurinburg
24,1974-1975,1974-12-01,1975-02-28,90,0,0,37,37,0,0,0,37,0,0,NC - Laurinburg
25,1975-1976,1975-12-01,1976-02-29,91,0,0,67,67,0,0,0,67,0,0,NC - Laurinburg
26,1976-1977,1976-12-01,1977-02-28,90,0,2,121,123,0,0,0,123,0,0,NC - Laurinburg
27,1977-1978,1977-12-01,1978-02-28,90,0,0,103,103,0,0,0,103,0,0,NC - Laurinburg
28,1978-1979,1978-12-01,1979-02-28,90,0,1,88,89,6,13,19,108,2,14,NC - Laurinburg
29,1979-1980,1979-12-01,1980-03-04,95,0,2,81,83,23,14,37,120,3,31,NC - Laurinburg
30,1980-1981,1980-12-01,1981-02-28,90,1,1,106,107,2,0,2,109,1,6,NC - Laurinburg
31,1981-1982,1981-12-01,1982-02-28,90,2,2,80,82,4,3,7,89,2,8,NC - Laurinburg
33,1983-1984,1983-12-01,1984-02-29,91,0,2,74,76,0,0,0,76,0,0,NC - Laurinburg
35,1985-1986,1985-12-01,1986-02-28,90,0,1,77,78,0,0,0,78,0,0,NC - Laurinburg
36,1986-1987,1986-12-01,1987-02-28,90,2,0,52,52,3,2,5,57,1,4,NC - Laurinburg
37,1987-1988,1987-12-01,1988-02-29,91,1,1,80,81,7,25,32,113,1,10,NC - Laurinburg
38,1988-1989,1988-12-01,1989-02-28,90,0,0,55,55,3,0,3,58,1,4,NC - Laurinburg
39,1989-1990,1989-12-01,1990-02-28,90,0,4,85,89,2,1,3,92,1,8,NC - Laurinburg
40,1990-1991,1990-12-01,1991-02-28,90,1,0,42,42,0,0,0,42,0,0,NC - Laurinburg
41,1991-1992,1991-12-01,1992-02-29,91,1,0,49,49,0,0,0,49,0,0,NC - Laurinburg
42,1992-1993,1992-12-01,1993-02-28,90,2,0,47,47,0,0,0,47,0,0,NC - Laurinburg
43,1993-1994,1993-12-01,1994-02-28,90,1,4,83,87,0,1,1,88,0,0,NC - Laurinburg
44,1994-1995,1994-12-01,1995-02-28,90,6,0,59,59,0,0,0,59,0,0,NC - Laurinburg
46,1996-1997,1996-12-01,1997-02-28,90,0,1,58,59,0,0,0,59,0,0,NC - Laurinburg
47,1997-1998,1997-12-01,1998-02-28,90,6,0,32,32,0,0,0,32,0,0,NC - Laurinburg
48,1998-1999,1998-12-01,1999-02-28,90,2,1,41,42,0,0,0,42,0,0,NC - Laurinburg
49,1999-2000,1999-12-01,2000-02-29,91,4,0,61,61,0,38,38,99,0,0,NC - Laurinburg
50,2000-2001,2000-12-01,2001-02-28,90,5,0,79,79,0,0,0,79,0,0,NC - Laurinburg
51,2001-2002,2001-12-01,2002-02-28,90,16,1,59,60,0,0,0,60,0,0,NC - Laurinburg
52,2002-2003,2002-12-01,2003-02-28,90,5,1,71,72,0,0,0,72,0,0,NC - Laurinburg
53,2003-2004,2003-12-01,2004-02-29,91,11,2,79,81,0,7,7,88,0,0,NC - Laurinburg
54,2004-2005,2004-12-01,2005-02-28,90,5,1,65,66,0,0,0,66,0,0,NC - Laurinburg
55,2005-2006,2005-12-01,2006-02-28,90,0,0,55,55,0,0,0,55,0,0,NC - Laurinburg
56,2006-2007,2006-12-01,2007-02-28,90,5,0,58,58,0,0,0,58,0,0,NC - Laurinburg
57,2007-2008,2007-12-01,2008-02-29,91,0,0,52,52,2,0,2,54,1,5,NC - Laurinburg
58,2008-2009,2008-12-01,2009-02-28,90,2,2,65,67,2,3,5,72,1,3,NC - Laurinburg
59,2009-2010,2009-12-01,2010-02-28,90,6,1,79,80,5,5,10,90,2,7,NC - Laurinburg
60,2010-2011,2010-12-01,2011-02-28,90,1,1,103,104,13,21,34,138,3,18,NC - Laurinburg
61,2011-2012,2011-12-01,2012-02-29,91,0,0,41,41,0,0,0,41,0,0,NC - Laurinburg
62,2012-2013,2012-12-01,2013-02-28,90,15,1,51,52,0,0,0,52,0,0,NC - Laurinburg
63,2013-2014,2013-12-01,2014-02-28,90,7,4,79,83,13,15,28,111,4,21,NC - Laurinburg
64,2014-2015,2014-12-01,2015-02-28,90,9,3,83,86,2,0,2,88,2,7,NC - Laurinburg
65,2015-2016,2015-12-01,2016-02-29,91,5,1,42,43,1,0,1,44,1,2,NC - Laurinburg
66,2016-2017,2016-12-01,2017-03-12,102,15,2,32,34,1,0,1,35,1,2,NC - Laurinburg
67,2017-2018,2017-12-01,2018-02-28,90,1,3,84,87,6,4,10,97,1,10,NC - Laurinburg
68,2018-2019,2018-12-01,2019-02-28,90,6,0,28,28,0,0,0,28,0,0,NC - Laurinburg
69,2019-2020,2019-12-01,2020-02-29,91,0,0,32,32,0,0,0,32,0,0,NC - Laurinburg
0,1950-1951,1950-12-01,1951-02-28,90,1,1,95,96,11,9,20,116,2,14,NC - Plymouth
2,1952-1953,1952-12-01,1953-02-28,90,2,0,44,44,0,0,0,44,0,0,NC - Plymouth
3,1953-1954,1953-12-01,1954-02-28,90,0,0,76,76,0,0,0,76,0,0,NC - Plymouth
4,1954-1955,1954-12-01,1955-02-28,90,2,0,104,104,6,2,8,112,3,9,NC - Plymouth
5,1955-1956,1955-12-01,1956-02-29,91,1,0,81,81,3,4,7,88,2,4,NC - Plymouth
6,1956-1957,1956-12-01,1957-02-28,90,0,1,51,52,0,0,0,52,0,0,NC - Plymouth
8,1958-1959,1958-12-01,1959-02-28,90,2,1,107,108,20,41,61,169,3,25,NC - Plymouth
9,1959-1960,1959-11-29,1960-03-10,103,5,0,68,68,20,0,20,88,5,27,NC - Plymouth
10,1960-1961,1960-12-01,1961-02-28,90,5,5,118,123,1,0,1,124,1,4,NC - Plymouth
11,1961-1962,1961-12-01,1962-03-07,97,6,3,80,83,15,19,34,117,5,24,NC - Plymouth
12,1962-1963,1962-12-01,1963-02-28,90,4,1,116,117,9,0,9,126,2,13,NC - Plymouth
13,1963-1964,1963-12-01,1964-02-29,91,2,1,85,86,0,0,0,86,0,0,NC - Plymouth
14,1964-1965,1964-12-01,1965-02-28,90,0,1,79,80,10,12,22,102,3,17,NC - Plymouth
15,1965-1966,1965-12-01,1966-02-28,90,1,0,95,95,8,24,32,127,3,13,NC - Plymouth
16,1966-1967,1966-12-01,1967-02-28,90,0,0,70,70,3,0,3,73,1,4,NC - Plymouth
17,1967-1968,1967-12-01,1968-02-29,91,1,5,105,110,3,8,11,121,1,7,NC - Plymouth
18,1968-1969,1968-12-01,1969-02-28,90,3,0,86,86,0,0,0,86,0,0,NC - Plymouth
19,1969-1970,1969-12-01,1970-02-28,90,1,5,109,114,2,0,2,116,1,5,NC - Plymouth
20,1970-1971,1970-12-01,1971-03-27,117,0,1,112,113,7,0,7,120,3,11,NC - Plymouth
21,1971-1972,1971-12-01,1972-02-29,91,0,0,50,50,0,0,0,50,0,0,NC - Plymouth
22,1972-1973,1972-12-01,1973-02-28,90,0,3,89,92,15,32,47,139,2,21,NC - Plymouth
23,1973-1974,1973-12-01,1974-02-28,90,1,0,42,42,2,2,4,46,1,3,NC - Plymouth
24,1974-1975,1974-12-01,1975-02-28,90,1,0,58,58,0,0,0,58,0,0,NC - Plymouth
25,1975-1976,1975-12-01,1976-02-29,91,0,3,84,87,3,7,10,97,1,5,NC - Plymouth
26,1976-1977,1976-12-01,1977-02-28,90,1,2,154,156,2,0,2,158,1,3,NC - Plymouth
27,1977-1978,1977-12-01,1978-02-28,90,1,1,138,139,9,7,16,155,2,13,NC - Plymouth
28,1978-1979,1978-12-01,1979-02-28,90,1,2,114,116,9,4,13,129,3,20,NC - Plymouth
29,1979-1980,1979-12-01,1980-03-05,96,12,2,107,109,31,49,80,189,5,43,NC - Plymouth
30,1980-1981,1980-12-01,1981-02-28,90,3,2,124,126,3,2,5,131,1,6,NC - Plymouth
31,1981-1982,1981-12-01,1982-02-28,90,9,3,102,105,0,0,0,105,0,0,NC - Plymouth
32,1982-1983,1982-12-01,1983-03-25,115,4,0,62,62,10,1,11,73,2,12,NC - Plymouth
33,1983-1984,1983-12-01,1984-02-29,91,6,6,95,101,0,0,0,101,0,0,NC - Plymouth
34,1984-1985,1984-12-01,1985-02-28,90,6,3,98,101,6,2,8,109,2,12,NC - Plymouth
35,1985-1986,1985-12-01,1986-02-28,90,2,0,94,94,0,0,0,94,0,0,NC - Plymouth
37,1987-1988,1987-12-01,1988-02-29,91,10,1,67,68,0,0,0,68,0,0,NC - Plymouth
38,1988-1989,1988-12-01,1989-02-28,90,5,0,51,51,8,0,8,59,2,10,NC - Plymouth
39,1989-1990,1989-12-01,1990-02-28,90,2,4,59,63,9,5,14,77,1,14,NC - Plymouth
40,1990-1991,1990-12-01,1991-02-28,90,5,0,29,29,0,0,0,29,0,0,NC - Plymouth
41,1991-1992,1991-12-01,1992-02-29,91,4,0,46,46,0,0,0,46,0,0,NC - Plymouth
42,1992-1993,1992-12-01,1993-02-28,90,3,0,41,41,0,0,0,41,0,0,NC - Plymouth
43,1993-1994,1993-12-01,1994-02-28,90,8,2,73,75,0,0,0,75,0,0,NC - Plymouth
44,1994-1995,1994-12-01,1995-02-28,90,2,1,48,49,4,2,6,55,1,5,NC - Plymouth
45,1995-1996,1995-12-01,1996-02-29,91,6,4,81,85,0,10,10,95,0,0,NC - Plymouth
46,1996-1997,1996-12-01,1997-02-28,90,3,1,45,46,0,0,0,46,0,0,NC - Plymouth
47,1997-1998,1997-12-01,1998-02-28,90,0,0,25,25,0,0,0,25,0,0,NC - Plymouth
48,1998-1999,1998-12-01,1999-02-28,90,0,0,40,40,0,0,0,40,0,0,NC - Plymouth
49,1999-2000,1999-12-01,2000-02-29,91,15,0,66,66,0,3,3,69,0,0,NC - Plymouth
50,2000-2001,2000-12-01,2001-02-28,90,5,0,75,75,0,15,15,90,0,0,NC - Plymouth
51,2001-2002,2001-12-01,2002-02-28,90,3,0,38,38,0,5,5,43,0,0,NC - Plymouth
52,2002-2003,2002-12-01,2003-02-28,90,17,3,72,75,6,4,10,85,1,10,NC - Plymouth
53,2003-2004,2003-12-01,2004-02-29,91,12,1,72,73,8,0,8,81,3,12,NC - Plymouth
54,2004-2005,2004-12-01,2005-02-28,90,5,2,61,63,4,0,4,67,2,10,NC - Plymouth
55,2005-2006,2005-12-01,2006-02-28,90,0,0,35,35,0,0,0,35,0,0,NC - Plymouth
56,2006-2007,2006-12-01,2007-02-28,90,1,0,57,57,0,0,0,57,0,0,NC - Plymouth
57,2007-2008,2007-12-01,2008-02-29,91,4,0,42,42,1,1,2,44,1,2,NC - Plymouth
58,2008-2009,2008-11-21,2009-03-03,103,4,1,82,83,1,4,5,88,1,2,NC - Plymouth
59,2009-2010,2009-12-01,2010-02-28,90,4,0,77,77,0,0,0,77,0,0,NC - Plymouth
67,2017-2018,2017-12-01,2018-02-28,90,0,5,81,86,13,20,33,119,2,18,NC - Plymouth
68,2018-2019,2018-12-01,2019-02-28,90,0,0,41,41,0,0,0,41,0,0,NC - Plymouth
69,2019-2020,2019-12-01,2020-02-29,91,0,0,29,29,2,1,3,32,1,3,NC - Plymouth
0,1950-1951,1950-12-01,1951-02-28,90,0,4,99,103,3,1,4,107,2,9,NC - Raleigh
1,1951-1952,1951-12-01,1952-03-15,106,0,1,71,72,6,2,8,80,2,8,NC - Raleigh
2,1952-1953,1952-12-01,1953-02-28,90,0,0,49,49,0,0,0,49,0,0,NC - Raleigh
3,1953-1954,1953-11-06,1954-02-28,115,0,1,92,93,11,14,25,118,4,19,NC - Raleigh
4,1954-1955,1954-12-01,1955-02-28,90,0,1,103,104,24,25,49,153,5,30,NC - Raleigh
5,1955-1956,1955-12-01,1956-02-29,91,0,1,87,88,3,1,4,92,1,4,NC - Raleigh
6,1956-1957,1956-12-01,1957-02-28,90,0,2,61,63,0,0,0,63,0,0,NC - Raleigh
7,1957-1958,1957-12-01,1958-02-28,90,0,8,117,125,11,7,18,143,4,17,NC - Raleigh
8,1958-1959,1958-12-01,1959-02-28,90,0,6,121,127,19,32,51,178,4,31,NC - Raleigh
9,1959-1960,1959-12-01,1960-03-17,108,0,5,112,117,25,63,88,205,4,35,NC - Raleigh
10,1960-1961,1960-12-01,1961-02-28,90,0,8,124,132,7,7,14,146,4,20,NC - Raleigh
11,1961-1962,1961-12-01,1962-03-09,99,0,3,109,112,22,17,39,151,8,34,NC - Raleigh
12,1962-1963,1962-11-25,1963-02-28,96,0,7,147,154,12,9,21,175,3,19,NC - Raleigh
13,1963-1964,1963-12-01,1964-02-29,91,0,3,115,118,8,1,9,127,5,16,NC - Raleigh
14,1964-1965,1964-11-30,1965-02-28,91,0,3,116,119,17,25,42,161,7,38,NC - Raleigh
15,1965-1966,1965-12-01,1966-02-28,90,3,5,103,108,18,44,62,170,6,32,NC - Raleigh
16,1966-1967,1966-12-01,1967-02-28,90,0,1,84,85,16,12,28,113,3,21,NC - Raleigh
17,1967-1968,1967-12-01,1968-03-01,92,0,4,122,126,9,9,18,144,5,20,NC - Raleigh
18,1968-1969,1968-11-12,1969-03-04,113,0,1,126,127,18,13,31,158,5,23,NC - Raleigh
19,1969-1970,1969-12-01,1970-02-28,90,0,10,163,173,4,2,6,179,2,10,NC - Raleigh
20,1970-1971,1970-12-01,1971-03-27,117,0,8,127,135,10,5,15,150,4,18,NC - Raleigh
21,1971-1972,1971-12-01,1972-03-26,117,0,4,78,82,10,6,16,98,5,16,NC - Raleigh
22,1972-1973,1972-12-01,1973-03-21,111,0,7,97,104,15,34,49,153,4,26,NC - Raleigh
23,1973-1974,1973-12-01,1974-03-25,115,0,3,63,66,7,8,15,81,3,13,NC - Raleigh
24,1974-1975,1974-12-01,1975-03-10,100,0,0,82,82,1,0,1,83,1,2,NC - Raleigh
25,1975-1976,1975-11-23,1976-02-29,99,0,2,95,97,4,0,4,101,2,6,NC - Raleigh
26,1976-1977,1976-11-30,1977-02-28,91,0,8,209,217,5,3,8,225,3,14,NC - Raleigh
27,1977-1978,1977-12-01,1978-03-03,93,0,2,155,157,16,16,32,189,7,29,NC - Raleigh
28,1978-1979,1978-12-01,1979-02-28,90,0,4,111,115,24,36,60,175,6,42,NC - Raleigh
29,1979-1980,1979-12-01,1980-03-05,96,0,6,112,118,28,27,55,173,8,51,NC - Raleigh
30,1980-1981,1980-12-01,1981-02-28,90,0,7,147,154,7,7,14,168,2,14,NC - Raleigh
31,1981-1982,1981-12-01,1982-02-28,90,0,8,84,92,10,20,30,122,3,16,NC - Raleigh
32,1982-1983,1982-12-01,1983-04-18,139,0,1,83,84,17,5,22,106,5,22,NC - Raleigh
33,1983-1984,1983-12-01,1984-02-29,91,0,7,104,111,9,4,13,124,1,11,NC - Raleigh
34,1984-1985,1984-12-01,1985-02-28,90,0,6,102,108,5,6,11,119,2,13,NC - Raleigh
35,1985-1986,1985-12-01,1986-02-28,90,0,4,103,107,3,1,4,111,3,11,NC - Raleigh
36,1986-1987,1986-12-01,1987-02-28,90,0,3,82,85,16,27,43,128,5,27,NC - Raleigh
37,1987-1988,1987-11-11,1988-02-29,111,0,6,112,118,12,29,41,159,3,22,NC - Raleigh
38,1988-1989,1988-12-01,1989-04-11,132,0,3,76,79,17,19,36,115,7,29,NC - Raleigh
39,1989-1990,1989-12-01,1990-02-28,90,0,9,73,82,4,4,8,90,3,8,NC - Raleigh
40,1990-1991,1990-12-01,1991-02-28,90,0,0,53,53,0,0,0,53,0,0,NC - Raleigh
41,1991-1992,1991-12-01,1992-02-29,91,0,0,55,55,0,0,0,55,0,0,NC - Raleigh
42,1992-1993,1992-12-01,1993-03-14,104,0,0,67,67,5,1,6,73,5,11,NC - Raleigh
43,1993-1994,1993-12-01,1994-03-03,93,0,9,107,116,7,4,11,127,5,14,NC - Raleigh
44,1994-1995,1994-12-01,1995-02-28,90,0,1,62,63,5,1,6,69,4,12,NC - Raleigh
45,1995-1996,1995-12-01,1996-03-08,99,0,11,101,112,19,35,54,166,7,41,NC - Raleigh
46,1996-1997,1996-12-01,1997-02-28,90,0,2,68,70,1,0,1,71,1,3,NC - Raleigh
47,1997-1998,1997-12-01,1998-02-28,90,0,0,50,50,5,0,5,55,3,8,NC - Raleigh
48,1998-1999,1998-12-01,1999-02-28,90,0,1,59,60,0,0,0,60,0,0,NC - Raleigh
49,1999-2000,1999-12-01,2000-02-29,91,0,5,95,100,33,66,99,199,5,43,NC - Raleigh
50,2000-2001,2000-11-19,2001-02-28,102,0,0,102,102,5,2,7,109,3,8,NC - Raleigh
51,2001-2002,2001-12-01,2002-02-28,90,0,2,67,69,15,24,39,108,2,20,NC - Raleigh
52,2002-2003,2002-12-01,2003-02-28,90,0,4,89,93,11,10,21,114,5,25,NC - Raleigh
53,2003-2004,2003-12-01,2004-02-29,91,0,4,95,99,21,12,33,132,7,32,NC - Raleigh
54,2004-2005,2004-12-01,2005-03-17,107,0,3,90,93,2,0,2,95,2,7,NC - Raleigh
55,2005-2006,2005-12-01,2006-02-28,90,0,1,60,61,0,0,0,61,0,0,NC - Raleigh
56,2006-2007,2006-12-01,2007-02-28,90,0,0,65,65,3,0,3,68,2,5,NC - Raleigh
57,2007-2008,2007-12-01,2008-02-29,91,0,0,51,51,1,1,2,53,1,1,NC - Raleigh
58,2008-2009,2008-11-21,2009-03-03,103,0,1,78,79,9,8,17,96,3,14,NC - Raleigh
59,2009-2010,2009-12-01,2010-03-03,93,0,3,100,103,14,14,28,131,8,23,NC - Raleigh
60,2010-2011,2010-12-01,2011-02-28,90,0,2,95,97,14,10,24,121,6,20,NC - Raleigh
61,2011-2012,2011-12-01,2012-02-29,91,0,0,42,42,1,1,2,44,1,1,NC - Raleigh
62,2012-2013,2012-12-01,2013-02-28,90,0,1,47,48,4,1,5,53,4,9,NC - Raleigh
63,2013-2014,2013-12-01,2014-03-03,93,0,5,92,97,10,4,14,111,6,25,NC - Raleigh
64,2014-2015,2014-12-01,2015-03-01,91,0,7,97,104,11,11,22,126,6,29,NC - Raleigh
65,2015-2016,2015-12-01,2016-02-29,91,0,5,56,61,3,3,6,67,2,7,NC - Raleigh
66,2016-2017,2016-12-01,2017-03-12,102,0,4,48,52,2,3,5,57,2,6,NC - Raleigh
67,2017-2018,2017-12-01,2018-03-24,114,0,8,106,114,13,12,25,139,6,28,NC - Raleigh
68,2018-2019,2018-12-01,2019-02-28,90,0,1,49,50,12,7,19,69,2,14,NC - Raleigh
69,2019-2020,2019-12-01,2020-02-29,91,0,0,36,36,3,2,5,41,1,3,NC - Raleigh
0,1950-1951,1950-12-01,1951-02-28,90,0,1,31,32,5,4,9,41,2,9,NC - Wilmington
1,1951-1952,1951-12-01,1952-02-29,91,0,0,28,28,0,0,0,28,0,0,NC - Wilmington
2,1952-1953,1952-12-01,1953-02-28,90,0,0,19,19,0,0,0,19,0,0,NC - Wilmington
3,1953-1954,1953-12-01,1954-02-28,90,1,0,28,28,0,0,0,28,0,0,NC - Wilmington
4,1954-1955,1954-12-01,1955-02-28,90,0,0,54,54,1,0,1,55,1,3,NC - Wilmington
5,1955-1956,1955-12-01,1956-02-29,91,0,0,47,47,1,1,2,49,1,2,NC - Wilmington
6,1956-1957,1956-12-01,1957-02-28,90,0,0,29,29,0,0,0,29,0,0,NC - Wilmington
7,1957-1958,1957-12-01,1958-02-28,90,0,3,70,73,5,3,8,81,2,7,NC - Wilmington
8,1958-1959,1958-12-01,1959-02-28,90,0,0,59,59,5,5,10,69,2,8,NC - Wilmington
9,1959-1960,1959-12-01,1960-03-12,103,1,1,49,50,8,4,12,62,3,12,NC - Wilmington
10,1960-1961,1960-12-01,1961-02-28,90,0,2,64,66,0,0,0,66,0,0,NC - Wilmington
11,1961-1962,1961-12-01,1962-03-07,97,0,2,50,52,6,2,8,60,4,12,NC - Wilmington
12,1962-1963,1962-12-01,1963-02-28,90,0,2,80,82,3,1,4,86,3,10,NC - Wilmington
13,1963-1964,1963-12-01,1964-02-29,91,0,0,46,46,0,0,0,46,0,0,NC - Wilmington
14,1964-1965,1964-12-01,1965-03-06,96,0,1,48,49,6,3,9,58,4,11,NC - Wilmington
15,1965-1966,1965-12-01,1966-02-28,90,0,1,47,48,0,0,0,48,0,0,NC - Wilmington
16,1966-1967,1966-12-01,1967-02-28,90,0,1,35,36,0,0,0,36,0,0,NC - Wilmington
17,1967-1968,1967-12-01,1968-02-29,91,0,1,60,61,6,3,9,70,3,9,NC - Wilmington
18,1968-1969,1968-12-01,1969-02-28,90,0,1,59,60,2,0,2,62,2,4,NC - Wilmington
19,1969-1970,1969-12-01,1970-02-28,90,0,4,70,74,4,2,6,80,3,10,NC - Wilmington
20,1970-1971,1970-12-01,1971-02-28,90,0,0,41,41,6,2,8,49,1,7,NC - Wilmington
21,1971-1972,1971-12-01,1972-02-29,91,0,0,24,24,0,0,0,24,0,0,NC - Wilmington
22,1972-1973,1972-12-01,1973-02-28,90,0,0,43,43,19,29,48,91,4,23,NC - Wilmington
23,1973-1974,1973-12-01,1974-02-28,90,0,0,24,24,1,0,1,25,1,2,NC - Wilmington
24,1974-1975,1974-12-01,1975-02-28,90,0,0,17,17,0,0,0,17,0,0,NC - Wilmington
25,1975-1976,1975-12-01,1976-02-29,91,0,1,41,42,0,0,0,42,0,0,NC - Wilmington
26,1976-1977,1976-12-01,1977-02-28,90,0,2,89,91,2,0,2,93,2,5,NC - Wilmington
27,1977-1978,1977-12-01,1978-02-28,90,0,0,74,74,0,0,0,74,0,0,NC - Wilmington
28,1978-1979,1978-12-01,1979-02-28,90,0,0,59,59,1,0,1,60,1,3,NC - Wilmington
29,1979-1980,1979-12-01,1980-03-05,96,0,2,68,70,10,15,25,95,4,21,NC - Wilmington
30,1980-1981,1980-12-01,1981-02-28,90,0,1,95,96,2,0,2,98,1,4,NC - Wilmington
31,1981-1982,1981-12-01,1982-02-28,90,0,1,68,69,1,0,1,70,1,2,NC - Wilmington
32,1982-1983,1982-12-01,1983-03-25,115,0,0,41,41,5,4,9,50,2,7,NC - Wilmington
33,1983-1984,1983-12-01,1984-02-29,91,0,1,59,60,0,0,0,60,0,0,NC - Wilmington
34,1984-1985,1984-12-01,1985-02-28,90,0,1,41,42,0,0,0,42,0,0,NC - Wilmington
35,1985-1986,1985-12-01,1986-02-28,90,0,1,49,50,0,0,0,50,0,0,NC - Wilmington
36,1986-1987,1986-12-01,1987-02-28,90,0,0,30,30,0,0,0,30,0,0,NC - Wilmington
37,1987-1988,1987-12-01,1988-02-29,91,0,0,53,53,8,4,12,65,2,13,NC - Wilmington
38,1988-1989,1988-12-01,1989-02-28,90,0,0,34,34,4,2,6,40,3,9,NC - Wilmington
39,1989-1990,1989-12-01,1990-02-28,90,0,4,51,55,21,41,62,117,3,34,NC - Wilmington
40,1990-1991,1990-12-01,1991-02-28,90,0,0,20,20,0,0,0,20,0,0,NC - Wilmington
41,1991-1992,1991-12-01,1992-02-29,91,0,0,30,30,2,1,3,33,1,3,NC - Wilmington
42,1992-1993,1992-12-01,1993-02-28,90,0,0,23,23,0,0,0,23,0,0,NC - Wilmington
43,1993-1994,1993-12-01,1994-02-28,90,0,2,51,53,1,0,1,54,1,2,NC - Wilmington
44,1994-1995,1994-12-01,1995-02-28,90,0,0,29,29,0,0,0,29,0,0,NC - Wilmington
45,1995-1996,1995-12-01,1996-02-29,91,4,2,68,70,2,0,2,72,2,7,NC - Wilmington
46,1996-1997,1996-12-01,1997-02-28,90,0,0,33,33,2,0,2,35,1,3,NC - Wilmington
47,1997-1998,1997-12-01,1998-02-28,90,0,0,20,20,0,0,0,20,0,0,NC - Wilmington
48,1998-1999,1998-12-01,1999-02-28,90,0,0,23,23,0,0,0,23,0,0,NC - Wilmington
49,1999-2000,1999-12-01,2000-02-29,91,0,0,33,33,9,6,15,48,2,11,NC - Wilmington
50,2000-2001,2000-12-01,2001-02-28,90,0,0,57,57,1,0,1,58,1,2,NC - Wilmington
51,2001-2002,2001-12-01,2002-02-28,90,0,0,29,29,3,2,5,34,2,5,NC - Wilmington
52,2002-2003,2002-12-01,2003-02-28,90,0,1,51,52,4,1,5,57,1,8,NC - Wilmington
53,2003-2004,2003-12-01,2004-02-29,91,0,0,59,59,0,0,0,59,0,0,NC - Wilmington
54,2004-2005,2004-12-01,2005-02-28,90,0,1,54,55,0,0,0,55,0,0,NC - Wilmington
55,2005-2006,2005-12-01,2006-02-28,90,0,0,35,35,0,0,0,35,0,0,NC - Wilmington
56,2006-2007,2006-12-01,2007-02-28,90,0,0,37,37,0,0,0,37,0,0,NC - Wilmington
57,2007-2008,2007-12-01,2008-02-29,91,0,0,29,29,0,0,0,29,0,0,NC - Wilmington
58,2008-2009,2008-12-01,2009-02-28,90,0,1,46,47,2,1,3,50,2,4,NC - Wilmington
59,2009-2010,2009-12-01,2010-02-28,90,0,0,63,63,5,3,8,71,2,7,NC - Wilmington
60,2010-2011,2010-12-01,2011-02-28,90,0,2,70,72,6,5,11,83,3,12,NC - Wilmington
61,2011-2012,2011-12-01,2012-02-29,91,0,0,20,20,0,0,0,20,0,0,NC - Wilmington
62,2012-2013,2012-12-01,2013-02-28,90,0,0,26,26,0,0,0,26,0,0,NC - Wilmington
63,2013-2014,2013-12-01,2014-02-28,90,0,2,47,49,2,3,5,54,2,7,NC - Wilmington
64,2014-2015,2014-12-01,2015-02-28,90,0,3,57,60,1,0,1,61,1,3,NC - Wilmington
65,2015-2016,2015-12-01,2016-02-29,91,0,0,31,31,0,0,0,31,0,0,NC - Wilmington
66,2016-2017,2016-12-01,2017-03-12,102,0,1,33,34,2,0,2,36,1,3,NC - Wilmington
67,2017-2018,2017-12-01,2018-02-28,90,0,2,52,54,5,14,19,73,2,10,NC - Wilmington
68,2018-2019,2018-12-01,2019-02-28,90,0,0,30,30,0,0,0,30,0,0,NC - Wilmington
69,2019-2020,2019-12-01,2020-02-29,91,0,0,14,14,0,0,0,14,0,0,NC - Wilmington
0,1950-1951,1950-10-01,1951-04-20,202,1,371,1006,1377,80,549,629,2006,48,470,ND - Bismarck
1,1951-1952,1951-10-29,1952-04-04,159,0,343,930,1273,82,654,736,2009,50,512,ND - Bismarck
2,1952-1953,1952-11-24,1953-05-11,169,0,136,610,746,67,123,190,936,41,285,ND - Bismarck
3,1953-1954,1953-11-07,1954-04-04,149,1,186,630,816,48,129,177,993,33,266,ND - Bismarck
4,1954-1955,1954-10-25,1955-04-05,163,0,185,678,863,42,122,164,1027,36,296,ND - Bismarck
5,1955-1956,1955-10-27,1956-04-27,184,0,377,995,1372,69,602,671,2043,34,353,ND - Bismarck
6,1956-1957,1956-11-02,1957-04-11,161,0,239,753,992,50,128,178,1170,41,379,ND - Bismarck
7,1957-1958,1957-10-24,1958-05-01,190,0,174,623,797,44,175,219,1016,28,186,ND - Bismarck
8,1958-1959,1958-11-15,1959-04-18,155,0,301,791,1092,63,385,448,1540,34,330,ND - Bismarck
9,1959-1960,1959-10-08,1960-05-03,209,0,249,715,964,78,248,326,1290,43,326,ND - Bismarck
10,1960-1961,1960-11-09,1961-04-27,170,0,155,596,751,57,133,190,941,30,226,ND - Bismarck
11,1961-1962,1961-11-04,1962-04-11,159,1,280,811,1091,47,219,266,1357,36,331,ND - Bismarck
12,1962-1963,1962-11-14,1963-04-19,157,0,211,673,884,40,92,132,1016,32,221,ND - Bismarck
13,1963-1964,1963-11-13,1964-04-07,147,0,178,742,920,45,143,188,1108,27,262,ND - Bismarck
14,1964-1965,1964-10-28,1965-05-26,211,0,393,978,1371,84,495,579,1950,44,468,ND - Bismarck
15,1965-1966,1965-09-16,1966-05-11,238,0,272,843,1115,70,234,304,1419,31,285,ND - Bismarck
16,1966-1967,1966-10-21,1967-05-11,203,0,239,901,1140,100,315,415,1555,52,501,ND - Bismarck
17,1967-1968,1967-10-27,1968-05-18,205,0,247,835,1082,60,216,276,1358,39,340,ND - Bismarck
18,1968-1969,1968-11-06,1969-04-27,173,0,323,826,1149,86,654,740,1889,48,457,ND - Bismarck
19,1969-1970,1969-10-11,1970-04-23,195,0,246,838,1084,95,471,566,1650,58,489,ND - Bismarck
20,1970-1971,1970-10-27,1971-04-27,183,0,297,815,1112,72,381,453,1565,47,347,ND - Bismarck
21,1971-1972,1971-10-28,1972-04-11,167,1,314,816,1130,87,394,481,1611,54,519,ND - Bismarck
22,1972-1973,1972-10-17,1973-04-15,181,0,207,651,858,38,176,214,1072,24,182,ND - Bismarck
23,1973-1974,1973-10-11,1974-04-13,185,0,274,858,1132,58,388,446,1578,44,376,ND - Bismarck
24,1974-1975,1974-11-01,1975-04-16,167,0,205,764,969,91,287,378,1347,41,374,ND - Bismarck
25,1975-1976,1975-11-11,1976-04-03,145,0,165,638,803,47,242,289,1092,32,227,ND - Bismarck
26,1976-1977,1976-10-17,1977-04-03,169,0,242,796,1038,59,198,257,1295,43,429,ND - Bismarck
27,1977-1978,1977-10-07,1978-04-17,193,3,394,854,1248,105,708,813,2061,53,517,ND - Bismarck
28,1978-1979,1978-11-10,1979-05-10,182,0,426,1024,1450,130,856,986,2436,62,651,ND - Bismarck
29,1979-1980,1979-11-01,1980-04-08,160,0,190,733,923,54,137,191,1114,39,273,ND - Bismarck
30,1980-1981,1980-10-16,1981-03-01,137,0,127,482,609,29,41,70,679,26,207,ND - Bismarck
31,1981-1982,1981-10-21,1982-04-08,170,0,349,847,1196,128,576,704,1900,62,664,ND - Bismarck
32,1982-1983,1982-10-05,1983-04-16,194,0,110,502,612,60,98,158,770,35,218,ND - Bismarck
33,1983-1984,1983-11-11,1984-05-02,174,0,262,701,963,103,253,356,1319,49,447,ND - Bismarck
34,1984-1985,1984-09-23,1985-04-16,206,0,271,833,1104,68,249,317,1421,39,371,ND - Bismarck
35,1985-1986,1985-10-07,1986-04-17,193,0,279,749,1028,103,435,538,1566,54,583,ND - Bismarck
36,1986-1987,1986-11-07,1987-04-10,155,0,113,518,631,106,361,467,1098,44,326,ND - Bismarck
37,1987-1988,1987-10-19,1988-04-26,191,0,170,734,904,53,135,188,1092,29,304,ND - Bismarck
38,1988-1989,1988-10-27,1989-04-29,185,0,255,754,1009,80,298,378,1387,45,452,ND - Bismarck
39,1989-1990,1989-10-31,1990-05-01,183,0,175,685,860,55,83,138,998,40,272,ND - Bismarck
40,1990-1991,1990-10-17,1991-05-04,200,0,201,738,939,73,130,203,1142,43,393,ND - Bismarck
41,1991-1992,1991-10-23,1992-04-24,185,0,107,542,649,94,166,260,909,40,323,ND - Bismarck
42,1992-1993,1992-10-15,1993-03-31,168,0,262,727,989,79,297,376,1365,52,430,ND - Bismarck
43,1993-1994,1993-10-28,1994-04-29,184,0,311,830,1141,152,746,898,2039,72,765,ND - Bismarck
44,1994-1995,1994-11-17,1995-04-11,146,0,229,665,894,107,546,653,1547,46,432,ND - Bismarck
45,1995-1996,1995-10-30,1996-04-26,180,0,334,881,1215,123,433,556,1771,50,469,ND - Bismarck
46,1996-1997,1996-10-20,1997-04-17,180,0,363,911,1274,152,737,889,2163,59,623,ND - Bismarck
47,1997-1998,1997-10-13,1998-03-18,157,0,157,502,659,48,123,171,830,35,239,ND - Bismarck
48,1998-1999,1998-11-05,1999-04-06,153,0,172,562,734,103,377,480,1214,47,452,ND - Bismarck
49,1999-2000,1999-12-01,2000-04-15,137,0,113,495,608,54,142,196,804,35,298,ND - Bismarck
50,2000-2001,2000-11-06,2001-04-21,167,0,259,763,1022,81,426,507,1529,55,470,ND - Bismarck
51,2001-2002,2001-10-24,2002-05-09,198,0,163,643,806,66,140,206,1012,45,314,ND - Bismarck
52,2002-2003,2002-10-21,2003-04-17,179,0,211,706,917,62,158,220,1137,46,399,ND - Bismarck
53,2003-2004,2003-10-29,2004-05-12,197,0,211,679,890,77,356,433,1323,44,415,ND - Bismarck
54,2004-2005,2004-10-17,2005-05-01,197,0,154,635,789,37,87,124,913,30,232,ND - Bismarck
55,2005-2006,2005-11-03,2006-03-31,149,0,117,460,577,59,126,185,762,42,237,ND - Bismarck
56,2006-2007,2006-10-17,2007-04-13,179,0,183,714,897,73,331,404,1301,35,304,ND - Bismarck
57,2007-2008,2007-11-17,2008-05-10,176,0,180,744,924,42,139,181,1105,33,282,ND - Bismarck
58,2008-2009,2008-11-06,2009-04-24,170,0,291,815,1106,153,743,896,2002,62,624,ND - Bismarck
59,2009-2010,2009-10-09,2010-05-07,211,0,273,675,948,91,696,787,1735,44,365,ND - Bismarck
60,2010-2011,2010-10-26,2011-05-01,188,0,322,798,1120,137,748,885,2005,77,733,ND - Bismarck
61,2011-2012,2011-11-16,2012-03-07,113,0,84,443,527,28,60,88,615,20,130,ND - Bismarck
62,2012-2013,2012-11-02,2013-04-24,174,0,194,693,887,96,405,501,1388,49,361,ND - Bismarck
63,2013-2014,2013-10-04,2014-04-29,208,0,278,853,1131,69,266,335,1466,41,416,ND - Bismarck
64,2014-2015,2014-11-09,2015-05-17,190,0,199,670,869,48,165,213,1082,36,287,ND - Bismarck
65,2015-2016,2015-10-28,2016-04-01,157,0,111,458,569,47,210,257,826,33,184,ND - Bismarck
66,2016-2017,2016-11-24,2017-03-21,118,0,227,576,803,105,681,786,1589,37,397,ND - Bismarck
67,2017-2018,2017-11-03,2018-04-13,162,0,227,759,986,72,246,318,1304,34,317,ND - Bismarck
68,2018-2019,2018-10-04,2019-04-28,207,0,298,778,1076,99,421,520,1596,48,498,ND - Bismarck
69,2019-2020,2019-10-10,2020-04-13,187,0,167,597,764,93,351,444,1208,43,348,ND - Bismarck
15,1965-1966,1965-11-08,1966-05-11,185,16,207,678,885,31,149,180,1065,13,105,ND - Bowman
17,1967-1968,1967-11-03,1968-04-22,172,10,178,605,783,28,129,157,940,11,90,ND - Bowman
22,1972-1973,1972-09-26,1973-04-09,196,12,199,556,755,50,168,218,973,18,160,ND - Bowman
25,1975-1976,1975-11-12,1976-04-03,144,4,143,543,686,80,445,525,1211,32,296,ND - Bowman
26,1976-1977,1976-11-11,1977-04-09,150,2,167,633,800,88,506,594,1394,36,316,ND - Bowman
27,1977-1978,1977-10-07,1978-04-18,194,16,356,798,1154,142,1573,1715,2869,44,505,ND - Bowman
28,1978-1979,1978-11-09,1979-04-27,170,4,367,895,1262,140,1436,1576,2838,55,547,ND - Bowman
29,1979-1980,1979-10-21,1980-04-01,164,1,164,641,805,65,112,177,982,39,304,ND - Bowman
30,1980-1981,1980-10-16,1981-02-28,136,0,105,424,529,42,102,144,673,22,160,ND - Bowman
38,1988-1989,1988-10-27,1989-05-01,187,9,221,751,972,126,438,564,1536,44,460,ND - Bowman
39,1989-1990,1989-10-29,1990-05-09,193,2,142,613,755,88,245,333,1088,35,302,ND - Bowman
40,1990-1991,1990-10-17,1991-05-04,200,0,191,659,850,85,255,340,1190,35,356,ND - Bowman
41,1991-1992,1991-10-23,1992-04-21,182,1,68,528,596,51,124,175,771,16,144,ND - Bowman
42,1992-1993,1992-10-15,1993-04-21,189,5,218,700,918,111,462,573,1491,35,344,ND - Bowman
43,1993-1994,1993-10-30,1994-04-29,182,2,211,749,960,174,831,1005,1965,54,595,ND - Bowman
44,1994-1995,1994-11-18,1995-04-15,149,1,141,579,720,76,323,399,1119,23,214,ND - Bowman
45,1995-1996,1995-10-30,1996-05-11,195,1,245,807,1052,119,448,567,1619,40,393,ND - Bowman
46,1996-1997,1996-10-21,1997-04-29,191,3,282,815,1097,130,920,1050,2147,34,405,ND - Bowman
47,1997-1998,1997-10-13,1998-04-10,180,6,115,571,686,72,333,405,1091,22,206,ND - Bowman
48,1998-1999,1998-11-04,1999-05-11,189,2,113,497,610,120,409,529,1139,42,372,ND - Bowman
49,1999-2000,1999-11-19,2000-05-13,177,11,51,457,508,46,135,181,689,18,138,ND - Bowman
51,2001-2002,2001-11-25,2002-05-08,165,4,139,609,748,78,230,308,1056,26,236,ND - Bowman
52,2002-2003,2002-10-21,2003-04-17,179,8,138,606,744,74,283,357,1101,31,278,ND - Bowman
53,2003-2004,2003-10-29,2004-03-17,141,1,193,578,771,89,439,528,1299,40,380,ND - Bowman
54,2004-2005,2004-10-30,2005-05-13,196,0,121,537,658,38,70,108,766,23,165,ND - Bowman
55,2005-2006,2005-10-05,2006-04-21,199,0,122,488,610,91,221,312,922,29,216,ND - Bowman
56,2006-2007,2006-10-11,2007-04-12,184,0,142,640,782,55,125,180,962,30,241,ND - Bowman
57,2007-2008,2007-11-20,2008-05-10,173,0,135,672,807,37,77,114,921,31,211,ND - Bowman
58,2008-2009,2008-10-12,2009-06-07,239,0,238,741,979,122,640,762,1741,47,434,ND - Bowman
59,2009-2010,2009-10-05,2010-05-08,216,1,258,691,949,83,797,880,1829,39,371,ND - Bowman
60,2010-2011,2010-09-18,2011-05-02,227,2,293,765,1058,127,763,890,1948,52,506,ND - Bowman
61,2011-2012,2011-11-19,2012-03-07,110,0,93,433,526,23,85,108,634,17,122,ND - Bowman
62,2012-2013,2012-10-04,2013-04-21,200,0,123,634,757,55,179,234,991,35,251,ND - Bowman
63,2013-2014,2013-10-05,2014-04-30,208,0,250,787,1037,93,491,584,1621,40,353,ND - Bowman
64,2014-2015,2014-11-10,2015-04-09,151,0,177,570,747,49,201,250,997,25,208,ND - Bowman
65,2015-2016,2015-11-20,2016-05-13,176,2,88,450,538,39,98,137,675,21,152,ND - Bowman
66,2016-2017,2016-11-18,2017-04-26,160,0,265,600,865,39,469,508,1373,27,278,ND - Bowman
67,2017-2018,2017-10-31,2018-04-24,176,1,271,770,1041,67,451,518,1559,40,365,ND - Bowman
68,2018-2019,2018-10-01,2019-05-19,231,2,280,760,1040,101,538,639,1679,53,471,ND - Bowman
69,2019-2020,2019-10-03,2020-04-15,196,2,129,601,730,62,293,355,1085,43,276,ND - Bowman
4,1954-1955,1954-11-01,1955-04-01,152,18,325,787,1112,55,470,525,1637,30,312,ND - Cavalier
7,1957-1958,1957-11-07,1958-04-29,174,12,213,664,877,26,66,92,969,20,127,ND - Cavalier
9,1959-1960,1959-10-09,1960-04-26,201,8,313,853,1166,88,579,667,1833,38,337,ND - Cavalier
10,1960-1961,1960-10-19,1961-04-27,191,2,257,789,1046,46,538,584,1630,26,232,ND - Cavalier
11,1961-1962,1961-11-03,1962-05-07,186,13,417,971,1388,86,873,959,2347,36,397,ND - Cavalier
12,1962-1963,1962-11-06,1963-04-03,149,6,298,779,1077,31,150,181,1258,20,207,ND - Cavalier
13,1963-1964,1963-11-13,1964-04-15,155,0,276,793,1069,68,436,504,1573,25,224,ND - Cavalier
16,1966-1967,1966-11-01,1967-05-04,185,15,370,1009,1379,61,687,748,2127,16,176,ND - Cavalier
18,1968-1969,1968-11-06,1969-04-08,154,16,417,850,1267,46,639,685,1952,25,278,ND - Cavalier
21,1971-1972,1971-10-29,1972-04-17,172,4,408,936,1344,69,441,510,1854,28,343,ND - Cavalier
22,1972-1973,1972-09-26,1973-04-07,194,1,284,729,1013,42,391,433,1446,16,126,ND - Cavalier
24,1974-1975,1974-10-06,1975-04-19,196,13,269,796,1065,63,378,441,1506,19,170,ND - Cavalier
27,1977-1978,1977-11-10,1978-04-20,162,2,509,1002,1511,49,877,926,2437,24,272,ND - Cavalier
28,1978-1979,1978-11-11,1979-05-11,182,0,583,1291,1874,79,1107,1186,3060,40,416,ND - Cavalier
29,1979-1980,1979-11-01,1980-03-28,149,0,339,839,1178,37,466,503,1681,21,215,ND - Cavalier
30,1980-1981,1980-10-23,1981-03-18,147,2,246,646,892,31,175,206,1098,12,92,ND - Cavalier
31,1981-1982,1981-10-23,1982-04-10,170,1,449,947,1396,47,533,580,1976,21,291,ND - Cavalier
32,1982-1983,1982-11-03,1983-05-15,194,7,248,675,923,23,130,153,1076,15,87,ND - Cavalier
33,1983-1984,1983-10-12,1984-04-28,200,1,352,845,1197,34,491,525,1722,20,182,ND - Cavalier
34,1984-1985,1984-10-28,1985-04-01,156,0,386,897,1283,46,501,547,1830,26,280,ND - Cavalier
35,1985-1986,1985-10-08,1986-04-26,201,2,410,973,1383,75,894,969,2352,32,355,ND - Cavalier
36,1986-1987,1986-11-04,1987-04-04,152,2,225,684,909,70,1017,1087,1996,23,187,ND - Cavalier
37,1987-1988,1987-10-22,1988-03-30,161,3,294,750,1044,33,268,301,1345,19,147,ND - Cavalier
38,1988-1989,1988-10-27,1989-04-15,171,4,397,1018,1415,89,1140,1229,2644,29,355,ND - Cavalier
39,1989-1990,1989-11-02,1990-05-02,182,1,343,883,1226,75,347,422,1648,32,289,ND - Cavalier
40,1990-1991,1990-11-07,1991-05-04,179,0,359,851,1210,47,308,355,1565,23,228,ND - Cavalier
41,1991-1992,1991-10-21,1992-04-25,188,2,271,768,1039,79,703,782,1821,33,304,ND - Cavalier
42,1992-1993,1992-10-14,1993-04-03,172,2,400,920,1320,70,958,1028,2348,25,266,ND - Cavalier
43,1993-1994,1993-10-29,1994-04-09,163,7,465,926,1391,50,634,684,2075,25,288,ND - Cavalier
44,1994-1995,1994-11-18,1995-04-09,143,3,360,766,1126,63,845,908,2034,18,181,ND - Cavalier
45,1995-1996,1995-11-02,1996-04-26,177,6,543,1140,1683,79,1325,1404,3087,31,330,ND - Cavalier
46,1996-1997,1996-10-31,1997-04-21,173,1,528,1129,1657,108,1433,1541,3198,32,430,ND - Cavalier
48,1998-1999,1998-11-05,1999-04-07,154,0,342,758,1100,68,583,651,1751,23,235,ND - Cavalier
49,1999-2000,1999-11-19,2000-04-15,149,1,214,671,885,18,173,191,1076,12,100,ND - Cavalier
50,2000-2001,2000-10-05,2001-04-22,200,3,446,977,1423,51,747,798,2221,25,272,ND - Cavalier
51,2001-2002,2001-10-24,2002-05-10,199,2,287,769,1056,61,342,403,1459,25,246,ND - Cavalier
52,2002-2003,2002-10-17,2003-04-18,184,0,393,903,1296,65,319,384,1680,25,205,ND - Cavalier
53,2003-2004,2003-10-28,2004-05-13,199,0,356,883,1239,81,674,755,1994,38,373,ND - Cavalier
54,2004-2005,2004-10-18,2005-05-02,197,1,334,869,1203,59,640,699,1902,24,249,ND - Cavalier
55,2005-2006,2005-10-06,2006-04-05,182,0,253,680,933,73,727,800,1733,22,198,ND - Cavalier
56,2006-2007,2006-10-18,2007-04-09,174,0,327,845,1172,65,636,701,1873,21,236,ND - Cavalier
57,2007-2008,2007-11-18,2008-04-06,141,2,404,900,1304,45,755,800,2104,24,261,ND - Cavalier
58,2008-2009,2008-11-07,2009-04-08,153,1,470,961,1431,52,660,712,2143,29,319,ND - Cavalier
59,2009-2010,2009-10-15,2010-03-28,165,0,342,744,1086,54,806,860,1946,23,212,ND - Cavalier
60,2010-2011,2010-11-14,2011-05-02,170,3,443,846,1289,59,877,936,2225,27,285,ND - Cavalier
61,2011-2012,2011-11-16,2012-03-12,118,0,183,546,729,32,154,186,915,17,144,ND - Cavalier
62,2012-2013,2012-10-05,2013-04-28,206,0,428,1007,1435,96,1112,1208,2643,29,327,ND - Cavalier
63,2013-2014,2013-10-29,2014-04-16,170,8,548,1114,1662,62,916,978,2640,26,319,ND - Cavalier
64,2014-2015,2014-11-09,2015-04-08,151,20,352,790,1142,42,356,398,1540,16,165,ND - Cavalier
66,2016-2017,2016-11-28,2017-04-25,149,16,295,654,949,62,719,781,1730,23,214,ND - Cavalier
67,2017-2018,2017-10-27,2018-04-12,168,4,360,850,1210,47,521,568,1778,28,257,ND - Cavalier
68,2018-2019,2018-10-05,2019-04-13,191,11,466,990,1456,73,789,862,2318,24,276,ND - Cavalier
69,2019-2020,2019-10-11,2020-04-15,188,16,315,807,1122,75,631,706,1828,25,245,ND - Cavalier
0,1950-1951,1950-10-02,1951-04-21,202,0,408,930,1338,84,612,696,2034,54,534,ND - Fargo
1,1951-1952,1951-10-29,1952-04-08,163,0,381,877,1258,98,742,840,2098,48,473,ND - Fargo
2,1952-1953,1952-11-09,1953-04-17,160,0,211,622,833,49,232,281,1114,40,296,ND - Fargo
3,1953-1954,1953-11-20,1954-05-03,165,0,264,672,936,52,491,543,1479,34,283,ND - Fargo
4,1954-1955,1954-11-01,1955-04-05,156,0,280,736,1016,52,337,389,1405,37,358,ND - Fargo
5,1955-1956,1955-11-02,1956-04-09,160,0,411,934,1345,57,500,557,1902,33,319,ND - Fargo
6,1956-1957,1956-11-15,1957-04-11,148,0,289,730,1019,38,81,119,1138,32,305,ND - Fargo
7,1957-1958,1957-10-25,1958-03-20,147,0,191,568,759,24,67,91,850,22,169,ND - Fargo
8,1958-1959,1958-11-17,1959-04-24,159,0,323,744,1067,29,218,247,1314,20,165,ND - Fargo
9,1959-1960,1959-10-10,1960-05-02,206,0,282,787,1069,44,293,337,1406,28,201,ND - Fargo
10,1960-1961,1960-10-19,1961-04-27,191,0,242,712,954,40,291,331,1285,24,214,ND - Fargo
11,1961-1962,1961-11-02,1962-04-14,164,0,347,825,1172,69,565,634,1806,43,389,ND - Fargo
12,1962-1963,1962-10-24,1963-05-21,210,0,284,761,1045,45,57,102,1147,32,277,ND - Fargo
13,1963-1964,1963-11-21,1964-04-14,146,0,222,711,933,54,261,315,1248,25,189,ND - Fargo
14,1964-1965,1964-11-19,1965-04-07,140,0,435,979,1414,54,469,523,1937,32,329,ND - Fargo
15,1965-1966,1965-11-09,1966-04-28,171,0,359,846,1205,63,405,468,1673,29,242,ND - Fargo
16,1966-1967,1966-10-22,1967-05-02,193,0,306,890,1196,61,340,401,1597,42,395,ND - Fargo
17,1967-1968,1967-10-27,1968-05-17,204,0,267,740,1007,56,260,316,1323,31,253,ND - Fargo
18,1968-1969,1968-10-18,1969-04-07,172,0,379,864,1243,72,710,782,2025,48,450,ND - Fargo
19,1969-1970,1969-10-25,1970-04-23,181,0,326,843,1169,75,499,574,1743,49,421,ND - Fargo
20,1970-1971,1970-10-09,1971-04-02,176,0,322,801,1123,63,399,462,1585,35,352,ND - Fargo
21,1971-1972,1971-10-29,1972-04-09,164,0,366,839,1205,95,418,513,1718,60,562,ND - Fargo
22,1972-1973,1972-10-17,1973-04-15,181,0,272,710,982,54,302,356,1338,30,264,ND - Fargo
23,1973-1974,1973-11-03,1974-04-29,178,0,360,822,1182,85,418,503,1685,59,558,ND - Fargo
24,1974-1975,1974-10-06,1975-04-19,196,0,259,714,973,104,441,545,1518,66,507,ND - Fargo
25,1975-1976,1975-10-24,1976-05-01,191,0,253,691,944,70,322,392,1336,34,307,ND - Fargo
26,1976-1977,1976-10-18,1977-04-05,170,0,361,855,1216,65,265,330,1546,40,373,ND - Fargo
27,1977-1978,1977-11-08,1978-04-20,164,0,472,876,1348,86,807,893,2241,41,429,ND - Fargo
28,1978-1979,1978-11-10,1979-05-05,177,0,501,1031,1532,97,822,919,2451,58,543,ND - Fargo
29,1979-1980,1979-10-31,1980-03-27,149,0,293,737,1030,73,288,361,1391,42,344,ND - Fargo
30,1980-1981,1980-10-23,1981-03-31,160,0,215,617,832,30,46,76,908,25,191,ND - Fargo
31,1981-1982,1981-10-21,1982-04-06,168,0,415,895,1310,110,534,644,1954,47,523,ND - Fargo
32,1982-1983,1982-11-04,1983-04-14,162,0,185,518,703,41,66,107,810,24,143,ND - Fargo
33,1983-1984,1983-11-12,1984-04-28,169,0,331,678,1009,61,525,586,1595,36,315,ND - Fargo
34,1984-1985,1984-10-28,1985-03-30,154,0,315,723,1038,47,227,274,1312,28,281,ND - Fargo
35,1985-1986,1985-11-08,1986-04-15,159,0,361,778,1139,89,708,797,1936,41,469,ND - Fargo
36,1986-1987,1986-11-08,1987-03-29,142,0,148,480,628,41,108,149,777,24,153,ND - Fargo
37,1987-1988,1987-11-16,1988-03-28,134,0,261,622,883,66,457,523,1406,26,244,ND - Fargo
38,1988-1989,1988-10-28,1989-04-17,172,0,307,828,1135,113,745,858,1993,43,419,ND - Fargo
39,1989-1990,1989-11-01,1990-04-29,180,0,230,711,941,78,201,279,1220,35,261,ND - Fargo
40,1990-1991,1990-10-17,1991-04-30,196,0,250,708,958,77,290,367,1325,37,387,ND - Fargo
41,1991-1992,1991-10-29,1992-04-25,180,0,162,583,745,50,182,232,977,35,266,ND - Fargo
42,1992-1993,1992-10-15,1993-03-26,163,0,317,733,1050,86,679,765,1815,44,404,ND - Fargo
43,1993-1994,1993-10-29,1994-04-29,183,0,361,820,1181,139,839,978,2159,56,633,ND - Fargo
44,1994-1995,1994-11-18,1995-04-11,145,0,219,611,830,81,346,427,1257,35,293,ND - Fargo
45,1995-1996,1995-10-31,1996-04-07,160,0,429,899,1328,109,718,827,2155,35,404,ND - Fargo
46,1996-1997,1996-10-30,1997-04-12,165,0,416,948,1364,167,1181,1348,2712,45,614,ND - Fargo
54,2004-2005,2004-11-25,2005-05-01,158,1,231,621,852,51,285,336,1188,32,260,ND - Fargo
55,2005-2006,2005-11-15,2006-03-29,135,0,200,534,734,65,593,658,1392,36,270,ND - Fargo
56,2006-2007,2006-10-11,2007-04-11,183,0,223,645,868,68,244,312,1180,39,308,ND - Fargo
57,2007-2008,2007-11-18,2008-04-26,161,0,333,787,1120,103,644,747,1867,50,454,ND - Fargo
58,2008-2009,2008-10-26,2009-04-09,166,1,355,832,1187,118,689,807,1994,41,467,ND - Fargo
59,2009-2010,2009-10-09,2010-03-25,168,0,285,636,921,73,675,748,1669,33,284,ND - Fargo
60,2010-2011,2010-10-26,2011-05-01,188,0,359,812,1171,136,916,1052,2223,62,617,ND - Fargo
61,2011-2012,2011-11-15,2012-03-11,118,0,104,441,545,52,214,266,811,32,204,ND - Fargo
62,2012-2013,2012-10-04,2013-04-25,204,0,269,776,1045,112,685,797,1842,61,491,ND - Fargo
63,2013-2014,2013-11-11,2014-04-16,157,0,396,886,1282,64,603,667,1949,49,518,ND - Fargo
64,2014-2015,2014-11-05,2015-03-25,141,0,234,634,868,38,142,180,1048,32,247,ND - Fargo
65,2015-2016,2015-11-19,2016-04-11,145,0,149,457,606,53,263,316,922,36,215,ND - Fargo
66,2016-2017,2016-11-17,2017-04-27,162,0,200,495,695,56,236,292,987,32,282,ND - Fargo
67,2017-2018,2017-10-26,2018-04-14,171,0,287,775,1062,81,463,544,1606,44,366,ND - Fargo
68,2018-2019,2018-10-10,2019-04-14,187,0,358,844,1202,92,690,782,1984,44,446,ND - Fargo
69,2019-2020,2019-10-11,2020-04-14,187,0,243,712,955,81,751,832,1787,38,315,ND - Fargo
0,1950-1951,1950-10-02,1951-04-21,202,0,434,952,1386,63,445,508,1894,46,480,ND - Grand Forks
1,1951-1952,1951-10-30,1952-04-03,157,0,399,907,1306,78,597,675,1981,44,469,ND - Grand Forks
2,1952-1953,1952-11-09,1953-05-11,184,0,246,682,928,46,154,200,1128,30,259,ND - Grand Forks
3,1953-1954,1953-11-20,1954-05-03,165,0,284,731,1015,75,399,474,1489,44,458,ND - Grand Forks
4,1954-1955,1954-10-31,1955-04-01,153,2,334,832,1166,63,457,520,1686,34,364,ND - Grand Forks
5,1955-1956,1955-10-31,1956-04-27,180,1,461,1104,1565,102,925,1027,2592,49,523,ND - Grand Forks
6,1956-1957,1956-11-15,1957-04-11,148,3,315,803,1118,46,233,279,1397,28,281,ND - Grand Forks
7,1957-1958,1957-11-02,1958-03-20,139,4,207,611,818,26,34,60,878,19,131,ND - Grand Forks
8,1958-1959,1958-11-15,1959-03-24,130,0,408,879,1287,70,670,740,2027,27,293,ND - Grand Forks
9,1959-1960,1959-10-11,1960-04-27,200,0,328,887,1215,64,512,576,1791,34,263,ND - Grand Forks
10,1960-1961,1960-10-19,1961-04-24,188,0,284,747,1031,48,346,394,1425,35,293,ND - Grand Forks
11,1961-1962,1961-11-03,1962-04-14,163,0,387,895,1282,70,620,690,1972,39,360,ND - Grand Forks
12,1962-1963,1962-11-04,1963-05-21,199,2,318,764,1082,28,108,136,1218,22,202,ND - Grand Forks
13,1963-1964,1963-11-21,1964-04-14,146,0,277,745,1022,53,338,391,1413,23,212,ND - Grand Forks
14,1964-1965,1964-10-19,1965-05-27,221,5,453,978,1431,54,593,647,2078,38,414,ND - Grand Forks
15,1965-1966,1965-11-08,1966-04-30,174,0,401,891,1292,99,579,678,1970,47,449,ND - Grand Forks
16,1966-1967,1966-11-01,1967-05-04,185,0,380,990,1370,75,622,697,2067,41,391,ND - Grand Forks
17,1967-1968,1967-10-27,1968-04-14,171,0,328,777,1105,41,272,313,1418,34,319,ND - Grand Forks
18,1968-1969,1968-10-18,1969-04-07,172,0,437,922,1359,67,690,757,2116,48,468,ND - Grand Forks
19,1969-1970,1969-10-26,1970-04-22,179,0,378,956,1334,69,599,668,2002,49,470,ND - Grand Forks
20,1970-1971,1970-11-19,1971-04-25,158,0,353,799,1152,65,540,605,1757,40,395,ND - Grand Forks
21,1971-1972,1971-10-30,1972-04-23,177,0,395,899,1294,66,255,321,1615,42,386,ND - Grand Forks
22,1972-1973,1972-10-17,1973-04-15,181,0,283,753,1036,33,189,222,1258,26,210,ND - Grand Forks
23,1973-1974,1973-11-02,1974-05-03,183,0,461,1008,1469,69,609,678,2147,48,523,ND - Grand Forks
24,1974-1975,1974-10-06,1975-04-10,187,0,288,796,1084,72,365,437,1521,44,395,ND - Grand Forks
25,1975-1976,1975-11-11,1976-03-25,136,0,281,768,1049,76,360,436,1485,44,404,ND - Grand Forks
26,1976-1977,1976-10-24,1977-04-05,164,0,316,843,1159,54,242,296,1455,38,407,ND - Grand Forks
27,1977-1978,1977-11-08,1978-04-19,163,0,478,931,1409,57,547,604,2013,38,352,ND - Grand Forks
28,1978-1979,1978-11-10,1979-05-11,183,0,549,1177,1726,90,891,981,2707,56,594,ND - Grand Forks
29,1979-1980,1979-10-31,1980-03-26,148,0,273,729,1002,61,276,337,1339,32,259,ND - Grand Forks
30,1980-1981,1980-11-10,1981-03-06,117,0,197,511,708,28,67,95,803,19,155,ND - Grand Forks
31,1981-1982,1981-10-21,1982-04-06,168,0,407,871,1278,78,386,464,1742,43,531,ND - Grand Forks
32,1982-1983,1982-11-04,1983-05-15,193,0,178,538,716,34,111,145,861,25,129,ND - Grand Forks
33,1983-1984,1983-10-12,1984-03-20,161,0,326,696,1022,64,335,399,1421,41,372,ND - Grand Forks
34,1984-1985,1984-10-19,1985-04-02,166,0,302,742,1044,66,352,418,1462,33,330,ND - Grand Forks
35,1985-1986,1985-10-07,1986-04-15,191,0,418,953,1371,96,873,969,2340,43,523,ND - Grand Forks
36,1986-1987,1986-11-03,1987-04-01,150,0,198,587,785,71,478,549,1334,35,277,ND - Grand Forks
37,1987-1988,1987-10-21,1988-03-28,160,0,285,760,1045,65,421,486,1531,36,317,ND - Grand Forks
38,1988-1989,1988-10-27,1989-04-16,172,0,361,931,1292,124,806,930,2222,45,475,ND - Grand Forks
39,1989-1990,1989-11-01,1990-04-29,180,0,260,803,1063,71,158,229,1292,44,353,ND - Grand Forks
40,1990-1991,1990-10-17,1991-04-30,196,0,281,804,1085,72,317,389,1474,40,413,ND - Grand Forks
41,1991-1992,1991-09-17,1992-04-23,220,0,208,657,865,78,237,315,1180,45,390,ND - Grand Forks
42,1992-1993,1992-10-13,1993-03-22,161,0,335,775,1110,74,527,601,1711,40,406,ND - Grand Forks
43,1993-1994,1993-10-29,1994-04-28,182,0,417,932,1349,103,794,897,2246,48,600,ND - Grand Forks
45,1995-1996,1995-10-30,1996-04-25,179,0,473,1005,1478,139,702,841,2319,60,600,ND - Grand Forks
46,1996-1997,1996-10-01,1997-04-13,195,0,437,966,1403,140,1261,1401,2804,56,677,ND - Grand Forks
48,1998-1999,1998-11-04,1999-04-04,152,0,284,715,999,112,620,732,1731,40,437,ND - Grand Forks
49,1999-2000,1999-11-29,2000-04-14,138,0,172,576,748,30,55,85,833,22,189,ND - Grand Forks
50,2000-2001,2000-10-05,2001-04-15,193,0,373,847,1220,81,527,608,1828,48,440,ND - Grand Forks
51,2001-2002,2001-10-24,2002-05-06,195,0,217,686,903,67,176,243,1146,38,306,ND - Grand Forks
52,2002-2003,2002-10-17,2003-04-17,183,0,329,838,1167,64,302,366,1533,44,379,ND - Grand Forks
53,2003-2004,2003-10-27,2004-03-29,155,0,319,833,1152,102,458,560,1712,55,510,ND - Grand Forks
54,2004-2005,2004-11-23,2005-05-01,160,0,287,791,1078,63,326,389,1467,36,329,ND - Grand Forks
55,2005-2006,2005-10-05,2006-03-30,177,0,236,662,898,72,547,619,1517,49,372,ND - Grand Forks
56,2006-2007,2006-10-12,2007-04-07,178,0,271,767,1038,74,269,343,1381,37,329,ND - Grand Forks
57,2007-2008,2007-11-06,2008-05-10,187,0,382,932,1314,77,651,728,2042,43,443,ND - Grand Forks
58,2008-2009,2008-10-26,2009-04-26,183,0,411,948,1359,96,531,627,1986,56,664,ND - Grand Forks
59,2009-2010,2009-10-14,2010-03-25,163,0,316,689,1005,56,610,666,1671,33,263,ND - Grand Forks
60,2010-2011,2010-11-13,2011-05-01,170,0,404,868,1272,92,576,668,1940,55,563,ND - Grand Forks
61,2011-2012,2011-11-15,2012-03-28,135,0,139,526,665,43,187,230,895,31,235,ND - Grand Forks
62,2012-2013,2012-10-04,2013-04-22,201,1,319,864,1183,96,595,691,1874,61,532,ND - Grand Forks
63,2013-2014,2013-11-10,2014-04-15,157,0,461,1070,1531,101,682,783,2314,49,633,ND - Grand Forks
64,2014-2015,2014-11-05,2015-04-07,154,0,288,762,1050,39,144,183,1233,33,258,ND - Grand Forks
65,2015-2016,2015-11-05,2016-04-08,156,0,182,522,704,49,247,296,1000,25,163,ND - Grand Forks
66,2016-2017,2016-11-22,2017-04-27,157,1,235,564,799,69,391,460,1259,32,282,ND - Grand Forks
67,2017-2018,2017-10-26,2018-04-17,174,0,328,842,1170,79,635,714,1884,41,336,ND - Grand Forks
68,2018-2019,2018-10-04,2019-04-14,193,0,433,990,1423,107,721,828,2251,48,532,ND - Grand Forks
69,2019-2020,2019-10-10,2020-04-14,188,0,287,872,1159,111,818,929,2088,50,490,ND - Grand Forks
4,1954-1955,1954-10-25,1955-04-05,163,1,247,762,1009,33,278,311,1320,22,209,ND - Max
5,1955-1956,1955-10-31,1956-04-07,160,1,435,999,1434,58,656,714,2148,25,237,ND - Max
6,1956-1957,1956-11-06,1957-04-12,158,0,310,823,1133,38,198,236,1369,22,229,ND - Max
7,1957-1958,1957-10-23,1958-03-28,157,1,223,706,929,38,195,233,1162,16,120,ND - Max
8,1958-1959,1958-11-15,1959-04-17,154,0,354,845,1199,47,619,666,1865,22,261,ND - Max
9,1959-1960,1959-10-08,1960-04-27,203,11,328,895,1223,81,699,780,2003,37,311,ND - Max
10,1960-1961,1960-11-09,1961-04-28,171,0,192,720,912,50,266,316,1228,21,202,ND - Max
11,1961-1962,1961-11-03,1962-04-12,161,0,373,955,1328,56,384,440,1768,32,342,ND - Max
12,1962-1963,1962-11-03,1963-04-05,154,0,261,758,1019,49,119,168,1187,23,255,ND - Max
18,1968-1969,1968-11-06,1969-04-11,157,0,425,934,1359,70,802,872,2231,38,444,ND - Max
19,1969-1970,1969-10-11,1970-04-28,200,20,320,928,1248,92,814,906,2154,39,358,ND - Max
20,1970-1971,1970-10-29,1971-04-27,181,0,391,936,1327,61,666,727,2054,33,350,ND - Max
21,1971-1972,1971-10-17,1972-04-06,173,1,401,984,1385,63,504,567,1952,22,285,ND - Max
22,1972-1973,1972-09-26,1973-04-08,195,0,274,744,1018,40,322,362,1380,16,131,ND - Max
24,1974-1975,1974-12-01,1975-04-22,143,5,259,762,1021,69,636,705,1726,19,195,ND - Max
25,1975-1976,1975-10-09,1976-03-26,170,2,239,752,991,88,695,783,1774,28,265,ND - Max
26,1976-1977,1976-10-24,1977-04-07,166,1,296,869,1165,50,432,482,1647,16,202,ND - Max
27,1977-1978,1977-11-19,1978-04-04,137,0,468,900,1368,60,705,765,2133,20,232,ND - Max
28,1978-1979,1978-11-10,1979-05-05,177,1,508,1140,1648,85,844,929,2577,32,377,ND - Max
30,1980-1981,1980-10-16,1981-03-07,143,7,199,609,808,61,267,328,1136,20,208,ND - Max
32,1982-1983,1982-10-06,1983-05-12,219,15,137,625,762,52,254,306,1068,12,103,ND - Max
33,1983-1984,1983-11-12,1984-05-03,174,7,280,714,994,52,392,444,1438,19,193,ND - Max
34,1984-1985,1984-09-24,1985-04-04,193,11,326,861,1187,69,354,423,1610,20,210,ND - Max
36,1986-1987,1986-11-01,1987-04-02,153,10,148,541,689,67,290,357,1046,15,151,ND - Max
37,1987-1988,1987-10-23,1988-03-29,159,16,213,585,798,28,179,207,1005,9,99,ND - Max
38,1988-1989,1988-10-28,1989-04-09,164,4,319,836,1155,60,457,517,1672,16,179,ND - Max
39,1989-1990,1989-11-01,1990-05-01,182,6,207,770,977,44,91,135,1112,14,128,ND - Max
40,1990-1991,1990-10-17,1991-05-05,201,0,253,777,1030,49,222,271,1301,15,156,ND - Max
53,2003-2004,2003-10-30,2004-05-13,197,9,287,767,1054,83,764,847,1901,25,248,ND - Max
54,2004-2005,2004-10-17,2005-03-27,162,9,199,662,861,48,217,265,1126,16,145,ND - Max
55,2005-2006,2005-10-05,2006-03-20,167,4,160,509,669,62,112,174,843,18,134,ND - Max
56,2006-2007,2006-10-18,2007-04-13,178,7,227,754,981,57,331,388,1369,18,181,ND - Max
57,2007-2008,2007-11-17,2008-05-10,176,3,261,816,1077,35,107,142,1219,14,150,ND - Max
58,2008-2009,2008-11-06,2009-04-13,159,6,406,867,1273,136,1227,1363,2636,28,405,ND - Max
59,2009-2010,2009-10-11,2010-05-07,209,3,306,709,1015,76,784,860,1875,26,278,ND - Max
60,2010-2011,2010-10-27,2011-05-01,187,6,379,863,1242,148,1163,1311,2553,40,499,ND - Max
61,2011-2012,2011-11-14,2012-03-09,117,7,118,447,565,38,93,131,696,13,108,ND - Max
64,2014-2015,2014-11-10,2015-05-18,190,0,287,694,981,45,265,310,1291,18,149,ND - Max
65,2015-2016,2015-11-20,2016-04-17,150,0,145,469,614,38,174,212,826,16,123,ND - Max
66,2016-2017,2016-10-08,2017-04-25,200,0,300,652,952,117,821,938,1890,31,354,ND - Max
67,2017-2018,2017-10-31,2018-04-21,173,2,336,892,1228,95,602,697,1925,26,288,ND - Max
68,2018-2019,2018-10-05,2019-04-30,208,0,389,866,1255,88,612,700,1955,28,366,ND - Max
69,2019-2020,2019-10-03,2020-04-15,196,0,235,709,944,72,370,442,1386,26,234,ND - Max
1,1951-1952,1951-10-31,1952-03-29,151,20,342,963,1305,45,524,569,1874,20,241,ND - Upham
3,1953-1954,1953-11-07,1954-04-03,148,15,233,805,1038,71,569,640,1678,32,358,ND - Upham
5,1955-1956,1955-10-31,1956-05-03,186,19,393,1042,1435,70,1163,1233,2668,28,274,ND - Upham
6,1956-1957,1956-11-09,1957-04-11,154,9,265,810,1075,19,313,332,1407,15,177,ND - Upham
7,1957-1958,1957-10-23,1958-03-23,152,6,198,717,915,33,157,190,1105,20,157,ND - Upham
27,1977-1978,1977-12-01,1978-04-12,133,11,456,1038,1494,47,805,852,2346,25,288,ND - Upham
28,1978-1979,1978-11-11,1979-05-10,181,7,522,1289,1811,121,1062,1183,2994,55,647,ND - Upham
31,1981-1982,1981-10-22,1982-05-09,200,18,457,1081,1538,81,915,996,2534,42,511,ND - Upham
32,1982-1983,1982-10-06,1983-05-13,220,9,198,752,950,47,335,382,1332,23,153,ND - Upham
33,1983-1984,1983-11-12,1984-05-01,172,15,330,778,1108,68,475,543,1651,32,307,ND - Upham
36,1986-1987,1986-11-01,1987-04-10,161,17,163,635,798,63,855,918,1716,19,164,ND - Upham
37,1987-1988,1987-11-18,1988-03-26,130,17,242,643,885,42,209,251,1136,16,185,ND - Upham
39,1989-1990,1989-11-01,1990-04-28,179,1,238,882,1120,65,155,220,1340,32,272,ND - Upham
40,1990-1991,1990-11-07,1991-05-05,180,2,287,912,1199,63,294,357,1556,26,258,ND - Upham
41,1991-1992,1991-09-18,1992-04-21,217,6,201,828,1029,72,856,928,1957,33,301,ND - Upham
42,1992-1993,1992-11-01,1993-04-11,162,1,342,924,1266,76,744,820,2086,38,345,ND - Upham
43,1993-1994,1993-10-30,1994-04-09,162,0,397,1051,1448,83,819,902,2350,35,512,ND - Upham
44,1994-1995,1994-11-14,1995-04-16,154,2,321,837,1158,110,969,1079,2237,34,365,ND - Upham
45,1995-1996,1995-10-30,1996-04-27,181,3,474,1176,1650,102,1151,1253,2903,41,498,ND - Upham
46,1996-1997,1996-10-02,1997-04-14,195,9,465,1121,1586,121,1142,1263,2849,41,507,ND - Upham
47,1997-1998,1997-10-14,1998-03-31,169,13,203,741,944,82,441,523,1467,27,280,ND - Upham
48,1998-1999,1998-11-06,1999-04-08,154,2,274,787,1061,112,1091,1203,2264,42,493,ND - Upham
49,1999-2000,1999-11-19,2000-05-13,177,7,155,640,795,55,199,254,1049,20,196,ND - Upham
50,2000-2001,2000-10-05,2001-04-16,194,10,352,1045,1397,88,995,1083,2480,36,356,ND - Upham
51,2001-2002,2001-10-24,2002-05-09,198,6,240,815,1055,88,546,634,1689,32,293,ND - Upham
52,2002-2003,2002-10-18,2003-04-17,182,6,337,994,1331,87,648,735,2066,36,382,ND - Upham
53,2003-2004,2003-10-30,2004-05-14,198,2,329,990,1319,109,1144,1253,2572,39,436,ND - Upham
54,2004-2005,2004-10-17,2005-05-13,209,3,235,855,1090,55,419,474,1564,28,259,ND - Upham
55,2005-2006,2005-10-05,2006-03-31,178,1,177,636,813,77,378,455,1268,36,294,ND - Upham
56,2006-2007,2006-10-12,2007-04-11,182,1,274,911,1185,65,539,604,1789,35,288,ND - Upham
57,2007-2008,2007-11-10,2008-03-30,142,4,307,917,1224,47,508,555,1779,27,326,ND - Upham
58,2008-2009,2008-11-07,2009-04-14,159,0,438,1091,1529,94,1096,1190,2719,38,495,ND - Upham
59,2009-2010,2009-10-10,2010-05-07,210,0,315,813,1128,70,697,767,1895,36,332,ND - Upham
60,2010-2011,2010-10-27,2011-05-01,187,0,392,916,1308,110,1144,1254,2562,45,473,ND - Upham
61,2011-2012,2011-11-07,2012-04-20,166,0,143,615,758,51,294,345,1103,24,217,ND - Upham
62,2012-2013,2012-10-29,2013-05-02,186,0,352,997,1349,120,1244,1364,2713,57,555,ND - Upham
63,2013-2014,2013-10-29,2014-05-05,189,0,440,1090,1530,66,751,817,2347,41,468,ND - Upham
64,2014-2015,2014-11-05,2015-05-18,195,0,312,841,1153,66,543,609,1762,37,302,ND - Upham
65,2015-2016,2015-11-06,2016-04-17,164,0,175,565,740,49,327,376,1116,27,175,ND - Upham
66,2016-2017,2016-10-12,2017-04-25,196,0,306,753,1059,105,1058,1163,2222,35,372,ND - Upham
67,2017-2018,2017-10-31,2018-04-15,167,0,310,945,1255,52,533,585,1840,26,237,ND - Upham
68,2018-2019,2018-10-04,2019-04-30,209,0,394,1039,1433,89,928,1017,2450,32,396,ND - Upham
69,2019-2020,2019-10-03,2020-05-10,221,10,249,781,1030,67,471,538,1568,31,235,ND - Upham
0,1950-1951,1950-11-11,1951-04-13,154,0,87,348,435,107,259,366,801,44,282,OH - Akron
1,1951-1952,1951-11-01,1952-04-06,158,0,66,296,362,86,97,183,545,41,219,OH - Akron
2,1952-1953,1952-10-20,1953-04-20,183,0,29,241,270,54,51,105,375,34,152,OH - Akron
3,1953-1954,1953-11-07,1954-04-03,148,0,56,268,324,77,85,162,486,44,239,OH - Akron
4,1954-1955,1954-10-31,1955-03-28,149,0,62,288,350,57,122,179,529,41,194,OH - Akron
5,1955-1956,1955-11-17,1956-04-24,160,0,61,333,394,70,87,157,551,45,199,OH - Akron
6,1956-1957,1956-11-21,1957-04-14,145,0,65,276,341,87,125,212,553,59,274,OH - Akron
7,1957-1958,1957-10-27,1958-04-10,166,0,75,323,398,65,121,186,584,49,238,OH - Akron
8,1958-1959,1958-11-21,1959-04-04,135,0,101,396,497,81,161,242,739,45,282,OH - Akron
9,1959-1960,1959-11-12,1960-04-10,151,0,76,319,395,94,248,342,737,56,293,OH - Akron
10,1960-1961,1960-11-06,1961-04-18,164,0,94,341,435,117,268,385,820,56,346,OH - Akron
11,1961-1962,1961-11-08,1962-04-15,159,0,81,321,402,81,91,172,574,43,243,OH - Akron
12,1962-1963,1962-10-25,1963-05-01,189,0,122,419,541,110,241,351,892,52,352,OH - Akron
13,1963-1964,1963-11-02,1964-04-09,160,0,86,338,424,96,225,321,745,54,265,OH - Akron
14,1964-1965,1964-11-20,1965-03-26,127,0,80,320,400,77,102,179,579,39,231,OH - Akron
15,1965-1966,1965-10-28,1966-05-09,194,0,72,292,364,77,111,188,552,53,255,OH - Akron
16,1966-1967,1966-11-03,1967-04-24,173,0,54,280,334,93,139,232,566,51,242,OH - Akron
17,1967-1968,1967-11-13,1968-04-25,165,0,68,336,404,72,155,227,631,43,225,OH - Akron
18,1968-1969,1968-10-29,1969-03-30,153,0,51,274,325,63,64,127,452,50,214,OH - Akron
19,1969-1970,1969-10-22,1970-04-02,163,0,80,374,454,94,223,317,771,65,344,OH - Akron
20,1970-1971,1970-11-23,1971-03-30,128,0,75,290,365,81,111,192,557,54,281,OH - Akron
21,1971-1972,1971-11-06,1972-04-08,155,0,80,349,429,71,109,180,609,42,208,OH - Akron
22,1972-1973,1972-10-18,1973-04-11,176,0,39,223,262,62,66,128,390,38,160,OH - Akron
23,1973-1974,1973-11-09,1974-04-09,152,0,46,246,292,67,93,160,452,39,195,OH - Akron
24,1974-1975,1974-10-02,1975-04-05,186,0,30,215,245,120,165,285,530,61,253,OH - Akron
25,1975-1976,1975-11-13,1976-04-04,144,0,49,251,300,81,154,235,535,40,211,OH - Akron
26,1976-1977,1976-10-27,1977-04-07,163,0,136,449,585,82,301,383,968,61,405,OH - Akron
27,1977-1978,1977-11-11,1978-04-21,162,0,134,436,570,133,402,535,1105,62,455,OH - Akron
28,1978-1979,1978-11-26,1979-04-08,134,0,117,359,476,80,228,308,784,49,305,OH - Akron
29,1979-1980,1979-10-25,1980-04-16,175,0,72,297,369,63,70,133,502,46,213,OH - Akron
30,1980-1981,1980-11-17,1981-03-22,126,0,74,302,376,85,185,270,646,51,253,OH - Akron
31,1981-1982,1981-11-20,1982-04-09,141,0,80,321,401,100,164,264,665,56,343,OH - Akron
32,1982-1983,1982-11-05,1983-04-18,165,0,29,200,229,65,81,146,375,34,152,OH - Akron
33,1983-1984,1983-11-04,1984-04-18,167,0,94,328,422,100,167,267,689,54,301,OH - Akron
34,1984-1985,1984-11-11,1985-04-09,150,0,84,310,394,83,249,332,726,53,321,OH - Akron
35,1985-1986,1985-12-01,1986-04-22,143,0,79,295,374,64,111,175,549,49,261,OH - Akron
36,1986-1987,1986-11-11,1987-04-07,148,0,39,240,279,76,76,152,431,30,140,OH - Akron
37,1987-1988,1987-11-20,1988-04-16,149,0,68,279,347,85,95,180,527,55,279,OH - Akron
38,1988-1989,1988-10-24,1989-05-07,196,0,56,282,338,62,47,109,447,39,172,OH - Akron
39,1989-1990,1989-10-19,1990-04-17,181,0,75,289,364,73,107,180,544,43,230,OH - Akron
40,1990-1991,1990-11-11,1991-04-01,142,0,31,196,227,50,56,106,333,33,138,OH - Akron
41,1991-1992,1991-11-04,1992-04-03,152,0,43,259,302,79,71,150,452,50,235,OH - Akron
42,1992-1993,1992-10-18,1993-04-17,182,0,51,258,309,85,109,194,503,49,203,OH - Akron
43,1993-1994,1993-10-30,1994-04-07,160,0,107,343,450,107,237,344,794,57,336,OH - Akron
44,1994-1995,1994-11-23,1995-04-04,133,0,51,262,313,48,89,137,450,33,173,OH - Akron
45,1995-1996,1995-11-04,1996-04-23,172,2,124,400,524,99,232,331,855,54,332,OH - Akron
47,1997-1998,1997-11-11,1998-03-24,134,0,29,174,203,47,27,74,277,34,124,OH - Akron
48,1998-1999,1998-12-01,1999-03-21,111,0,51,224,275,83,134,217,492,35,211,OH - Akron
49,1999-2000,1999-11-02,2000-04-09,160,0,57,240,297,61,89,150,447,40,204,OH - Akron
50,2000-2001,2000-10-08,2001-04-17,192,0,84,325,409,87,134,221,630,56,298,OH - Akron
51,2001-2002,2001-12-01,2002-04-06,127,0,38,191,229,45,42,87,316,31,138,OH - Akron
52,2002-2003,2002-10-29,2003-03-31,154,0,98,351,449,91,154,245,694,56,330,OH - Akron
53,2003-2004,2003-11-28,2004-04-27,152,0,68,276,344,82,140,222,566,48,241,OH - Akron
54,2004-2005,2004-11-25,2005-04-25,152,0,69,295,364,90,143,233,597,47,268,OH - Akron
55,2005-2006,2005-10-28,2006-04-05,160,0,51,238,289,63,69,132,421,45,187,OH - Akron
56,2006-2007,2006-10-12,2007-04-14,185,0,80,294,374,74,88,162,536,51,259,OH - Akron
57,2007-2008,2007-11-06,2008-03-22,138,0,63,275,338,104,148,252,590,49,275,OH - Akron
58,2008-2009,2008-10-29,2009-04-07,161,0,84,347,431,97,170,267,698,57,330,OH - Akron
59,2009-2010,2009-12-01,2010-03-26,116,0,70,240,310,95,231,326,636,41,250,OH - Akron
60,2010-2011,2010-11-06,2011-03-31,146,0,89,308,397,96,247,343,740,52,303,OH - Akron
61,2011-2012,2011-11-30,2012-04-11,134,0,25,151,176,51,45,96,272,34,132,OH - Akron
62,2012-2013,2012-11-24,2013-04-20,148,0,49,225,274,78,118,196,470,44,224,OH - Akron
63,2013-2014,2013-11-11,2014-04-15,156,0,109,381,490,111,198,309,799,61,384,OH - Akron
64,2014-2015,2014-11-16,2015-03-28,133,2,97,354,451,93,293,386,837,44,292,OH - Akron
65,2015-2016,2015-12-01,2016-04-09,131,0,44,192,236,54,51,105,341,35,188,OH - Akron
66,2016-2017,2016-11-19,2017-04-07,140,0,42,180,222,58,70,128,350,34,150,OH - Akron
67,2017-2018,2017-11-19,2018-04-19,152,0,75,293,368,86,110,196,564,51,262,OH - Akron
68,2018-2019,2018-11-09,2019-03-31,143,0,56,236,292,71,73,144,436,46,212,OH - Akron
69,2019-2020,2019-11-07,2020-04-17,163,0,18,166,184,52,28,80,264,35,112,OH - Akron
13,1963-1964,1963-12-01,1964-04-01,123,3,39,315,354,63,180,243,597,20,137,OH - Cambridge
15,1965-1966,1965-12-01,1966-04-09,130,3,41,251,292,39,95,134,426,14,88,OH - Cambridge
16,1966-1967,1966-11-29,1967-03-20,112,1,31,250,281,59,80,139,420,19,124,OH - Cambridge
17,1967-1968,1967-11-08,1968-03-24,138,1,40,330,370,55,169,224,594,16,110,OH - Cambridge
18,1968-1969,1968-12-01,1969-03-11,101,1,37,225,262,19,21,40,302,7,42,OH - Cambridge
20,1970-1971,1970-11-24,1971-03-08,105,19,49,229,278,15,17,32,310,6,40,OH - Cambridge
21,1971-1972,1971-12-01,1972-04-08,130,5,26,251,277,15,9,24,301,6,36,OH - Cambridge
26,1976-1977,1976-11-23,1977-03-01,99,1,80,389,469,53,245,298,767,28,210,OH - Cambridge
27,1977-1978,1977-11-26,1978-03-16,111,1,84,376,460,74,289,363,823,23,175,OH - Cambridge
28,1978-1979,1978-11-27,1979-02-28,94,0,64,284,348,46,189,235,583,14,109,OH - Cambridge
29,1979-1980,1979-11-30,1980-03-03,95,0,40,228,268,16,19,35,303,8,46,OH - Cambridge
31,1981-1982,1981-11-21,1982-04-09,140,5,46,292,338,49,87,136,474,20,128,OH - Cambridge
32,1982-1983,1982-12-01,1983-03-11,101,0,11,149,160,11,16,27,187,7,21,OH - Cambridge
33,1983-1984,1983-11-12,1984-03-22,132,6,53,277,330,27,53,80,410,12,72,OH - Cambridge
34,1984-1985,1984-11-19,1985-02-28,102,1,49,251,300,52,207,259,559,21,136,OH - Cambridge
35,1985-1986,1985-12-01,1986-03-21,111,2,50,236,286,31,55,86,372,13,77,OH - Cambridge
36,1986-1987,1986-12-01,1987-04-07,128,0,14,180,194,33,42,75,269,5,41,OH - Cambridge
37,1987-1988,1987-11-11,1988-03-21,132,0,40,240,280,21,26,47,327,11,57,OH - Cambridge
38,1988-1989,1988-12-01,1989-03-21,111,0,27,191,218,23,13,36,254,11,57,OH - Cambridge
39,1989-1990,1989-11-22,1990-03-24,123,0,51,219,270,33,62,95,365,14,78,OH - Cambridge
40,1990-1991,1990-12-01,1991-03-14,104,0,14,148,162,14,9,23,185,6,31,OH - Cambridge
41,1991-1992,1991-11-04,1992-03-21,139,1,21,206,227,29,49,78,305,13,77,OH - Cambridge
42,1992-1993,1992-12-01,1993-03-18,108,4,21,171,192,19,38,57,249,4,33,OH - Cambridge
43,1993-1994,1993-12-01,1994-03-11,101,3,56,249,305,32,125,157,462,13,73,OH - Cambridge
44,1994-1995,1994-12-01,1995-03-09,99,0,28,196,224,22,98,120,344,8,52,OH - Cambridge
45,1995-1996,1995-11-13,1996-03-22,131,5,71,294,365,43,108,151,516,23,135,OH - Cambridge
46,1996-1997,1996-11-27,1997-02-28,94,2,33,161,194,6,7,13,207,3,9,OH - Cambridge
47,1997-1998,1997-12-01,1998-03-12,102,1,7,101,108,8,4,12,120,4,18,OH - Cambridge
48,1998-1999,1998-12-01,1999-03-15,105,5,27,180,207,37,92,129,336,11,74,OH - Cambridge
49,1999-2000,1999-12-01,2000-03-12,103,4,31,186,217,26,84,110,327,11,57,OH - Cambridge
50,2000-2001,2000-11-18,2001-03-26,129,6,45,251,296,20,74,94,390,10,57,OH - Cambridge
52,2002-2003,2002-11-27,2003-03-10,104,3,52,234,286,54,158,212,498,20,130,OH - Cambridge
53,2003-2004,2003-11-29,2004-03-22,115,7,37,216,253,31,53,84,337,17,76,OH - Cambridge
54,2004-2005,2004-12-01,2005-03-12,102,9,32,180,212,23,48,71,283,15,89,OH - Cambridge
55,2005-2006,2005-11-24,2006-03-07,104,0,21,145,166,14,14,28,194,10,39,OH - Cambridge
56,2006-2007,2006-12-01,2007-04-08,129,5,48,222,270,36,79,115,385,19,117,OH - Cambridge
57,2007-2008,2007-12-01,2008-03-12,103,5,29,186,215,49,73,122,337,23,140,OH - Cambridge
58,2008-2009,2008-11-17,2009-03-03,107,6,47,260,307,22,68,90,397,15,79,OH - Cambridge
59,2009-2010,2009-12-01,2010-03-07,97,0,43,214,257,63,229,292,549,22,132,OH - Cambridge
60,2010-2011,2010-12-01,2011-03-11,101,2,50,237,287,31,102,133,420,13,68,OH - Cambridge
61,2011-2012,2011-12-01,2012-02-29,91,1,9,116,125,3,7,10,135,1,7,OH - Cambridge
62,2012-2013,2012-12-01,2013-03-25,115,7,26,176,202,26,99,125,327,9,48,OH - Cambridge
63,2013-2014,2013-11-12,2014-03-30,139,5,65,335,400,46,131,177,577,15,106,OH - Cambridge
64,2014-2015,2014-11-18,2015-03-24,127,2,60,282,342,33,97,130,472,16,104,OH - Cambridge
65,2015-2016,2015-12-01,2016-02-29,91,9,24,157,181,3,28,31,212,1,11,OH - Cambridge
66,2016-2017,2016-11-20,2017-03-15,116,7,20,142,162,4,9,13,175,2,7,OH - Cambridge
67,2017-2018,2017-12-01,2018-02-28,90,11,53,194,247,3,63,66,313,1,9,OH - Cambridge
68,2018-2019,2018-11-28,2019-03-06,99,4,31,189,220,19,29,48,268,5,48,OH - Cambridge
69,2019-2020,2019-11-13,2020-03-15,124,5,13,187,200,9,9,18,218,5,14,OH - Cambridge
0,1950-1951,1950-11-10,1951-03-25,136,0,62,264,326,69,103,172,498,33,206,OH - Cincinnati
1,1951-1952,1951-11-02,1952-03-02,122,0,27,167,194,30,33,63,257,20,72,OH - Cincinnati
2,1952-1953,1952-11-28,1953-04-19,143,0,15,120,135,40,26,66,201,17,78,OH - Cincinnati
3,1953-1954,1953-11-25,1954-03-15,111,0,21,149,170,21,18,39,209,14,44,OH - Cincinnati
4,1954-1955,1954-11-02,1955-03-27,146,0,33,186,219,41,35,76,295,31,113,OH - Cincinnati
5,1955-1956,1955-11-18,1956-04-08,143,0,25,219,244,44,54,98,342,25,96,OH - Cincinnati
6,1956-1957,1956-11-21,1957-04-08,139,0,24,159,183,30,11,41,224,27,89,OH - Cincinnati
7,1957-1958,1957-11-30,1958-03-20,111,0,48,208,256,37,19,56,312,24,107,OH - Cincinnati
8,1958-1959,1958-11-28,1959-04-12,136,0,46,258,304,49,54,103,407,22,114,OH - Cincinnati
9,1959-1960,1959-11-24,1960-03-22,120,0,37,212,249,58,61,119,368,39,164,OH - Cincinnati
10,1960-1961,1960-11-30,1961-04-17,139,0,46,207,253,54,93,147,400,28,167,OH - Cincinnati
11,1961-1962,1961-11-19,1962-04-01,134,0,44,213,257,42,38,80,337,22,111,OH - Cincinnati
12,1962-1963,1962-10-25,1963-03-21,148,0,74,363,437,43,57,100,537,29,161,OH - Cincinnati
13,1963-1964,1963-11-13,1964-03-29,138,0,48,281,329,55,66,121,450,31,139,OH - Cincinnati
14,1964-1965,1964-11-20,1965-03-26,127,0,43,283,326,36,59,95,421,22,129,OH - Cincinnati
15,1965-1966,1965-11-29,1966-04-05,128,0,50,215,265,35,69,104,369,15,95,OH - Cincinnati
16,1966-1967,1966-11-02,1967-03-20,139,0,36,231,267,50,34,84,351,24,113,OH - Cincinnati
17,1967-1968,1967-11-05,1968-03-24,141,0,45,264,309,51,62,113,422,25,132,OH - Cincinnati
18,1968-1969,1968-11-12,1969-03-26,135,0,33,210,243,20,1,21,264,18,55,OH - Cincinnati
19,1969-1970,1969-11-14,1970-03-29,136,0,56,274,330,55,79,134,464,35,179,OH - Cincinnati
20,1970-1971,1970-11-14,1971-03-26,133,0,46,227,273,44,41,85,358,22,106,OH - Cincinnati
21,1971-1972,1971-11-06,1972-04-02,149,0,32,237,269,28,28,56,325,18,79,OH - Cincinnati
22,1972-1973,1972-11-22,1973-04-10,140,0,25,169,194,29,12,41,235,17,56,OH - Cincinnati
23,1973-1974,1973-11-05,1974-04-08,155,0,32,182,214,22,13,35,249,16,73,OH - Cincinnati
24,1974-1975,1974-11-30,1975-04-03,125,0,12,149,161,37,19,56,217,24,79,OH - Cincinnati
25,1975-1976,1975-11-13,1976-03-16,125,0,23,195,218,25,20,45,263,18,70,OH - Cincinnati
26,1976-1977,1976-11-22,1977-04-06,136,0,106,400,506,72,216,288,794,35,222,OH - Cincinnati
27,1977-1978,1977-11-26,1978-03-16,111,0,116,390,506,83,304,387,893,38,264,OH - Cincinnati
28,1978-1979,1978-12-01,1979-04-07,128,0,78,300,378,49,142,191,569,28,180,OH - Cincinnati
29,1979-1980,1979-11-28,1980-03-17,111,0,53,242,295,50,89,139,434,25,144,OH - Cincinnati
30,1980-1981,1980-11-17,1981-03-19,123,0,57,267,324,26,35,61,385,18,76,OH - Cincinnati
31,1981-1982,1981-11-20,1982-04-09,141,0,65,298,363,41,62,103,466,23,145,OH - Cincinnati
32,1982-1983,1982-12-01,1983-03-21,111,0,19,124,143,14,10,24,167,11,31,OH - Cincinnati
33,1983-1984,1983-12-01,1984-03-22,113,0,80,279,359,34,39,73,432,25,118,OH - Cincinnati
34,1984-1985,1984-11-18,1985-04-07,141,0,58,236,294,55,173,228,522,27,153,OH - Cincinnati
35,1985-1986,1985-12-01,1986-03-07,97,0,47,228,275,36,37,73,348,23,116,OH - Cincinnati
36,1986-1987,1986-11-13,1987-04-05,144,0,17,163,180,26,13,39,219,14,51,OH - Cincinnati
37,1987-1988,1987-11-20,1988-03-18,120,0,44,237,281,25,16,41,322,20,110,OH - Cincinnati
38,1988-1989,1988-11-06,1989-05-06,182,0,19,181,200,19,7,26,226,16,57,OH - Cincinnati
39,1989-1990,1989-10-19,1990-03-25,158,0,42,221,263,47,80,127,390,19,117,OH - Cincinnati
40,1990-1991,1990-12-01,1991-02-28,90,0,20,131,151,28,14,42,193,16,85,OH - Cincinnati
41,1991-1992,1991-11-04,1992-04-04,153,0,15,173,188,26,8,34,222,21,73,OH - Cincinnati
42,1992-1993,1992-11-05,1993-03-18,134,1,29,191,220,46,50,96,316,23,99,OH - Cincinnati
43,1993-1994,1993-10-30,1994-04-03,156,0,60,247,307,52,73,125,432,25,136,OH - Cincinnati
44,1994-1995,1994-12-01,1995-03-10,100,0,31,173,204,38,88,126,330,16,86,OH - Cincinnati
45,1995-1996,1995-11-13,1996-04-07,147,0,72,300,372,72,83,155,527,38,221,OH - Cincinnati
46,1996-1997,1996-11-09,1997-02-28,112,0,36,192,228,23,6,29,257,17,69,OH - Cincinnati
47,1997-1998,1997-11-15,1998-03-21,127,0,9,122,131,50,42,92,223,21,86,OH - Cincinnati
48,1998-1999,1998-12-01,1999-03-16,106,0,28,178,206,41,56,97,303,20,121,OH - Cincinnati
49,1999-2000,1999-12-01,2000-04-04,126,0,33,187,220,25,58,83,303,19,97,OH - Cincinnati
50,2000-2001,2000-11-21,2001-04-17,148,0,44,252,296,33,56,89,385,24,119,OH - Cincinnati
51,2001-2002,2001-12-01,2002-04-06,127,0,12,157,169,17,14,31,200,11,50,OH - Cincinnati
52,2002-2003,2002-11-26,2003-03-10,105,0,49,225,274,50,107,157,431,29,134,OH - Cincinnati
53,2003-2004,2003-11-28,2004-04-13,138,0,28,191,219,35,50,85,304,17,78,OH - Cincinnati
54,2004-2005,2004-12-01,2005-04-24,145,0,27,184,211,39,81,120,331,22,91,OH - Cincinnati
55,2005-2006,2005-11-17,2006-03-22,126,0,21,164,185,31,28,59,244,17,65,OH - Cincinnati
56,2006-2007,2006-12-01,2007-04-06,127,0,42,204,246,29,60,89,335,15,91,OH - Cincinnati
57,2007-2008,2007-12-01,2008-03-19,110,3,30,188,218,42,37,79,297,23,113,OH - Cincinnati
58,2008-2009,2008-12-01,2009-03-03,93,0,43,214,257,36,64,100,357,19,109,OH - Cincinnati
59,2009-2010,2009-12-01,2010-02-28,90,0,44,201,245,62,145,207,452,27,154,OH - Cincinnati
60,2010-2011,2010-11-26,2011-03-30,125,0,50,224,274,58,123,181,455,33,149,OH - Cincinnati
61,2011-2012,2011-11-29,2012-03-05,98,0,10,107,117,11,4,15,132,10,35,OH - Cincinnati
62,2012-2013,2012-12-01,2013-03-26,116,0,25,161,186,43,38,81,267,28,99,OH - Cincinnati
63,2013-2014,2013-11-12,2014-04-15,155,0,56,311,367,78,119,197,564,41,231,OH - Cincinnati
64,2014-2015,2014-11-13,2015-03-07,115,0,51,258,309,47,90,137,446,19,128,OH - Cincinnati
65,2015-2016,2015-12-01,2016-03-04,95,0,26,132,158,29,34,63,221,14,83,OH - Cincinnati
66,2016-2017,2016-12-01,2017-03-17,107,0,22,130,152,19,6,25,177,14,46,OH - Cincinnati
67,2017-2018,2017-12-01,2018-04-16,137,0,50,216,266,41,40,81,347,28,123,OH - Cincinnati
68,2018-2019,2018-11-10,2019-03-08,119,0,29,163,192,39,47,86,278,24,107,OH - Cincinnati
69,2019-2020,2019-11-11,2020-02-29,111,0,7,107,114,22,9,31,145,15,46,OH - Cincinnati
0,1950-1951,1950-11-11,1951-04-17,158,0,75,292,367,119,245,364,731,50,301,OH - Cleveland
1,1951-1952,1951-11-02,1952-04-07,158,0,50,247,297,115,129,244,541,50,250,OH - Cleveland
2,1952-1953,1952-10-20,1953-04-21,184,0,22,177,199,58,43,101,300,39,144,OH - Cleveland
3,1953-1954,1953-11-05,1954-04-03,150,0,41,214,255,107,107,214,469,52,241,OH - Cleveland
4,1954-1955,1954-10-16,1955-03-30,166,0,54,237,291,81,97,178,469,46,236,OH - Cleveland
5,1955-1956,1955-11-17,1956-04-18,154,2,52,260,312,91,136,227,539,52,229,OH - Cleveland
6,1956-1957,1956-11-21,1957-04-13,144,0,51,225,276,90,126,216,492,51,221,OH - Cleveland
7,1957-1958,1957-10-27,1958-04-07,163,0,65,229,294,56,65,121,415,39,177,OH - Cleveland
8,1958-1959,1958-11-26,1959-03-22,117,0,93,322,415,85,172,257,672,46,267,OH - Cleveland
9,1959-1960,1959-11-12,1960-04-09,150,0,68,270,338,88,178,266,604,59,257,OH - Cleveland
10,1960-1961,1960-11-05,1961-04-18,165,0,95,335,430,64,148,212,642,42,224,OH - Cleveland
11,1961-1962,1961-11-17,1962-04-15,150,0,87,313,400,62,63,125,525,38,194,OH - Cleveland
12,1962-1963,1962-10-25,1963-05-01,189,0,130,419,549,113,341,454,1003,53,378,OH - Cleveland
13,1963-1964,1963-11-29,1964-04-09,133,0,88,287,375,91,168,259,634,51,261,OH - Cleveland
14,1964-1965,1964-11-20,1965-04-02,134,0,81,280,361,86,112,198,559,55,303,OH - Cleveland
15,1965-1966,1965-11-29,1966-04-07,130,0,80,260,340,71,100,171,511,49,252,OH - Cleveland
16,1966-1967,1966-11-03,1967-04-24,173,0,59,256,315,86,128,214,529,52,252,OH - Cleveland
17,1967-1968,1967-10-28,1968-04-25,181,0,87,325,412,71,142,213,625,46,251,OH - Cleveland
18,1968-1969,1968-11-09,1969-04-19,162,0,83,267,350,69,83,152,502,44,200,OH - Cleveland
19,1969-1970,1969-10-22,1970-04-02,163,0,106,323,429,94,209,303,732,67,335,OH - Cleveland
20,1970-1971,1970-11-15,1971-04-24,161,0,91,319,410,83,131,214,624,46,283,OH - Cleveland
21,1971-1972,1971-11-04,1972-04-08,157,0,67,276,343,82,81,163,506,55,267,OH - Cleveland
22,1972-1973,1972-10-18,1973-05-04,199,0,43,199,242,106,139,245,487,46,213,OH - Cleveland
23,1973-1974,1973-11-09,1974-05-07,180,0,50,209,259,101,139,240,499,56,249,OH - Cleveland
24,1974-1975,1974-10-02,1975-04-15,196,0,39,214,253,109,111,220,473,56,219,OH - Cleveland
25,1975-1976,1975-11-13,1976-04-04,144,0,64,240,304,89,143,232,536,49,252,OH - Cleveland
26,1976-1977,1976-10-26,1977-04-06,163,0,141,472,613,114,322,436,1049,73,494,OH - Cleveland
27,1977-1978,1977-11-11,1978-04-21,162,0,108,436,544,138,449,587,1131,56,421,OH - Cleveland
28,1978-1979,1978-11-27,1979-04-09,134,0,92,324,416,68,209,277,693,43,251,OH - Cleveland
29,1979-1980,1979-10-25,1980-03-18,146,0,87,298,385,67,163,230,615,39,224,OH - Cleveland
30,1980-1981,1980-11-17,1981-03-21,125,0,90,306,396,95,212,307,703,53,323,OH - Cleveland
31,1981-1982,1981-10-19,1982-04-10,174,0,90,347,437,150,252,402,839,62,407,OH - Cleveland
32,1982-1983,1982-11-15,1983-04-19,156,0,28,171,199,58,82,140,339,31,131,OH - Cleveland
33,1983-1984,1983-11-11,1984-03-29,140,0,121,341,462,126,250,376,838,52,342,OH - Cleveland
34,1984-1985,1984-11-11,1985-04-09,150,0,88,290,378,96,222,318,696,48,292,OH - Cleveland
35,1985-1986,1985-12-01,1986-04-11,132,0,80,286,366,90,164,254,620,52,312,OH - Cleveland
36,1986-1987,1986-11-11,1987-04-05,146,0,35,232,267,88,113,201,468,36,168,OH - Cleveland
37,1987-1988,1987-11-20,1988-04-16,149,0,63,274,337,107,127,234,571,52,281,OH - Cleveland
38,1988-1989,1988-11-06,1989-04-18,164,0,48,237,285,83,82,165,450,44,212,OH - Cleveland
39,1989-1990,1989-11-03,1990-04-12,161,0,62,274,336,93,127,220,556,43,236,OH - Cleveland
40,1990-1991,1990-12-01,1991-03-11,101,0,32,178,210,78,90,168,378,41,202,OH - Cleveland
41,1991-1992,1991-11-04,1992-04-03,152,0,37,216,253,103,106,209,462,51,243,OH - Cleveland
42,1992-1993,1992-11-05,1993-04-21,168,0,44,225,269,129,162,291,560,51,246,OH - Cleveland
43,1993-1994,1993-10-31,1994-04-07,159,0,97,329,426,115,221,336,762,56,320,OH - Cleveland
44,1994-1995,1994-12-01,1995-04-01,122,0,39,212,251,68,121,189,440,30,169,OH - Cleveland
45,1995-1996,1995-11-08,1996-04-23,168,1,113,350,463,148,251,399,862,63,410,OH - Cleveland
46,1996-1997,1996-11-02,1997-04-17,167,0,60,243,303,89,85,174,477,46,230,OH - Cleveland
47,1997-1998,1997-11-13,1998-03-24,132,0,25,141,166,58,45,103,269,35,122,OH - Cleveland
48,1998-1999,1998-11-21,1999-03-16,116,0,54,209,263,92,135,227,490,37,239,OH - Cleveland
49,1999-2000,1999-11-03,2000-04-09,159,0,55,226,281,88,145,233,514,39,218,OH - Cleveland
50,2000-2001,2000-10-08,2001-04-17,192,0,78,285,363,119,176,295,658,56,313,OH - Cleveland
51,2001-2002,2001-10-26,2002-04-06,163,0,30,160,190,73,63,136,326,35,162,OH - Cleveland
52,2002-2003,2002-11-22,2003-04-05,135,0,88,290,378,144,239,383,761,60,376,OH - Cleveland
53,2003-2004,2003-10-02,2004-04-27,209,0,63,243,306,130,179,309,615,59,286,OH - Cleveland
54,2004-2005,2004-11-25,2005-04-25,152,0,67,250,317,166,257,423,740,49,304,OH - Cleveland
55,2005-2006,2005-11-17,2006-04-05,140,0,44,189,233,78,116,194,427,41,172,OH - Cleveland
56,2006-2007,2006-11-02,2007-04-14,164,0,84,256,340,112,168,280,620,49,307,OH - Cleveland
57,2007-2008,2007-11-22,2008-03-25,125,0,51,240,291,109,166,275,566,44,245,OH - Cleveland
58,2008-2009,2008-10-29,2009-04-07,161,0,82,309,391,123,233,356,747,53,313,OH - Cleveland
59,2009-2010,2009-11-27,2010-03-25,119,0,46,186,232,86,286,372,604,41,198,OH - Cleveland
60,2010-2011,2010-12-01,2011-03-31,121,0,79,261,340,105,232,337,677,46,246,OH - Cleveland
61,2011-2012,2011-11-11,2012-04-11,153,0,19,120,139,64,50,114,253,34,133,OH - Cleveland
62,2012-2013,2012-11-24,2013-04-20,148,0,51,202,253,83,110,193,446,44,215,OH - Cleveland
63,2013-2014,2013-11-08,2014-04-15,159,0,103,361,464,124,259,383,847,61,376,OH - Cleveland
64,2014-2015,2014-11-13,2015-04-23,162,0,117,370,487,96,279,375,862,42,294,OH - Cleveland
65,2015-2016,2015-10-17,2016-04-10,177,0,41,185,226,54,75,129,355,32,146,OH - Cleveland
66,2016-2017,2016-11-19,2017-04-07,140,0,33,138,171,59,45,104,275,36,139,OH - Cleveland
67,2017-2018,2017-11-10,2018-04-19,161,0,72,267,339,88,144,232,571,53,252,OH - Cleveland
68,2018-2019,2018-11-09,2019-04-01,144,0,48,205,253,66,58,124,377,44,182,OH - Cleveland
69,2019-2020,2019-11-07,2020-05-11,187,0,15,144,159,55,43,98,257,37,110,OH - Cleveland
0,1950-1951,1950-11-23,1951-03-21,119,0,69,279,348,62,144,206,554,27,175,OH - Columbus
1,1951-1952,1951-11-01,1952-03-09,130,0,29,208,237,41,53,94,331,23,80,OH - Columbus
2,1952-1953,1952-11-28,1953-04-21,145,0,20,168,188,47,25,72,260,24,111,OH - Columbus
3,1953-1954,1953-11-07,1954-04-04,149,0,18,206,224,38,30,68,292,21,78,OH - Columbus
4,1954-1955,1954-10-31,1955-03-27,148,0,41,234,275,44,38,82,357,36,135,OH - Columbus
5,1955-1956,1955-11-18,1956-04-16,151,0,29,252,281,54,62,116,397,31,131,OH - Columbus
6,1956-1957,1956-11-21,1957-04-09,140,0,27,205,232,47,29,76,308,35,149,OH - Columbus
7,1957-1958,1957-12-01,1958-03-20,110,0,49,223,272,42,29,71,343,23,121,OH - Columbus
8,1958-1959,1958-11-28,1959-04-12,136,0,67,315,382,45,88,133,515,22,100,OH - Columbus
9,1959-1960,1959-11-25,1960-03-26,123,0,50,232,282,49,74,123,405,31,132,OH - Columbus
10,1960-1961,1960-11-29,1961-04-17,140,0,63,276,339,61,197,258,597,26,155,OH - Columbus
11,1961-1962,1961-11-19,1962-04-20,153,0,66,300,366,59,91,150,516,28,152,OH - Columbus
12,1962-1963,1962-10-25,1963-03-21,148,0,95,374,469,57,116,173,642,35,206,OH - Columbus
13,1963-1964,1963-11-13,1964-03-31,140,0,69,296,365,57,93,150,515,28,148,OH - Columbus
14,1964-1965,1964-11-21,1965-03-25,125,0,64,268,332,56,59,115,447,34,169,OH - Columbus
15,1965-1966,1965-11-28,1966-04-09,133,0,62,245,307,33,76,109,416,22,111,OH - Columbus
16,1966-1967,1966-11-02,1967-03-20,139,0,46,237,283,72,70,142,425,31,155,OH - Columbus
17,1967-1968,1967-11-05,1968-03-24,141,0,69,301,370,53,78,131,501,29,134,OH - Columbus
18,1968-1969,1968-11-09,1969-04-19,162,0,50,267,317,35,9,44,361,27,107,OH - Columbus
19,1969-1970,1969-11-13,1970-04-06,145,0,84,334,418,73,122,195,613,49,271,OH - Columbus
20,1970-1971,1970-11-15,1971-03-23,129,0,67,257,324,57,46,103,427,33,161,OH - Columbus
21,1971-1972,1971-11-06,1972-04-08,155,0,50,283,333,44,31,75,408,31,131,OH - Columbus
22,1972-1973,1972-11-26,1973-04-12,138,0,32,166,198,40,18,58,256,17,70,OH - Columbus
23,1973-1974,1973-12-01,1974-04-08,129,0,38,189,227,30,43,73,300,19,91,OH - Columbus
24,1974-1975,1974-11-13,1975-03-26,134,0,26,168,194,42,18,60,254,30,100,OH - Columbus
25,1975-1976,1975-11-25,1976-03-17,114,0,51,209,260,34,32,66,326,21,100,OH - Columbus
26,1976-1977,1976-11-08,1977-04-05,149,0,139,428,567,59,243,302,869,34,215,OH - Columbus
27,1977-1978,1977-11-26,1978-03-16,111,0,132,374,506,87,330,417,923,40,294,OH - Columbus
28,1978-1979,1978-11-26,1979-04-09,135,0,94,314,408,63,187,250,658,34,187,OH - Columbus
29,1979-1980,1979-11-28,1980-03-17,111,0,55,230,285,32,27,59,344,21,97,OH - Columbus
30,1980-1981,1980-11-17,1981-03-20,124,0,60,262,322,53,109,162,484,32,124,OH - Columbus
31,1981-1982,1981-11-21,1982-04-09,140,0,76,311,387,66,96,162,549,40,245,OH - Columbus
32,1982-1983,1982-12-01,1983-04-18,139,0,21,172,193,23,18,41,234,18,61,OH - Columbus
33,1983-1984,1983-11-11,1984-04-18,160,0,83,305,388,60,112,172,560,34,163,OH - Columbus
34,1984-1985,1984-11-18,1985-04-08,142,0,72,272,344,62,233,295,639,28,203,OH - Columbus
35,1985-1986,1985-12-01,1986-03-21,111,0,53,233,286,46,44,90,376,31,146,OH - Columbus
36,1986-1987,1986-11-11,1987-04-06,147,0,19,177,196,43,20,63,259,20,69,OH - Columbus
37,1987-1988,1987-11-20,1988-03-20,122,0,48,242,290,54,31,85,375,44,209,OH - Columbus
38,1988-1989,1988-11-06,1989-05-07,183,0,27,223,250,34,15,49,299,25,90,OH - Columbus
39,1989-1990,1989-10-19,1990-04-11,175,0,57,257,314,43,73,116,430,29,139,OH - Columbus
40,1990-1991,1990-12-01,1991-03-14,104,0,20,159,179,26,25,51,230,19,91,OH - Columbus
41,1991-1992,1991-11-04,1992-04-04,153,0,21,190,211,38,39,77,288,26,89,OH - Columbus
42,1992-1993,1992-11-05,1993-04-02,149,0,31,195,226,51,57,108,334,32,110,OH - Columbus
43,1993-1994,1993-10-30,1994-04-07,160,0,69,284,353,66,108,174,527,41,202,OH - Columbus
44,1994-1995,1994-12-01,1995-03-10,100,0,41,201,242,36,83,119,361,23,110,OH - Columbus
45,1995-1996,1995-11-11,1996-04-16,158,0,75,308,383,90,132,222,605,49,261,OH - Columbus
46,1996-1997,1996-11-09,1997-03-15,127,1,42,201,243,16,6,22,265,14,56,OH - Columbus
47,1997-1998,1997-11-04,1998-03-23,140,0,11,118,129,21,7,28,157,19,52,OH - Columbus
48,1998-1999,1998-12-01,1999-03-15,105,0,33,171,204,63,122,185,389,28,154,OH - Columbus
49,1999-2000,1999-11-02,2000-04-04,155,0,39,205,244,50,123,173,417,30,134,OH - Columbus
50,2000-2001,2000-11-14,2001-04-17,155,0,56,257,313,53,72,125,438,41,194,OH - Columbus
51,2001-2002,2001-12-01,2002-04-03,124,0,22,139,161,21,8,29,190,17,66,OH - Columbus
52,2002-2003,2002-11-22,2003-03-10,109,0,63,252,315,80,99,179,494,46,220,OH - Columbus
53,2003-2004,2003-11-24,2004-04-04,133,0,50,211,261,47,40,87,348,32,145,OH - Columbus
54,2004-2005,2004-11-25,2005-04-24,151,0,44,211,255,61,67,128,383,35,148,OH - Columbus
55,2005-2006,2005-11-17,2006-03-25,129,0,28,159,187,27,25,52,239,22,60,OH - Columbus
56,2006-2007,2006-11-20,2007-04-07,139,0,53,208,261,42,57,99,360,25,121,OH - Columbus
57,2007-2008,2007-12-01,2008-03-19,110,0,30,181,211,72,70,142,353,30,160,OH - Columbus
58,2008-2009,2008-11-17,2009-04-06,141,0,58,251,309,38,87,125,434,22,118,OH - Columbus
59,2009-2010,2009-12-01,2010-03-26,116,0,53,207,260,79,177,256,516,35,193,OH - Columbus
60,2010-2011,2010-12-01,2011-03-30,120,0,59,228,287,51,94,145,432,36,148,OH - Columbus
61,2011-2012,2011-12-01,2012-03-05,96,0,15,103,118,23,14,37,155,16,63,OH - Columbus
62,2012-2013,2012-10-30,2013-03-27,149,0,31,181,212,60,92,152,364,31,137,OH - Columbus
63,2013-2014,2013-11-11,2014-04-15,156,0,69,323,392,87,159,246,638,42,235,OH - Columbus
64,2014-2015,2014-11-16,2015-03-24,129,0,82,303,385,46,117,163,548,22,139,OH - Columbus
65,2015-2016,2015-12-01,2016-04-09,131,0,35,161,196,28,29,57,253,17,92,OH - Columbus
66,2016-2017,2016-12-01,2017-03-17,107,0,27,138,165,19,12,31,196,15,54,OH - Columbus
67,2017-2018,2017-12-01,2018-04-19,140,0,61,234,295,51,65,116,411,34,148,OH - Columbus
68,2018-2019,2018-11-15,2019-03-06,112,0,39,167,206,49,48,97,303,29,137,OH - Columbus
69,2019-2020,2019-11-11,2020-03-14,125,0,15,140,155,21,13,34,189,16,45,OH - Columbus
0,1950-1951,1950-11-10,1951-03-21,132,3,83,304,387,86,157,243,630,36,242,OH - Dayton
1,1951-1952,1951-11-02,1952-03-09,129,6,39,210,249,40,57,97,346,20,96,OH - Dayton
2,1952-1953,1952-11-28,1953-04-20,144,0,23,162,185,36,26,62,247,23,102,OH - Dayton
3,1953-1954,1953-11-25,1954-04-04,131,0,28,193,221,33,33,66,287,21,85,OH - Dayton
4,1954-1955,1954-10-30,1955-03-28,150,0,45,223,268,46,44,90,358,34,127,OH - Dayton
5,1955-1956,1955-11-18,1956-04-07,142,0,44,263,307,50,73,123,430,29,130,OH - Dayton
6,1956-1957,1956-11-22,1957-04-13,143,0,35,217,252,33,30,63,315,26,120,OH - Dayton
7,1957-1958,1957-10-27,1958-03-21,146,0,60,248,308,40,32,72,380,23,91,OH - Dayton
8,1958-1959,1958-11-28,1959-03-17,110,0,79,315,394,52,87,139,533,26,150,OH - Dayton
9,1959-1960,1959-11-18,1960-04-09,144,0,62,266,328,56,80,136,464,35,162,OH - Dayton
10,1960-1961,1960-11-06,1961-04-17,163,0,76,286,362,65,158,223,585,37,216,OH - Dayton
11,1961-1962,1961-11-19,1962-04-01,134,0,65,287,352,61,83,144,496,28,161,OH - Dayton
12,1962-1963,1962-10-25,1963-03-21,148,0,102,377,479,56,102,158,637,33,228,OH - Dayton
13,1963-1964,1963-11-13,1964-03-30,139,0,56,293,349,66,106,172,521,28,144,OH - Dayton
14,1964-1965,1964-11-19,1965-03-26,128,0,56,273,329,43,58,101,430,26,140,OH - Dayton
15,1965-1966,1965-11-29,1966-04-09,132,0,61,248,309,36,58,94,403,22,117,OH - Dayton
16,1966-1967,1966-11-02,1967-03-21,140,0,47,251,298,60,69,129,427,32,157,OH - Dayton
17,1967-1968,1967-11-04,1968-03-25,143,0,58,323,381,57,79,136,517,26,144,OH - Dayton
18,1968-1969,1968-11-11,1969-04-19,160,0,45,262,307,26,6,32,339,23,74,OH - Dayton
19,1969-1970,1969-11-14,1970-03-29,136,0,74,301,375,69,119,188,563,41,213,OH - Dayton
20,1970-1971,1970-11-14,1971-03-24,131,0,60,263,323,47,37,84,407,29,141,OH - Dayton
21,1971-1972,1971-11-06,1972-04-08,155,0,51,285,336,42,39,81,417,30,142,OH - Dayton
22,1972-1973,1972-11-22,1973-04-12,142,0,31,207,238,34,24,58,296,22,80,OH - Dayton
23,1973-1974,1973-12-01,1974-04-09,130,0,47,220,267,46,96,142,409,25,135,OH - Dayton
24,1974-1975,1974-11-14,1975-03-28,135,0,20,165,185,68,87,155,340,38,140,OH - Dayton
25,1975-1976,1975-11-13,1976-03-16,125,0,40,214,254,39,53,92,346,28,113,OH - Dayton
26,1976-1977,1976-11-12,1977-04-05,145,0,119,416,535,65,276,341,876,38,230,OH - Dayton
27,1977-1978,1977-11-12,1978-03-15,124,0,119,406,525,97,378,475,1000,39,288,OH - Dayton
28,1978-1979,1978-12-01,1979-03-25,115,0,93,315,408,65,184,249,657,31,212,OH - Dayton
29,1979-1980,1979-11-28,1980-03-17,111,0,61,266,327,40,63,103,430,24,133,OH - Dayton
30,1980-1981,1980-11-17,1981-03-20,124,0,61,275,336,41,73,114,450,29,130,OH - Dayton
31,1981-1982,1981-11-20,1982-04-10,142,0,78,330,408,69,122,191,599,37,237,OH - Dayton
32,1982-1983,1982-11-05,1983-04-17,164,0,29,195,224,17,6,23,247,16,65,OH - Dayton
33,1983-1984,1983-12-01,1984-03-25,116,0,110,316,426,65,95,160,586,34,189,OH - Dayton
34,1984-1985,1984-11-18,1985-04-09,143,0,90,293,383,56,198,254,637,28,184,OH - Dayton
35,1985-1986,1985-12-01,1986-04-16,137,0,64,270,334,49,50,99,433,35,168,OH - Dayton
36,1986-1987,1986-11-11,1987-04-05,146,0,31,201,232,32,19,51,283,16,65,OH - Dayton
37,1987-1988,1987-11-20,1988-03-20,122,0,55,252,307,35,28,63,370,28,131,OH - Dayton
38,1988-1989,1988-11-06,1989-04-09,155,0,38,220,258,33,21,54,312,26,110,OH - Dayton
39,1989-1990,1989-10-18,1990-04-11,176,0,64,264,328,43,68,111,439,27,144,OH - Dayton
40,1990-1991,1990-12-01,1991-03-14,104,0,28,170,198,24,22,46,244,18,79,OH - Dayton
41,1991-1992,1991-11-03,1992-04-04,154,0,30,223,253,34,31,65,318,25,119,OH - Dayton
42,1992-1993,1992-10-20,1993-03-18,150,0,41,229,270,50,64,114,384,31,114,OH - Dayton
43,1993-1994,1993-10-30,1994-04-07,160,0,84,306,390,73,83,156,546,41,246,OH - Dayton
44,1994-1995,1994-12-01,1995-04-24,145,0,50,215,265,32,57,89,354,22,92,OH - Dayton
47,1997-1998,1997-11-15,1998-03-23,129,0,21,143,164,20,5,25,189,13,55,OH - Dayton
48,1998-1999,1998-12-01,1999-03-14,104,0,43,202,245,45,94,139,384,18,130,OH - Dayton
49,1999-2000,1999-12-01,2000-03-12,103,2,45,212,257,41,97,138,395,16,116,OH - Dayton
50,2000-2001,2000-11-21,2001-04-17,148,0,62,291,353,29,68,97,450,22,119,OH - Dayton
51,2001-2002,2001-12-01,2002-04-05,126,0,26,166,192,15,9,24,216,12,44,OH - Dayton
52,2002-2003,2002-11-22,2003-03-31,130,6,78,293,371,69,109,178,549,34,194,OH - Dayton
53,2003-2004,2003-11-29,2004-03-18,111,0,52,228,280,30,33,63,343,16,87,OH - Dayton
54,2004-2005,2004-12-01,2005-04-24,145,0,58,243,301,55,94,149,450,27,136,OH - Dayton
55,2005-2006,2005-11-17,2006-03-25,129,0,44,213,257,43,65,108,365,25,109,OH - Dayton
56,2006-2007,2006-12-01,2007-04-06,127,0,65,243,308,32,68,100,408,19,121,OH - Dayton
57,2007-2008,2007-11-22,2008-03-22,122,0,47,245,292,66,67,133,425,30,181,OH - Dayton
58,2008-2009,2008-11-09,2009-03-12,124,3,77,296,373,35,62,97,470,23,121,OH - Dayton
59,2009-2010,2009-12-01,2010-03-26,116,0,65,245,310,67,149,216,526,37,205,OH - Dayton
60,2010-2011,2010-12-01,2011-03-30,120,0,73,265,338,45,123,168,506,31,148,OH - Dayton
61,2011-2012,2011-11-29,2012-03-04,97,0,18,142,160,21,9,30,190,18,75,OH - Dayton
62,2012-2013,2012-10-30,2013-04-20,173,0,42,220,262,61,82,143,405,32,147,OH - Dayton
63,2013-2014,2013-10-23,2014-04-15,175,0,83,361,444,85,200,285,729,41,248,OH - Dayton
64,2014-2015,2014-11-13,2015-03-24,132,0,77,305,382,45,102,147,529,26,161,OH - Dayton
65,2015-2016,2015-12-01,2016-04-09,131,0,35,176,211,28,26,54,265,21,105,OH - Dayton
66,2016-2017,2016-12-01,2017-03-17,107,0,38,164,202,19,16,35,237,14,66,OH - Dayton
67,2017-2018,2017-11-10,2018-04-16,158,0,77,288,365,49,70,119,484,33,172,OH - Dayton
68,2018-2019,2018-11-09,2019-03-17,129,0,44,197,241,50,60,110,351,30,156,OH - Dayton
69,2019-2020,2019-11-11,2020-03-15,126,0,16,137,153,28,31,59,212,17,60,OH - Dayton
0,1950-1951,1950-11-05,1951-03-22,138,3,100,368,468,58,152,210,678,36,227,OH - Defiance
1,1951-1952,1951-11-04,1952-03-17,135,0,50,296,346,53,122,175,521,29,174,OH - Defiance
2,1952-1953,1952-11-28,1953-03-09,102,0,33,208,241,31,51,82,323,17,95,OH - Defiance
3,1953-1954,1953-11-26,1954-03-31,126,5,35,262,297,42,57,99,396,21,109,OH - Defiance
4,1954-1955,1954-11-02,1955-03-29,148,1,53,305,358,37,79,116,474,19,104,OH - Defiance
5,1955-1956,1955-11-18,1956-04-24,159,3,57,371,428,50,101,151,579,20,105,OH - Defiance
6,1956-1957,1956-11-23,1957-04-10,139,11,62,308,370,71,130,201,571,27,152,OH - Defiance
7,1957-1958,1957-11-10,1958-03-25,136,1,67,303,370,27,118,145,515,14,67,OH - Defiance
8,1958-1959,1958-11-27,1959-03-18,112,1,99,396,495,31,142,173,668,12,96,OH - Defiance
9,1959-1960,1959-11-13,1960-03-26,135,2,58,349,407,45,149,194,601,14,90,OH - Defiance
10,1960-1961,1960-11-07,1961-04-17,162,0,80,404,484,30,110,140,624,11,89,OH - Defiance
11,1961-1962,1961-11-20,1962-03-16,117,1,87,371,458,55,144,199,657,17,128,OH - Defiance
12,1962-1963,1962-10-25,1963-03-08,135,4,132,492,624,43,188,231,855,22,184,OH - Defiance
13,1963-1964,1963-12-01,1964-03-31,122,1,79,402,481,50,158,208,689,16,111,OH - Defiance
14,1964-1965,1964-11-19,1965-04-02,135,3,88,430,518,63,138,201,719,20,146,OH - Defiance
15,1965-1966,1965-11-29,1966-04-06,129,3,63,327,390,15,41,56,446,9,47,OH - Defiance
16,1966-1967,1966-11-02,1967-03-20,139,3,71,344,415,54,105,159,574,17,105,OH - Defiance
17,1967-1968,1967-11-16,1968-03-25,131,0,82,385,467,35,112,147,614,14,101,OH - Defiance
18,1968-1969,1968-11-21,1969-03-31,131,0,72,343,415,17,51,68,483,8,44,OH - Defiance
19,1969-1970,1969-11-15,1970-03-19,125,0,99,421,520,47,199,246,766,18,111,OH - Defiance
20,1970-1971,1970-11-15,1971-03-24,130,3,81,374,455,36,62,98,553,18,102,OH - Defiance
21,1971-1972,1971-11-23,1972-04-08,138,3,62,389,451,29,61,90,541,14,83,OH - Defiance
22,1972-1973,1972-10-19,1973-04-12,176,3,48,313,361,30,38,68,429,16,76,OH - Defiance
23,1973-1974,1973-12-01,1974-04-08,129,4,71,325,396,57,176,233,629,20,155,OH - Defiance
24,1974-1975,1974-11-14,1975-04-03,141,0,37,318,355,41,104,145,500,17,92,OH - Defiance
25,1975-1976,1975-11-25,1976-03-18,115,0,52,312,364,41,133,174,538,17,100,OH - Defiance
26,1976-1977,1976-11-05,1977-04-06,153,1,146,537,683,50,273,323,1006,19,151,OH - Defiance
27,1977-1978,1977-11-12,1978-03-25,134,3,130,560,690,85,582,667,1357,29,242,OH - Defiance
28,1978-1979,1978-11-27,1979-04-05,130,0,115,425,540,38,226,264,804,23,144,OH - Defiance
29,1979-1980,1979-11-28,1980-03-21,115,0,78,384,462,27,122,149,611,13,88,OH - Defiance
30,1980-1981,1980-10-28,1981-03-20,144,0,89,471,560,45,179,224,784,24,152,OH - Defiance
31,1981-1982,1981-11-23,1982-04-08,137,6,108,556,664,80,303,383,1047,30,269,OH - Defiance
32,1982-1983,1982-12-01,1983-03-26,116,6,31,203,234,13,32,45,279,8,35,OH - Defiance
33,1983-1984,1983-12-01,1984-03-21,112,8,125,408,533,44,212,256,789,20,136,OH - Defiance
36,1986-1987,1986-11-14,1987-03-30,137,14,46,230,276,17,64,81,357,5,30,OH - Defiance
37,1987-1988,1987-12-01,1988-03-21,112,6,75,287,362,23,75,98,460,5,47,OH - Defiance
39,1989-1990,1989-10-19,1990-04-07,171,14,78,300,378,16,80,96,474,13,82,OH - Defiance
40,1990-1991,1990-12-01,1991-03-04,94,16,45,196,241,16,49,65,306,8,55,OH - Defiance
41,1991-1992,1991-11-03,1992-04-01,151,14,42,249,291,20,53,73,364,9,54,OH - Defiance
42,1992-1993,1992-10-21,1993-03-19,150,6,58,266,324,33,115,148,472,18,79,OH - Defiance
43,1993-1994,1993-11-08,1994-04-07,151,10,120,381,501,36,140,176,677,14,116,OH - Defiance
44,1994-1995,1994-12-01,1995-03-10,100,10,63,234,297,21,76,97,394,9,58,OH - Defiance
47,1997-1998,1997-11-14,1998-03-13,120,13,28,143,171,10,17,27,198,7,25,OH - Defiance
51,2001-2002,2001-12-01,2002-03-30,120,12,34,197,231,26,25,51,282,11,60,OH - Defiance
52,2002-2003,2002-11-16,2003-03-31,136,17,106,374,480,72,165,237,717,31,206,OH - Defiance
53,2003-2004,2003-12-01,2004-03-18,109,0,83,277,360,44,163,207,567,26,140,OH - Defiance
54,2004-2005,2004-11-25,2005-04-24,151,6,78,298,376,60,150,210,586,28,165,OH - Defiance
55,2005-2006,2005-11-18,2006-03-17,120,3,54,218,272,26,88,114,386,13,61,OH - Defiance
56,2006-2007,2006-12-01,2007-04-15,136,5,82,292,374,33,94,127,501,13,102,OH - Defiance
57,2007-2008,2007-12-01,2008-03-11,102,11,75,267,342,49,102,151,493,16,128,OH - Defiance
60,2010-2011,2010-11-27,2011-03-10,104,4,99,326,425,49,195,244,669,19,138,OH - Defiance
61,2011-2012,2011-11-30,2012-02-29,92,1,26,154,180,15,19,34,214,8,45,OH - Defiance
62,2012-2013,2012-12-01,2013-03-25,115,1,53,226,279,32,69,101,380,16,90,OH - Defiance
63,2013-2014,2013-11-12,2014-04-15,155,0,153,492,645,108,330,438,1083,38,334,OH - Defiance
64,2014-2015,2014-11-17,2015-03-28,132,4,116,395,511,63,225,288,799,24,217,OH - Defiance
65,2015-2016,2015-11-22,2016-04-09,140,0,44,204,248,22,37,59,307,12,66,OH - Defiance
66,2016-2017,2016-12-01,2017-03-16,106,11,39,181,220,14,68,82,302,7,42,OH - Defiance
67,2017-2018,2017-12-01,2018-03-21,111,4,89,294,383,32,121,153,536,17,117,OH - Defiance
68,2018-2019,2018-11-09,2019-03-31,143,0,82,310,392,31,43,74,466,20,108,OH - Defiance
69,2019-2020,2019-11-12,2020-04-17,158,8,26,212,238,28,39,67,305,16,61,OH - Defiance
0,1950-1951,1950-11-04,1951-04-17,165,2,101,341,442,95,228,323,765,52,306,OH - Mansfield
1,1951-1952,1951-11-01,1952-04-15,167,0,73,287,360,63,66,129,489,43,206,OH - Mansfield
2,1952-1953,1952-10-20,1953-04-27,190,0,39,218,257,71,47,118,375,43,195,OH - Mansfield
3,1953-1954,1953-11-07,1954-04-03,148,0,55,249,304,63,81,144,448,40,189,OH - Mansfield
4,1954-1955,1954-10-31,1955-03-30,151,0,71,267,338,54,109,163,501,36,156,OH - Mansfield
5,1955-1956,1955-10-31,1956-04-22,175,1,67,321,388,60,104,164,552,35,154,OH - Mansfield
9,1959-1960,1959-11-18,1960-04-09,144,4,91,303,394,78,200,278,672,46,255,OH - Mansfield
10,1960-1961,1960-11-06,1961-04-18,164,0,101,334,435,67,167,234,669,37,217,OH - Mansfield
11,1961-1962,1961-11-08,1962-04-20,164,2,84,347,431,55,75,130,561,32,169,OH - Mansfield
12,1962-1963,1962-10-25,1963-05-01,189,0,141,448,589,90,171,261,850,46,320,OH - Mansfield
13,1963-1964,1963-11-12,1964-04-01,142,0,85,339,424,81,160,241,665,44,235,OH - Mansfield
14,1964-1965,1964-11-19,1965-03-27,129,3,95,325,420,70,84,154,574,43,240,OH - Mansfield
15,1965-1966,1965-11-29,1966-05-09,162,0,81,288,369,43,67,110,479,32,155,OH - Mansfield
16,1966-1967,1966-11-02,1967-03-20,139,0,72,285,357,63,93,156,513,33,158,OH - Mansfield
17,1967-1968,1967-11-06,1968-04-05,152,0,86,329,415,78,169,247,662,37,226,OH - Mansfield
18,1968-1969,1968-11-10,1969-04-19,161,0,62,274,336,52,76,128,464,38,168,OH - Mansfield
19,1969-1970,1969-11-13,1970-03-22,130,0,97,334,431,70,183,253,684,54,303,OH - Mansfield
20,1970-1971,1970-11-23,1971-03-24,122,0,76,292,368,67,99,166,534,32,187,OH - Mansfield
21,1971-1972,1971-11-06,1972-04-08,155,0,52,304,356,50,66,116,472,37,176,OH - Mansfield
22,1972-1973,1972-11-14,1973-04-11,149,0,43,229,272,46,67,113,385,30,128,OH - Mansfield
23,1973-1974,1973-11-16,1974-04-09,145,0,53,230,283,60,123,183,466,30,171,OH - Mansfield
24,1974-1975,1974-11-13,1975-04-03,142,0,47,240,287,84,125,209,496,45,212,OH - Mansfield
25,1975-1976,1975-11-13,1976-04-04,144,0,77,289,366,59,117,176,542,32,180,OH - Mansfield
26,1976-1977,1976-11-05,1977-04-06,153,0,181,499,680,94,282,376,1056,55,418,OH - Mansfield
27,1977-1978,1977-11-11,1978-03-18,128,0,145,431,576,117,453,570,1146,49,376,OH - Mansfield
28,1978-1979,1978-11-27,1979-04-08,133,0,128,368,496,56,182,238,734,31,195,OH - Mansfield
29,1979-1980,1979-11-29,1980-04-15,139,0,81,313,394,43,98,141,535,27,162,OH - Mansfield
30,1980-1981,1980-11-17,1981-03-21,125,0,69,289,358,69,170,239,597,39,206,OH - Mansfield
31,1981-1982,1981-11-20,1982-04-11,143,0,109,367,476,101,184,285,761,47,326,OH - Mansfield
32,1982-1983,1982-11-24,1983-04-18,146,0,35,183,218,29,43,72,290,22,80,OH - Mansfield
33,1983-1984,1983-11-11,1984-04-17,159,0,129,354,483,85,213,298,781,43,265,OH - Mansfield
34,1984-1985,1984-11-11,1985-04-09,150,0,84,288,372,83,237,320,692,43,260,OH - Mansfield
35,1985-1986,1985-12-01,1986-04-22,143,0,92,306,398,63,110,173,571,43,236,OH - Mansfield
36,1986-1987,1986-11-11,1987-04-06,147,0,45,239,284,66,52,118,402,30,128,OH - Mansfield
37,1987-1988,1987-11-20,1988-04-15,148,0,78,300,378,77,104,181,559,45,246,OH - Mansfield
38,1988-1989,1988-10-24,1989-05-07,196,0,59,291,350,51,46,97,447,38,179,OH - Mansfield
39,1989-1990,1989-10-19,1990-04-11,175,0,79,308,387,58,93,151,538,33,176,OH - Mansfield
40,1990-1991,1990-12-01,1991-03-30,120,0,39,208,247,42,65,107,354,28,128,OH - Mansfield
41,1991-1992,1991-11-03,1992-04-04,154,0,54,271,325,64,80,144,469,41,205,OH - Mansfield
42,1992-1993,1992-10-18,1993-04-02,167,0,65,269,334,80,141,221,555,40,179,OH - Mansfield
43,1993-1994,1993-10-30,1994-04-07,160,0,116,351,467,98,253,351,818,51,341,OH - Mansfield
44,1994-1995,1994-12-01,1995-04-01,122,0,63,251,314,49,165,214,528,27,166,OH - Mansfield
45,1995-1996,1995-11-05,1996-04-23,171,0,122,397,519,140,300,440,959,60,399,OH - Mansfield
46,1996-1997,1996-11-09,1997-04-17,160,3,75,302,377,50,26,76,453,37,189,OH - Mansfield
49,1999-2000,1999-11-02,2000-04-09,160,0,67,270,337,62,118,180,517,38,210,OH - Mansfield
50,2000-2001,2000-11-14,2001-04-17,155,0,93,332,425,91,150,241,666,51,311,OH - Mansfield
51,2001-2002,2001-12-01,2002-04-06,127,0,40,191,231,57,50,107,338,35,173,OH - Mansfield
52,2002-2003,2002-10-29,2003-03-31,154,3,106,361,467,93,231,324,791,52,320,OH - Mansfield
53,2003-2004,2003-11-13,2004-04-27,167,0,77,304,381,98,144,242,623,55,300,OH - Mansfield
54,2004-2005,2004-11-25,2005-04-25,152,0,80,305,385,127,190,317,702,39,258,OH - Mansfield
55,2005-2006,2005-11-17,2006-03-25,129,5,54,236,290,53,94,147,437,31,140,OH - Mansfield
56,2006-2007,2006-11-19,2007-04-15,148,0,90,276,366,71,85,156,522,35,224,OH - Mansfield
57,2007-2008,2007-12-01,2008-03-22,113,0,63,255,318,113,148,261,579,35,250,OH - Mansfield
58,2008-2009,2008-11-10,2009-04-07,149,0,100,364,464,99,181,280,744,43,295,OH - Mansfield
59,2009-2010,2009-12-01,2010-03-26,116,0,81,253,334,118,276,394,728,39,273,OH - Mansfield
60,2010-2011,2010-11-27,2011-03-31,125,0,101,317,418,91,232,323,741,44,271,OH - Mansfield
61,2011-2012,2011-11-30,2012-03-05,97,0,28,142,170,51,50,101,271,29,139,OH - Mansfield
62,2012-2013,2012-10-30,2013-04-20,173,0,59,263,322,61,102,163,485,34,180,OH - Mansfield
63,2013-2014,2013-11-11,2014-04-15,156,0,125,428,553,99,155,254,807,50,345,OH - Mansfield
64,2014-2015,2014-11-13,2015-03-28,136,0,115,386,501,95,222,317,818,41,318,OH - Mansfield
65,2015-2016,2015-12-01,2016-04-10,132,0,48,204,252,44,53,97,349,27,156,OH - Mansfield
66,2016-2017,2016-11-19,2017-04-07,140,0,51,198,249,57,67,124,373,31,139,OH - Mansfield
67,2017-2018,2017-11-01,2018-04-19,170,0,90,319,409,78,100,178,587,46,223,OH - Mansfield
68,2018-2019,2018-11-09,2019-04-15,158,0,65,282,347,77,86,163,510,38,209,OH - Mansfield
69,2019-2020,2019-11-11,2020-04-17,159,0,21,182,203,32,34,66,269,24,81,OH - Mansfield
0,1950-1951,1950-11-04,1951-03-22,139,3,91,331,422,70,141,211,633,35,203,OH - Toledo
1,1951-1952,1951-11-03,1952-04-06,156,0,60,286,346,82,124,206,552,36,193,OH - Toledo
2,1952-1953,1952-11-28,1953-04-19,143,3,25,204,229,34,24,58,287,23,99,OH - Toledo
3,1953-1954,1953-11-07,1954-04-03,148,0,40,242,282,62,49,111,393,30,123,OH - Toledo
4,1954-1955,1954-10-31,1955-03-29,150,0,51,261,312,40,42,82,394,30,136,OH - Toledo
5,1955-1956,1955-11-17,1956-04-17,153,0,55,333,388,63,89,152,540,37,157,OH - Toledo
6,1956-1957,1956-11-22,1957-04-12,142,0,63,280,343,69,101,170,513,43,193,OH - Toledo
7,1957-1958,1957-12-01,1958-03-25,115,0,61,258,319,41,49,90,409,27,103,OH - Toledo
8,1958-1959,1958-11-27,1959-03-27,121,0,97,383,480,44,90,134,614,32,187,OH - Toledo
9,1959-1960,1959-11-12,1960-03-26,136,0,64,305,369,70,117,187,556,39,185,OH - Toledo
10,1960-1961,1960-11-09,1961-04-17,160,0,89,362,451,42,44,86,537,29,175,OH - Toledo
11,1961-1962,1961-11-19,1962-03-14,116,0,93,319,412,67,95,162,574,33,208,OH - Toledo
12,1962-1963,1962-10-25,1963-04-30,188,0,153,491,644,69,162,231,875,46,304,OH - Toledo
13,1963-1964,1963-12-01,1964-04-03,125,0,87,340,427,66,97,163,590,36,209,OH - Toledo
14,1964-1965,1964-11-19,1965-04-02,135,0,85,354,439,70,118,188,627,39,230,OH - Toledo
15,1965-1966,1965-11-18,1966-04-06,140,0,77,304,381,45,44,89,470,36,193,OH - Toledo
16,1966-1967,1966-11-02,1967-04-24,174,0,78,341,419,101,163,264,683,52,281,OH - Toledo
17,1967-1968,1967-11-14,1968-04-25,164,0,73,353,426,57,90,147,573,35,185,OH - Toledo
18,1968-1969,1968-11-12,1969-04-19,159,0,80,371,451,55,71,126,577,39,220,OH - Toledo
19,1969-1970,1969-11-14,1970-04-11,149,0,103,434,537,98,197,295,832,50,326,OH - Toledo
20,1970-1971,1970-11-14,1971-03-24,131,0,85,333,418,63,54,117,535,44,248,OH - Toledo
21,1971-1972,1971-11-03,1972-04-08,158,0,73,379,452,54,46,100,552,39,182,OH - Toledo
22,1972-1973,1972-10-18,1973-03-19,153,0,59,257,316,51,56,107,423,29,120,OH - Toledo
23,1973-1974,1973-11-09,1974-04-08,151,0,82,323,405,61,125,186,591,34,220,OH - Toledo
24,1974-1975,1974-11-13,1975-04-15,154,0,44,287,331,76,115,191,522,41,163,OH - Toledo
25,1975-1976,1975-11-24,1976-04-25,154,0,74,318,392,76,166,242,634,43,215,OH - Toledo
26,1976-1977,1976-11-04,1977-04-07,155,0,162,514,676,89,227,316,992,48,374,OH - Toledo
27,1977-1978,1977-11-10,1978-03-25,136,0,167,514,681,114,448,562,1243,51,423,OH - Toledo
28,1978-1979,1978-11-20,1979-04-09,141,0,139,399,538,56,108,164,702,48,269,OH - Toledo
29,1979-1980,1979-11-08,1980-04-15,160,0,87,331,418,43,52,95,513,37,174,OH - Toledo
30,1980-1981,1980-10-27,1981-03-20,145,0,103,391,494,64,196,260,754,37,206,OH - Toledo
31,1981-1982,1981-11-20,1982-04-11,143,0,132,427,559,107,322,429,988,55,400,OH - Toledo
32,1982-1983,1982-11-24,1983-04-18,146,0,45,229,274,30,28,58,332,25,100,OH - Toledo
33,1983-1984,1983-11-11,1984-03-29,140,0,145,407,552,71,225,296,848,40,257,OH - Toledo
34,1984-1985,1984-11-11,1985-04-09,150,0,87,330,417,62,216,278,695,38,231,OH - Toledo
35,1985-1986,1985-11-22,1986-04-22,152,0,90,341,431,57,155,212,643,39,193,OH - Toledo
36,1986-1987,1986-11-11,1987-04-05,146,0,38,255,293,60,104,164,457,29,127,OH - Toledo
37,1987-1988,1987-11-20,1988-03-21,123,0,74,303,377,64,105,169,546,32,174,OH - Toledo
38,1988-1989,1988-11-06,1989-05-07,183,0,52,314,366,40,41,81,447,30,142,OH - Toledo
39,1989-1990,1989-10-19,1990-04-06,170,0,70,312,382,51,88,139,521,34,172,OH - Toledo
40,1990-1991,1990-12-01,1991-03-03,93,0,43,192,235,38,53,91,326,23,114,OH - Toledo
41,1991-1992,1991-11-03,1992-04-02,152,0,40,252,292,59,81,140,432,39,157,OH - Toledo
42,1992-1993,1992-10-20,1993-04-21,184,0,46,258,304,69,127,196,500,33,135,OH - Toledo
43,1993-1994,1993-10-30,1994-04-07,160,0,113,382,495,91,178,269,764,45,302,OH - Toledo
44,1994-1995,1994-12-01,1995-04-09,130,3,52,247,299,38,80,118,417,21,111,OH - Toledo
45,1995-1996,1995-11-12,1996-03-26,136,7,109,359,468,55,106,161,629,36,186,OH - Toledo
46,1996-1997,1996-11-09,1997-03-18,130,0,70,285,355,58,81,139,494,29,154,OH - Toledo
54,2004-2005,2004-11-25,2005-04-24,151,0,70,286,356,84,140,224,580,32,176,OH - Toledo
55,2005-2006,2005-11-17,2006-03-16,120,0,42,210,252,47,79,126,378,21,98,OH - Toledo
56,2006-2007,2006-12-01,2007-04-15,136,0,81,268,349,48,74,122,471,30,187,OH - Toledo
57,2007-2008,2007-11-26,2008-03-28,124,2,61,286,347,88,97,185,532,45,218,OH - Toledo
58,2008-2009,2008-11-15,2009-04-06,143,0,94,378,472,72,178,250,722,32,195,OH - Toledo
59,2009-2010,2009-12-01,2010-03-04,94,0,64,218,282,63,147,210,492,32,151,OH - Toledo
60,2010-2011,2010-12-01,2011-03-11,101,6,96,295,391,74,206,280,671,33,203,OH - Toledo
61,2011-2012,2011-11-29,2012-03-06,99,0,26,150,176,38,26,64,240,26,103,OH - Toledo
62,2012-2013,2012-12-01,2013-04-20,141,0,51,252,303,40,49,89,392,27,148,OH - Toledo
63,2013-2014,2013-11-11,2014-04-15,156,0,150,489,639,125,332,457,1096,44,376,OH - Toledo
64,2014-2015,2014-11-15,2015-03-26,132,0,126,413,539,68,265,333,872,28,231,OH - Toledo
65,2015-2016,2015-11-21,2016-04-10,142,0,45,210,255,42,23,65,320,25,138,OH - Toledo
66,2016-2017,2016-12-01,2017-04-07,128,0,53,200,253,44,55,99,352,27,135,OH - Toledo
67,2017-2018,2017-11-10,2018-04-19,161,0,91,321,412,55,144,199,611,31,180,OH - Toledo
68,2018-2019,2018-11-10,2019-03-30,141,0,62,260,322,47,69,116,438,31,149,OH - Toledo
69,2019-2020,2019-11-11,2020-04-17,159,0,17,173,190,38,58,96,286,19,69,OH - Toledo
0,1950-1951,1950-11-05,1951-04-17,164,0,83,346,429,134,252,386,815,56,347,OH - Youngstown
1,1951-1952,1951-11-01,1952-04-15,167,0,62,306,368,85,94,179,547,54,236,OH - Youngstown
2,1952-1953,1952-10-20,1953-04-20,183,0,32,215,247,66,40,106,353,50,185,OH - Youngstown
3,1953-1954,1953-11-05,1954-04-03,150,0,51,271,322,82,54,136,458,49,238,OH - Youngstown
4,1954-1955,1954-10-31,1955-03-28,149,0,62,296,358,102,123,225,583,62,308,OH - Youngstown
5,1955-1956,1955-10-24,1956-05-16,206,0,59,351,410,123,114,237,647,78,354,OH - Youngstown
6,1956-1957,1956-11-08,1957-04-14,158,0,59,288,347,118,109,227,574,70,327,OH - Youngstown
7,1957-1958,1957-10-26,1958-04-10,167,0,76,304,380,87,155,242,622,59,287,OH - Youngstown
8,1958-1959,1958-11-27,1959-03-27,121,0,102,390,492,96,116,212,704,54,358,OH - Youngstown
9,1959-1960,1959-11-12,1960-04-09,150,0,79,319,398,117,216,333,731,67,342,OH - Youngstown
10,1960-1961,1960-10-24,1961-04-28,187,0,100,351,451,103,210,313,764,59,368,OH - Youngstown
11,1961-1962,1961-11-08,1962-04-15,159,0,93,345,438,105,129,234,672,59,320,OH - Youngstown
12,1962-1963,1962-10-24,1963-05-01,190,0,140,440,580,124,251,375,955,66,440,OH - Youngstown
13,1963-1964,1963-11-02,1964-04-09,160,0,98,342,440,122,254,376,816,63,373,OH - Youngstown
14,1964-1965,1964-11-20,1965-04-02,134,0,96,331,427,102,122,224,651,53,350,OH - Youngstown
15,1965-1966,1965-10-28,1966-05-09,194,0,87,305,392,93,114,207,599,53,293,OH - Youngstown
16,1966-1967,1966-11-03,1967-04-24,173,0,92,341,433,104,144,248,681,57,333,OH - Youngstown
17,1967-1968,1967-10-28,1968-03-24,149,0,115,383,498,79,164,243,741,48,299,OH - Youngstown
18,1968-1969,1968-11-12,1969-03-31,140,0,93,312,405,97,106,203,608,60,339,OH - Youngstown
19,1969-1970,1969-10-22,1970-04-02,163,0,118,402,520,109,237,346,866,75,437,OH - Youngstown
20,1970-1971,1970-11-23,1971-04-24,153,0,108,340,448,121,171,292,740,62,392,OH - Youngstown
21,1971-1972,1971-11-04,1972-04-08,157,0,86,342,428,107,162,269,697,59,307,OH - Youngstown
22,1972-1973,1972-10-18,1973-04-11,176,0,60,271,331,71,83,154,485,42,207,OH - Youngstown
23,1973-1974,1973-11-05,1974-04-10,157,0,62,256,318,70,95,165,483,42,209,OH - Youngstown
24,1974-1975,1974-10-03,1975-04-05,185,0,52,235,287,101,110,211,498,56,229,OH - Youngstown
25,1975-1976,1975-11-13,1976-04-26,166,0,78,293,371,74,141,215,586,43,224,OH - Youngstown
26,1976-1977,1976-11-05,1977-04-06,153,0,161,469,630,97,348,445,1075,62,409,OH - Youngstown
27,1977-1978,1977-11-11,1978-03-17,127,0,142,416,558,117,389,506,1064,62,444,OH - Youngstown
28,1978-1979,1978-11-21,1979-03-27,127,0,117,343,460,61,184,245,705,42,231,OH - Youngstown
29,1979-1980,1979-11-14,1980-03-22,130,3,95,300,395,57,109,166,561,39,198,OH - Youngstown
30,1980-1981,1980-10-25,1981-03-22,149,0,110,361,471,81,195,276,747,52,291,OH - Youngstown
31,1981-1982,1981-10-19,1982-04-10,174,0,96,355,451,88,175,263,714,42,245,OH - Youngstown
32,1982-1983,1982-11-15,1983-04-19,156,0,30,188,218,59,87,146,364,26,123,OH - Youngstown
33,1983-1984,1983-11-04,1984-03-31,149,0,111,338,449,98,186,284,733,51,277,OH - Youngstown
34,1984-1985,1984-11-12,1985-04-09,149,0,97,326,423,82,214,296,719,40,263,OH - Youngstown
35,1985-1986,1985-12-01,1986-04-16,137,0,80,306,386,67,155,222,608,34,194,OH - Youngstown
36,1986-1987,1986-11-11,1987-04-06,147,0,42,270,312,96,108,204,516,36,179,OH - Youngstown
37,1987-1988,1987-10-21,1988-04-16,179,0,73,316,389,117,137,254,643,61,321,OH - Youngstown
38,1988-1989,1988-10-12,1989-05-07,208,0,57,315,372,71,61,132,504,46,226,OH - Youngstown
39,1989-1990,1989-10-19,1990-04-17,181,0,71,313,384,79,116,195,579,50,252,OH - Youngstown
40,1990-1991,1990-11-11,1991-04-02,143,0,35,233,268,54,57,111,379,40,183,OH - Youngstown
41,1991-1992,1991-11-04,1992-04-03,152,0,43,275,318,92,91,183,501,51,265,OH - Youngstown
42,1992-1993,1992-10-18,1993-04-03,168,0,53,271,324,127,168,295,619,55,266,OH - Youngstown
43,1993-1994,1993-10-30,1994-04-07,160,0,104,359,463,122,241,363,826,56,326,OH - Youngstown
44,1994-1995,1994-11-23,1995-04-14,143,0,45,270,315,53,81,134,449,33,162,OH - Youngstown
45,1995-1996,1995-11-09,1996-04-23,167,0,135,408,543,86,237,323,866,49,326,OH - Youngstown
47,1997-1998,1997-10-22,1998-03-24,154,0,28,169,197,71,76,147,344,48,168,OH - Youngstown
48,1998-1999,1998-11-21,1999-03-22,122,2,55,246,301,99,184,283,584,42,273,OH - Youngstown
49,1999-2000,1999-11-03,2000-04-09,159,0,62,256,318,74,132,206,524,46,238,OH - Youngstown
50,2000-2001,2000-10-08,2001-04-17,192,0,83,318,401,95,159,254,655,69,332,OH - Youngstown
51,2001-2002,2001-10-26,2002-04-05,162,0,39,196,235,77,66,143,378,48,211,OH - Youngstown
52,2002-2003,2002-10-29,2003-04-01,155,0,101,350,451,128,269,397,848,72,423,OH - Youngstown
53,2003-2004,2003-10-02,2004-04-14,196,0,78,307,385,116,235,351,736,61,339,OH - Youngstown
54,2004-2005,2004-11-25,2005-04-25,152,0,70,308,378,122,206,328,706,59,331,OH - Youngstown
55,2005-2006,2005-11-17,2006-04-05,140,0,50,234,284,87,126,213,497,52,237,OH - Youngstown
56,2006-2007,2006-10-23,2007-04-15,175,0,87,292,379,134,186,320,699,58,353,OH - Youngstown
57,2007-2008,2007-11-06,2008-03-25,141,0,52,277,329,145,224,369,698,59,310,OH - Youngstown
58,2008-2009,2008-10-28,2009-04-08,163,0,88,343,431,133,254,387,818,66,421,OH - Youngstown
59,2009-2010,2009-10-15,2010-03-26,163,3,60,241,301,114,313,427,728,53,284,OH - Youngstown
60,2010-2011,2010-11-27,2011-04-01,126,0,88,315,403,166,395,561,964,65,428,OH - Youngstown
61,2011-2012,2011-11-11,2012-04-11,153,0,23,158,181,83,93,176,357,44,173,OH - Youngstown
62,2012-2013,2012-11-24,2013-04-02,130,0,57,240,297,127,170,297,594,64,327,OH - Youngstown
63,2013-2014,2013-10-24,2014-04-15,174,0,120,439,559,139,260,399,958,69,462,OH - Youngstown
64,2014-2015,2014-11-13,2015-04-23,162,0,114,408,522,121,382,503,1025,57,379,OH - Youngstown
65,2015-2016,2015-10-17,2016-05-15,212,0,48,228,276,71,95,166,442,41,209,OH - Youngstown
66,2016-2017,2016-11-19,2017-04-07,140,0,46,208,254,104,148,252,506,47,236,OH - Youngstown
67,2017-2018,2017-11-10,2018-04-19,161,0,80,323,403,126,178,304,707,64,359,OH - Youngstown
68,2018-2019,2018-11-09,2019-04-01,144,0,57,261,318,77,108,185,503,50,246,OH - Youngstown
69,2019-2020,2019-11-07,2020-05-09,185,0,21,204,225,79,69,148,373,50,167,OH - Youngstown
0,1950-1951,1950-12-01,1951-02-28,90,6,20,152,172,1,0,1,173,1,12,OK - Mutual
1,1951-1952,1951-11-02,1952-03-03,123,9,6,158,164,13,8,21,185,7,31,OK - Mutual
3,1953-1954,1953-12-01,1954-02-28,90,8,6,122,128,2,0,2,130,1,5,OK - Mutual
4,1954-1955,1954-12-01,1955-03-26,116,6,1,232,233,2,0,2,235,2,11,OK - Mutual
5,1955-1956,1955-12-01,1956-02-29,91,6,10,209,219,14,7,21,240,5,31,OK - Mutual
6,1956-1957,1956-12-01,1957-04-12,133,17,14,160,174,10,0,10,184,6,27,OK - Mutual
7,1957-1958,1957-12-01,1958-03-12,102,10,9,168,177,0,3,3,180,0,0,OK - Mutual
10,1960-1961,1960-12-01,1961-02-28,90,11,11,171,182,16,5,21,203,5,37,OK - Mutual
11,1961-1962,1961-12-01,1962-02-28,90,6,27,196,223,9,11,20,243,5,25,OK - Mutual
12,1962-1963,1962-12-01,1963-02-28,90,4,16,228,244,4,0,4,248,2,11,OK - Mutual
13,1963-1964,1963-12-01,1964-02-29,91,1,14,171,185,12,13,25,210,5,34,OK - Mutual
14,1964-1965,1964-12-01,1965-03-24,114,0,12,208,220,18,27,45,265,4,28,OK - Mutual
15,1965-1966,1965-12-01,1966-02-28,90,0,27,166,193,16,62,78,271,5,27,OK - Mutual
16,1966-1967,1966-12-01,1967-02-28,90,0,8,167,175,2,1,3,178,1,5,OK - Mutual
18,1968-1969,1968-12-01,1969-03-15,105,0,7,172,179,26,28,54,233,7,38,OK - Mutual
20,1970-1971,1970-12-01,1971-02-28,90,1,10,170,180,23,38,61,241,3,33,OK - Mutual
21,1971-1972,1971-12-01,1972-02-29,91,0,12,148,160,15,21,36,196,2,24,OK - Mutual
24,1974-1975,1974-11-30,1975-03-11,102,6,17,167,184,23,36,59,243,7,43,OK - Mutual
25,1975-1976,1975-11-26,1976-02-29,96,5,15,148,163,5,2,7,170,3,17,OK - Mutual
27,1977-1978,1977-12-01,1978-03-04,94,0,51,264,315,25,97,122,437,10,76,OK - Mutual
28,1978-1979,1978-11-21,1979-04-03,134,9,68,287,355,19,46,65,420,10,81,OK - Mutual
29,1979-1980,1979-11-10,1980-03-30,142,1,27,205,232,8,9,17,249,4,14,OK - Mutual
30,1980-1981,1980-11-25,1981-03-08,104,1,14,152,166,9,6,15,181,5,21,OK - Mutual
31,1981-1982,1981-12-01,1982-03-27,117,3,39,224,263,23,46,69,332,8,61,OK - Mutual
32,1982-1983,1982-11-28,1983-04-05,129,4,15,142,157,20,27,47,204,10,39,OK - Mutual
34,1984-1985,1984-12-01,1985-02-28,90,10,26,191,217,14,20,34,251,3,25,OK - Mutual
35,1985-1986,1985-11-28,1986-02-28,93,1,27,179,206,17,36,53,259,7,52,OK - Mutual
36,1986-1987,1986-11-13,1987-02-28,108,3,14,140,154,23,45,68,222,8,50,OK - Mutual
37,1987-1988,1987-12-01,1988-03-18,109,2,39,240,279,63,145,208,487,13,110,OK - Mutual
38,1988-1989,1988-11-20,1989-03-05,106,3,23,215,238,11,10,21,259,3,17,OK - Mutual
40,1990-1991,1990-12-01,1991-03-03,93,3,33,199,232,8,14,22,254,4,41,OK - Mutual
41,1991-1992,1991-10-31,1992-02-29,122,1,8,129,137,10,7,17,154,4,27,OK - Mutual
42,1992-1993,1992-11-22,1993-03-13,112,11,32,208,240,48,104,152,392,16,89,OK - Mutual
43,1993-1994,1993-11-25,1994-03-10,106,5,14,233,247,18,14,32,279,4,34,OK - Mutual
44,1994-1995,1994-12-01,1995-03-08,98,3,14,161,175,23,31,54,229,11,66,OK - Mutual
45,1995-1996,1995-12-01,1996-03-09,100,17,35,243,278,13,19,32,310,6,47,OK - Mutual
46,1996-1997,1996-10-22,1997-04-12,173,10,26,234,260,27,42,69,329,10,60,OK - Mutual
47,1997-1998,1997-11-10,1998-03-20,131,15,10,160,170,23,29,52,222,8,33,OK - Mutual
48,1998-1999,1998-12-01,1999-03-14,104,1,17,154,171,7,4,11,182,6,30,OK - Mutual
49,1999-2000,1999-12-01,2000-03-17,108,5,5,159,164,20,18,38,202,9,41,OK - Mutual
50,2000-2001,2000-11-08,2001-03-27,140,9,27,238,265,26,29,55,320,14,87,OK - Mutual
51,2001-2002,2001-11-28,2002-03-03,96,7,9,196,205,16,27,43,248,8,44,OK - Mutual
52,2002-2003,2002-12-01,2003-03-06,96,12,16,181,197,33,68,101,298,9,65,OK - Mutual
53,2003-2004,2003-12-01,2004-02-29,91,7,16,180,196,12,14,26,222,5,30,OK - Mutual
54,2004-2005,2004-11-24,2005-03-15,112,7,15,135,150,14,13,27,177,8,33,OK - Mutual
55,2005-2006,2005-12-01,2006-03-23,113,17,13,202,215,7,6,13,228,3,17,OK - Mutual
56,2006-2007,2006-11-30,2007-04-14,136,2,29,198,227,29,43,72,299,15,92,OK - Mutual
57,2007-2008,2007-11-24,2008-02-29,98,9,14,223,237,15,17,32,269,8,49,OK - Mutual
58,2008-2009,2008-12-01,2009-03-30,120,1,12,156,168,26,15,41,209,5,43,OK - Mutual
59,2009-2010,2009-12-01,2010-03-21,111,0,23,209,232,31,40,71,303,9,51,OK - Mutual
60,2010-2011,2010-12-01,2011-02-28,90,9,19,219,238,19,37,56,294,5,43,OK - Mutual
61,2011-2012,2011-12-01,2012-02-29,91,0,7,138,145,8,6,14,159,3,16,OK - Mutual
62,2012-2013,2012-12-01,2013-03-24,114,6,12,201,213,74,51,125,338,7,91,OK - Mutual
63,2013-2014,2013-11-23,2014-03-04,102,2,56,273,329,26,52,78,407,9,83,OK - Mutual
64,2014-2015,2014-11-13,2015-03-05,113,0,26,198,224,9,9,18,242,5,25,OK - Mutual
65,2015-2016,2015-11-28,2016-03-27,121,0,8,141,149,14,30,44,193,6,24,OK - Mutual
66,2016-2017,2016-12-01,2017-02-28,90,3,15,159,174,2,2,4,178,1,9,OK - Mutual
67,2017-2018,2017-12-01,2018-04-07,128,1,23,262,285,1,0,1,286,1,4,OK - Mutual
68,2018-2019,2018-11-12,2019-03-05,114,8,18,184,202,9,8,17,219,7,27,OK - Mutual
69,2019-2020,2019-10-25,2020-04-14,173,12,6,177,183,14,11,25,208,6,21,OK - Mutual
1,1951-1952,1951-11-01,1952-02-29,121,3,6,100,106,14,8,22,128,8,26,OK - Oklahoma City
2,1952-1953,1952-11-28,1953-02-28,93,0,5,77,82,8,5,13,95,6,27,OK - Oklahoma City
3,1953-1954,1953-12-01,1954-03-05,95,0,11,100,111,11,7,18,129,5,30,OK - Oklahoma City
4,1954-1955,1954-12-01,1955-03-22,112,0,3,117,120,19,19,38,158,7,35,OK - Oklahoma City
5,1955-1956,1955-11-30,1956-03-07,99,0,9,131,140,11,6,17,157,7,31,OK - Oklahoma City
6,1956-1957,1956-12-01,1957-04-12,133,0,18,99,117,4,4,8,125,3,11,OK - Oklahoma City
7,1957-1958,1957-12-01,1958-03-14,104,0,8,106,114,14,8,22,136,5,25,OK - Oklahoma City
8,1958-1959,1958-11-27,1959-03-05,99,0,29,155,184,23,30,53,237,13,70,OK - Oklahoma City
9,1959-1960,1959-11-14,1960-03-08,116,0,28,153,181,25,44,69,250,12,65,OK - Oklahoma City
10,1960-1961,1960-12-01,1961-03-18,108,0,9,112,121,25,22,47,168,12,50,OK - Oklahoma City
11,1961-1962,1961-12-01,1962-02-28,90,0,26,144,170,19,13,32,202,10,72,OK - Oklahoma City
12,1962-1963,1962-12-01,1963-02-28,90,0,24,181,205,6,2,8,213,4,19,OK - Oklahoma City
13,1963-1964,1963-12-01,1964-03-09,100,0,18,141,159,8,2,10,169,7,31,OK - Oklahoma City
14,1964-1965,1964-11-21,1965-03-19,119,0,11,169,180,6,3,9,189,4,20,OK - Oklahoma City
15,1965-1966,1965-12-01,1966-02-28,90,0,19,103,122,12,19,31,153,6,29,OK - Oklahoma City
16,1966-1967,1966-12-01,1967-03-07,97,0,6,130,136,4,1,5,141,4,13,OK - Oklahoma City
17,1967-1968,1967-11-02,1968-03-22,142,0,15,136,151,42,26,68,219,18,76,OK - Oklahoma City
18,1968-1969,1968-11-28,1969-03-15,108,0,5,124,129,20,7,27,156,11,27,OK - Oklahoma City
19,1969-1970,1969-12-01,1970-03-28,118,0,16,140,156,11,17,28,184,7,34,OK - Oklahoma City
20,1970-1971,1970-12-01,1971-03-03,93,0,7,120,127,9,9,18,145,4,21,OK - Oklahoma City
21,1971-1972,1971-11-23,1972-02-29,99,1,11,110,121,17,18,35,156,8,36,OK - Oklahoma City
22,1972-1973,1972-11-18,1973-02-28,103,0,33,145,178,25,39,64,242,12,51,OK - Oklahoma City
23,1973-1974,1973-12-01,1974-03-21,111,0,15,131,146,6,2,8,154,5,24,OK - Oklahoma City
24,1974-1975,1974-11-29,1975-03-29,121,0,5,115,120,10,3,13,133,7,19,OK - Oklahoma City
25,1975-1976,1975-11-26,1976-02-29,96,0,7,106,113,8,2,10,123,6,16,OK - Oklahoma City
26,1976-1977,1976-11-13,1977-02-28,108,0,14,179,193,8,8,16,209,6,29,OK - Oklahoma City
27,1977-1978,1977-12-01,1978-03-03,93,1,38,191,229,30,65,95,324,12,73,OK - Oklahoma City
28,1978-1979,1978-12-01,1979-02-28,90,0,47,222,269,24,58,82,351,12,84,OK - Oklahoma City
29,1979-1980,1979-12-01,1980-03-01,92,0,13,112,125,3,9,12,137,2,9,OK - Oklahoma City
30,1980-1981,1980-11-17,1981-02-28,104,0,5,131,136,6,3,9,145,1,7,OK - Oklahoma City
31,1981-1982,1981-12-01,1982-03-27,117,0,18,158,176,13,6,19,195,7,31,OK - Oklahoma City
32,1982-1983,1982-12-01,1983-02-28,90,0,3,68,71,14,11,25,96,6,23,OK - Oklahoma City
33,1983-1984,1983-12-01,1984-02-29,91,0,53,177,230,16,13,29,259,10,75,OK - Oklahoma City
34,1984-1985,1984-12-01,1985-02-28,90,0,21,132,153,13,16,29,182,5,29,OK - Oklahoma City
35,1985-1986,1985-11-28,1986-02-28,93,0,17,119,136,20,22,42,178,7,46,OK - Oklahoma City
36,1986-1987,1986-11-13,1987-02-28,108,0,7,84,91,18,44,62,153,5,29,OK - Oklahoma City
37,1987-1988,1987-11-18,1988-03-17,121,3,19,130,149,35,75,110,259,8,60,OK - Oklahoma City
38,1988-1989,1988-11-19,1989-04-10,143,0,15,118,133,18,16,34,167,9,29,OK - Oklahoma City
39,1989-1990,1989-12-01,1990-03-24,114,0,18,100,118,9,2,11,129,7,35,OK - Oklahoma City
40,1990-1991,1990-12-01,1991-02-28,90,0,20,104,124,7,7,14,138,4,31,OK - Oklahoma City
41,1991-1992,1991-11-02,1992-02-29,120,0,2,59,61,12,4,16,77,5,22,OK - Oklahoma City
42,1992-1993,1992-11-26,1993-02-28,95,0,13,104,117,8,8,16,133,4,14,OK - Oklahoma City
43,1993-1994,1993-10-30,1994-03-10,132,0,10,167,177,11,5,16,193,4,20,OK - Oklahoma City
44,1994-1995,1994-12-01,1995-03-07,97,0,8,90,98,13,16,29,127,5,27,OK - Oklahoma City
45,1995-1996,1995-11-10,1996-03-08,120,1,21,160,181,12,8,20,201,8,45,OK - Oklahoma City
46,1996-1997,1996-12-01,1997-02-28,90,0,12,104,116,9,11,20,136,3,18,OK - Oklahoma City
47,1997-1998,1997-11-14,1998-02-28,107,0,2,68,70,5,2,7,77,4,8,OK - Oklahoma City
48,1998-1999,1998-12-01,1999-03-14,104,0,9,86,95,4,1,5,100,2,9,OK - Oklahoma City
49,1999-2000,1999-12-01,2000-02-29,91,0,4,64,68,13,24,37,105,3,20,OK - Oklahoma City
50,2000-2001,2000-12-01,2001-02-28,90,0,18,121,139,16,37,53,192,6,37,OK - Oklahoma City
51,2001-2002,2001-11-27,2002-03-03,97,0,7,117,124,12,12,24,148,6,27,OK - Oklahoma City
52,2002-2003,2002-12-01,2003-03-05,95,0,13,125,138,11,6,17,155,6,29,OK - Oklahoma City
53,2003-2004,2003-12-01,2004-02-29,91,0,4,102,106,6,4,10,116,5,15,OK - Oklahoma City
54,2004-2005,2004-12-01,2005-02-28,90,0,5,71,76,5,2,7,83,3,8,OK - Oklahoma City
55,2005-2006,2005-12-01,2006-03-23,113,0,8,94,102,8,4,12,114,6,26,OK - Oklahoma City
56,2006-2007,2006-11-30,2007-02-28,91,0,13,100,113,17,21,38,151,9,42,OK - Oklahoma City
57,2007-2008,2007-12-01,2008-03-03,94,0,5,110,115,7,2,9,124,7,15,OK - Oklahoma City
58,2008-2009,2008-12-01,2009-03-28,118,0,10,126,136,6,4,10,146,3,13,OK - Oklahoma City
59,2009-2010,2009-12-01,2010-03-21,111,0,13,133,146,34,58,92,238,9,47,OK - Oklahoma City
60,2010-2011,2010-12-01,2011-02-28,90,0,17,145,162,26,41,67,229,6,57,OK - Oklahoma City
61,2011-2012,2011-12-01,2012-02-29,91,0,2,66,68,2,2,4,72,2,6,OK - Oklahoma City
62,2012-2013,2012-12-01,2013-02-28,90,0,2,87,89,10,1,11,100,6,16,OK - Oklahoma City
63,2013-2014,2013-11-22,2014-03-04,103,0,24,167,191,15,20,35,226,9,52,OK - Oklahoma City
64,2014-2015,2014-11-12,2015-03-05,114,0,9,119,128,18,10,28,156,7,39,OK - Oklahoma City
65,2015-2016,2015-12-01,2016-02-29,91,0,3,70,73,3,0,3,76,3,9,OK - Oklahoma City
66,2016-2017,2016-12-01,2017-02-28,90,0,7,85,92,4,3,7,99,3,22,OK - Oklahoma City
67,2017-2018,2017-12-01,2018-02-28,90,0,15,142,157,2,0,2,159,2,6,OK - Oklahoma City
68,2018-2019,2018-11-12,2019-03-04,113,0,9,125,134,9,6,15,149,4,14,OK - Oklahoma City
69,2019-2020,2019-12-01,2020-04-14,136,0,2,79,81,9,7,16,97,4,14,OK - Oklahoma City
0,1950-1951,1950-12-01,1951-02-28,90,0,22,139,161,11,20,31,192,5,35,OK - Tulsa
1,1951-1952,1951-11-01,1952-02-29,121,0,8,108,116,18,6,24,140,12,39,OK - Tulsa
2,1952-1953,1952-11-28,1953-02-28,93,0,4,86,90,12,12,24,114,5,26,OK - Tulsa
3,1953-1954,1953-12-01,1954-03-02,92,0,11,87,98,9,10,19,117,5,30,OK - Tulsa
4,1954-1955,1954-12-01,1955-03-22,112,0,1,99,100,20,19,39,139,4,28,OK - Tulsa
5,1955-1956,1955-11-30,1956-02-29,92,0,7,120,127,9,3,12,139,6,26,OK - Tulsa
6,1956-1957,1956-12-01,1957-04-12,133,0,15,87,102,8,2,10,112,6,26,OK - Tulsa
7,1957-1958,1957-12-01,1958-03-17,107,0,12,108,120,25,14,39,159,8,41,OK - Tulsa
8,1958-1959,1958-11-27,1959-02-28,94,0,21,143,164,28,49,77,241,12,64,OK - Tulsa
9,1959-1960,1959-11-17,1960-03-09,114,0,21,150,171,27,54,81,252,10,54,OK - Tulsa
10,1960-1961,1960-12-01,1961-02-28,90,0,8,123,131,8,7,15,146,3,13,OK - Tulsa
11,1961-1962,1961-12-01,1962-03-02,92,0,25,168,193,12,19,31,224,7,44,OK - Tulsa
12,1962-1963,1962-12-01,1963-02-28,90,0,24,190,214,6,0,6,220,5,26,OK - Tulsa
13,1963-1964,1963-12-01,1964-03-10,101,0,19,173,192,20,20,40,232,6,45,OK - Tulsa
14,1964-1965,1964-12-01,1965-03-25,115,0,13,168,181,6,1,7,188,5,23,OK - Tulsa
15,1965-1966,1965-12-01,1966-02-28,90,0,16,130,146,15,15,30,176,9,46,OK - Tulsa
16,1966-1967,1966-12-01,1967-03-08,98,0,10,161,171,10,7,17,188,7,28,OK - Tulsa
17,1967-1968,1967-11-28,1968-03-21,115,0,12,146,158,24,15,39,197,9,45,OK - Tulsa
18,1968-1969,1968-12-01,1969-03-15,105,0,6,144,150,12,3,15,165,5,17,OK - Tulsa
19,1969-1970,1969-12-01,1970-03-21,111,0,25,151,176,30,54,84,260,10,66,OK - Tulsa
20,1970-1971,1970-12-01,1971-02-28,90,0,11,111,122,9,9,18,140,4,17,OK - Tulsa
21,1971-1972,1971-11-22,1972-02-29,100,0,13,114,127,16,10,26,153,9,44,OK - Tulsa
22,1972-1973,1972-11-18,1973-04-09,143,0,33,149,182,26,20,46,228,14,61,OK - Tulsa
23,1973-1974,1973-12-01,1974-02-28,90,0,21,130,151,2,4,6,157,1,6,OK - Tulsa
24,1974-1975,1974-11-29,1975-03-13,105,0,6,107,113,9,6,15,128,6,23,OK - Tulsa
25,1975-1976,1975-11-26,1976-02-29,96,0,11,115,126,3,0,3,129,2,8,OK - Tulsa
26,1976-1977,1976-11-14,1977-02-28,107,0,23,190,213,17,30,47,260,7,45,OK - Tulsa
27,1977-1978,1977-12-01,1978-03-04,94,0,44,211,255,21,35,56,311,14,76,OK - Tulsa
28,1978-1979,1978-12-01,1979-02-28,90,0,49,231,280,29,89,118,398,18,114,OK - Tulsa
29,1979-1980,1979-12-01,1980-03-01,92,0,11,102,113,6,14,20,133,4,10,OK - Tulsa
30,1980-1981,1980-12-01,1981-02-28,90,0,6,121,127,2,0,2,129,2,8,OK - Tulsa
31,1981-1982,1981-12-01,1982-02-28,90,0,23,141,164,10,7,17,181,7,27,OK - Tulsa
32,1982-1983,1982-12-01,1983-02-28,90,0,2,57,59,9,5,14,73,5,16,OK - Tulsa
33,1983-1984,1983-12-01,1984-02-29,91,0,50,157,207,12,34,46,253,9,64,OK - Tulsa
34,1984-1985,1984-12-01,1985-02-28,90,0,23,142,165,20,20,40,205,6,38,OK - Tulsa
35,1985-1986,1985-11-28,1986-02-28,93,0,16,124,140,11,12,23,163,5,30,OK - Tulsa
36,1986-1987,1986-11-11,1987-02-28,110,0,6,92,98,20,43,63,161,4,27,OK - Tulsa
37,1987-1988,1987-12-01,1988-03-04,95,0,19,123,142,26,49,75,217,6,48,OK - Tulsa
38,1988-1989,1988-11-20,1989-03-09,110,0,17,122,139,24,21,45,184,8,39,OK - Tulsa
39,1989-1990,1989-12-01,1990-03-24,114,0,18,119,137,5,2,7,144,4,14,OK - Tulsa
40,1990-1991,1990-12-01,1991-02-28,90,0,17,103,120,9,12,21,141,6,38,OK - Tulsa
41,1991-1992,1991-11-02,1992-02-29,120,0,1,51,52,3,0,3,55,3,8,OK - Tulsa
42,1992-1993,1992-11-22,1993-02-28,99,0,14,114,128,18,16,34,162,7,34,OK - Tulsa
43,1993-1994,1993-10-30,1994-03-10,132,0,12,158,170,21,10,31,201,3,25,OK - Tulsa
44,1994-1995,1994-12-01,1995-03-04,94,0,5,78,83,12,9,21,104,7,26,OK - Tulsa
45,1995-1996,1995-11-10,1996-03-08,120,2,23,163,186,11,14,25,211,4,27,OK - Tulsa
46,1996-1997,1996-12-01,1997-02-28,90,0,17,115,132,11,7,18,150,5,25,OK - Tulsa
47,1997-1998,1997-12-01,1998-03-11,101,2,4,66,70,8,3,11,81,3,10,OK - Tulsa
48,1998-1999,1998-12-01,1999-03-14,104,0,11,91,102,12,8,20,122,4,16,OK - Tulsa
49,1999-2000,1999-12-01,2000-03-11,102,0,4,76,80,14,17,31,111,6,26,OK - Tulsa
50,2000-2001,2000-11-08,2001-02-28,113,0,21,173,194,21,38,59,253,8,47,OK - Tulsa
51,2001-2002,2001-11-28,2002-03-04,97,0,5,106,111,15,14,29,140,4,23,OK - Tulsa
52,2002-2003,2002-12-01,2003-03-05,95,0,13,120,133,31,35,66,199,8,52,OK - Tulsa
53,2003-2004,2003-12-01,2004-02-29,91,0,7,102,109,11,8,19,128,5,19,OK - Tulsa
54,2004-2005,2004-12-01,2005-02-28,90,0,6,77,83,3,1,4,87,2,5,OK - Tulsa
55,2005-2006,2005-12-01,2006-03-23,113,0,7,92,99,12,12,24,123,7,39,OK - Tulsa
56,2006-2007,2006-11-29,2007-04-05,128,0,15,121,136,25,37,62,198,10,54,OK - Tulsa
57,2007-2008,2007-12-01,2008-03-03,94,0,5,110,115,10,2,12,127,8,22,OK - Tulsa
58,2008-2009,2008-12-01,2009-03-29,119,0,12,128,140,20,6,26,166,7,40,OK - Tulsa
59,2009-2010,2009-12-01,2010-03-21,111,0,19,148,167,35,42,77,244,12,64,OK - Tulsa
60,2010-2011,2010-12-01,2011-02-28,90,0,19,162,181,35,82,117,298,7,68,OK - Tulsa
61,2011-2012,2011-12-01,2012-02-29,91,0,1,66,67,3,2,5,72,2,5,OK - Tulsa
62,2012-2013,2012-12-01,2013-02-28,90,0,2,95,97,6,0,6,103,3,9,OK - Tulsa
63,2013-2014,2013-11-24,2014-03-04,101,0,30,196,226,20,24,44,270,10,65,OK - Tulsa
64,2014-2015,2014-11-16,2015-03-04,109,0,10,128,138,13,10,23,161,8,36,OK - Tulsa
65,2015-2016,2015-12-01,2016-02-29,91,0,3,64,67,4,1,5,72,2,7,OK - Tulsa
66,2016-2017,2016-12-01,2017-02-28,90,0,5,85,90,2,0,2,92,2,13,OK - Tulsa
67,2017-2018,2017-12-01,2018-04-07,128,0,13,130,143,4,2,6,149,2,6,OK - Tulsa
68,2018-2019,2018-11-12,2019-03-04,113,0,7,121,128,6,1,7,135,5,23,OK - Tulsa
69,2019-2020,2019-11-11,2020-02-29,111,0,1,72,73,6,3,9,82,4,11,OK - Tulsa
0,1950-1951,1950-12-01,1951-03-13,103,4,2,44,46,51,41,92,138,12,66,OR - Clatskanie
1,1951-1952,1951-12-01,1952-02-29,91,8,3,57,60,38,46,84,144,12,53,OR - Clatskanie
2,1952-1953,1952-12-01,1953-02-28,90,0,0,16,16,0,0,0,16,0,0,OR - Clatskanie
3,1953-1954,1953-12-01,1954-02-28,90,0,1,34,35,49,84,133,168,10,59,OR - Clatskanie
4,1954-1955,1954-12-01,1955-03-13,103,0,0,51,51,14,3,17,68,6,20,OR - Clatskanie
5,1955-1956,1955-11-11,1956-03-06,117,1,8,85,93,62,85,147,240,15,91,OR - Clatskanie
6,1956-1957,1956-12-01,1957-02-28,90,1,8,74,82,24,50,74,156,14,47,OR - Clatskanie
7,1957-1958,1957-12-01,1958-02-28,90,1,0,10,10,0,0,0,10,0,0,OR - Clatskanie
8,1958-1959,1958-12-01,1959-02-28,90,0,2,22,24,3,3,6,30,1,5,OR - Clatskanie
9,1959-1960,1959-12-01,1960-03-04,95,1,1,50,51,26,22,48,99,7,35,OR - Clatskanie
10,1960-1961,1960-12-01,1961-03-03,93,0,0,23,23,2,0,2,25,1,3,OR - Clatskanie
11,1961-1962,1961-12-01,1962-03-04,94,0,5,53,58,23,23,46,104,7,30,OR - Clatskanie
12,1962-1963,1962-12-01,1963-02-28,90,0,4,46,50,12,20,32,82,3,20,OR - Clatskanie
13,1963-1964,1963-12-01,1964-02-29,91,0,0,25,25,0,0,0,25,0,0,OR - Clatskanie
14,1964-1965,1964-11-13,1965-03-25,133,0,4,61,65,43,53,96,161,13,57,OR - Clatskanie
15,1965-1966,1965-12-01,1966-03-21,111,0,0,44,44,30,33,63,107,10,40,OR - Clatskanie
16,1966-1967,1966-12-01,1967-02-28,90,0,0,16,16,2,0,2,18,1,3,OR - Clatskanie
17,1967-1968,1967-12-01,1968-02-29,91,0,0,44,44,18,3,21,65,7,25,OR - Clatskanie
18,1968-1969,1968-12-01,1969-02-28,90,7,11,73,84,49,129,178,262,19,83,OR - Clatskanie
19,1969-1970,1969-12-01,1970-02-28,90,0,0,25,25,2,0,2,27,1,3,OR - Clatskanie
20,1970-1971,1970-11-22,1971-03-06,105,0,1,44,45,61,58,119,164,13,75,OR - Clatskanie
21,1971-1972,1971-12-01,1972-03-25,116,0,3,38,41,16,15,31,72,6,23,OR - Clatskanie
22,1972-1973,1972-12-01,1973-02-28,90,0,14,60,74,13,41,54,128,4,23,OR - Clatskanie
23,1973-1974,1973-11-03,1974-03-07,125,3,7,48,55,7,1,8,63,5,14,OR - Clatskanie
24,1974-1975,1974-12-01,1975-02-28,90,0,0,21,21,6,3,9,30,1,7,OR - Clatskanie
25,1975-1976,1975-11-29,1976-02-29,93,9,0,32,32,5,3,8,40,2,7,OR - Clatskanie
26,1976-1977,1976-12-01,1977-02-28,90,6,1,34,35,2,0,2,37,1,2,OR - Clatskanie
27,1977-1978,1977-11-22,1978-03-03,102,6,0,19,19,2,1,3,22,2,4,OR - Clatskanie
28,1978-1979,1978-11-19,1979-02-28,102,0,10,83,93,25,56,81,174,10,44,OR - Clatskanie
29,1979-1980,1979-12-01,1980-03-15,106,0,4,43,47,35,19,54,101,10,46,OR - Clatskanie
30,1980-1981,1980-12-01,1981-02-28,90,1,0,20,20,4,0,4,24,2,5,OR - Clatskanie
31,1981-1982,1981-12-01,1982-02-28,90,5,1,31,32,21,21,42,74,7,25,OR - Clatskanie
32,1982-1983,1982-12-01,1983-02-28,90,6,0,23,23,0,0,0,23,0,0,OR - Clatskanie
33,1983-1984,1983-12-01,1984-02-29,91,1,6,55,61,5,13,18,79,3,18,OR - Clatskanie
34,1984-1985,1984-12-01,1985-02-28,90,0,2,69,71,16,9,25,96,7,26,OR - Clatskanie
35,1985-1986,1985-11-22,1986-02-28,99,4,8,96,104,11,28,39,143,7,31,OR - Clatskanie
37,1987-1988,1987-12-01,1988-02-29,91,5,0,51,51,2,1,3,54,1,3,OR - Clatskanie
39,1989-1990,1989-12-01,1990-02-28,90,6,0,43,43,13,1,14,57,3,17,OR - Clatskanie
40,1990-1991,1990-12-01,1991-02-28,90,10,15,89,104,6,12,18,122,4,18,OR - Clatskanie
41,1991-1992,1991-12-01,1992-02-29,91,0,0,30,30,0,0,0,30,0,0,OR - Clatskanie
42,1992-1993,1992-12-01,1993-02-28,90,7,0,97,97,0,2,2,99,0,0,OR - Clatskanie
43,1993-1994,1993-12-01,1994-02-28,90,3,0,58,58,3,0,3,61,1,4,OR - Clatskanie
44,1994-1995,1994-12-01,1995-02-28,90,5,0,44,44,4,0,4,48,4,9,OR - Clatskanie
45,1995-1996,1995-12-01,1996-02-29,91,1,2,58,60,0,0,0,60,0,0,OR - Clatskanie
46,1996-1997,1996-12-01,1997-02-28,90,0,0,46,46,2,1,3,49,1,3,OR - Clatskanie
47,1997-1998,1997-12-01,1998-02-28,90,0,1,35,36,8,12,20,56,3,12,OR - Clatskanie
48,1998-1999,1998-12-01,1999-02-28,90,0,6,49,55,6,7,13,68,4,24,OR - Clatskanie
49,1999-2000,1999-12-01,2000-02-29,91,0,0,46,46,1,1,2,48,1,2,OR - Clatskanie
50,2000-2001,2000-12-01,2001-02-28,90,0,0,60,60,1,0,1,61,1,3,OR - Clatskanie
51,2001-2002,2001-12-01,2002-03-17,107,2,0,53,53,4,0,4,57,3,7,OR - Clatskanie
52,2002-2003,2002-12-01,2003-02-28,90,16,0,37,37,0,0,0,37,0,0,OR - Clatskanie
53,2003-2004,2003-12-01,2004-02-29,91,2,3,44,47,11,23,34,81,4,18,OR - Clatskanie
54,2004-2005,2004-12-01,2005-02-28,90,0,0,59,59,0,0,0,59,0,0,OR - Clatskanie
55,2005-2006,2005-12-01,2006-03-10,100,0,0,62,62,1,0,1,63,1,2,OR - Clatskanie
56,2006-2007,2006-11-27,2007-03-01,95,0,2,65,67,9,8,17,84,6,15,OR - Clatskanie
57,2007-2008,2007-12-01,2008-03-27,118,1,0,65,65,5,0,5,70,4,9,OR - Clatskanie
58,2008-2009,2008-12-01,2009-03-09,99,7,8,90,98,31,71,102,200,17,59,OR - Clatskanie
59,2009-2010,2009-12-01,2010-02-28,90,10,2,65,67,2,1,3,70,1,3,OR - Clatskanie
63,2013-2014,2013-12-01,2014-02-28,90,14,9,76,85,11,0,11,96,3,21,OR - Clatskanie
64,2014-2015,2014-12-01,2015-02-28,90,0,0,42,42,0,0,0,42,0,0,OR - Clatskanie
65,2015-2016,2015-12-01,2016-02-29,91,0,1,42,43,2,1,3,46,1,6,OR - Clatskanie
66,2016-2017,2016-12-01,2017-02-28,90,0,2,93,95,0,0,0,95,0,0,OR - Clatskanie
67,2017-2018,2017-12-01,2018-02-28,90,17,0,48,48,5,0,5,53,2,8,OR - Clatskanie
68,2018-2019,2018-12-01,2019-02-28,90,2,0,58,58,5,0,5,63,2,7,OR - Clatskanie
69,2019-2020,2019-12-01,2020-02-29,91,0,0,34,34,0,0,0,34,0,0,OR - Clatskanie
0,1950-1951,1950-12-01,1951-03-12,102,0,0,48,48,28,31,59,107,5,35,OR - Cottage Grove
1,1951-1952,1951-12-01,1952-02-29,91,0,1,57,58,24,12,36,94,10,35,OR - Cottage Grove
2,1952-1953,1952-12-01,1953-04-07,128,3,0,44,44,1,0,1,45,1,1,OR - Cottage Grove
3,1953-1954,1953-12-01,1954-03-11,101,0,0,44,44,11,0,11,55,5,16,OR - Cottage Grove
4,1954-1955,1954-12-01,1955-03-14,104,0,0,70,70,6,1,7,77,3,9,OR - Cottage Grove
5,1955-1956,1955-11-15,1956-03-05,112,1,2,64,66,25,22,47,113,7,39,OR - Cottage Grove
6,1956-1957,1956-12-01,1957-02-28,90,0,6,91,97,9,18,27,124,5,17,OR - Cottage Grove
7,1957-1958,1957-12-01,1958-02-28,90,1,0,22,22,0,0,0,22,0,0,OR - Cottage Grove
8,1958-1959,1958-12-01,1959-02-28,90,0,1,26,27,5,1,6,33,3,10,OR - Cottage Grove
9,1959-1960,1959-12-01,1960-02-29,91,0,0,49,49,1,0,1,50,1,1,OR - Cottage Grove
10,1960-1961,1960-12-01,1961-02-28,90,0,0,32,32,0,0,0,32,0,0,OR - Cottage Grove
11,1961-1962,1961-11-24,1962-03-03,100,9,4,81,85,21,31,52,137,5,34,OR - Cottage Grove
12,1962-1963,1962-12-01,1963-04-16,137,0,3,78,81,7,1,8,89,3,13,OR - Cottage Grove
13,1963-1964,1963-12-01,1964-05-05,157,0,0,72,72,4,0,4,76,3,6,OR - Cottage Grove
15,1965-1966,1965-12-01,1966-03-03,93,0,2,60,62,22,6,28,90,7,29,OR - Cottage Grove
16,1966-1967,1966-12-01,1967-02-28,90,0,0,27,27,0,0,0,27,0,0,OR - Cottage Grove
17,1967-1968,1967-12-01,1968-02-29,91,0,1,65,66,12,4,16,82,4,18,OR - Cottage Grove
18,1968-1969,1968-12-01,1969-02-28,90,3,3,64,67,64,96,160,227,11,82,OR - Cottage Grove
19,1969-1970,1969-12-01,1970-03-01,91,0,0,33,33,3,0,3,36,1,4,OR - Cottage Grove
20,1970-1971,1970-12-01,1971-03-02,92,0,1,53,54,39,26,65,119,6,46,OR - Cottage Grove
21,1971-1972,1971-12-01,1972-03-25,116,0,1,58,59,6,2,8,67,4,12,OR - Cottage Grove
22,1972-1973,1972-12-01,1973-02-28,90,1,10,76,86,10,24,34,120,5,25,OR - Cottage Grove
23,1973-1974,1973-11-05,1974-02-28,116,0,2,61,63,4,0,4,67,2,6,OR - Cottage Grove
24,1974-1975,1974-12-01,1975-02-28,90,0,0,38,38,5,3,8,46,2,7,OR - Cottage Grove
25,1975-1976,1975-12-01,1976-03-31,122,0,0,72,72,7,4,11,83,3,10,OR - Cottage Grove
26,1976-1977,1976-12-01,1977-02-28,90,0,0,73,73,0,0,0,73,0,0,OR - Cottage Grove
27,1977-1978,1977-11-21,1978-02-28,100,0,0,26,26,3,1,4,30,1,4,OR - Cottage Grove
28,1978-1979,1978-12-01,1979-02-28,90,0,7,95,102,2,0,2,104,1,6,OR - Cottage Grove
29,1979-1980,1979-12-01,1980-03-15,106,0,2,69,71,4,0,4,75,2,6,OR - Cottage Grove
30,1980-1981,1980-12-01,1981-02-28,90,0,0,33,33,1,0,1,34,1,2,OR - Cottage Grove
31,1981-1982,1981-12-01,1982-02-28,90,0,0,61,61,8,22,30,91,3,11,OR - Cottage Grove
32,1982-1983,1982-12-01,1983-02-28,90,1,0,41,41,0,0,0,41,0,0,OR - Cottage Grove
33,1983-1984,1983-12-01,1984-02-29,91,6,4,52,56,5,4,9,65,2,11,OR - Cottage Grove
34,1984-1985,1984-12-01,1985-02-28,90,0,1,70,71,1,0,1,72,1,2,OR - Cottage Grove
35,1985-1986,1985-11-24,1986-02-28,97,0,2,95,97,16,6,22,119,5,25,OR - Cottage Grove
36,1986-1987,1986-12-01,1987-02-28,90,1,0,55,55,0,0,0,55,0,0,OR - Cottage Grove
37,1987-1988,1987-12-01,1988-02-29,91,0,0,47,47,9,9,18,65,3,12,OR - Cottage Grove
38,1988-1989,1988-12-01,1989-02-28,90,0,4,84,88,14,26,40,128,3,17,OR - Cottage Grove
39,1989-1990,1989-12-01,1990-02-28,90,3,0,37,37,14,18,32,69,2,16,OR - Cottage Grove
40,1990-1991,1990-12-01,1991-02-28,90,2,9,89,98,3,6,9,107,1,4,OR - Cottage Grove
41,1991-1992,1991-12-01,1992-02-29,91,0,0,26,26,0,0,0,26,0,0,OR - Cottage Grove
42,1992-1993,1992-12-01,1993-02-28,90,3,0,62,62,1,3,4,66,1,2,OR - Cottage Grove
43,1993-1994,1993-12-01,1994-02-28,90,0,0,54,54,0,0,0,54,0,0,OR - Cottage Grove
44,1994-1995,1994-12-01,1995-02-28,90,2,0,29,29,0,0,0,29,0,0,OR - Cottage Grove
45,1995-1996,1995-12-01,1996-02-29,91,12,1,35,36,0,0,0,36,0,0,OR - Cottage Grove
48,1998-1999,1998-12-01,1999-02-28,90,15,4,54,58,4,2,6,64,3,8,OR - Cottage Grove
49,1999-2000,1999-12-01,2000-02-29,91,1,0,30,30,0,0,0,30,0,0,OR - Cottage Grove
50,2000-2001,2000-12-01,2001-02-28,90,1,0,46,46,0,0,0,46,0,0,OR - Cottage Grove
51,2001-2002,2001-12-01,2002-02-28,90,1,0,35,35,0,0,0,35,0,0,OR - Cottage Grove
52,2002-2003,2002-12-01,2003-02-28,90,1,0,23,23,0,0,0,23,0,0,OR - Cottage Grove
53,2003-2004,2003-12-01,2004-02-29,91,14,1,20,21,0,1,1,22,0,0,OR - Cottage Grove
54,2004-2005,2004-12-01,2005-02-28,90,4,0,48,48,0,0,0,48,0,0,OR - Cottage Grove
55,2005-2006,2005-12-01,2006-02-28,90,0,4,55,59,0,0,0,59,0,0,OR - Cottage Grove
56,2006-2007,2006-12-01,2007-02-28,90,0,3,65,68,3,0,3,71,1,4,OR - Cottage Grove
57,2007-2008,2007-12-01,2008-04-20,142,13,1,75,76,25,2,27,103,7,34,OR - Cottage Grove
58,2008-2009,2008-12-01,2009-04-13,134,0,1,66,67,11,8,19,86,6,16,OR - Cottage Grove
59,2009-2010,2009-12-01,2010-02-28,90,0,4,43,47,0,0,0,47,0,0,OR - Cottage Grove
60,2010-2011,2010-11-22,2011-02-28,99,1,1,49,50,5,1,6,56,5,7,OR - Cottage Grove
61,2011-2012,2011-12-01,2012-03-21,112,0,1,65,66,20,13,33,99,6,22,OR - Cottage Grove
62,2012-2013,2012-12-01,2013-02-28,90,0,0,36,36,1,0,1,37,1,1,OR - Cottage Grove
63,2013-2014,2013-12-01,2014-02-28,90,0,8,78,86,9,29,38,124,4,20,OR - Cottage Grove
64,2014-2015,2014-12-01,2015-02-28,90,0,0,25,25,0,0,0,25,0,0,OR - Cottage Grove
65,2015-2016,2015-12-01,2016-02-29,91,0,1,31,32,1,0,1,33,1,2,OR - Cottage Grove
66,2016-2017,2016-12-01,2017-03-06,96,0,6,73,79,6,10,16,95,3,13,OR - Cottage Grove
67,2017-2018,2017-12-01,2018-02-28,90,0,0,36,36,7,5,12,48,2,8,OR - Cottage Grove
68,2018-2019,2018-12-01,2019-03-11,101,0,1,60,61,32,69,101,162,7,40,OR - Cottage Grove
69,2019-2020,2019-12-01,2020-02-29,91,0,0,29,29,0,0,0,29,0,0,OR - Cottage Grove
1,1951-1952,1951-08-29,1952-06-30,307,14,115,562,677,1145,3569,4714,5391,114,1535,OR - Crater Lake
2,1952-1953,1952-11-12,1953-06-30,231,10,75,492,567,860,3261,4121,4688,100,1166,OR - Crater Lake
4,1954-1955,1954-10-13,1955-06-13,244,8,124,585,709,719,2824,3543,4252,99,1095,OR - Crater Lake
5,1955-1956,1955-09-15,1956-06-29,289,20,136,598,734,913,3323,4236,4970,111,1353,OR - Crater Lake
6,1956-1957,1956-10-11,1957-06-15,248,14,92,488,580,670,2981,3651,4231,89,966,OR - Crater Lake
7,1957-1958,1957-10-03,1958-06-22,263,1,74,480,554,799,3193,3992,4546,109,1101,OR - Crater Lake
8,1958-1959,1958-10-19,1959-06-11,236,1,61,441,502,547,2582,3129,3631,87,809,OR - Crater Lake
9,1959-1960,1959-09-18,1960-06-25,282,1,85,499,584,671,2765,3436,4020,107,1004,OR - Crater Lake
10,1960-1961,1960-08-22,1961-06-21,304,3,71,502,573,720,3208,3928,4501,111,1062,OR - Crater Lake
11,1961-1962,1961-09-21,1962-06-21,274,2,109,673,782,788,3374,4162,4944,105,1197,OR - Crater Lake
12,1962-1963,1962-09-29,1963-06-29,274,0,56,474,530,662,2707,3369,3899,94,911,OR - Crater Lake
13,1963-1964,1963-10-06,1964-06-24,263,1,82,546,628,807,3117,3924,4552,96,1140,OR - Crater Lake
14,1964-1965,1964-09-01,1965-06-19,292,0,81,523,604,752,3197,3949,4553,89,1053,OR - Crater Lake
15,1965-1966,1965-10-15,1966-06-07,236,10,94,531,625,631,2646,3277,3902,80,934,OR - Crater Lake
16,1966-1967,1966-07-02,1967-06-27,361,3,93,585,678,792,3251,4043,4721,117,1202,OR - Crater Lake
17,1967-1968,1967-10-02,1968-06-29,272,2,91,494,585,518,2529,3047,3632,88,844,OR - Crater Lake
18,1968-1969,1968-08-18,1969-06-28,315,4,147,624,771,837,3046,3883,4654,131,1360,OR - Crater Lake
19,1969-1970,1969-10-02,1970-06-29,271,0,83,524,607,731,2932,3663,4270,110,1048,OR - Crater Lake
20,1970-1971,1970-10-06,1971-06-30,268,3,120,612,732,935,3623,4558,5290,119,1366,OR - Crater Lake
21,1971-1972,1971-09-25,1972-06-30,280,0,119,618,737,856,3561,4417,5154,125,1283,OR - Crater Lake
22,1972-1973,1972-08-16,1973-06-18,307,2,117,618,735,636,2943,3579,4314,111,1019,OR - Crater Lake
23,1973-1974,1973-09-24,1974-06-30,280,0,126,612,738,877,3622,4499,5237,131,1328,OR - Crater Lake
24,1974-1975,1974-07-10,1975-06-30,356,9,103,611,714,892,3220,4112,4826,106,1271,OR - Crater Lake
25,1975-1976,1975-10-06,1976-06-25,264,4,92,616,708,717,3501,4218,4926,104,1079,OR - Crater Lake
26,1976-1977,1976-07-01,1977-06-04,339,6,55,518,573,355,1710,2065,2638,70,581,OR - Crater Lake
27,1977-1978,1977-10-07,1978-06-19,256,3,75,489,564,574,3178,3752,4316,107,882,OR - Crater Lake
28,1978-1979,1978-09-11,1979-04-30,232,9,107,570,677,443,2107,2550,3227,83,722,OR - Crater Lake
29,1979-1980,1979-10-19,1980-06-24,250,4,76,573,649,577,3437,4014,4663,106,899,OR - Crater Lake
30,1980-1981,1980-10-12,1981-06-14,246,5,40,496,536,398,2477,2875,3411,80,620,OR - Crater Lake
31,1981-1982,1981-07-07,1982-06-30,359,4,106,644,750,855,3501,4356,5106,111,1240,OR - Crater Lake
33,1983-1984,1983-07-07,1984-06-30,360,14,83,571,654,788,3560,4348,5002,110,1100,OR - Crater Lake
34,1984-1985,1984-09-23,1985-06-16,267,4,110,628,738,710,3434,4144,4882,96,1101,OR - Crater Lake
35,1985-1986,1985-09-09,1986-06-18,283,11,80,546,626,720,3145,3865,4491,96,1020,OR - Crater Lake
36,1986-1987,1986-07-04,1987-06-12,344,10,58,537,595,604,2849,3453,4048,91,872,OR - Crater Lake
37,1987-1988,1987-11-02,1988-06-29,241,7,73,540,613,507,2775,3282,3895,99,805,OR - Crater Lake
38,1988-1989,1988-11-06,1989-06-24,231,4,108,543,651,842,3277,4119,4770,101,1214,OR - Crater Lake
41,1991-1992,1991-10-24,1992-06-13,234,9,33,356,389,341,2344,2685,3074,64,487,OR - Crater Lake
42,1992-1993,1992-09-24,1993-06-30,280,4,103,534,637,843,3329,4172,4809,114,1232,OR - Crater Lake
43,1993-1994,1993-10-16,1994-06-14,242,17,53,425,478,493,2510,3003,3481,74,705,OR - Crater Lake
44,1994-1995,1994-11-01,1995-06-30,242,7,104,521,625,847,3501,4348,4973,110,1207,OR - Crater Lake
45,1995-1996,1995-10-12,1996-06-15,248,7,72,437,509,741,2701,3442,3951,93,1014,OR - Crater Lake
46,1996-1997,1996-09-16,1997-06-17,275,12,61,512,573,753,3157,3910,4483,105,1024,OR - Crater Lake
48,1998-1999,1998-10-02,1999-06-30,272,11,123,582,705,958,3487,4445,5150,123,1384,OR - Crater Lake
49,1999-2000,1999-08-31,2000-06-17,292,9,67,431,498,676,2970,3646,4144,122,994,OR - Crater Lake
50,2000-2001,2000-09-02,2001-06-12,284,2,69,508,577,387,2431,2818,3395,89,654,OR - Crater Lake
51,2001-2002,2001-10-24,2002-06-15,235,6,82,499,581,639,2919,3558,4139,93,957,OR - Crater Lake
52,2002-2003,2002-09-30,2003-06-19,263,9,57,436,493,597,2965,3562,4055,94,835,OR - Crater Lake
53,2003-2004,2003-09-17,2004-06-24,282,11,75,460,535,724,3234,3958,4493,109,1031,OR - Crater Lake
54,2004-2005,2004-09-18,2005-06-20,276,12,54,470,524,542,3106,3648,4172,103,796,OR - Crater Lake
55,2005-2006,2005-09-10,2006-06-30,294,10,94,528,622,794,3422,4216,4838,116,1157,OR - Crater Lake
58,2008-2009,2008-10-10,2009-06-21,255,10,87,521,608,635,2745,3380,3988,101,1004,OR - Crater Lake
59,2009-2010,2009-09-29,2010-06-30,275,13,124,564,688,587,3091,3678,4366,121,977,OR - Crater Lake
60,2010-2011,2010-10-23,2011-06-30,251,4,180,554,734,945,3546,4491,5225,134,1449,OR - Crater Lake
61,2011-2012,2011-10-05,2012-06-30,270,9,103,548,651,549,2896,3445,4096,108,923,OR - Crater Lake
62,2012-2013,2012-10-20,2013-06-19,243,6,110,495,605,484,2715,3199,3804,83,775,OR - Crater Lake
66,2016-2017,2016-10-03,2017-06-30,271,0,122,531,653,798,3381,4179,4832,118,1163,OR - Crater Lake
67,2017-2018,2017-09-19,2018-06-10,265,9,116,497,613,479,2664,3143,3756,89,828,OR - Crater Lake
69,2019-2020,2019-09-28,2020-06-17,264,11,109,468,577,510,2638,3148,3725,96,809,OR - Crater Lake
6,1956-1957,1956-10-27,1957-03-09,134,4,78,440,518,80,543,623,1141,29,208,OR - Halfway
7,1957-1958,1957-12-01,1958-05-12,163,0,26,271,297,72,585,657,954,14,102,OR - Halfway
8,1958-1959,1958-11-17,1959-04-17,152,1,13,269,282,55,117,172,454,16,90,OR - Halfway
9,1959-1960,1959-11-04,1960-03-18,136,4,40,471,511,70,510,580,1091,31,194,OR - Halfway
10,1960-1961,1960-11-15,1961-03-27,133,0,11,312,323,75,255,330,653,22,115,OR - Halfway
11,1961-1962,1961-10-23,1962-03-24,153,0,77,513,590,138,755,893,1483,36,274,OR - Halfway
12,1962-1963,1962-11-17,1963-04-15,150,0,20,314,334,31,26,57,391,12,62,OR - Halfway
13,1963-1964,1963-11-08,1964-05-02,177,1,55,513,568,175,936,1111,1679,45,297,OR - Halfway
14,1964-1965,1964-11-22,1965-03-26,125,1,27,320,347,119,462,581,928,32,189,OR - Halfway
15,1965-1966,1965-11-25,1966-03-21,117,0,18,289,307,52,150,202,509,20,100,OR - Halfway
16,1966-1967,1966-10-22,1967-04-14,175,0,16,303,319,86,377,463,782,26,137,OR - Halfway
17,1967-1968,1967-11-28,1968-02-29,94,0,43,304,347,77,468,545,892,24,163,OR - Halfway
18,1968-1969,1968-11-15,1969-04-06,143,0,36,370,406,136,646,782,1188,36,252,OR - Halfway
19,1969-1970,1969-11-17,1970-04-27,162,0,11,301,312,66,217,283,595,18,102,OR - Halfway
20,1970-1971,1970-10-23,1971-03-17,146,0,38,363,401,90,574,664,1065,26,158,OR - Halfway
21,1971-1972,1971-10-27,1972-03-25,151,0,59,398,457,157,787,944,1401,36,266,OR - Halfway
22,1972-1973,1972-11-26,1973-03-13,108,0,81,343,424,62,549,611,1035,18,130,OR - Halfway
23,1973-1974,1973-11-05,1974-03-08,124,0,64,305,369,137,677,814,1183,29,198,OR - Halfway
24,1974-1975,1974-11-23,1975-04-04,133,1,41,385,426,189,910,1099,1525,40,297,OR - Halfway
25,1975-1976,1975-10-23,1976-03-30,160,0,57,456,513,150,961,1111,1624,31,214,OR - Halfway
26,1976-1977,1976-12-01,1977-04-01,122,1,35,381,416,40,215,255,671,16,77,OR - Halfway
27,1977-1978,1977-11-19,1978-04-06,139,0,10,186,196,61,167,228,424,19,94,OR - Halfway
28,1978-1979,1978-11-11,1979-04-02,143,1,133,570,703,100,853,953,1656,29,196,OR - Halfway
29,1979-1980,1979-11-18,1980-03-27,131,0,25,260,285,68,317,385,670,17,106,OR - Halfway
30,1980-1981,1980-11-21,1981-03-31,131,0,9,242,251,40,52,92,343,12,60,OR - Halfway
31,1981-1982,1981-11-24,1982-04-07,135,1,55,364,419,177,661,838,1257,41,299,OR - Halfway
32,1982-1983,1982-11-20,1983-03-27,128,0,27,275,302,87,472,559,861,18,124,OR - Halfway
33,1983-1984,1983-11-19,1984-04-12,146,9,86,404,490,142,976,1118,1608,36,250,OR - Halfway
34,1984-1985,1984-11-10,1985-03-31,142,1,114,567,681,154,1046,1200,1881,36,299,OR - Halfway
35,1985-1986,1985-10-22,1986-02-28,130,4,107,456,563,119,767,886,1449,27,192,OR - Halfway
36,1986-1987,1986-11-07,1987-03-06,120,2,42,317,359,85,521,606,965,24,157,OR - Halfway
37,1987-1988,1987-11-24,1988-03-29,127,4,36,340,376,76,376,452,828,19,128,OR - Halfway
38,1988-1989,1988-11-13,1989-03-26,134,8,94,505,599,206,1145,1351,1950,42,361,OR - Halfway
39,1989-1990,1989-12-01,1990-03-11,101,4,6,275,281,112,243,355,636,19,164,OR - Halfway
40,1990-1991,1990-11-21,1991-03-13,113,8,73,403,476,67,424,491,967,18,148,OR - Halfway
41,1991-1992,1991-11-01,1992-02-29,121,2,6,244,250,36,244,280,530,11,53,OR - Halfway
42,1992-1993,1992-11-21,1993-04-10,141,6,73,402,475,222,1109,1331,1806,45,373,OR - Halfway
44,1994-1995,1994-11-04,1995-02-28,117,4,52,317,369,115,605,720,1089,20,186,OR - Halfway
45,1995-1996,1995-11-07,1996-02-29,115,10,31,253,284,48,405,453,737,10,67,OR - Halfway
46,1996-1997,1996-12-01,1997-03-09,99,12,18,231,249,78,347,425,674,18,118,OR - Halfway
47,1997-1998,1997-12-01,1998-03-10,100,0,28,239,267,82,552,634,901,18,127,OR - Halfway
48,1998-1999,1998-12-01,1999-03-22,112,0,41,332,373,121,756,877,1250,22,179,OR - Halfway
49,1999-2000,1999-11-21,2000-03-07,108,3,35,256,291,124,815,939,1230,27,195,OR - Halfway
50,2000-2001,2000-11-08,2001-04-02,146,19,49,371,420,80,523,603,1023,24,131,OR - Halfway
51,2001-2002,2001-11-25,2002-03-27,123,0,45,391,436,161,1074,1235,1671,34,263,OR - Halfway
52,2002-2003,2002-10-30,2003-02-28,122,8,7,237,244,37,169,206,450,7,48,OR - Halfway
53,2003-2004,2003-11-24,2004-03-21,119,1,31,298,329,142,777,919,1248,30,230,OR - Halfway
54,2004-2005,2004-11-30,2005-02-28,91,7,17,235,252,29,190,219,471,9,61,OR - Halfway
55,2005-2006,2005-11-06,2006-03-24,139,13,48,434,482,87,674,761,1243,15,120,OR - Halfway
56,2006-2007,2006-11-26,2007-03-05,100,4,48,336,384,48,315,363,747,14,84,OR - Halfway
57,2007-2008,2007-11-20,2008-04-09,142,1,45,406,451,174,763,937,1388,39,300,OR - Halfway
58,2008-2009,2008-12-01,2009-04-03,124,1,45,369,414,112,651,763,1177,27,216,OR - Halfway
59,2009-2010,2009-11-13,2010-04-02,141,2,26,374,400,89,660,749,1149,21,142,OR - Halfway
61,2011-2012,2011-11-16,2012-03-21,127,0,8,290,298,54,135,189,487,15,84,OR - Halfway
62,2012-2013,2012-11-12,2013-03-01,110,4,62,287,349,58,329,387,736,19,125,OR - Halfway
63,2013-2014,2013-11-05,2014-02-28,116,0,60,295,355,44,251,295,650,16,102,OR - Halfway
64,2014-2015,2014-11-12,2015-02-28,109,0,46,217,263,48,288,336,599,17,92,OR - Halfway
65,2015-2016,2015-11-09,2016-02-29,113,0,64,273,337,88,720,808,1145,22,144,OR - Halfway
66,2016-2017,2016-12-01,2017-03-15,105,0,136,358,494,132,951,1083,1577,35,309,OR - Halfway
67,2017-2018,2017-11-05,2018-03-07,123,0,30,238,268,44,169,213,481,17,99,OR - Halfway
68,2018-2019,2018-12-01,2019-03-17,107,0,51,278,329,64,496,560,889,22,113,OR - Halfway
69,2019-2020,2019-11-25,2020-03-05,102,0,27,216,243,76,528,604,847,19,121,OR - Halfway
0,1950-1951,1950-12-01,1951-03-07,97,6,12,101,113,7,4,11,124,6,18,OR - Heppner
1,1951-1952,1951-12-01,1952-03-20,111,5,27,185,212,38,62,100,312,16,83,OR - Heppner
2,1952-1953,1952-11-25,1953-04-09,136,2,15,128,143,22,20,42,185,9,37,OR - Heppner
3,1953-1954,1953-12-01,1954-04-30,151,3,16,149,165,21,23,44,209,5,33,OR - Heppner
4,1954-1955,1954-12-01,1955-04-18,139,2,7,180,187,16,7,23,210,10,35,OR - Heppner
5,1955-1956,1955-11-01,1956-03-06,127,2,46,218,264,44,89,133,397,25,136,OR - Heppner
6,1956-1957,1956-11-20,1957-02-28,101,9,66,217,283,37,111,148,431,18,129,OR - Heppner
7,1957-1958,1957-12-01,1958-03-14,104,14,4,74,78,4,0,4,82,3,9,OR - Heppner
8,1958-1959,1958-11-15,1959-02-28,106,0,23,124,147,25,26,51,198,12,54,OR - Heppner
9,1959-1960,1959-11-14,1960-03-07,115,4,36,224,260,32,105,137,397,17,103,OR - Heppner
10,1960-1961,1960-12-01,1961-03-04,94,1,21,95,116,1,0,1,117,1,2,OR - Heppner
11,1961-1962,1961-11-24,1962-03-11,108,3,35,173,208,29,60,89,297,17,89,OR - Heppner
12,1962-1963,1962-11-22,1963-04-20,150,1,23,171,194,20,27,47,241,13,63,OR - Heppner
13,1963-1964,1963-12-01,1964-04-05,127,6,8,132,140,8,13,21,161,5,19,OR - Heppner
14,1964-1965,1964-11-22,1965-03-27,126,1,22,155,177,26,28,54,231,14,62,OR - Heppner
15,1965-1966,1965-12-01,1966-03-01,91,2,7,111,118,15,7,22,140,10,31,OR - Heppner
16,1966-1967,1966-12-01,1967-03-28,118,0,0,78,78,16,12,28,106,7,22,OR - Heppner
17,1967-1968,1967-11-27,1968-02-29,95,0,12,122,134,17,23,40,174,7,36,OR - Heppner
18,1968-1969,1968-12-01,1969-03-07,97,0,64,197,261,68,212,280,541,31,224,OR - Heppner
19,1969-1970,1969-11-27,1970-03-02,96,0,24,103,127,33,52,85,212,11,58,OR - Heppner
20,1970-1971,1970-11-22,1971-03-13,112,1,9,127,136,15,14,29,165,11,38,OR - Heppner
21,1971-1972,1971-10-27,1972-04-12,169,0,33,195,228,36,37,73,301,18,112,OR - Heppner
22,1972-1973,1972-10-29,1973-02-28,123,1,66,204,270,26,58,84,354,11,95,OR - Heppner
23,1973-1974,1973-11-04,1974-02-28,117,0,44,135,179,31,73,104,283,13,83,OR - Heppner
24,1974-1975,1974-12-01,1975-04-06,127,0,11,134,145,25,53,78,223,12,49,OR - Heppner
25,1975-1976,1975-11-10,1976-03-31,143,1,15,151,166,22,15,37,203,14,43,OR - Heppner
26,1976-1977,1976-11-25,1977-03-17,113,0,32,167,199,8,20,28,227,5,21,OR - Heppner
27,1977-1978,1977-11-18,1978-03-04,107,0,29,122,151,45,69,114,265,14,100,OR - Heppner
28,1978-1979,1978-11-11,1979-02-28,110,0,78,295,373,45,163,208,581,15,103,OR - Heppner
29,1979-1980,1979-11-15,1980-03-05,112,1,43,158,201,28,40,68,269,10,66,OR - Heppner
30,1980-1981,1980-11-14,1981-02-28,107,0,13,97,110,14,9,23,133,7,27,OR - Heppner
31,1981-1982,1981-11-24,1982-02-28,97,7,8,111,119,24,30,54,173,16,59,OR - Heppner
33,1983-1984,1983-11-29,1984-02-29,93,5,47,166,213,28,63,91,304,14,97,OR - Heppner
35,1985-1986,1985-11-10,1986-02-28,111,3,66,238,304,32,195,227,531,12,75,OR - Heppner
36,1986-1987,1986-11-09,1987-02-28,112,0,14,156,170,22,55,77,247,11,45,OR - Heppner
37,1987-1988,1987-12-01,1988-02-29,91,8,24,132,156,17,29,46,202,8,40,OR - Heppner
38,1988-1989,1988-11-13,1989-03-04,112,20,28,169,197,12,59,71,268,5,17,OR - Heppner
39,1989-1990,1989-11-30,1990-02-28,91,10,8,91,99,6,6,12,111,3,9,OR - Heppner
40,1990-1991,1990-12-01,1991-03-26,116,19,36,189,225,27,61,88,313,16,76,OR - Heppner
41,1991-1992,1991-10-29,1992-02-29,124,18,2,83,85,9,1,10,95,3,15,OR - Heppner
42,1992-1993,1992-11-23,1993-03-04,102,13,44,229,273,62,172,234,507,27,169,OR - Heppner
43,1993-1994,1993-11-23,1994-03-23,121,5,20,145,165,12,23,35,200,6,28,OR - Heppner
44,1994-1995,1994-12-01,1995-02-28,90,13,15,104,119,23,33,56,175,5,43,OR - Heppner
45,1995-1996,1995-12-01,1996-03-05,96,16,32,137,169,27,40,67,236,16,79,OR - Heppner
46,1996-1997,1996-11-19,1997-04-04,137,8,13,141,154,16,21,37,191,9,43,OR - Heppner
47,1997-1998,1997-12-01,1998-02-28,90,12,9,80,89,12,13,25,114,5,34,OR - Heppner
48,1998-1999,1998-12-01,1999-02-28,90,19,15,84,99,6,14,20,119,3,11,OR - Heppner
49,1999-2000,1999-12-01,2000-02-29,91,14,12,77,89,5,4,9,98,3,9,OR - Heppner
50,2000-2001,2000-11-18,2001-04-11,145,11,20,152,172,15,10,25,197,10,33,OR - Heppner
52,2002-2003,2002-12-01,2003-02-28,90,11,3,68,71,3,0,3,74,2,3,OR - Heppner
54,2004-2005,2004-12-01,2005-02-28,90,5,12,94,106,14,17,31,137,8,31,OR - Heppner
55,2005-2006,2005-12-01,2006-02-28,90,2,22,114,136,6,4,10,146,4,21,OR - Heppner
56,2006-2007,2006-11-27,2007-03-01,95,2,30,140,170,12,21,33,203,7,31,OR - Heppner
58,2008-2009,2008-12-01,2009-04-15,136,5,37,191,228,64,134,198,426,18,154,OR - Heppner
59,2009-2010,2009-12-01,2010-02-28,90,2,24,115,139,7,9,16,155,4,20,OR - Heppner
61,2011-2012,2011-11-18,2012-03-22,126,0,6,156,162,15,7,22,184,8,25,OR - Heppner
62,2012-2013,2012-11-27,2013-02-28,94,0,20,108,128,3,2,5,133,2,7,OR - Heppner
63,2013-2014,2013-12-01,2014-03-02,92,0,39,152,191,20,35,55,246,6,56,OR - Heppner
64,2014-2015,2014-11-13,2015-02-28,108,1,25,130,155,19,46,65,220,5,33,OR - Heppner
65,2015-2016,2015-11-23,2016-02-29,99,4,29,110,139,4,21,25,164,1,7,OR - Heppner
66,2016-2017,2016-12-01,2017-02-28,90,0,59,204,263,43,120,163,426,14,102,OR - Heppner
67,2017-2018,2017-12-01,2018-02-28,90,0,22,120,142,19,25,44,186,6,43,OR - Heppner
68,2018-2019,2018-11-13,2019-03-14,122,5,34,187,221,52,121,173,394,16,102,OR - Heppner
69,2019-2020,2019-11-27,2020-03-16,111,0,11,125,136,19,32,51,187,7,41,OR - Heppner
0,1950-1951,1950-12-01,1951-03-30,120,0,0,57,57,11,2,13,70,6,17,OR - Medford
1,1951-1952,1951-12-01,1952-03-19,110,0,9,98,107,32,21,53,160,18,51,OR - Medford
2,1952-1953,1952-12-01,1953-04-07,128,0,0,63,63,10,0,10,73,4,13,OR - Medford
3,1953-1954,1953-12-01,1954-03-10,100,0,1,57,58,9,2,11,69,3,11,OR - Medford
4,1954-1955,1954-12-01,1955-03-14,104,0,0,100,100,11,1,12,112,9,21,OR - Medford
5,1955-1956,1955-11-13,1956-03-07,116,0,0,74,74,45,26,71,145,14,62,OR - Medford
6,1956-1957,1956-10-27,1957-02-28,125,0,13,119,132,12,1,13,145,9,21,OR - Medford
7,1957-1958,1957-12-01,1958-02-28,90,0,1,35,36,3,0,3,39,3,6,OR - Medford
8,1958-1959,1958-11-14,1959-02-28,107,0,0,51,51,3,0,3,54,3,4,OR - Medford
9,1959-1960,1959-12-01,1960-02-29,91,0,7,90,97,7,0,7,104,6,18,OR - Medford
10,1960-1961,1960-11-25,1961-04-21,148,0,1,82,83,8,0,8,91,2,9,OR - Medford
11,1961-1962,1961-11-24,1962-03-10,107,0,11,120,131,27,28,55,186,11,36,OR - Medford
12,1962-1963,1962-12-01,1963-04-15,136,0,2,142,144,4,2,6,150,3,12,OR - Medford
13,1963-1964,1963-12-01,1964-03-12,103,0,5,120,125,4,0,4,129,4,8,OR - Medford
14,1964-1965,1964-11-13,1965-02-28,108,0,2,72,74,30,30,60,134,13,40,OR - Medford
15,1965-1966,1965-12-01,1966-03-16,106,0,2,105,107,21,8,29,136,11,34,OR - Medford
16,1966-1967,1966-12-01,1967-04-17,138,0,1,63,64,11,2,13,77,6,17,OR - Medford
17,1967-1968,1967-12-01,1968-02-29,91,0,2,87,89,18,6,24,113,11,36,OR - Medford
18,1968-1969,1968-12-01,1969-02-28,90,0,2,57,59,31,20,51,110,20,53,OR - Medford
19,1969-1970,1969-12-01,1970-04-26,147,0,5,76,81,5,0,5,86,4,9,OR - Medford
20,1970-1971,1970-12-01,1971-03-16,106,0,1,77,78,28,7,35,113,11,41,OR - Medford
21,1971-1972,1971-12-01,1972-03-25,116,0,4,68,72,15,2,17,89,12,25,OR - Medford
22,1972-1973,1972-12-01,1973-02-28,90,0,15,106,121,21,45,66,187,9,51,OR - Medford
23,1973-1974,1973-12-01,1974-03-06,96,0,0,67,67,9,0,9,76,4,13,OR - Medford
24,1974-1975,1974-12-01,1975-04-14,135,0,5,69,74,22,11,33,107,11,35,OR - Medford
25,1975-1976,1975-11-28,1976-03-01,95,0,0,75,75,12,1,13,88,9,18,OR - Medford
26,1976-1977,1976-12-01,1977-02-28,90,0,11,127,138,3,0,3,141,2,6,OR - Medford
27,1977-1978,1977-11-20,1978-02-28,101,0,1,34,35,14,8,22,57,4,20,OR - Medford
28,1978-1979,1978-12-01,1979-02-28,90,0,5,102,107,1,1,2,109,1,2,OR - Medford
29,1979-1980,1979-12-01,1980-03-15,106,0,3,67,70,3,0,3,73,3,7,OR - Medford
30,1980-1981,1980-12-01,1981-02-28,90,0,4,57,61,3,0,3,64,3,10,OR - Medford
31,1981-1982,1981-12-01,1982-03-28,118,0,5,70,75,14,4,18,93,8,18,OR - Medford
32,1982-1983,1982-12-01,1983-02-28,90,0,2,56,58,0,0,0,58,0,0,OR - Medford
33,1983-1984,1983-12-01,1984-02-29,91,0,2,53,55,5,2,7,62,3,11,OR - Medford
34,1984-1985,1984-11-23,1985-03-27,125,0,0,105,105,13,0,13,118,12,21,OR - Medford
35,1985-1986,1985-11-18,1986-02-28,103,0,0,72,72,3,0,3,75,3,4,OR - Medford
36,1986-1987,1986-12-01,1987-02-28,90,0,0,70,70,0,0,0,70,0,0,OR - Medford
37,1987-1988,1987-12-01,1988-02-29,91,0,0,60,60,17,1,18,78,8,21,OR - Medford
38,1988-1989,1988-12-01,1989-03-02,92,0,1,91,92,18,4,22,114,12,32,OR - Medford
39,1989-1990,1989-12-01,1990-03-11,101,0,3,93,96,11,0,11,107,10,27,OR - Medford
40,1990-1991,1990-12-01,1991-03-10,100,0,5,120,125,8,2,10,135,7,19,OR - Medford
41,1991-1992,1991-12-01,1992-02-29,91,0,0,50,50,0,0,0,50,0,0,OR - Medford
42,1992-1993,1992-12-01,1993-02-28,90,0,0,61,61,9,1,10,71,6,14,OR - Medford
43,1993-1994,1993-11-22,1994-02-28,99,0,0,91,91,1,0,1,92,1,2,OR - Medford
44,1994-1995,1994-11-25,1995-02-28,96,0,0,41,41,5,1,6,47,4,10,OR - Medford
45,1995-1996,1995-12-01,1996-03-27,118,0,0,46,46,4,0,4,50,4,5,OR - Medford
46,1996-1997,1996-12-01,1997-02-28,90,0,0,54,54,0,0,0,54,0,0,OR - Medford
50,2000-2001,2000-11-14,2001-02-28,107,2,0,82,82,2,1,3,85,2,2,OR - Medford
51,2001-2002,2001-12-01,2002-03-17,107,20,0,57,57,2,0,2,59,2,4,OR - Medford
52,2002-2003,2002-12-01,2003-02-28,90,0,0,34,34,0,0,0,34,0,0,OR - Medford
53,2003-2004,2003-12-01,2004-02-29,91,0,0,27,27,6,3,9,36,4,9,OR - Medford
54,2004-2005,2004-11-30,2005-02-28,91,0,0,55,55,9,3,12,67,6,13,OR - Medford
55,2005-2006,2005-11-30,2006-03-10,101,0,2,55,57,7,0,7,64,4,10,OR - Medford
56,2006-2007,2006-11-28,2007-02-28,93,0,3,85,88,15,8,23,111,9,28,OR - Medford
57,2007-2008,2007-12-01,2008-02-29,91,0,0,72,72,16,4,20,92,8,27,OR - Medford
58,2008-2009,2008-12-01,2009-02-28,90,0,0,70,70,11,3,14,84,9,19,OR - Medford
59,2009-2010,2009-12-01,2010-02-28,90,0,3,44,47,1,0,1,48,1,2,OR - Medford
60,2010-2011,2010-11-23,2011-04-07,136,0,2,66,68,6,1,7,75,5,9,OR - Medford
61,2011-2012,2011-12-01,2012-03-01,92,0,1,94,95,6,0,6,101,4,9,OR - Medford
62,2012-2013,2012-12-01,2013-02-28,90,0,2,65,67,6,1,7,74,6,14,OR - Medford
63,2013-2014,2013-12-01,2014-02-28,90,0,9,90,99,5,8,13,112,2,12,OR - Medford
64,2014-2015,2014-12-01,2015-02-28,90,0,0,31,31,0,0,0,31,0,0,OR - Medford
65,2015-2016,2015-12-01,2016-02-29,91,0,0,22,22,5,0,5,27,4,5,OR - Medford
66,2016-2017,2016-12-01,2017-02-28,90,0,2,61,63,19,19,38,101,7,29,OR - Medford
67,2017-2018,2017-12-01,2018-02-28,90,0,0,61,61,6,0,6,67,3,9,OR - Medford
68,2018-2019,2018-12-01,2019-02-28,90,0,0,52,52,11,1,12,64,4,15,OR - Medford
69,2019-2020,2019-12-01,2020-02-29,91,0,0,42,42,1,0,1,43,1,2,OR - Medford
0,1950-1951,1950-11-11,1951-03-16,126,0,22,109,131,25,23,48,179,14,50,OR - Pendleton
1,1951-1952,1951-11-14,1952-03-19,127,0,39,158,197,43,57,100,297,27,124,OR - Pendleton
2,1952-1953,1952-11-24,1953-03-01,98,0,17,69,86,17,10,27,113,9,29,OR - Pendleton
3,1953-1954,1953-12-01,1954-03-17,107,0,21,87,108,14,27,41,149,8,35,OR - Pendleton
4,1954-1955,1954-12-01,1955-03-25,115,0,13,131,144,25,13,38,182,17,53,OR - Pendleton
5,1955-1956,1955-11-01,1956-03-06,127,0,70,222,292,60,120,180,472,38,192,OR - Pendleton
6,1956-1957,1956-11-24,1957-03-05,102,1,85,204,289,46,134,180,469,21,156,OR - Pendleton
7,1957-1958,1957-12-01,1958-03-17,107,0,7,57,64,6,9,15,79,3,11,OR - Pendleton
8,1958-1959,1958-11-15,1959-02-28,106,0,22,111,133,33,36,69,202,16,77,OR - Pendleton
9,1959-1960,1959-11-13,1960-03-08,117,0,51,210,261,31,111,142,403,19,103,OR - Pendleton
10,1960-1961,1960-11-29,1961-03-11,103,0,26,76,102,3,0,3,105,3,6,OR - Pendleton
11,1961-1962,1961-11-24,1962-03-02,99,0,40,125,165,40,74,114,279,15,85,OR - Pendleton
12,1962-1963,1962-12-01,1963-04-20,141,0,32,121,153,19,35,54,207,8,56,OR - Pendleton
13,1963-1964,1963-12-01,1964-03-21,112,0,14,77,91,5,10,15,106,5,11,OR - Pendleton
14,1964-1965,1964-11-13,1965-03-26,134,0,28,132,160,27,33,60,220,19,84,OR - Pendleton
15,1965-1966,1965-11-29,1966-03-20,112,0,11,71,82,25,10,35,117,15,39,OR - Pendleton
16,1966-1967,1966-11-08,1967-03-29,142,0,0,51,51,17,3,20,71,12,27,OR - Pendleton
17,1967-1968,1967-11-27,1968-02-29,95,0,12,99,111,8,10,18,129,7,24,OR - Pendleton
18,1968-1969,1968-12-01,1969-02-28,90,0,72,175,247,66,165,231,478,36,242,OR - Pendleton
19,1969-1970,1969-11-27,1970-03-03,97,0,29,94,123,25,48,73,196,12,55,OR - Pendleton
20,1970-1971,1970-11-22,1971-03-13,112,0,14,111,125,21,15,36,161,15,50,OR - Pendleton
21,1971-1972,1971-10-27,1972-04-12,169,0,42,142,184,39,56,95,279,21,114,OR - Pendleton
22,1972-1973,1972-12-01,1973-04-19,140,0,81,201,282,31,101,132,414,12,99,OR - Pendleton
23,1973-1974,1973-10-31,1974-02-28,121,0,48,101,149,31,39,70,219,14,55,OR - Pendleton
24,1974-1975,1974-12-01,1975-04-14,135,0,8,71,79,36,49,85,164,17,62,OR - Pendleton
25,1975-1976,1975-11-10,1976-03-11,123,0,15,91,106,16,11,27,133,13,34,OR - Pendleton
26,1976-1977,1976-12-01,1977-03-16,106,0,48,122,170,11,39,50,220,8,34,OR - Pendleton
27,1977-1978,1977-11-18,1978-03-06,109,0,43,122,165,44,86,130,295,16,104,OR - Pendleton
28,1978-1979,1978-11-11,1979-02-28,110,0,124,275,399,52,232,284,683,25,185,OR - Pendleton
29,1979-1980,1979-11-14,1980-03-07,115,0,60,160,220,39,61,100,320,17,103,OR - Pendleton
30,1980-1981,1980-11-14,1981-02-28,107,0,18,89,107,15,10,25,132,8,31,OR - Pendleton
31,1981-1982,1981-11-27,1982-03-19,113,0,15,114,129,27,17,44,173,18,61,OR - Pendleton
32,1982-1983,1982-11-22,1983-02-28,99,0,20,59,79,4,1,5,84,4,11,OR - Pendleton
33,1983-1984,1983-12-01,1984-02-29,91,0,57,155,212,40,92,132,344,17,117,OR - Pendleton
34,1984-1985,1984-12-01,1985-03-28,118,0,57,170,227,30,70,100,327,15,89,OR - Pendleton
35,1985-1986,1985-11-10,1986-02-28,111,0,112,246,358,46,251,297,655,22,161,OR - Pendleton
36,1986-1987,1986-11-09,1987-02-28,112,0,29,129,158,24,35,59,217,12,56,OR - Pendleton
37,1987-1988,1987-11-30,1988-03-29,121,0,34,133,167,23,30,53,220,13,57,OR - Pendleton
38,1988-1989,1988-12-01,1989-03-16,106,0,48,164,212,21,28,49,261,12,71,OR - Pendleton
39,1989-1990,1989-11-29,1990-03-23,115,0,20,90,110,7,7,14,124,5,16,OR - Pendleton
40,1990-1991,1990-12-01,1991-03-26,116,1,51,178,229,14,49,63,292,10,66,OR - Pendleton
41,1991-1992,1991-10-28,1992-02-29,125,0,8,76,84,8,3,11,95,7,17,OR - Pendleton
42,1992-1993,1992-11-25,1993-03-06,102,0,78,229,307,71,189,260,567,30,204,OR - Pendleton
43,1993-1994,1993-11-22,1994-03-23,122,0,30,123,153,27,28,55,208,6,46,OR - Pendleton
44,1994-1995,1994-11-17,1995-02-28,104,0,28,103,131,21,27,48,179,10,49,OR - Pendleton
48,1998-1999,1998-12-01,1999-02-28,90,0,15,68,83,5,1,6,89,3,11,OR - Pendleton
49,1999-2000,1999-12-01,2000-03-06,97,0,15,63,78,18,6,24,102,10,33,OR - Pendleton
50,2000-2001,2000-11-20,2001-02-28,101,0,36,111,147,17,6,23,170,14,40,OR - Pendleton
51,2001-2002,2001-12-01,2002-03-07,97,0,6,92,98,10,3,13,111,7,22,OR - Pendleton
52,2002-2003,2002-10-30,2003-02-28,122,0,8,80,88,5,0,5,93,4,11,OR - Pendleton
53,2003-2004,2003-11-22,2004-02-29,100,2,31,118,149,37,115,152,301,16,109,OR - Pendleton
54,2004-2005,2004-11-30,2005-02-28,91,0,10,99,109,9,5,14,123,7,21,OR - Pendleton
55,2005-2006,2005-11-22,2006-02-28,99,0,23,125,148,7,2,9,157,7,29,OR - Pendleton
56,2006-2007,2006-11-27,2007-03-01,95,0,39,128,167,10,1,11,178,8,45,OR - Pendleton
57,2007-2008,2007-11-19,2008-03-30,133,0,22,147,169,54,60,114,283,21,90,OR - Pendleton
58,2008-2009,2008-12-01,2009-04-01,122,0,46,171,217,63,98,161,378,22,166,OR - Pendleton
59,2009-2010,2009-12-01,2010-02-28,90,0,24,109,133,9,15,24,157,4,22,OR - Pendleton
60,2010-2011,2010-11-21,2011-03-01,101,0,36,160,196,35,52,87,283,15,84,OR - Pendleton
61,2011-2012,2011-11-19,2012-03-22,125,0,14,164,178,16,6,22,200,11,34,OR - Pendleton
62,2012-2013,2012-11-27,2013-03-22,116,0,22,106,128,7,1,8,136,7,15,OR - Pendleton
63,2013-2014,2013-12-01,2014-03-02,92,0,48,155,203,32,45,77,280,13,105,OR - Pendleton
64,2014-2015,2014-11-12,2015-02-28,109,0,33,129,162,9,32,41,203,4,22,OR - Pendleton
65,2015-2016,2015-11-22,2016-02-29,100,0,31,101,132,8,17,25,157,7,26,OR - Pendleton
66,2016-2017,2016-12-01,2017-03-05,95,0,69,215,284,64,130,194,478,30,195,OR - Pendleton
67,2017-2018,2017-12-01,2018-03-01,91,0,24,98,122,24,36,60,182,13,71,OR - Pendleton
68,2018-2019,2018-11-12,2019-03-13,122,0,44,173,217,53,128,181,398,20,123,OR - Pendleton
69,2019-2020,2019-11-28,2020-03-16,110,0,8,96,104,20,17,37,141,8,39,OR - Pendleton
0,1950-1951,1950-12-01,1951-03-10,100,0,3,27,30,19,10,29,59,9,25,OR - Portland
1,1951-1952,1951-12-01,1952-02-29,91,0,6,53,59,17,18,35,94,10,30,OR - Portland
2,1952-1953,1952-12-01,1953-02-28,90,0,0,16,16,0,0,0,16,0,0,OR - Portland
3,1953-1954,1953-12-01,1954-02-28,90,0,2,25,27,16,11,27,54,8,23,OR - Portland
4,1954-1955,1954-12-01,1955-03-14,104,0,0,41,41,8,1,9,50,7,12,OR - Portland
5,1955-1956,1955-11-11,1956-03-05,116,0,13,68,81,33,32,65,146,11,57,OR - Portland
6,1956-1957,1956-12-01,1957-02-28,90,0,15,82,97,14,9,23,120,10,37,OR - Portland
7,1957-1958,1957-12-01,1958-02-28,90,0,0,10,10,0,0,0,10,0,0,OR - Portland
8,1958-1959,1958-12-01,1959-02-28,90,0,3,23,26,4,3,7,33,2,7,OR - Portland
9,1959-1960,1959-12-01,1960-03-05,96,0,4,58,62,19,27,46,108,7,31,OR - Portland
10,1960-1961,1960-12-01,1961-02-28,90,0,0,25,25,0,0,0,25,0,0,OR - Portland
11,1961-1962,1961-12-01,1962-03-02,92,0,2,52,54,9,3,12,66,6,15,OR - Portland
12,1962-1963,1962-12-01,1963-02-28,90,0,6,48,54,7,3,10,64,3,15,OR - Portland
13,1963-1964,1963-12-01,1964-02-29,91,0,0,49,49,0,0,0,49,0,0,OR - Portland
14,1964-1965,1964-12-01,1965-03-25,115,0,8,52,60,17,16,33,93,4,29,OR - Portland
15,1965-1966,1965-12-01,1966-03-03,93,0,0,41,41,2,0,2,43,2,2,OR - Portland
16,1966-1967,1966-12-01,1967-02-28,90,0,0,13,13,0,0,0,13,0,0,OR - Portland
17,1967-1968,1967-12-01,1968-02-29,91,0,2,37,39,14,9,23,62,4,18,OR - Portland
18,1968-1969,1968-12-01,1969-02-28,90,0,21,70,91,49,81,130,221,17,99,OR - Portland
19,1969-1970,1969-12-01,1970-02-28,90,0,0,23,23,0,0,0,23,0,0,OR - Portland
20,1970-1971,1970-12-01,1971-02-28,90,0,1,34,35,15,8,23,58,8,22,OR - Portland
21,1971-1972,1971-12-01,1972-02-29,91,0,2,43,45,7,4,11,56,4,14,OR - Portland
22,1972-1973,1972-12-01,1973-02-28,90,0,14,62,76,8,23,31,107,4,22,OR - Portland
23,1973-1974,1973-12-01,1974-02-28,90,0,7,43,50,0,0,0,50,0,0,OR - Portland
24,1974-1975,1974-12-01,1975-02-28,90,0,0,27,27,1,0,1,28,1,2,OR - Portland
25,1975-1976,1975-12-01,1976-02-29,91,0,0,30,30,0,0,0,30,0,0,OR - Portland
26,1976-1977,1976-12-01,1977-02-28,90,0,2,52,54,0,0,0,54,0,0,OR - Portland
27,1977-1978,1977-11-18,1978-03-03,106,0,0,31,31,13,8,21,52,4,16,OR - Portland
28,1978-1979,1978-11-19,1979-02-28,102,0,18,97,115,14,11,25,140,8,27,OR - Portland
29,1979-1980,1979-12-01,1980-02-29,91,0,8,46,54,17,20,37,91,5,26,OR - Portland
30,1980-1981,1980-12-01,1981-02-28,90,0,0,24,24,0,0,0,24,0,0,OR - Portland
31,1981-1982,1981-12-01,1982-02-28,90,0,3,31,34,8,4,12,46,4,13,OR - Portland
32,1982-1983,1982-12-01,1983-02-28,90,0,0,23,23,0,0,0,23,0,0,OR - Portland
33,1983-1984,1983-12-01,1984-02-29,91,0,10,44,54,7,0,7,61,6,17,OR - Portland
34,1984-1985,1984-12-01,1985-02-28,90,0,2,56,58,12,3,15,73,6,22,OR - Portland
35,1985-1986,1985-11-17,1986-02-28,104,0,10,75,85,17,6,23,108,10,33,OR - Portland
36,1986-1987,1986-12-01,1987-02-28,90,0,0,32,32,1,0,1,33,1,1,OR - Portland
37,1987-1988,1987-12-01,1988-02-29,91,0,0,41,41,7,1,8,49,5,11,OR - Portland
38,1988-1989,1988-12-01,1989-03-03,93,0,7,51,58,5,2,7,65,4,10,OR - Portland
39,1989-1990,1989-12-01,1990-02-28,90,0,0,32,32,14,4,18,50,6,18,OR - Portland
40,1990-1991,1990-12-01,1991-02-28,90,0,13,66,79,5,0,5,84,5,18,OR - Portland
41,1991-1992,1991-12-01,1992-02-29,91,0,0,16,16,0,0,0,16,0,0,OR - Portland
42,1992-1993,1992-12-01,1993-02-28,90,0,2,50,52,23,14,37,89,10,32,OR - Portland
43,1993-1994,1993-12-01,1994-02-28,90,0,0,30,30,4,1,5,35,2,5,OR - Portland
44,1994-1995,1994-11-17,1995-02-28,104,0,1,27,28,8,6,14,42,5,12,OR - Portland
45,1995-1996,1995-12-01,1996-02-29,91,2,8,33,41,13,17,30,71,4,21,OR - Portland
46,1996-1997,1996-12-01,1997-02-28,90,0,0,29,29,0,0,0,29,0,0,OR - Portland
47,1997-1998,1997-12-01,1998-02-28,90,0,2,15,17,12,18,30,47,3,18,OR - Portland
48,1998-1999,1998-12-01,1999-02-28,90,0,5,27,32,3,0,3,35,1,5,OR - Portland
49,1999-2000,1999-12-01,2000-02-29,91,0,0,22,22,2,0,2,24,1,3,OR - Portland
50,2000-2001,2000-12-01,2001-02-28,90,0,0,26,26,1,0,1,27,1,2,OR - Portland
51,2001-2002,2001-12-01,2002-02-28,90,0,0,18,18,2,0,2,20,2,3,OR - Portland
52,2002-2003,2002-12-01,2003-02-28,90,0,0,19,19,0,0,0,19,0,0,OR - Portland
53,2003-2004,2003-11-19,2004-02-29,103,0,5,23,28,17,30,47,75,6,27,OR - Portland
54,2004-2005,2004-12-01,2005-02-28,90,0,1,28,29,0,0,0,29,0,0,OR - Portland
55,2005-2006,2005-12-01,2006-03-10,100,0,0,26,26,4,0,4,30,3,5,OR - Portland
56,2006-2007,2006-12-01,2007-02-28,90,0,2,38,40,5,4,9,49,2,8,OR - Portland
57,2007-2008,2007-12-01,2008-02-29,91,0,0,23,23,0,0,0,23,0,0,OR - Portland
58,2008-2009,2008-12-01,2009-03-08,98,0,7,54,61,36,46,82,143,14,55,OR - Portland
59,2009-2010,2009-12-01,2010-02-28,90,0,3,37,40,3,2,5,45,1,4,OR - Portland
60,2010-2011,2010-11-22,2011-02-28,99,0,2,33,35,3,0,3,38,2,5,OR - Portland
61,2011-2012,2011-12-01,2012-03-21,112,0,0,37,37,6,1,7,44,4,10,OR - Portland
62,2012-2013,2012-12-01,2013-02-28,90,0,0,21,21,0,0,0,21,0,0,OR - Portland
63,2013-2014,2013-12-01,2014-02-28,90,0,10,53,63,10,17,27,90,4,23,OR - Portland
64,2014-2015,2014-12-01,2015-02-28,90,0,0,15,15,0,0,0,15,0,0,OR - Portland
65,2015-2016,2015-12-01,2016-02-29,91,0,1,11,12,3,1,4,16,2,5,OR - Portland
66,2016-2017,2016-12-01,2017-02-28,90,0,6,65,71,16,38,54,125,5,24,OR - Portland
67,2017-2018,2017-12-01,2018-02-28,90,0,0,28,28,12,8,20,48,5,18,OR - Portland
68,2018-2019,2018-12-01,2019-03-06,96,0,0,33,33,11,9,20,53,6,17,OR - Portland
69,2019-2020,2019-12-01,2020-03-14,105,0,0,21,21,1,0,1,22,1,2,OR - Portland
0,1950-1951,1950-11-26,1951-03-22,117,0,33,209,242,33,30,63,305,18,74,PA - Allentown
1,1951-1952,1951-11-19,1952-03-16,119,0,22,213,235,33,70,103,338,17,83,PA - Allentown
2,1952-1953,1952-11-30,1953-03-09,100,0,13,145,158,26,29,55,213,13,57,PA - Allentown
3,1953-1954,1953-11-06,1954-03-05,120,0,28,200,228,31,75,106,334,11,65,PA - Allentown
4,1954-1955,1954-12-01,1955-03-26,116,0,30,220,250,23,24,47,297,13,54,PA - Allentown
5,1955-1956,1955-11-19,1956-04-08,142,0,37,272,309,54,54,108,417,26,123,PA - Allentown
6,1956-1957,1956-11-23,1957-04-05,134,0,23,224,247,33,29,62,309,17,82,PA - Allentown
7,1957-1958,1957-12-01,1958-03-23,113,0,41,213,254,87,137,224,478,16,115,PA - Allentown
8,1958-1959,1958-11-28,1959-04-13,137,0,42,304,346,36,38,74,420,20,91,PA - Allentown
9,1959-1960,1959-11-18,1960-03-26,130,0,24,224,248,57,104,161,409,21,115,PA - Allentown
10,1960-1961,1960-12-01,1961-04-13,134,0,68,339,407,93,263,356,763,28,199,PA - Allentown
11,1961-1962,1961-11-20,1962-03-10,111,0,40,262,302,53,105,158,460,21,115,PA - Allentown
12,1962-1963,1962-10-26,1963-04-23,180,0,65,377,442,68,201,269,711,26,146,PA - Allentown
13,1963-1964,1963-12-01,1964-03-22,113,0,41,277,318,76,188,264,582,22,145,PA - Allentown
14,1964-1965,1964-11-22,1965-04-02,132,0,43,269,312,35,71,106,418,18,92,PA - Allentown
15,1965-1966,1965-12-01,1966-03-06,96,0,35,207,242,54,125,179,421,15,116,PA - Allentown
16,1966-1967,1966-12-01,1967-04-27,148,0,39,286,325,102,188,290,615,34,184,PA - Allentown
17,1967-1968,1967-11-17,1968-03-12,117,0,57,313,370,30,106,136,506,16,99,PA - Allentown
18,1968-1969,1968-11-10,1969-03-07,118,0,29,213,242,44,39,83,325,15,76,PA - Allentown
19,1969-1970,1969-12-01,1970-04-01,122,0,76,309,385,72,229,301,686,28,182,PA - Allentown
20,1970-1971,1970-12-01,1971-04-06,127,0,63,262,325,43,64,107,432,19,98,PA - Allentown
21,1971-1972,1971-11-24,1972-04-07,136,0,26,234,260,46,78,124,384,23,93,PA - Allentown
22,1972-1973,1972-10-18,1973-03-18,152,0,23,205,228,16,9,25,253,12,41,PA - Allentown
23,1973-1974,1973-12-01,1974-04-10,131,0,33,188,221,32,72,104,325,14,72,PA - Allentown
24,1974-1975,1974-11-26,1975-03-15,110,0,19,169,188,33,64,97,285,14,68,PA - Allentown
25,1975-1976,1975-12-01,1976-03-17,108,0,40,212,252,30,40,70,322,14,74,PA - Allentown
26,1976-1977,1976-11-29,1977-03-23,115,0,74,297,371,43,196,239,610,22,118,PA - Allentown
27,1977-1978,1977-11-27,1978-04-03,128,0,76,286,362,79,340,419,781,22,138,PA - Allentown
28,1978-1979,1978-11-27,1979-02-28,94,0,68,237,305,54,125,179,484,20,139,PA - Allentown
29,1979-1980,1979-12-01,1980-04-01,123,0,32,199,231,35,49,84,315,15,77,PA - Allentown
30,1980-1981,1980-11-17,1981-03-20,124,0,56,271,327,42,89,131,458,20,103,PA - Allentown
31,1981-1982,1981-12-01,1982-04-10,131,0,68,283,351,62,164,226,577,22,126,PA - Allentown
32,1982-1983,1982-12-01,1983-04-20,141,0,22,167,189,67,127,194,383,13,89,PA - Allentown
33,1983-1984,1983-12-01,1984-03-31,122,0,59,259,318,51,106,157,475,24,135,PA - Allentown
34,1984-1985,1984-12-01,1985-03-04,94,0,38,176,214,40,72,112,326,19,92,PA - Allentown
35,1985-1986,1985-12-01,1986-04-23,144,0,42,244,286,42,75,117,403,22,108,PA - Allentown
36,1986-1987,1986-11-11,1987-03-03,113,0,19,210,229,51,133,184,413,16,77,PA - Allentown
37,1987-1988,1987-11-10,1988-03-20,132,0,43,262,305,57,111,168,473,16,102,PA - Allentown
38,1988-1989,1988-12-01,1989-03-20,110,0,24,200,224,17,25,42,266,8,35,PA - Allentown
39,1989-1990,1989-11-22,1990-04-07,137,0,34,236,270,38,42,80,350,21,106,PA - Allentown
40,1990-1991,1990-12-01,1991-03-30,120,0,15,168,183,26,29,55,238,13,55,PA - Allentown
41,1991-1992,1991-12-01,1992-03-25,116,0,16,178,194,23,26,49,243,11,52,PA - Allentown
42,1992-1993,1992-12-01,1993-03-23,113,0,21,212,233,53,110,163,396,18,90,PA - Allentown
43,1993-1994,1993-12-01,1994-03-29,119,0,75,304,379,107,471,578,957,31,236,PA - Allentown
44,1994-1995,1994-11-23,1995-03-09,107,0,19,175,194,24,52,76,270,11,48,PA - Allentown
46,1996-1997,1996-11-27,1997-04-01,126,1,28,206,234,37,24,61,295,18,69,PA - Allentown
50,2000-2001,2000-12-01,2001-03-09,99,16,36,251,287,70,278,348,635,17,122,PA - Allentown
51,2001-2002,2001-12-01,2002-03-22,112,0,7,162,169,15,25,40,209,4,24,PA - Allentown
52,2002-2003,2002-11-27,2003-04-09,134,0,52,296,348,84,269,353,701,21,153,PA - Allentown
53,2003-2004,2003-12-01,2004-03-20,111,0,48,245,293,57,136,193,486,18,127,PA - Allentown
54,2004-2005,2004-12-01,2005-03-24,114,0,48,252,300,61,136,197,497,22,143,PA - Allentown
55,2005-2006,2005-11-24,2006-04-08,136,0,17,204,221,49,77,126,347,13,74,PA - Allentown
56,2006-2007,2006-12-01,2007-03-21,111,0,40,215,255,36,69,105,360,13,74,PA - Allentown
57,2007-2008,2007-11-18,2008-03-01,105,0,16,172,188,30,28,58,246,14,62,PA - Allentown
58,2008-2009,2008-11-22,2009-03-04,103,0,41,249,290,33,73,106,396,17,84,PA - Allentown
59,2009-2010,2009-12-01,2010-03-01,91,0,27,187,214,83,174,257,471,21,128,PA - Allentown
60,2010-2011,2010-11-25,2011-03-24,120,3,38,263,301,56,183,239,540,25,134,PA - Allentown
61,2011-2012,2011-10-29,2012-02-29,124,0,7,147,154,16,15,31,185,4,23,PA - Allentown
62,2012-2013,2012-11-27,2013-03-25,119,0,21,170,191,33,28,61,252,16,72,PA - Allentown
63,2013-2014,2013-11-24,2014-04-15,143,0,65,348,413,94,293,387,800,25,184,PA - Allentown
64,2014-2015,2014-11-13,2015-03-31,139,0,52,331,383,73,228,301,684,26,160,PA - Allentown
65,2015-2016,2015-12-01,2016-03-04,95,0,15,148,163,57,92,149,312,9,78,PA - Allentown
66,2016-2017,2016-12-01,2017-03-21,111,0,14,165,179,44,67,111,290,12,74,PA - Allentown
67,2017-2018,2017-12-01,2018-04-02,123,0,39,217,256,67,59,126,382,19,118,PA - Allentown
68,2018-2019,2018-11-15,2019-03-09,115,0,19,179,198,46,61,107,305,17,76,PA - Allentown
69,2019-2020,2019-12-01,2020-02-29,91,0,5,107,112,8,4,12,124,6,19,PA - Allentown
0,1950-1951,1950-11-21,1951-04-04,135,1,76,400,476,119,433,552,1028,41,296,PA - Bradford
1,1951-1952,1951-11-01,1952-05-12,194,0,63,465,528,152,570,722,1250,59,364,PA - Bradford
2,1952-1953,1952-10-20,1953-04-21,184,1,44,354,398,122,272,394,792,48,277,PA - Bradford
3,1953-1954,1953-11-05,1954-04-05,152,0,59,402,461,118,435,553,1014,52,336,PA - Bradford
4,1954-1955,1954-10-31,1955-04-07,159,0,80,464,544,134,594,728,1272,63,388,PA - Bradford
5,1955-1956,1955-10-25,1956-04-23,182,0,75,539,614,181,582,763,1377,64,420,PA - Bradford
6,1956-1957,1956-11-13,1957-05-04,173,19,68,435,503,136,506,642,1145,49,331,PA - Bradford
11,1961-1962,1961-11-08,1962-04-03,147,1,88,475,563,105,251,356,919,44,277,PA - Bradford
12,1962-1963,1962-10-24,1963-05-01,190,0,123,624,747,170,825,995,1742,61,513,PA - Bradford
13,1963-1964,1963-11-02,1964-03-31,151,18,84,436,520,170,611,781,1301,49,368,PA - Bradford
14,1964-1965,1964-11-21,1965-04-18,149,0,92,431,523,107,277,384,907,39,280,PA - Bradford
15,1965-1966,1965-10-28,1966-05-09,194,1,75,424,499,139,357,496,995,42,294,PA - Bradford
16,1966-1967,1966-11-06,1967-04-24,170,1,81,411,492,148,417,565,1057,51,363,PA - Bradford
17,1967-1968,1967-11-05,1968-03-24,141,0,103,465,568,135,442,577,1145,50,361,PA - Bradford
18,1968-1969,1968-11-12,1969-03-31,140,0,92,408,500,146,330,476,976,48,359,PA - Bradford
19,1969-1970,1969-11-14,1970-03-30,137,1,126,494,620,202,754,956,1576,63,524,PA - Bradford
20,1970-1971,1970-11-16,1971-04-24,160,0,101,431,532,216,682,898,1430,54,444,PA - Bradford
21,1971-1972,1971-11-08,1972-04-08,153,0,70,436,506,172,498,670,1176,46,345,PA - Bradford
22,1972-1973,1972-11-15,1973-04-11,148,0,65,345,410,120,215,335,745,33,244,PA - Bradford
23,1973-1974,1973-11-06,1974-04-09,155,3,77,371,448,132,265,397,845,36,280,PA - Bradford
24,1974-1975,1974-11-21,1975-04-08,139,0,52,383,435,162,376,538,973,56,351,PA - Bradford
25,1975-1976,1975-11-15,1976-05-04,172,3,85,451,536,164,529,693,1229,54,427,PA - Bradford
27,1977-1978,1977-11-11,1978-04-20,161,8,142,559,701,257,805,1062,1763,76,677,PA - Bradford
28,1978-1979,1978-11-20,1979-04-10,142,9,123,496,619,196,648,844,1463,63,517,PA - Bradford
29,1979-1980,1979-10-26,1980-04-16,174,0,103,443,546,76,324,400,946,43,267,PA - Bradford
30,1980-1981,1980-10-26,1981-04-06,163,5,144,536,680,110,524,634,1314,52,380,PA - Bradford
31,1981-1982,1981-10-24,1982-04-08,167,7,151,535,686,120,653,773,1459,61,450,PA - Bradford
32,1982-1983,1982-11-13,1983-04-19,158,6,75,380,455,79,187,266,721,35,219,PA - Bradford
33,1983-1984,1983-11-03,1984-04-06,156,8,135,581,716,117,480,597,1313,46,359,PA - Bradford
34,1984-1985,1984-11-12,1985-04-09,149,3,84,425,509,116,413,529,1038,40,301,PA - Bradford
35,1985-1986,1985-12-01,1986-04-11,132,7,93,458,551,96,464,560,1111,34,291,PA - Bradford
36,1986-1987,1986-11-10,1987-04-04,146,6,75,403,478,73,408,481,959,29,152,PA - Bradford
37,1987-1988,1987-11-05,1988-04-15,163,4,102,459,561,97,413,510,1071,44,293,PA - Bradford
38,1988-1989,1988-10-11,1989-05-07,209,10,94,446,540,76,189,265,805,39,244,PA - Bradford
39,1989-1990,1989-11-02,1990-04-17,167,9,112,441,553,124,351,475,1028,45,316,PA - Bradford
40,1990-1991,1990-11-12,1991-03-11,120,4,67,306,373,67,205,272,645,30,200,PA - Bradford
41,1991-1992,1991-11-05,1992-04-04,152,14,74,444,518,92,364,456,974,28,219,PA - Bradford
42,1992-1993,1992-10-19,1993-04-03,167,12,105,483,588,173,580,753,1341,35,319,PA - Bradford
43,1993-1994,1993-10-30,1994-04-02,155,4,151,538,689,132,725,857,1546,39,365,PA - Bradford
44,1994-1995,1994-11-23,1995-03-10,108,6,87,351,438,53,235,288,726,18,145,PA - Bradford
45,1995-1996,1995-11-04,1996-03-26,144,12,160,524,684,137,466,603,1287,42,371,PA - Bradford
46,1996-1997,1996-11-02,1997-04-09,159,4,86,400,486,108,226,334,820,35,260,PA - Bradford
47,1997-1998,1997-11-12,1998-03-24,133,3,52,282,334,92,272,364,698,28,172,PA - Bradford
48,1998-1999,1998-12-01,1999-03-26,116,3,75,382,457,98,353,451,908,32,263,PA - Bradford
49,1999-2000,1999-11-03,2000-03-17,136,9,86,388,474,76,281,357,831,29,214,PA - Bradford
50,2000-2001,2000-11-14,2001-04-04,142,20,116,462,578,124,521,645,1223,42,317,PA - Bradford
51,2001-2002,2001-10-26,2002-04-06,163,1,52,317,369,84,188,272,641,35,214,PA - Bradford
52,2002-2003,2002-11-01,2003-04-09,160,4,134,523,657,122,640,762,1419,45,344,PA - Bradford
53,2003-2004,2003-11-09,2004-04-06,150,5,111,464,575,143,610,753,1328,48,345,PA - Bradford
54,2004-2005,2004-11-09,2005-04-25,168,4,93,474,567,131,474,605,1172,45,311,PA - Bradford
55,2005-2006,2005-11-18,2006-04-05,139,4,86,363,449,111,305,416,865,36,261,PA - Bradford
56,2006-2007,2006-11-03,2007-04-17,166,5,114,428,542,128,399,527,1069,43,337,PA - Bradford
57,2007-2008,2007-11-07,2008-03-23,138,1,78,380,458,133,349,482,940,39,289,PA - Bradford
58,2008-2009,2008-10-29,2009-04-08,162,1,115,534,649,139,469,608,1257,47,371,PA - Bradford
59,2009-2010,2009-10-16,2010-03-11,147,2,86,396,482,85,354,439,921,38,244,PA - Bradford
60,2010-2011,2010-11-27,2011-04-07,132,0,111,478,589,166,622,788,1377,51,404,PA - Bradford
61,2011-2012,2011-10-28,2012-04-25,181,0,39,334,373,81,127,208,581,32,179,PA - Bradford
62,2012-2013,2012-11-14,2013-05-13,181,0,85,387,472,110,389,499,971,49,313,PA - Bradford
63,2013-2014,2013-10-24,2014-04-16,175,0,170,635,805,122,348,470,1275,52,425,PA - Bradford
64,2014-2015,2014-11-14,2015-04-24,162,0,147,611,758,125,614,739,1497,50,393,PA - Bradford
65,2015-2016,2015-10-18,2016-04-10,176,0,63,354,417,84,173,257,674,35,270,PA - Bradford
66,2016-2017,2016-11-20,2017-03-23,124,0,68,306,374,131,270,401,775,42,322,PA - Bradford
67,2017-2018,2017-11-10,2018-04-19,161,0,113,490,603,144,354,498,1101,47,377,PA - Bradford
68,2018-2019,2018-10-21,2019-04-11,173,0,103,450,553,95,270,365,918,37,253,PA - Bradford
69,2019-2020,2019-11-08,2020-05-09,184,0,48,350,398,108,296,404,802,41,218,PA - Bradford
14,1964-1965,1964-11-21,1965-04-03,134,2,73,415,488,158,321,479,967,42,360,PA - Ebensburg
15,1965-1966,1965-10-29,1966-04-13,167,1,65,368,433,218,462,680,1113,57,451,PA - Ebensburg
16,1966-1967,1966-11-29,1967-04-27,150,0,55,365,420,200,438,638,1058,51,408,PA - Ebensburg
17,1967-1968,1967-11-05,1968-03-25,142,1,68,433,501,154,461,615,1116,50,376,PA - Ebensburg
18,1968-1969,1968-10-27,1969-03-31,156,1,68,414,482,169,402,571,1053,57,400,PA - Ebensburg
20,1970-1971,1970-11-24,1971-04-14,142,0,72,400,472,250,597,847,1319,59,510,PA - Ebensburg
21,1971-1972,1971-11-07,1972-04-10,156,1,46,384,430,205,468,673,1103,46,370,PA - Ebensburg
22,1972-1973,1972-10-19,1973-05-05,199,0,27,344,371,127,190,317,688,41,252,PA - Ebensburg
23,1973-1974,1973-11-06,1974-04-11,157,3,39,285,324,114,187,301,625,47,263,PA - Ebensburg
24,1974-1975,1974-10-20,1975-04-21,184,2,26,362,388,225,460,685,1073,61,397,PA - Ebensburg
26,1976-1977,1976-11-08,1977-04-06,150,0,111,504,615,194,747,941,1556,73,614,PA - Ebensburg
27,1977-1978,1977-10-17,1978-04-22,188,2,105,513,618,270,905,1175,1793,77,662,PA - Ebensburg
28,1978-1979,1978-11-26,1979-04-10,136,0,84,399,483,167,499,666,1149,45,381,PA - Ebensburg
29,1979-1980,1979-11-14,1980-04-16,155,2,60,370,430,113,252,365,795,43,324,PA - Ebensburg
30,1980-1981,1980-11-11,1981-03-23,133,0,76,399,475,186,422,608,1083,53,443,PA - Ebensburg
31,1981-1982,1981-11-07,1982-04-11,156,12,73,404,477,210,532,742,1219,57,465,PA - Ebensburg
32,1982-1983,1982-12-01,1983-04-20,141,1,25,259,284,78,202,280,564,23,155,PA - Ebensburg
33,1983-1984,1983-11-05,1984-04-19,167,2,76,407,483,170,388,558,1041,51,374,PA - Ebensburg
34,1984-1985,1984-11-13,1985-04-10,149,2,60,366,426,172,408,580,1006,46,389,PA - Ebensburg
35,1985-1986,1985-12-01,1986-04-17,138,0,62,358,420,149,316,465,885,51,364,PA - Ebensburg
36,1986-1987,1986-11-11,1987-04-06,147,2,27,359,386,121,259,380,766,31,202,PA - Ebensburg
37,1987-1988,1987-11-10,1988-04-29,172,0,52,387,439,134,215,349,788,53,334,PA - Ebensburg
38,1988-1989,1988-11-07,1989-04-13,158,2,37,338,375,85,114,199,574,31,196,PA - Ebensburg
39,1989-1990,1989-11-17,1990-04-18,153,0,62,374,436,117,182,299,735,49,309,PA - Ebensburg
40,1990-1991,1990-11-12,1991-04-22,162,3,25,284,309,101,130,231,540,34,199,PA - Ebensburg
41,1991-1992,1991-11-12,1992-04-03,144,2,33,318,351,111,218,329,680,41,265,PA - Ebensburg
42,1992-1993,1992-10-19,1993-04-22,186,1,38,361,399,203,464,667,1066,45,334,PA - Ebensburg
43,1993-1994,1993-09-30,1994-03-30,182,4,80,429,509,191,650,841,1350,48,404,PA - Ebensburg
44,1994-1995,1994-11-24,1995-04-05,133,3,42,310,352,57,152,209,561,19,135,PA - Ebensburg
45,1995-1996,1995-11-09,1996-04-17,161,2,82,434,516,223,497,720,1236,54,454,PA - Ebensburg
46,1996-1997,1996-11-03,1997-04-18,167,1,42,400,442,107,176,283,725,40,255,PA - Ebensburg
47,1997-1998,1997-11-12,1998-03-23,132,1,15,274,289,87,129,216,505,26,152,PA - Ebensburg
48,1998-1999,1998-12-01,1999-03-23,113,3,32,306,338,95,195,290,628,26,188,PA - Ebensburg
49,1999-2000,1999-11-03,2000-04-10,160,6,40,336,376,50,133,183,559,21,146,PA - Ebensburg
50,2000-2001,2000-11-18,2001-03-27,130,7,65,347,412,92,289,381,793,31,223,PA - Ebensburg
51,2001-2002,2001-10-27,2002-04-06,162,6,27,251,278,36,52,88,366,15,95,PA - Ebensburg
53,2003-2004,2003-11-14,2004-04-05,144,7,66,370,436,176,424,600,1036,51,374,PA - Ebensburg
54,2004-2005,2004-12-01,2005-04-25,146,4,52,338,390,115,237,352,742,35,249,PA - Ebensburg
55,2005-2006,2005-10-26,2006-04-05,162,7,53,299,352,103,229,332,684,33,213,PA - Ebensburg
56,2006-2007,2006-10-24,2007-04-17,176,6,77,355,432,147,315,462,894,40,353,PA - Ebensburg
57,2007-2008,2007-11-16,2008-03-23,129,9,44,298,342,113,263,376,718,41,254,PA - Ebensburg
58,2008-2009,2008-10-29,2009-04-08,162,3,68,378,446,121,248,369,815,42,291,PA - Ebensburg
59,2009-2010,2009-12-01,2010-03-13,103,0,72,301,373,210,528,738,1111,42,395,PA - Ebensburg
60,2010-2011,2010-12-01,2011-04-02,123,0,86,361,447,134,364,498,945,49,347,PA - Ebensburg
61,2011-2012,2011-10-29,2012-04-24,179,0,19,262,281,81,97,178,459,25,164,PA - Ebensburg
62,2012-2013,2012-11-25,2013-04-02,129,1,50,276,326,123,247,370,696,49,278,PA - Ebensburg
63,2013-2014,2013-11-12,2014-03-31,140,0,113,502,615,120,351,471,1086,53,414,PA - Ebensburg
64,2014-2015,2014-11-14,2015-04-23,161,0,101,475,576,116,355,471,1047,49,366,PA - Ebensburg
65,2015-2016,2015-11-24,2016-04-10,139,0,60,314,374,69,124,193,567,31,223,PA - Ebensburg
66,2016-2017,2016-11-20,2017-04-08,140,0,62,294,356,105,162,267,623,42,279,PA - Ebensburg
67,2017-2018,2017-11-08,2018-04-18,162,0,105,447,552,138,276,414,966,37,313,PA - Ebensburg
68,2018-2019,2018-10-21,2019-04-01,163,3,82,376,458,76,221,297,755,35,229,PA - Ebensburg
69,2019-2020,2019-11-08,2020-05-09,184,0,42,306,348,69,100,169,517,32,150,PA - Ebensburg
0,1950-1951,1950-11-10,1951-03-25,136,0,73,264,337,143,308,451,788,54,314,PA - Erie
1,1951-1952,1951-11-02,1952-04-07,158,2,58,257,315,89,115,204,519,38,181,PA - Erie
2,1952-1953,1952-11-28,1953-04-20,144,0,29,167,196,63,64,127,323,36,152,PA - Erie
3,1953-1954,1953-11-07,1954-04-03,148,0,49,229,278,83,106,189,467,26,150,PA - Erie
4,1954-1955,1954-10-30,1955-03-28,150,0,63,238,301,79,129,208,509,29,184,PA - Erie
5,1955-1956,1955-11-17,1956-04-17,153,3,61,280,341,105,187,292,633,47,234,PA - Erie
6,1956-1957,1956-11-22,1957-04-13,143,0,59,236,295,158,308,466,761,53,309,PA - Erie
7,1957-1958,1957-10-27,1958-04-09,165,0,72,274,346,101,252,353,699,41,243,PA - Erie
8,1958-1959,1958-11-27,1959-03-28,122,0,96,367,463,156,334,490,953,53,378,PA - Erie
9,1959-1960,1959-11-12,1960-04-09,150,1,70,272,342,109,311,420,762,56,260,PA - Erie
10,1960-1961,1960-11-05,1961-04-17,164,0,96,300,396,105,228,333,729,53,329,PA - Erie
11,1961-1962,1961-11-08,1962-04-15,159,1,90,305,395,75,90,165,560,50,264,PA - Erie
12,1962-1963,1962-10-24,1963-05-01,190,0,126,387,513,125,260,385,898,63,414,PA - Erie
13,1963-1964,1963-11-12,1964-04-08,149,0,73,279,352,166,289,455,807,65,380,PA - Erie
14,1964-1965,1964-11-20,1965-04-18,150,0,85,299,384,139,194,333,717,56,355,PA - Erie
15,1965-1966,1965-11-28,1966-04-07,131,0,83,243,326,126,176,302,628,55,324,PA - Erie
16,1966-1967,1966-11-03,1967-04-24,173,0,60,258,318,109,138,247,565,57,276,PA - Erie
17,1967-1968,1967-11-04,1968-04-25,174,0,91,331,422,156,243,399,821,61,394,PA - Erie
18,1968-1969,1968-11-12,1969-04-19,159,0,73,279,352,120,174,294,646,63,311,PA - Erie
19,1969-1970,1969-10-22,1970-04-02,163,0,128,399,527,129,308,437,964,66,420,PA - Erie
20,1970-1971,1970-11-23,1971-04-24,153,0,94,315,409,179,219,398,807,68,428,PA - Erie
21,1971-1972,1971-11-04,1972-04-08,157,0,86,312,398,143,138,281,679,69,366,PA - Erie
22,1972-1973,1972-10-18,1973-04-10,175,0,60,242,302,80,116,196,498,45,211,PA - Erie
23,1973-1974,1973-11-16,1974-04-10,146,0,73,235,308,107,173,280,588,53,291,PA - Erie
24,1974-1975,1974-10-19,1975-04-05,169,0,54,229,283,108,143,251,534,57,259,PA - Erie
25,1975-1976,1975-11-21,1976-04-04,136,0,70,279,349,106,186,292,641,56,305,PA - Erie
26,1976-1977,1976-10-21,1977-04-06,168,0,151,403,554,166,432,598,1152,81,567,PA - Erie
27,1977-1978,1977-11-11,1978-04-03,144,0,144,430,574,204,512,716,1290,63,523,PA - Erie
28,1978-1979,1978-11-20,1979-04-09,141,0,153,379,532,116,275,391,923,57,417,PA - Erie
29,1979-1980,1979-10-25,1980-03-23,151,0,101,276,377,87,124,211,588,49,277,PA - Erie
30,1980-1981,1980-11-17,1981-03-22,126,0,100,331,431,132,274,406,837,58,408,PA - Erie
31,1981-1982,1981-11-21,1982-04-11,142,0,99,346,445,116,246,362,807,64,396,PA - Erie
32,1982-1983,1982-11-05,1983-04-18,165,0,28,184,212,66,61,127,339,42,148,PA - Erie
33,1983-1984,1983-11-04,1984-03-31,149,0,100,307,407,166,359,525,932,68,442,PA - Erie
34,1984-1985,1984-11-12,1985-04-09,149,0,78,267,345,155,339,494,839,55,372,PA - Erie
35,1985-1986,1985-11-27,1986-04-22,147,0,80,271,351,179,354,533,884,67,425,PA - Erie
36,1986-1987,1986-11-12,1987-04-05,145,0,43,227,270,104,167,271,541,52,233,PA - Erie
37,1987-1988,1987-11-21,1988-04-16,148,0,60,244,304,151,230,381,685,59,347,PA - Erie
38,1988-1989,1988-10-26,1989-05-07,194,0,60,244,304,120,130,250,554,55,273,PA - Erie
39,1989-1990,1989-11-16,1990-04-12,148,0,66,229,295,163,265,428,723,59,345,PA - Erie
40,1990-1991,1990-11-11,1991-04-10,151,0,38,178,216,91,107,198,414,47,209,PA - Erie
41,1991-1992,1991-11-07,1992-04-04,150,0,39,214,253,149,150,299,552,52,280,PA - Erie
42,1992-1993,1992-11-05,1993-04-03,150,1,46,224,270,165,265,430,700,64,311,PA - Erie
43,1993-1994,1993-10-30,1994-04-07,160,0,115,349,464,188,409,597,1061,61,478,PA - Erie
44,1994-1995,1994-11-23,1995-04-10,139,0,50,223,273,84,127,211,484,40,210,PA - Erie
45,1995-1996,1995-11-03,1996-04-10,160,16,117,350,467,189,265,454,921,70,474,PA - Erie
46,1996-1997,1996-11-09,1997-03-26,138,1,58,241,299,136,217,353,652,48,283,PA - Erie
54,2004-2005,2004-11-25,2005-04-05,132,2,77,280,357,176,341,517,874,59,388,PA - Erie
55,2005-2006,2005-11-17,2006-04-06,141,0,55,187,242,125,162,287,529,50,255,PA - Erie
56,2006-2007,2006-10-23,2007-04-15,175,0,87,241,328,157,314,471,799,64,395,PA - Erie
57,2007-2008,2007-11-06,2008-03-28,144,0,46,218,264,175,208,383,647,61,339,PA - Erie
58,2008-2009,2008-10-29,2009-04-08,162,0,76,282,358,207,347,554,912,68,424,PA - Erie
59,2009-2010,2009-12-01,2010-03-26,116,0,68,219,287,135,329,464,751,52,312,PA - Erie
60,2010-2011,2010-11-26,2011-04-18,144,0,87,275,362,160,349,509,871,66,370,PA - Erie
61,2011-2012,2011-11-11,2012-04-23,165,0,17,131,148,75,47,122,270,31,129,PA - Erie
62,2012-2013,2012-11-13,2013-04-20,159,0,54,196,250,150,154,304,554,54,293,PA - Erie
63,2013-2014,2013-10-24,2014-04-16,175,3,130,397,527,195,241,436,963,73,496,PA - Erie
64,2014-2015,2014-11-13,2015-04-01,140,0,118,380,498,166,441,607,1105,66,431,PA - Erie
65,2015-2016,2015-11-22,2016-04-10,141,0,44,170,214,110,107,217,431,50,257,PA - Erie
66,2016-2017,2016-11-19,2017-04-07,140,0,42,152,194,112,124,236,430,46,233,PA - Erie
67,2017-2018,2017-11-19,2018-04-18,151,10,80,269,349,224,259,483,832,58,433,PA - Erie
68,2018-2019,2018-11-09,2019-04-01,144,2,56,230,286,130,128,258,544,48,276,PA - Erie
69,2019-2020,2019-11-08,2020-04-23,168,0,21,131,152,100,87,187,339,37,156,PA - Erie
0,1950-1951,1950-11-25,1951-03-21,117,0,30,182,212,34,60,94,306,22,77,PA - Harrisburg
1,1951-1952,1951-11-03,1952-03-19,138,0,16,169,185,55,116,171,356,17,88,PA - Harrisburg
2,1952-1953,1952-11-29,1953-04-20,143,0,5,102,107,36,38,74,181,17,58,PA - Harrisburg
3,1953-1954,1953-11-06,1954-03-11,126,0,17,149,166,41,80,121,287,11,68,PA - Harrisburg
4,1954-1955,1954-11-02,1955-03-18,137,0,28,173,201,28,26,54,255,15,64,PA - Harrisburg
5,1955-1956,1955-11-19,1956-03-29,132,0,23,186,209,58,49,107,316,22,99,PA - Harrisburg
6,1956-1957,1956-11-17,1957-04-04,139,0,22,149,171,51,40,91,262,25,96,PA - Harrisburg
7,1957-1958,1957-12-01,1958-03-24,114,0,33,170,203,60,84,144,347,21,90,PA - Harrisburg
8,1958-1959,1958-11-03,1959-04-13,162,0,38,248,286,39,22,61,347,20,84,PA - Harrisburg
9,1959-1960,1959-11-18,1960-04-06,141,0,22,182,204,66,82,148,352,30,134,PA - Harrisburg
10,1960-1961,1960-12-01,1961-04-13,134,0,55,267,322,116,375,491,813,32,206,PA - Harrisburg
11,1961-1962,1961-11-19,1962-03-11,113,0,40,240,280,76,147,223,503,26,152,PA - Harrisburg
12,1962-1963,1962-11-03,1963-03-21,139,0,55,278,333,73,155,228,561,29,141,PA - Harrisburg
13,1963-1964,1963-12-01,1964-04-01,123,0,33,243,276,108,241,349,625,25,169,PA - Harrisburg
14,1964-1965,1964-12-01,1965-04-02,123,0,34,217,251,48,68,116,367,18,91,PA - Harrisburg
15,1965-1966,1965-12-01,1966-03-24,114,0,34,181,215,62,153,215,430,14,116,PA - Harrisburg
16,1966-1967,1966-11-29,1967-03-23,115,0,34,218,252,74,108,182,434,31,148,PA - Harrisburg
17,1967-1968,1967-11-17,1968-03-23,128,0,46,239,285,46,137,183,468,16,95,PA - Harrisburg
18,1968-1969,1968-11-12,1969-03-26,135,0,26,186,212,42,31,73,285,22,73,PA - Harrisburg
19,1969-1970,1969-11-15,1970-04-01,138,0,49,264,313,90,309,399,712,36,175,PA - Harrisburg
20,1970-1971,1970-12-01,1971-03-19,109,0,33,171,204,51,138,189,393,26,110,PA - Harrisburg
21,1971-1972,1971-11-24,1972-04-08,137,0,18,147,165,50,94,144,309,16,75,PA - Harrisburg
22,1972-1973,1972-10-19,1973-02-28,133,0,15,146,161,21,15,36,197,8,32,PA - Harrisburg
23,1973-1974,1973-12-01,1974-02-28,90,0,18,110,128,40,68,108,236,8,60,PA - Harrisburg
24,1974-1975,1974-11-26,1975-03-16,111,0,14,150,164,44,72,116,280,15,72,PA - Harrisburg
25,1975-1976,1975-12-01,1976-03-17,108,0,26,145,171,31,16,47,218,15,60,PA - Harrisburg
26,1976-1977,1976-11-05,1977-03-20,136,0,68,274,342,37,141,178,520,20,92,PA - Harrisburg
27,1977-1978,1977-11-12,1978-03-19,128,0,59,273,332,100,343,443,775,25,164,PA - Harrisburg
28,1978-1979,1978-11-27,1979-03-15,109,0,51,212,263,56,117,173,436,20,133,PA - Harrisburg
29,1979-1980,1979-12-01,1980-03-16,107,0,25,190,215,27,19,46,261,18,80,PA - Harrisburg
30,1980-1981,1980-11-17,1981-03-21,125,0,55,266,321,37,56,93,414,18,93,PA - Harrisburg
31,1981-1982,1981-11-24,1982-04-10,138,0,53,230,283,81,154,235,518,29,153,PA - Harrisburg
32,1982-1983,1982-12-01,1983-04-20,141,0,7,129,136,57,84,141,277,14,75,PA - Harrisburg
33,1983-1984,1983-12-01,1984-04-01,123,0,50,234,284,51,85,136,420,24,125,PA - Harrisburg
34,1984-1985,1984-11-18,1985-04-09,143,0,32,148,180,41,69,110,290,19,78,PA - Harrisburg
35,1985-1986,1985-12-01,1986-03-08,98,0,37,166,203,56,90,146,349,26,129,PA - Harrisburg
36,1986-1987,1986-12-01,1987-04-05,126,0,17,145,162,63,133,196,358,17,90,PA - Harrisburg
37,1987-1988,1987-11-10,1988-03-20,132,0,32,217,249,40,67,107,356,17,80,PA - Harrisburg
38,1988-1989,1988-12-01,1989-03-20,110,1,25,182,207,30,42,72,279,11,56,PA - Harrisburg
39,1989-1990,1989-11-22,1990-04-12,142,0,34,211,245,34,29,63,308,22,86,PA - Harrisburg
40,1990-1991,1990-12-01,1991-03-30,120,0,8,143,151,31,28,59,210,15,60,PA - Harrisburg
41,1991-1992,1991-12-01,1992-03-23,114,0,11,149,160,22,13,35,195,12,50,PA - Harrisburg
42,1992-1993,1992-12-01,1993-04-22,143,0,16,182,198,66,114,180,378,21,102,PA - Harrisburg
43,1993-1994,1993-12-01,1994-03-29,119,0,64,288,352,107,363,470,822,26,204,PA - Harrisburg
44,1994-1995,1994-11-23,1995-03-09,107,0,17,145,162,18,20,38,200,12,35,PA - Harrisburg
45,1995-1996,1995-11-11,1996-04-10,152,0,53,264,317,114,258,372,689,35,207,PA - Harrisburg
46,1996-1997,1996-11-28,1997-03-31,124,0,20,145,165,37,17,54,219,18,63,PA - Harrisburg
47,1997-1998,1997-11-13,1998-03-11,119,0,4,98,102,23,10,33,135,17,40,PA - Harrisburg
48,1998-1999,1998-12-01,1999-03-17,107,0,17,152,169,34,25,59,228,15,69,PA - Harrisburg
49,1999-2000,1999-12-01,2000-04-09,131,0,27,170,197,33,87,120,317,11,72,PA - Harrisburg
50,2000-2001,2000-12-01,2001-03-05,95,0,26,199,225,39,92,131,356,14,74,PA - Harrisburg
51,2001-2002,2001-12-01,2002-03-22,112,0,6,126,132,17,27,44,176,6,28,PA - Harrisburg
52,2002-2003,2002-11-26,2003-04-07,133,0,41,253,294,86,176,262,556,25,150,PA - Harrisburg
53,2003-2004,2003-12-01,2004-03-19,110,0,43,207,250,51,109,160,410,21,125,PA - Harrisburg
54,2004-2005,2004-12-01,2005-03-09,99,0,28,159,187,45,67,112,299,18,99,PA - Harrisburg
55,2005-2006,2005-11-23,2006-02-28,98,0,12,135,147,27,61,88,235,8,46,PA - Harrisburg
56,2006-2007,2006-12-01,2007-03-20,110,0,27,177,204,32,47,79,283,10,60,PA - Harrisburg
57,2007-2008,2007-11-18,2008-03-22,126,0,15,155,170,23,17,40,210,14,55,PA - Harrisburg
58,2008-2009,2008-11-21,2009-03-03,103,0,32,185,217,25,19,44,261,15,66,PA - Harrisburg
59,2009-2010,2009-12-01,2010-02-28,90,0,23,140,163,81,161,242,405,19,118,PA - Harrisburg
60,2010-2011,2010-11-25,2011-04-01,128,0,29,210,239,40,90,130,369,22,95,PA - Harrisburg
61,2011-2012,2011-10-29,2012-02-29,124,0,8,117,125,18,19,37,162,6,31,PA - Harrisburg
62,2012-2013,2012-11-27,2013-03-26,120,0,14,142,156,28,16,44,200,16,63,PA - Harrisburg
63,2013-2014,2013-11-24,2014-03-30,127,0,54,284,338,64,146,210,548,23,134,PA - Harrisburg
64,2014-2015,2014-11-19,2015-03-28,130,0,49,286,335,58,75,133,468,25,148,PA - Harrisburg
65,2015-2016,2015-12-01,2016-04-09,131,0,16,151,167,56,105,161,328,10,82,PA - Harrisburg
66,2016-2017,2016-12-01,2017-03-20,110,0,12,122,134,35,51,86,220,12,60,PA - Harrisburg
67,2017-2018,2017-12-01,2018-04-02,123,2,34,193,227,53,52,105,332,20,96,PA - Harrisburg
68,2018-2019,2018-11-15,2019-03-09,115,0,17,157,174,57,69,126,300,17,87,PA - Harrisburg
69,2019-2020,2019-12-01,2020-02-29,91,0,3,89,92,7,7,14,106,3,10,PA - Harrisburg
0,1950-1951,1950-11-27,1951-02-28,94,0,14,118,132,11,1,12,144,9,30,PA - Philadelphia
1,1951-1952,1951-12-01,1952-03-04,95,0,11,96,107,23,29,52,159,6,33,PA - Philadelphia
2,1952-1953,1952-11-30,1953-03-10,101,0,4,81,85,25,17,42,127,7,33,PA - Philadelphia
3,1953-1954,1953-11-06,1954-03-31,146,0,16,126,142,31,49,80,222,8,51,PA - Philadelphia
4,1954-1955,1954-12-01,1955-03-18,108,0,15,120,135,16,15,31,166,8,28,PA - Philadelphia
5,1955-1956,1955-11-19,1956-03-24,127,0,17,162,179,33,30,63,242,17,58,PA - Philadelphia
6,1956-1957,1956-12-01,1957-03-07,97,0,15,112,127,17,11,28,155,14,51,PA - Philadelphia
7,1957-1958,1957-12-01,1958-03-23,113,0,29,150,179,58,77,135,314,16,85,PA - Philadelphia
8,1958-1959,1958-11-30,1959-03-14,105,0,29,185,214,10,6,16,230,7,24,PA - Philadelphia
9,1959-1960,1959-11-18,1960-03-22,126,0,12,166,178,36,33,69,247,19,82,PA - Philadelphia
10,1960-1961,1960-12-01,1961-03-22,112,0,49,237,286,69,180,249,535,20,147,PA - Philadelphia
11,1961-1962,1961-11-20,1962-03-10,111,0,27,213,240,46,30,76,316,19,93,PA - Philadelphia
12,1962-1963,1962-12-01,1963-03-01,91,0,42,225,267,30,22,52,319,14,63,PA - Philadelphia
13,1963-1964,1963-12-01,1964-03-22,113,0,23,200,223,47,62,109,332,17,88,PA - Philadelphia
14,1964-1965,1964-12-01,1965-04-02,123,0,28,182,210,37,40,77,287,16,72,PA - Philadelphia
15,1965-1966,1965-12-01,1966-02-28,90,0,29,169,198,35,71,106,304,12,77,PA - Philadelphia
16,1966-1967,1966-12-01,1967-04-27,148,0,23,178,201,70,74,144,345,29,129,PA - Philadelphia
17,1967-1968,1967-11-30,1968-03-13,105,0,24,169,193,28,46,74,267,16,66,PA - Philadelphia
18,1968-1969,1968-11-12,1969-03-08,117,0,21,168,189,32,30,62,251,15,54,PA - Philadelphia
19,1969-1970,1969-11-30,1970-03-30,121,0,36,192,228,35,55,90,318,20,79,PA - Philadelphia
20,1970-1971,1970-12-01,1971-04-07,128,0,30,153,183,31,13,44,227,16,57,PA - Philadelphia
21,1971-1972,1971-12-01,1972-04-08,130,0,14,138,152,21,24,45,197,13,46,PA - Philadelphia
22,1972-1973,1972-12-01,1973-02-28,90,0,15,106,121,0,0,0,121,0,0,PA - Philadelphia
23,1973-1974,1973-12-01,1974-02-28,90,0,18,115,133,30,36,66,199,10,57,PA - Philadelphia
24,1974-1975,1974-12-01,1975-03-14,104,0,6,99,105,20,7,27,132,11,35,PA - Philadelphia
25,1975-1976,1975-12-01,1976-03-10,101,0,19,135,154,25,16,41,195,11,47,PA - Philadelphia
26,1976-1977,1976-11-30,1977-02-28,91,0,55,249,304,29,57,86,390,13,74,PA - Philadelphia
27,1977-1978,1977-11-27,1978-03-16,110,0,50,242,292,82,146,228,520,21,135,PA - Philadelphia
28,1978-1979,1978-11-27,1979-02-28,94,0,49,176,225,57,93,150,375,18,126,PA - Philadelphia
29,1979-1980,1979-10-10,1980-03-31,174,0,30,156,186,29,21,50,236,14,64,PA - Philadelphia
30,1980-1981,1980-11-17,1981-03-06,110,0,45,207,252,26,22,48,300,12,60,PA - Philadelphia
31,1981-1982,1981-12-01,1982-04-09,130,0,35,196,231,43,88,131,362,24,97,PA - Philadelphia
32,1982-1983,1982-12-01,1983-04-20,141,0,8,121,129,51,68,119,248,10,68,PA - Philadelphia
33,1983-1984,1983-11-25,1984-03-29,126,0,42,209,251,30,68,98,349,14,70,PA - Philadelphia
34,1984-1985,1984-12-01,1985-02-28,90,0,23,142,165,23,32,55,220,10,50,PA - Philadelphia
35,1985-1986,1985-12-01,1986-03-08,98,0,22,165,187,28,35,63,250,14,63,PA - Philadelphia
36,1986-1987,1986-12-01,1987-02-28,90,0,10,128,138,37,86,123,261,13,58,PA - Philadelphia
37,1987-1988,1987-11-11,1988-02-29,111,0,25,161,186,22,32,54,240,12,53,PA - Philadelphia
38,1988-1989,1988-12-01,1989-03-09,99,0,15,129,144,21,15,36,180,12,47,PA - Philadelphia
39,1989-1990,1989-11-22,1990-04-07,137,0,22,168,190,27,20,47,237,16,54,PA - Philadelphia
40,1990-1991,1990-12-01,1991-03-30,120,0,7,90,97,22,16,38,135,10,35,PA - Philadelphia
41,1991-1992,1991-12-01,1992-03-23,114,0,9,116,125,10,2,12,137,8,26,PA - Philadelphia
42,1992-1993,1992-12-01,1993-03-21,111,0,11,119,130,33,26,59,189,13,51,PA - Philadelphia
43,1993-1994,1993-12-01,1994-03-18,108,0,32,161,193,34,63,97,290,18,87,PA - Philadelphia
44,1994-1995,1994-12-01,1995-02-28,90,0,12,103,115,14,32,46,161,4,22,PA - Philadelphia
45,1995-1996,1995-11-29,1996-04-09,133,0,43,195,238,90,171,261,499,22,155,PA - Philadelphia
46,1996-1997,1996-11-28,1997-04-01,125,0,15,108,123,19,8,27,150,10,29,PA - Philadelphia
47,1997-1998,1997-12-01,1998-03-22,112,0,1,62,63,4,0,4,67,4,5,PA - Philadelphia
48,1998-1999,1998-12-01,1999-03-15,105,0,15,107,122,19,10,29,151,10,38,PA - Philadelphia
49,1999-2000,1999-12-01,2000-04-09,131,0,20,118,138,28,75,103,241,7,41,PA - Philadelphia
50,2000-2001,2000-12-01,2001-03-26,116,0,14,134,148,40,60,100,248,13,67,PA - Philadelphia
51,2001-2002,2001-12-01,2002-02-28,90,0,3,58,61,5,7,12,73,2,8,PA - Philadelphia
52,2002-2003,2002-12-01,2003-04-07,128,0,29,171,200,69,130,199,399,21,118,PA - Philadelphia
53,2003-2004,2003-12-01,2004-04-04,126,0,32,161,193,28,45,73,266,16,69,PA - Philadelphia
54,2004-2005,2004-12-01,2005-03-09,99,0,26,135,161,45,83,128,289,17,100,PA - Philadelphia
55,2005-2006,2005-12-01,2006-04-05,126,0,7,101,108,29,31,60,168,10,42,PA - Philadelphia
56,2006-2007,2006-12-01,2007-03-19,109,0,23,135,158,23,28,51,209,15,59,PA - Philadelphia
57,2007-2008,2007-12-01,2008-02-29,91,0,9,89,98,10,4,14,112,5,21,PA - Philadelphia
58,2008-2009,2008-11-21,2009-03-05,105,0,22,139,161,34,33,67,228,13,57,PA - Philadelphia
59,2009-2010,2009-12-01,2010-02-28,90,0,16,124,140,100,170,270,410,15,130,PA - Philadelphia
60,2010-2011,2010-12-01,2011-02-28,90,0,20,138,158,59,115,174,332,16,93,PA - Philadelphia
61,2011-2012,2011-10-29,2012-02-29,124,0,4,58,62,7,6,13,75,5,16,PA - Philadelphia
62,2012-2013,2012-12-01,2013-03-25,115,0,11,89,100,19,5,24,124,15,42,PA - Philadelphia
63,2013-2014,2013-11-24,2014-03-25,122,0,36,192,228,93,165,258,486,21,146,PA - Philadelphia
64,2014-2015,2014-12-01,2015-03-30,120,0,32,172,204,41,37,78,282,19,87,PA - Philadelphia
65,2015-2016,2015-12-01,2016-04-09,131,0,12,83,95,42,57,99,194,12,61,PA - Philadelphia
66,2016-2017,2016-12-01,2017-03-17,107,0,9,84,93,23,18,41,134,10,41,PA - Philadelphia
67,2017-2018,2017-12-01,2018-03-23,113,0,25,135,160,45,38,83,243,14,71,PA - Philadelphia
68,2018-2019,2018-11-15,2019-03-06,112,0,13,107,120,26,12,38,158,14,53,PA - Philadelphia
69,2019-2020,2019-12-01,2020-02-29,91,0,2,66,68,2,0,2,70,2,5,PA - Philadelphia
0,1950-1951,1950-11-21,1951-04-17,148,0,56,232,288,126,175,301,589,44,282,PA - Pittsburgh
1,1951-1952,1951-11-01,1952-04-07,159,0,35,198,233,81,27,108,341,48,182,PA - Pittsburgh
2,1952-1953,1952-10-20,1953-04-21,184,0,21,168,189,45,35,80,269,29,108,PA - Pittsburgh
3,1953-1954,1953-11-07,1954-04-03,148,0,36,209,245,48,23,71,316,33,137,PA - Pittsburgh
4,1954-1955,1954-11-05,1955-03-27,143,0,48,247,295,47,69,116,411,36,158,PA - Pittsburgh
5,1955-1956,1955-11-17,1956-04-23,159,0,42,259,301,69,71,140,441,42,192,PA - Pittsburgh
6,1956-1957,1956-11-22,1957-04-13,143,0,43,206,249,65,50,115,364,43,151,PA - Pittsburgh
7,1957-1958,1957-10-27,1958-04-10,166,0,67,255,322,65,143,208,530,46,183,PA - Pittsburgh
8,1958-1959,1958-11-27,1959-04-13,138,0,80,336,416,71,122,193,609,37,200,PA - Pittsburgh
9,1959-1960,1959-11-02,1960-04-08,159,0,71,297,368,101,172,273,641,48,257,PA - Pittsburgh
10,1960-1961,1960-10-24,1961-04-29,188,0,89,335,424,113,268,381,805,54,321,PA - Pittsburgh
11,1961-1962,1961-11-08,1962-04-15,159,0,63,277,340,75,68,143,483,39,183,PA - Pittsburgh
12,1962-1963,1962-10-25,1963-05-01,189,0,116,413,529,86,174,260,789,48,297,PA - Pittsburgh
13,1963-1964,1963-11-02,1964-04-09,160,0,72,284,356,101,197,298,654,49,240,PA - Pittsburgh
14,1964-1965,1964-11-20,1965-04-02,134,0,63,278,341,73,82,155,496,48,238,PA - Pittsburgh
15,1965-1966,1965-10-28,1966-05-09,194,0,63,254,317,85,115,200,517,48,230,PA - Pittsburgh
16,1966-1967,1966-11-03,1967-04-24,173,0,54,275,329,93,120,213,542,47,234,PA - Pittsburgh
17,1967-1968,1967-11-06,1968-03-24,140,0,82,335,417,82,169,251,668,38,239,PA - Pittsburgh
18,1968-1969,1968-11-12,1969-03-30,139,0,65,284,349,59,43,102,451,45,225,PA - Pittsburgh
19,1969-1970,1969-10-23,1970-04-02,162,0,86,342,428,113,197,310,738,64,360,PA - Pittsburgh
20,1970-1971,1970-11-24,1971-04-05,133,0,80,278,358,100,116,216,574,55,314,PA - Pittsburgh
21,1971-1972,1971-11-06,1972-04-08,155,0,56,282,338,80,93,173,511,41,192,PA - Pittsburgh
22,1972-1973,1972-10-18,1973-04-11,176,0,41,213,254,49,32,81,335,37,134,PA - Pittsburgh
23,1973-1974,1973-11-09,1974-04-09,152,0,37,196,233,34,19,53,286,28,110,PA - Pittsburgh
24,1974-1975,1974-11-15,1975-04-05,142,0,31,188,219,101,119,220,439,53,215,PA - Pittsburgh
25,1975-1976,1975-11-13,1976-04-02,142,0,57,226,283,68,88,156,439,44,183,PA - Pittsburgh
26,1976-1977,1976-11-08,1977-04-07,151,0,144,448,592,88,294,382,974,59,414,PA - Pittsburgh
27,1977-1978,1977-11-11,1978-04-21,162,0,93,331,424,106,329,435,859,58,339,PA - Pittsburgh
28,1978-1979,1978-11-26,1979-04-09,135,0,104,327,431,65,208,273,704,38,223,PA - Pittsburgh
29,1979-1980,1979-11-15,1980-03-21,128,0,66,270,336,45,48,93,429,31,168,PA - Pittsburgh
30,1980-1981,1980-11-17,1981-03-21,125,0,85,320,405,77,183,260,665,38,229,PA - Pittsburgh
31,1981-1982,1981-11-21,1982-04-10,141,0,79,324,403,74,113,187,590,39,259,PA - Pittsburgh
32,1982-1983,1982-11-24,1983-04-19,147,0,27,195,222,51,67,118,340,27,126,PA - Pittsburgh
33,1983-1984,1983-11-04,1984-03-29,147,0,81,311,392,82,118,200,592,43,250,PA - Pittsburgh
34,1984-1985,1984-11-12,1985-04-10,150,0,70,284,354,61,228,289,643,41,227,PA - Pittsburgh
35,1985-1986,1985-12-01,1986-04-22,143,0,60,263,323,76,152,228,551,43,227,PA - Pittsburgh
36,1986-1987,1986-11-11,1987-04-06,147,0,25,226,251,44,77,121,372,21,90,PA - Pittsburgh
37,1987-1988,1987-11-10,1988-04-16,159,0,60,263,323,67,50,117,440,50,221,PA - Pittsburgh
38,1988-1989,1988-10-24,1989-04-10,169,0,38,234,272,42,31,73,345,32,134,PA - Pittsburgh
39,1989-1990,1989-10-21,1990-04-17,179,0,58,270,328,58,75,133,461,42,191,PA - Pittsburgh
40,1990-1991,1990-12-01,1991-03-30,120,0,19,162,181,33,17,50,231,25,89,PA - Pittsburgh
41,1991-1992,1991-11-04,1992-04-04,153,0,35,227,262,58,63,121,383,41,154,PA - Pittsburgh
42,1992-1993,1992-10-18,1993-04-03,168,0,31,209,240,109,121,230,470,45,199,PA - Pittsburgh
43,1993-1994,1993-10-30,1994-04-07,160,0,72,295,367,117,235,352,719,54,322,PA - Pittsburgh
44,1994-1995,1994-11-23,1995-04-02,131,0,42,223,265,39,70,109,374,22,117,PA - Pittsburgh
45,1995-1996,1995-11-08,1996-04-17,162,0,86,327,413,120,227,347,760,64,354,PA - Pittsburgh
46,1996-1997,1996-11-09,1997-04-08,151,2,48,229,277,49,48,97,374,33,136,PA - Pittsburgh
47,1997-1998,1997-11-12,1998-03-22,131,0,16,137,153,42,32,74,227,27,96,PA - Pittsburgh
48,1998-1999,1998-12-01,1999-03-22,112,0,35,212,247,60,83,143,390,29,155,PA - Pittsburgh
49,1999-2000,1999-11-02,2000-04-09,160,0,43,211,254,55,96,151,405,38,171,PA - Pittsburgh
50,2000-2001,2000-11-15,2001-04-17,154,0,60,274,334,69,131,200,534,49,229,PA - Pittsburgh
51,2001-2002,2001-10-27,2002-04-06,162,0,24,175,199,45,40,85,284,31,132,PA - Pittsburgh
52,2002-2003,2002-11-22,2003-03-31,130,0,82,287,369,100,156,256,625,53,297,PA - Pittsburgh
53,2003-2004,2003-11-13,2004-04-27,167,0,59,259,318,86,137,223,541,49,237,PA - Pittsburgh
54,2004-2005,2004-12-01,2005-04-24,145,3,50,243,293,74,107,181,474,34,186,PA - Pittsburgh
55,2005-2006,2005-11-17,2006-03-25,129,0,36,216,252,54,72,126,378,36,155,PA - Pittsburgh
56,2006-2007,2006-12-01,2007-04-08,129,0,63,233,296,60,76,136,432,36,203,PA - Pittsburgh
57,2007-2008,2007-11-22,2008-03-22,122,0,34,220,254,71,63,134,388,43,196,PA - Pittsburgh
58,2008-2009,2008-10-28,2009-04-07,162,0,66,293,359,68,80,148,507,44,207,PA - Pittsburgh
59,2009-2010,2009-12-01,2010-03-26,116,1,59,230,289,110,326,436,725,44,261,PA - Pittsburgh
60,2010-2011,2010-12-01,2011-04-02,123,3,67,251,318,91,181,272,590,51,249,PA - Pittsburgh
61,2011-2012,2011-10-29,2012-03-06,130,0,15,143,158,55,49,104,262,26,126,PA - Pittsburgh
62,2012-2013,2012-11-24,2013-03-27,124,12,47,196,243,89,82,171,414,45,217,PA - Pittsburgh
63,2013-2014,2013-10-25,2014-04-15,173,0,80,354,434,102,150,252,686,54,288,PA - Pittsburgh
64,2014-2015,2014-11-13,2015-04-25,164,0,77,332,409,80,160,240,649,49,281,PA - Pittsburgh
65,2015-2016,2015-12-01,2016-04-09,131,0,40,189,229,51,49,100,329,32,175,PA - Pittsburgh
66,2016-2017,2016-11-19,2017-03-18,120,0,34,162,196,50,40,90,286,29,113,PA - Pittsburgh
67,2017-2018,2017-12-01,2018-04-19,140,0,66,258,324,92,125,217,541,47,238,PA - Pittsburgh
68,2018-2019,2018-11-14,2019-03-22,129,0,50,217,267,61,55,116,383,33,159,PA - Pittsburgh
69,2019-2020,2019-11-12,2020-04-10,151,0,15,168,183,42,18,60,243,29,95,PA - Pittsburgh
0,1950-1951,1950-11-25,1951-02-28,96,0,51,297,348,73,264,337,685,27,191,PA - Ridgway
1,1951-1952,1951-11-01,1952-03-20,141,5,28,347,375,80,198,278,653,29,176,PA - Ridgway
2,1952-1953,1952-11-28,1953-04-21,145,2,20,251,271,51,58,109,380,26,128,PA - Ridgway
3,1953-1954,1953-11-07,1954-04-01,146,0,34,306,340,64,103,167,507,28,144,PA - Ridgway
4,1954-1955,1954-12-01,1955-03-29,119,1,63,389,452,59,212,271,723,27,158,PA - Ridgway
5,1955-1956,1955-11-18,1956-04-24,159,5,57,436,493,93,250,343,836,38,220,PA - Ridgway
6,1956-1957,1956-11-24,1957-04-14,142,7,59,383,442,86,227,313,755,36,213,PA - Ridgway
7,1957-1958,1957-10-27,1958-04-11,167,0,84,526,610,86,360,446,1056,45,311,PA - Ridgway
8,1958-1959,1958-11-28,1959-03-22,115,0,85,434,519,86,301,387,906,33,233,PA - Ridgway
9,1959-1960,1959-11-18,1960-04-09,144,3,61,399,460,129,369,498,958,43,295,PA - Ridgway
10,1960-1961,1960-10-24,1961-04-13,172,0,89,506,595,136,516,652,1247,45,362,PA - Ridgway
11,1961-1962,1961-11-08,1962-04-18,162,2,55,428,483,88,215,303,786,41,216,PA - Ridgway
12,1962-1963,1962-10-24,1963-05-01,190,8,114,607,721,126,446,572,1293,55,397,PA - Ridgway
13,1963-1964,1963-11-03,1964-04-09,159,0,81,480,561,129,374,503,1064,64,408,PA - Ridgway
14,1964-1965,1964-11-22,1965-04-18,148,1,80,443,523,76,141,217,740,44,277,PA - Ridgway
15,1965-1966,1965-11-17,1966-05-09,174,6,72,407,479,93,178,271,750,41,270,PA - Ridgway
16,1966-1967,1966-11-06,1967-04-24,170,1,64,421,485,114,186,300,785,47,314,PA - Ridgway
17,1967-1968,1967-11-08,1968-03-23,137,0,87,470,557,77,202,279,836,41,267,PA - Ridgway
18,1968-1969,1968-11-12,1969-04-01,141,0,76,433,509,65,133,198,707,30,182,PA - Ridgway
19,1969-1970,1969-10-23,1970-04-03,163,0,88,544,632,114,325,439,1071,49,347,PA - Ridgway
20,1970-1971,1970-11-24,1971-03-30,127,3,83,367,450,117,276,393,843,43,295,PA - Ridgway
21,1971-1972,1971-11-08,1972-04-09,154,0,59,426,485,109,265,374,859,32,238,PA - Ridgway
22,1972-1973,1972-10-19,1973-04-12,176,0,48,348,396,59,94,153,549,22,119,PA - Ridgway
23,1973-1974,1973-11-10,1974-04-11,153,1,40,338,378,57,108,165,543,25,133,PA - Ridgway
24,1974-1975,1974-11-16,1975-04-06,142,0,38,346,384,98,183,281,665,38,198,PA - Ridgway
25,1975-1976,1975-11-15,1976-03-18,125,0,66,368,434,100,227,327,761,35,255,PA - Ridgway
26,1976-1977,1976-10-22,1977-04-06,167,0,153,594,747,138,442,580,1327,53,445,PA - Ridgway
27,1977-1978,1977-11-13,1978-03-27,135,3,115,524,639,129,494,623,1262,39,347,PA - Ridgway
28,1978-1979,1978-11-27,1979-04-07,132,0,115,465,580,103,361,464,1044,33,250,PA - Ridgway
29,1979-1980,1979-11-30,1980-03-23,115,0,72,366,438,61,97,158,596,26,163,PA - Ridgway
30,1980-1981,1980-11-18,1981-03-21,124,0,96,488,584,97,225,322,906,36,278,PA - Ridgway
31,1981-1982,1981-11-21,1982-04-11,142,6,95,522,617,106,334,440,1057,46,344,PA - Ridgway
32,1982-1983,1982-11-28,1983-04-19,143,2,36,304,340,38,85,123,463,19,93,PA - Ridgway
33,1983-1984,1983-11-05,1984-04-01,149,5,99,533,632,86,337,423,1055,33,244,PA - Ridgway
34,1984-1985,1984-11-12,1985-04-09,149,3,82,451,533,95,255,350,883,35,262,PA - Ridgway
35,1985-1986,1985-12-01,1986-04-11,132,3,89,376,465,63,185,248,713,29,190,PA - Ridgway
36,1986-1987,1986-11-11,1987-04-04,145,1,52,425,477,63,203,266,743,26,140,PA - Ridgway
37,1987-1988,1987-11-06,1988-04-16,163,6,88,434,522,62,150,212,734,30,183,PA - Ridgway
38,1988-1989,1988-11-29,1989-04-01,124,3,67,351,418,47,90,137,555,21,135,PA - Ridgway
39,1989-1990,1989-11-17,1990-04-07,142,0,89,421,510,67,167,234,744,28,186,PA - Ridgway
40,1990-1991,1990-11-24,1991-03-09,106,2,45,259,304,57,104,161,465,23,150,PA - Ridgway
41,1991-1992,1991-11-05,1992-04-03,151,3,64,404,468,89,199,288,756,30,249,PA - Ridgway
42,1992-1993,1992-11-15,1993-04-22,159,5,77,405,482,111,343,454,936,31,224,PA - Ridgway
43,1993-1994,1993-11-01,1994-03-26,146,3,121,505,626,113,499,612,1238,33,280,PA - Ridgway
44,1994-1995,1994-11-24,1995-04-05,133,7,63,362,425,45,86,131,556,19,132,PA - Ridgway
45,1995-1996,1995-11-05,1996-03-23,140,0,139,475,614,119,306,425,1039,35,294,PA - Ridgway
46,1996-1997,1996-11-12,1997-04-14,154,6,68,372,440,68,118,186,626,27,164,PA - Ridgway
47,1997-1998,1997-11-14,1998-03-23,130,1,33,236,269,56,89,145,414,23,120,PA - Ridgway
48,1998-1999,1998-12-01,1999-03-23,113,1,52,329,381,72,206,278,659,22,165,PA - Ridgway
49,1999-2000,1999-11-17,2000-03-18,123,8,59,334,393,37,140,177,570,16,113,PA - Ridgway
50,2000-2001,2000-11-16,2001-03-28,133,10,86,416,502,70,218,288,790,24,192,PA - Ridgway
51,2001-2002,2001-12-01,2002-03-26,116,4,42,237,279,35,50,85,364,13,79,PA - Ridgway
52,2002-2003,2002-10-30,2003-04-08,161,5,110,472,582,90,303,393,975,34,250,PA - Ridgway
53,2003-2004,2003-11-14,2004-03-23,131,17,92,411,503,102,337,439,942,29,239,PA - Ridgway
54,2004-2005,2004-12-01,2005-04-04,125,8,65,397,462,76,208,284,746,21,167,PA - Ridgway
55,2005-2006,2005-10-25,2006-04-05,163,11,62,366,428,51,95,146,574,24,151,PA - Ridgway
56,2006-2007,2006-12-01,2007-04-09,130,6,92,361,453,60,189,249,702,24,169,PA - Ridgway
57,2007-2008,2007-11-18,2008-03-22,126,3,58,327,385,72,128,200,585,32,188,PA - Ridgway
58,2008-2009,2008-10-29,2009-04-08,162,0,92,460,552,121,258,379,931,46,325,PA - Ridgway
59,2009-2010,2009-10-16,2010-03-26,162,3,79,380,459,112,251,363,822,36,254,PA - Ridgway
60,2010-2011,2010-11-28,2011-04-01,125,3,85,405,490,110,296,406,896,51,338,PA - Ridgway
61,2011-2012,2011-10-29,2012-04-23,178,0,24,287,311,38,52,90,401,23,118,PA - Ridgway
62,2012-2013,2012-11-24,2013-04-02,130,0,60,309,369,94,185,279,648,46,258,PA - Ridgway
63,2013-2014,2013-10-24,2014-04-16,175,0,120,539,659,111,283,394,1053,57,414,PA - Ridgway
64,2014-2015,2014-11-14,2015-04-01,139,0,104,506,610,104,364,468,1078,51,369,PA - Ridgway
65,2015-2016,2015-10-18,2016-04-10,176,0,50,303,353,51,91,142,495,28,180,PA - Ridgway
66,2016-2017,2016-11-21,2017-04-07,138,0,48,258,306,74,126,200,506,40,220,PA - Ridgway
67,2017-2018,2017-11-17,2018-04-18,153,0,85,405,490,115,215,330,820,48,336,PA - Ridgway
68,2018-2019,2018-10-22,2019-04-16,177,2,68,356,424,85,171,256,680,37,202,PA - Ridgway
69,2019-2020,2019-11-12,2020-05-09,180,0,23,277,300,58,88,146,446,28,124,PA - Ridgway
0,1950-1951,1950-11-23,1951-02-28,98,3,30,191,221,37,118,155,376,11,67,PA - Shippensburg
1,1951-1952,1951-11-03,1952-03-19,138,0,17,198,215,55,134,189,404,14,87,PA - Shippensburg
2,1952-1953,1952-11-30,1953-04-20,142,0,5,122,127,47,53,100,227,15,70,PA - Shippensburg
3,1953-1954,1953-11-06,1954-02-28,115,0,14,157,171,48,54,102,273,11,76,PA - Shippensburg
4,1954-1955,1954-11-02,1955-03-18,137,0,18,199,217,26,17,43,260,12,45,PA - Shippensburg
5,1955-1956,1955-11-11,1956-03-29,140,2,18,214,232,52,57,109,341,15,73,PA - Shippensburg
6,1956-1957,1956-11-18,1957-04-04,138,1,12,184,196,45,33,78,274,20,80,PA - Shippensburg
7,1957-1958,1957-12-01,1958-03-25,115,0,35,201,236,86,163,249,485,17,114,PA - Shippensburg
8,1958-1959,1958-11-28,1959-04-13,137,0,35,262,297,39,35,74,371,13,60,PA - Shippensburg
9,1959-1960,1959-11-18,1960-03-22,126,2,22,208,230,54,124,178,408,12,81,PA - Shippensburg
10,1960-1961,1960-10-24,1961-04-13,172,0,61,314,375,138,393,531,906,28,233,PA - Shippensburg
11,1961-1962,1961-11-20,1962-03-17,118,0,28,230,258,87,199,286,544,19,128,PA - Shippensburg
12,1962-1963,1962-11-03,1963-03-12,130,4,49,303,352,91,288,379,731,23,149,PA - Shippensburg
13,1963-1964,1963-12-01,1964-04-01,123,0,29,230,259,113,260,373,632,24,172,PA - Shippensburg
15,1965-1966,1965-12-01,1966-02-28,90,15,29,156,185,61,80,141,326,13,115,PA - Shippensburg
16,1966-1967,1966-11-30,1967-03-23,114,2,25,201,226,60,70,130,356,23,113,PA - Shippensburg
17,1967-1968,1967-11-17,1968-03-14,119,1,43,248,291,59,167,226,517,15,97,PA - Shippensburg
19,1969-1970,1969-11-21,1970-04-01,132,1,52,268,320,93,315,408,728,22,161,PA - Shippensburg
20,1970-1971,1970-11-24,1971-03-19,116,1,46,200,246,53,179,232,478,13,85,PA - Shippensburg
21,1971-1972,1971-11-24,1972-04-08,137,1,24,211,235,64,97,161,396,18,105,PA - Shippensburg
22,1972-1973,1972-10-19,1973-02-28,133,1,16,166,182,11,9,20,202,6,22,PA - Shippensburg
23,1973-1974,1973-11-09,1974-03-30,142,1,23,178,201,43,83,126,327,13,78,PA - Shippensburg
24,1974-1975,1974-12-01,1975-03-16,106,0,18,183,201,42,78,120,321,16,76,PA - Shippensburg
25,1975-1976,1975-12-01,1976-03-18,109,1,44,198,242,27,57,84,326,15,63,PA - Shippensburg
26,1976-1977,1976-11-08,1977-02-28,113,0,81,325,406,36,133,169,575,15,96,PA - Shippensburg
27,1977-1978,1977-11-27,1978-03-18,112,1,84,305,389,79,436,515,904,22,150,PA - Shippensburg
28,1978-1979,1978-11-27,1979-03-15,109,3,76,255,331,57,138,195,526,17,139,PA - Shippensburg
29,1979-1980,1979-12-01,1980-03-16,107,1,35,210,245,24,44,68,313,9,66,PA - Shippensburg
30,1980-1981,1980-11-17,1981-03-21,125,1,59,272,331,27,29,56,387,13,70,PA - Shippensburg
31,1981-1982,1981-11-24,1982-04-09,137,13,65,283,348,83,299,382,730,25,172,PA - Shippensburg
32,1982-1983,1982-11-28,1983-04-20,144,2,15,169,184,36,71,107,291,8,57,PA - Shippensburg
33,1983-1984,1983-11-25,1984-03-31,128,10,64,250,314,51,108,159,473,18,112,PA - Shippensburg
34,1984-1985,1984-11-18,1985-04-09,143,1,40,224,264,52,134,186,450,16,94,PA - Shippensburg
35,1985-1986,1985-12-01,1986-03-08,98,8,39,217,256,55,148,203,459,22,123,PA - Shippensburg
36,1986-1987,1986-12-01,1987-04-05,126,4,24,208,232,72,147,219,451,19,120,PA - Shippensburg
37,1987-1988,1987-11-10,1988-03-20,132,0,33,231,264,46,82,128,392,19,93,PA - Shippensburg
38,1988-1989,1988-12-01,1989-03-20,110,3,26,189,215,28,54,82,297,12,71,PA - Shippensburg
39,1989-1990,1989-11-21,1990-04-12,143,1,37,210,247,32,67,99,346,19,71,PA - Shippensburg
40,1990-1991,1990-12-01,1991-03-30,120,1,13,153,166,38,48,86,252,8,57,PA - Shippensburg
41,1991-1992,1991-12-01,1992-03-22,113,5,12,175,187,24,16,40,227,8,44,PA - Shippensburg
42,1992-1993,1992-12-01,1993-04-22,143,6,22,216,238,102,302,404,642,17,137,PA - Shippensburg
43,1993-1994,1993-12-01,1994-03-29,119,7,63,280,343,109,567,676,1019,26,207,PA - Shippensburg
44,1994-1995,1994-11-23,1995-03-10,108,6,27,173,200,17,31,48,248,8,39,PA - Shippensburg
45,1995-1996,1995-11-11,1996-04-09,151,6,71,293,364,129,353,482,846,31,229,PA - Shippensburg
46,1996-1997,1996-11-14,1997-03-19,126,2,28,182,210,42,69,111,321,19,81,PA - Shippensburg
47,1997-1998,1997-12-01,1998-03-22,112,5,6,100,106,43,43,86,192,15,65,PA - Shippensburg
48,1998-1999,1998-12-01,1999-03-16,106,5,27,171,198,51,86,137,335,19,111,PA - Shippensburg
49,1999-2000,1999-12-01,2000-04-09,131,1,24,164,188,40,137,177,365,11,77,PA - Shippensburg
50,2000-2001,2000-11-29,2001-03-06,98,2,23,194,217,41,204,245,462,15,73,PA - Shippensburg
51,2001-2002,2001-12-01,2002-03-17,107,1,4,117,121,16,23,39,160,6,28,PA - Shippensburg
52,2002-2003,2002-10-30,2003-04-07,160,0,41,255,296,100,268,368,664,34,187,PA - Shippensburg
53,2003-2004,2003-12-01,2004-03-19,110,0,37,214,251,68,273,341,592,21,143,PA - Shippensburg
54,2004-2005,2004-12-01,2005-03-11,101,0,29,188,217,35,54,89,306,14,77,PA - Shippensburg
55,2005-2006,2005-11-23,2006-02-28,98,3,12,146,158,25,74,99,257,9,46,PA - Shippensburg
56,2006-2007,2006-12-01,2007-03-19,109,0,31,189,220,37,69,106,326,14,82,PA - Shippensburg
57,2007-2008,2007-12-01,2008-03-22,113,0,16,158,174,29,28,57,231,14,58,PA - Shippensburg
58,2008-2009,2008-11-21,2009-03-03,103,0,31,202,233,25,23,48,281,16,67,PA - Shippensburg
59,2009-2010,2009-12-01,2010-03-03,93,0,32,166,198,84,205,289,487,17,124,PA - Shippensburg
60,2010-2011,2010-12-01,2011-03-06,96,0,36,198,234,35,132,167,401,16,88,PA - Shippensburg
61,2011-2012,2011-10-29,2012-02-29,124,0,8,128,136,22,19,41,177,10,43,PA - Shippensburg
62,2012-2013,2012-11-27,2013-03-25,119,0,19,155,174,52,52,104,278,21,100,PA - Shippensburg
63,2013-2014,2013-11-23,2014-03-25,123,0,59,297,356,64,208,272,628,23,142,PA - Shippensburg
64,2014-2015,2014-11-18,2015-03-24,127,0,53,284,337,62,207,269,606,28,165,PA - Shippensburg
65,2015-2016,2015-12-01,2016-03-04,95,0,26,162,188,53,167,220,408,11,92,PA - Shippensburg
66,2016-2017,2016-12-01,2017-03-19,109,0,24,157,181,35,26,61,242,16,81,PA - Shippensburg
67,2017-2018,2017-12-01,2018-04-09,130,0,41,223,264,50,78,128,392,13,80,PA - Shippensburg
68,2018-2019,2018-11-15,2019-03-10,116,0,25,183,208,60,103,163,371,18,108,PA - Shippensburg
69,2019-2020,2019-11-24,2020-02-29,98,0,10,131,141,13,8,21,162,8,29,PA - Shippensburg
0,1950-1951,1950-11-11,1951-03-22,132,1,57,254,311,78,229,307,618,28,160,PA - State College
1,1951-1952,1951-11-01,1952-03-29,150,0,39,240,279,70,128,198,477,29,132,PA - State College
2,1952-1953,1952-11-28,1953-04-19,143,1,19,147,166,50,66,116,282,26,104,PA - State College
3,1953-1954,1953-11-06,1954-03-21,136,1,43,205,248,51,72,123,371,16,94,PA - State College
4,1954-1955,1954-11-02,1955-03-28,147,3,48,242,290,47,79,126,416,28,127,PA - State College
5,1955-1956,1955-11-11,1956-04-22,164,15,48,281,329,53,86,139,468,23,106,PA - State College
6,1956-1957,1956-11-18,1957-04-09,143,1,41,206,247,92,79,171,418,40,167,PA - State College
7,1957-1958,1957-12-01,1958-04-11,132,0,62,267,329,92,207,299,628,33,168,PA - State College
8,1958-1959,1958-11-03,1959-04-13,162,0,83,363,446,74,105,179,625,30,158,PA - State College
9,1959-1960,1959-11-19,1960-04-09,143,4,56,277,333,80,222,302,635,33,188,PA - State College
10,1960-1961,1960-10-24,1961-04-18,177,0,88,347,435,139,416,555,990,46,306,PA - State College
11,1961-1962,1961-11-20,1962-04-16,148,0,67,301,368,82,185,267,635,36,198,PA - State College
12,1962-1963,1962-10-26,1963-05-01,188,0,106,429,535,94,248,342,877,37,262,PA - State College
13,1963-1964,1963-11-30,1964-04-01,124,0,68,309,377,115,380,495,872,34,233,PA - State College
14,1964-1965,1964-11-22,1965-04-02,132,0,73,318,391,71,163,234,625,32,184,PA - State College
15,1965-1966,1965-10-29,1966-04-10,164,0,68,293,361,75,132,207,568,37,209,PA - State College
16,1966-1967,1966-11-29,1967-04-27,150,3,63,292,355,86,138,224,579,38,214,PA - State College
17,1967-1968,1967-11-15,1968-03-24,131,2,84,325,409,51,122,173,582,29,175,PA - State College
18,1968-1969,1968-11-12,1969-03-27,136,0,63,296,359,64,42,106,465,28,154,PA - State College
19,1969-1970,1969-10-23,1970-04-07,167,0,78,380,458,133,387,520,978,49,297,PA - State College
20,1970-1971,1970-11-24,1971-03-30,127,0,71,287,358,102,227,329,687,32,192,PA - State College
21,1971-1972,1971-11-10,1972-04-08,151,0,48,295,343,86,170,256,599,39,204,PA - State College
22,1972-1973,1972-10-19,1973-04-11,175,0,43,243,286,54,65,119,405,27,126,PA - State College
25,1975-1976,1975-12-01,1976-04-05,127,0,59,258,317,77,142,219,536,41,219,PA - State College
26,1976-1977,1976-11-04,1977-04-07,155,0,125,417,542,68,247,315,857,38,228,PA - State College
28,1978-1979,1978-11-26,1979-03-27,122,4,96,307,403,69,229,298,701,35,230,PA - State College
29,1979-1980,1979-11-30,1980-03-23,115,0,53,267,320,36,29,65,385,25,128,PA - State College
30,1980-1981,1980-11-18,1981-03-21,124,1,81,338,419,63,123,186,605,31,182,PA - State College
31,1981-1982,1981-11-21,1982-04-10,141,1,81,392,473,105,248,353,826,48,283,PA - State College
32,1982-1983,1982-11-16,1983-03-28,133,2,39,223,262,31,63,94,356,11,65,PA - State College
33,1983-1984,1983-11-04,1984-03-31,149,3,84,376,460,80,177,257,717,37,199,PA - State College
34,1984-1985,1984-11-13,1985-04-10,149,2,66,325,391,47,133,180,571,30,140,PA - State College
35,1985-1986,1985-12-01,1986-04-11,132,4,71,312,383,65,139,204,587,31,190,PA - State College
36,1986-1987,1986-11-11,1987-04-04,145,1,29,299,328,76,183,259,587,21,113,PA - State College
37,1987-1988,1987-11-11,1988-04-17,159,0,62,357,419,62,91,153,572,32,178,PA - State College
38,1988-1989,1988-11-29,1989-04-10,133,1,42,307,349,40,45,85,434,21,135,PA - State College
39,1989-1990,1989-11-17,1990-04-12,147,0,62,283,345,71,81,152,497,43,194,PA - State College
40,1990-1991,1990-11-12,1991-04-02,142,0,30,224,254,55,64,119,373,25,120,PA - State College
41,1991-1992,1991-11-12,1992-04-03,144,0,44,253,297,45,47,92,389,24,135,PA - State College
42,1992-1993,1992-12-01,1993-04-23,144,0,48,268,316,142,311,453,769,40,259,PA - State College
43,1993-1994,1993-11-01,1994-03-31,151,0,99,362,461,159,556,715,1176,45,350,PA - State College
44,1994-1995,1994-11-24,1995-04-05,133,0,46,243,289,39,58,97,386,21,119,PA - State College
45,1995-1996,1995-11-12,1996-04-17,158,1,98,359,457,150,358,508,965,48,307,PA - State College
46,1996-1997,1996-11-03,1997-04-09,158,0,43,276,319,61,126,187,506,23,124,PA - State College
47,1997-1998,1997-11-14,1998-03-23,130,0,15,160,175,72,74,146,321,25,109,PA - State College
48,1998-1999,1998-12-01,1999-03-22,112,0,39,223,262,54,122,176,438,22,135,PA - State College
49,1999-2000,1999-11-30,2000-04-09,132,0,43,219,262,34,96,130,392,22,126,PA - State College
50,2000-2001,2000-11-22,2001-03-27,126,0,59,287,346,51,143,194,540,23,127,PA - State College
51,2001-2002,2001-12-01,2002-03-26,116,0,23,144,167,36,26,62,229,15,69,PA - State College
52,2002-2003,2002-10-30,2003-04-08,161,0,79,322,401,119,252,371,772,44,256,PA - State College
53,2003-2004,2003-11-14,2004-03-23,131,0,69,275,344,105,362,467,811,33,229,PA - State College
54,2004-2005,2004-12-01,2005-04-25,146,3,49,254,303,58,110,168,471,27,120,PA - State College
55,2005-2006,2005-10-26,2006-04-05,162,1,34,225,259,51,102,153,412,30,124,PA - State College
56,2006-2007,2006-12-01,2007-04-08,129,0,60,243,303,62,111,173,476,30,183,PA - State College
57,2007-2008,2007-11-18,2008-03-23,127,0,34,219,253,70,106,176,429,34,160,PA - State College
58,2008-2009,2008-10-30,2009-03-04,126,0,60,262,322,47,105,152,474,32,145,PA - State College
59,2009-2010,2009-10-16,2010-03-08,144,0,49,219,268,73,231,304,572,29,147,PA - State College
60,2010-2011,2010-12-01,2011-03-31,121,0,51,278,329,64,189,253,582,28,150,PA - State College
61,2011-2012,2011-10-30,2012-02-29,123,2,15,137,152,32,27,59,211,18,71,PA - State College
62,2012-2013,2012-11-27,2013-03-26,120,0,45,191,236,69,118,187,423,34,158,PA - State College
63,2013-2014,2013-11-12,2014-03-27,136,0,103,376,479,83,224,307,786,37,256,PA - State College
64,2014-2015,2014-11-19,2015-04-01,134,0,92,354,446,81,274,355,801,40,250,PA - State College
65,2015-2016,2015-12-01,2016-04-10,132,0,45,195,240,34,43,77,317,17,97,PA - State College
66,2016-2017,2016-11-21,2017-03-19,119,0,40,177,217,55,71,126,343,24,114,PA - State College
67,2017-2018,2017-11-11,2018-04-10,151,0,80,284,364,54,86,140,504,27,137,PA - State College
68,2018-2019,2018-11-10,2019-03-12,123,0,57,228,285,60,166,226,511,21,135,PA - State College
69,2019-2020,2019-11-14,2020-04-18,157,1,19,176,195,26,14,40,235,18,58,PA - State College
0,1950-1951,1950-11-21,1951-03-22,122,0,38,261,299,67,171,238,537,35,159,PA - Williamsport
1,1951-1952,1951-11-03,1952-03-19,138,0,27,265,292,84,148,232,524,38,174,PA - Williamsport
2,1952-1953,1952-10-20,1953-04-18,181,0,12,192,204,39,25,64,268,24,87,PA - Williamsport
3,1953-1954,1953-11-06,1954-03-05,120,0,29,202,231,46,60,106,337,18,90,PA - Williamsport
4,1954-1955,1954-11-02,1955-03-26,145,0,35,243,278,60,42,102,380,37,160,PA - Williamsport
5,1955-1956,1955-11-10,1956-04-23,166,0,35,289,324,74,85,159,483,40,173,PA - Williamsport
6,1956-1957,1956-11-17,1957-04-08,143,0,28,240,268,77,93,170,438,37,154,PA - Williamsport
7,1957-1958,1957-11-26,1958-04-08,134,0,42,233,275,79,158,237,512,29,137,PA - Williamsport
8,1958-1959,1958-11-02,1959-04-13,163,0,52,332,384,56,67,123,507,31,127,PA - Williamsport
9,1959-1960,1959-11-18,1960-04-09,144,0,29,245,274,79,131,210,484,28,145,PA - Williamsport
10,1960-1961,1960-12-01,1961-04-18,139,0,76,366,442,113,400,513,955,35,237,PA - Williamsport
11,1961-1962,1961-11-09,1962-04-15,158,0,44,302,346,72,103,175,521,36,176,PA - Williamsport
12,1962-1963,1962-10-26,1963-03-19,145,0,76,390,466,86,293,379,845,40,244,PA - Williamsport
13,1963-1964,1963-11-29,1964-04-09,133,0,43,299,342,110,282,392,734,32,194,PA - Williamsport
14,1964-1965,1964-12-01,1965-04-18,139,0,57,303,360,43,48,91,451,29,134,PA - Williamsport
15,1965-1966,1965-12-01,1966-04-01,122,0,34,229,263,60,152,212,475,24,131,PA - Williamsport
16,1966-1967,1966-11-29,1967-04-27,150,0,53,284,337,99,132,231,568,42,216,PA - Williamsport
17,1967-1968,1967-11-14,1968-03-24,132,0,52,306,358,47,129,176,534,25,131,PA - Williamsport
18,1968-1969,1968-11-12,1969-03-11,120,0,31,244,275,36,22,58,333,22,84,PA - Williamsport
19,1969-1970,1969-11-15,1970-04-01,138,0,59,396,455,121,410,531,986,47,290,PA - Williamsport
20,1970-1971,1970-11-24,1971-03-30,127,0,53,247,300,99,201,300,600,45,192,PA - Williamsport
21,1971-1972,1971-11-09,1972-04-08,152,0,41,289,330,96,171,267,597,44,200,PA - Williamsport
22,1972-1973,1972-10-18,1973-03-18,152,0,34,234,268,51,66,117,385,24,103,PA - Williamsport
23,1973-1974,1973-11-09,1974-04-10,153,0,42,236,278,64,102,166,444,27,136,PA - Williamsport
24,1974-1975,1974-11-26,1975-04-04,130,0,22,192,214,60,124,184,398,28,115,PA - Williamsport
25,1975-1976,1975-11-25,1976-03-18,115,0,44,227,271,49,81,130,401,27,110,PA - Williamsport
26,1976-1977,1976-11-05,1977-05-09,186,0,90,390,480,64,202,266,746,34,180,PA - Williamsport
27,1977-1978,1977-10-16,1978-04-03,170,0,87,350,437,124,490,614,1051,42,256,PA - Williamsport
28,1978-1979,1978-11-21,1979-04-08,139,0,76,281,357,64,144,208,565,33,194,PA - Williamsport
29,1979-1980,1979-12-01,1980-03-22,113,0,37,242,279,38,39,77,356,21,90,PA - Williamsport
30,1980-1981,1980-11-17,1981-03-21,125,0,74,358,432,65,190,255,687,28,166,PA - Williamsport
31,1981-1982,1981-12-01,1982-04-10,131,0,69,315,384,78,245,323,707,30,174,PA - Williamsport
32,1982-1983,1982-12-01,1983-04-20,141,0,20,185,205,30,58,88,293,14,56,PA - Williamsport
33,1983-1984,1983-12-01,1984-04-02,124,0,84,307,391,58,167,225,616,26,157,PA - Williamsport
34,1984-1985,1984-12-01,1985-04-03,124,0,46,233,279,41,107,148,427,19,101,PA - Williamsport
35,1985-1986,1985-12-01,1986-03-08,98,0,47,242,289,53,140,193,482,27,149,PA - Williamsport
36,1986-1987,1986-11-05,1987-03-10,126,0,31,268,299,77,226,303,602,15,104,PA - Williamsport
37,1987-1988,1987-11-06,1988-03-20,136,0,47,284,331,54,110,164,495,25,114,PA - Williamsport
38,1988-1989,1988-12-01,1989-03-21,111,0,29,236,265,15,5,20,285,13,50,PA - Williamsport
39,1989-1990,1989-11-18,1990-04-07,141,0,44,281,325,54,67,121,446,29,143,PA - Williamsport
40,1990-1991,1990-12-01,1991-04-01,122,0,14,190,204,44,47,91,295,23,98,PA - Williamsport
41,1991-1992,1991-12-01,1992-04-03,125,0,23,217,240,38,29,67,307,22,97,PA - Williamsport
42,1992-1993,1992-12-01,1993-04-22,143,0,23,252,275,83,180,263,538,30,150,PA - Williamsport
43,1993-1994,1993-10-31,1994-03-25,146,0,84,377,461,115,551,666,1127,36,261,PA - Williamsport
44,1994-1995,1994-11-23,1995-04-08,137,0,26,247,273,24,39,63,336,15,73,PA - Williamsport
45,1995-1996,1995-11-08,1996-04-09,154,19,85,373,458,127,260,387,845,49,288,PA - Williamsport
54,2004-2005,2004-12-01,2005-03-24,114,0,50,256,306,55,103,158,464,26,141,PA - Williamsport
55,2005-2006,2005-11-23,2006-04-05,134,1,31,229,260,41,83,124,384,22,100,PA - Williamsport
56,2006-2007,2006-12-01,2007-04-08,129,0,43,235,278,46,103,149,427,20,108,PA - Williamsport
57,2007-2008,2007-11-18,2008-03-03,107,0,28,194,222,48,82,130,352,24,110,PA - Williamsport
58,2008-2009,2008-11-20,2009-03-03,104,0,45,251,296,46,134,180,476,27,120,PA - Williamsport
59,2009-2010,2009-10-15,2010-03-03,140,0,24,177,201,54,99,153,354,24,100,PA - Williamsport
60,2010-2011,2010-11-25,2011-03-24,120,0,41,267,308,73,186,259,567,34,166,PA - Williamsport
61,2011-2012,2011-10-29,2012-03-04,128,0,10,144,154,22,27,49,203,13,47,PA - Williamsport
62,2012-2013,2012-11-27,2013-03-25,119,0,30,188,218,49,95,144,362,22,106,PA - Williamsport
63,2013-2014,2013-11-12,2014-03-16,125,0,82,369,451,74,172,246,697,31,178,PA - Williamsport
64,2014-2015,2014-11-18,2015-04-01,135,0,58,350,408,66,235,301,709,28,176,PA - Williamsport
65,2015-2016,2015-12-01,2016-04-09,131,0,23,163,186,17,13,30,216,13,55,PA - Williamsport
66,2016-2017,2016-11-19,2017-03-20,122,0,24,161,185,66,77,143,328,22,109,PA - Williamsport
67,2017-2018,2017-11-19,2018-04-06,139,0,42,243,285,44,65,109,394,25,113,PA - Williamsport
68,2018-2019,2018-11-15,2019-03-10,116,0,32,213,245,49,92,141,386,18,93,PA - Williamsport
69,2019-2020,2019-11-12,2020-04-17,158,0,9,182,191,25,21,46,237,17,53,PA - Williamsport
0,1950-1951,1950-12-01,1951-03-22,112,1,21,198,219,23,17,40,259,12,61,RI - Kingston
1,1951-1952,1951-11-20,1952-03-16,118,1,17,221,238,38,49,87,325,14,65,RI - Kingston
5,1955-1956,1955-11-19,1956-03-30,133,3,29,305,334,76,154,230,564,17,126,RI - Kingston
6,1956-1957,1956-12-01,1957-04-05,126,1,19,258,277,41,121,162,439,14,81,RI - Kingston
7,1957-1958,1957-12-01,1958-04-11,132,1,25,233,258,46,88,134,392,12,79,RI - Kingston
8,1958-1959,1958-12-01,1959-03-29,119,2,36,322,358,29,66,95,453,13,61,RI - Kingston
9,1959-1960,1959-12-01,1960-04-07,129,4,14,265,279,57,161,218,497,17,110,RI - Kingston
11,1961-1962,1961-12-01,1962-03-10,100,2,27,248,275,52,184,236,511,14,88,RI - Kingston
12,1962-1963,1962-11-19,1963-03-21,123,0,40,302,342,31,47,78,420,15,69,RI - Kingston
13,1963-1964,1963-12-01,1964-03-04,95,0,29,271,300,70,270,340,640,16,113,RI - Kingston
14,1964-1965,1964-12-01,1965-03-29,119,0,40,296,336,71,219,290,626,19,131,RI - Kingston
15,1965-1966,1965-12-01,1966-03-14,104,0,14,228,242,38,120,158,400,10,61,RI - Kingston
16,1966-1967,1966-12-01,1967-03-27,117,1,15,271,286,77,137,214,500,21,130,RI - Kingston
17,1967-1968,1967-11-16,1968-02-29,106,0,35,305,340,50,105,155,495,13,90,RI - Kingston
18,1968-1969,1968-12-01,1969-03-30,120,1,25,272,297,41,156,197,494,8,53,RI - Kingston
19,1969-1970,1969-12-01,1970-04-01,122,0,37,336,373,58,134,192,565,21,121,RI - Kingston
20,1970-1971,1970-12-01,1971-03-11,101,0,40,270,310,37,80,117,427,14,73,RI - Kingston
21,1971-1972,1971-12-01,1972-03-15,106,3,19,247,266,30,42,72,338,12,64,RI - Kingston
22,1972-1973,1972-12-01,1973-04-08,129,8,25,195,220,15,10,25,245,9,37,RI - Kingston
23,1973-1974,1973-12-01,1974-04-10,131,1,23,236,259,43,123,166,425,13,91,RI - Kingston
24,1974-1975,1974-11-26,1975-03-11,106,0,9,204,213,37,78,115,328,9,67,RI - Kingston
25,1975-1976,1975-12-01,1976-03-18,109,0,29,257,286,43,74,117,403,10,74,RI - Kingston
27,1977-1978,1977-12-01,1978-03-19,109,0,45,355,400,84,285,369,769,18,140,RI - Kingston
28,1978-1979,1978-11-27,1979-02-28,94,0,48,250,298,23,59,82,380,11,66,RI - Kingston
29,1979-1980,1979-12-01,1980-03-25,116,0,21,251,272,16,7,23,295,10,36,RI - Kingston
30,1980-1981,1980-12-01,1981-03-07,97,0,38,301,339,21,91,112,451,12,74,RI - Kingston
31,1981-1982,1981-12-01,1982-04-09,130,1,36,298,334,58,156,214,548,17,113,RI - Kingston
32,1982-1983,1982-12-01,1983-02-28,90,1,17,178,195,49,106,155,350,9,68,RI - Kingston
33,1983-1984,1983-12-01,1984-03-30,121,0,33,265,298,31,85,116,414,9,57,RI - Kingston
34,1984-1985,1984-12-01,1985-03-18,108,0,24,247,271,27,88,115,386,11,63,RI - Kingston
35,1985-1986,1985-12-01,1986-03-08,98,0,21,252,273,19,35,54,327,10,48,RI - Kingston
36,1986-1987,1986-11-19,1987-03-21,123,0,9,274,283,46,134,180,463,20,87,RI - Kingston
37,1987-1988,1987-11-12,1988-03-05,115,0,20,270,290,45,98,143,433,11,74,RI - Kingston
38,1988-1989,1988-12-01,1989-03-08,98,0,17,234,251,13,13,26,277,6,37,RI - Kingston
39,1989-1990,1989-11-23,1990-04-07,136,0,38,304,342,56,113,169,511,19,127,RI - Kingston
40,1990-1991,1990-12-01,1991-03-15,105,0,6,194,200,26,20,46,246,8,40,RI - Kingston
41,1991-1992,1991-12-01,1992-04-17,139,0,15,274,289,27,24,51,340,11,60,RI - Kingston
42,1992-1993,1992-12-01,1993-03-20,110,3,19,254,273,46,54,100,373,16,86,RI - Kingston
43,1993-1994,1993-12-01,1994-03-19,109,3,48,329,377,78,227,305,682,22,162,RI - Kingston
44,1994-1995,1994-12-01,1995-02-28,90,1,14,169,183,18,15,33,216,6,30,RI - Kingston
45,1995-1996,1995-11-29,1996-04-10,134,4,36,327,363,107,268,375,738,24,189,RI - Kingston
46,1996-1997,1996-11-27,1997-04-02,127,3,13,195,208,38,34,72,280,10,56,RI - Kingston
47,1997-1998,1997-12-01,1998-03-12,102,0,4,134,138,10,8,18,156,4,15,RI - Kingston
48,1998-1999,1998-12-01,1999-03-16,106,3,13,204,217,52,46,98,315,13,86,RI - Kingston
49,1999-2000,1999-12-01,2000-03-18,109,0,21,199,220,22,31,53,273,8,47,RI - Kingston
50,2000-2001,2000-12-01,2001-03-27,117,2,8,239,247,56,93,149,396,22,90,RI - Kingston
51,2001-2002,2001-12-01,2002-03-18,108,0,0,153,153,14,9,23,176,7,26,RI - Kingston
52,2002-2003,2002-11-27,2003-04-08,133,10,34,328,362,73,159,232,594,28,158,RI - Kingston
53,2003-2004,2003-12-01,2004-03-20,111,0,38,254,292,54,96,150,442,18,97,RI - Kingston
54,2004-2005,2004-11-13,2005-03-24,132,8,23,283,306,103,247,350,656,24,181,RI - Kingston
55,2005-2006,2005-12-01,2006-03-06,96,3,7,188,195,38,52,90,285,9,62,RI - Kingston
56,2006-2007,2006-12-01,2007-03-20,110,0,17,213,230,20,16,36,266,7,29,RI - Kingston
57,2007-2008,2007-12-01,2008-03-01,92,2,10,190,200,22,51,73,273,10,43,RI - Kingston
58,2008-2009,2008-12-01,2009-03-07,97,0,21,236,257,67,170,237,494,18,119,RI - Kingston
59,2009-2010,2009-12-01,2010-03-03,93,2,13,195,208,51,131,182,390,13,76,RI - Kingston
61,2011-2012,2011-10-30,2012-02-29,123,0,4,155,159,20,17,37,196,5,28,RI - Kingston
62,2012-2013,2012-11-28,2013-03-19,112,0,15,194,209,64,111,175,384,19,113,RI - Kingston
63,2013-2014,2013-12-01,2014-03-26,116,0,24,308,332,65,160,225,557,23,146,RI - Kingston
64,2014-2015,2014-11-14,2015-03-29,136,0,26,362,388,90,309,399,787,29,191,RI - Kingston
65,2015-2016,2015-12-01,2016-04-05,127,0,9,180,189,43,67,110,299,16,83,RI - Kingston
66,2016-2017,2016-12-01,2017-03-16,106,0,8,190,198,64,99,163,361,14,105,RI - Kingston
67,2017-2018,2017-12-01,2018-04-06,127,0,30,243,273,74,88,162,435,21,131,RI - Kingston
68,2018-2019,2018-11-16,2019-03-23,128,0,10,237,247,29,37,66,313,9,42,RI - Kingston
69,2019-2020,2019-12-01,2020-03-07,98,0,3,147,150,20,19,39,189,8,31,RI - Kingston
24,1974-1975,1974-11-21,1975-04-27,158,3,34,286,320,60,145,205,525,32,140,RI - North Foster
25,1975-1976,1975-11-24,1976-03-19,117,0,63,325,388,76,119,195,583,35,230,RI - North Foster
26,1976-1977,1976-11-10,1977-05-10,182,0,90,418,508,125,551,676,1184,34,238,RI - North Foster
27,1977-1978,1977-11-26,1978-03-27,122,0,78,369,447,134,633,767,1214,27,228,RI - North Foster
28,1978-1979,1978-11-21,1979-04-10,141,0,81,336,417,55,119,174,591,23,132,RI - North Foster
29,1979-1980,1979-10-10,1980-03-25,168,0,50,324,374,36,36,72,446,15,87,RI - North Foster
30,1980-1981,1980-11-17,1981-03-21,125,0,76,377,453,53,182,235,688,24,160,RI - North Foster
31,1981-1982,1981-12-01,1982-04-10,131,1,67,351,418,111,364,475,893,34,226,RI - North Foster
32,1982-1983,1982-12-01,1983-04-19,140,0,41,235,276,69,265,334,610,16,123,RI - North Foster
33,1983-1984,1983-11-25,1984-04-03,131,2,57,320,377,85,188,273,650,27,176,RI - North Foster
34,1984-1985,1984-11-20,1985-04-08,140,0,56,312,368,51,210,261,629,24,155,RI - North Foster
35,1985-1986,1985-11-16,1986-04-11,147,0,48,323,371,49,84,133,504,31,153,RI - North Foster
36,1986-1987,1986-11-11,1987-04-30,171,5,30,321,351,118,568,686,1037,31,193,RI - North Foster
37,1987-1988,1987-11-10,1988-03-21,133,3,46,315,361,85,268,353,714,25,148,RI - North Foster
38,1988-1989,1988-12-01,1989-04-10,131,1,41,299,340,29,29,58,398,22,110,RI - North Foster
39,1989-1990,1989-11-20,1990-04-07,139,5,61,340,401,83,160,243,644,26,171,RI - North Foster
40,1990-1991,1990-11-12,1991-03-30,139,0,27,254,281,57,76,133,414,19,102,RI - North Foster
41,1991-1992,1991-11-11,1992-04-17,159,0,37,313,350,56,81,137,487,28,137,RI - North Foster
42,1992-1993,1992-11-15,1993-04-27,164,0,48,336,384,115,384,499,883,37,231,RI - North Foster
43,1993-1994,1993-11-24,1994-03-30,127,3,85,368,453,126,554,680,1133,43,316,RI - North Foster
44,1994-1995,1994-11-23,1995-05-01,160,0,35,277,312,36,75,111,423,20,80,RI - North Foster
45,1995-1996,1995-11-13,1996-04-12,152,1,63,379,442,176,489,665,1107,41,331,RI - North Foster
46,1996-1997,1996-11-15,1997-04-06,143,1,29,258,287,110,144,254,541,29,177,RI - North Foster
47,1997-1998,1997-11-14,1998-03-23,130,0,17,207,224,48,105,153,377,24,92,RI - North Foster
48,1998-1999,1998-12-01,1999-03-17,107,0,25,227,252,74,85,159,411,23,147,RI - North Foster
49,1999-2000,1999-11-29,2000-04-26,150,1,42,269,311,39,171,210,521,16,97,RI - North Foster
50,2000-2001,2000-11-24,2001-04-18,146,0,46,314,360,119,603,722,1082,40,219,RI - North Foster
51,2001-2002,2001-12-01,2002-04-25,146,0,7,197,204,55,75,130,334,23,97,RI - North Foster
52,2002-2003,2002-11-27,2003-04-09,134,0,69,367,436,128,583,711,1147,39,249,RI - North Foster
53,2003-2004,2003-10-23,2004-03-23,153,5,75,332,407,60,312,372,779,21,140,RI - North Foster
54,2004-2005,2004-11-12,2005-03-27,136,0,55,310,365,143,435,578,943,41,292,RI - North Foster
55,2005-2006,2005-10-29,2006-04-08,162,1,35,267,302,81,205,286,588,19,129,RI - North Foster
56,2006-2007,2006-12-01,2007-03-25,115,0,47,260,307,45,77,122,429,21,96,RI - North Foster
57,2007-2008,2007-11-20,2008-03-19,121,1,35,243,278,79,240,319,597,27,146,RI - North Foster
58,2008-2009,2008-11-19,2009-03-09,111,0,60,299,359,90,313,403,762,24,172,RI - North Foster
59,2009-2010,2009-10-15,2010-03-05,142,0,41,226,267,93,236,329,596,27,147,RI - North Foster
60,2010-2011,2010-11-08,2011-04-01,145,1,56,323,379,113,535,648,1027,29,196,RI - North Foster
61,2011-2012,2011-10-27,2012-03-31,157,0,15,188,203,37,50,87,290,13,66,RI - North Foster
62,2012-2013,2012-11-07,2013-03-22,136,0,34,225,259,104,291,395,654,28,172,RI - North Foster
63,2013-2014,2013-11-12,2014-04-16,156,0,71,371,442,98,361,459,901,32,238,RI - North Foster
64,2014-2015,2014-11-14,2015-04-05,143,0,88,393,481,151,623,774,1255,38,320,RI - North Foster
65,2015-2016,2015-12-01,2016-04-06,128,0,28,188,216,75,125,200,416,19,139,RI - North Foster
66,2016-2017,2016-11-20,2017-03-31,132,0,34,233,267,91,207,298,565,22,155,RI - North Foster
67,2017-2018,2017-12-01,2018-04-15,136,0,61,263,324,126,259,385,709,33,198,RI - North Foster
68,2018-2019,2018-11-15,2019-03-23,129,0,42,269,311,68,135,203,514,23,124,RI - North Foster
69,2019-2020,2019-11-13,2020-04-19,159,1,19,208,227,45,74,119,346,16,77,RI - North Foster
0,1950-1951,1950-12-01,1951-03-22,112,0,23,160,183,32,30,62,245,13,66,RI - Providence
1,1951-1952,1951-11-20,1952-03-16,118,3,24,194,218,48,75,123,341,23,86,RI - Providence
2,1952-1953,1952-12-01,1953-04-14,135,0,8,154,162,39,33,72,234,15,57,RI - Providence
3,1953-1954,1953-12-01,1954-04-01,122,0,26,201,227,28,60,88,315,14,77,RI - Providence
4,1954-1955,1954-12-01,1955-03-26,116,0,30,210,240,32,41,73,313,16,79,RI - Providence
5,1955-1956,1955-11-19,1956-04-09,143,0,40,263,303,81,123,204,507,28,147,RI - Providence
6,1956-1957,1956-12-01,1957-04-05,126,0,31,228,259,54,95,149,408,22,104,RI - Providence
7,1957-1958,1957-11-26,1958-04-11,137,0,33,196,229,56,78,134,363,20,102,RI - Providence
8,1958-1959,1958-11-30,1959-03-29,120,3,48,300,348,43,61,104,452,22,108,RI - Providence
9,1959-1960,1959-11-18,1960-03-25,129,0,22,206,228,65,115,180,408,26,130,RI - Providence
10,1960-1961,1960-12-01,1961-04-13,134,0,53,295,348,92,298,390,738,23,163,RI - Providence
11,1961-1962,1961-11-20,1962-04-16,148,1,32,247,279,65,218,283,562,21,118,RI - Providence
12,1962-1963,1962-10-26,1963-03-22,148,0,46,278,324,49,52,101,425,25,112,RI - Providence
13,1963-1964,1963-12-01,1964-03-12,103,0,43,246,289,69,188,257,546,22,141,RI - Providence
14,1964-1965,1964-12-01,1965-03-30,120,0,46,254,300,70,161,231,531,27,145,RI - Providence
15,1965-1966,1965-12-01,1966-03-16,106,0,22,188,210,51,114,165,375,21,91,RI - Providence
16,1966-1967,1966-12-01,1967-04-08,129,0,36,247,283,82,133,215,498,30,165,RI - Providence
17,1967-1968,1967-11-15,1968-03-14,121,0,49,286,335,60,123,183,518,22,123,RI - Providence
18,1968-1969,1968-11-13,1969-03-30,138,0,37,240,277,52,156,208,485,17,76,RI - Providence
19,1969-1970,1969-12-01,1970-04-02,123,0,59,301,360,69,166,235,595,29,172,RI - Providence
20,1970-1971,1970-12-01,1971-04-07,128,0,57,267,324,63,115,178,502,29,136,RI - Providence
21,1971-1972,1971-12-01,1972-04-08,130,0,31,244,275,47,50,97,372,25,112,RI - Providence
22,1972-1973,1972-10-19,1973-04-08,172,0,30,217,247,20,9,29,276,16,50,RI - Providence
23,1973-1974,1973-12-01,1974-04-10,131,0,31,199,230,41,127,168,398,16,93,RI - Providence
24,1974-1975,1974-11-26,1975-04-05,131,0,17,195,212,41,59,100,312,17,87,RI - Providence
25,1975-1976,1975-11-24,1976-03-19,117,0,45,264,309,57,61,118,427,22,149,RI - Providence
26,1976-1977,1976-11-30,1977-05-10,162,1,66,314,380,72,152,224,604,24,135,RI - Providence
27,1977-1978,1977-11-28,1978-03-19,112,0,64,303,367,102,302,404,771,21,174,RI - Providence
28,1978-1979,1978-11-21,1979-04-10,141,0,69,287,356,28,33,61,417,17,79,RI - Providence
29,1979-1980,1979-12-01,1980-03-25,116,0,34,231,265,16,14,30,295,9,35,RI - Providence
30,1980-1981,1980-11-17,1981-03-16,120,0,50,297,347,35,76,111,458,21,117,RI - Providence
31,1981-1982,1981-12-01,1982-04-09,130,0,56,265,321,71,157,228,549,25,137,RI - Providence
32,1982-1983,1982-12-01,1983-02-28,90,0,23,137,160,44,112,156,316,9,68,RI - Providence
33,1983-1984,1983-12-01,1984-04-01,123,0,46,230,276,50,95,145,421,16,92,RI - Providence
34,1984-1985,1984-12-01,1985-03-18,108,1,43,208,251,35,76,111,362,15,89,RI - Providence
35,1985-1986,1985-11-26,1986-03-21,116,0,30,232,262,34,31,65,327,21,90,RI - Providence
36,1986-1987,1986-11-11,1987-04-29,170,0,19,231,250,63,161,224,474,24,105,RI - Providence
37,1987-1988,1987-11-11,1988-03-21,132,0,28,238,266,58,125,183,449,20,98,RI - Providence
38,1988-1989,1988-12-01,1989-04-10,131,0,26,216,242,21,18,39,281,15,66,RI - Providence
39,1989-1990,1989-11-23,1990-04-07,136,0,41,251,292,76,123,199,491,21,144,RI - Providence
40,1990-1991,1990-12-01,1991-03-16,106,0,14,165,179,35,35,70,249,14,62,RI - Providence
41,1991-1992,1991-12-01,1992-04-16,138,0,20,209,229,33,26,59,288,16,73,RI - Providence
42,1992-1993,1992-12-01,1993-04-27,148,0,28,235,263,60,65,125,388,30,131,RI - Providence
43,1993-1994,1993-12-01,1994-03-29,119,0,64,271,335,94,225,319,654,35,216,RI - Providence
44,1994-1995,1994-11-27,1995-04-08,133,0,16,176,192,22,29,51,243,12,39,RI - Providence
47,1997-1998,1997-11-23,1998-03-14,112,5,7,132,139,10,5,15,154,8,21,RI - Providence
51,2001-2002,2001-12-01,2002-03-19,109,0,2,132,134,16,11,27,161,9,28,RI - Providence
52,2002-2003,2002-11-27,2003-04-08,133,0,55,269,324,82,117,199,523,25,147,RI - Providence
53,2003-2004,2003-12-01,2004-03-20,111,0,46,212,258,56,62,118,376,17,95,RI - Providence
54,2004-2005,2004-11-12,2005-03-24,133,0,34,234,268,100,201,301,569,30,186,RI - Providence
55,2005-2006,2005-11-24,2006-04-08,136,0,15,179,194,47,45,92,286,15,71,RI - Providence
56,2006-2007,2006-12-01,2007-03-24,114,0,27,185,212,23,9,32,244,13,42,RI - Providence
57,2007-2008,2007-12-01,2008-03-01,92,0,13,150,163,39,58,97,260,14,70,RI - Providence
58,2008-2009,2008-11-22,2009-03-07,106,0,42,223,265,74,130,204,469,20,138,RI - Providence
59,2009-2010,2009-12-01,2010-03-03,93,0,22,164,186,46,54,100,286,17,76,RI - Providence
60,2010-2011,2010-11-08,2011-03-31,144,0,31,244,275,76,179,255,530,23,128,RI - Providence
61,2011-2012,2011-10-29,2012-03-01,125,0,10,133,143,27,21,48,191,10,47,RI - Providence
62,2012-2013,2012-11-07,2013-03-19,133,0,19,169,188,69,80,149,337,25,125,RI - Providence
63,2013-2014,2013-11-12,2014-04-16,156,0,49,295,344,64,107,171,515,27,162,RI - Providence
64,2014-2015,2014-11-14,2015-03-29,136,0,55,317,372,114,354,468,840,38,261,RI - Providence
65,2015-2016,2015-12-01,2016-04-04,126,0,18,146,164,39,51,90,254,12,69,RI - Providence
66,2016-2017,2016-12-01,2017-03-16,106,0,22,160,182,59,75,134,316,14,99,RI - Providence
67,2017-2018,2017-12-01,2018-04-06,127,0,41,195,236,72,65,137,373,24,114,RI - Providence
68,2018-2019,2018-11-15,2019-03-23,129,0,27,210,237,40,46,86,323,14,72,RI - Providence
69,2019-2020,2019-11-13,2020-04-18,158,2,8,144,152,22,7,29,181,14,41,RI - Providence
0,1950-1951,1950-12-01,1951-02-28,90,0,0,40,40,0,0,0,40,0,0,SC - Charleston
1,1951-1952,1951-12-01,1952-02-29,91,0,0,17,17,0,0,0,17,0,0,SC - Charleston
2,1952-1953,1952-12-01,1953-02-28,90,0,0,20,20,0,0,0,20,0,0,SC - Charleston
3,1953-1954,1953-12-01,1954-02-28,90,0,0,26,26,0,0,0,26,0,0,SC - Charleston
4,1954-1955,1954-12-01,1955-02-28,90,0,0,37,37,0,0,0,37,0,0,SC - Charleston
5,1955-1956,1955-12-01,1956-02-29,91,0,0,34,34,0,0,0,34,0,0,SC - Charleston
6,1956-1957,1956-12-01,1957-02-28,90,0,0,23,23,0,0,0,23,0,0,SC - Charleston
7,1957-1958,1957-12-01,1958-02-28,90,0,1,61,62,0,0,0,62,0,0,SC - Charleston
8,1958-1959,1958-12-01,1959-02-28,90,0,0,45,45,1,0,1,46,1,2,SC - Charleston
9,1959-1960,1959-12-01,1960-03-11,102,0,0,40,40,1,0,1,41,1,2,SC - Charleston
10,1960-1961,1960-12-01,1961-02-28,90,0,0,63,63,0,0,0,63,0,0,SC - Charleston
11,1961-1962,1961-12-01,1962-02-28,90,0,1,37,38,0,0,0,38,0,0,SC - Charleston
12,1962-1963,1962-12-01,1963-02-28,90,0,1,57,58,2,0,2,60,2,4,SC - Charleston
13,1963-1964,1963-12-01,1964-02-29,91,0,0,45,45,0,0,0,45,0,0,SC - Charleston
14,1964-1965,1964-12-01,1965-02-28,90,0,0,35,35,0,0,0,35,0,0,SC - Charleston
15,1965-1966,1965-12-01,1966-02-28,90,0,0,49,49,1,1,2,51,1,2,SC - Charleston
16,1966-1967,1966-12-01,1967-02-28,90,0,0,37,37,0,0,0,37,0,0,SC - Charleston
17,1967-1968,1967-12-01,1968-02-29,91,0,0,58,58,3,1,4,62,2,5,SC - Charleston
18,1968-1969,1968-12-01,1969-03-04,94,0,0,58,58,3,0,3,61,1,4,SC - Charleston
19,1969-1970,1969-12-01,1970-02-28,90,0,3,66,69,0,0,0,69,0,0,SC - Charleston
20,1970-1971,1970-12-01,1971-02-28,90,0,0,33,33,0,0,0,33,0,0,SC - Charleston
21,1971-1972,1971-12-01,1972-02-29,91,0,0,19,19,0,0,0,19,0,0,SC - Charleston
22,1972-1973,1972-12-01,1973-02-28,90,0,1,38,39,9,17,26,65,2,12,SC - Charleston
23,1973-1974,1973-12-01,1974-02-28,90,0,0,20,20,0,0,0,20,0,0,SC - Charleston
24,1974-1975,1974-12-01,1975-02-28,90,0,0,14,14,0,0,0,14,0,0,SC - Charleston
25,1975-1976,1975-12-01,1976-02-29,91,0,0,49,49,1,0,1,50,1,2,SC - Charleston
26,1976-1977,1976-12-01,1977-02-28,90,0,1,68,69,3,0,3,72,3,9,SC - Charleston
27,1977-1978,1977-12-01,1978-02-28,90,0,0,63,63,1,0,1,64,1,2,SC - Charleston
28,1978-1979,1978-12-01,1979-02-28,90,0,1,47,48,4,2,6,54,3,8,SC - Charleston
29,1979-1980,1979-12-01,1980-03-03,94,0,1,49,50,2,1,3,53,1,5,SC - Charleston
30,1980-1981,1980-12-01,1981-02-28,90,0,1,57,58,5,4,9,67,2,8,SC - Charleston
31,1981-1982,1981-12-01,1982-02-28,90,0,1,51,52,0,0,0,52,0,0,SC - Charleston
32,1982-1983,1982-12-01,1983-02-28,90,0,0,17,17,0,0,0,17,0,0,SC - Charleston
33,1983-1984,1983-12-01,1984-02-29,91,0,1,34,35,0,0,0,35,0,0,SC - Charleston
34,1984-1985,1984-12-01,1985-02-28,90,0,1,43,44,0,0,0,44,0,0,SC - Charleston
35,1985-1986,1985-12-01,1986-02-28,90,0,0,35,35,1,0,1,36,1,4,SC - Charleston
36,1986-1987,1986-12-01,1987-02-28,90,0,0,13,13,0,0,0,13,0,0,SC - Charleston
37,1987-1988,1987-12-01,1988-02-29,91,0,0,35,35,1,0,1,36,1,2,SC - Charleston
38,1988-1989,1988-12-01,1989-02-28,90,0,0,19,19,2,1,3,22,2,4,SC - Charleston
39,1989-1990,1989-12-01,1990-02-28,90,0,2,27,29,12,13,25,54,3,23,SC - Charleston
40,1990-1991,1990-12-01,1991-02-28,90,0,0,11,11,0,0,0,11,0,0,SC - Charleston
41,1991-1992,1991-12-01,1992-02-29,91,0,0,10,10,0,0,0,10,0,0,SC - Charleston
42,1992-1993,1992-12-01,1993-02-28,90,0,0,4,4,0,0,0,4,0,0,SC - Charleston
43,1993-1994,1993-12-01,1994-02-28,90,0,1,33,34,0,0,0,34,0,0,SC - Charleston
44,1994-1995,1994-12-01,1995-02-28,90,0,0,16,16,0,0,0,16,0,0,SC - Charleston
45,1995-1996,1995-12-01,1996-02-29,91,0,0,50,50,0,0,0,50,0,0,SC - Charleston
46,1996-1997,1996-12-01,1997-02-28,90,0,0,19,19,0,0,0,19,0,0,SC - Charleston
47,1997-1998,1997-12-01,1998-02-28,90,0,0,9,9,0,0,0,9,0,0,SC - Charleston
48,1998-1999,1998-12-01,1999-02-28,90,0,0,22,22,0,0,0,22,0,0,SC - Charleston
49,1999-2000,1999-12-01,2000-02-29,91,0,0,29,29,4,3,7,36,2,5,SC - Charleston
50,2000-2001,2000-12-01,2001-02-28,90,0,0,49,49,0,0,0,49,0,0,SC - Charleston
51,2001-2002,2001-12-01,2002-02-28,90,0,0,21,21,0,0,0,21,0,0,SC - Charleston
52,2002-2003,2002-12-01,2003-02-28,90,0,0,31,31,0,0,0,31,0,0,SC - Charleston
53,2003-2004,2003-12-01,2004-02-29,91,0,0,36,36,0,0,0,36,0,0,SC - Charleston
54,2004-2005,2004-12-01,2005-02-28,90,0,0,32,32,0,0,0,32,0,0,SC - Charleston
55,2005-2006,2005-12-01,2006-02-28,90,0,0,24,24,0,0,0,24,0,0,SC - Charleston
56,2006-2007,2006-12-01,2007-02-28,90,0,0,20,20,0,0,0,20,0,0,SC - Charleston
57,2007-2008,2007-12-01,2008-02-29,91,0,0,17,17,0,0,0,17,0,0,SC - Charleston
58,2008-2009,2008-12-01,2009-02-28,90,0,0,29,29,0,0,0,29,0,0,SC - Charleston
59,2009-2010,2009-12-01,2010-02-28,90,0,0,38,38,5,3,8,46,2,7,SC - Charleston
60,2010-2011,2010-12-01,2011-02-28,90,0,0,48,48,1,0,1,49,1,2,SC - Charleston
61,2011-2012,2011-12-01,2012-02-29,91,0,0,16,16,0,0,0,16,0,0,SC - Charleston
62,2012-2013,2012-12-01,2013-02-28,90,0,0,12,12,0,0,0,12,0,0,SC - Charleston
63,2013-2014,2013-12-01,2014-02-28,90,0,1,26,27,0,0,0,27,0,0,SC - Charleston
64,2014-2015,2014-12-01,2015-02-28,90,0,0,28,28,0,0,0,28,0,0,SC - Charleston
65,2015-2016,2015-12-01,2016-02-29,91,0,0,20,20,0,0,0,20,0,0,SC - Charleston
66,2016-2017,2016-12-01,2017-02-28,90,0,0,9,9,0,0,0,9,0,0,SC - Charleston
67,2017-2018,2017-12-01,2018-02-28,90,0,1,34,35,7,12,19,54,1,10,SC - Charleston
68,2018-2019,2018-12-01,2019-02-28,90,0,0,12,12,0,0,0,12,0,0,SC - Charleston
69,2019-2020,2019-12-01,2020-02-29,91,0,0,10,10,0,0,0,10,0,0,SC - Charleston
0,1950-1951,1950-11-25,1951-02-28,96,0,2,82,84,0,0,0,84,0,0,SC - Columbia
1,1951-1952,1951-12-01,1952-02-29,91,0,0,37,37,0,0,0,37,0,0,SC - Columbia
2,1952-1953,1952-12-01,1953-02-28,90,0,0,40,40,0,0,0,40,0,0,SC - Columbia
3,1953-1954,1953-12-01,1954-02-28,90,0,0,52,52,0,0,0,52,0,0,SC - Columbia
4,1954-1955,1954-12-01,1955-02-28,90,0,0,67,67,2,0,2,69,1,3,SC - Columbia
5,1955-1956,1955-12-01,1956-02-29,91,0,0,65,65,0,0,0,65,0,0,SC - Columbia
6,1956-1957,1956-12-01,1957-02-28,90,0,0,34,34,0,0,0,34,0,0,SC - Columbia
7,1957-1958,1957-12-01,1958-02-28,90,0,2,87,89,2,1,3,92,1,3,SC - Columbia
8,1958-1959,1958-12-01,1959-03-02,92,0,0,82,82,15,15,30,112,3,19,SC - Columbia
9,1959-1960,1959-12-01,1960-03-12,103,0,0,66,66,4,2,6,72,2,6,SC - Columbia
10,1960-1961,1960-12-01,1961-02-28,90,0,2,90,92,3,2,5,97,2,8,SC - Columbia
11,1961-1962,1961-12-01,1962-02-28,90,0,2,45,47,0,0,0,47,0,0,SC - Columbia
12,1962-1963,1962-12-01,1963-02-28,90,0,2,87,89,0,0,0,89,0,0,SC - Columbia
13,1963-1964,1963-12-01,1964-02-29,91,0,0,78,78,0,0,0,78,0,0,SC - Columbia
14,1964-1965,1964-12-01,1965-02-28,90,0,0,56,56,3,1,4,60,2,5,SC - Columbia
15,1965-1966,1965-12-01,1966-02-28,90,0,2,65,67,2,1,3,70,2,5,SC - Columbia
16,1966-1967,1966-12-01,1967-02-28,90,0,1,66,67,4,3,7,74,1,5,SC - Columbia
17,1967-1968,1967-12-01,1968-02-29,91,0,1,90,91,5,2,7,98,4,9,SC - Columbia
18,1968-1969,1968-12-01,1969-02-28,90,0,1,89,90,2,1,3,93,2,4,SC - Columbia
19,1969-1970,1969-12-01,1970-02-28,90,0,2,104,106,2,1,3,109,1,5,SC - Columbia
20,1970-1971,1970-12-01,1971-03-25,115,0,0,73,73,2,0,2,75,1,2,SC - Columbia
21,1971-1972,1971-12-01,1972-02-29,91,0,1,39,40,1,0,1,41,1,1,SC - Columbia
22,1972-1973,1972-12-01,1973-02-28,90,0,0,69,69,25,34,59,128,4,29,SC - Columbia
23,1973-1974,1973-12-01,1974-02-28,90,0,0,31,31,0,0,0,31,0,0,SC - Columbia
24,1974-1975,1974-12-01,1975-02-28,90,0,0,32,32,0,0,0,32,0,0,SC - Columbia
25,1975-1976,1975-12-01,1976-02-29,91,0,0,63,63,0,0,0,63,0,0,SC - Columbia
26,1976-1977,1976-12-01,1977-02-28,90,0,2,103,105,0,0,0,105,0,0,SC - Columbia
27,1977-1978,1977-12-01,1978-02-28,90,0,0,117,117,1,0,1,118,1,2,SC - Columbia
28,1978-1979,1978-12-01,1979-02-28,90,0,1,79,80,7,11,18,98,1,11,SC - Columbia
29,1979-1980,1979-12-01,1980-03-04,95,0,1,92,93,10,7,17,110,2,15,SC - Columbia
30,1980-1981,1980-12-01,1981-02-28,90,0,0,101,101,1,0,1,102,1,2,SC - Columbia
31,1981-1982,1981-12-01,1982-02-28,90,0,3,74,77,6,2,8,85,3,10,SC - Columbia
32,1982-1983,1982-12-01,1983-03-24,114,0,1,60,61,2,0,2,63,2,3,SC - Columbia
33,1983-1984,1983-12-01,1984-02-29,91,0,2,78,80,0,0,0,80,0,0,SC - Columbia
34,1984-1985,1984-12-01,1985-02-28,90,0,1,84,85,0,0,0,85,0,0,SC - Columbia
35,1985-1986,1985-12-01,1986-02-28,90,0,1,94,95,0,0,0,95,0,0,SC - Columbia
36,1986-1987,1986-12-01,1987-03-12,102,0,0,52,52,3,0,3,55,3,6,SC - Columbia
37,1987-1988,1987-12-01,1988-02-29,91,0,2,81,83,6,12,18,101,1,9,SC - Columbia
38,1988-1989,1988-12-01,1989-02-28,90,0,0,49,49,5,4,9,58,2,7,SC - Columbia
39,1989-1990,1989-12-01,1990-02-28,90,0,2,46,48,0,0,0,48,0,0,SC - Columbia
40,1990-1991,1990-12-01,1991-02-28,90,0,0,34,34,1,0,1,35,1,1,SC - Columbia
41,1991-1992,1991-12-01,1992-02-29,91,0,0,47,47,2,1,3,50,2,3,SC - Columbia
42,1992-1993,1992-12-01,1993-03-13,103,0,0,37,37,2,0,2,39,1,3,SC - Columbia
43,1993-1994,1993-12-01,1994-02-28,90,0,2,67,69,3,1,4,73,1,4,SC - Columbia
44,1994-1995,1994-12-01,1995-02-28,90,0,0,45,45,0,0,0,45,0,0,SC - Columbia
45,1995-1996,1995-12-01,1996-02-29,91,1,1,76,77,2,0,2,79,2,5,SC - Columbia
46,1996-1997,1996-12-01,1997-02-28,90,0,0,49,49,0,0,0,49,0,0,SC - Columbia
47,1997-1998,1997-12-01,1998-02-28,90,0,0,33,33,0,0,0,33,0,0,SC - Columbia
48,1998-1999,1998-12-01,1999-02-28,90,0,0,35,35,1,1,2,37,1,2,SC - Columbia
49,1999-2000,1999-12-01,2000-02-29,91,0,0,57,57,6,10,16,73,1,6,SC - Columbia
50,2000-2001,2000-12-01,2001-02-28,90,0,0,75,75,0,0,0,75,0,0,SC - Columbia
51,2001-2002,2001-12-01,2002-02-28,90,0,0,45,45,7,9,16,61,2,9,SC - Columbia
52,2002-2003,2002-12-01,2003-02-28,90,0,0,52,52,4,2,6,58,1,7,SC - Columbia
53,2003-2004,2003-12-01,2004-02-29,91,0,1,67,68,1,0,1,69,1,1,SC - Columbia
54,2004-2005,2004-12-01,2005-02-28,90,0,0,50,50,0,0,0,50,0,0,SC - Columbia
55,2005-2006,2005-12-01,2006-02-28,90,0,0,45,45,0,0,0,45,0,0,SC - Columbia
56,2006-2007,2006-12-01,2007-02-28,90,0,0,48,48,1,0,1,49,1,2,SC - Columbia
57,2007-2008,2007-12-01,2008-02-29,91,0,0,35,35,1,0,1,36,1,3,SC - Columbia
58,2008-2009,2008-12-01,2009-02-28,90,0,0,56,56,0,0,0,56,0,0,SC - Columbia
59,2009-2010,2009-12-01,2010-03-02,92,0,0,75,75,13,5,18,93,2,15,SC - Columbia
60,2010-2011,2010-12-01,2011-02-28,90,0,0,69,69,6,5,11,80,2,8,SC - Columbia
61,2011-2012,2011-12-01,2012-02-29,91,0,0,31,31,0,0,0,31,0,0,SC - Columbia
62,2012-2013,2012-12-01,2013-02-28,90,0,0,25,25,0,0,0,25,0,0,SC - Columbia
63,2013-2014,2013-12-01,2014-02-28,90,0,2,59,61,6,7,13,74,3,11,SC - Columbia
64,2014-2015,2014-12-01,2015-02-28,90,0,0,47,47,0,0,0,47,0,0,SC - Columbia
65,2015-2016,2015-12-01,2016-02-29,91,0,0,33,33,0,0,0,33,0,0,SC - Columbia
66,2016-2017,2016-12-01,2017-02-28,90,0,0,21,21,1,0,1,22,1,2,SC - Columbia
67,2017-2018,2017-12-01,2018-02-28,90,0,0,53,53,0,0,0,53,0,0,SC - Columbia
68,2018-2019,2018-12-01,2019-02-28,90,0,0,29,29,0,0,0,29,0,0,SC - Columbia
69,2019-2020,2019-12-01,2020-02-29,91,0,0,22,22,0,0,0,22,0,0,SC - Columbia
0,1950-1951,1950-11-25,1951-02-28,96,0,4,81,85,3,0,3,88,3,9,SC - Greenville
1,1951-1952,1951-12-01,1952-02-29,91,0,1,40,41,4,3,7,48,1,5,SC - Greenville
2,1952-1953,1952-12-01,1953-02-28,90,0,0,30,30,1,0,1,31,1,2,SC - Greenville
3,1953-1954,1953-12-01,1954-02-28,90,0,0,40,40,0,0,0,40,0,0,SC - Greenville
4,1954-1955,1954-12-01,1955-02-28,90,0,0,56,56,2,1,3,59,2,4,SC - Greenville
5,1955-1956,1955-12-01,1956-02-29,91,0,0,49,49,1,0,1,50,1,2,SC - Greenville
6,1956-1957,1956-12-01,1957-02-28,90,0,0,29,29,0,0,0,29,0,0,SC - Greenville
7,1957-1958,1957-12-01,1958-02-28,90,0,4,101,105,11,19,30,135,2,13,SC - Greenville
8,1958-1959,1958-12-01,1959-03-02,92,0,1,63,64,6,4,10,74,4,12,SC - Greenville
9,1959-1960,1959-12-01,1960-03-13,104,0,4,74,78,27,36,63,141,8,40,SC - Greenville
10,1960-1961,1960-12-01,1961-02-28,90,0,3,82,85,5,4,9,94,3,14,SC - Greenville
11,1961-1962,1961-12-01,1962-03-09,99,0,3,48,51,16,13,29,80,6,22,SC - Greenville
12,1962-1963,1962-12-01,1963-02-28,90,0,3,109,112,7,2,9,121,4,10,SC - Greenville
13,1963-1964,1963-12-01,1964-02-29,91,0,2,89,91,7,6,13,104,5,14,SC - Greenville
14,1964-1965,1964-12-01,1965-03-12,102,0,1,77,78,15,10,25,103,6,23,SC - Greenville
15,1965-1966,1965-12-01,1966-02-28,90,0,2,95,97,16,16,32,129,6,24,SC - Greenville
16,1966-1967,1966-12-01,1967-02-28,90,0,1,67,68,3,1,4,72,2,5,SC - Greenville
17,1967-1968,1967-12-01,1968-02-29,91,0,4,90,94,6,4,10,104,5,13,SC - Greenville
18,1968-1969,1968-11-11,1969-03-01,111,0,1,106,107,14,14,28,135,6,18,SC - Greenville
19,1969-1970,1969-12-01,1970-02-28,90,0,6,114,120,4,0,4,124,3,10,SC - Greenville
20,1970-1971,1970-12-01,1971-03-27,117,0,4,115,119,15,12,27,146,4,21,SC - Greenville
21,1971-1972,1971-12-01,1972-03-25,116,0,2,66,68,21,12,33,101,4,25,SC - Greenville
22,1972-1973,1972-12-01,1973-02-28,90,0,2,71,73,5,13,18,91,2,10,SC - Greenville
23,1973-1974,1973-12-01,1974-03-25,115,0,0,61,61,1,0,1,62,1,2,SC - Greenville
24,1974-1975,1974-12-01,1975-02-28,90,0,0,47,47,2,0,2,49,1,2,SC - Greenville
25,1975-1976,1975-12-01,1976-02-29,91,0,1,80,81,0,0,0,81,0,0,SC - Greenville
26,1976-1977,1976-11-14,1977-02-28,107,0,5,151,156,10,6,16,172,4,14,SC - Greenville
27,1977-1978,1977-12-01,1978-03-04,94,0,2,106,108,5,4,9,117,3,8,SC - Greenville
28,1978-1979,1978-12-01,1979-02-28,90,0,2,89,91,20,20,40,131,4,26,SC - Greenville
29,1979-1980,1979-12-01,1980-03-12,103,0,3,82,85,18,12,30,115,7,30,SC - Greenville
30,1980-1981,1980-12-01,1981-02-28,90,0,1,107,108,2,0,2,110,1,3,SC - Greenville
31,1981-1982,1981-12-01,1982-02-28,90,0,5,86,91,16,23,39,130,4,28,SC - Greenville
32,1982-1983,1982-12-01,1983-04-18,139,0,1,62,63,23,15,38,101,6,30,SC - Greenville
33,1983-1984,1983-12-01,1984-02-29,91,0,4,87,91,2,0,2,93,2,5,SC - Greenville
34,1984-1985,1984-12-01,1985-02-28,90,0,1,84,85,4,0,4,89,4,7,SC - Greenville
35,1985-1986,1985-12-01,1986-02-28,90,0,3,99,102,2,1,3,105,1,4,SC - Greenville
36,1986-1987,1986-12-01,1987-04-03,124,0,2,68,70,18,18,36,106,5,22,SC - Greenville
37,1987-1988,1987-11-11,1988-02-29,111,0,1,105,106,19,45,64,170,2,23,SC - Greenville
38,1988-1989,1988-12-01,1989-02-28,90,0,0,62,62,3,0,3,65,1,4,SC - Greenville
39,1989-1990,1989-12-01,1990-02-28,90,0,4,69,73,2,0,2,75,2,4,SC - Greenville
40,1990-1991,1990-12-01,1991-02-28,90,0,0,53,53,4,0,4,57,1,5,SC - Greenville
41,1991-1992,1991-12-01,1992-02-29,91,0,0,53,53,0,0,0,53,0,0,SC - Greenville
42,1992-1993,1992-12-01,1993-03-15,105,0,0,69,69,15,5,20,89,3,18,SC - Greenville
43,1993-1994,1993-12-01,1994-02-28,90,0,4,92,96,4,0,4,100,3,9,SC - Greenville
44,1994-1995,1994-12-01,1995-02-28,90,0,1,67,68,1,0,1,69,1,2,SC - Greenville
45,1995-1996,1995-12-01,1996-02-29,91,0,5,87,92,15,12,27,119,7,31,SC - Greenville
46,1996-1997,1996-12-01,1997-02-28,90,0,0,56,56,5,3,8,64,3,8,SC - Greenville
47,1997-1998,1997-12-01,1998-02-28,90,0,0,39,39,5,1,6,45,2,7,SC - Greenville
48,1998-1999,1998-12-01,1999-03-09,99,0,1,49,50,4,2,6,56,3,7,SC - Greenville
49,1999-2000,1999-12-01,2000-02-29,91,0,1,48,49,7,3,10,59,4,10,SC - Greenville
50,2000-2001,2000-11-19,2001-03-20,122,0,0,89,89,9,2,11,100,5,14,SC - Greenville
51,2001-2002,2001-12-01,2002-02-28,90,0,1,52,53,5,6,11,64,2,8,SC - Greenville
52,2002-2003,2002-12-01,2003-02-28,90,0,0,60,60,7,6,13,73,3,13,SC - Greenville
53,2003-2004,2003-12-01,2004-02-29,91,0,1,73,74,15,7,22,96,3,19,SC - Greenville
54,2004-2005,2004-12-01,2005-03-17,107,0,2,64,66,3,1,4,70,2,6,SC - Greenville
55,2005-2006,2005-12-01,2006-02-28,90,0,0,47,47,0,0,0,47,0,0,SC - Greenville
56,2006-2007,2006-12-01,2007-02-28,90,0,0,56,56,2,1,3,59,1,3,SC - Greenville
57,2007-2008,2007-12-01,2008-02-29,91,0,0,46,46,5,2,7,53,2,8,SC - Greenville
58,2008-2009,2008-12-01,2009-03-03,93,0,1,70,71,7,5,12,83,2,9,SC - Greenville
59,2009-2010,2009-12-01,2010-03-02,92,0,1,90,91,9,8,17,108,4,13,SC - Greenville
60,2010-2011,2010-12-01,2011-02-28,90,0,2,87,89,12,23,35,124,3,17,SC - Greenville
61,2011-2012,2011-12-01,2012-02-29,91,0,0,38,38,0,0,0,38,0,0,SC - Greenville
62,2012-2013,2012-12-01,2013-02-28,90,0,1,35,36,3,1,4,40,1,4,SC - Greenville
63,2013-2014,2013-11-27,2014-02-28,94,0,3,88,91,11,9,20,111,5,18,SC - Greenville
64,2014-2015,2014-12-01,2015-02-28,90,0,2,67,69,7,4,11,80,4,10,SC - Greenville
65,2015-2016,2015-12-01,2016-02-29,91,0,2,48,50,5,6,11,61,3,8,SC - Greenville
66,2016-2017,2016-12-01,2017-03-12,102,0,2,37,39,5,12,17,56,3,10,SC - Greenville
67,2017-2018,2017-12-01,2018-02-28,90,0,2,78,80,6,5,11,91,2,9,SC - Greenville
68,2018-2019,2018-12-01,2019-02-28,90,0,0,38,38,5,6,11,49,2,6,SC - Greenville
69,2019-2020,2019-12-01,2020-02-29,91,0,0,41,41,2,0,2,43,2,5,SC - Greenville
0,1950-1951,1950-10-02,1951-04-21,202,0,300,880,1180,73,382,455,1635,32,357,SD - Aberdeen
1,1951-1952,1951-10-30,1952-04-06,160,2,308,844,1152,93,806,899,2051,39,412,SD - Aberdeen
2,1952-1953,1952-11-24,1953-04-16,144,0,162,566,728,52,233,285,1013,25,235,SD - Aberdeen
3,1953-1954,1953-11-20,1954-05-03,165,0,181,600,781,64,292,356,1137,30,282,SD - Aberdeen
4,1954-1955,1954-11-01,1955-03-26,146,0,189,651,840,44,258,302,1142,23,234,SD - Aberdeen
5,1955-1956,1955-11-02,1956-04-06,157,1,324,929,1253,69,545,614,1867,30,308,SD - Aberdeen
6,1956-1957,1956-11-09,1957-04-11,154,0,205,678,883,47,119,166,1049,26,290,SD - Aberdeen
7,1957-1958,1957-10-24,1958-04-06,165,1,144,582,726,37,78,115,841,22,146,SD - Aberdeen
8,1958-1959,1958-11-23,1959-03-16,114,0,251,700,951,33,172,205,1156,25,273,SD - Aberdeen
9,1959-1960,1959-10-12,1960-04-05,177,1,258,737,995,77,472,549,1544,39,317,SD - Aberdeen
10,1960-1961,1960-11-09,1961-04-11,154,0,192,662,854,31,374,405,1259,15,131,SD - Aberdeen
11,1961-1962,1961-11-04,1962-03-31,148,3,278,767,1045,52,345,397,1442,29,289,SD - Aberdeen
12,1962-1963,1962-11-16,1963-04-22,158,1,213,677,890,28,103,131,1021,17,141,SD - Aberdeen
13,1963-1964,1963-11-21,1964-03-31,132,0,186,669,855,31,165,196,1051,15,134,SD - Aberdeen
14,1964-1965,1964-11-18,1965-04-24,158,0,335,938,1273,70,161,231,1504,41,395,SD - Aberdeen
15,1965-1966,1965-09-23,1966-05-11,231,0,252,796,1048,69,184,253,1301,35,332,SD - Aberdeen
16,1966-1967,1966-11-01,1967-05-11,192,0,167,728,895,55,130,185,1080,45,371,SD - Aberdeen
17,1967-1968,1967-10-26,1968-04-23,181,0,210,690,900,60,116,176,1076,31,242,SD - Aberdeen
18,1968-1969,1968-10-18,1969-04-07,172,0,282,765,1047,99,671,770,1817,54,474,SD - Aberdeen
19,1969-1970,1969-10-12,1970-05-01,202,1,236,790,1026,94,353,447,1473,46,324,SD - Aberdeen
20,1970-1971,1970-10-07,1971-04-27,203,0,231,754,985,72,235,307,1292,45,372,SD - Aberdeen
21,1971-1972,1971-10-28,1972-04-07,163,0,273,757,1030,76,547,623,1653,53,475,SD - Aberdeen
22,1972-1973,1972-10-30,1973-04-24,177,0,170,557,727,53,169,222,949,30,268,SD - Aberdeen
23,1973-1974,1973-11-03,1974-03-26,144,0,256,675,931,56,275,331,1262,38,348,SD - Aberdeen
24,1974-1975,1974-11-13,1975-04-10,149,0,151,629,780,86,203,289,1069,43,326,SD - Aberdeen
25,1975-1976,1975-10-24,1976-05-02,192,0,177,602,779,59,203,262,1041,33,256,SD - Aberdeen
26,1976-1977,1976-10-18,1977-04-04,169,1,239,742,981,58,165,223,1204,29,269,SD - Aberdeen
27,1977-1978,1977-10-07,1978-04-02,178,8,404,838,1242,78,603,681,1923,41,376,SD - Aberdeen
28,1978-1979,1978-11-09,1979-05-10,183,1,396,919,1315,88,637,725,2040,55,501,SD - Aberdeen
29,1979-1980,1979-10-31,1980-04-08,161,1,168,626,794,47,149,196,990,25,181,SD - Aberdeen
30,1980-1981,1980-10-23,1981-03-31,160,0,123,548,671,19,4,23,694,17,134,SD - Aberdeen
32,1982-1983,1982-10-06,1983-04-17,194,0,91,441,532,35,34,69,601,24,91,SD - Aberdeen
33,1983-1984,1983-11-08,1984-04-27,172,0,251,616,867,60,205,265,1132,38,307,SD - Aberdeen
34,1984-1985,1984-10-18,1985-04-07,172,0,225,658,883,52,145,197,1080,26,202,SD - Aberdeen
35,1985-1986,1985-11-08,1986-04-17,161,0,289,724,1013,86,639,725,1738,38,385,SD - Aberdeen
36,1986-1987,1986-11-07,1987-03-29,143,0,78,445,523,39,34,73,596,27,140,SD - Aberdeen
37,1987-1988,1987-11-16,1988-04-26,163,0,178,633,811,36,43,79,890,24,215,SD - Aberdeen
38,1988-1989,1988-11-12,1989-04-18,158,0,240,734,974,74,506,580,1554,35,337,SD - Aberdeen
39,1989-1990,1989-10-31,1990-04-29,181,0,153,616,769,55,44,99,868,33,216,SD - Aberdeen
40,1990-1991,1990-10-17,1991-04-14,180,0,183,633,816,57,118,175,991,30,237,SD - Aberdeen
41,1991-1992,1991-10-29,1992-04-22,177,0,96,509,605,33,65,98,703,22,144,SD - Aberdeen
42,1992-1993,1992-10-15,1993-04-11,179,1,240,690,930,68,234,302,1232,46,351,SD - Aberdeen
43,1993-1994,1993-10-29,1994-04-29,183,0,296,767,1063,117,778,895,1958,53,542,SD - Aberdeen
44,1994-1995,1994-11-18,1995-04-18,152,3,217,657,874,95,447,542,1416,35,304,SD - Aberdeen
45,1995-1996,1995-09-21,1996-04-12,205,6,299,809,1108,71,273,344,1452,39,327,SD - Aberdeen
46,1996-1997,1996-10-30,1997-04-12,165,0,377,913,1290,112,1107,1219,2509,47,487,SD - Aberdeen
47,1997-1998,1997-10-13,1998-03-31,170,0,157,543,700,60,187,247,947,42,273,SD - Aberdeen
48,1998-1999,1998-11-05,1999-04-03,150,0,148,514,662,47,157,204,866,33,261,SD - Aberdeen
49,1999-2000,1999-10-03,2000-04-16,197,0,105,571,676,40,71,111,787,24,170,SD - Aberdeen
50,2000-2001,2000-11-02,2001-04-24,174,0,324,872,1196,109,875,984,2180,40,377,SD - Aberdeen
51,2001-2002,2001-10-24,2002-05-07,196,0,148,574,722,53,106,159,881,35,255,SD - Aberdeen
52,2002-2003,2002-10-21,2003-04-16,178,0,188,709,897,48,66,114,1011,35,276,SD - Aberdeen
53,2003-2004,2003-10-26,2004-04-29,187,6,189,649,838,61,143,204,1042,37,326,SD - Aberdeen
54,2004-2005,2004-12-01,2005-03-15,105,0,148,494,642,24,69,93,735,17,142,SD - Aberdeen
55,2005-2006,2005-11-16,2006-04-24,160,0,126,448,574,45,117,162,736,24,153,SD - Aberdeen
56,2006-2007,2006-10-11,2007-04-13,185,0,191,775,966,61,357,418,1384,23,192,SD - Aberdeen
57,2007-2008,2007-11-08,2008-04-26,171,0,232,811,1043,67,316,383,1426,33,287,SD - Aberdeen
58,2008-2009,2008-11-06,2009-04-04,150,0,261,777,1038,85,379,464,1502,34,344,SD - Aberdeen
59,2009-2010,2009-10-09,2010-03-16,159,0,254,638,892,63,548,611,1503,32,260,SD - Aberdeen
60,2010-2011,2010-10-27,2011-04-20,176,0,306,801,1107,123,699,822,1929,48,516,SD - Aberdeen
61,2011-2012,2011-11-16,2012-03-08,114,0,75,465,540,29,61,90,630,15,101,SD - Aberdeen
62,2012-2013,2012-11-04,2013-04-24,172,0,206,774,980,107,467,574,1554,48,380,SD - Aberdeen
63,2013-2014,2013-10-23,2014-04-16,176,0,298,939,1237,52,236,288,1525,30,329,SD - Aberdeen
64,2014-2015,2014-11-09,2015-03-27,139,0,194,630,824,39,125,164,988,27,221,SD - Aberdeen
65,2015-2016,2015-11-20,2016-03-19,121,0,100,387,487,49,210,259,746,28,159,SD - Aberdeen
66,2016-2017,2016-11-17,2017-04-26,161,0,188,560,748,68,217,285,1033,37,341,SD - Aberdeen
67,2017-2018,2017-11-03,2018-04-10,159,0,202,759,961,68,153,221,1182,31,289,SD - Aberdeen
68,2018-2019,2018-10-10,2019-04-15,188,0,296,832,1128,120,648,768,1896,44,522,SD - Aberdeen
69,2019-2020,2019-10-10,2020-04-09,183,0,154,626,780,67,584,651,1431,29,218,SD - Aberdeen
2,1952-1953,1952-11-17,1953-04-17,152,1,26,395,421,69,168,237,658,15,128,SD - Hot Springs
3,1953-1954,1953-12-01,1954-03-31,121,1,38,386,424,44,44,88,512,18,136,SD - Hot Springs
4,1954-1955,1954-10-25,1955-04-04,162,0,44,481,525,82,172,254,779,20,173,SD - Hot Springs
5,1955-1956,1955-10-23,1956-04-28,189,0,86,567,653,82,129,211,864,34,256,SD - Hot Springs
6,1956-1957,1956-11-02,1957-04-17,167,9,91,527,618,97,166,263,881,28,259,SD - Hot Springs
7,1957-1958,1957-11-03,1958-04-25,174,5,45,433,478,53,96,149,627,20,146,SD - Hot Springs
8,1958-1959,1958-11-16,1959-04-20,156,16,69,492,561,45,57,102,663,18,140,SD - Hot Springs
10,1960-1961,1960-11-08,1961-04-24,168,0,26,417,443,42,29,71,514,18,106,SD - Hot Springs
11,1961-1962,1961-09-30,1962-03-13,165,0,105,550,655,70,109,179,834,20,240,SD - Hot Springs
12,1962-1963,1962-12-01,1963-03-17,107,0,80,413,493,39,124,163,656,10,107,SD - Hot Springs
13,1963-1964,1963-11-21,1964-04-06,138,2,56,439,495,32,64,96,591,12,86,SD - Hot Springs
14,1964-1965,1964-11-18,1965-04-05,139,1,79,523,602,79,159,238,840,29,236,SD - Hot Springs
15,1965-1966,1965-11-25,1966-04-21,148,0,70,485,555,61,124,185,740,19,154,SD - Hot Springs
16,1966-1967,1966-11-08,1967-05-12,186,0,40,430,470,62,98,160,630,17,140,SD - Hot Springs
17,1967-1968,1967-11-02,1968-04-04,155,2,60,489,549,54,151,205,754,15,149,SD - Hot Springs
18,1968-1969,1968-11-06,1969-03-29,144,3,84,511,595,50,104,154,749,22,152,SD - Hot Springs
19,1969-1970,1969-10-12,1970-04-22,193,1,47,534,581,70,86,156,737,17,133,SD - Hot Springs
20,1970-1971,1970-09-13,1971-04-04,204,6,63,517,580,73,141,214,794,27,179,SD - Hot Springs
21,1971-1972,1971-10-28,1972-03-04,129,1,62,449,511,39,66,105,616,15,126,SD - Hot Springs
22,1972-1973,1972-10-29,1973-04-08,162,3,89,476,565,50,85,135,700,17,154,SD - Hot Springs
23,1973-1974,1973-10-11,1974-04-03,175,2,56,457,513,56,168,224,737,21,140,SD - Hot Springs
24,1974-1975,1974-11-29,1975-04-02,125,1,49,495,544,64,149,213,757,17,150,SD - Hot Springs
25,1975-1976,1975-10-23,1976-04-06,167,1,59,481,540,108,196,304,844,25,225,SD - Hot Springs
26,1976-1977,1976-11-11,1977-03-29,139,2,42,461,503,34,76,110,613,10,80,SD - Hot Springs
27,1977-1978,1977-10-10,1978-03-23,165,1,125,597,722,71,207,278,1000,27,246,SD - Hot Springs
28,1978-1979,1978-11-10,1979-05-10,182,3,138,692,830,69,248,317,1147,24,233,SD - Hot Springs
29,1979-1980,1979-11-20,1980-04-03,136,6,54,459,513,27,42,69,582,14,92,SD - Hot Springs
30,1980-1981,1980-11-13,1981-02-28,108,0,30,289,319,26,50,76,395,11,89,SD - Hot Springs
31,1981-1982,1981-11-28,1982-04-09,133,3,90,511,601,71,227,298,899,25,217,SD - Hot Springs
32,1982-1983,1982-11-01,1983-04-03,154,14,17,345,362,29,36,65,427,14,67,SD - Hot Springs
33,1983-1984,1983-11-08,1984-04-30,175,12,117,519,636,78,242,320,956,22,183,SD - Hot Springs
34,1984-1985,1984-11-09,1985-03-07,119,8,61,470,531,30,48,78,609,9,81,SD - Hot Springs
35,1985-1986,1985-09-28,1986-04-13,198,6,93,523,616,77,337,414,1030,27,219,SD - Hot Springs
36,1986-1987,1986-11-07,1987-03-29,143,13,24,340,364,56,100,156,520,18,125,SD - Hot Springs
37,1987-1988,1987-10-09,1988-04-22,197,18,51,479,530,25,110,135,665,10,68,SD - Hot Springs
38,1988-1989,1988-11-09,1989-03-18,130,7,62,438,500,34,96,130,630,10,120,SD - Hot Springs
39,1989-1990,1989-10-29,1990-04-10,164,4,61,439,500,32,69,101,601,12,110,SD - Hot Springs
40,1990-1991,1990-12-01,1991-04-12,133,7,58,416,474,30,127,157,631,10,74,SD - Hot Springs
41,1991-1992,1991-10-29,1992-04-12,167,14,17,386,403,17,94,111,514,5,39,SD - Hot Springs
42,1992-1993,1992-11-24,1993-04-13,141,7,93,536,629,61,386,447,1076,22,162,SD - Hot Springs
44,1994-1995,1994-11-03,1995-04-11,160,11,50,420,470,46,142,188,658,14,121,SD - Hot Springs
46,1996-1997,1996-10-17,1997-04-28,194,18,102,554,656,53,129,182,838,15,147,SD - Hot Springs
47,1997-1998,1997-10-25,1998-03-31,158,8,38,410,448,41,80,121,569,9,79,SD - Hot Springs
48,1998-1999,1998-11-04,1999-04-03,151,14,31,363,394,38,107,145,539,10,65,SD - Hot Springs
49,1999-2000,1999-12-01,2000-04-21,143,19,14,324,338,29,54,83,421,7,46,SD - Hot Springs
53,2003-2004,2003-10-30,2004-03-18,141,12,43,390,433,56,84,140,573,17,117,SD - Hot Springs
54,2004-2005,2004-11-28,2005-05-12,166,13,29,373,402,28,67,95,497,8,66,SD - Hot Springs
55,2005-2006,2005-11-30,2006-04-24,146,12,45,341,386,52,127,179,565,13,106,SD - Hot Springs
56,2006-2007,2006-10-18,2007-04-06,171,8,45,460,505,27,55,82,587,9,65,SD - Hot Springs
57,2007-2008,2007-11-21,2008-05-02,164,10,43,480,523,55,79,134,657,19,126,SD - Hot Springs
58,2008-2009,2008-12-01,2009-04-26,147,5,60,434,494,78,99,177,671,22,196,SD - Hot Springs
59,2009-2010,2009-10-09,2010-03-11,154,4,72,474,546,50,151,201,747,16,124,SD - Hot Springs
62,2012-2013,2012-11-10,2013-04-23,165,15,38,461,499,81,120,201,700,22,170,SD - Hot Springs
63,2013-2014,2013-10-04,2014-04-17,196,1,100,533,633,69,130,199,832,31,250,SD - Hot Springs
64,2014-2015,2014-11-10,2015-05-10,182,3,50,446,496,54,97,151,647,14,121,SD - Hot Springs
65,2015-2016,2015-11-20,2016-04-17,150,0,32,355,387,52,85,137,524,19,128,SD - Hot Springs
66,2016-2017,2016-11-17,2017-04-25,160,0,72,458,530,58,168,226,756,16,142,SD - Hot Springs
67,2017-2018,2017-11-02,2018-04-13,163,0,61,543,604,82,187,269,873,21,201,SD - Hot Springs
68,2018-2019,2018-10-13,2019-05-01,201,1,70,547,617,57,132,189,806,22,155,SD - Hot Springs
69,2019-2020,2019-10-10,2020-04-13,187,2,22,444,466,82,103,185,651,23,160,SD - Hot Springs
0,1950-1951,1950-11-08,1951-04-11,155,0,224,709,933,66,188,254,1187,37,330,SD - Huron
1,1951-1952,1951-10-21,1952-03-28,160,0,241,715,956,78,426,504,1460,39,335,SD - Huron
2,1952-1953,1952-11-17,1953-05-12,177,0,119,508,627,66,173,239,866,32,241,SD - Huron
3,1953-1954,1953-11-20,1954-05-02,164,0,145,542,687,76,235,311,998,30,234,SD - Huron
4,1954-1955,1954-10-31,1955-03-26,147,0,149,573,722,51,161,212,934,29,259,SD - Huron
5,1955-1956,1955-11-06,1956-04-30,177,0,309,849,1158,81,614,695,1853,39,380,SD - Huron
6,1956-1957,1956-11-14,1957-04-11,149,0,158,587,745,56,124,180,925,29,285,SD - Huron
7,1957-1958,1957-10-25,1958-04-06,164,0,114,511,625,40,118,158,783,26,137,SD - Huron
8,1958-1959,1958-11-04,1959-04-11,159,0,211,679,890,53,192,245,1135,36,332,SD - Huron
9,1959-1960,1959-10-30,1960-04-03,157,0,257,683,940,76,488,564,1504,42,330,SD - Huron
10,1960-1961,1960-11-09,1961-04-11,154,0,185,647,832,48,344,392,1224,23,216,SD - Huron
11,1961-1962,1961-11-02,1962-04-12,162,0,268,775,1043,115,443,558,1601,40,426,SD - Huron
12,1962-1963,1962-10-24,1963-04-22,181,0,189,656,845,44,126,170,1015,28,236,SD - Huron
13,1963-1964,1963-11-21,1964-04-12,144,0,154,633,787,53,144,197,984,33,258,SD - Huron
14,1964-1965,1964-11-19,1965-04-06,139,0,271,845,1116,74,325,399,1515,38,370,SD - Huron
15,1965-1966,1965-11-13,1966-05-11,180,0,196,639,835,59,194,253,1088,27,246,SD - Huron
16,1966-1967,1966-11-01,1967-05-01,182,0,135,627,762,58,144,202,964,37,307,SD - Huron
17,1967-1968,1967-11-12,1968-05-18,189,0,141,565,706,35,52,87,793,25,142,SD - Huron
18,1968-1969,1968-11-05,1969-04-04,151,0,232,654,886,106,792,898,1784,49,424,SD - Huron
19,1969-1970,1969-10-12,1970-04-22,193,0,173,650,823,83,270,353,1176,47,317,SD - Huron
20,1970-1971,1970-10-07,1971-03-24,169,0,218,670,888,75,354,429,1317,43,342,SD - Huron
21,1971-1972,1971-10-28,1972-04-03,159,0,213,670,883,81,486,567,1450,51,432,SD - Huron
22,1972-1973,1972-10-17,1973-03-28,163,0,154,462,616,64,201,265,881,29,230,SD - Huron
23,1973-1974,1973-11-04,1974-03-23,140,0,164,521,685,59,193,252,937,38,275,SD - Huron
24,1974-1975,1974-11-13,1975-04-10,149,0,149,623,772,105,359,464,1236,34,285,SD - Huron
25,1975-1976,1975-11-12,1976-03-15,125,0,138,526,664,56,194,250,914,28,227,SD - Huron
26,1976-1977,1976-10-18,1977-04-04,169,0,195,716,911,57,118,175,1086,26,222,SD - Huron
27,1977-1978,1977-11-08,1978-04-02,146,0,321,776,1097,56,322,378,1475,39,355,SD - Huron
28,1978-1979,1978-11-11,1979-04-12,153,0,314,813,1127,72,508,580,1707,40,385,SD - Huron
29,1979-1980,1979-10-21,1980-03-29,161,0,110,548,658,42,53,95,753,26,149,SD - Huron
30,1980-1981,1980-10-27,1981-03-31,156,0,95,505,600,21,18,39,639,15,117,SD - Huron
31,1981-1982,1981-10-24,1982-04-19,178,0,227,624,851,92,478,570,1421,40,374,SD - Huron
32,1982-1983,1982-10-19,1983-04-17,181,0,61,376,437,50,42,92,529,32,122,SD - Huron
33,1983-1984,1983-11-08,1984-03-28,142,0,216,532,748,86,431,517,1265,43,306,SD - Huron
34,1984-1985,1984-11-01,1985-04-05,156,0,172,538,710,70,161,231,941,27,260,SD - Huron
35,1985-1986,1985-11-07,1986-04-17,162,0,248,674,922,102,564,666,1588,46,404,SD - Huron
36,1986-1987,1986-11-08,1987-03-29,142,0,55,409,464,36,42,78,542,18,99,SD - Huron
37,1987-1988,1987-11-16,1988-04-26,163,0,174,618,792,76,431,507,1299,28,245,SD - Huron
38,1988-1989,1988-11-12,1989-05-05,175,0,185,632,817,96,259,355,1172,39,396,SD - Huron
39,1989-1990,1989-11-01,1990-04-29,180,0,126,575,701,45,70,115,816,23,182,SD - Huron
40,1990-1991,1990-10-17,1991-04-11,177,0,156,600,756,52,173,225,981,26,227,SD - Huron
41,1991-1992,1991-10-29,1992-04-21,176,0,76,432,508,35,76,111,619,18,110,SD - Huron
42,1992-1993,1992-10-15,1993-04-14,182,0,189,629,818,74,235,309,1127,47,350,SD - Huron
43,1993-1994,1993-10-30,1994-04-29,182,0,241,700,941,98,598,696,1637,47,424,SD - Huron
44,1994-1995,1994-11-18,1995-04-18,152,0,155,512,667,94,329,423,1090,39,289,SD - Huron
45,1995-1996,1995-10-23,1996-04-13,174,0,233,672,905,94,300,394,1299,37,319,SD - Huron
46,1996-1997,1996-10-30,1997-04-13,166,0,292,747,1039,75,949,1024,2063,26,282,SD - Huron
47,1997-1998,1997-11-02,1998-04-02,152,0,111,428,539,58,152,210,749,25,176,SD - Huron
48,1998-1999,1998-11-07,1999-04-10,155,0,103,420,523,59,188,247,770,25,180,SD - Huron
49,1999-2000,1999-10-01,2000-04-16,199,0,59,482,541,39,32,71,612,16,105,SD - Huron
50,2000-2001,2000-11-07,2001-04-23,168,0,267,786,1053,132,1016,1148,2201,41,396,SD - Huron
51,2001-2002,2001-11-26,2002-04-21,147,0,117,463,580,67,161,228,808,18,157,SD - Huron
52,2002-2003,2002-10-22,2003-04-07,168,0,138,583,721,48,76,124,845,26,210,SD - Huron
53,2003-2004,2003-10-29,2004-04-11,166,0,148,511,659,57,185,242,901,31,258,SD - Huron
54,2004-2005,2004-11-28,2005-03-20,113,0,111,436,547,20,23,43,590,14,92,SD - Huron
55,2005-2006,2005-11-15,2006-03-21,127,0,101,389,490,58,187,245,735,22,165,SD - Huron
56,2006-2007,2006-10-18,2007-04-13,178,0,158,596,754,67,236,303,1057,28,208,SD - Huron
57,2007-2008,2007-11-21,2008-04-27,159,0,159,630,789,70,218,288,1077,29,233,SD - Huron
58,2008-2009,2008-11-06,2009-04-25,171,0,188,656,844,77,306,383,1227,35,292,SD - Huron
59,2009-2010,2009-10-09,2010-03-14,157,0,225,563,788,76,585,661,1449,33,296,SD - Huron
60,2010-2011,2010-10-27,2011-04-16,172,0,244,672,916,105,624,729,1645,38,373,SD - Huron
61,2011-2012,2011-11-19,2012-03-08,111,0,60,376,436,46,117,163,599,18,135,SD - Huron
62,2012-2013,2012-10-25,2013-04-23,181,0,156,621,777,86,484,570,1347,33,215,SD - Huron
63,2013-2014,2013-10-22,2014-04-17,178,0,230,770,1000,50,169,219,1219,32,274,SD - Huron
64,2014-2015,2014-11-10,2015-03-05,116,0,168,555,723,39,175,214,937,22,187,SD - Huron
65,2015-2016,2015-11-26,2016-03-26,122,0,106,373,479,53,206,259,738,25,164,SD - Huron
66,2016-2017,2016-11-18,2017-03-17,120,0,147,454,601,52,164,216,817,22,173,SD - Huron
67,2017-2018,2017-11-05,2018-04-19,166,0,186,655,841,87,189,276,1117,35,270,SD - Huron
68,2018-2019,2018-11-07,2019-04-27,172,0,243,696,939,97,395,492,1431,35,370,SD - Huron
69,2019-2020,2019-10-10,2020-04-13,187,0,130,528,658,77,484,561,1219,30,212,SD - Huron
0,1950-1951,1950-10-01,1951-06-04,247,4,107,538,645,109,162,271,916,47,331,SD - Lead
1,1951-1952,1951-09-23,1952-05-09,230,5,117,541,658,155,695,850,1508,58,436,SD - Lead
2,1952-1953,1952-10-13,1953-05-13,213,3,76,402,478,252,603,855,1333,72,501,SD - Lead
3,1953-1954,1953-10-22,1954-06-03,225,1,82,439,521,172,358,530,1051,55,364,SD - Lead
4,1954-1955,1954-09-29,1955-06-09,254,8,115,470,585,269,654,923,1508,65,563,SD - Lead
5,1955-1956,1955-09-22,1956-05-13,235,1,130,543,673,187,315,502,1175,58,430,SD - Lead
6,1956-1957,1956-10-24,1957-05-22,211,0,128,551,679,244,554,798,1477,64,523,SD - Lead
7,1957-1958,1957-09-19,1958-04-30,224,1,82,389,471,196,365,561,1032,62,405,SD - Lead
8,1958-1959,1958-10-20,1959-05-20,213,0,121,458,579,198,509,707,1286,62,457,SD - Lead
9,1959-1960,1959-09-29,1960-05-05,220,0,147,512,659,236,703,939,1598,64,547,SD - Lead
10,1960-1961,1960-09-22,1961-05-04,225,0,61,386,447,164,366,530,977,52,327,SD - Lead
11,1961-1962,1961-09-12,1962-04-27,228,0,169,544,713,200,466,666,1379,66,513,SD - Lead
12,1962-1963,1962-09-08,1963-04-23,228,0,118,441,559,244,599,843,1402,64,568,SD - Lead
13,1963-1964,1963-10-30,1964-05-11,195,3,112,443,555,219,899,1118,1673,61,469,SD - Lead
14,1964-1965,1964-09-26,1965-05-26,243,0,140,526,666,239,756,995,1661,71,579,SD - Lead
15,1965-1966,1965-09-16,1966-05-12,239,0,105,452,557,250,459,709,1266,52,491,SD - Lead
16,1966-1967,1966-09-30,1967-05-14,227,0,82,468,550,218,657,875,1425,65,495,SD - Lead
17,1967-1968,1967-10-26,1968-05-18,206,0,91,474,565,169,619,788,1353,65,434,SD - Lead
18,1968-1969,1968-10-02,1969-06-13,255,0,116,552,668,195,516,711,1379,61,475,SD - Lead
19,1969-1970,1969-10-11,1970-05-15,217,0,113,504,617,323,768,1091,1708,73,602,SD - Lead
20,1970-1971,1970-09-12,1971-06-12,274,0,116,535,651,310,623,933,1584,92,665,SD - Lead
21,1971-1972,1971-09-15,1972-06-19,279,0,121,527,648,261,375,636,1284,84,613,SD - Lead
22,1972-1973,1972-09-29,1973-06-19,264,0,127,497,624,285,436,721,1345,65,540,SD - Lead
23,1973-1974,1973-10-09,1974-05-17,221,0,99,448,547,198,313,511,1058,55,437,SD - Lead
24,1974-1975,1974-09-12,1975-05-25,256,2,100,519,619,268,587,855,1474,70,580,SD - Lead
25,1975-1976,1975-10-08,1976-05-12,218,0,87,457,544,207,363,570,1114,65,478,SD - Lead
26,1976-1977,1976-10-06,1977-04-19,196,0,105,489,594,368,801,1169,1763,74,722,SD - Lead
27,1977-1978,1977-10-01,1978-05-11,223,0,120,537,657,232,575,807,1464,63,513,SD - Lead
28,1978-1979,1978-10-12,1979-05-30,231,2,170,633,803,187,567,754,1557,60,480,SD - Lead
29,1979-1980,1979-10-08,1980-04-16,192,3,88,467,555,163,229,392,947,61,438,SD - Lead
30,1980-1981,1980-09-16,1981-05-04,231,3,52,341,393,116,121,237,630,35,266,SD - Lead
31,1981-1982,1981-10-05,1982-05-05,213,4,117,528,645,210,372,582,1227,65,512,SD - Lead
32,1982-1983,1982-09-14,1983-05-11,240,4,50,416,466,342,562,904,1370,74,573,SD - Lead
33,1983-1984,1983-09-19,1984-05-27,252,10,149,510,659,342,597,939,1598,80,647,SD - Lead
34,1984-1985,1984-09-23,1985-04-26,216,3,112,544,656,181,358,539,1195,55,435,SD - Lead
35,1985-1986,1985-09-22,1986-05-23,244,6,127,502,629,299,859,1158,1787,79,599,SD - Lead
36,1986-1987,1986-10-02,1987-05-21,232,4,70,391,461,215,350,565,1026,60,459,SD - Lead
37,1987-1988,1987-10-09,1988-05-08,213,2,98,500,598,258,480,738,1336,60,497,SD - Lead
38,1988-1989,1988-09-19,1989-05-26,250,2,153,533,686,259,295,554,1240,80,647,SD - Lead
39,1989-1990,1989-09-10,1990-05-12,245,4,93,477,570,298,648,946,1516,78,623,SD - Lead
40,1990-1991,1990-10-06,1991-05-03,210,2,114,482,596,261,443,704,1300,62,550,SD - Lead
41,1991-1992,1991-10-03,1992-05-01,212,4,47,348,395,241,363,604,999,58,431,SD - Lead
42,1992-1993,1992-10-06,1993-05-09,216,15,114,536,650,293,668,961,1611,76,607,SD - Lead
43,1993-1994,1993-09-13,1994-05-01,231,2,114,489,603,505,1182,1687,2290,85,879,SD - Lead
44,1994-1995,1994-09-21,1995-06-10,263,12,82,424,506,252,195,447,953,73,483,SD - Lead
45,1995-1996,1995-09-19,1996-05-28,253,11,148,581,729,401,574,975,1704,88,787,SD - Lead
46,1996-1997,1996-09-25,1997-05-03,221,8,151,606,757,428,1054,1482,2239,76,793,SD - Lead
47,1997-1998,1997-10-08,1998-06-05,241,10,91,426,517,328,526,854,1371,70,586,SD - Lead
48,1998-1999,1998-10-04,1999-04-22,201,17,72,383,455,248,396,644,1099,59,467,SD - Lead
49,1999-2000,1999-09-26,2000-05-12,230,10,33,319,352,250,439,689,1041,64,430,SD - Lead
50,2000-2001,2000-09-20,2001-05-21,244,10,106,535,641,269,1041,1310,1951,72,575,SD - Lead
51,2001-2002,2001-10-04,2002-05-11,220,9,104,491,595,168,372,540,1135,54,425,SD - Lead
53,2003-2004,2003-09-17,2004-05-22,249,10,66,417,483,177,263,440,923,49,375,SD - Lead
55,2005-2006,2005-10-05,2006-05-11,219,20,104,383,487,342,607,949,1436,71,627,SD - Lead
57,2007-2008,2007-10-18,2008-05-27,223,8,99,502,601,359,791,1150,1751,69,651,SD - Lead
58,2008-2009,2008-10-10,2009-05-08,211,16,98,517,615,378,1221,1599,2214,71,690,SD - Lead
59,2009-2010,2009-10-01,2010-05-13,225,4,111,505,616,309,1004,1313,1929,75,631,SD - Lead
60,2010-2011,2010-10-27,2011-05-19,205,1,115,497,612,260,1003,1263,1875,70,590,SD - Lead
61,2011-2012,2011-11-01,2012-04-29,181,0,44,384,428,191,612,803,1231,47,359,SD - Lead
62,2012-2013,2012-10-03,2013-04-26,206,1,85,473,558,258,702,960,1518,72,592,SD - Lead
63,2013-2014,2013-10-04,2014-05-11,220,0,107,447,554,247,658,905,1459,66,498,SD - Lead
64,2014-2015,2014-09-11,2015-05-11,243,3,78,399,477,165,561,726,1203,34,328,SD - Lead
65,2015-2016,2015-11-19,2016-04-29,163,3,50,290,340,135,450,585,925,32,247,SD - Lead
66,2016-2017,2016-11-17,2017-04-26,161,7,99,384,483,121,346,467,950,33,306,SD - Lead
67,2017-2018,2017-10-14,2018-04-24,193,0,88,502,590,184,463,647,1237,54,457,SD - Lead
68,2018-2019,2018-09-28,2019-05-24,239,0,111,526,637,234,720,954,1591,61,517,SD - Lead
69,2019-2020,2019-10-02,2020-05-10,222,4,74,438,512,253,911,1164,1676,61,474,SD - Lead
0,1950-1951,1950-10-01,1951-04-21,203,13,248,806,1054,34,304,338,1392,8,86,SD - Lemmon
13,1963-1964,1963-11-12,1964-04-07,148,7,138,625,763,38,158,196,959,16,171,SD - Lemmon
20,1970-1971,1970-10-29,1971-04-27,181,3,272,747,1019,80,465,545,1564,35,322,SD - Lemmon
22,1972-1973,1972-10-29,1973-04-15,169,0,175,558,733,65,237,302,1035,20,220,SD - Lemmon
23,1973-1974,1973-10-11,1974-04-13,185,3,171,623,794,44,130,174,968,18,109,SD - Lemmon
24,1974-1975,1974-11-12,1975-04-16,156,19,172,634,806,67,267,334,1140,19,188,SD - Lemmon
25,1975-1976,1975-11-20,1976-04-03,136,0,149,537,686,49,238,287,973,15,161,SD - Lemmon
26,1976-1977,1976-10-23,1977-04-06,166,10,171,678,849,46,224,270,1119,14,131,SD - Lemmon
27,1977-1978,1977-11-18,1978-04-19,153,1,353,786,1139,82,714,796,1935,26,296,SD - Lemmon
28,1978-1979,1978-11-09,1979-04-14,157,1,354,906,1260,86,769,855,2115,23,280,SD - Lemmon
30,1980-1981,1980-10-15,1981-02-28,137,0,96,421,517,17,40,57,574,8,75,SD - Lemmon
31,1981-1982,1981-10-22,1982-04-19,180,8,274,752,1026,116,435,551,1577,47,493,SD - Lemmon
32,1982-1983,1982-11-03,1983-05-12,191,5,102,479,581,47,73,120,701,27,171,SD - Lemmon
33,1983-1984,1983-11-11,1984-04-30,172,4,226,615,841,63,258,321,1162,35,307,SD - Lemmon
34,1984-1985,1984-09-23,1985-04-06,196,10,233,737,970,85,371,456,1426,31,312,SD - Lemmon
37,1987-1988,1987-12-01,1988-03-19,110,20,128,453,581,25,161,186,767,10,95,SD - Lemmon
40,1990-1991,1990-10-17,1991-05-03,199,16,148,541,689,35,96,131,820,16,134,SD - Lemmon
41,1991-1992,1991-10-28,1992-04-12,168,20,68,399,467,9,105,114,581,5,27,SD - Lemmon
42,1992-1993,1992-10-15,1993-04-19,187,18,212,599,811,62,336,398,1209,23,227,SD - Lemmon
43,1993-1994,1993-10-08,1994-04-30,205,7,246,689,935,97,730,827,1762,32,358,SD - Lemmon
44,1994-1995,1994-11-17,1995-04-12,147,16,143,493,636,50,196,246,882,17,132,SD - Lemmon
47,1997-1998,1997-10-13,1998-03-23,162,10,137,480,617,34,176,210,827,10,98,SD - Lemmon
48,1998-1999,1998-11-06,1999-04-07,153,15,119,439,558,70,287,357,915,21,183,SD - Lemmon
49,1999-2000,1999-11-19,2000-03-17,120,14,60,358,418,29,104,133,551,12,101,SD - Lemmon
55,2005-2006,2005-10-05,2006-03-31,178,16,96,403,499,61,189,250,749,18,142,SD - Lemmon
56,2006-2007,2006-10-21,2007-04-11,173,8,118,538,656,50,70,120,776,16,122,SD - Lemmon
57,2007-2008,2007-11-20,2008-05-10,173,18,113,568,681,44,106,150,831,18,128,SD - Lemmon
58,2008-2009,2008-11-06,2009-04-26,172,4,216,655,871,128,678,806,1677,33,346,SD - Lemmon
59,2009-2010,2009-10-05,2010-04-02,180,1,233,583,816,100,639,739,1555,26,272,SD - Lemmon
60,2010-2011,2010-10-27,2011-04-20,176,20,264,687,951,128,707,835,1786,32,350,SD - Lemmon
63,2013-2014,2013-10-04,2014-04-29,208,1,223,717,940,98,347,445,1385,24,248,SD - Lemmon
64,2014-2015,2014-11-09,2015-05-10,183,1,150,523,673,45,161,206,879,15,137,SD - Lemmon
65,2015-2016,2015-11-25,2016-04-28,156,0,72,319,391,45,100,145,536,15,97,SD - Lemmon
66,2016-2017,2016-11-18,2017-03-15,118,0,176,399,575,69,516,585,1160,22,229,SD - Lemmon
67,2017-2018,2017-11-03,2018-04-24,173,0,187,672,859,81,247,328,1187,27,279,SD - Lemmon
68,2018-2019,2018-11-06,2019-05-01,177,0,240,652,892,87,453,540,1432,29,335,SD - Lemmon
69,2019-2020,2019-10-02,2020-04-13,195,0,115,539,654,63,186,249,903,24,196,SD - Lemmon
0,1950-1951,1950-10-02,1951-04-20,201,0,238,801,1039,45,173,218,1257,29,283,SD - Mobridge
1,1951-1952,1951-10-20,1952-04-06,170,4,291,777,1068,54,626,680,1748,34,307,SD - Mobridge
2,1952-1953,1952-11-25,1953-04-16,143,6,114,519,633,45,219,264,897,21,185,SD - Mobridge
3,1953-1954,1953-11-06,1954-05-02,178,0,140,554,694,35,83,118,812,24,204,SD - Mobridge
4,1954-1955,1954-10-25,1955-03-25,152,2,124,581,705,34,93,127,832,19,152,SD - Mobridge
5,1955-1956,1955-11-02,1956-04-03,154,0,296,863,1159,45,398,443,1602,22,229,SD - Mobridge
6,1956-1957,1956-11-02,1957-04-11,161,0,184,647,831,33,66,99,930,23,245,SD - Mobridge
7,1957-1958,1957-10-24,1958-03-23,151,0,130,544,674,28,135,163,837,17,122,SD - Mobridge
8,1958-1959,1958-11-14,1959-04-11,149,0,216,692,908,40,198,238,1146,26,232,SD - Mobridge
9,1959-1960,1959-11-04,1960-04-02,151,12,213,661,874,54,252,306,1180,34,273,SD - Mobridge
10,1960-1961,1960-11-09,1961-04-11,154,1,135,528,663,28,236,264,927,12,91,SD - Mobridge
11,1961-1962,1961-11-15,1962-03-24,130,0,240,675,915,49,274,323,1238,27,245,SD - Mobridge
12,1962-1963,1962-11-16,1963-04-10,146,0,178,570,748,39,124,163,911,17,176,SD - Mobridge
13,1963-1964,1963-11-13,1964-04-07,147,0,140,593,733,38,101,139,872,22,204,SD - Mobridge
14,1964-1965,1964-11-19,1965-04-23,156,0,293,786,1079,59,434,493,1572,31,322,SD - Mobridge
16,1966-1967,1966-11-01,1967-05-01,182,0,151,636,787,59,157,216,1003,27,269,SD - Mobridge
17,1967-1968,1967-11-03,1968-04-23,173,0,176,603,779,60,143,203,982,22,223,SD - Mobridge
18,1968-1969,1968-11-06,1969-04-02,148,0,279,684,963,68,552,620,1583,40,350,SD - Mobridge
19,1969-1970,1969-11-13,1970-04-20,159,0,201,649,850,86,378,464,1314,36,278,SD - Mobridge
20,1970-1971,1970-11-10,1971-03-24,135,0,266,674,940,62,372,434,1374,35,319,SD - Mobridge
21,1971-1972,1971-10-28,1972-03-14,139,3,267,701,968,74,701,775,1743,38,393,SD - Mobridge
22,1972-1973,1972-10-30,1973-03-15,137,1,182,515,697,37,253,290,987,18,192,SD - Mobridge
23,1973-1974,1973-11-03,1974-04-13,162,0,182,571,753,30,96,126,879,20,163,SD - Mobridge
24,1974-1975,1974-11-01,1975-04-13,164,0,163,610,773,75,266,341,1114,35,272,SD - Mobridge
25,1975-1976,1975-11-23,1976-04-02,132,0,158,510,668,45,228,273,941,28,227,SD - Mobridge
26,1976-1977,1976-10-18,1977-04-01,166,0,201,654,855,72,162,234,1089,38,299,SD - Mobridge
27,1977-1978,1977-11-08,1978-04-18,162,0,365,786,1151,88,689,777,1928,47,448,SD - Mobridge
28,1978-1979,1978-11-09,1979-05-10,183,2,356,840,1196,82,539,621,1817,42,338,SD - Mobridge
29,1979-1980,1979-10-31,1980-03-24,146,0,129,584,713,37,47,84,797,24,168,SD - Mobridge
30,1980-1981,1980-10-23,1981-02-28,129,0,97,413,510,14,10,24,534,14,101,SD - Mobridge
31,1981-1982,1981-10-24,1982-04-19,178,0,261,707,968,89,358,447,1415,42,378,SD - Mobridge
32,1982-1983,1982-11-02,1983-04-13,163,1,80,448,528,40,45,85,613,24,128,SD - Mobridge
33,1983-1984,1983-11-08,1984-04-28,173,1,239,606,845,57,243,300,1145,36,289,SD - Mobridge
34,1984-1985,1984-10-30,1985-04-05,158,3,221,697,918,38,221,259,1177,12,128,SD - Mobridge
35,1985-1986,1985-11-08,1986-04-17,161,2,244,651,895,91,848,939,1834,27,309,SD - Mobridge
36,1986-1987,1986-11-07,1987-04-01,146,4,73,424,497,67,350,417,914,18,122,SD - Mobridge
37,1987-1988,1987-12-01,1988-03-21,112,1,149,515,664,28,153,181,845,10,118,SD - Mobridge
38,1988-1989,1988-11-15,1989-04-28,165,9,210,648,858,55,266,321,1179,17,192,SD - Mobridge
39,1989-1990,1989-11-02,1990-04-29,179,2,134,565,699,18,69,87,786,6,45,SD - Mobridge
40,1990-1991,1990-10-17,1991-05-05,201,5,155,572,727,36,126,162,889,13,101,SD - Mobridge
41,1991-1992,1991-10-28,1992-04-20,176,3,82,441,523,23,82,105,628,16,97,SD - Mobridge
42,1992-1993,1992-10-15,1993-03-31,168,2,221,618,839,51,212,263,1102,36,263,SD - Mobridge
43,1993-1994,1993-10-29,1994-04-28,182,4,245,696,941,93,640,733,1674,51,438,SD - Mobridge
44,1994-1995,1994-11-17,1995-04-26,161,4,189,551,740,78,412,490,1230,36,270,SD - Mobridge
45,1995-1996,1995-10-30,1996-05-03,187,1,261,695,956,54,280,334,1290,32,237,SD - Mobridge
46,1996-1997,1996-10-21,1997-04-13,175,2,320,783,1103,113,1113,1226,2329,40,378,SD - Mobridge
50,2000-2001,2000-11-06,2001-04-22,168,0,240,739,979,51,322,373,1352,26,204,SD - Mobridge
51,2001-2002,2001-10-24,2002-04-21,180,3,122,542,664,25,73,98,762,17,120,SD - Mobridge
52,2002-2003,2002-10-21,2003-03-14,145,0,155,599,754,32,53,85,839,22,169,SD - Mobridge
53,2003-2004,2003-10-29,2004-04-11,166,0,169,572,741,49,211,260,1001,27,225,SD - Mobridge
54,2004-2005,2004-11-28,2005-03-22,115,1,119,443,562,22,70,92,654,14,87,SD - Mobridge
60,2010-2011,2010-11-20,2011-04-22,154,4,290,714,1004,113,661,774,1778,44,450,SD - Mobridge
61,2011-2012,2011-11-19,2012-03-07,110,5,72,428,500,26,66,92,592,15,129,SD - Mobridge
62,2012-2013,2012-11-10,2013-04-23,165,0,152,603,755,64,179,243,998,29,234,SD - Mobridge
63,2013-2014,2013-10-28,2014-04-05,160,0,250,760,1010,60,187,247,1257,28,299,SD - Mobridge
64,2014-2015,2014-11-09,2015-03-04,116,0,147,505,652,27,131,158,810,15,109,SD - Mobridge
65,2015-2016,2015-11-26,2016-03-18,114,3,82,321,403,28,109,137,540,19,99,SD - Mobridge
66,2016-2017,2016-11-17,2017-03-18,122,4,202,505,707,69,476,545,1252,33,316,SD - Mobridge
68,2018-2019,2018-11-07,2019-04-16,161,1,245,656,901,120,690,810,1711,40,458,SD - Mobridge
69,2019-2020,2019-10-10,2020-04-05,179,0,126,535,661,67,308,375,1036,28,196,SD - Mobridge
0,1950-1951,1950-11-09,1951-04-20,163,0,195,695,890,29,97,126,1016,15,154,SD - Pierre
1,1951-1952,1951-10-18,1952-04-07,173,0,245,730,975,119,963,1082,2057,34,348,SD - Pierre
2,1952-1953,1952-11-17,1953-04-02,137,0,104,450,554,55,238,293,847,22,188,SD - Pierre
3,1953-1954,1953-11-06,1954-05-02,178,2,103,488,591,51,120,171,762,20,154,SD - Pierre
4,1954-1955,1954-10-26,1955-03-25,151,0,115,506,621,51,186,237,858,21,175,SD - Pierre
5,1955-1956,1955-10-23,1956-04-30,191,1,263,788,1051,79,421,500,1551,40,393,SD - Pierre
6,1956-1957,1956-11-14,1957-04-11,149,0,163,563,726,55,146,201,927,26,246,SD - Pierre
7,1957-1958,1957-10-23,1958-04-05,165,1,100,512,612,44,176,220,832,22,146,SD - Pierre
8,1958-1959,1958-11-17,1959-04-20,155,0,175,606,781,32,98,130,911,23,209,SD - Pierre
9,1959-1960,1959-11-04,1960-04-03,152,0,209,629,838,72,425,497,1335,39,314,SD - Pierre
10,1960-1961,1960-11-09,1961-04-11,154,1,105,476,581,31,126,157,738,20,118,SD - Pierre
11,1961-1962,1961-11-02,1962-03-26,145,0,206,653,859,55,279,334,1193,29,291,SD - Pierre
12,1962-1963,1962-11-16,1963-04-04,140,6,137,501,638,31,73,104,742,23,191,SD - Pierre
13,1963-1964,1963-11-13,1964-04-08,148,0,112,494,606,30,58,88,694,22,145,SD - Pierre
14,1964-1965,1964-11-18,1965-04-06,140,0,249,729,978,50,203,253,1231,33,333,SD - Pierre
15,1965-1966,1965-11-25,1966-05-11,168,3,191,529,720,46,202,248,968,32,296,SD - Pierre
16,1966-1967,1966-11-01,1967-05-02,183,0,125,517,642,50,128,178,820,25,212,SD - Pierre
17,1967-1968,1967-11-03,1968-04-07,157,0,144,526,670,36,92,128,798,18,161,SD - Pierre
18,1968-1969,1968-11-06,1969-04-27,173,2,231,584,815,50,369,419,1234,38,279,SD - Pierre
19,1969-1970,1969-11-14,1970-04-19,157,0,161,545,706,60,185,245,951,35,254,SD - Pierre
20,1970-1971,1970-10-07,1971-04-27,203,0,203,613,816,48,202,250,1066,32,225,SD - Pierre
21,1971-1972,1971-10-28,1972-04-02,158,0,206,613,819,41,168,209,1028,28,218,SD - Pierre
22,1972-1973,1972-10-30,1973-03-14,136,0,153,437,590,41,182,223,813,22,178,SD - Pierre
23,1973-1974,1973-11-03,1974-03-23,141,0,129,437,566,23,37,60,626,20,139,SD - Pierre
24,1974-1975,1974-11-13,1975-04-09,148,0,119,521,640,87,268,355,995,33,287,SD - Pierre
25,1975-1976,1975-11-23,1976-03-12,111,0,114,409,523,32,105,137,660,21,164,SD - Pierre
26,1976-1977,1976-10-18,1977-04-03,168,0,155,598,753,58,82,140,893,30,221,SD - Pierre
27,1977-1978,1977-10-10,1978-04-18,191,0,292,702,994,86,421,507,1501,51,429,SD - Pierre
28,1978-1979,1978-11-10,1979-05-09,181,0,276,745,1021,60,208,268,1289,37,308,SD - Pierre
29,1979-1980,1979-10-31,1980-03-29,151,0,99,472,571,29,17,46,617,24,169,SD - Pierre
30,1980-1981,1980-10-18,1981-02-28,134,0,63,311,374,20,30,50,424,13,103,SD - Pierre
31,1981-1982,1981-10-22,1982-04-21,182,0,197,556,753,79,211,290,1043,38,346,SD - Pierre
32,1982-1983,1982-11-09,1983-04-13,156,0,45,347,392,18,4,22,414,16,54,SD - Pierre
33,1983-1984,1983-11-11,1984-04-28,170,1,183,475,658,48,180,228,886,33,254,SD - Pierre
34,1984-1985,1984-11-01,1985-04-05,156,1,155,581,736,58,222,280,1016,22,208,SD - Pierre
35,1985-1986,1985-11-08,1986-04-16,160,3,210,556,766,116,484,600,1366,44,401,SD - Pierre
36,1986-1987,1986-10-11,1987-04-10,182,0,49,393,442,58,133,191,633,22,122,SD - Pierre
37,1987-1988,1987-12-01,1988-04-25,147,0,134,510,644,30,112,142,786,16,138,SD - Pierre
38,1988-1989,1988-11-05,1989-04-30,177,0,176,570,746,62,224,286,1032,29,284,SD - Pierre
39,1989-1990,1989-10-29,1990-04-29,183,0,123,476,599,52,93,145,744,27,216,SD - Pierre
40,1990-1991,1990-10-06,1991-04-19,196,0,141,536,677,57,164,221,898,26,223,SD - Pierre
41,1991-1992,1991-10-28,1992-04-20,176,0,64,369,433,28,57,85,518,19,118,SD - Pierre
42,1992-1993,1992-11-01,1993-04-07,158,1,174,567,741,50,145,195,936,34,257,SD - Pierre
43,1993-1994,1993-10-29,1994-04-28,182,0,186,590,776,80,287,367,1143,44,402,SD - Pierre
44,1994-1995,1994-11-17,1995-04-19,154,5,123,451,574,70,165,235,809,33,230,SD - Pierre
45,1995-1996,1995-10-22,1996-04-14,176,0,211,626,837,52,153,205,1042,32,257,SD - Pierre
46,1996-1997,1996-11-10,1997-04-14,156,10,236,635,871,114,716,830,1701,37,369,SD - Pierre
47,1997-1998,1997-11-11,1998-03-30,140,3,82,374,456,36,103,139,595,25,151,SD - Pierre
48,1998-1999,1998-11-06,1999-04-03,149,3,69,353,422,51,89,140,562,22,189,SD - Pierre
49,1999-2000,1999-10-01,2000-04-16,199,0,43,372,415,30,28,58,473,18,97,SD - Pierre
59,2009-2010,2009-10-11,2010-03-12,153,0,220,537,757,62,534,596,1353,29,259,SD - Pierre
61,2011-2012,2011-11-19,2012-03-05,108,0,51,352,403,38,64,102,505,14,109,SD - Pierre
62,2012-2013,2012-11-10,2013-04-22,164,0,122,536,658,77,185,262,920,31,232,SD - Pierre
63,2013-2014,2013-10-28,2014-04-05,160,0,204,656,860,57,243,300,1160,30,295,SD - Pierre
64,2014-2015,2014-11-09,2015-03-26,138,0,125,532,657,39,197,236,893,17,160,SD - Pierre
65,2015-2016,2015-11-26,2016-03-19,115,0,78,315,393,44,220,264,657,22,151,SD - Pierre
66,2016-2017,2016-11-17,2017-03-22,126,1,168,445,613,53,314,367,980,27,231,SD - Pierre
67,2017-2018,2017-11-09,2018-04-18,161,0,167,600,767,69,189,258,1025,24,232,SD - Pierre
68,2018-2019,2018-11-07,2019-04-17,162,5,196,585,781,93,499,592,1373,32,345,SD - Pierre
69,2019-2020,2019-10-10,2020-04-12,186,0,102,496,598,62,203,265,863,32,191,SD - Pierre
0,1950-1951,1950-10-01,1951-06-01,244,11,122,608,730,39,36,75,805,24,152,SD - Rapid City (Airport)
1,1951-1952,1951-10-17,1952-04-03,170,0,145,590,735,46,114,160,895,34,224,SD - Rapid City (Airport)
2,1952-1953,1952-11-24,1953-05-13,171,0,50,398,448,76,188,264,712,32,197,SD - Rapid City (Airport)
3,1953-1954,1953-11-06,1954-05-02,178,0,74,428,502,55,70,125,627,29,166,SD - Rapid City (Airport)
4,1954-1955,1954-10-24,1955-04-06,165,0,88,464,552,71,117,188,740,36,240,SD - Rapid City (Airport)
5,1955-1956,1955-10-22,1956-04-30,192,0,146,605,751,71,155,226,977,45,328,SD - Rapid City (Airport)
6,1956-1957,1956-10-29,1957-04-17,171,0,140,547,687,78,170,248,935,43,331,SD - Rapid City (Airport)
7,1957-1958,1957-10-24,1958-04-26,185,0,69,392,461,58,89,147,608,36,203,SD - Rapid City (Airport)
8,1958-1959,1958-11-14,1959-04-22,160,0,112,492,604,60,74,134,738,37,251,SD - Rapid City (Airport)
9,1959-1960,1959-11-04,1960-04-28,177,0,138,525,663,68,179,247,910,40,313,SD - Rapid City (Airport)
10,1960-1961,1960-11-07,1961-04-24,169,0,56,402,458,38,79,117,575,24,135,SD - Rapid City (Airport)
11,1961-1962,1961-09-29,1962-04-11,195,0,158,570,728,53,150,203,931,34,274,SD - Rapid City (Airport)
12,1962-1963,1962-11-16,1963-04-22,158,0,111,460,571,82,128,210,781,47,364,SD - Rapid City (Airport)
13,1963-1964,1963-11-21,1964-04-19,151,0,80,432,512,49,70,119,631,37,226,SD - Rapid City (Airport)
14,1964-1965,1964-11-18,1965-05-09,173,0,138,595,733,68,129,197,930,47,349,SD - Rapid City (Airport)
15,1965-1966,1965-09-15,1966-05-11,239,0,135,552,687,71,169,240,927,35,245,SD - Rapid City (Airport)
16,1966-1967,1966-10-13,1967-05-12,212,0,88,452,540,85,133,218,758,46,281,SD - Rapid City (Airport)
17,1967-1968,1967-11-01,1968-04-22,174,0,95,488,583,55,96,151,734,32,215,SD - Rapid City (Airport)
18,1968-1969,1968-11-05,1969-06-13,221,0,148,563,711,59,108,167,878,41,243,SD - Rapid City (Airport)
19,1969-1970,1969-10-11,1970-04-26,198,0,102,531,633,107,236,343,976,41,295,SD - Rapid City (Airport)
20,1970-1971,1970-09-13,1971-04-27,227,0,150,565,715,107,233,340,1055,52,312,SD - Rapid City (Airport)
21,1971-1972,1971-10-27,1972-04-18,175,0,121,585,706,61,68,129,835,39,293,SD - Rapid City (Airport)
22,1972-1973,1972-10-30,1973-04-14,167,0,128,480,608,60,127,187,795,32,257,SD - Rapid City (Airport)
23,1973-1974,1973-10-11,1974-04-13,185,0,110,468,578,51,53,104,682,30,178,SD - Rapid City (Airport)
24,1974-1975,1974-11-13,1975-04-29,168,0,104,525,629,79,186,265,894,39,274,SD - Rapid City (Airport)
25,1975-1976,1975-10-22,1976-04-27,189,0,100,425,525,70,154,224,749,33,248,SD - Rapid City (Airport)
26,1976-1977,1976-10-18,1977-04-08,173,0,103,524,627,87,162,249,876,44,307,SD - Rapid City (Airport)
27,1977-1978,1977-10-09,1978-04-18,192,0,211,588,799,74,225,299,1098,41,337,SD - Rapid City (Airport)
28,1978-1979,1978-11-09,1979-05-10,183,0,227,686,913,56,250,306,1219,40,287,SD - Rapid City (Airport)
29,1979-1980,1979-11-09,1980-04-12,156,0,91,465,556,51,48,99,655,33,204,SD - Rapid City (Airport)
30,1980-1981,1980-10-16,1981-02-28,136,0,55,293,348,31,52,83,431,20,140,SD - Rapid City (Airport)
31,1981-1982,1981-10-20,1982-04-20,183,0,160,579,739,58,88,146,885,35,289,SD - Rapid City (Airport)
32,1982-1983,1982-10-09,1983-05-12,216,0,32,354,386,45,39,84,470,31,116,SD - Rapid City (Airport)
33,1983-1984,1983-09-19,1984-05-01,226,0,144,499,643,80,187,267,910,43,279,SD - Rapid City (Airport)
34,1984-1985,1984-09-23,1985-04-26,216,0,112,575,687,58,103,161,848,35,254,SD - Rapid City (Airport)
35,1985-1986,1985-09-27,1986-04-26,212,0,172,542,714,119,428,547,1261,53,393,SD - Rapid City (Airport)
36,1986-1987,1986-11-06,1987-04-02,148,0,51,374,425,69,121,190,615,30,187,SD - Rapid City (Airport)
37,1987-1988,1987-10-09,1988-04-26,201,0,81,535,616,47,98,145,761,22,156,SD - Rapid City (Airport)
38,1988-1989,1988-11-09,1989-04-30,173,0,143,529,672,58,108,166,838,36,279,SD - Rapid City (Airport)
39,1989-1990,1989-10-29,1990-05-09,193,0,93,464,557,68,133,201,758,43,258,SD - Rapid City (Airport)
40,1990-1991,1990-10-07,1991-05-03,209,0,116,531,647,70,109,179,826,39,274,SD - Rapid City (Airport)
41,1991-1992,1991-10-04,1992-04-20,200,0,44,373,417,47,71,118,535,26,133,SD - Rapid City (Airport)
42,1992-1993,1992-10-07,1993-04-30,206,0,159,610,769,91,399,490,1259,51,369,SD - Rapid City (Airport)
43,1993-1994,1993-10-08,1994-04-30,205,0,107,502,609,83,155,238,847,42,323,SD - Rapid City (Airport)
44,1994-1995,1994-11-02,1995-04-30,180,0,77,411,488,58,87,145,633,30,171,SD - Rapid City (Airport)
48,1998-1999,1998-11-03,1999-04-03,152,0,61,395,456,67,83,150,606,19,134,SD - Rapid City (Airport)
49,1999-2000,1999-11-18,2000-04-21,156,0,26,358,384,46,38,84,468,13,85,SD - Rapid City (Airport)
54,2004-2005,2004-11-23,2005-05-13,172,6,75,393,468,55,86,141,609,24,185,SD - Rapid City (Airport)
55,2005-2006,2005-10-04,2006-04-25,204,4,79,402,481,58,114,172,653,23,155,SD - Rapid City (Airport)
56,2006-2007,2006-10-11,2007-04-12,184,0,75,503,578,40,51,91,669,24,163,SD - Rapid City (Airport)
57,2007-2008,2007-11-21,2008-05-03,165,0,71,533,604,75,101,176,780,38,241,SD - Rapid City (Airport)
58,2008-2009,2008-11-05,2009-04-26,173,0,117,543,660,121,168,289,949,37,349,SD - Rapid City (Airport)
59,2009-2010,2009-10-07,2010-05-12,218,0,134,541,675,64,136,200,875,37,257,SD - Rapid City (Airport)
60,2010-2011,2010-11-17,2011-04-19,154,0,155,567,722,107,211,318,1040,48,437,SD - Rapid City (Airport)
61,2011-2012,2011-11-09,2012-03-04,117,0,36,385,421,46,39,85,506,27,160,SD - Rapid City (Airport)
62,2012-2013,2012-10-24,2013-04-25,184,0,74,541,615,110,132,242,857,33,273,SD - Rapid City (Airport)
63,2013-2014,2013-10-04,2014-05-07,216,0,145,621,766,98,111,209,975,41,357,SD - Rapid City (Airport)
64,2014-2015,2014-11-10,2015-05-11,183,0,98,500,598,72,101,173,771,28,259,SD - Rapid City (Airport)
65,2015-2016,2015-11-20,2016-04-28,161,0,54,372,426,52,78,130,556,23,142,SD - Rapid City (Airport)
66,2016-2017,2016-11-17,2017-04-26,161,0,120,483,603,54,187,241,844,27,231,SD - Rapid City (Airport)
67,2017-2018,2017-11-06,2018-04-16,162,0,139,612,751,89,150,239,990,34,319,SD - Rapid City (Airport)
0,1950-1951,1950-10-02,1951-06-02,244,16,97,522,619,47,42,89,708,30,194,SD - Rapid City (Downtown)
1,1951-1952,1951-10-20,1952-03-24,157,2,108,490,598,42,110,152,750,31,224,SD - Rapid City (Downtown)
2,1952-1953,1952-11-21,1953-05-01,162,1,33,305,338,70,152,222,560,29,169,SD - Rapid City (Downtown)
3,1953-1954,1953-11-06,1954-05-01,177,0,64,363,427,55,61,116,543,31,192,SD - Rapid City (Downtown)
4,1954-1955,1954-10-25,1955-04-04,162,1,64,393,457,68,78,146,603,29,180,SD - Rapid City (Downtown)
5,1955-1956,1955-09-25,1956-04-29,218,3,131,506,637,72,141,213,850,38,267,SD - Rapid City (Downtown)
6,1956-1957,1956-10-29,1957-04-17,171,0,119,470,589,83,140,223,812,40,308,SD - Rapid City (Downtown)
7,1957-1958,1957-10-25,1958-04-25,183,1,65,343,408,68,66,134,542,34,197,SD - Rapid City (Downtown)
8,1958-1959,1958-11-14,1959-05-20,188,1,102,418,520,67,69,136,656,36,235,SD - Rapid City (Downtown)
9,1959-1960,1959-10-01,1960-04-30,213,8,130,456,586,78,178,256,842,37,280,SD - Rapid City (Downtown)
10,1960-1961,1960-11-03,1961-04-14,163,1,45,313,358,38,45,83,441,21,126,SD - Rapid City (Downtown)
11,1961-1962,1961-09-29,1962-04-11,195,0,135,508,643,62,134,196,839,39,299,SD - Rapid City (Downtown)
12,1962-1963,1962-11-16,1963-04-22,158,0,91,377,468,83,119,202,670,36,272,SD - Rapid City (Downtown)
14,1964-1965,1964-11-15,1965-05-09,176,1,114,522,636,67,117,184,820,39,283,SD - Rapid City (Downtown)
15,1965-1966,1965-09-16,1966-04-21,218,3,114,445,559,69,152,221,780,29,249,SD - Rapid City (Downtown)
16,1966-1967,1966-10-14,1967-05-12,211,1,70,396,466,83,113,196,662,44,279,SD - Rapid City (Downtown)
17,1967-1968,1967-11-02,1968-04-22,173,0,78,395,473,56,82,138,611,30,206,SD - Rapid City (Downtown)
18,1968-1969,1968-11-05,1969-06-13,221,0,134,476,610,71,100,171,781,45,281,SD - Rapid City (Downtown)
19,1969-1970,1969-10-12,1970-04-23,194,1,89,417,506,119,173,292,798,39,295,SD - Rapid City (Downtown)
20,1970-1971,1970-09-13,1971-04-26,226,1,128,457,585,102,234,336,921,40,265,SD - Rapid City (Downtown)
21,1971-1972,1971-10-28,1972-04-02,158,0,97,462,559,52,77,129,688,28,204,SD - Rapid City (Downtown)
46,1996-1997,1996-10-16,1997-04-13,180,4,192,551,743,84,166,250,993,36,311,SD - Rapid City (Downtown)
47,1997-1998,1997-10-13,1998-06-03,234,0,92,365,457,66,70,136,593,32,224,SD - Rapid City (Downtown)
48,1998-1999,1998-11-02,1999-04-04,154,3,64,311,375,84,96,180,555,28,205,SD - Rapid City (Downtown)
49,1999-2000,1999-10-01,2000-04-21,204,3,25,265,290,67,39,106,396,28,150,SD - Rapid City (Downtown)
50,2000-2001,2000-09-22,2001-04-23,214,0,136,481,617,95,159,254,871,35,280,SD - Rapid City (Downtown)
51,2001-2002,2001-11-18,2002-05-11,175,1,95,393,488,60,121,181,669,25,187,SD - Rapid City (Downtown)
52,2002-2003,2002-10-22,2003-04-07,168,0,85,397,482,66,84,150,632,42,301,SD - Rapid City (Downtown)
53,2003-2004,2003-10-30,2004-04-29,183,0,98,372,470,81,141,222,692,33,258,SD - Rapid City (Downtown)
54,2004-2005,2004-11-23,2005-05-13,172,1,77,335,412,59,77,136,548,30,204,SD - Rapid City (Downtown)
55,2005-2006,2005-10-04,2006-04-24,203,0,84,312,396,71,110,181,577,26,185,SD - Rapid City (Downtown)
56,2006-2007,2006-10-11,2007-04-11,183,0,79,408,487,47,49,96,583,26,181,SD - Rapid City (Downtown)
57,2007-2008,2007-11-20,2008-05-02,165,0,74,430,504,83,95,178,682,42,264,SD - Rapid City (Downtown)
58,2008-2009,2008-10-12,2009-04-26,197,0,112,467,579,125,144,269,848,41,332,SD - Rapid City (Downtown)
59,2009-2010,2009-10-05,2010-05-12,220,0,132,445,577,60,113,173,750,35,248,SD - Rapid City (Downtown)
60,2010-2011,2010-11-16,2011-04-19,155,0,168,492,660,94,169,263,923,46,386,SD - Rapid City (Downtown)
61,2011-2012,2011-11-16,2012-03-02,108,0,43,272,315,40,31,71,386,24,127,SD - Rapid City (Downtown)
62,2012-2013,2012-10-24,2013-04-24,183,4,81,404,485,108,118,226,711,38,293,SD - Rapid City (Downtown)
63,2013-2014,2013-10-04,2014-05-07,216,0,151,548,699,121,120,241,940,58,460,SD - Rapid City (Downtown)
64,2014-2015,2014-09-11,2015-05-11,243,3,95,393,488,76,94,170,658,33,264,SD - Rapid City (Downtown)
65,2015-2016,2015-11-20,2016-04-27,160,0,52,261,313,60,81,141,454,26,146,SD - Rapid City (Downtown)
66,2016-2017,2016-11-17,2017-04-26,161,0,119,371,490,62,157,219,709,30,246,SD - Rapid City (Downtown)
67,2017-2018,2017-11-02,2018-04-14,164,0,138,476,614,101,135,236,850,45,360,SD - Rapid City (Downtown)
68,2018-2019,2018-10-08,2019-05-22,227,0,168,497,665,126,212,338,1003,58,424,SD - Rapid City (Downtown)
69,2019-2020,2019-10-09,2020-04-19,194,0,61,389,450,125,137,262,712,46,285,SD - Rapid City (Downtown)
0,1950-1951,1950-11-08,1951-04-12,156,0,191,672,863,85,324,409,1272,31,294,SD - Sioux Falls
1,1951-1952,1951-10-18,1952-04-12,178,0,187,675,862,96,427,523,1385,40,329,SD - Sioux Falls
2,1952-1953,1952-11-24,1953-04-25,153,0,109,499,608,70,256,326,934,33,248,SD - Sioux Falls
3,1953-1954,1953-11-20,1954-05-02,164,0,122,516,638,60,264,324,962,25,177,SD - Sioux Falls
4,1954-1955,1954-11-01,1955-03-27,147,0,137,537,674,53,206,259,933,27,227,SD - Sioux Falls
5,1955-1956,1955-10-23,1956-04-29,190,0,234,805,1039,94,499,593,1632,38,351,SD - Sioux Falls
6,1956-1957,1956-11-15,1957-04-11,148,0,145,574,719,64,147,211,930,20,186,SD - Sioux Falls
7,1957-1958,1957-10-25,1958-03-19,146,0,92,465,557,22,51,73,630,13,69,SD - Sioux Falls
8,1958-1959,1958-11-17,1959-04-11,146,0,179,618,797,48,147,195,992,24,210,SD - Sioux Falls
9,1959-1960,1959-10-08,1960-04-04,180,0,209,652,861,87,509,596,1457,29,257,SD - Sioux Falls
10,1960-1961,1960-11-09,1961-03-21,133,0,124,493,617,48,214,262,879,17,141,SD - Sioux Falls
11,1961-1962,1961-11-02,1962-04-12,162,0,223,652,875,119,532,651,1526,42,414,SD - Sioux Falls
12,1962-1963,1962-10-24,1963-04-22,181,0,184,565,749,41,176,217,966,23,203,SD - Sioux Falls
13,1963-1964,1963-12-01,1964-03-29,120,0,133,517,650,40,103,143,793,18,138,SD - Sioux Falls
14,1964-1965,1964-11-19,1965-04-17,150,0,226,729,955,75,260,335,1290,32,325,SD - Sioux Falls
15,1965-1966,1965-11-26,1966-04-20,146,0,184,569,753,29,92,121,874,22,236,SD - Sioux Falls
16,1966-1967,1966-10-14,1967-05-01,200,0,124,644,768,48,211,259,1027,26,248,SD - Sioux Falls
17,1967-1968,1967-10-26,1968-05-18,206,0,124,586,710,23,36,59,769,20,129,SD - Sioux Falls
18,1968-1969,1968-10-18,1969-04-07,172,0,229,671,900,139,977,1116,2016,48,460,SD - Sioux Falls
19,1969-1970,1969-11-02,1970-04-22,172,0,198,688,886,75,404,479,1365,35,280,SD - Sioux Falls
20,1970-1971,1970-10-08,1971-04-01,176,0,218,637,855,38,317,355,1210,18,140,SD - Sioux Falls
21,1971-1972,1971-11-06,1972-04-03,150,0,199,689,888,48,449,497,1385,26,228,SD - Sioux Falls
22,1972-1973,1972-10-18,1973-03-28,162,0,158,466,624,36,133,169,793,19,114,SD - Sioux Falls
23,1973-1974,1973-11-08,1974-04-04,148,0,159,545,704,47,234,281,985,27,237,SD - Sioux Falls
24,1974-1975,1974-11-13,1975-04-05,144,0,144,569,713,68,342,410,1123,36,232,SD - Sioux Falls
25,1975-1976,1975-11-19,1976-05-02,166,0,138,480,618,59,384,443,1061,27,197,SD - Sioux Falls
26,1976-1977,1976-10-18,1977-03-21,155,0,189,683,872,49,103,152,1024,25,204,SD - Sioux Falls
27,1977-1978,1977-10-10,1978-04-18,191,0,307,735,1042,65,364,429,1471,40,335,SD - Sioux Falls
28,1978-1979,1978-11-11,1979-04-05,146,0,307,764,1071,85,520,605,1676,43,388,SD - Sioux Falls
29,1979-1980,1979-11-05,1980-03-29,146,0,131,490,621,57,150,207,828,34,211,SD - Sioux Falls
30,1980-1981,1980-10-18,1981-04-04,169,0,105,488,593,19,31,50,643,14,99,SD - Sioux Falls
31,1981-1982,1981-10-24,1982-04-09,168,0,219,631,850,75,367,442,1292,41,369,SD - Sioux Falls
32,1982-1983,1982-10-19,1983-04-18,182,0,103,445,548,109,410,519,1067,39,236,SD - Sioux Falls
33,1983-1984,1983-11-09,1984-04-30,174,0,236,607,843,117,548,665,1508,46,374,SD - Sioux Falls
34,1984-1985,1984-11-10,1985-04-08,150,0,146,542,688,51,116,167,855,28,180,SD - Sioux Falls
35,1985-1986,1985-09-28,1986-04-15,200,0,224,643,867,79,562,641,1508,36,271,SD - Sioux Falls
36,1986-1987,1986-11-09,1987-03-28,140,0,55,407,462,17,26,43,505,11,72,SD - Sioux Falls
37,1987-1988,1987-10-20,1988-04-26,190,0,167,594,761,85,446,531,1292,31,251,SD - Sioux Falls
38,1988-1989,1988-11-11,1989-04-18,159,0,158,584,742,68,118,186,928,37,317,SD - Sioux Falls
39,1989-1990,1989-11-01,1990-03-23,143,0,124,520,644,25,41,66,710,17,115,SD - Sioux Falls
40,1990-1991,1990-10-17,1991-03-27,162,0,152,548,700,54,180,234,934,33,257,SD - Sioux Falls
41,1991-1992,1991-10-18,1992-04-22,188,0,83,422,505,73,157,230,735,28,182,SD - Sioux Falls
42,1992-1993,1992-11-01,1993-04-14,165,0,186,587,773,75,369,444,1217,37,289,SD - Sioux Falls
43,1993-1994,1993-10-30,1994-04-30,183,0,223,646,869,88,373,461,1330,42,393,SD - Sioux Falls
44,1994-1995,1994-11-18,1995-04-14,148,0,141,460,601,57,271,328,929,22,158,SD - Sioux Falls
45,1995-1996,1995-10-23,1996-04-12,173,0,196,607,803,66,124,190,993,37,282,SD - Sioux Falls
46,1996-1997,1996-10-30,1997-04-13,166,0,283,726,1009,101,758,859,1868,47,446,SD - Sioux Falls
47,1997-1998,1997-10-13,1998-04-02,172,0,116,455,571,82,147,229,800,46,250,SD - Sioux Falls
48,1998-1999,1998-11-07,1999-04-16,161,0,123,464,587,86,202,288,875,32,294,SD - Sioux Falls
49,1999-2000,1999-10-01,2000-04-16,199,0,75,494,569,36,76,112,681,19,136,SD - Sioux Falls
50,2000-2001,2000-11-06,2001-04-23,169,0,252,711,963,94,631,725,1688,45,389,SD - Sioux Falls
51,2001-2002,2001-11-26,2002-04-27,153,0,104,447,551,71,123,194,745,29,215,SD - Sioux Falls
52,2002-2003,2002-10-16,2003-04-09,176,0,135,566,701,56,62,118,819,32,219,SD - Sioux Falls
53,2003-2004,2003-10-26,2004-03-17,144,0,141,471,612,85,291,376,988,34,281,SD - Sioux Falls
54,2004-2005,2004-11-29,2005-03-25,117,0,110,407,517,46,96,142,659,21,164,SD - Sioux Falls
55,2005-2006,2005-11-15,2006-03-23,129,0,102,391,493,57,162,219,712,28,193,SD - Sioux Falls
56,2006-2007,2006-10-11,2007-04-13,185,0,148,533,681,65,244,309,990,31,241,SD - Sioux Falls
57,2007-2008,2007-11-21,2008-04-26,158,0,181,603,784,68,442,510,1294,33,248,SD - Sioux Falls
58,2008-2009,2008-11-06,2009-04-25,171,0,162,587,749,59,176,235,984,33,250,SD - Sioux Falls
59,2009-2010,2009-10-09,2010-03-15,158,0,201,553,754,88,657,745,1499,36,300,SD - Sioux Falls
60,2010-2011,2010-11-20,2011-04-17,149,0,211,602,813,69,404,473,1286,35,280,SD - Sioux Falls
61,2011-2012,2011-11-19,2012-03-04,107,0,55,341,396,33,65,98,494,21,117,SD - Sioux Falls
62,2012-2013,2012-10-25,2013-05-01,189,0,132,572,704,64,166,230,934,30,197,SD - Sioux Falls
63,2013-2014,2013-10-22,2014-04-17,178,0,237,752,989,73,249,322,1311,42,353,SD - Sioux Falls
64,2014-2015,2014-11-10,2015-03-05,116,0,162,505,667,52,157,209,876,24,196,SD - Sioux Falls
65,2015-2016,2015-11-20,2016-03-28,130,0,108,382,490,102,321,423,913,32,249,SD - Sioux Falls
66,2016-2017,2016-11-18,2017-05-01,165,0,114,388,502,66,114,180,682,26,192,SD - Sioux Falls
67,2017-2018,2017-11-06,2018-04-20,166,0,182,576,758,103,219,322,1080,38,322,SD - Sioux Falls
68,2018-2019,2018-10-14,2019-04-27,196,0,195,576,771,83,291,374,1145,44,355,SD - Sioux Falls
69,2019-2020,2019-10-12,2020-04-15,187,0,96,475,571,59,204,263,834,29,181,SD - Sioux Falls
0,1950-1951,1950-11-09,1951-04-11,154,0,293,813,1106,47,319,366,1472,25,257,SD - Watertown
1,1951-1952,1951-10-21,1952-04-09,172,0,277,795,1072,58,546,604,1676,37,342,SD - Watertown
2,1952-1953,1952-11-09,1953-05-12,185,0,178,615,793,69,306,375,1168,36,319,SD - Watertown
3,1953-1954,1953-11-20,1954-05-03,165,0,190,614,804,76,346,422,1226,31,260,SD - Watertown
4,1954-1955,1954-11-01,1955-03-26,146,0,186,632,818,31,153,184,1002,21,213,SD - Watertown
5,1955-1956,1955-11-02,1956-04-04,155,0,310,870,1180,76,544,620,1800,32,327,SD - Watertown
6,1956-1957,1956-11-14,1957-04-11,149,2,200,676,876,48,131,179,1055,23,249,SD - Watertown
7,1957-1958,1957-10-24,1958-04-06,165,0,151,568,719,22,54,76,795,14,91,SD - Watertown
8,1958-1959,1958-11-17,1959-04-11,146,0,254,724,978,50,325,375,1353,20,227,SD - Watertown
9,1959-1960,1959-10-12,1960-04-04,176,0,254,758,1012,60,465,525,1537,31,261,SD - Watertown
10,1960-1961,1960-11-09,1961-04-15,158,1,173,633,806,31,151,182,988,13,109,SD - Watertown
11,1961-1962,1961-11-02,1962-04-08,158,1,277,753,1030,72,445,517,1547,30,319,SD - Watertown
12,1962-1963,1962-11-16,1963-04-23,159,2,220,664,884,44,142,186,1070,22,207,SD - Watertown
13,1963-1964,1963-11-13,1964-04-07,147,0,185,675,860,35,151,186,1046,15,120,SD - Watertown
14,1964-1965,1964-11-19,1965-04-04,137,0,321,863,1184,60,456,516,1700,25,279,SD - Watertown
15,1965-1966,1965-11-13,1966-05-11,180,0,237,704,941,35,108,143,1084,15,134,SD - Watertown
16,1966-1967,1966-11-01,1967-04-01,152,0,202,714,916,49,227,276,1192,19,206,SD - Watertown
17,1967-1968,1967-10-27,1968-04-14,171,0,194,686,880,22,93,115,995,10,71,SD - Watertown
18,1968-1969,1968-11-06,1969-04-08,154,0,301,750,1051,85,994,1079,2130,36,326,SD - Watertown
19,1969-1970,1969-10-31,1970-04-23,175,0,237,738,975,53,309,362,1337,29,224,SD - Watertown
20,1970-1971,1970-10-07,1971-03-24,169,1,262,737,999,49,219,268,1267,29,219,SD - Watertown
21,1971-1972,1971-10-28,1972-04-07,163,0,282,789,1071,45,489,534,1605,25,211,SD - Watertown
22,1972-1973,1972-10-17,1973-02-28,135,0,202,550,752,29,197,226,978,19,170,SD - Watertown
23,1973-1974,1973-11-04,1974-04-03,151,0,242,688,930,32,304,336,1266,19,174,SD - Watertown
24,1974-1975,1974-11-13,1975-04-11,150,0,201,690,891,80,472,552,1443,34,307,SD - Watertown
25,1975-1976,1975-11-11,1976-03-15,126,0,190,586,776,57,377,434,1210,32,252,SD - Watertown
26,1976-1977,1976-10-18,1977-04-04,169,0,264,756,1020,50,277,327,1347,31,255,SD - Watertown
27,1977-1978,1977-10-08,1978-04-17,192,3,385,857,1242,80,761,841,2083,43,390,SD - Watertown
28,1978-1979,1978-11-11,1979-05-09,180,0,380,902,1282,79,743,822,2104,48,469,SD - Watertown
29,1979-1980,1979-10-21,1980-04-08,171,1,177,653,830,49,139,188,1018,37,266,SD - Watertown
30,1980-1981,1980-10-18,1981-03-06,140,0,146,508,654,21,51,72,726,18,176,SD - Watertown
31,1981-1982,1981-10-22,1982-04-09,170,6,311,780,1091,63,366,429,1520,46,420,SD - Watertown
32,1982-1983,1982-10-19,1983-04-18,182,0,118,518,636,62,79,141,777,32,179,SD - Watertown
33,1983-1984,1983-11-08,1984-04-28,173,1,288,684,972,67,396,463,1435,45,367,SD - Watertown
34,1984-1985,1984-10-30,1985-04-06,159,0,210,677,887,59,314,373,1260,29,232,SD - Watertown
35,1985-1986,1985-11-08,1986-03-27,140,9,261,707,968,66,728,794,1762,36,348,SD - Watertown
36,1986-1987,1986-11-09,1987-03-29,141,0,74,434,508,34,59,93,601,16,109,SD - Watertown
37,1987-1988,1987-10-20,1988-04-26,190,3,191,612,803,40,109,149,952,24,188,SD - Watertown
38,1988-1989,1988-11-12,1989-04-18,158,0,204,683,887,71,290,361,1248,33,308,SD - Watertown
39,1989-1990,1989-11-02,1990-04-30,180,0,156,637,793,30,21,51,844,24,191,SD - Watertown
40,1990-1991,1990-10-17,1991-03-29,164,1,182,603,785,36,144,180,965,24,197,SD - Watertown
41,1991-1992,1991-10-30,1992-04-24,178,0,108,505,613,35,102,137,750,21,157,SD - Watertown
42,1992-1993,1992-10-15,1993-04-14,182,0,263,711,974,57,520,577,1551,38,249,SD - Watertown
43,1993-1994,1993-10-30,1994-04-29,182,0,314,758,1072,87,696,783,1855,42,449,SD - Watertown
44,1994-1995,1994-11-18,1995-04-14,148,0,188,533,721,59,339,398,1119,31,232,SD - Watertown
45,1995-1996,1995-09-21,1996-04-12,205,3,274,754,1028,69,397,466,1494,33,292,SD - Watertown
51,2001-2002,2001-11-26,2002-04-27,153,0,155,528,683,59,220,279,962,20,139,SD - Watertown
52,2002-2003,2002-10-16,2003-04-04,171,1,206,665,871,52,172,224,1095,23,178,SD - Watertown
53,2003-2004,2003-10-27,2004-04-11,168,0,199,601,800,75,348,423,1223,26,236,SD - Watertown
54,2004-2005,2004-11-27,2005-03-18,112,0,155,481,636,19,59,78,714,11,103,SD - Watertown
55,2005-2006,2005-11-16,2006-03-21,126,0,161,457,618,52,304,356,974,19,134,SD - Watertown
56,2006-2007,2006-10-11,2007-04-13,185,0,196,631,827,72,286,358,1185,17,149,SD - Watertown
58,2008-2009,2008-11-06,2009-04-25,171,0,269,779,1048,78,555,633,1681,24,240,SD - Watertown
59,2009-2010,2009-10-09,2010-03-25,168,3,258,637,895,83,772,855,1750,29,254,SD - Watertown
60,2010-2011,2010-10-27,2011-04-16,172,9,325,792,1117,118,913,1031,2148,35,369,SD - Watertown
61,2011-2012,2011-11-16,2012-03-10,116,3,92,429,521,29,112,141,662,13,99,SD - Watertown
62,2012-2013,2012-10-24,2013-04-25,184,5,218,722,940,76,724,800,1740,32,227,SD - Watertown
63,2013-2014,2013-10-22,2014-04-17,178,0,320,881,1201,51,489,540,1741,34,330,SD - Watertown
64,2014-2015,2014-11-09,2015-03-22,134,0,226,605,831,42,261,303,1134,23,201,SD - Watertown
65,2015-2016,2015-11-20,2016-03-26,128,0,123,409,532,47,306,353,885,24,173,SD - Watertown
66,2016-2017,2016-11-17,2017-05-01,166,0,189,543,732,61,420,481,1213,26,240,SD - Watertown
67,2017-2018,2017-11-03,2018-04-18,167,0,233,713,946,80,232,312,1258,35,309,SD - Watertown
68,2018-2019,2018-11-06,2019-04-18,164,3,311,762,1073,121,835,956,2029,41,485,SD - Watertown
69,2019-2020,2019-10-10,2020-04-14,188,0,180,643,823,59,726,785,1608,32,222,SD - Watertown
0,1950-1951,1950-11-24,1951-03-15,112,0,21,166,187,26,23,49,236,17,87,TN - Bristol-Johnson City
1,1951-1952,1951-11-02,1952-02-29,120,0,6,130,136,11,0,11,147,11,28,TN - Bristol-Johnson City
2,1952-1953,1952-11-21,1953-04-19,150,0,4,105,109,45,23,68,177,16,72,TN - Bristol-Johnson City
3,1953-1954,1953-11-25,1954-03-03,99,0,4,133,137,26,13,39,176,9,37,TN - Bristol-Johnson City
4,1954-1955,1954-11-02,1955-02-28,119,0,13,157,170,36,34,70,240,18,86,TN - Bristol-Johnson City
5,1955-1956,1955-11-29,1956-02-29,93,0,8,126,134,20,19,39,173,10,38,TN - Bristol-Johnson City
6,1956-1957,1956-11-23,1957-03-08,106,0,7,91,98,9,0,9,107,7,19,TN - Bristol-Johnson City
7,1957-1958,1957-11-30,1958-03-20,111,0,29,184,213,27,41,68,281,13,60,TN - Bristol-Johnson City
8,1958-1959,1958-12-01,1959-03-12,102,0,12,178,190,16,18,34,224,5,29,TN - Bristol-Johnson City
9,1959-1960,1959-11-28,1960-03-26,120,0,16,175,191,75,89,164,355,22,124,TN - Bristol-Johnson City
10,1960-1961,1960-11-07,1961-04-03,148,0,16,180,196,27,17,44,240,17,60,TN - Bristol-Johnson City
11,1961-1962,1961-12-01,1962-04-02,123,0,12,117,129,32,25,57,186,14,59,TN - Bristol-Johnson City
12,1962-1963,1962-11-05,1963-03-21,137,0,30,224,254,36,25,61,315,16,79,TN - Bristol-Johnson City
13,1963-1964,1963-11-29,1964-03-30,123,0,23,219,242,58,84,142,384,24,107,TN - Bristol-Johnson City
14,1964-1965,1964-11-30,1965-03-20,111,0,17,159,176,35,41,76,252,15,75,TN - Bristol-Johnson City
15,1965-1966,1965-12-01,1966-02-28,90,0,19,163,182,37,80,117,299,13,78,TN - Bristol-Johnson City
16,1966-1967,1966-11-03,1967-02-28,118,0,10,148,158,26,21,47,205,12,45,TN - Bristol-Johnson City
17,1967-1968,1967-12-01,1968-03-23,114,0,17,198,215,35,31,66,281,16,66,TN - Bristol-Johnson City
18,1968-1969,1968-11-09,1969-03-10,122,0,14,204,218,42,41,83,301,17,76,TN - Bristol-Johnson City
19,1969-1970,1969-11-14,1970-03-24,131,0,29,219,248,44,60,104,352,18,99,TN - Bristol-Johnson City
20,1970-1971,1970-11-04,1971-03-26,143,0,21,175,196,37,38,75,271,15,65,TN - Bristol-Johnson City
21,1971-1972,1971-11-23,1972-03-26,125,0,7,119,126,20,8,28,154,10,40,TN - Bristol-Johnson City
22,1972-1973,1972-11-22,1973-02-28,99,0,12,119,131,13,19,32,163,7,25,TN - Bristol-Johnson City
23,1973-1974,1973-12-01,1974-02-28,90,0,6,70,76,7,2,9,85,6,19,TN - Bristol-Johnson City
24,1974-1975,1974-11-14,1975-03-10,117,0,4,112,116,19,4,23,139,14,38,TN - Bristol-Johnson City
25,1975-1976,1975-12-01,1976-02-29,91,0,9,120,129,6,3,9,138,4,15,TN - Bristol-Johnson City
26,1976-1977,1976-11-11,1977-03-01,111,0,42,268,310,41,30,71,381,26,115,TN - Bristol-Johnson City
27,1977-1978,1977-11-27,1978-03-27,121,0,38,251,289,40,63,103,392,24,109,TN - Bristol-Johnson City
28,1978-1979,1978-12-01,1979-03-27,117,0,19,189,208,42,54,96,304,16,86,TN - Bristol-Johnson City
29,1979-1980,1979-12-01,1980-03-04,95,0,18,163,181,27,71,98,279,12,60,TN - Bristol-Johnson City
30,1980-1981,1980-12-01,1981-03-20,110,0,18,209,227,17,14,31,258,10,50,TN - Bristol-Johnson City
31,1981-1982,1981-11-21,1982-04-08,139,0,24,172,196,23,17,40,236,14,58,TN - Bristol-Johnson City
32,1982-1983,1982-12-01,1983-04-18,139,0,7,132,139,33,22,55,194,14,53,TN - Bristol-Johnson City
33,1983-1984,1983-12-01,1984-03-21,112,0,21,168,189,19,8,27,216,15,48,TN - Bristol-Johnson City
34,1984-1985,1984-12-01,1985-02-28,90,0,24,163,187,26,48,74,261,13,79,TN - Bristol-Johnson City
35,1985-1986,1985-12-01,1986-02-28,90,0,12,165,177,37,31,68,245,18,86,TN - Bristol-Johnson City
36,1986-1987,1986-12-01,1987-04-07,128,0,5,125,130,49,47,96,226,20,92,TN - Bristol-Johnson City
37,1987-1988,1987-11-11,1988-03-16,127,0,15,179,194,15,27,42,236,9,38,TN - Bristol-Johnson City
38,1988-1989,1988-12-01,1989-02-28,90,0,5,110,115,26,13,39,154,9,38,TN - Bristol-Johnson City
39,1989-1990,1989-10-20,1990-03-19,151,0,23,152,175,16,12,28,203,12,38,TN - Bristol-Johnson City
40,1990-1991,1990-12-01,1991-02-28,90,0,3,95,98,3,1,4,102,3,10,TN - Bristol-Johnson City
41,1991-1992,1991-12-01,1992-04-02,124,0,2,127,129,3,0,3,132,3,7,TN - Bristol-Johnson City
42,1992-1993,1992-12-01,1993-03-18,108,0,4,115,119,28,25,53,172,9,42,TN - Bristol-Johnson City
43,1993-1994,1993-10-31,1994-03-03,124,0,16,157,173,16,9,25,198,12,35,TN - Bristol-Johnson City
44,1994-1995,1994-12-01,1995-03-09,99,0,8,115,123,14,7,21,144,9,31,TN - Bristol-Johnson City
45,1995-1996,1995-12-01,1996-03-21,112,4,33,202,235,52,101,153,388,10,83,TN - Bristol-Johnson City
46,1996-1997,1996-11-10,1997-02-28,111,8,13,139,152,4,5,9,161,2,13,TN - Bristol-Johnson City
47,1997-1998,1997-12-01,1998-03-12,102,10,5,96,101,0,0,0,101,0,0,TN - Bristol-Johnson City
48,1998-1999,1998-12-01,1999-03-15,105,9,6,111,117,5,7,12,129,3,10,TN - Bristol-Johnson City
49,1999-2000,1999-12-01,2000-02-29,91,7,10,129,139,11,8,19,158,6,28,TN - Bristol-Johnson City
50,2000-2001,2000-11-21,2001-03-06,106,8,14,185,199,7,6,13,212,5,17,TN - Bristol-Johnson City
51,2001-2002,2001-12-01,2002-03-04,94,0,5,125,130,0,0,0,130,0,0,TN - Bristol-Johnson City
52,2002-2003,2002-12-01,2003-02-28,90,1,14,138,152,4,10,14,166,1,8,TN - Bristol-Johnson City
53,2003-2004,2003-11-29,2004-02-29,93,5,7,144,151,16,14,30,181,9,28,TN - Bristol-Johnson City
54,2004-2005,2004-12-01,2005-04-24,145,0,9,140,149,10,1,11,160,8,23,TN - Bristol-Johnson City
55,2005-2006,2005-11-22,2006-03-25,124,0,3,138,141,20,11,31,172,15,46,TN - Bristol-Johnson City
56,2006-2007,2006-12-01,2007-04-15,136,0,7,160,167,11,2,13,180,9,33,TN - Bristol-Johnson City
57,2007-2008,2007-12-01,2008-03-08,99,0,4,116,120,11,3,14,134,8,25,TN - Bristol-Johnson City
58,2008-2009,2008-11-18,2009-04-07,141,0,14,185,199,18,7,25,224,16,60,TN - Bristol-Johnson City
59,2009-2010,2009-12-01,2010-03-04,94,0,25,151,176,46,48,94,270,27,122,TN - Bristol-Johnson City
60,2010-2011,2010-12-01,2011-03-06,96,0,16,156,172,31,31,62,234,22,81,TN - Bristol-Johnson City
61,2011-2012,2011-12-01,2012-02-29,91,0,2,89,91,5,2,7,98,5,19,TN - Bristol-Johnson City
62,2012-2013,2012-12-01,2013-03-26,116,0,2,111,113,15,15,30,143,10,27,TN - Bristol-Johnson City
63,2013-2014,2013-11-27,2014-03-25,119,0,16,199,215,21,23,44,259,11,64,TN - Bristol-Johnson City
64,2014-2015,2014-11-01,2015-02-28,120,0,15,195,210,23,41,64,274,11,54,TN - Bristol-Johnson City
65,2015-2016,2015-12-01,2016-02-29,91,0,9,114,123,27,40,67,190,12,60,TN - Bristol-Johnson City
66,2016-2017,2016-12-01,2017-03-15,105,0,4,94,98,8,7,15,113,5,22,TN - Bristol-Johnson City
67,2017-2018,2017-12-01,2018-04-16,137,0,14,156,170,17,7,24,194,14,45,TN - Bristol-Johnson City
68,2018-2019,2018-11-27,2019-02-28,94,0,4,87,91,22,28,50,141,9,36,TN - Bristol-Johnson City
69,2019-2020,2019-11-12,2020-02-29,110,0,2,81,83,10,6,16,99,8,20,TN - Bristol-Johnson City
0,1950-1951,1950-11-24,1951-02-28,97,0,5,109,114,6,4,10,124,2,11,TN - Chattanooga
1,1951-1952,1951-12-01,1952-02-29,91,0,1,57,58,0,0,0,58,0,0,TN - Chattanooga
2,1952-1953,1952-12-01,1953-02-28,90,0,0,52,52,4,1,5,57,2,5,TN - Chattanooga
3,1953-1954,1953-12-01,1954-02-28,90,0,2,75,77,1,0,1,78,1,2,TN - Chattanooga
4,1954-1955,1954-12-01,1955-02-28,90,0,1,79,80,0,0,0,80,0,0,TN - Chattanooga
5,1955-1956,1955-12-01,1956-02-29,91,0,0,75,75,0,0,0,75,0,0,TN - Chattanooga
6,1956-1957,1956-12-01,1957-02-28,90,0,1,45,46,0,0,0,46,0,0,TN - Chattanooga
7,1957-1958,1957-12-01,1958-02-28,90,0,11,138,149,9,17,26,175,1,12,TN - Chattanooga
8,1958-1959,1958-12-01,1959-02-28,90,0,3,109,112,3,1,4,116,3,9,TN - Chattanooga
9,1959-1960,1959-12-01,1960-03-19,110,0,4,99,103,32,24,56,159,10,43,TN - Chattanooga
10,1960-1961,1960-12-01,1961-02-28,90,0,5,117,122,2,0,2,124,2,4,TN - Chattanooga
11,1961-1962,1961-12-01,1962-02-28,90,0,8,74,82,10,11,21,103,4,24,TN - Chattanooga
12,1962-1963,1962-12-01,1963-02-28,90,0,15,179,194,6,1,7,201,3,13,TN - Chattanooga
13,1963-1964,1963-12-01,1964-02-29,91,0,1,101,102,18,19,37,139,6,27,TN - Chattanooga
14,1964-1965,1964-12-01,1965-03-05,95,0,4,99,103,6,2,8,111,5,15,TN - Chattanooga
15,1965-1966,1965-12-01,1966-02-28,90,0,9,124,133,12,20,32,165,1,18,TN - Chattanooga
16,1966-1967,1966-12-01,1967-02-28,90,0,4,89,93,3,2,5,98,2,7,TN - Chattanooga
17,1967-1968,1967-12-01,1968-02-29,91,0,5,112,117,17,15,32,149,10,36,TN - Chattanooga
18,1968-1969,1968-12-01,1969-03-06,96,0,3,99,102,13,9,22,124,5,16,TN - Chattanooga
19,1969-1970,1969-12-01,1970-02-28,90,0,14,147,161,17,8,25,186,5,29,TN - Chattanooga
20,1970-1971,1970-11-24,1971-04-07,135,0,9,126,135,15,2,17,152,6,24,TN - Chattanooga
21,1971-1972,1971-12-01,1972-03-25,116,0,4,78,82,2,0,2,84,1,2,TN - Chattanooga
22,1972-1973,1972-12-01,1973-02-28,90,0,10,110,120,3,2,5,125,1,5,TN - Chattanooga
23,1973-1974,1973-12-01,1974-02-28,90,0,2,56,58,1,0,1,59,1,2,TN - Chattanooga
24,1974-1975,1974-12-01,1975-02-28,90,0,0,75,75,0,0,0,75,0,0,TN - Chattanooga
25,1975-1976,1975-12-01,1976-02-29,91,0,5,109,114,1,0,1,115,1,2,TN - Chattanooga
26,1976-1977,1976-12-01,1977-02-28,90,0,11,192,203,5,5,10,213,3,11,TN - Chattanooga
27,1977-1978,1977-12-01,1978-03-02,92,0,16,133,149,8,4,12,161,7,21,TN - Chattanooga
28,1978-1979,1978-12-01,1979-02-28,90,0,3,106,109,15,13,28,137,7,23,TN - Chattanooga
29,1979-1980,1979-12-01,1980-03-02,93,0,4,99,103,12,16,28,131,7,27,TN - Chattanooga
30,1980-1981,1980-12-01,1981-02-28,90,0,6,121,127,0,0,0,127,0,0,TN - Chattanooga
31,1981-1982,1981-12-01,1982-02-28,90,0,11,108,119,9,8,17,136,5,24,TN - Chattanooga
32,1982-1983,1982-12-01,1983-03-24,114,0,1,64,65,4,1,5,70,3,7,TN - Chattanooga
33,1983-1984,1983-12-01,1984-02-29,91,0,15,128,143,4,1,5,148,3,9,TN - Chattanooga
34,1984-1985,1984-12-01,1985-02-28,90,0,7,114,121,9,4,13,134,7,29,TN - Chattanooga
35,1985-1986,1985-12-01,1986-02-28,90,0,5,119,124,4,0,4,128,2,6,TN - Chattanooga
36,1986-1987,1986-12-01,1987-04-03,124,0,2,71,73,14,10,24,97,6,26,TN - Chattanooga
37,1987-1988,1987-12-01,1988-02-29,91,0,7,110,117,14,34,48,165,1,18,TN - Chattanooga
38,1988-1989,1988-12-01,1989-02-28,90,0,1,66,67,4,1,5,72,3,5,TN - Chattanooga
39,1989-1990,1989-11-16,1990-02-28,105,0,9,86,95,2,0,2,97,2,5,TN - Chattanooga
40,1990-1991,1990-12-01,1991-03-08,98,0,1,57,58,5,1,6,64,3,10,TN - Chattanooga
41,1991-1992,1991-12-01,1992-02-29,91,0,1,63,64,0,0,0,64,0,0,TN - Chattanooga
42,1992-1993,1992-12-01,1993-03-17,107,0,0,57,57,31,26,57,114,3,34,TN - Chattanooga
43,1993-1994,1993-12-01,1994-02-28,90,0,6,93,99,0,0,0,99,0,0,TN - Chattanooga
44,1994-1995,1994-12-01,1995-02-28,90,0,1,61,62,4,1,5,67,4,11,TN - Chattanooga
54,2004-2005,2004-12-01,2005-02-28,90,0,2,60,62,0,0,0,62,0,0,TN - Chattanooga
55,2005-2006,2005-12-01,2006-02-28,90,0,1,61,62,2,0,2,64,2,4,TN - Chattanooga
56,2006-2007,2006-12-01,2007-02-28,90,0,0,70,70,3,0,3,73,1,4,TN - Chattanooga
57,2007-2008,2007-12-01,2008-03-24,115,0,2,68,70,4,0,4,74,3,7,TN - Chattanooga
58,2008-2009,2008-12-01,2009-02-28,90,0,3,82,85,0,0,0,85,0,0,TN - Chattanooga
59,2009-2010,2009-12-01,2010-03-02,92,0,6,87,93,15,3,18,111,8,25,TN - Chattanooga
60,2010-2011,2010-12-01,2011-02-28,90,0,7,94,101,20,32,52,153,6,31,TN - Chattanooga
61,2011-2012,2011-12-01,2012-02-29,91,0,0,40,40,0,0,0,40,0,0,TN - Chattanooga
62,2012-2013,2012-12-01,2013-02-28,90,0,0,34,34,1,0,1,35,1,3,TN - Chattanooga
63,2013-2014,2013-12-01,2014-02-28,90,0,8,106,114,12,6,18,132,3,20,TN - Chattanooga
64,2014-2015,2014-12-01,2015-02-28,90,0,5,80,85,15,12,27,112,6,28,TN - Chattanooga
65,2015-2016,2015-12-01,2016-02-29,91,0,1,49,50,2,0,2,52,2,4,TN - Chattanooga
66,2016-2017,2016-12-01,2017-02-28,90,0,2,38,40,1,1,2,42,1,3,TN - Chattanooga
67,2017-2018,2017-12-01,2018-02-28,90,0,5,84,89,2,0,2,91,2,6,TN - Chattanooga
68,2018-2019,2018-12-01,2019-02-28,90,0,0,33,33,1,0,1,34,1,3,TN - Chattanooga
69,2019-2020,2019-12-01,2020-02-29,91,0,0,25,25,4,1,5,30,2,5,TN - Chattanooga
1,1951-1952,1951-11-03,1952-02-29,119,2,1,72,73,1,0,1,74,1,4,TN - Jackson
2,1952-1953,1952-11-29,1953-02-28,92,3,2,60,62,0,0,0,62,0,0,TN - Jackson
3,1953-1954,1953-12-01,1954-02-28,90,3,4,80,84,5,0,5,89,2,10,TN - Jackson
4,1954-1955,1954-12-01,1955-02-28,90,2,3,90,93,2,0,2,95,1,3,TN - Jackson
6,1956-1957,1956-12-01,1957-02-28,90,1,3,54,57,0,0,0,57,0,0,TN - Jackson
9,1959-1960,1959-12-01,1960-03-15,106,6,5,98,103,16,0,16,119,5,22,TN - Jackson
10,1960-1961,1960-12-01,1961-02-28,90,0,5,117,122,0,0,0,122,0,0,TN - Jackson
11,1961-1962,1961-12-01,1962-03-06,96,7,18,122,140,4,0,4,144,2,17,TN - Jackson
12,1962-1963,1962-12-01,1963-02-28,90,13,33,211,244,4,6,10,254,2,8,TN - Jackson
14,1964-1965,1964-11-22,1965-03-20,119,7,14,148,162,0,8,8,170,0,0,TN - Jackson
15,1965-1966,1965-12-01,1966-02-28,90,19,16,124,140,0,12,12,152,0,0,TN - Jackson
16,1966-1967,1966-11-02,1967-02-28,119,6,8,127,135,2,1,3,138,1,2,TN - Jackson
17,1967-1968,1967-12-01,1968-03-25,116,1,9,169,178,35,46,81,259,6,51,TN - Jackson
18,1968-1969,1968-12-01,1969-02-28,90,5,6,89,95,1,1,2,97,1,3,TN - Jackson
20,1970-1971,1970-11-24,1971-03-26,123,1,17,129,146,9,9,18,164,3,13,TN - Jackson
21,1971-1972,1971-11-23,1972-03-03,102,1,7,79,86,2,0,2,88,2,4,TN - Jackson
22,1972-1973,1972-12-01,1973-02-28,90,0,10,97,107,3,16,19,126,2,9,TN - Jackson
25,1975-1976,1975-12-01,1976-02-29,91,1,9,93,102,0,0,0,102,0,0,TN - Jackson
27,1977-1978,1977-12-01,1978-03-05,95,2,40,210,250,23,44,67,317,11,67,TN - Jackson
28,1978-1979,1978-12-01,1979-02-28,90,0,29,168,197,24,47,71,268,7,40,TN - Jackson
29,1979-1980,1979-11-30,1980-03-03,95,0,18,114,132,16,13,29,161,9,37,TN - Jackson
30,1980-1981,1980-12-01,1981-02-28,90,1,16,139,155,0,0,0,155,0,0,TN - Jackson
31,1981-1982,1981-12-01,1982-02-28,90,0,23,153,176,8,15,23,199,2,15,TN - Jackson
32,1982-1983,1982-12-01,1983-02-28,90,1,1,73,74,0,0,0,74,0,0,TN - Jackson
34,1984-1985,1984-12-01,1985-02-28,90,0,27,140,167,34,52,86,253,8,69,TN - Jackson
35,1985-1986,1985-12-01,1986-02-28,90,18,15,131,146,1,0,1,147,1,6,TN - Jackson
36,1986-1987,1986-11-14,1987-03-31,138,0,4,81,85,6,4,10,95,2,8,TN - Jackson
37,1987-1988,1987-12-01,1988-02-29,91,2,16,117,133,19,29,48,181,5,49,TN - Jackson
39,1989-1990,1989-12-01,1990-03-19,109,0,24,108,132,1,0,1,133,1,2,TN - Jackson
40,1990-1991,1990-12-01,1991-02-28,90,0,6,75,81,1,0,1,82,1,7,TN - Jackson
41,1991-1992,1991-12-01,1992-02-29,91,0,1,57,58,0,0,0,58,0,0,TN - Jackson
42,1992-1993,1992-12-01,1993-03-14,104,9,5,76,81,1,1,2,83,1,2,TN - Jackson
43,1993-1994,1993-12-01,1994-02-28,90,0,15,112,127,6,3,9,136,4,21,TN - Jackson
44,1994-1995,1994-12-01,1995-02-28,90,0,4,78,82,0,0,0,82,0,0,TN - Jackson
45,1995-1996,1995-12-01,1996-03-09,100,3,22,143,165,2,2,4,169,1,8,TN - Jackson
46,1996-1997,1996-12-01,1997-02-28,90,1,16,90,106,4,10,14,120,1,11,TN - Jackson
47,1997-1998,1997-12-01,1998-02-28,90,3,0,37,37,2,1,3,40,1,3,TN - Jackson
48,1998-1999,1998-12-01,1999-02-28,90,5,10,69,79,2,0,2,81,1,5,TN - Jackson
49,1999-2000,1999-12-01,2000-02-29,91,5,3,83,86,3,5,8,94,1,5,TN - Jackson
50,2000-2001,2000-12-01,2001-02-28,90,7,16,131,147,5,4,9,156,3,17,TN - Jackson
51,2001-2002,2001-12-01,2002-03-04,94,3,4,80,84,6,3,9,93,2,8,TN - Jackson
52,2002-2003,2002-12-01,2003-02-28,90,6,10,109,119,16,16,32,151,6,29,TN - Jackson
53,2003-2004,2003-12-01,2004-04-13,135,1,5,94,99,4,3,7,106,1,5,TN - Jackson
54,2004-2005,2004-12-01,2005-02-28,90,0,7,71,78,4,11,15,93,1,8,TN - Jackson
55,2005-2006,2005-12-01,2006-02-28,90,0,3,77,80,4,2,6,86,2,10,TN - Jackson
56,2006-2007,2006-12-01,2007-02-28,90,1,6,90,96,3,1,4,100,2,8,TN - Jackson
57,2007-2008,2007-12-01,2008-03-08,99,0,6,90,96,2,2,4,100,1,3,TN - Jackson
58,2008-2009,2008-12-01,2009-03-03,93,2,7,116,123,10,7,17,140,2,13,TN - Jackson
59,2009-2010,2009-12-01,2010-02-28,90,10,13,137,150,16,19,35,185,3,19,TN - Jackson
65,2015-2016,2015-12-01,2016-02-29,91,0,5,84,89,0,0,0,89,0,0,TN - Jackson
66,2016-2017,2016-12-01,2017-03-12,102,0,9,80,89,8,8,16,105,3,20,TN - Jackson
67,2017-2018,2017-12-01,2018-02-28,90,0,14,136,150,6,6,12,162,2,14,TN - Jackson
68,2018-2019,2018-11-15,2019-03-05,111,0,5,92,97,2,2,4,101,2,5,TN - Jackson
69,2019-2020,2019-12-01,2020-02-29,91,0,0,50,50,1,1,2,52,1,2,TN - Jackson
0,1950-1951,1950-11-24,1951-03-14,111,0,14,117,131,15,17,32,163,7,29,TN - Knoxville
1,1951-1952,1951-12-01,1952-02-29,91,0,2,57,59,0,0,0,59,0,0,TN - Knoxville
2,1952-1953,1952-11-21,1953-02-28,100,0,3,58,61,41,21,62,123,8,51,TN - Knoxville
3,1953-1954,1953-12-01,1954-03-01,91,0,4,79,83,12,5,17,100,3,15,TN - Knoxville
4,1954-1955,1954-12-01,1955-02-28,90,0,4,86,90,9,7,16,106,5,22,TN - Knoxville
5,1955-1956,1955-11-29,1956-02-29,93,0,2,81,83,10,7,17,100,4,16,TN - Knoxville
6,1956-1957,1956-11-26,1957-03-08,103,0,1,51,52,7,0,7,59,4,11,TN - Knoxville
7,1957-1958,1957-12-01,1958-02-28,90,0,16,138,154,17,16,33,187,6,31,TN - Knoxville
8,1958-1959,1958-12-01,1959-03-12,102,0,6,117,123,10,9,19,142,4,18,TN - Knoxville
9,1959-1960,1959-11-28,1960-03-21,115,0,6,120,126,77,62,139,265,16,104,TN - Knoxville
10,1960-1961,1960-12-01,1961-03-09,99,0,11,121,132,16,8,24,156,9,38,TN - Knoxville
11,1961-1962,1961-12-01,1962-03-06,96,0,11,88,99,31,26,57,156,9,52,TN - Knoxville
12,1962-1963,1962-12-01,1963-02-28,90,0,15,164,179,24,17,41,220,7,45,TN - Knoxville
13,1963-1964,1963-11-14,1964-02-29,108,0,8,150,158,46,47,93,251,11,63,TN - Knoxville
14,1964-1965,1964-12-01,1965-03-20,110,0,5,107,112,28,26,54,166,11,48,TN - Knoxville
15,1965-1966,1965-12-01,1966-03-06,96,0,9,103,112,20,33,53,165,5,30,TN - Knoxville
16,1966-1967,1966-12-01,1967-02-28,90,0,5,86,91,14,12,26,117,4,22,TN - Knoxville
17,1967-1968,1967-12-01,1968-03-22,113,0,3,125,128,19,9,28,156,9,31,TN - Knoxville
18,1968-1969,1968-11-19,1969-03-10,112,0,5,122,127,21,8,29,156,10,31,TN - Knoxville
19,1969-1970,1969-12-01,1970-02-28,90,0,19,132,151,36,35,71,222,11,73,TN - Knoxville
20,1970-1971,1970-11-24,1971-04-07,135,0,12,125,137,37,15,52,189,14,56,TN - Knoxville
21,1971-1972,1971-12-01,1972-03-26,117,0,4,70,74,15,1,16,90,4,20,TN - Knoxville
22,1972-1973,1972-12-01,1973-03-21,111,0,7,85,92,15,20,35,127,4,18,TN - Knoxville
23,1973-1974,1973-12-01,1974-03-25,115,0,3,55,58,6,1,7,65,4,13,TN - Knoxville
24,1974-1975,1974-12-01,1975-03-10,100,0,3,70,73,9,1,10,83,5,14,TN - Knoxville
25,1975-1976,1975-12-01,1976-02-29,91,0,6,105,111,5,3,8,119,3,11,TN - Knoxville
26,1976-1977,1976-11-29,1977-02-28,92,0,16,177,193,20,8,28,221,11,45,TN - Knoxville
27,1977-1978,1977-11-26,1978-03-18,113,0,19,165,184,31,34,65,249,14,54,TN - Knoxville
28,1978-1979,1978-12-01,1979-02-28,90,0,4,124,128,29,33,62,190,11,44,TN - Knoxville
29,1979-1980,1979-12-01,1980-03-04,95,0,6,98,104,23,23,46,150,8,43,TN - Knoxville
30,1980-1981,1980-12-01,1981-02-28,90,0,6,124,130,11,1,12,142,4,22,TN - Knoxville
31,1981-1982,1981-12-01,1982-03-07,97,0,17,111,128,10,11,21,149,6,28,TN - Knoxville
32,1982-1983,1982-12-01,1983-04-18,139,0,0,86,86,16,8,24,110,8,21,TN - Knoxville
33,1983-1984,1983-12-01,1984-02-29,91,0,15,135,150,11,10,21,171,8,29,TN - Knoxville
34,1984-1985,1984-12-01,1985-02-28,90,0,15,151,166,33,58,91,257,9,62,TN - Knoxville
35,1985-1986,1985-12-01,1986-02-28,90,0,8,163,171,12,8,20,191,3,17,TN - Knoxville
36,1986-1987,1986-12-01,1987-04-05,126,0,3,105,108,29,26,55,163,8,45,TN - Knoxville
37,1987-1988,1987-12-01,1988-02-29,91,0,7,132,139,16,26,42,181,5,28,TN - Knoxville
38,1988-1989,1988-12-01,1989-02-28,90,0,3,87,90,10,4,14,104,6,16,TN - Knoxville
39,1989-1990,1989-12-01,1990-02-28,90,0,12,87,99,3,1,4,103,3,10,TN - Knoxville
40,1990-1991,1990-12-01,1991-03-04,94,0,2,60,62,4,2,6,68,3,4,TN - Knoxville
41,1991-1992,1991-11-08,1992-02-29,114,0,2,77,79,1,0,1,80,1,1,TN - Knoxville
42,1992-1993,1992-12-01,1993-03-17,107,0,3,71,74,22,29,51,125,5,34,TN - Knoxville
43,1993-1994,1993-12-01,1994-03-02,92,0,13,110,123,6,11,17,140,4,10,TN - Knoxville
44,1994-1995,1994-12-01,1995-03-08,98,1,2,78,80,8,3,11,91,5,12,TN - Knoxville
47,1997-1998,1997-12-01,1998-02-28,90,0,1,46,47,6,5,11,58,4,10,TN - Knoxville
48,1998-1999,1998-12-01,1999-03-15,105,0,5,67,72,7,3,10,82,4,11,TN - Knoxville
49,1999-2000,1999-12-01,2000-02-29,91,0,6,80,86,3,5,8,94,1,6,TN - Knoxville
54,2004-2005,2004-12-01,2005-03-01,91,0,6,79,85,2,0,2,87,2,6,TN - Knoxville
55,2005-2006,2005-12-01,2006-02-28,90,0,0,76,76,6,2,8,84,4,12,TN - Knoxville
56,2006-2007,2006-12-01,2007-02-28,90,0,2,98,100,1,0,1,101,1,2,TN - Knoxville
57,2007-2008,2007-12-01,2008-02-29,91,0,2,83,85,0,0,0,85,0,0,TN - Knoxville
58,2008-2009,2008-12-01,2009-02-28,90,0,7,108,115,9,6,15,130,3,13,TN - Knoxville
59,2009-2010,2009-12-01,2010-03-02,92,0,14,111,125,10,10,20,145,5,17,TN - Knoxville
60,2010-2011,2010-12-01,2011-02-28,90,0,9,109,118,19,20,39,157,9,35,TN - Knoxville
61,2011-2012,2011-12-01,2012-02-29,91,0,2,53,55,1,0,1,56,1,1,TN - Knoxville
62,2012-2013,2012-12-01,2013-03-26,116,0,0,65,65,9,4,13,78,8,18,TN - Knoxville
63,2013-2014,2013-11-27,2014-03-25,119,0,10,135,145,18,20,38,183,8,34,TN - Knoxville
64,2014-2015,2014-11-18,2015-02-28,103,0,13,120,133,15,11,26,159,7,28,TN - Knoxville
65,2015-2016,2015-12-01,2016-02-29,91,0,8,71,79,10,3,13,92,8,26,TN - Knoxville
66,2016-2017,2016-12-01,2017-02-28,90,0,3,49,52,4,2,6,58,2,12,TN - Knoxville
67,2017-2018,2017-12-01,2018-02-28,90,0,12,100,112,5,2,7,119,4,11,TN - Knoxville
68,2018-2019,2018-12-01,2019-02-28,90,0,2,47,49,3,3,6,55,2,7,TN - Knoxville
69,2019-2020,2019-11-12,2020-02-29,110,0,1,43,44,6,1,7,51,4,9,TN - Knoxville
0,1950-1951,1950-11-23,1951-03-13,111,0,16,115,131,14,26,40,171,9,46,TN - Memphis
1,1951-1952,1951-11-02,1952-02-29,120,0,2,58,60,1,0,1,61,1,2,TN - Memphis
2,1952-1953,1952-12-01,1953-02-28,90,0,1,29,30,0,0,0,30,0,0,TN - Memphis
3,1953-1954,1953-12-01,1954-02-28,90,0,3,46,49,6,7,13,62,3,11,TN - Memphis
4,1954-1955,1954-12-01,1955-03-26,116,0,3,68,71,3,0,3,74,3,7,TN - Memphis
5,1955-1956,1955-12-01,1956-02-29,91,0,2,64,66,7,7,14,80,1,9,TN - Memphis
6,1956-1957,1956-12-01,1957-02-28,90,0,2,38,40,0,0,0,40,0,0,TN - Memphis
7,1957-1958,1957-12-01,1958-02-28,90,0,13,101,114,8,9,17,131,4,14,TN - Memphis
8,1958-1959,1958-12-01,1959-02-28,90,0,11,93,104,6,7,13,117,3,11,TN - Memphis
9,1959-1960,1959-12-01,1960-03-15,106,0,5,72,77,31,12,43,120,12,43,TN - Memphis
10,1960-1961,1960-12-01,1961-02-28,90,0,8,110,118,4,0,4,122,3,7,TN - Memphis
11,1961-1962,1961-12-01,1962-02-28,90,0,12,75,87,7,11,18,105,2,14,TN - Memphis
12,1962-1963,1962-12-01,1963-02-28,90,0,17,140,157,7,6,13,170,3,16,TN - Memphis
13,1963-1964,1963-12-01,1964-02-29,91,0,13,136,149,19,29,48,197,2,26,TN - Memphis
14,1964-1965,1964-11-30,1965-03-20,111,0,7,93,100,13,7,20,120,6,25,TN - Memphis
15,1965-1966,1965-12-01,1966-02-28,90,0,12,88,100,16,21,37,137,6,33,TN - Memphis
16,1966-1967,1966-12-01,1967-03-06,96,0,6,97,103,3,1,4,107,3,9,TN - Memphis
17,1967-1968,1967-12-01,1968-03-25,116,0,7,102,109,34,27,61,170,7,46,TN - Memphis
18,1968-1969,1968-12-01,1969-02-28,90,0,2,63,65,0,0,0,65,0,0,TN - Memphis
19,1969-1970,1969-12-01,1970-02-28,90,0,15,96,111,8,6,14,125,5,22,TN - Memphis
20,1970-1971,1970-11-24,1971-03-03,100,0,10,74,84,12,3,15,99,5,19,TN - Memphis
21,1971-1972,1971-11-23,1972-02-29,99,0,4,56,60,3,0,3,63,3,6,TN - Memphis
22,1972-1973,1972-12-01,1973-02-28,90,0,9,79,88,2,1,3,91,1,4,TN - Memphis
23,1973-1974,1973-12-01,1974-02-28,90,0,5,46,51,5,6,11,62,5,15,TN - Memphis
24,1974-1975,1974-12-01,1975-03-13,103,0,1,48,49,8,3,11,60,5,14,TN - Memphis
25,1975-1976,1975-12-01,1976-02-29,91,0,4,57,61,2,0,2,63,2,3,TN - Memphis
26,1976-1977,1976-11-14,1977-02-28,107,0,13,116,129,11,3,14,143,9,34,TN - Memphis
27,1977-1978,1977-12-01,1978-02-28,90,0,17,103,120,13,11,24,144,9,31,TN - Memphis
28,1978-1979,1978-12-01,1979-02-28,90,0,18,103,121,17,16,33,154,11,32,TN - Memphis
29,1979-1980,1979-12-01,1980-03-02,93,0,4,64,68,7,2,9,77,6,16,TN - Memphis
30,1980-1981,1980-12-01,1981-02-28,90,0,4,59,63,0,0,0,63,0,0,TN - Memphis
31,1981-1982,1981-12-01,1982-03-06,96,0,15,107,122,10,15,25,147,4,20,TN - Memphis
32,1982-1983,1982-12-01,1983-03-10,100,0,0,35,35,11,1,12,47,4,13,TN - Memphis
33,1983-1984,1983-12-01,1984-03-10,101,0,19,113,132,7,6,13,145,5,20,TN - Memphis
34,1984-1985,1984-12-01,1985-02-28,90,0,14,93,107,28,42,70,177,7,46,TN - Memphis
35,1985-1986,1985-12-01,1986-02-28,90,0,10,95,105,3,0,3,108,1,6,TN - Memphis
36,1986-1987,1986-12-01,1987-03-30,120,0,1,50,51,1,0,1,52,1,2,TN - Memphis
37,1987-1988,1987-12-01,1988-02-29,91,0,12,88,100,15,28,43,143,4,29,TN - Memphis
38,1988-1989,1988-12-01,1989-03-07,97,0,8,54,62,1,0,1,63,1,4,TN - Memphis
39,1989-1990,1989-12-01,1990-02-28,90,0,19,80,99,1,0,1,100,1,5,TN - Memphis
40,1990-1991,1990-12-01,1991-03-29,119,0,4,57,61,3,0,3,64,2,5,TN - Memphis
41,1991-1992,1991-11-07,1992-02-29,115,0,0,43,43,1,1,2,45,1,2,TN - Memphis
42,1992-1993,1992-12-01,1993-02-28,90,0,1,41,42,0,0,0,42,0,0,TN - Memphis
43,1993-1994,1993-12-01,1994-02-28,90,0,6,68,74,6,5,11,85,4,13,TN - Memphis
44,1994-1995,1994-12-01,1995-03-03,93,0,2,49,51,7,4,11,62,5,12,TN - Memphis
45,1995-1996,1995-12-01,1996-03-08,99,0,18,101,119,3,0,3,122,3,11,TN - Memphis
46,1996-1997,1996-12-01,1997-02-28,90,0,10,63,73,6,6,12,85,3,11,TN - Memphis
47,1997-1998,1997-12-01,1998-02-28,90,0,0,21,21,5,5,10,31,2,7,TN - Memphis
48,1998-1999,1998-12-01,1999-02-28,90,0,8,45,53,2,2,4,57,2,6,TN - Memphis
49,1999-2000,1999-12-01,2000-02-29,91,0,1,45,46,5,5,10,56,2,7,TN - Memphis
50,2000-2001,2000-12-01,2001-02-28,90,0,13,93,106,4,6,10,116,3,11,TN - Memphis
51,2001-2002,2001-12-01,2002-03-03,93,0,1,49,50,5,4,9,59,2,7,TN - Memphis
52,2002-2003,2002-12-01,2003-02-28,90,0,5,62,67,6,0,6,73,4,9,TN - Memphis
53,2003-2004,2003-12-01,2004-02-29,91,0,1,52,53,1,0,1,54,1,1,TN - Memphis
54,2004-2005,2004-12-01,2005-02-28,90,0,3,47,50,3,11,14,64,1,5,TN - Memphis
55,2005-2006,2005-12-01,2006-02-28,90,9,1,46,47,4,2,6,53,1,5,TN - Memphis
56,2006-2007,2006-12-01,2007-02-28,90,0,4,58,62,3,2,5,67,2,6,TN - Memphis
57,2007-2008,2007-12-01,2008-03-08,99,0,2,58,60,8,4,12,72,2,11,TN - Memphis
58,2008-2009,2008-12-01,2009-03-01,91,0,4,60,64,6,4,10,74,3,9,TN - Memphis
59,2009-2010,2009-12-01,2010-02-28,90,0,10,96,106,12,6,18,124,5,20,TN - Memphis
60,2010-2011,2010-12-01,2011-02-28,90,0,7,81,88,15,12,27,115,6,25,TN - Memphis
61,2011-2012,2011-11-28,2012-02-29,94,0,0,31,31,3,0,3,34,2,4,TN - Memphis
62,2012-2013,2012-12-01,2013-02-28,90,0,2,36,38,1,1,2,40,1,2,TN - Memphis
63,2013-2014,2013-12-01,2014-03-04,94,0,11,109,120,2,1,3,123,2,7,TN - Memphis
64,2014-2015,2014-11-13,2015-03-07,115,0,5,84,89,11,11,22,111,7,24,TN - Memphis
65,2015-2016,2015-12-01,2016-02-29,91,0,1,35,36,1,0,1,37,1,2,TN - Memphis
66,2016-2017,2016-12-01,2017-02-28,90,0,4,37,41,3,1,4,45,1,7,TN - Memphis
67,2017-2018,2017-12-01,2018-02-28,90,0,11,82,93,3,8,11,104,2,10,TN - Memphis
68,2018-2019,2018-11-14,2019-03-04,111,0,2,47,49,2,0,2,51,2,5,TN - Memphis
69,2019-2020,2019-11-12,2020-02-29,110,0,1,37,38,2,0,2,40,2,4,TN - Memphis
0,1950-1951,1950-11-23,1951-04-02,131,0,26,168,194,50,70,120,314,16,103,TN - Nashville
1,1951-1952,1951-11-02,1952-02-29,120,0,3,92,95,7,2,9,104,5,15,TN - Nashville
2,1952-1953,1952-11-29,1953-02-28,92,0,2,50,52,5,0,5,57,5,11,TN - Nashville
3,1953-1954,1953-12-01,1954-03-03,93,0,5,90,95,6,1,7,102,3,8,TN - Nashville
4,1954-1955,1954-11-02,1955-03-26,145,0,8,111,119,17,11,28,147,12,40,TN - Nashville
5,1955-1956,1955-11-28,1956-02-29,94,0,3,100,103,8,6,14,117,2,14,TN - Nashville
6,1956-1957,1956-12-01,1957-03-08,98,0,4,59,63,4,2,6,69,1,5,TN - Nashville
7,1957-1958,1957-11-22,1958-03-21,120,0,21,152,173,16,17,33,206,9,37,TN - Nashville
8,1958-1959,1958-12-01,1959-02-28,90,3,12,135,147,3,0,3,150,2,5,TN - Nashville
9,1959-1960,1959-11-28,1960-03-20,114,0,16,137,153,57,68,125,278,18,88,TN - Nashville
10,1960-1961,1960-12-01,1961-03-09,99,0,9,146,155,10,8,18,173,7,29,TN - Nashville
11,1961-1962,1961-12-01,1962-03-05,95,0,15,106,121,12,6,18,139,9,34,TN - Nashville
12,1962-1963,1962-12-01,1963-02-28,90,0,25,212,237,33,35,68,305,11,71,TN - Nashville
13,1963-1964,1963-12-01,1964-02-29,91,0,15,148,163,30,39,69,232,7,48,TN - Nashville
14,1964-1965,1964-11-30,1965-03-20,111,0,11,149,160,12,7,19,179,8,31,TN - Nashville
15,1965-1966,1965-11-30,1966-02-28,91,0,17,120,137,14,36,50,187,2,25,TN - Nashville
16,1966-1967,1966-11-02,1967-02-28,119,0,4,111,115,18,21,39,154,3,21,TN - Nashville
17,1967-1968,1967-12-01,1968-03-24,115,0,13,188,201,38,43,81,282,11,67,TN - Nashville
18,1968-1969,1968-12-01,1969-03-09,99,0,7,113,120,23,15,38,158,7,32,TN - Nashville
19,1969-1970,1969-11-14,1970-02-28,107,0,20,156,176,21,13,34,210,13,60,TN - Nashville
20,1970-1971,1970-11-23,1971-04-06,135,0,18,158,176,21,17,38,214,11,46,TN - Nashville
21,1971-1972,1971-11-23,1972-03-25,124,0,6,90,96,4,0,4,100,4,8,TN - Nashville
22,1972-1973,1972-11-30,1973-04-10,132,0,10,96,106,10,17,27,133,5,15,TN - Nashville
23,1973-1974,1973-12-01,1974-02-28,90,0,6,71,77,5,3,8,85,3,9,TN - Nashville
24,1974-1975,1974-12-01,1975-02-28,90,0,1,63,64,9,2,11,75,5,14,TN - Nashville
25,1975-1976,1975-12-01,1976-02-29,91,0,8,91,99,6,3,9,108,4,18,TN - Nashville
26,1976-1977,1976-11-11,1977-02-28,110,0,27,225,252,31,21,52,304,13,76,TN - Nashville
27,1977-1978,1977-11-26,1978-03-17,112,0,34,209,243,40,53,93,336,16,75,TN - Nashville
28,1978-1979,1978-12-01,1979-03-25,115,0,18,169,187,37,48,85,272,14,67,TN - Nashville
29,1979-1980,1979-12-01,1980-03-03,94,0,8,120,128,13,23,36,164,6,25,TN - Nashville
30,1980-1981,1980-12-01,1981-02-28,90,0,6,130,136,6,0,6,142,4,19,TN - Nashville
31,1981-1982,1981-12-01,1982-03-07,97,0,21,151,172,17,21,38,210,10,44,TN - Nashville
32,1982-1983,1982-12-01,1983-02-28,90,0,0,59,59,3,0,3,62,3,7,TN - Nashville
33,1983-1984,1983-12-01,1984-02-29,91,0,34,170,204,14,26,40,244,7,35,TN - Nashville
34,1984-1985,1984-12-01,1985-02-28,90,0,25,153,178,28,48,76,254,11,79,TN - Nashville
35,1985-1986,1985-12-01,1986-02-28,90,0,17,148,165,8,3,11,176,6,28,TN - Nashville
36,1986-1987,1986-12-01,1987-03-30,120,0,5,87,92,9,2,11,103,7,23,TN - Nashville
37,1987-1988,1987-12-01,1988-02-29,91,0,15,127,142,19,27,46,188,7,45,TN - Nashville
38,1988-1989,1988-12-01,1989-02-28,90,0,4,76,80,11,6,17,97,5,20,TN - Nashville
39,1989-1990,1989-12-01,1990-03-19,109,0,24,119,143,4,0,4,147,4,20,TN - Nashville
40,1990-1991,1990-12-01,1991-03-29,119,0,6,84,90,6,0,6,96,5,16,TN - Nashville
41,1991-1992,1991-12-01,1992-03-12,103,0,2,66,68,2,0,2,70,1,3,TN - Nashville
42,1992-1993,1992-12-01,1993-03-14,104,0,3,83,86,12,7,19,105,5,20,TN - Nashville
43,1993-1994,1993-10-31,1994-02-28,121,0,15,135,150,8,4,12,162,6,22,TN - Nashville
44,1994-1995,1994-12-01,1995-03-08,98,0,7,90,97,8,1,9,106,6,19,TN - Nashville
45,1995-1996,1995-12-01,1996-03-21,112,0,25,152,177,27,34,61,238,13,64,TN - Nashville
55,2005-2006,2005-12-01,2006-02-28,90,0,2,75,77,5,2,7,84,5,17,TN - Nashville
56,2006-2007,2006-12-01,2007-02-28,90,0,6,92,98,4,1,5,103,3,10,TN - Nashville
57,2007-2008,2007-12-01,2008-03-08,99,0,3,91,94,4,1,5,99,4,12,TN - Nashville
58,2008-2009,2008-12-01,2009-03-01,91,0,7,109,116,5,1,6,122,4,10,TN - Nashville
59,2009-2010,2009-12-01,2010-02-28,90,0,15,134,149,13,13,26,175,9,47,TN - Nashville
60,2010-2011,2010-12-01,2011-02-28,90,0,16,126,142,20,18,38,180,12,48,TN - Nashville
61,2011-2012,2011-12-01,2012-02-29,91,0,0,58,58,2,0,2,60,2,4,TN - Nashville
62,2012-2013,2012-12-01,2013-03-02,92,0,2,58,60,5,0,5,65,5,13,TN - Nashville
63,2013-2014,2013-11-25,2014-03-25,121,0,16,171,187,8,0,8,195,8,23,TN - Nashville
64,2014-2015,2014-11-17,2015-03-05,109,0,11,133,144,12,4,16,160,10,44,TN - Nashville
65,2015-2016,2015-12-01,2016-02-29,91,0,5,74,79,18,21,39,118,5,28,TN - Nashville
66,2016-2017,2016-12-01,2017-03-11,101,0,6,55,61,4,0,4,65,3,11,TN - Nashville
67,2017-2018,2017-12-01,2018-03-12,102,0,15,112,127,6,4,10,137,5,22,TN - Nashville
68,2018-2019,2018-12-01,2019-02-28,90,0,3,45,48,2,0,2,50,2,7,TN - Nashville
69,2019-2020,2019-11-11,2020-02-29,111,0,2,48,50,3,1,4,54,3,5,TN - Nashville
0,1950-1951,1950-12-01,1951-02-28,90,0,15,91,106,7,4,11,117,4,25,TX - Abilene
1,1951-1952,1951-12-01,1952-02-29,91,0,2,43,45,1,0,1,46,1,2,TX - Abilene
2,1952-1953,1952-12-01,1953-02-28,90,0,1,38,39,2,1,3,42,1,6,TX - Abilene
3,1953-1954,1953-12-01,1954-03-04,94,0,3,57,60,3,5,8,68,2,10,TX - Abilene
4,1954-1955,1954-12-01,1955-02-28,90,0,0,46,46,9,10,19,65,2,11,TX - Abilene
5,1955-1956,1955-12-01,1956-02-29,91,0,6,71,77,14,14,28,105,4,25,TX - Abilene
6,1956-1957,1956-12-01,1957-02-28,90,0,3,37,40,0,0,0,40,0,0,TX - Abilene
7,1957-1958,1957-11-22,1958-03-12,111,0,2,52,54,18,9,27,81,7,28,TX - Abilene
8,1958-1959,1958-12-01,1959-02-28,90,0,7,99,106,8,4,12,118,2,14,TX - Abilene
9,1959-1960,1959-12-01,1960-03-04,95,0,6,69,75,2,1,3,78,1,7,TX - Abilene
10,1960-1961,1960-12-01,1961-02-28,90,0,6,75,81,14,18,32,113,8,37,TX - Abilene
11,1961-1962,1961-12-01,1962-03-15,105,0,8,100,108,9,3,12,120,3,19,TX - Abilene
12,1962-1963,1962-12-01,1963-02-28,90,0,8,105,113,5,5,10,123,3,17,TX - Abilene
13,1963-1964,1963-12-01,1964-02-29,91,0,2,66,68,11,7,18,86,4,16,TX - Abilene
14,1964-1965,1964-12-01,1965-02-28,90,0,1,54,55,0,0,0,55,0,0,TX - Abilene
15,1965-1966,1965-12-01,1966-02-28,90,0,7,73,80,11,12,23,103,5,22,TX - Abilene
16,1966-1967,1966-12-01,1967-02-28,90,0,0,87,87,0,0,0,87,0,0,TX - Abilene
17,1967-1968,1967-12-01,1968-03-12,103,0,6,65,71,12,11,23,94,5,20,TX - Abilene
18,1968-1969,1968-11-08,1969-03-02,115,0,1,59,60,11,2,13,73,4,11,TX - Abilene
19,1969-1970,1969-12-01,1970-03-21,111,0,4,69,73,19,7,26,99,7,23,TX - Abilene
20,1970-1971,1970-12-01,1971-03-02,92,0,3,67,70,3,1,4,74,2,8,TX - Abilene
21,1971-1972,1971-12-01,1972-02-29,91,0,2,67,69,3,0,3,72,3,13,TX - Abilene
22,1972-1973,1972-11-29,1973-02-28,92,0,16,102,118,24,17,41,159,8,45,TX - Abilene
23,1973-1974,1973-12-01,1974-02-28,90,0,6,77,83,1,0,1,84,1,2,TX - Abilene
24,1974-1975,1974-12-01,1975-02-28,90,0,1,58,59,12,9,21,80,3,19,TX - Abilene
25,1975-1976,1975-12-01,1976-02-29,91,0,2,75,77,4,1,5,82,2,6,TX - Abilene
26,1976-1977,1976-11-12,1977-02-28,109,0,9,123,132,13,9,22,154,5,32,TX - Abilene
27,1977-1978,1977-12-01,1978-03-03,93,0,7,105,112,10,2,12,124,7,25,TX - Abilene
28,1978-1979,1978-12-01,1979-02-28,90,0,13,101,114,11,8,19,133,6,28,TX - Abilene
29,1979-1980,1979-12-01,1980-03-01,92,0,5,52,57,5,4,9,66,3,11,TX - Abilene
30,1980-1981,1980-11-16,1981-02-28,105,0,1,52,53,9,4,13,66,6,15,TX - Abilene
31,1981-1982,1981-12-01,1982-02-28,90,0,7,75,82,10,5,15,97,4,21,TX - Abilene
32,1982-1983,1982-12-01,1983-02-28,90,0,0,46,46,18,17,35,81,5,24,TX - Abilene
33,1983-1984,1983-12-01,1984-03-05,96,0,25,107,132,14,12,26,158,8,35,TX - Abilene
34,1984-1985,1984-12-01,1985-02-28,90,0,17,80,97,10,14,24,121,4,33,TX - Abilene
35,1985-1986,1985-12-01,1986-02-28,90,0,7,68,75,1,0,1,76,1,4,TX - Abilene
36,1986-1987,1986-11-13,1987-02-28,108,0,3,43,46,9,7,16,62,4,17,TX - Abilene
37,1987-1988,1987-12-01,1988-02-29,91,0,8,80,88,8,4,12,100,4,17,TX - Abilene
38,1988-1989,1988-12-01,1989-03-21,111,0,8,68,76,9,8,17,93,4,17,TX - Abilene
39,1989-1990,1989-12-01,1990-02-28,90,0,6,73,79,0,0,0,79,0,0,TX - Abilene
40,1990-1991,1990-12-01,1991-02-28,90,0,10,62,72,6,6,12,84,3,15,TX - Abilene
41,1991-1992,1991-12-01,1992-02-29,91,0,0,33,33,2,1,3,36,2,4,TX - Abilene
42,1992-1993,1992-11-21,1993-03-12,112,0,3,50,53,4,3,7,60,2,5,TX - Abilene
43,1993-1994,1993-10-29,1994-02-28,123,0,2,71,73,7,3,10,83,5,14,TX - Abilene
44,1994-1995,1994-12-01,1995-03-02,92,0,3,34,37,10,4,14,51,3,13,TX - Abilene
45,1995-1996,1995-11-28,1996-04-05,130,0,6,106,112,23,3,26,138,5,35,TX - Abilene
46,1996-1997,1996-11-24,1997-02-28,97,0,9,72,81,6,3,9,90,5,11,TX - Abilene
47,1997-1998,1997-12-01,1998-02-28,90,8,0,41,41,0,0,0,41,0,0,TX - Abilene
48,1998-1999,1998-12-01,1999-02-28,90,1,5,52,57,0,0,0,57,0,0,TX - Abilene
49,1999-2000,1999-12-01,2000-02-29,91,0,1,41,42,0,0,0,42,0,0,TX - Abilene
50,2000-2001,2000-11-08,2001-02-28,113,9,7,72,79,5,4,9,88,2,9,TX - Abilene
51,2001-2002,2001-11-28,2002-02-28,93,2,1,56,57,7,5,12,69,1,10,TX - Abilene
52,2002-2003,2002-12-01,2003-02-28,90,0,2,51,53,2,1,3,56,1,6,TX - Abilene
54,2004-2005,2004-12-01,2005-03-27,117,0,2,43,45,8,2,10,55,2,10,TX - Abilene
55,2005-2006,2005-12-01,2006-02-28,90,0,4,55,59,0,0,0,59,0,0,TX - Abilene
56,2006-2007,2006-11-30,2007-02-28,91,0,8,66,74,3,2,5,79,3,10,TX - Abilene
57,2007-2008,2007-11-22,2008-03-06,106,0,0,70,70,10,1,11,81,4,14,TX - Abilene
58,2008-2009,2008-12-01,2009-02-28,90,0,2,68,70,0,0,0,70,0,0,TX - Abilene
59,2009-2010,2009-12-01,2010-02-28,90,0,1,83,84,19,9,28,112,5,24,TX - Abilene
60,2010-2011,2010-12-01,2011-02-28,90,0,8,80,88,6,13,19,107,3,18,TX - Abilene
61,2011-2012,2011-12-01,2012-02-29,91,0,1,33,34,4,2,6,40,2,6,TX - Abilene
62,2012-2013,2012-12-01,2013-02-28,90,0,0,57,57,3,1,4,61,2,6,TX - Abilene
63,2013-2014,2013-11-22,2014-02-28,99,2,8,105,113,6,6,12,125,5,22,TX - Abilene
64,2014-2015,2014-11-16,2015-03-05,110,0,8,64,72,7,2,9,81,5,20,TX - Abilene
65,2015-2016,2015-12-01,2016-02-29,91,0,0,33,33,7,6,13,46,3,9,TX - Abilene
66,2016-2017,2016-12-01,2017-02-28,90,0,2,46,48,0,0,0,48,0,0,TX - Abilene
67,2017-2018,2017-12-01,2018-02-28,90,0,7,97,104,1,0,1,105,1,3,TX - Abilene
68,2018-2019,2018-12-01,2019-03-04,94,0,2,37,39,5,0,5,44,2,7,TX - Abilene
69,2019-2020,2019-12-01,2020-02-29,91,0,1,39,40,6,0,6,46,2,10,TX - Abilene
0,1950-1951,1950-12-01,1951-03-17,107,0,23,197,220,11,8,19,239,9,51,TX - Amarillo
1,1951-1952,1951-11-01,1952-03-21,142,0,10,186,196,19,21,40,236,12,60,TX - Amarillo
2,1952-1953,1952-11-23,1953-02-28,98,0,10,149,159,39,43,82,241,9,61,TX - Amarillo
3,1953-1954,1953-11-21,1954-03-05,105,0,10,147,157,11,6,17,174,8,45,TX - Amarillo
4,1954-1955,1954-12-01,1955-04-01,122,0,7,190,197,7,1,8,205,6,21,TX - Amarillo
5,1955-1956,1955-11-07,1956-03-15,130,0,16,227,243,27,43,70,313,9,69,TX - Amarillo
6,1956-1957,1956-12-01,1957-04-12,133,0,11,151,162,20,12,32,194,7,43,TX - Amarillo
7,1957-1958,1957-11-21,1958-03-23,123,0,12,173,185,30,22,52,237,13,59,TX - Amarillo
8,1958-1959,1958-11-17,1959-03-21,125,0,22,244,266,18,16,34,300,14,83,TX - Amarillo
9,1959-1960,1959-11-05,1960-03-04,121,0,31,236,267,29,51,80,347,13,83,TX - Amarillo
10,1960-1961,1960-12-01,1961-04-05,126,0,13,183,196,36,20,56,252,15,66,TX - Amarillo
11,1961-1962,1961-11-06,1962-02-28,115,0,28,202,230,16,22,38,268,10,57,TX - Amarillo
12,1962-1963,1962-11-17,1963-02-28,104,0,27,213,240,22,13,35,275,10,77,TX - Amarillo
13,1963-1964,1963-12-01,1964-02-29,91,0,16,198,214,31,38,69,283,9,66,TX - Amarillo
14,1964-1965,1964-12-01,1965-03-25,115,0,13,193,206,22,11,33,239,14,58,TX - Amarillo
15,1965-1966,1965-12-01,1966-03-03,93,0,27,208,235,16,42,58,293,10,60,TX - Amarillo
16,1966-1967,1966-12-01,1967-03-05,95,0,5,181,186,7,3,10,196,6,25,TX - Amarillo
17,1967-1968,1967-11-27,1968-03-20,115,0,18,157,175,29,25,54,229,15,81,TX - Amarillo
18,1968-1969,1968-11-08,1969-03-16,129,0,9,198,207,24,12,36,243,15,53,TX - Amarillo
19,1969-1970,1969-12-01,1970-04-04,125,0,18,180,198,35,42,77,275,13,64,TX - Amarillo
20,1970-1971,1970-10-08,1971-03-02,146,0,17,178,195,33,27,60,255,10,60,TX - Amarillo
21,1971-1972,1971-11-30,1972-03-30,122,0,16,192,208,17,28,45,253,8,50,TX - Amarillo
22,1972-1973,1972-10-31,1973-04-09,161,0,37,231,268,46,48,94,362,25,133,TX - Amarillo
23,1973-1974,1973-11-20,1974-03-23,124,0,20,180,200,13,12,25,225,9,50,TX - Amarillo
24,1974-1975,1974-11-29,1975-03-29,121,0,12,194,206,28,29,57,263,15,77,TX - Amarillo
25,1975-1976,1975-11-25,1976-03-09,106,0,8,169,177,11,2,13,190,5,18,TX - Amarillo
26,1976-1977,1976-10-19,1977-02-28,133,0,19,237,256,28,26,54,310,16,75,TX - Amarillo
27,1977-1978,1977-11-01,1978-05-03,184,0,32,255,287,32,35,67,354,19,103,TX - Amarillo
28,1978-1979,1978-11-15,1979-02-28,106,0,51,252,303,23,18,41,344,14,96,TX - Amarillo
29,1979-1980,1979-10-30,1980-03-29,152,0,17,247,264,17,22,39,303,11,44,TX - Amarillo
30,1980-1981,1980-11-16,1981-03-07,112,0,9,184,193,16,18,34,227,8,40,TX - Amarillo
31,1981-1982,1981-12-01,1982-03-05,95,0,19,205,224,13,17,30,254,8,55,TX - Amarillo
32,1982-1983,1982-11-24,1983-04-08,136,0,15,210,225,69,125,194,419,21,122,TX - Amarillo
33,1983-1984,1983-11-27,1984-03-30,125,0,64,284,348,27,64,91,439,13,98,TX - Amarillo
34,1984-1985,1984-09-29,1985-03-30,183,0,22,192,214,18,16,34,248,11,61,TX - Amarillo
35,1985-1986,1985-12-01,1986-03-13,103,0,24,163,187,23,42,65,252,7,68,TX - Amarillo
36,1986-1987,1986-11-13,1987-04-02,141,0,14,179,193,36,66,102,295,17,83,TX - Amarillo
37,1987-1988,1987-11-18,1988-04-02,137,0,28,261,289,49,77,126,415,17,112,TX - Amarillo
38,1988-1989,1988-11-19,1989-04-10,143,0,19,238,257,15,8,23,280,8,38,TX - Amarillo
39,1989-1990,1989-12-01,1990-03-24,114,0,17,196,213,26,21,47,260,10,57,TX - Amarillo
40,1990-1991,1990-11-03,1991-03-30,148,0,22,214,236,20,23,43,279,8,64,TX - Amarillo
41,1991-1992,1991-10-30,1992-04-01,155,0,7,153,160,13,10,23,183,9,30,TX - Amarillo
42,1992-1993,1992-11-21,1993-03-12,112,0,28,230,258,41,57,98,356,12,89,TX - Amarillo
43,1993-1994,1993-11-24,1994-03-10,107,0,9,210,219,20,28,48,267,4,38,TX - Amarillo
44,1994-1995,1994-12-01,1995-03-03,93,0,11,121,132,10,7,17,149,7,34,TX - Amarillo
45,1995-1996,1995-11-10,1996-03-06,118,0,24,214,238,17,15,32,270,11,74,TX - Amarillo
46,1996-1997,1996-10-21,1997-04-25,187,0,24,216,240,45,43,88,328,17,105,TX - Amarillo
47,1997-1998,1997-11-09,1998-03-19,131,0,11,168,179,49,60,109,288,21,83,TX - Amarillo
48,1998-1999,1998-12-01,1999-03-19,109,2,13,135,148,22,15,37,185,8,47,TX - Amarillo
49,1999-2000,1999-12-01,2000-04-01,123,0,4,145,149,18,17,35,184,7,31,TX - Amarillo
50,2000-2001,2000-11-07,2001-03-26,140,0,15,200,215,67,108,175,390,18,108,TX - Amarillo
51,2001-2002,2001-11-27,2002-03-02,96,0,8,149,157,16,15,31,188,9,49,TX - Amarillo
52,2002-2003,2002-12-01,2003-03-27,117,0,10,175,185,21,23,44,229,8,42,TX - Amarillo
53,2003-2004,2003-12-01,2004-04-12,134,0,5,147,152,18,8,26,178,10,41,TX - Amarillo
54,2004-2005,2004-11-01,2005-05-02,183,0,11,140,151,56,41,97,248,16,86,TX - Amarillo
55,2005-2006,2005-11-27,2006-03-23,117,0,12,189,201,5,1,6,207,4,14,TX - Amarillo
56,2006-2007,2006-11-29,2007-04-14,137,0,20,180,200,39,53,92,292,14,80,TX - Amarillo
57,2007-2008,2007-11-23,2008-03-06,105,0,6,177,183,19,7,26,209,11,45,TX - Amarillo
58,2008-2009,2008-12-01,2009-03-29,119,0,10,172,182,21,10,31,213,7,42,TX - Amarillo
59,2009-2010,2009-11-29,2010-03-25,117,0,16,213,229,43,64,107,336,17,81,TX - Amarillo
60,2010-2011,2010-11-12,2011-02-28,109,0,18,212,230,21,19,40,270,7,57,TX - Amarillo
61,2011-2012,2011-10-27,2012-03-02,128,0,10,147,157,18,14,32,189,8,36,TX - Amarillo
62,2012-2013,2012-12-01,2013-03-23,113,0,5,139,144,45,38,83,227,11,71,TX - Amarillo
63,2013-2014,2013-11-22,2014-04-14,144,0,33,246,279,21,17,38,317,12,84,TX - Amarillo
64,2014-2015,2014-11-12,2015-03-04,113,0,20,179,199,34,36,70,269,11,79,TX - Amarillo
65,2015-2016,2015-11-26,2016-03-27,123,0,7,133,140,21,13,34,174,13,44,TX - Amarillo
66,2016-2017,2016-12-01,2017-04-30,151,0,8,149,157,15,11,26,183,8,40,TX - Amarillo
67,2017-2018,2017-12-01,2018-02-28,90,0,13,180,193,0,0,0,193,0,0,TX - Amarillo
68,2018-2019,2018-11-11,2019-03-04,114,0,11,186,197,14,10,24,221,9,42,TX - Amarillo
69,2019-2020,2019-10-24,2020-04-14,174,0,4,170,174,16,10,26,200,6,27,TX - Amarillo
0,1950-1951,1950-12-01,1951-02-28,90,0,6,45,51,3,2,5,56,2,9,TX - Austin
1,1951-1952,1951-12-01,1952-02-29,91,0,0,14,14,0,0,0,14,0,0,TX - Austin
2,1952-1953,1952-12-01,1953-02-28,90,0,0,10,10,0,0,0,10,0,0,TX - Austin
3,1953-1954,1953-12-01,1954-02-28,90,0,0,20,20,0,0,0,20,0,0,TX - Austin
4,1954-1955,1954-12-01,1955-02-28,90,0,0,13,13,0,0,0,13,0,0,TX - Austin
5,1955-1956,1955-12-01,1956-02-29,91,0,1,15,16,0,0,0,16,0,0,TX - Austin
6,1956-1957,1956-12-01,1957-02-28,90,0,0,4,4,0,0,0,4,0,0,TX - Austin
7,1957-1958,1957-12-01,1958-02-28,90,0,0,15,15,1,0,1,16,1,2,TX - Austin
8,1958-1959,1958-12-01,1959-02-28,90,0,1,30,31,0,0,0,31,0,0,TX - Austin
9,1959-1960,1959-11-14,1960-02-29,108,0,0,26,26,2,0,2,28,1,3,TX - Austin
10,1960-1961,1960-12-01,1961-02-28,90,0,1,15,16,0,0,0,16,0,0,TX - Austin
11,1961-1962,1961-12-01,1962-02-28,90,0,5,31,36,0,0,0,36,0,0,TX - Austin
12,1962-1963,1962-12-01,1963-02-28,90,0,2,45,47,2,0,2,49,1,3,TX - Austin
13,1963-1964,1963-12-01,1964-02-29,91,0,1,34,35,7,1,8,43,2,9,TX - Austin
14,1964-1965,1964-12-01,1965-03-03,93,0,0,21,21,4,2,6,27,2,7,TX - Austin
15,1965-1966,1965-12-01,1966-02-28,90,0,0,28,28,9,5,14,42,2,11,TX - Austin
16,1966-1967,1966-12-01,1967-02-28,90,0,0,28,28,3,1,4,32,1,4,TX - Austin
17,1967-1968,1967-12-01,1968-02-29,91,0,2,24,26,0,0,0,26,0,0,TX - Austin
18,1968-1969,1968-12-01,1969-02-28,90,0,0,16,16,0,0,0,16,0,0,TX - Austin
19,1969-1970,1969-12-01,1970-02-28,90,0,1,27,28,2,1,3,31,1,3,TX - Austin
20,1970-1971,1970-12-01,1971-02-28,90,0,0,18,18,0,0,0,18,0,0,TX - Austin
21,1971-1972,1971-12-01,1972-02-29,91,0,0,19,19,0,0,0,19,0,0,TX - Austin
22,1972-1973,1972-12-01,1973-02-28,90,0,3,31,34,5,2,7,41,5,15,TX - Austin
23,1973-1974,1973-12-01,1974-02-28,90,0,1,20,21,0,0,0,21,0,0,TX - Austin
24,1974-1975,1974-12-01,1975-02-28,90,0,0,20,20,0,0,0,20,0,0,TX - Austin
25,1975-1976,1975-12-01,1976-02-29,91,0,0,20,20,0,0,0,20,0,0,TX - Austin
26,1976-1977,1976-12-01,1977-02-28,90,0,0,34,34,0,0,0,34,0,0,TX - Austin
27,1977-1978,1977-12-01,1978-02-28,90,0,1,38,39,0,0,0,39,0,0,TX - Austin
28,1978-1979,1978-12-01,1979-02-28,90,0,2,50,52,0,0,0,52,0,0,TX - Austin
29,1979-1980,1979-12-01,1980-02-29,91,0,0,11,11,0,0,0,11,0,0,TX - Austin
30,1980-1981,1980-11-25,1981-02-28,96,0,0,17,17,4,0,4,21,2,4,TX - Austin
31,1981-1982,1981-12-01,1982-02-28,90,0,1,29,30,3,2,5,35,1,5,TX - Austin
32,1982-1983,1982-12-01,1983-02-28,90,0,0,10,10,0,0,0,10,0,0,TX - Austin
33,1983-1984,1983-12-01,1984-02-29,91,0,7,55,62,0,0,0,62,0,0,TX - Austin
34,1984-1985,1984-12-01,1985-02-28,90,0,6,31,37,11,11,22,59,4,22,TX - Austin
35,1985-1986,1985-12-01,1986-02-28,90,0,0,13,13,0,0,0,13,0,0,TX - Austin
36,1986-1987,1986-12-01,1987-02-28,90,0,0,5,5,0,0,0,5,0,0,TX - Austin
37,1987-1988,1987-12-01,1988-02-29,91,0,0,23,23,0,0,0,23,0,0,TX - Austin
38,1988-1989,1988-12-01,1989-02-28,90,0,5,16,21,0,0,0,21,0,0,TX - Austin
39,1989-1990,1989-12-01,1990-02-28,90,0,3,33,36,0,0,0,36,0,0,TX - Austin
40,1990-1991,1990-12-01,1991-02-28,90,0,2,19,21,0,0,0,21,0,0,TX - Austin
41,1991-1992,1991-12-01,1992-02-29,91,0,0,3,3,0,0,0,3,0,0,TX - Austin
42,1992-1993,1992-12-01,1993-02-28,90,0,0,1,1,0,0,0,1,0,0,TX - Austin
43,1993-1994,1993-12-01,1994-02-28,90,0,0,9,9,1,0,1,10,1,2,TX - Austin
44,1994-1995,1994-12-01,1995-02-28,90,0,0,3,3,0,0,0,3,0,0,TX - Austin
45,1995-1996,1995-12-01,1996-02-29,91,0,2,26,28,1,0,1,29,1,3,TX - Austin
53,2003-2004,2003-12-01,2004-02-29,91,0,0,9,9,2,1,3,12,1,2,TX - Austin
54,2004-2005,2004-12-01,2005-02-28,90,0,0,14,14,0,0,0,14,0,0,TX - Austin
55,2005-2006,2005-12-01,2006-02-28,90,0,0,9,9,0,0,0,9,0,0,TX - Austin
56,2006-2007,2006-12-01,2007-02-28,90,0,1,14,15,2,1,3,18,2,5,TX - Austin
57,2007-2008,2007-12-01,2008-02-29,91,0,0,14,14,0,0,0,14,0,0,TX - Austin
58,2008-2009,2008-12-01,2009-02-28,90,0,0,11,11,1,0,1,12,1,1,TX - Austin
59,2009-2010,2009-12-01,2010-02-28,90,0,0,27,27,1,0,1,28,1,1,TX - Austin
60,2010-2011,2010-12-01,2011-02-28,90,0,2,30,32,1,0,1,33,1,3,TX - Austin
61,2011-2012,2011-12-01,2012-02-29,91,0,0,7,7,0,0,0,7,0,0,TX - Austin
62,2012-2013,2012-12-01,2013-02-28,90,0,0,11,11,0,0,0,11,0,0,TX - Austin
63,2013-2014,2013-12-01,2014-02-28,90,0,2,24,26,2,0,2,28,2,4,TX - Austin
64,2014-2015,2014-12-01,2015-02-28,90,0,0,12,12,0,0,0,12,0,0,TX - Austin
65,2015-2016,2015-12-01,2016-02-29,91,0,0,4,4,0,0,0,4,0,0,TX - Austin
66,2016-2017,2016-12-01,2017-02-28,90,0,0,10,10,0,0,0,10,0,0,TX - Austin
67,2017-2018,2017-12-01,2018-02-28,90,0,2,18,20,1,0,1,21,1,2,TX - Austin
68,2018-2019,2018-12-01,2019-02-28,90,0,0,5,5,0,0,0,5,0,0,TX - Austin
69,2019-2020,2019-12-01,2020-02-29,91,0,0,3,3,0,0,0,3,0,0,TX - Austin
0,1950-1951,1950-12-01,1951-02-28,90,0,13,68,81,9,15,24,105,5,29,TX - Dallas-Fort Worth
1,1951-1952,1951-11-02,1952-02-29,120,0,0,36,36,1,0,1,37,1,2,TX - Dallas-Fort Worth
2,1952-1953,1952-12-01,1953-02-28,90,0,1,13,14,2,1,3,17,1,6,TX - Dallas-Fort Worth
3,1953-1954,1953-12-01,1954-03-05,95,0,3,44,47,4,3,7,54,2,10,TX - Dallas-Fort Worth
4,1954-1955,1954-12-01,1955-02-28,90,0,0,34,34,0,0,0,34,0,0,TX - Dallas-Fort Worth
5,1955-1956,1955-12-01,1956-02-29,91,0,2,39,41,6,10,16,57,3,11,TX - Dallas-Fort Worth
6,1956-1957,1956-12-01,1957-02-28,90,0,4,28,32,0,0,0,32,0,0,TX - Dallas-Fort Worth
7,1957-1958,1957-12-01,1958-02-28,90,0,0,39,39,2,1,3,42,2,5,TX - Dallas-Fort Worth
8,1958-1959,1958-12-01,1959-02-28,90,0,5,68,73,5,1,6,79,3,10,TX - Dallas-Fort Worth
9,1959-1960,1959-12-01,1960-03-01,92,0,4,48,52,4,1,5,57,3,9,TX - Dallas-Fort Worth
10,1960-1961,1960-12-01,1961-02-28,90,0,3,56,59,9,8,17,76,4,19,TX - Dallas-Fort Worth
11,1961-1962,1961-12-01,1962-03-14,104,0,9,79,88,7,5,12,100,3,15,TX - Dallas-Fort Worth
12,1962-1963,1962-12-01,1963-03-05,95,0,9,87,96,1,0,1,97,1,1,TX - Dallas-Fort Worth
13,1963-1964,1963-12-01,1964-03-09,100,0,2,87,89,23,16,39,128,7,37,TX - Dallas-Fort Worth
14,1964-1965,1964-12-01,1965-02-28,90,0,1,56,57,0,0,0,57,0,0,TX - Dallas-Fort Worth
15,1965-1966,1965-12-01,1966-02-28,90,4,5,47,52,6,7,13,65,4,14,TX - Dallas-Fort Worth
16,1966-1967,1966-12-01,1967-02-28,90,0,0,58,58,0,0,0,58,0,0,TX - Dallas-Fort Worth
17,1967-1968,1967-12-01,1968-02-29,91,0,4,43,47,6,3,9,56,4,14,TX - Dallas-Fort Worth
18,1968-1969,1968-12-01,1969-02-28,90,0,1,35,36,0,0,0,36,0,0,TX - Dallas-Fort Worth
19,1969-1970,1969-12-01,1970-03-21,111,0,2,54,56,2,1,3,59,2,2,TX - Dallas-Fort Worth
20,1970-1971,1970-12-01,1971-03-03,93,0,1,52,53,2,2,4,57,1,3,TX - Dallas-Fort Worth
21,1971-1972,1971-12-01,1972-02-29,91,0,0,31,31,0,0,0,31,0,0,TX - Dallas-Fort Worth
22,1972-1973,1972-12-01,1973-02-28,90,0,5,49,54,6,6,12,66,3,14,TX - Dallas-Fort Worth
23,1973-1974,1973-12-01,1974-02-28,90,0,3,42,45,0,0,0,45,0,0,TX - Dallas-Fort Worth
24,1974-1975,1974-12-01,1975-02-28,90,1,0,26,26,4,2,6,32,1,5,TX - Dallas-Fort Worth
25,1975-1976,1975-12-01,1976-02-29,91,0,1,46,47,1,0,1,48,1,1,TX - Dallas-Fort Worth
26,1976-1977,1976-11-13,1977-02-28,108,0,5,86,91,15,13,28,119,4,25,TX - Dallas-Fort Worth
27,1977-1978,1977-12-01,1978-02-28,90,0,12,105,117,24,38,62,179,8,44,TX - Dallas-Fort Worth
28,1978-1979,1978-12-01,1979-02-28,90,0,9,81,90,6,4,10,100,5,15,TX - Dallas-Fort Worth
29,1979-1980,1979-12-01,1980-02-29,91,0,0,38,38,3,1,4,42,2,7,TX - Dallas-Fort Worth
30,1980-1981,1980-12-01,1981-02-28,90,0,1,47,48,0,0,0,48,0,0,TX - Dallas-Fort Worth
31,1981-1982,1981-12-01,1982-02-28,90,0,5,72,77,1,0,1,78,1,2,TX - Dallas-Fort Worth
32,1982-1983,1982-12-01,1983-02-28,90,0,0,26,26,0,0,0,26,0,0,TX - Dallas-Fort Worth
33,1983-1984,1983-12-01,1984-02-29,91,0,23,99,122,3,2,5,127,1,4,TX - Dallas-Fort Worth
34,1984-1985,1984-12-01,1985-02-28,90,0,10,64,74,8,12,20,94,4,23,TX - Dallas-Fort Worth
35,1985-1986,1985-12-01,1986-02-28,90,0,3,52,55,1,0,1,56,1,2,TX - Dallas-Fort Worth
36,1986-1987,1986-12-01,1987-03-29,119,0,0,29,29,4,0,4,33,3,6,TX - Dallas-Fort Worth
37,1987-1988,1987-12-01,1988-02-29,91,0,4,56,60,6,4,10,70,4,13,TX - Dallas-Fort Worth
38,1988-1989,1988-12-01,1989-03-21,111,0,9,48,57,6,2,8,65,6,25,TX - Dallas-Fort Worth
39,1989-1990,1989-12-01,1990-02-28,90,0,8,61,69,0,0,0,69,0,0,TX - Dallas-Fort Worth
40,1990-1991,1990-12-01,1991-02-28,90,0,5,50,55,3,0,3,58,3,15,TX - Dallas-Fort Worth
41,1991-1992,1991-12-01,1992-02-29,91,0,0,16,16,0,0,0,16,0,0,TX - Dallas-Fort Worth
42,1992-1993,1992-12-01,1993-02-28,90,0,0,13,13,0,0,0,13,0,0,TX - Dallas-Fort Worth
43,1993-1994,1993-11-25,1994-02-28,96,0,0,40,40,2,0,2,42,2,6,TX - Dallas-Fort Worth
44,1994-1995,1994-12-01,1995-02-28,90,0,0,18,18,0,0,0,18,0,0,TX - Dallas-Fort Worth
55,2005-2006,2005-12-01,2006-02-28,90,0,2,25,27,0,0,0,27,0,0,TX - Dallas-Fort Worth
56,2006-2007,2006-12-01,2007-02-28,90,0,3,38,41,2,0,2,43,2,6,TX - Dallas-Fort Worth
57,2007-2008,2007-12-01,2008-03-07,98,0,0,27,27,4,2,6,33,2,4,TX - Dallas-Fort Worth
58,2008-2009,2008-12-01,2009-02-28,90,0,0,30,30,1,0,1,31,1,2,TX - Dallas-Fort Worth
59,2009-2010,2009-12-01,2010-03-21,111,0,2,58,60,25,15,40,100,7,32,TX - Dallas-Fort Worth
60,2010-2011,2010-12-01,2011-02-28,90,0,5,58,63,8,8,16,79,6,26,TX - Dallas-Fort Worth
61,2011-2012,2011-12-01,2012-02-29,91,0,0,14,14,1,0,1,15,1,2,TX - Dallas-Fort Worth
62,2012-2013,2012-12-01,2013-02-28,90,0,1,27,28,3,0,3,31,3,6,TX - Dallas-Fort Worth
63,2013-2014,2013-12-01,2014-03-02,92,0,4,70,74,6,9,15,89,4,17,TX - Dallas-Fort Worth
64,2014-2015,2014-12-01,2015-03-05,95,0,3,39,42,10,7,17,59,5,19,TX - Dallas-Fort Worth
65,2015-2016,2015-12-01,2016-02-29,91,0,0,16,16,0,0,0,16,0,0,TX - Dallas-Fort Worth
66,2016-2017,2016-12-01,2017-02-28,90,0,2,23,25,1,0,1,26,1,5,TX - Dallas-Fort Worth
67,2017-2018,2017-12-01,2018-02-28,90,0,3,40,43,0,0,0,43,0,0,TX - Dallas-Fort Worth
68,2018-2019,2018-12-01,2019-03-04,94,0,1,22,23,0,0,0,23,0,0,TX - Dallas-Fort Worth
69,2019-2020,2019-12-01,2020-02-29,91,0,0,16,16,1,0,1,17,1,2,TX - Dallas-Fort Worth
0,1950-1951,1950-12-01,1951-02-28,90,0,1,68,69,8,0,8,77,4,17,TX - El Paso
1,1951-1952,1951-12-01,1952-02-29,91,0,0,43,43,12,1,13,56,3,16,TX - El Paso
2,1952-1953,1952-12-01,1953-02-28,90,0,0,55,55,0,0,0,55,0,0,TX - El Paso
3,1953-1954,1953-12-01,1954-02-28,90,0,0,81,81,4,1,5,86,2,7,TX - El Paso
4,1954-1955,1954-12-01,1955-03-27,117,0,0,79,79,2,1,3,82,2,6,TX - El Paso
5,1955-1956,1955-12-01,1956-02-29,91,0,3,50,53,12,13,25,78,3,23,TX - El Paso
6,1956-1957,1956-12-01,1957-02-28,90,0,0,28,28,3,1,4,32,1,4,TX - El Paso
7,1957-1958,1957-11-21,1958-03-12,112,0,0,62,62,16,8,24,86,5,22,TX - El Paso
8,1958-1959,1958-11-16,1959-02-28,105,0,0,62,62,2,1,3,65,2,4,TX - El Paso
9,1959-1960,1959-12-01,1960-02-29,91,0,0,63,63,3,2,5,68,1,6,TX - El Paso
10,1960-1961,1960-12-01,1961-02-28,90,0,0,88,88,13,12,25,113,4,18,TX - El Paso
11,1961-1962,1961-11-13,1962-02-28,108,0,7,78,85,14,7,21,106,4,27,TX - El Paso
12,1962-1963,1962-12-01,1963-02-28,90,0,2,81,83,9,6,15,98,4,24,TX - El Paso
13,1963-1964,1963-12-01,1964-02-29,91,0,0,130,130,0,0,0,130,0,0,TX - El Paso
14,1964-1965,1964-12-01,1965-02-28,90,0,0,53,53,1,0,1,54,1,2,TX - El Paso
15,1965-1966,1965-12-01,1966-02-28,90,0,0,75,75,1,0,1,76,1,2,TX - El Paso
16,1966-1967,1966-12-01,1967-02-28,90,0,0,121,121,0,0,0,121,0,0,TX - El Paso
17,1967-1968,1967-12-01,1968-03-11,102,0,1,52,53,15,14,29,82,8,24,TX - El Paso
18,1968-1969,1968-11-26,1969-02-28,95,0,0,78,78,10,7,17,95,2,12,TX - El Paso
19,1969-1970,1969-11-27,1970-02-28,94,0,0,43,43,15,7,22,65,7,21,TX - El Paso
20,1970-1971,1970-12-01,1971-02-28,90,0,4,88,92,6,3,9,101,4,28,TX - El Paso
21,1971-1972,1971-12-01,1972-02-29,91,0,0,56,56,7,0,7,63,4,12,TX - El Paso
22,1972-1973,1972-12-01,1973-02-28,90,0,0,65,65,14,4,18,83,5,16,TX - El Paso
23,1973-1974,1973-12-01,1974-02-28,90,0,0,115,115,0,0,0,115,0,0,TX - El Paso
24,1974-1975,1974-12-01,1975-03-29,119,1,0,87,87,15,19,34,121,6,23,TX - El Paso
25,1975-1976,1975-12-01,1976-02-29,91,0,0,75,75,2,1,3,78,2,5,TX - El Paso
26,1976-1977,1976-11-12,1977-02-28,109,0,2,107,109,20,17,37,146,5,35,TX - El Paso
27,1977-1978,1977-12-01,1978-02-28,90,0,0,41,41,0,0,0,41,0,0,TX - El Paso
28,1978-1979,1978-12-01,1979-02-28,90,0,0,69,69,2,0,2,71,1,3,TX - El Paso
29,1979-1980,1979-12-01,1980-04-12,134,0,0,81,81,8,6,14,95,3,14,TX - El Paso
30,1980-1981,1980-10-28,1981-02-28,124,0,0,75,75,13,12,25,100,5,17,TX - El Paso
31,1981-1982,1981-12-01,1982-02-28,90,0,0,84,84,0,0,0,84,0,0,TX - El Paso
32,1982-1983,1982-11-24,1983-04-08,136,0,2,66,68,50,45,95,163,9,56,TX - El Paso
33,1983-1984,1983-12-01,1984-03-06,97,0,1,96,97,9,4,13,110,1,10,TX - El Paso
34,1984-1985,1984-12-01,1985-02-28,90,0,3,85,88,14,8,22,110,7,32,TX - El Paso
35,1985-1986,1985-12-01,1986-02-28,90,0,0,93,93,2,1,3,96,2,5,TX - El Paso
36,1986-1987,1986-12-01,1987-03-29,119,0,0,107,107,11,8,19,126,6,24,TX - El Paso
37,1987-1988,1987-12-01,1988-02-29,91,0,3,99,102,43,39,82,184,7,57,TX - El Paso
38,1988-1989,1988-12-01,1989-02-28,90,0,0,82,82,1,0,1,83,1,2,TX - El Paso
39,1989-1990,1989-12-01,1990-02-28,90,0,1,99,100,0,0,0,100,0,0,TX - El Paso
40,1990-1991,1990-11-07,1991-02-28,114,0,0,59,59,9,2,11,70,5,12,TX - El Paso
41,1991-1992,1991-12-01,1992-02-29,91,0,0,35,35,10,4,14,49,4,12,TX - El Paso
42,1992-1993,1992-12-01,1993-02-28,90,0,0,27,27,3,3,6,33,2,5,TX - El Paso
43,1993-1994,1993-10-29,1994-02-28,123,0,0,72,72,6,3,9,81,5,11,TX - El Paso
44,1994-1995,1994-12-01,1995-02-28,90,0,0,15,15,0,0,0,15,0,0,TX - El Paso
45,1995-1996,1995-12-01,1996-02-29,91,0,0,46,46,2,1,3,49,1,3,TX - El Paso
54,2004-2005,2004-12-01,2005-02-28,90,5,1,30,31,2,2,4,35,1,3,TX - El Paso
55,2005-2006,2005-12-01,2006-02-28,90,5,0,41,41,0,0,0,41,0,0,TX - El Paso
56,2006-2007,2006-12-01,2007-02-28,90,12,0,51,51,3,1,4,55,2,5,TX - El Paso
57,2007-2008,2007-11-24,2008-02-29,98,0,0,49,49,11,0,11,60,2,13,TX - El Paso
58,2008-2009,2008-12-01,2009-02-28,90,0,0,45,45,0,0,0,45,0,0,TX - El Paso
59,2009-2010,2009-11-30,2010-02-28,91,0,0,45,45,12,3,15,60,5,15,TX - El Paso
60,2010-2011,2010-12-01,2011-02-28,90,0,6,78,84,3,3,6,90,2,11,TX - El Paso
61,2011-2012,2011-12-01,2012-02-29,91,0,0,44,44,6,0,6,50,4,10,TX - El Paso
62,2012-2013,2012-12-01,2013-02-28,90,0,0,57,57,4,1,5,62,2,6,TX - El Paso
63,2013-2014,2013-12-01,2014-02-28,90,0,0,50,50,0,0,0,50,0,0,TX - El Paso
64,2014-2015,2014-12-01,2015-02-28,90,0,1,38,39,0,0,0,39,0,0,TX - El Paso
65,2015-2016,2015-12-01,2016-02-29,91,0,0,40,40,11,5,16,56,2,13,TX - El Paso
66,2016-2017,2016-12-01,2017-02-28,90,0,0,18,18,0,0,0,18,0,0,TX - El Paso
67,2017-2018,2017-12-01,2018-02-28,90,0,0,33,33,1,0,1,34,1,2,TX - El Paso
68,2018-2019,2018-12-01,2019-02-28,90,0,0,29,29,4,1,5,34,2,6,TX - El Paso
69,2019-2020,2019-12-01,2020-02-29,91,0,0,29,29,4,2,6,35,3,6,TX - El Paso
19,1969-1970,1969-12-01,1970-02-28,90,0,0,26,26,0,0,0,26,0,0,TX - Houston
20,1970-1971,1970-12-01,1971-02-28,90,0,0,16,16,0,0,0,16,0,0,TX - Houston
21,1971-1972,1971-12-01,1972-02-29,91,0,0,17,17,0,0,0,17,0,0,TX - Houston
22,1972-1973,1972-12-01,1973-02-28,90,0,0,30,30,8,2,10,40,4,11,TX - Houston
23,1973-1974,1973-12-01,1974-02-28,90,0,0,18,18,0,0,0,18,0,0,TX - Houston
24,1974-1975,1974-12-01,1975-02-28,90,0,0,20,20,0,0,0,20,0,0,TX - Houston
25,1975-1976,1975-12-01,1976-02-29,91,0,0,29,29,0,0,0,29,0,0,TX - Houston
26,1976-1977,1976-12-01,1977-02-28,90,0,0,42,42,0,0,0,42,0,0,TX - Houston
27,1977-1978,1977-12-01,1978-02-28,90,1,2,42,44,1,0,1,45,1,2,TX - Houston
28,1978-1979,1978-12-01,1979-02-28,90,0,0,33,33,0,0,0,33,0,0,TX - Houston
29,1979-1980,1979-12-01,1980-02-29,91,0,0,17,17,2,0,2,19,1,3,TX - Houston
30,1980-1981,1980-12-01,1981-02-28,90,0,0,14,14,0,0,0,14,0,0,TX - Houston
31,1981-1982,1981-12-01,1982-02-28,90,0,0,20,20,0,0,0,20,0,0,TX - Houston
32,1982-1983,1982-12-01,1983-02-28,90,0,0,5,5,0,0,0,5,0,0,TX - Houston
33,1983-1984,1983-12-01,1984-02-29,91,0,4,40,44,0,0,0,44,0,0,TX - Houston
34,1984-1985,1984-12-01,1985-02-28,90,0,1,23,24,4,0,4,28,3,9,TX - Houston
35,1985-1986,1985-12-01,1986-02-28,90,0,0,10,10,0,0,0,10,0,0,TX - Houston
36,1986-1987,1986-12-01,1987-02-28,90,0,0,7,7,0,0,0,7,0,0,TX - Houston
37,1987-1988,1987-12-01,1988-02-29,91,0,0,18,18,0,0,0,18,0,0,TX - Houston
38,1988-1989,1988-12-01,1989-02-28,90,0,4,18,22,0,0,0,22,0,0,TX - Houston
39,1989-1990,1989-12-01,1990-02-28,90,0,1,29,30,2,0,2,32,1,6,TX - Houston
40,1990-1991,1990-12-01,1991-02-28,90,0,1,18,19,0,0,0,19,0,0,TX - Houston
41,1991-1992,1991-12-01,1992-02-29,91,0,0,5,5,0,0,0,5,0,0,TX - Houston
42,1992-1993,1992-12-01,1993-02-28,90,0,0,2,2,0,0,0,2,0,0,TX - Houston
43,1993-1994,1993-12-01,1994-02-28,90,0,0,11,11,1,0,1,12,1,2,TX - Houston
44,1994-1995,1994-12-01,1995-02-28,90,0,0,4,4,0,0,0,4,0,0,TX - Houston
45,1995-1996,1995-12-01,1996-02-29,91,0,0,22,22,0,0,0,22,0,0,TX - Houston
46,1996-1997,1996-12-01,1997-02-28,90,1,1,19,20,0,0,0,20,0,0,TX - Houston
47,1997-1998,1997-12-01,1998-02-28,90,0,0,8,8,0,0,0,8,0,0,TX - Houston
48,1998-1999,1998-12-01,1999-02-28,90,0,0,8,8,0,0,0,8,0,0,TX - Houston
49,1999-2000,1999-12-01,2000-02-29,91,0,0,13,13,0,0,0,13,0,0,TX - Houston
50,2000-2001,2000-12-01,2001-02-28,90,0,0,18,18,0,0,0,18,0,0,TX - Houston
51,2001-2002,2001-12-01,2002-02-28,90,0,0,17,17,0,0,0,17,0,0,TX - Houston
52,2002-2003,2002-12-01,2003-02-28,90,0,0,6,6,0,0,0,6,0,0,TX - Houston
53,2003-2004,2003-12-01,2004-02-29,91,0,0,5,5,0,0,0,5,0,0,TX - Houston
54,2004-2005,2004-12-01,2005-02-28,90,0,0,8,8,0,0,0,8,0,0,TX - Houston
55,2005-2006,2005-12-01,2006-02-28,90,0,0,4,4,0,0,0,4,0,0,TX - Houston
56,2006-2007,2006-12-01,2007-02-28,90,0,0,9,9,0,0,0,9,0,0,TX - Houston
57,2007-2008,2007-12-01,2008-02-29,91,0,0,5,5,0,0,0,5,0,0,TX - Houston
58,2008-2009,2008-12-01,2009-02-28,90,0,0,9,9,2,0,2,11,1,3,TX - Houston
59,2009-2010,2009-12-01,2010-02-28,90,0,0,19,19,2,0,2,21,1,3,TX - Houston
60,2010-2011,2010-12-01,2011-02-28,90,0,1,27,28,0,0,0,28,0,0,TX - Houston
61,2011-2012,2011-12-01,2012-02-29,91,0,0,5,5,0,0,0,5,0,0,TX - Houston
62,2012-2013,2012-12-01,2013-02-28,90,0,0,7,7,0,0,0,7,0,0,TX - Houston
63,2013-2014,2013-12-01,2014-02-28,90,0,0,18,18,0,0,0,18,0,0,TX - Houston
64,2014-2015,2014-12-01,2015-02-28,90,0,0,3,3,0,0,0,3,0,0,TX - Houston
65,2015-2016,2015-12-01,2016-02-29,91,0,0,2,2,0,0,0,2,0,0,TX - Houston
66,2016-2017,2016-12-01,2017-02-28,90,0,0,6,6,0,0,0,6,0,0,TX - Houston
67,2017-2018,2017-12-01,2018-02-28,90,0,0,15,15,3,1,4,19,3,5,TX - Houston
68,2018-2019,2018-12-01,2019-02-28,90,0,0,2,2,0,0,0,2,0,0,TX - Houston
69,2019-2020,2019-12-01,2020-02-29,91,0,0,3,3,0,0,0,3,0,0,TX - Houston
0,1950-1951,1950-12-01,1951-02-28,90,0,13,166,179,8,6,14,193,4,23,TX - Lubbock
1,1951-1952,1951-12-01,1952-02-29,91,0,3,116,119,2,1,3,122,1,4,TX - Lubbock
2,1952-1953,1952-11-27,1953-02-28,94,0,2,129,131,0,0,0,131,0,0,TX - Lubbock
3,1953-1954,1953-12-01,1954-03-04,94,0,5,137,142,2,1,3,145,1,5,TX - Lubbock
4,1954-1955,1954-12-01,1955-03-21,111,0,1,144,145,17,11,28,173,4,27,TX - Lubbock
5,1955-1956,1955-11-07,1956-02-29,115,0,11,162,173,26,38,64,237,6,54,TX - Lubbock
6,1956-1957,1956-12-01,1957-04-04,125,1,4,100,104,4,1,5,109,3,6,TX - Lubbock
7,1957-1958,1957-11-21,1958-03-19,119,0,5,161,166,38,41,79,245,12,62,TX - Lubbock
8,1958-1959,1958-11-28,1959-02-28,93,0,7,168,175,6,2,8,183,6,29,TX - Lubbock
9,1959-1960,1959-12-01,1960-03-05,96,0,13,162,175,20,18,38,213,6,38,TX - Lubbock
10,1960-1961,1960-12-01,1961-03-20,110,0,9,152,161,47,40,87,248,12,75,TX - Lubbock
11,1961-1962,1961-11-15,1962-03-14,120,0,10,185,195,5,1,6,201,5,18,TX - Lubbock
12,1962-1963,1962-12-01,1963-02-28,90,1,15,179,194,19,17,36,230,9,64,TX - Lubbock
13,1963-1964,1963-12-01,1964-03-09,100,0,6,177,183,9,4,13,196,6,23,TX - Lubbock
14,1964-1965,1964-12-01,1965-03-25,115,0,6,144,150,9,2,11,161,7,25,TX - Lubbock
15,1965-1966,1965-12-01,1966-02-28,90,0,6,135,141,8,16,24,165,5,18,TX - Lubbock
16,1966-1967,1966-12-01,1967-02-28,90,0,0,190,190,1,1,2,192,1,2,TX - Lubbock
17,1967-1968,1967-10-31,1968-03-22,144,0,14,165,179,29,21,50,229,15,71,TX - Lubbock
18,1968-1969,1968-11-08,1969-03-18,131,0,1,145,146,22,17,39,185,7,27,TX - Lubbock
19,1969-1970,1969-11-01,1970-03-21,141,0,2,169,171,22,12,34,205,11,38,TX - Lubbock
20,1970-1971,1970-11-13,1971-03-03,111,0,7,150,157,12,10,22,179,5,28,TX - Lubbock
21,1971-1972,1971-12-01,1972-02-29,91,0,2,117,119,14,13,27,146,7,33,TX - Lubbock
22,1972-1973,1972-11-18,1973-04-08,142,0,21,160,181,37,34,71,252,16,80,TX - Lubbock
23,1973-1974,1973-12-01,1974-02-28,90,0,6,122,128,1,0,1,129,1,5,TX - Lubbock
24,1974-1975,1974-12-01,1975-03-29,119,0,2,120,122,13,6,19,141,10,33,TX - Lubbock
25,1975-1976,1975-12-01,1976-02-29,91,0,2,117,119,5,3,8,127,3,7,TX - Lubbock
26,1976-1977,1976-10-28,1977-02-28,124,0,10,184,194,31,24,55,249,12,71,TX - Lubbock
27,1977-1978,1977-12-01,1978-03-03,93,0,19,166,185,24,33,57,242,9,57,TX - Lubbock
28,1978-1979,1978-11-16,1979-03-10,115,0,21,174,195,23,19,42,237,12,59,TX - Lubbock
29,1979-1980,1979-11-10,1980-04-12,155,0,8,135,143,18,19,37,180,8,31,TX - Lubbock
30,1980-1981,1980-11-16,1981-02-28,105,0,4,113,117,35,40,75,192,7,48,TX - Lubbock
31,1981-1982,1981-12-01,1982-02-28,90,0,9,125,134,7,2,9,143,6,26,TX - Lubbock
32,1982-1983,1982-11-24,1983-04-08,136,0,16,162,178,58,111,169,347,16,89,TX - Lubbock
33,1983-1984,1983-12-01,1984-02-29,91,0,35,157,192,11,3,14,206,9,63,TX - Lubbock
34,1984-1985,1984-12-01,1985-02-28,90,0,12,128,140,6,5,11,151,6,36,TX - Lubbock
35,1985-1986,1985-12-01,1986-02-28,90,0,14,118,132,14,21,35,167,7,49,TX - Lubbock
36,1986-1987,1986-11-13,1987-04-05,144,0,8,119,127,22,25,47,174,12,38,TX - Lubbock
37,1987-1988,1987-12-01,1988-03-03,94,0,16,134,150,17,22,39,189,11,50,TX - Lubbock
38,1988-1989,1988-11-19,1989-03-21,123,0,11,143,154,14,9,23,177,6,29,TX - Lubbock
39,1989-1990,1989-12-01,1990-03-24,114,0,8,148,156,6,0,6,162,6,21,TX - Lubbock
40,1990-1991,1990-11-04,1991-03-30,147,0,10,123,133,6,0,6,139,6,22,TX - Lubbock
41,1991-1992,1991-10-31,1992-02-29,122,0,4,82,86,14,8,22,108,7,29,TX - Lubbock
42,1992-1993,1992-11-21,1993-03-12,112,0,7,117,124,15,9,24,148,9,37,TX - Lubbock
43,1993-1994,1993-10-29,1994-03-08,131,0,1,157,158,6,1,7,165,5,11,TX - Lubbock
44,1994-1995,1994-12-01,1995-03-02,92,0,3,74,77,6,0,6,83,5,17,TX - Lubbock
45,1995-1996,1995-12-01,1996-03-06,97,5,10,133,143,7,1,8,151,4,25,TX - Lubbock
46,1996-1997,1996-12-01,1997-02-28,90,0,17,125,142,17,16,33,175,11,63,TX - Lubbock
47,1997-1998,1997-11-14,1998-03-16,123,0,3,133,136,12,7,19,155,9,24,TX - Lubbock
48,1998-1999,1998-12-01,1999-02-28,90,0,3,100,103,6,4,10,113,2,8,TX - Lubbock
49,1999-2000,1999-10-17,2000-02-29,136,1,1,101,102,13,7,20,122,3,18,TX - Lubbock
50,2000-2001,2000-11-07,2001-03-18,132,0,11,143,154,26,38,64,218,9,43,TX - Lubbock
51,2001-2002,2001-11-27,2002-02-28,94,0,5,115,120,13,14,27,147,6,28,TX - Lubbock
52,2002-2003,2002-12-01,2003-03-28,118,0,2,110,112,2,1,3,115,2,3,TX - Lubbock
53,2003-2004,2003-12-01,2004-02-29,91,0,3,102,105,7,3,10,115,5,15,TX - Lubbock
54,2004-2005,2004-11-02,2005-03-16,135,0,6,87,93,23,19,42,135,8,42,TX - Lubbock
55,2005-2006,2005-12-01,2006-03-22,112,0,2,110,112,2,0,2,114,2,7,TX - Lubbock
56,2006-2007,2006-11-30,2007-04-08,130,0,10,124,134,22,19,41,175,11,48,TX - Lubbock
57,2007-2008,2007-11-22,2008-03-06,106,0,3,133,136,7,2,9,145,7,18,TX - Lubbock
58,2008-2009,2008-12-01,2009-03-27,117,0,2,117,119,2,0,2,121,2,8,TX - Lubbock
59,2009-2010,2009-12-01,2010-03-20,110,0,6,144,150,20,21,41,191,12,35,TX - Lubbock
60,2010-2011,2010-12-01,2011-02-28,90,0,11,149,160,10,4,14,174,8,48,TX - Lubbock
61,2011-2012,2011-12-01,2012-02-29,91,0,3,95,98,10,5,15,113,4,20,TX - Lubbock
62,2012-2013,2012-12-01,2013-04-10,131,0,1,124,125,7,2,9,134,4,17,TX - Lubbock
63,2013-2014,2013-11-22,2014-03-02,101,0,19,174,193,8,4,12,205,5,30,TX - Lubbock
64,2014-2015,2014-11-12,2015-03-05,114,0,14,128,142,25,23,48,190,14,64,TX - Lubbock
65,2015-2016,2015-12-01,2016-02-29,91,0,2,97,99,18,27,45,144,3,23,TX - Lubbock
66,2016-2017,2016-12-01,2017-02-28,90,0,4,79,83,1,0,1,84,1,7,TX - Lubbock
67,2017-2018,2017-12-01,2018-02-28,90,0,5,144,149,1,0,1,150,1,6,TX - Lubbock
68,2018-2019,2018-12-01,2019-03-04,94,0,6,106,112,15,8,23,135,2,18,TX - Lubbock
69,2019-2020,2019-10-24,2020-02-29,129,0,2,108,110,6,1,7,117,5,17,TX - Lubbock
0,1950-1951,1950-12-01,1951-02-28,90,0,7,110,117,3,2,5,122,1,6,TX - Midland-Odessa
1,1951-1952,1951-12-01,1952-02-29,91,0,1,46,47,2,0,2,49,1,3,TX - Midland-Odessa
2,1952-1953,1952-12-01,1953-02-28,90,0,0,48,48,0,0,0,48,0,0,TX - Midland-Odessa
3,1953-1954,1953-12-01,1954-02-28,90,0,1,60,61,0,0,0,61,0,0,TX - Midland-Odessa
4,1954-1955,1954-12-01,1955-02-28,90,0,0,71,71,9,7,16,87,2,14,TX - Midland-Odessa
5,1955-1956,1955-11-08,1956-02-29,114,0,5,81,86,5,2,7,93,4,21,TX - Midland-Odessa
6,1956-1957,1956-12-01,1957-02-28,90,0,3,43,46,0,0,0,46,0,0,TX - Midland-Odessa
7,1957-1958,1957-11-22,1958-03-12,111,0,2,72,74,9,3,12,86,5,16,TX - Midland-Odessa
8,1958-1959,1958-12-01,1959-02-28,90,0,4,92,96,2,0,2,98,2,5,TX - Midland-Odessa
9,1959-1960,1959-11-14,1960-03-01,109,0,4,92,96,6,0,6,102,4,16,TX - Midland-Odessa
10,1960-1961,1960-12-01,1961-02-28,90,0,3,86,89,13,7,20,109,6,26,TX - Midland-Odessa
11,1961-1962,1961-12-01,1962-03-14,104,0,6,96,102,6,4,10,112,2,16,TX - Midland-Odessa
12,1962-1963,1962-12-01,1963-02-28,90,0,9,108,117,5,4,9,126,3,14,TX - Midland-Odessa
13,1963-1964,1963-12-01,1964-02-29,91,0,3,106,109,2,0,2,111,2,4,TX - Midland-Odessa
14,1964-1965,1964-12-01,1965-03-03,93,0,2,75,77,7,1,8,85,3,12,TX - Midland-Odessa
15,1965-1966,1965-12-01,1966-02-28,90,0,3,101,104,5,8,13,117,2,12,TX - Midland-Odessa
16,1966-1967,1966-12-01,1967-02-28,90,0,0,118,118,0,0,0,118,0,0,TX - Midland-Odessa
17,1967-1968,1967-12-01,1968-03-11,102,0,5,72,77,8,7,15,92,6,17,TX - Midland-Odessa
18,1968-1969,1968-11-08,1969-03-16,129,0,0,99,99,10,1,11,110,5,15,TX - Midland-Odessa
19,1969-1970,1969-11-28,1970-03-21,114,0,1,83,84,15,5,20,104,8,24,TX - Midland-Odessa
20,1970-1971,1970-12-01,1971-02-28,90,0,2,69,71,1,0,1,72,1,3,TX - Midland-Odessa
21,1971-1972,1971-12-01,1972-02-29,91,0,1,80,81,4,1,5,86,3,12,TX - Midland-Odessa
22,1972-1973,1972-11-29,1973-02-28,92,0,7,88,95,14,4,18,113,9,31,TX - Midland-Odessa
23,1973-1974,1973-12-01,1974-02-28,90,0,0,72,72,10,9,19,91,3,10,TX - Midland-Odessa
24,1974-1975,1974-12-01,1975-02-28,90,0,0,43,43,4,0,4,47,3,9,TX - Midland-Odessa
25,1975-1976,1975-12-01,1976-02-29,91,0,0,65,65,3,0,3,68,2,4,TX - Midland-Odessa
26,1976-1977,1976-11-12,1977-02-28,109,0,3,97,100,8,8,16,116,3,15,TX - Midland-Odessa
27,1977-1978,1977-12-01,1978-02-28,90,0,2,81,83,2,1,3,86,1,6,TX - Midland-Odessa
28,1978-1979,1978-12-01,1979-02-28,90,0,8,111,119,6,4,10,129,4,16,TX - Midland-Odessa
29,1979-1980,1979-12-01,1980-02-29,91,0,3,64,67,9,4,13,80,4,19,TX - Midland-Odessa
30,1980-1981,1980-11-16,1981-02-28,105,0,3,69,72,15,22,37,109,4,21,TX - Midland-Odessa
31,1981-1982,1981-12-01,1982-02-28,90,0,5,91,96,5,4,9,105,2,10,TX - Midland-Odessa
32,1982-1983,1982-11-24,1983-04-07,135,0,2,74,76,16,26,42,118,7,26,TX - Midland-Odessa
33,1983-1984,1983-12-01,1984-02-29,91,0,15,105,120,4,2,6,126,2,10,TX - Midland-Odessa
34,1984-1985,1984-12-01,1985-02-28,90,0,13,91,104,14,22,36,140,6,47,TX - Midland-Odessa
35,1985-1986,1985-12-01,1986-02-28,90,0,5,95,100,5,3,8,108,3,13,TX - Midland-Odessa
36,1986-1987,1986-11-13,1987-03-29,137,0,4,80,84,18,10,28,112,8,27,TX - Midland-Odessa
37,1987-1988,1987-12-01,1988-03-03,94,0,6,125,131,8,3,11,142,6,22,TX - Midland-Odessa
38,1988-1989,1988-12-01,1989-03-22,112,0,3,117,120,10,5,15,135,4,17,TX - Midland-Odessa
39,1989-1990,1989-11-30,1990-02-28,91,0,5,111,116,2,0,2,118,2,12,TX - Midland-Odessa
40,1990-1991,1990-12-01,1991-02-28,90,0,2,73,75,10,3,13,88,6,23,TX - Midland-Odessa
41,1991-1992,1991-10-31,1992-02-29,122,0,1,70,71,11,11,22,93,6,20,TX - Midland-Odessa
42,1992-1993,1992-12-01,1993-02-28,90,0,3,56,59,6,5,11,70,2,9,TX - Midland-Odessa
43,1993-1994,1993-10-30,1994-02-28,122,0,1,98,99,9,7,16,115,6,20,TX - Midland-Odessa
44,1994-1995,1994-12-01,1995-03-02,92,0,3,38,41,3,1,4,45,2,6,TX - Midland-Odessa
45,1995-1996,1995-12-01,1996-04-05,127,0,4,107,111,6,0,6,117,4,15,TX - Midland-Odessa
46,1996-1997,1996-11-24,1997-02-28,97,0,9,89,98,10,5,15,113,5,22,TX - Midland-Odessa
47,1997-1998,1997-12-01,1998-02-28,90,0,0,57,57,5,3,8,65,2,8,TX - Midland-Odessa
48,1998-1999,1998-12-01,1999-02-28,90,0,4,67,71,14,7,21,92,2,16,TX - Midland-Odessa
49,1999-2000,1999-12-01,2000-02-29,91,0,1,52,53,1,0,1,54,1,2,TX - Midland-Odessa
50,2000-2001,2000-11-07,2001-02-28,114,0,2,75,77,9,1,10,87,6,17,TX - Midland-Odessa
51,2001-2002,2001-11-27,2002-02-28,94,0,2,76,78,13,7,20,98,3,20,TX - Midland-Odessa
52,2002-2003,2002-12-01,2003-02-28,90,0,1,59,60,0,0,0,60,0,0,TX - Midland-Odessa
54,2004-2005,2004-12-01,2005-02-28,90,0,2,46,48,3,0,3,51,2,6,TX - Midland-Odessa
55,2005-2006,2005-12-01,2006-02-28,90,0,0,72,72,2,0,2,74,1,3,TX - Midland-Odessa
56,2006-2007,2006-11-30,2007-04-07,129,0,5,91,96,11,0,11,107,6,22,TX - Midland-Odessa
57,2007-2008,2007-11-22,2008-02-29,100,0,0,97,97,8,3,11,108,3,11,TX - Midland-Odessa
58,2008-2009,2008-12-01,2009-02-28,90,0,1,81,82,0,0,0,82,0,0,TX - Midland-Odessa
59,2009-2010,2009-12-01,2010-02-28,90,0,2,96,98,14,0,14,112,7,26,TX - Midland-Odessa
60,2010-2011,2010-12-01,2011-02-28,90,0,9,120,129,6,2,8,137,4,29,TX - Midland-Odessa
61,2011-2012,2011-12-01,2012-02-29,91,0,2,49,51,26,14,40,91,5,33,TX - Midland-Odessa
62,2012-2013,2012-12-01,2013-02-28,90,0,0,63,63,2,1,3,66,1,3,TX - Midland-Odessa
63,2013-2014,2013-11-23,2014-02-28,98,0,10,90,100,3,0,3,103,3,12,TX - Midland-Odessa
64,2014-2015,2014-11-13,2015-02-28,108,0,10,62,72,8,2,10,82,7,23,TX - Midland-Odessa
65,2015-2016,2015-12-01,2016-02-29,91,0,0,47,47,11,11,22,69,2,13,TX - Midland-Odessa
66,2016-2017,2016-12-01,2017-02-28,90,0,2,31,33,1,0,1,34,1,2,TX - Midland-Odessa
67,2017-2018,2017-12-01,2018-02-28,90,0,5,76,81,0,0,0,81,0,0,TX - Midland-Odessa
68,2018-2019,2018-12-01,2019-02-28,90,0,1,43,44,0,0,0,44,0,0,TX - Midland-Odessa
69,2019-2020,2019-12-01,2020-02-29,91,0,1,39,40,10,10,20,60,2,16,TX - Midland-Odessa
0,1950-1951,1950-12-01,1951-02-28,90,0,5,47,52,3,1,4,56,3,12,TX - San Antonio
1,1951-1952,1951-12-01,1952-02-29,91,0,0,10,10,0,0,0,10,0,0,TX - San Antonio
2,1952-1953,1952-12-01,1953-02-28,90,0,0,8,8,0,0,0,8,0,0,TX - San Antonio
3,1953-1954,1953-12-01,1954-02-28,90,0,0,18,18,0,0,0,18,0,0,TX - San Antonio
4,1954-1955,1954-12-01,1955-02-28,90,0,0,10,10,0,0,0,10,0,0,TX - San Antonio
5,1955-1956,1955-12-01,1956-02-29,91,0,0,18,18,0,0,0,18,0,0,TX - San Antonio
6,1956-1957,1956-12-01,1957-02-28,90,0,0,5,5,0,0,0,5,0,0,TX - San Antonio
7,1957-1958,1957-11-23,1958-02-28,98,0,0,17,17,3,1,4,21,3,4,TX - San Antonio
8,1958-1959,1958-12-01,1959-02-28,90,0,0,24,24,0,0,0,24,0,0,TX - San Antonio
9,1959-1960,1959-12-01,1960-02-29,91,0,0,20,20,0,0,0,20,0,0,TX - San Antonio
10,1960-1961,1960-12-01,1961-02-28,90,0,0,17,17,0,0,0,17,0,0,TX - San Antonio
11,1961-1962,1961-12-01,1962-02-28,90,0,1,29,30,0,0,0,30,0,0,TX - San Antonio
12,1962-1963,1962-12-01,1963-02-28,90,0,1,30,31,0,0,0,31,0,0,TX - San Antonio
13,1963-1964,1963-12-01,1964-02-29,91,0,0,26,26,3,0,3,29,1,4,TX - San Antonio
14,1964-1965,1964-12-01,1965-02-28,90,0,0,25,25,1,1,2,27,1,2,TX - San Antonio
15,1965-1966,1965-12-01,1966-02-28,90,0,0,36,36,5,3,8,44,2,7,TX - San Antonio
16,1966-1967,1966-12-01,1967-02-28,90,0,0,44,44,0,0,0,44,0,0,TX - San Antonio
17,1967-1968,1967-12-01,1968-02-29,91,0,0,23,23,0,0,0,23,0,0,TX - San Antonio
18,1968-1969,1968-12-01,1969-02-28,90,0,0,21,21,0,0,0,21,0,0,TX - San Antonio
19,1969-1970,1969-12-01,1970-02-28,90,0,0,26,26,0,0,0,26,0,0,TX - San Antonio
20,1970-1971,1970-12-01,1971-02-28,90,0,0,22,22,0,0,0,22,0,0,TX - San Antonio
21,1971-1972,1971-12-01,1972-02-29,91,0,0,18,18,0,0,0,18,0,0,TX - San Antonio
22,1972-1973,1972-12-01,1973-02-28,90,0,1,38,39,5,3,8,47,3,8,TX - San Antonio
23,1973-1974,1973-12-01,1974-02-28,90,0,0,30,30,0,0,0,30,0,0,TX - San Antonio
24,1974-1975,1974-12-01,1975-02-28,90,0,0,20,20,0,0,0,20,0,0,TX - San Antonio
25,1975-1976,1975-12-01,1976-02-29,91,0,0,32,32,0,0,0,32,0,0,TX - San Antonio
26,1976-1977,1976-12-01,1977-02-28,90,0,0,32,32,0,0,0,32,0,0,TX - San Antonio
27,1977-1978,1977-12-01,1978-02-28,90,0,0,36,36,0,0,0,36,0,0,TX - San Antonio
28,1978-1979,1978-12-01,1979-02-28,90,0,0,36,36,0,0,0,36,0,0,TX - San Antonio
29,1979-1980,1979-12-01,1980-02-29,91,0,0,19,19,0,0,0,19,0,0,TX - San Antonio
30,1980-1981,1980-12-01,1981-02-28,90,0,0,18,18,0,0,0,18,0,0,TX - San Antonio
31,1981-1982,1981-12-01,1982-02-28,90,0,1,46,47,1,0,1,48,1,3,TX - San Antonio
32,1982-1983,1982-12-01,1983-02-28,90,0,0,12,12,0,0,0,12,0,0,TX - San Antonio
33,1983-1984,1983-12-01,1984-02-29,91,0,4,58,62,0,0,0,62,0,0,TX - San Antonio
34,1984-1985,1984-12-01,1985-02-28,90,0,4,37,41,22,18,40,81,3,28,TX - San Antonio
35,1985-1986,1985-12-01,1986-02-28,90,0,0,18,18,0,0,0,18,0,0,TX - San Antonio
36,1986-1987,1986-12-01,1987-02-28,90,0,0,11,11,2,0,2,13,1,2,TX - San Antonio
37,1987-1988,1987-12-01,1988-02-29,91,0,0,27,27,1,0,1,28,1,1,TX - San Antonio
38,1988-1989,1988-12-01,1989-02-28,90,0,3,16,19,0,0,0,19,0,0,TX - San Antonio
39,1989-1990,1989-12-01,1990-02-28,90,0,3,34,37,0,0,0,37,0,0,TX - San Antonio
40,1990-1991,1990-12-01,1991-02-28,90,0,1,23,24,0,0,0,24,0,0,TX - San Antonio
41,1991-1992,1991-12-01,1992-02-29,91,0,0,4,4,0,0,0,4,0,0,TX - San Antonio
42,1992-1993,1992-12-01,1993-02-28,90,0,0,1,1,0,0,0,1,0,0,TX - San Antonio
43,1993-1994,1993-12-01,1994-02-28,90,0,0,23,23,0,0,0,23,0,0,TX - San Antonio
44,1994-1995,1994-12-01,1995-02-28,90,0,0,5,5,0,0,0,5,0,0,TX - San Antonio
50,2000-2001,2000-12-01,2001-02-28,90,0,0,19,19,0,0,0,19,0,0,TX - San Antonio
51,2001-2002,2001-12-01,2002-02-28,90,0,0,20,20,0,0,0,20,0,0,TX - San Antonio
52,2002-2003,2002-12-01,2003-02-28,90,0,0,10,10,2,0,2,12,2,3,TX - San Antonio
53,2003-2004,2003-12-01,2004-02-29,91,0,0,20,20,2,0,2,22,2,4,TX - San Antonio
54,2004-2005,2004-12-01,2005-02-28,90,0,0,11,11,0,0,0,11,0,0,TX - San Antonio
55,2005-2006,2005-12-01,2006-02-28,90,0,0,12,12,0,0,0,12,0,0,TX - San Antonio
56,2006-2007,2006-12-01,2007-02-28,90,0,1,13,14,0,0,0,14,0,0,TX - San Antonio
57,2007-2008,2007-12-01,2008-02-29,91,0,0,12,12,0,0,0,12,0,0,TX - San Antonio
58,2008-2009,2008-12-01,2009-02-28,90,2,0,12,12,0,0,0,12,0,0,TX - San Antonio
59,2009-2010,2009-12-01,2010-02-28,90,0,0,24,24,1,0,1,25,1,1,TX - San Antonio
60,2010-2011,2010-12-01,2011-02-28,90,0,2,30,32,1,0,1,33,1,3,TX - San Antonio
61,2011-2012,2011-12-01,2012-02-29,91,0,0,7,7,0,0,0,7,0,0,TX - San Antonio
62,2012-2013,2012-12-01,2013-02-28,90,0,0,13,13,0,0,0,13,0,0,TX - San Antonio
63,2013-2014,2013-12-01,2014-02-28,90,0,0,21,21,2,0,2,23,2,4,TX - San Antonio
64,2014-2015,2014-12-01,2015-02-28,90,0,0,7,7,0,0,0,7,0,0,TX - San Antonio
65,2015-2016,2015-12-01,2016-02-29,91,0,0,4,4,0,0,0,4,0,0,TX - San Antonio
66,2016-2017,2016-12-01,2017-02-28,90,0,0,8,8,0,0,0,8,0,0,TX - San Antonio
67,2017-2018,2017-12-01,2018-02-28,90,0,1,14,15,2,2,4,19,1,3,TX - San Antonio
68,2018-2019,2018-12-01,2019-02-28,90,0,0,4,4,0,0,0,4,0,0,TX - San Antonio
69,2019-2020,2019-12-01,2020-02-29,91,0,0,4,4,0,0,0,4,0,0,TX - San Antonio
0,1950-1951,1950-12-01,1951-02-28,90,0,17,120,137,7,8,15,152,3,23,TX - Wichita Falls
1,1951-1952,1951-11-01,1952-02-29,121,0,3,74,77,3,0,3,80,1,4,TX - Wichita Falls
2,1952-1953,1952-12-01,1953-02-28,90,0,2,49,51,6,2,8,59,4,14,TX - Wichita Falls
3,1953-1954,1953-12-01,1954-02-28,90,0,6,61,67,4,2,6,73,2,13,TX - Wichita Falls
4,1954-1955,1954-12-01,1955-02-28,90,0,1,60,61,11,16,27,88,3,14,TX - Wichita Falls
5,1955-1956,1955-12-01,1956-02-29,91,0,5,86,91,10,7,17,108,5,25,TX - Wichita Falls
6,1956-1957,1956-12-01,1957-02-28,90,0,7,52,59,3,1,4,63,2,10,TX - Wichita Falls
7,1957-1958,1957-11-22,1958-03-13,112,0,4,79,83,19,10,29,112,6,32,TX - Wichita Falls
8,1958-1959,1958-12-01,1959-02-28,90,0,11,107,118,12,9,21,139,7,36,TX - Wichita Falls
9,1959-1960,1959-12-01,1960-03-05,96,0,10,91,101,10,4,14,115,5,22,TX - Wichita Falls
10,1960-1961,1960-12-01,1961-02-28,90,0,6,76,82,17,7,24,106,9,32,TX - Wichita Falls
11,1961-1962,1961-12-01,1962-02-28,90,0,13,107,120,4,4,8,128,3,20,TX - Wichita Falls
12,1962-1963,1962-12-01,1963-02-28,90,1,7,114,121,9,3,12,133,4,15,TX - Wichita Falls
13,1963-1964,1963-12-01,1964-03-09,100,0,5,99,104,11,2,13,117,8,29,TX - Wichita Falls
14,1964-1965,1964-12-01,1965-03-20,110,0,3,107,110,2,1,3,113,1,7,TX - Wichita Falls
15,1965-1966,1965-12-01,1966-02-28,90,0,14,103,117,17,24,41,158,5,37,TX - Wichita Falls
16,1966-1967,1966-12-01,1967-03-06,96,0,0,101,101,1,0,1,102,1,1,TX - Wichita Falls
17,1967-1968,1967-12-01,1968-03-12,103,1,8,92,100,16,14,30,130,6,31,TX - Wichita Falls
18,1968-1969,1968-12-01,1969-03-15,105,0,2,91,93,6,1,7,100,2,8,TX - Wichita Falls
19,1969-1970,1969-12-01,1970-03-17,107,0,10,108,118,13,12,25,143,5,24,TX - Wichita Falls
20,1970-1971,1970-12-01,1971-03-03,93,0,4,102,106,4,3,7,113,1,5,TX - Wichita Falls
21,1971-1972,1971-12-01,1972-02-29,91,1,6,88,94,9,1,10,104,3,17,TX - Wichita Falls
22,1972-1973,1972-11-21,1973-04-08,139,0,19,105,124,14,8,22,146,8,26,TX - Wichita Falls
23,1973-1974,1973-12-01,1974-02-28,90,0,5,82,87,1,1,2,89,1,5,TX - Wichita Falls
24,1974-1975,1974-11-29,1975-03-29,121,0,3,78,81,5,2,7,88,4,10,TX - Wichita Falls
25,1975-1976,1975-11-26,1976-02-29,96,0,3,79,82,5,3,8,90,3,8,TX - Wichita Falls
26,1976-1977,1976-11-13,1977-02-28,108,0,11,137,148,13,22,35,183,5,34,TX - Wichita Falls
27,1977-1978,1977-12-01,1978-03-03,93,0,23,171,194,21,30,51,245,9,48,TX - Wichita Falls
28,1978-1979,1978-12-01,1979-02-28,90,0,25,157,182,16,25,41,223,6,34,TX - Wichita Falls
29,1979-1980,1979-12-01,1980-03-01,92,0,7,77,84,5,4,9,93,2,14,TX - Wichita Falls
30,1980-1981,1980-11-16,1981-02-28,105,0,3,63,66,4,3,7,73,2,6,TX - Wichita Falls
31,1981-1982,1981-12-01,1982-02-28,90,0,10,119,129,7,2,9,138,4,14,TX - Wichita Falls
32,1982-1983,1982-12-01,1983-02-28,90,0,1,53,54,12,5,17,71,4,17,TX - Wichita Falls
33,1983-1984,1983-12-01,1984-02-29,91,0,30,150,180,11,7,18,198,4,32,TX - Wichita Falls
34,1984-1985,1984-12-01,1985-02-28,90,0,18,112,130,15,31,46,176,4,35,TX - Wichita Falls
35,1985-1986,1985-12-01,1986-02-28,90,0,11,99,110,5,2,7,117,3,14,TX - Wichita Falls
36,1986-1987,1986-11-13,1987-02-28,108,0,4,60,64,3,5,8,72,2,8,TX - Wichita Falls
37,1987-1988,1987-12-01,1988-02-29,91,0,12,103,115,17,25,42,157,5,31,TX - Wichita Falls
38,1988-1989,1988-12-01,1989-03-21,111,0,11,92,103,20,14,34,137,5,30,TX - Wichita Falls
39,1989-1990,1989-12-01,1990-02-28,90,0,11,101,112,0,0,0,112,0,0,TX - Wichita Falls
40,1990-1991,1990-12-01,1991-02-28,90,0,13,82,95,3,1,4,99,3,19,TX - Wichita Falls
41,1991-1992,1991-12-01,1992-02-29,91,0,0,35,35,12,11,23,58,2,15,TX - Wichita Falls
42,1992-1993,1992-12-01,1993-02-28,90,0,4,58,62,0,0,0,62,0,0,TX - Wichita Falls
43,1993-1994,1993-10-30,1994-02-28,122,0,5,114,119,2,1,3,122,1,4,TX - Wichita Falls
44,1994-1995,1994-12-01,1995-03-02,92,2,1,54,55,0,0,0,55,0,0,TX - Wichita Falls
45,1995-1996,1995-12-01,1996-02-29,91,0,10,110,120,0,0,0,120,0,0,TX - Wichita Falls
46,1996-1997,1996-12-01,1997-02-28,90,0,11,78,89,9,11,20,109,3,22,TX - Wichita Falls
47,1997-1998,1997-12-01,1998-03-08,98,1,0,43,43,7,3,10,53,3,10,TX - Wichita Falls
48,1998-1999,1998-12-01,1999-02-28,90,1,6,59,65,0,0,0,65,0,0,TX - Wichita Falls
49,1999-2000,1999-12-01,2000-02-29,91,0,2,50,52,0,0,0,52,0,0,TX - Wichita Falls
50,2000-2001,2000-12-01,2001-02-28,90,0,8,74,82,3,2,5,87,3,13,TX - Wichita Falls
51,2001-2002,2001-11-27,2002-03-02,96,0,2,66,68,15,11,26,94,6,26,TX - Wichita Falls
52,2002-2003,2002-12-01,2003-02-28,90,0,4,78,82,1,0,1,83,1,6,TX - Wichita Falls
53,2003-2004,2003-12-01,2004-02-29,91,0,1,77,78,7,4,11,89,1,8,TX - Wichita Falls
54,2004-2005,2004-12-01,2005-02-28,90,0,2,58,60,2,1,3,63,1,5,TX - Wichita Falls
55,2005-2006,2005-12-01,2006-02-28,90,0,4,59,63,0,0,0,63,0,0,TX - Wichita Falls
56,2006-2007,2006-11-30,2007-02-28,91,0,7,66,73,3,1,4,77,2,8,TX - Wichita Falls
57,2007-2008,2007-12-01,2008-02-29,91,0,0,77,77,0,0,0,77,0,0,TX - Wichita Falls
58,2008-2009,2008-12-01,2009-02-28,90,0,5,90,95,0,0,0,95,0,0,TX - Wichita Falls
59,2009-2010,2009-12-01,2010-03-20,110,0,5,113,118,22,22,44,162,5,31,TX - Wichita Falls
60,2010-2011,2010-12-01,2011-02-28,90,0,11,123,134,7,8,15,149,2,20,TX - Wichita Falls
61,2011-2012,2011-12-01,2012-02-29,91,0,1,45,46,3,1,4,50,2,5,TX - Wichita Falls
62,2012-2013,2012-12-01,2013-02-28,90,0,1,78,79,5,4,9,88,2,10,TX - Wichita Falls
63,2013-2014,2013-11-24,2014-03-03,100,0,15,147,162,9,8,17,179,4,19,TX - Wichita Falls
64,2014-2015,2014-11-16,2015-03-05,110,0,6,81,87,9,6,15,102,5,21,TX - Wichita Falls
65,2015-2016,2015-12-01,2016-02-29,91,0,0,56,56,3,1,4,60,2,5,TX - Wichita Falls
66,2016-2017,2016-12-01,2017-02-28,90,0,4,63,67,0,0,0,67,0,0,TX - Wichita Falls
67,2017-2018,2017-12-01,2018-02-28,90,0,7,104,111,2,0,2,113,1,5,TX - Wichita Falls
68,2018-2019,2018-12-01,2019-03-04,94,0,2,70,72,5,3,8,80,2,7,TX - Wichita Falls
69,2019-2020,2019-12-01,2020-02-29,91,0,1,47,48,4,7,11,59,1,6,TX - Wichita Falls
7,1957-1958,1957-11-02,1958-04-07,157,4,19,527,546,105,302,407,953,36,192,UT - Echo Dam
9,1959-1960,1959-12-01,1960-04-24,146,9,41,489,530,35,131,166,696,21,117,UT - Echo Dam
10,1960-1961,1960-11-04,1961-04-13,161,3,6,475,481,64,60,124,605,26,115,UT - Echo Dam
11,1961-1962,1961-10-28,1962-03-23,147,4,58,525,583,98,224,322,905,32,213,UT - Echo Dam
12,1962-1963,1962-11-16,1963-04-21,157,4,33,515,548,46,70,116,664,20,94,UT - Echo Dam
13,1963-1964,1963-11-07,1964-05-03,179,0,39,721,760,92,456,548,1308,45,266,UT - Echo Dam
14,1964-1965,1964-11-11,1965-05-05,176,0,36,532,568,93,233,326,894,36,198,UT - Echo Dam
15,1965-1966,1965-09-17,1966-04-19,215,0,36,726,762,62,351,413,1175,28,169,UT - Echo Dam
16,1966-1967,1966-10-13,1967-05-11,211,0,38,460,498,80,276,356,854,27,136,UT - Echo Dam
17,1967-1968,1967-11-28,1968-04-21,146,0,45,482,527,73,344,417,944,26,160,UT - Echo Dam
18,1968-1969,1968-11-16,1969-04-07,143,13,37,487,524,79,474,553,1077,27,157,UT - Echo Dam
20,1970-1971,1970-10-25,1971-04-27,185,0,56,539,595,78,284,362,957,24,151,UT - Echo Dam
21,1971-1972,1971-10-27,1972-04-14,171,1,74,508,582,75,422,497,1079,29,174,UT - Echo Dam
22,1972-1973,1972-10-24,1973-04-14,173,0,110,643,753,116,637,753,1506,36,230,UT - Echo Dam
23,1973-1974,1973-11-01,1974-04-27,178,0,61,559,620,160,661,821,1441,41,277,UT - Echo Dam
24,1974-1975,1974-12-01,1975-05-21,172,0,59,460,519,108,385,493,1012,29,181,UT - Echo Dam
25,1975-1976,1975-10-08,1976-03-25,170,0,33,531,564,74,232,306,870,32,171,UT - Echo Dam
26,1976-1977,1976-11-26,1977-05-18,174,3,18,573,591,73,121,194,785,25,138,UT - Echo Dam
27,1977-1978,1977-11-19,1978-05-08,171,2,23,332,355,120,405,525,880,39,196,UT - Echo Dam
28,1978-1979,1978-09-18,1979-04-19,214,3,104,626,730,133,339,472,1202,43,267,UT - Echo Dam
29,1979-1980,1979-11-11,1980-04-07,149,2,42,487,529,135,305,440,969,36,241,UT - Echo Dam
30,1980-1981,1980-10-15,1981-05-08,206,3,9,388,397,88,83,171,568,25,122,UT - Echo Dam
31,1981-1982,1981-11-25,1982-04-08,135,2,59,432,491,157,377,534,1025,45,304,UT - Echo Dam
32,1982-1983,1982-11-10,1983-05-11,183,7,33,397,430,126,130,256,686,39,191,UT - Echo Dam
33,1983-1984,1983-11-08,1984-04-30,175,8,103,542,645,134,619,753,1398,45,264,UT - Echo Dam
34,1984-1985,1984-09-24,1985-04-26,215,11,72,674,746,158,658,816,1562,52,293,UT - Echo Dam
36,1986-1987,1986-09-25,1987-04-19,207,8,38,495,533,98,193,291,824,27,159,UT - Echo Dam
37,1987-1988,1987-11-17,1988-05-02,168,1,66,512,578,73,291,364,942,31,159,UT - Echo Dam
38,1988-1989,1988-11-11,1989-04-27,168,2,134,586,720,153,635,788,1508,34,274,UT - Echo Dam
39,1989-1990,1989-10-28,1990-06-01,217,0,26,463,489,93,132,225,714,27,184,UT - Echo Dam
40,1990-1991,1990-11-01,1991-05-23,204,8,94,602,696,114,371,485,1181,34,209,UT - Echo Dam
41,1991-1992,1991-10-29,1992-03-18,142,1,31,426,457,49,178,227,684,22,96,UT - Echo Dam
42,1992-1993,1992-11-02,1993-04-18,168,16,101,594,695,142,670,812,1507,41,281,UT - Echo Dam
43,1993-1994,1993-11-18,1994-04-29,163,3,42,469,511,75,160,235,746,24,161,UT - Echo Dam
44,1994-1995,1994-11-02,1995-04-17,167,6,57,446,503,119,241,360,863,29,207,UT - Echo Dam
45,1995-1996,1995-11-10,1996-04-18,161,6,35,378,413,135,299,434,847,31,224,UT - Echo Dam
46,1996-1997,1996-09-17,1997-05-01,227,15,41,525,566,161,364,525,1091,40,289,UT - Echo Dam
47,1997-1998,1997-10-24,1998-03-30,158,5,31,433,464,101,138,239,703,33,171,UT - Echo Dam
49,1999-2000,1999-11-18,2000-05-11,176,5,25,372,397,114,223,337,734,29,181,UT - Echo Dam
50,2000-2001,2000-09-23,2001-04-22,212,10,92,574,666,122,485,607,1273,35,231,UT - Echo Dam
51,2001-2002,2001-11-22,2002-04-17,147,6,75,520,595,89,179,268,863,29,182,UT - Echo Dam
52,2002-2003,2002-10-30,2003-05-10,193,3,30,431,461,95,260,355,816,31,176,UT - Echo Dam
53,2003-2004,2003-10-30,2004-05-13,197,9,77,502,579,146,450,596,1175,45,277,UT - Echo Dam
54,2004-2005,2004-10-25,2005-03-21,148,5,16,358,374,57,99,156,530,19,98,UT - Echo Dam
55,2005-2006,2005-11-05,2006-04-18,165,5,52,499,551,136,202,338,889,40,259,UT - Echo Dam
56,2006-2007,2006-09-16,2007-04-19,216,6,61,591,652,102,317,419,1071,32,217,UT - Echo Dam
57,2007-2008,2007-10-17,2008-04-24,191,6,87,664,751,201,708,909,1660,54,401,UT - Echo Dam
58,2008-2009,2008-10-11,2009-04-16,188,2,30,489,519,138,335,473,992,44,269,UT - Echo Dam
59,2009-2010,2009-10-05,2010-05-02,210,6,56,590,646,135,505,640,1286,41,248,UT - Echo Dam
62,2012-2013,2012-10-25,2013-04-09,167,4,64,489,553,75,247,322,875,25,167,UT - Echo Dam
63,2013-2014,2013-11-16,2014-04-26,162,2,64,456,520,78,336,414,934,22,165,UT - Echo Dam
64,2014-2015,2014-11-13,2015-03-03,111,4,26,260,286,45,73,118,404,13,79,UT - Echo Dam
65,2015-2016,2015-11-10,2016-04-15,158,4,84,481,565,104,493,597,1162,28,201,UT - Echo Dam
66,2016-2017,2016-11-17,2017-05-17,182,3,68,428,496,143,344,487,983,34,242,UT - Echo Dam
67,2017-2018,2017-11-17,2018-03-05,109,1,30,308,338,77,250,327,665,14,118,UT - Echo Dam
68,2018-2019,2018-10-10,2019-04-12,185,2,63,523,586,146,575,721,1307,34,248,UT - Echo Dam
69,2019-2020,2019-10-27,2020-03-30,156,3,37,447,484,125,466,591,1075,35,214,UT - Echo Dam
9,1959-1960,1959-12-01,1960-03-04,95,0,23,328,351,67,460,527,878,12,90,UT - Escalante
12,1962-1963,1962-12-01,1963-03-20,110,0,27,343,370,21,52,73,443,6,30,UT - Escalante
13,1963-1964,1963-12-01,1964-04-03,125,0,7,415,422,30,19,49,471,7,44,UT - Escalante
16,1966-1967,1966-12-01,1967-04-12,133,5,9,304,313,33,54,87,400,7,46,UT - Escalante
17,1967-1968,1967-11-29,1968-04-18,142,0,15,392,407,69,456,525,932,13,102,UT - Escalante
18,1968-1969,1968-12-01,1969-03-13,103,0,9,298,307,73,150,223,530,15,109,UT - Escalante
19,1969-1970,1969-12-01,1970-03-10,100,0,3,233,236,15,0,15,251,6,23,UT - Escalante
20,1970-1971,1970-12-01,1971-03-01,91,0,24,267,291,25,55,80,371,7,47,UT - Escalante
21,1971-1972,1971-10-29,1972-02-29,124,0,10,328,338,25,43,68,406,7,40,UT - Escalante
22,1972-1973,1972-11-12,1973-03-22,131,0,28,418,446,84,153,237,683,19,125,UT - Escalante
23,1973-1974,1973-11-22,1974-02-28,99,0,18,355,373,37,212,249,622,8,66,UT - Escalante
24,1974-1975,1974-11-03,1975-04-11,160,0,13,380,393,47,18,65,458,16,75,UT - Escalante
25,1975-1976,1975-10-23,1976-04-16,177,0,7,386,393,34,41,75,468,8,45,UT - Escalante
26,1976-1977,1976-11-27,1977-02-28,94,0,8,313,321,11,47,58,379,3,17,UT - Escalante
28,1978-1979,1978-11-14,1979-03-21,128,2,43,459,502,105,560,665,1167,22,156,UT - Escalante
29,1979-1980,1979-12-01,1980-03-23,114,1,8,243,251,81,138,219,470,13,96,UT - Escalante
30,1980-1981,1980-12-01,1981-03-30,120,0,0,221,221,16,0,16,237,7,23,UT - Escalante
31,1981-1982,1981-11-26,1982-02-28,95,3,9,264,273,45,54,99,372,10,72,UT - Escalante
32,1982-1983,1982-12-01,1983-03-24,114,13,3,243,246,39,27,66,312,10,57,UT - Escalante
38,1988-1989,1988-12-01,1989-02-28,90,1,27,340,367,53,327,380,747,12,92,UT - Escalante
39,1989-1990,1989-12-01,1990-02-28,90,1,0,249,249,23,16,39,288,4,27,UT - Escalante
40,1990-1991,1990-11-26,1991-03-26,121,1,26,348,374,23,66,89,463,7,36,UT - Escalante
41,1991-1992,1991-11-30,1992-03-08,100,0,22,301,323,49,224,273,596,11,75,UT - Escalante
42,1992-1993,1992-12-01,1993-03-05,95,1,8,274,282,99,443,542,824,20,128,UT - Escalante
43,1993-1994,1993-11-11,1994-02-28,110,1,2,306,308,17,6,23,331,7,29,UT - Escalante
44,1994-1995,1994-11-18,1995-03-25,128,1,0,227,227,54,84,138,365,11,66,UT - Escalante
45,1995-1996,1995-12-01,1996-02-29,91,0,2,203,205,6,2,8,213,3,11,UT - Escalante
46,1996-1997,1996-10-28,1997-04-12,167,11,2,279,281,75,118,193,474,15,97,UT - Escalante
47,1997-1998,1997-12-01,1998-04-02,123,7,1,241,242,28,22,50,292,8,39,UT - Escalante
48,1998-1999,1998-10-16,1999-04-23,190,16,3,263,266,34,4,38,304,5,38,UT - Escalante
49,1999-2000,1999-12-01,2000-03-09,100,0,1,186,187,18,2,20,207,6,25,UT - Escalante
50,2000-2001,2000-12-01,2001-02-28,90,6,1,228,229,44,185,229,458,10,64,UT - Escalante
51,2001-2002,2001-11-25,2002-02-28,96,7,2,286,288,8,1,9,297,5,21,UT - Escalante
53,2003-2004,2003-12-01,2004-02-29,91,14,4,241,245,16,7,23,268,6,24,UT - Escalante
54,2004-2005,2004-11-21,2005-03-03,103,12,2,179,181,47,61,108,289,14,63,UT - Escalante
55,2005-2006,2005-12-01,2006-03-22,112,3,2,265,267,22,25,47,314,6,38,UT - Escalante
56,2006-2007,2006-11-29,2007-02-28,92,2,5,245,250,12,6,18,268,7,25,UT - Escalante
57,2007-2008,2007-12-01,2008-03-17,108,4,5,282,287,40,102,142,429,12,62,UT - Escalante
58,2008-2009,2008-12-01,2009-04-16,137,0,6,276,282,51,164,215,497,14,92,UT - Escalante
59,2009-2010,2009-11-29,2010-03-14,106,0,4,330,334,105,523,628,962,22,140,UT - Escalante
60,2010-2011,2010-11-24,2011-03-26,123,0,11,269,280,32,44,76,356,10,45,UT - Escalante
61,2011-2012,2011-11-07,2012-03-18,133,0,1,275,276,39,116,155,431,10,54,UT - Escalante
62,2012-2013,2012-12-01,2013-03-09,99,0,9,274,283,18,66,84,367,9,35,UT - Escalante
63,2013-2014,2013-11-22,2014-02-28,99,0,7,227,234,40,134,174,408,7,58,UT - Escalante
64,2014-2015,2014-12-01,2015-03-07,97,0,3,167,170,52,76,128,298,9,68,UT - Escalante
65,2015-2016,2015-12-01,2016-04-28,150,0,3,280,283,45,139,184,467,11,63,UT - Escalante
66,2016-2017,2016-11-27,2017-04-01,126,0,2,201,203,29,71,100,303,9,44,UT - Escalante
67,2017-2018,2017-12-01,2018-02-28,90,0,0,188,188,5,0,5,193,3,10,UT - Escalante
68,2018-2019,2018-12-01,2019-02-28,90,0,8,231,239,55,103,158,397,14,88,UT - Escalante
69,2019-2020,2019-11-29,2020-03-19,112,0,5,229,234,30,124,154,388,9,46,UT - Escalante
0,1950-1951,1950-11-14,1951-05-02,170,0,21,320,341,41,43,84,425,16,84,UT - Manti
1,1951-1952,1951-11-12,1952-04-15,156,0,69,506,575,158,930,1088,1663,46,266,UT - Manti
2,1952-1953,1952-11-15,1953-05-09,176,1,29,382,411,87,269,356,767,23,134,UT - Manti
3,1953-1954,1953-11-18,1954-05-01,165,0,31,371,402,77,132,209,611,19,114,UT - Manti
4,1954-1955,1954-10-24,1955-04-26,185,13,52,465,517,84,327,411,928,28,183,UT - Manti
5,1955-1956,1955-11-14,1956-04-18,157,1,30,348,378,80,95,175,553,23,139,UT - Manti
6,1956-1957,1956-10-24,1957-04-22,181,0,28,407,435,82,133,215,650,24,145,UT - Manti
7,1957-1958,1957-11-03,1958-04-23,172,0,9,362,371,71,39,110,481,28,123,UT - Manti
8,1958-1959,1958-11-15,1959-04-18,155,3,16,339,355,54,137,191,546,11,80,UT - Manti
9,1959-1960,1959-12-01,1960-03-16,107,0,31,362,393,77,400,477,870,25,148,UT - Manti
10,1960-1961,1960-10-10,1961-05-13,216,1,5,412,417,95,87,182,599,24,131,UT - Manti
11,1961-1962,1961-10-28,1962-03-24,148,0,43,474,517,121,467,588,1105,26,187,UT - Manti
13,1963-1964,1963-12-01,1964-05-07,159,1,46,526,572,105,363,468,1040,36,222,UT - Manti
14,1964-1965,1964-11-11,1965-05-08,179,1,20,391,411,95,298,393,804,28,158,UT - Manti
16,1966-1967,1966-10-13,1967-05-01,201,1,26,411,437,73,312,385,822,24,136,UT - Manti
17,1967-1968,1967-11-28,1968-05-06,161,0,28,394,422,86,436,522,944,27,154,UT - Manti
18,1968-1969,1968-11-14,1969-04-16,154,0,18,383,401,89,142,231,632,36,180,UT - Manti
19,1969-1970,1969-10-10,1970-04-28,201,6,17,390,407,87,39,126,533,38,149,UT - Manti
20,1970-1971,1970-10-07,1971-04-19,195,1,37,401,438,56,146,202,640,24,122,UT - Manti
21,1971-1972,1971-10-01,1972-04-19,202,1,43,420,463,87,167,254,717,25,162,UT - Manti
22,1972-1973,1972-10-24,1973-04-18,177,0,68,500,568,120,572,692,1260,37,229,UT - Manti
23,1973-1974,1973-10-09,1974-05-20,224,1,44,455,499,123,509,632,1131,36,216,UT - Manti
24,1974-1975,1974-10-29,1975-05-20,204,1,48,516,564,93,292,385,949,43,223,UT - Manti
25,1975-1976,1975-11-10,1976-04-17,160,0,28,423,451,79,237,316,767,30,167,UT - Manti
26,1976-1977,1976-11-27,1977-04-15,140,3,23,428,451,37,76,113,564,15,71,UT - Manti
27,1977-1978,1977-11-19,1978-05-06,169,2,11,268,279,102,246,348,627,36,165,UT - Manti
28,1978-1979,1978-09-18,1979-05-08,233,3,61,467,528,130,277,407,935,46,266,UT - Manti
29,1979-1980,1979-10-20,1980-04-11,175,0,14,389,403,93,161,254,657,33,151,UT - Manti
30,1980-1981,1980-10-15,1981-04-03,171,0,4,303,307,45,24,69,376,21,76,UT - Manti
31,1981-1982,1981-10-14,1982-05-10,209,1,34,415,449,107,278,385,834,38,199,UT - Manti
32,1982-1983,1982-09-29,1983-05-16,230,0,22,405,427,115,341,456,883,44,184,UT - Manti
33,1983-1984,1983-11-18,1984-04-26,161,1,40,425,465,121,336,457,922,38,211,UT - Manti
34,1984-1985,1984-10-15,1985-04-26,194,2,39,450,489,114,303,417,906,35,180,UT - Manti
35,1985-1986,1985-10-09,1986-04-17,191,2,18,333,351,76,148,224,575,24,124,UT - Manti
36,1986-1987,1986-11-08,1987-04-19,163,1,22,340,362,53,81,134,496,18,100,UT - Manti
37,1987-1988,1987-11-25,1988-05-01,159,1,60,415,475,111,425,536,1011,28,201,UT - Manti
38,1988-1989,1988-11-14,1989-04-26,164,5,75,435,510,113,408,521,1031,37,237,UT - Manti
39,1989-1990,1989-10-26,1990-06-01,219,7,22,357,379,100,128,228,607,29,180,UT - Manti
40,1990-1991,1990-11-02,1991-05-04,184,4,58,442,500,88,358,446,946,33,183,UT - Manti
41,1991-1992,1991-10-27,1992-03-18,144,8,21,315,336,62,130,192,528,29,118,UT - Manti
42,1992-1993,1992-11-05,1993-04-02,149,2,57,394,451,140,584,724,1175,39,246,UT - Manti
43,1993-1994,1993-11-13,1994-03-23,131,5,28,328,356,55,170,225,581,27,127,UT - Manti
44,1994-1995,1994-10-15,1995-04-20,188,9,27,318,345,125,112,237,582,36,194,UT - Manti
45,1995-1996,1995-11-10,1996-04-18,161,8,12,259,271,43,25,68,339,21,89,UT - Manti
46,1996-1997,1996-10-20,1997-05-01,194,7,34,382,416,98,190,288,704,30,172,UT - Manti
47,1997-1998,1997-11-27,1998-04-18,143,3,23,281,304,94,102,196,500,35,161,UT - Manti
48,1998-1999,1998-11-06,1999-05-03,179,6,25,316,341,85,111,196,537,27,134,UT - Manti
49,1999-2000,1999-11-21,2000-03-30,131,16,11,222,233,54,33,87,320,23,95,UT - Manti
50,2000-2001,2000-10-12,2001-05-03,204,16,21,364,385,89,90,179,564,32,140,UT - Manti
51,2001-2002,2001-11-23,2002-04-20,149,7,72,468,540,82,319,401,941,30,177,UT - Manti
52,2002-2003,2002-10-03,2003-04-30,210,4,25,413,438,68,154,222,660,25,134,UT - Manti
53,2003-2004,2003-10-31,2004-05-12,195,15,57,446,503,78,220,298,801,27,157,UT - Manti
54,2004-2005,2004-10-31,2005-03-23,144,8,22,285,307,40,57,97,404,16,84,UT - Manti
57,2007-2008,2007-10-20,2008-04-30,194,16,74,527,601,119,423,542,1143,45,295,UT - Manti
58,2008-2009,2008-10-11,2009-04-26,198,8,25,378,403,105,200,305,708,44,213,UT - Manti
59,2009-2010,2009-10-27,2010-05-24,210,0,45,434,479,159,436,595,1074,48,266,UT - Manti
63,2013-2014,2013-11-04,2014-05-12,190,2,43,339,382,72,171,243,625,19,125,UT - Manti
64,2014-2015,2014-11-15,2015-04-16,153,0,20,219,239,46,50,96,335,16,84,UT - Manti
65,2015-2016,2015-11-04,2016-03-29,147,0,47,348,395,104,290,394,789,34,195,UT - Manti
66,2016-2017,2016-11-17,2017-04-09,144,1,53,294,347,94,180,274,621,27,175,UT - Manti
67,2017-2018,2017-11-17,2018-04-17,152,0,10,262,272,68,36,104,376,20,109,UT - Manti
68,2018-2019,2018-11-11,2019-04-11,152,0,43,331,374,80,106,186,560,34,169,UT - Manti
69,2019-2020,2019-10-29,2020-06-08,224,1,18,306,324,72,151,223,547,31,131,UT - Manti
8,1958-1959,1958-11-11,1959-04-18,159,7,19,269,288,65,128,193,481,33,134,UT - Richmond
11,1961-1962,1961-10-22,1962-03-14,144,6,72,393,465,82,255,337,802,31,171,UT - Richmond
12,1962-1963,1962-12-01,1963-04-21,142,2,36,347,383,59,70,129,512,19,101,UT - Richmond
13,1963-1964,1963-11-06,1964-05-02,179,4,107,554,661,130,686,816,1477,43,251,UT - Richmond
14,1964-1965,1964-11-11,1965-04-13,154,14,37,352,389,83,200,283,672,27,158,UT - Richmond
16,1966-1967,1966-10-13,1967-05-01,201,2,54,339,393,161,316,477,870,38,276,UT - Richmond
18,1968-1969,1968-11-26,1969-04-07,133,1,48,386,434,94,557,651,1085,25,170,UT - Richmond
19,1969-1970,1969-12-01,1970-04-28,149,0,30,296,326,58,99,157,483,17,89,UT - Richmond
20,1970-1971,1970-10-06,1971-04-26,203,10,57,411,468,98,326,424,892,26,160,UT - Richmond
21,1971-1972,1971-10-01,1972-04-17,200,0,62,450,512,93,295,388,900,24,168,UT - Richmond
23,1973-1974,1973-11-22,1974-04-14,144,18,58,409,467,98,507,605,1072,24,198,UT - Richmond
24,1974-1975,1974-10-21,1975-05-20,212,5,73,473,546,103,338,441,987,31,195,UT - Richmond
25,1975-1976,1975-10-22,1976-04-26,188,0,67,518,585,153,581,734,1319,36,253,UT - Richmond
26,1976-1977,1976-11-27,1977-04-14,139,0,50,439,489,79,215,294,783,23,127,UT - Richmond
27,1977-1978,1977-11-19,1978-04-21,154,4,17,195,212,65,63,128,340,17,97,UT - Richmond
28,1978-1979,1978-09-18,1979-05-29,254,3,132,550,682,143,635,778,1460,34,265,UT - Richmond
29,1979-1980,1979-11-23,1980-04-01,131,1,46,307,353,101,181,282,635,23,171,UT - Richmond
30,1980-1981,1980-10-15,1981-03-28,165,1,61,345,406,69,214,283,689,15,97,UT - Richmond
31,1981-1982,1981-10-30,1982-05-28,211,6,83,406,489,144,389,533,1022,37,252,UT - Richmond
32,1982-1983,1982-11-19,1983-05-12,175,7,42,285,327,108,185,293,620,30,145,UT - Richmond
33,1983-1984,1983-11-07,1984-04-29,175,5,124,517,641,208,1094,1302,1943,55,378,UT - Richmond
34,1984-1985,1984-10-17,1985-04-22,188,4,128,636,764,132,862,994,1758,33,252,UT - Richmond
35,1985-1986,1985-10-09,1986-05-08,212,6,112,435,547,133,459,592,1139,29,198,UT - Richmond
36,1986-1987,1986-11-06,1987-04-19,165,13,64,386,450,56,170,226,676,16,90,UT - Richmond
37,1987-1988,1987-11-17,1988-05-01,167,6,71,420,491,82,430,512,1003,24,136,UT - Richmond
38,1988-1989,1988-11-14,1989-03-30,137,2,123,486,609,121,614,735,1344,34,231,UT - Richmond
39,1989-1990,1989-10-27,1990-05-08,194,5,35,367,402,75,244,319,721,18,121,UT - Richmond
40,1990-1991,1990-11-01,1991-05-03,184,2,111,512,623,91,448,539,1162,24,160,UT - Richmond
41,1991-1992,1991-10-27,1992-03-17,143,1,81,391,472,67,443,510,982,15,102,UT - Richmond
42,1992-1993,1992-11-02,1993-04-13,163,2,111,487,598,127,795,922,1520,33,243,UT - Richmond
43,1993-1994,1993-11-23,1994-04-07,136,1,28,297,325,79,196,275,600,20,121,UT - Richmond
44,1994-1995,1994-11-02,1995-06-06,217,5,36,308,344,110,235,345,689,26,159,UT - Richmond
45,1995-1996,1995-10-22,1996-04-18,180,8,34,302,336,93,224,317,653,22,151,UT - Richmond
46,1996-1997,1996-10-25,1997-04-24,182,16,26,323,349,106,257,363,712,22,157,UT - Richmond
47,1997-1998,1997-10-24,1998-04-14,173,3,35,315,350,105,305,410,760,28,155,UT - Richmond
48,1998-1999,1998-11-06,1999-05-15,191,6,46,325,371,114,237,351,722,28,162,UT - Richmond
49,1999-2000,1999-11-22,2000-03-30,130,2,18,244,262,92,136,228,490,25,135,UT - Richmond
50,2000-2001,2000-11-08,2001-04-12,156,7,74,421,495,85,456,541,1036,22,133,UT - Richmond
51,2001-2002,2001-11-24,2002-04-16,144,5,109,489,598,119,755,874,1472,26,195,UT - Richmond
52,2002-2003,2002-10-01,2003-04-26,208,12,20,284,304,67,98,165,469,19,99,UT - Richmond
53,2003-2004,2003-10-30,2004-04-28,182,19,78,367,445,129,590,719,1164,32,209,UT - Richmond
56,2006-2007,2006-10-26,2007-05-22,209,9,64,353,417,68,187,255,672,19,113,UT - Richmond
57,2007-2008,2007-11-27,2008-04-24,150,9,84,372,456,117,413,530,986,36,229,UT - Richmond
58,2008-2009,2008-11-04,2009-03-30,147,3,49,340,389,122,475,597,986,25,200,UT - Richmond
59,2009-2010,2009-10-27,2010-05-06,192,0,89,429,518,93,467,560,1078,26,154,UT - Richmond
60,2010-2011,2010-11-20,2011-04-14,146,19,74,322,396,148,298,446,842,34,230,UT - Richmond
61,2011-2012,2011-11-18,2012-04-06,141,16,32,289,321,66,59,125,446,22,117,UT - Richmond
62,2012-2013,2012-10-25,2013-05-01,189,0,128,448,576,106,521,627,1203,29,194,UT - Richmond
63,2013-2014,2013-11-03,2014-04-01,150,1,73,340,413,75,279,354,767,21,134,UT - Richmond
64,2014-2015,2014-11-12,2015-04-16,156,0,29,276,305,45,67,112,417,13,74,UT - Richmond
66,2016-2017,2016-11-17,2017-05-17,182,13,90,345,435,129,358,487,922,25,212,UT - Richmond
67,2017-2018,2017-12-01,2018-04-17,138,2,46,258,304,61,159,220,524,19,104,UT - Richmond
68,2018-2019,2018-12-01,2019-03-14,104,2,70,294,364,66,324,390,754,21,126,UT - Richmond
69,2019-2020,2019-10-29,2020-04-16,171,3,59,349,408,108,352,460,868,35,214,UT - Richmond
0,1950-1951,1950-11-09,1951-04-30,173,0,21,215,236,56,60,116,352,28,112,UT - Salt Lake City
1,1951-1952,1951-11-12,1952-03-25,135,0,50,324,374,152,304,456,830,50,275,UT - Salt Lake City
2,1952-1953,1952-11-15,1953-05-10,177,0,15,195,210,66,75,141,351,23,102,UT - Salt Lake City
3,1953-1954,1953-11-17,1954-03-30,134,0,9,194,203,60,70,130,333,25,108,UT - Salt Lake City
4,1954-1955,1954-11-30,1955-05-15,167,0,46,367,413,104,220,324,737,39,219,UT - Salt Lake City
5,1955-1956,1955-11-11,1956-04-02,144,1,27,247,274,79,111,190,464,35,155,UT - Salt Lake City
6,1956-1957,1956-10-24,1957-04-23,182,0,18,298,316,82,131,213,529,30,162,UT - Salt Lake City
7,1957-1958,1957-11-02,1958-04-25,175,0,3,225,228,98,30,128,356,42,144,UT - Salt Lake City
8,1958-1959,1958-11-14,1959-04-18,156,0,10,203,213,59,65,124,337,21,105,UT - Salt Lake City
9,1959-1960,1959-11-04,1960-05-18,197,0,39,353,392,83,144,227,619,40,203,UT - Salt Lake City
10,1960-1961,1960-11-15,1961-04-24,161,0,3,262,265,49,28,77,342,22,79,UT - Salt Lake City
11,1961-1962,1961-10-21,1962-04-21,183,0,80,376,456,118,202,320,776,41,241,UT - Salt Lake City
12,1962-1963,1962-11-16,1963-04-22,158,0,43,341,384,55,61,116,500,22,117,UT - Salt Lake City
13,1963-1964,1963-11-15,1964-05-05,173,0,57,416,473,126,230,356,829,51,284,UT - Salt Lake City
14,1964-1965,1964-11-10,1965-05-06,178,0,22,264,286,72,76,148,434,36,135,UT - Salt Lake City
15,1965-1966,1965-09-17,1966-04-19,215,0,26,275,301,88,120,208,509,35,172,UT - Salt Lake City
16,1966-1967,1966-10-13,1967-05-11,211,0,24,239,263,101,101,202,465,34,174,UT - Salt Lake City
17,1967-1968,1967-11-30,1968-04-22,145,0,28,274,302,102,156,258,560,25,154,UT - Salt Lake City
18,1968-1969,1968-11-16,1969-04-24,160,0,27,273,300,132,196,328,628,42,252,UT - Salt Lake City
19,1969-1970,1969-10-14,1970-04-30,199,0,14,206,220,82,51,133,353,38,120,UT - Salt Lake City
20,1970-1971,1970-10-24,1971-05-17,206,0,32,249,281,95,146,241,522,47,202,UT - Salt Lake City
21,1971-1972,1971-09-30,1972-04-25,209,0,29,278,307,115,134,249,556,40,204,UT - Salt Lake City
22,1972-1973,1972-10-28,1973-04-19,174,0,77,349,426,128,298,426,852,47,235,UT - Salt Lake City
23,1973-1974,1973-10-29,1974-04-13,167,0,24,246,270,153,195,348,618,52,250,UT - Salt Lake City
24,1974-1975,1974-12-01,1975-05-06,157,0,26,205,231,105,84,189,420,42,184,UT - Salt Lake City
25,1975-1976,1975-10-24,1976-04-26,186,0,24,268,292,113,135,248,540,47,216,UT - Salt Lake City
26,1976-1977,1976-11-27,1977-05-18,173,0,18,291,309,94,68,162,471,35,149,UT - Salt Lake City
27,1977-1978,1977-10-31,1978-05-05,187,0,5,104,109,88,50,138,247,38,125,UT - Salt Lake City
28,1978-1979,1978-09-18,1979-04-12,207,0,54,295,349,99,132,231,580,51,218,UT - Salt Lake City
29,1979-1980,1979-11-18,1980-04-07,142,0,16,213,229,86,127,213,442,24,121,UT - Salt Lake City
30,1980-1981,1980-11-23,1981-04-04,133,0,21,127,148,52,32,84,232,28,83,UT - Salt Lake City
31,1981-1982,1981-10-29,1982-04-07,161,0,27,206,233,84,104,188,421,41,164,UT - Salt Lake City
32,1982-1983,1982-10-27,1983-05-11,197,0,11,187,198,85,95,180,378,33,121,UT - Salt Lake City
33,1983-1984,1983-11-08,1984-04-28,173,0,59,265,324,141,434,575,899,63,275,UT - Salt Lake City
34,1984-1985,1984-10-15,1985-04-19,187,0,34,294,328,109,352,461,789,48,199,UT - Salt Lake City
35,1985-1986,1985-11-09,1986-04-26,169,0,35,196,231,85,247,332,563,38,158,UT - Salt Lake City
36,1986-1987,1986-11-06,1987-04-19,165,0,22,235,257,60,107,167,424,29,123,UT - Salt Lake City
37,1987-1988,1987-11-17,1988-05-01,167,0,31,271,302,53,158,211,513,28,113,UT - Salt Lake City
38,1988-1989,1988-11-14,1989-03-04,111,0,51,319,370,91,335,426,796,43,224,UT - Salt Lake City
39,1989-1990,1989-10-26,1990-04-28,185,0,10,206,216,57,48,105,321,28,106,UT - Salt Lake City
40,1990-1991,1990-11-20,1991-04-28,160,0,51,325,376,65,196,261,637,32,162,UT - Salt Lake City
41,1991-1992,1991-10-27,1992-04-18,175,0,22,212,234,65,107,172,406,31,109,UT - Salt Lake City
42,1992-1993,1992-11-19,1993-05-08,171,0,37,296,333,146,394,540,873,56,292,UT - Salt Lake City
43,1993-1994,1993-11-22,1994-04-04,134,0,9,186,195,60,65,125,320,23,95,UT - Salt Lake City
44,1994-1995,1994-11-02,1995-04-14,164,0,15,207,222,120,195,315,537,38,181,UT - Salt Lake City
45,1995-1996,1995-10-22,1996-04-20,182,0,13,197,210,125,216,341,551,33,183,UT - Salt Lake City
46,1996-1997,1996-10-20,1997-04-24,187,0,11,190,201,94,82,176,377,41,152,UT - Salt Lake City
47,1997-1998,1997-10-11,1998-04-15,187,0,14,197,211,90,158,248,459,29,130,UT - Salt Lake City
48,1998-1999,1998-11-06,1999-04-09,155,2,22,178,200,48,48,96,296,21,78,UT - Salt Lake City
49,1999-2000,1999-11-21,2000-05-11,173,0,13,148,161,71,98,169,330,27,117,UT - Salt Lake City
50,2000-2001,2000-11-05,2001-04-12,159,0,32,235,267,97,115,212,479,43,186,UT - Salt Lake City
51,2001-2002,2001-11-23,2002-04-17,146,0,47,299,346,103,164,267,613,33,185,UT - Salt Lake City
52,2002-2003,2002-11-24,2003-04-07,135,0,7,133,140,34,30,64,204,19,61,UT - Salt Lake City
53,2003-2004,2003-10-30,2004-04-28,182,0,55,264,319,117,268,385,704,42,208,UT - Salt Lake City
54,2004-2005,2004-10-31,2005-03-30,151,0,19,164,183,46,39,85,268,25,84,UT - Salt Lake City
55,2005-2006,2005-11-26,2006-04-17,143,0,19,182,201,70,57,127,328,35,119,UT - Salt Lake City
56,2006-2007,2006-11-28,2007-03-28,121,0,45,248,293,62,163,225,518,24,130,UT - Salt Lake City
57,2007-2008,2007-10-17,2008-03-31,167,0,44,282,326,111,207,318,644,41,211,UT - Salt Lake City
58,2008-2009,2008-10-11,2009-04-04,176,0,18,207,225,74,111,185,410,34,139,UT - Salt Lake City
59,2009-2010,2009-10-27,2010-05-24,210,0,37,248,285,58,115,173,458,34,137,UT - Salt Lake City
60,2010-2011,2010-10-25,2011-04-30,188,0,40,211,251,95,133,228,479,39,171,UT - Salt Lake City
61,2011-2012,2011-11-05,2012-04-06,154,0,7,196,203,38,29,67,270,21,60,UT - Salt Lake City
62,2012-2013,2012-10-25,2013-04-15,173,0,62,256,318,101,273,374,692,34,184,UT - Salt Lake City
63,2013-2014,2013-11-03,2014-03-30,148,0,25,199,224,52,176,228,452,20,93,UT - Salt Lake City
64,2014-2015,2014-11-13,2015-04-16,155,0,12,125,137,25,15,40,177,13,42,UT - Salt Lake City
65,2015-2016,2015-11-28,2016-03-28,122,0,28,161,189,55,106,161,350,29,113,UT - Salt Lake City
66,2016-2017,2016-11-17,2017-05-17,182,0,35,175,210,80,118,198,408,34,138,UT - Salt Lake City
67,2017-2018,2017-12-01,2018-04-17,138,0,7,119,126,70,91,161,287,30,105,UT - Salt Lake City
68,2018-2019,2018-11-24,2019-04-12,140,0,22,161,183,69,104,173,356,31,123,UT - Salt Lake City
69,2019-2020,2019-11-25,2020-03-28,125,1,6,120,126,65,61,126,252,29,96,UT - Salt Lake City
0,1950-1951,1950-12-01,1951-02-28,90,1,0,102,102,3,0,3,105,2,6,UT - St George
1,1951-1952,1951-12-01,1952-02-29,91,0,0,107,107,0,0,0,107,0,0,UT - St George
2,1952-1953,1952-12-01,1953-02-28,90,0,0,85,85,0,0,0,85,0,0,UT - St George
3,1953-1954,1953-12-01,1954-02-28,90,2,0,118,118,0,0,0,118,0,0,UT - St George
4,1954-1955,1954-12-01,1955-02-28,90,9,0,136,136,0,0,0,136,0,0,UT - St George
5,1955-1956,1955-12-01,1956-02-29,91,2,0,105,105,0,0,0,105,0,0,UT - St George
7,1957-1958,1957-12-01,1958-02-28,90,0,0,82,82,0,0,0,82,0,0,UT - St George
8,1958-1959,1958-12-01,1959-02-28,90,0,0,108,108,0,0,0,108,0,0,UT - St George
9,1959-1960,1959-12-01,1960-02-29,91,0,0,94,94,0,0,0,94,0,0,UT - St George
10,1960-1961,1960-12-01,1961-02-28,90,1,0,136,136,0,0,0,136,0,0,UT - St George
11,1961-1962,1961-12-01,1962-02-28,90,0,0,123,123,0,0,0,123,0,0,UT - St George
12,1962-1963,1962-12-01,1963-02-28,90,1,1,150,151,0,0,0,151,0,0,UT - St George
13,1963-1964,1963-12-01,1964-02-29,91,1,0,162,162,0,0,0,162,0,0,UT - St George
14,1964-1965,1964-12-01,1965-02-28,90,1,0,76,76,0,0,0,76,0,0,UT - St George
15,1965-1966,1965-12-01,1966-02-28,90,0,0,133,133,0,0,0,133,0,0,UT - St George
18,1968-1969,1968-12-01,1969-02-28,90,2,0,71,71,12,9,21,92,2,14,UT - St George
19,1969-1970,1969-12-01,1970-02-28,90,0,0,57,57,0,0,0,57,0,0,UT - St George
20,1970-1971,1970-12-01,1971-02-28,90,7,4,112,116,0,0,0,116,0,0,UT - St George
21,1971-1972,1971-10-29,1972-02-29,124,5,0,146,146,5,0,5,151,3,9,UT - St George
25,1975-1976,1975-12-01,1976-02-29,91,8,0,93,93,0,3,3,96,0,0,UT - St George
26,1976-1977,1976-12-01,1977-02-28,90,6,0,125,125,0,0,0,125,0,0,UT - St George
27,1977-1978,1977-12-01,1978-02-28,90,15,0,36,36,0,0,0,36,0,0,UT - St George
28,1978-1979,1978-12-01,1979-02-28,90,19,4,128,132,0,15,15,147,0,0,UT - St George
32,1982-1983,1982-12-01,1983-02-28,90,1,0,62,62,0,0,0,62,0,0,UT - St George
33,1983-1984,1983-12-01,1984-02-29,91,0,0,87,87,0,0,0,87,0,0,UT - St George
36,1986-1987,1986-12-01,1987-02-28,90,0,0,80,80,8,0,8,88,3,11,UT - St George
37,1987-1988,1987-12-01,1988-02-29,91,6,0,92,92,5,0,5,97,2,6,UT - St George
38,1988-1989,1988-12-01,1989-02-28,90,2,3,103,106,6,6,12,118,3,9,UT - St George
39,1989-1990,1989-12-01,1990-02-28,90,1,0,104,104,2,0,2,106,1,3,UT - St George
40,1990-1991,1990-12-01,1991-02-28,90,3,2,129,131,1,0,1,132,1,2,UT - St George
42,1992-1993,1992-12-01,1993-02-28,90,1,0,53,53,0,0,0,53,0,0,UT - St George
43,1993-1994,1993-12-01,1994-02-28,90,0,0,85,85,0,0,0,85,0,0,UT - St George
44,1994-1995,1994-12-01,1995-02-28,90,0,0,39,39,0,0,0,39,0,0,UT - St George
45,1995-1996,1995-12-01,1996-02-29,91,4,0,62,62,2,0,2,64,1,4,UT - St George
46,1996-1997,1996-12-01,1997-02-28,90,1,0,42,42,13,10,23,65,2,16,UT - St George
47,1997-1998,1997-12-01,1998-02-28,90,0,0,53,53,1,0,1,54,1,1,UT - St George
48,1998-1999,1998-12-01,1999-04-09,130,2,0,65,65,1,0,1,66,1,2,UT - St George
50,2000-2001,2000-12-01,2001-02-28,90,2,0,56,56,0,0,0,56,0,0,UT - St George
52,2002-2003,2002-12-01,2003-02-28,90,20,0,31,31,0,0,0,31,0,0,UT - St George
57,2007-2008,2007-12-01,2008-02-29,91,4,0,60,60,0,0,0,60,0,0,UT - St George
58,2008-2009,2008-12-01,2009-02-28,90,14,1,60,61,1,0,1,62,1,2,UT - St George
59,2009-2010,2009-12-01,2010-02-28,90,7,0,53,53,0,0,0,53,0,0,UT - St George
61,2011-2012,2011-12-01,2012-02-29,91,14,0,77,77,0,0,0,77,0,0,UT - St George
62,2012-2013,2012-12-01,2013-02-28,90,17,0,77,77,0,0,0,77,0,0,UT - St George
64,2014-2015,2014-12-01,2015-02-28,90,0,0,44,44,5,4,9,53,2,8,UT - St George
65,2015-2016,2015-12-01,2016-02-29,91,0,0,78,78,0,0,0,78,0,0,UT - St George
66,2016-2017,2016-12-01,2017-02-28,90,0,0,50,50,0,0,0,50,0,0,UT - St George
67,2017-2018,2017-12-01,2018-02-28,90,0,0,60,60,1,0,1,61,1,3,UT - St George
68,2018-2019,2018-12-01,2019-02-28,90,0,0,88,88,10,8,18,106,3,13,UT - St George
69,2019-2020,2019-12-01,2020-02-29,91,0,0,101,101,0,0,0,101,0,0,UT - St George
0,1950-1951,1950-11-11,1951-04-17,158,0,106,383,489,82,155,237,726,48,251,VT - Burlington
1,1951-1952,1951-11-01,1952-03-23,144,0,116,431,547,125,376,501,1048,50,329,VT - Burlington
2,1952-1953,1952-10-20,1953-04-20,183,0,80,368,448,92,192,284,732,39,222,VT - Burlington
3,1953-1954,1953-11-30,1954-04-04,126,0,113,417,530,127,266,393,923,48,360,VT - Burlington
4,1954-1955,1954-11-21,1955-04-08,139,0,149,445,594,131,208,339,933,65,397,VT - Burlington
5,1955-1956,1955-11-17,1956-05-04,170,0,162,520,682,130,333,463,1145,60,358,VT - Burlington
6,1956-1957,1956-11-09,1957-04-09,152,0,117,495,612,85,174,259,871,38,263,VT - Burlington
7,1957-1958,1957-11-25,1958-04-09,136,0,125,425,550,143,587,730,1280,53,384,VT - Burlington
8,1958-1959,1958-11-24,1959-04-06,134,0,181,600,781,132,536,668,1449,55,474,VT - Burlington
9,1959-1960,1959-11-17,1960-04-09,145,0,138,456,594,113,356,469,1063,57,321,VT - Burlington
10,1960-1961,1960-11-30,1961-04-14,136,0,191,585,776,82,362,444,1220,37,278,VT - Burlington
11,1961-1962,1961-11-08,1962-04-15,159,0,153,564,717,121,374,495,1212,56,415,VT - Burlington
12,1962-1963,1962-10-25,1963-04-11,169,0,169,672,841,110,619,729,1570,54,376,VT - Burlington
13,1963-1964,1963-11-14,1964-04-06,145,0,156,534,690,91,265,356,1046,45,336,VT - Burlington
14,1964-1965,1964-10-10,1965-04-17,190,0,152,548,700,85,159,244,944,48,295,VT - Burlington
15,1965-1966,1965-10-28,1966-05-10,195,0,133,493,626,165,350,515,1141,68,443,VT - Burlington
16,1966-1967,1966-11-14,1967-05-08,176,0,154,552,706,131,373,504,1210,55,415,VT - Burlington
17,1967-1968,1967-11-06,1968-03-25,141,0,212,609,821,123,432,555,1376,54,461,VT - Burlington
18,1968-1969,1968-11-08,1969-04-20,164,0,175,561,736,145,760,905,1641,68,473,VT - Burlington
19,1969-1970,1969-10-22,1970-05-06,197,0,223,686,909,157,851,1008,1917,69,547,VT - Burlington
20,1970-1971,1970-10-17,1971-04-17,183,0,209,648,857,207,979,1186,2043,72,637,VT - Burlington
21,1971-1972,1971-11-07,1972-04-13,159,0,136,554,690,163,355,518,1208,67,474,VT - Burlington
22,1972-1973,1972-11-04,1973-04-13,161,0,144,474,618,133,298,431,1049,60,378,VT - Burlington
23,1973-1974,1973-11-06,1974-04-24,170,0,147,474,621,147,276,423,1044,59,402,VT - Burlington
24,1974-1975,1974-10-21,1975-04-14,176,0,100,429,529,132,346,478,1007,64,342,VT - Burlington
25,1975-1976,1975-11-14,1976-04-26,165,0,157,542,699,138,418,556,1255,57,461,VT - Burlington
26,1976-1977,1976-10-18,1977-04-07,172,0,178,527,705,131,519,650,1355,73,487,VT - Burlington
27,1977-1978,1977-11-12,1978-04-15,155,0,207,574,781,145,673,818,1599,60,449,VT - Burlington
28,1978-1979,1978-11-20,1979-04-14,146,0,197,492,689,132,425,557,1246,56,393,VT - Burlington
29,1979-1980,1979-10-09,1980-04-16,191,0,126,415,541,77,115,192,733,46,250,VT - Burlington
30,1980-1981,1980-11-10,1981-04-20,162,0,180,532,712,107,300,407,1119,57,404,VT - Burlington
31,1981-1982,1981-11-07,1982-04-12,157,0,169,518,687,137,694,831,1518,68,487,VT - Burlington
32,1982-1983,1982-11-26,1983-05-09,165,0,93,369,462,116,265,381,843,43,244,VT - Burlington
33,1983-1984,1983-11-12,1984-04-08,149,0,151,477,628,103,333,436,1064,51,358,VT - Burlington
34,1984-1985,1984-11-12,1985-04-09,149,0,132,428,560,136,356,492,1052,58,434,VT - Burlington
35,1985-1986,1985-11-10,1986-03-23,134,3,138,491,629,125,607,732,1361,56,397,VT - Burlington
36,1986-1987,1986-11-06,1987-04-03,149,0,109,480,589,103,534,637,1226,49,283,VT - Burlington
37,1987-1988,1987-10-11,1988-04-21,194,0,107,453,560,104,222,326,886,49,269,VT - Burlington
38,1988-1989,1988-10-22,1989-04-14,175,0,112,473,585,77,119,196,781,52,253,VT - Burlington
39,1989-1990,1989-11-03,1990-04-18,167,0,146,513,659,121,256,377,1036,52,353,VT - Burlington
40,1990-1991,1990-11-07,1991-03-26,140,0,81,353,434,84,185,269,703,56,285,VT - Burlington
41,1991-1992,1991-11-07,1992-04-17,163,0,125,539,664,125,282,407,1071,65,441,VT - Burlington
42,1992-1993,1992-09-30,1993-04-24,207,0,128,541,669,182,516,698,1367,69,497,VT - Burlington
43,1993-1994,1993-10-31,1994-04-22,174,0,189,593,782,164,574,738,1520,54,504,VT - Burlington
44,1994-1995,1994-11-22,1995-04-16,146,0,88,392,480,99,241,340,820,46,260,VT - Burlington
45,1995-1996,1995-10-31,1996-05-12,195,5,165,508,673,152,383,535,1208,72,422,VT - Burlington
46,1996-1997,1996-11-02,1997-04-20,170,0,104,437,541,156,365,521,1062,71,434,VT - Burlington
47,1997-1998,1997-10-24,1998-04-05,164,0,76,377,453,143,332,475,928,53,317,VT - Burlington
48,1998-1999,1998-11-04,1999-03-21,138,1,94,372,466,99,280,379,845,38,286,VT - Burlington
49,1999-2000,1999-11-07,2000-04-14,160,3,113,398,511,115,266,381,892,44,281,VT - Burlington
50,2000-2001,2000-10-29,2001-04-10,164,0,118,478,596,183,751,934,1530,65,427,VT - Burlington
51,2001-2002,2001-11-11,2002-04-23,164,0,48,300,348,88,210,298,646,42,200,VT - Burlington
52,2002-2003,2002-11-06,2003-04-24,170,0,181,531,712,130,521,651,1363,61,391,VT - Burlington
53,2003-2004,2003-11-11,2004-04-06,148,0,166,496,662,147,504,651,1313,53,409,VT - Burlington
54,2004-2005,2004-11-08,2005-03-27,140,0,137,487,624,129,438,567,1191,53,429,VT - Burlington
55,2005-2006,2005-10-25,2006-04-04,162,0,94,360,454,109,234,343,797,54,300,VT - Burlington
56,2006-2007,2006-10-20,2007-04-16,179,0,132,446,578,134,446,580,1158,43,364,VT - Burlington
57,2007-2008,2007-11-20,2008-04-04,137,0,92,391,483,172,494,666,1149,66,387,VT - Burlington
58,2008-2009,2008-10-28,2009-04-08,163,0,134,469,603,134,294,428,1031,44,353,VT - Burlington
59,2009-2010,2009-12-01,2010-04-28,149,0,90,302,392,141,358,499,891,48,311,VT - Burlington
60,2010-2011,2010-10-31,2011-04-05,157,0,135,428,563,192,597,789,1352,67,484,VT - Burlington
61,2011-2012,2011-10-30,2012-03-10,133,0,41,274,315,71,81,152,467,47,216,VT - Burlington
62,2012-2013,2012-11-25,2013-04-12,139,3,90,347,437,129,217,346,783,54,348,VT - Burlington
63,2013-2014,2013-11-11,2014-04-16,157,0,162,530,692,132,493,625,1317,55,401,VT - Burlington
64,2014-2015,2014-11-13,2015-04-09,148,0,163,544,707,130,366,496,1203,59,431,VT - Burlington
65,2015-2016,2015-11-29,2016-04-26,150,0,53,286,339,59,99,158,497,34,203,VT - Burlington
66,2016-2017,2016-11-20,2017-04-03,135,0,68,294,362,141,269,410,772,48,283,VT - Burlington
67,2017-2018,2017-11-11,2018-04-20,161,0,117,403,520,132,386,518,1038,56,353,VT - Burlington
68,2018-2019,2018-11-13,2019-04-10,149,0,121,460,581,158,465,623,1204,67,433,VT - Burlington
69,2019-2020,2019-11-08,2020-05-09,184,0,64,355,419,109,383,492,911,55,270,VT - Burlington
0,1950-1951,1950-11-21,1951-03-26,126,0,63,315,378,56,113,169,547,24,142,VT - Rutland
1,1951-1952,1951-11-01,1952-03-21,142,0,74,410,484,105,341,446,930,34,227,VT - Rutland
2,1952-1953,1952-10-28,1953-04-20,175,1,46,343,389,76,206,282,671,34,171,VT - Rutland
3,1953-1954,1953-11-07,1954-04-04,149,2,69,389,458,88,211,299,757,31,230,VT - Rutland
4,1954-1955,1954-11-29,1955-04-08,131,4,91,382,473,65,160,225,698,33,146,VT - Rutland
5,1955-1956,1955-11-05,1956-04-23,171,1,94,479,573,88,348,436,1009,41,241,VT - Rutland
6,1956-1957,1956-11-18,1957-04-09,143,5,62,425,487,82,182,264,751,24,169,VT - Rutland
7,1957-1958,1957-11-09,1958-04-03,146,5,69,365,434,123,532,655,1089,32,242,VT - Rutland
8,1958-1959,1958-11-24,1959-03-30,127,10,106,506,612,82,284,366,978,33,237,VT - Rutland
9,1959-1960,1959-11-18,1960-04-09,144,4,73,380,453,110,435,545,998,37,231,VT - Rutland
10,1960-1961,1960-12-01,1961-04-11,132,1,94,484,578,75,385,460,1038,23,186,VT - Rutland
11,1961-1962,1961-11-20,1962-03-13,114,5,78,395,473,85,305,390,863,29,198,VT - Rutland
12,1962-1963,1962-11-18,1963-04-11,145,1,95,484,579,114,711,825,1404,38,272,VT - Rutland
13,1963-1964,1963-11-15,1964-04-04,142,4,90,418,508,79,319,398,906,27,180,VT - Rutland
14,1964-1965,1964-12-01,1965-04-18,139,7,91,420,511,51,171,222,733,19,147,VT - Rutland
15,1965-1966,1965-11-18,1966-05-09,173,2,71,399,470,83,267,350,820,27,167,VT - Rutland
16,1966-1967,1966-12-01,1967-04-08,129,4,84,410,494,90,434,524,1018,32,215,VT - Rutland
17,1967-1968,1967-11-15,1968-03-24,131,1,117,482,599,75,401,476,1075,27,202,VT - Rutland
18,1968-1969,1968-11-12,1969-04-20,160,7,87,444,531,121,683,804,1335,39,250,VT - Rutland
19,1969-1970,1969-10-22,1970-04-11,172,2,121,546,667,105,728,833,1500,37,273,VT - Rutland
20,1970-1971,1970-10-17,1971-04-16,182,3,120,500,620,154,703,857,1477,45,344,VT - Rutland
21,1971-1972,1971-11-08,1972-04-07,152,11,77,458,535,129,278,407,942,39,289,VT - Rutland
22,1972-1973,1972-11-05,1973-04-10,157,6,72,390,462,90,249,339,801,34,217,VT - Rutland
23,1973-1974,1973-12-01,1974-04-11,132,8,88,395,483,91,209,300,783,24,191,VT - Rutland
25,1975-1976,1975-11-14,1976-03-19,127,0,100,425,525,101,399,500,1025,32,243,VT - Rutland
26,1976-1977,1976-10-26,1977-04-07,164,7,112,483,595,133,503,636,1231,45,294,VT - Rutland
27,1977-1978,1977-11-13,1978-04-07,146,4,115,490,605,139,598,737,1342,32,288,VT - Rutland
28,1978-1979,1978-11-21,1979-04-14,145,17,125,446,571,107,382,489,1060,30,209,VT - Rutland
29,1979-1980,1979-12-01,1980-03-16,107,10,89,350,439,58,114,172,611,20,124,VT - Rutland
30,1980-1981,1980-11-18,1981-03-21,124,7,115,475,590,104,364,468,1058,27,209,VT - Rutland
38,1988-1989,1988-12-01,1989-04-10,131,1,69,434,503,75,208,283,786,30,172,VT - Rutland
39,1989-1990,1989-11-04,1990-04-18,166,4,114,542,656,116,316,432,1088,31,244,VT - Rutland
40,1990-1991,1990-11-11,1991-03-30,140,3,51,361,412,69,168,237,649,29,149,VT - Rutland
41,1991-1992,1991-11-08,1992-04-17,162,4,66,495,561,90,208,298,859,45,257,VT - Rutland
42,1992-1993,1992-11-06,1993-04-04,150,1,84,504,588,125,503,628,1216,40,282,VT - Rutland
43,1993-1994,1993-11-01,1994-04-04,155,4,153,617,770,135,837,972,1742,34,343,VT - Rutland
44,1994-1995,1994-11-23,1995-04-05,134,3,64,359,423,57,222,279,702,22,129,VT - Rutland
45,1995-1996,1995-11-09,1996-04-11,155,3,135,530,665,132,372,504,1169,46,345,VT - Rutland
46,1996-1997,1996-11-11,1997-04-19,160,3,65,441,506,142,398,540,1046,39,265,VT - Rutland
47,1997-1998,1997-11-12,1998-03-26,135,3,44,371,415,105,283,388,803,38,230,VT - Rutland
48,1998-1999,1998-11-17,1999-03-17,121,6,63,360,423,102,223,325,748,30,237,VT - Rutland
49,1999-2000,1999-11-16,2000-04-27,164,4,66,409,475,97,207,304,779,30,205,VT - Rutland
50,2000-2001,2000-10-29,2001-04-13,167,2,63,481,544,160,758,918,1462,45,295,VT - Rutland
51,2001-2002,2001-11-29,2002-04-23,146,4,18,286,304,84,181,265,569,34,165,VT - Rutland
52,2002-2003,2002-11-16,2003-04-24,160,3,113,545,658,163,795,958,1616,46,327,VT - Rutland
53,2003-2004,2003-11-13,2004-03-23,132,1,122,488,610,121,497,618,1228,32,278,VT - Rutland
54,2004-2005,2004-11-09,2005-03-31,143,2,88,487,575,128,468,596,1171,38,316,VT - Rutland
55,2005-2006,2005-10-26,2006-04-04,161,5,58,378,436,104,245,349,785,38,233,VT - Rutland
56,2006-2007,2006-11-02,2007-04-16,166,5,98,468,566,113,516,629,1195,29,251,VT - Rutland
57,2007-2008,2007-11-20,2008-04-04,137,0,79,442,521,127,404,531,1052,48,309,VT - Rutland
58,2008-2009,2008-10-29,2009-03-24,147,0,131,507,638,137,465,602,1240,43,336,VT - Rutland
59,2009-2010,2009-12-01,2010-04-29,150,0,99,355,454,83,219,302,756,31,200,VT - Rutland
60,2010-2011,2010-11-09,2011-04-23,166,2,118,543,661,138,640,778,1439,41,351,VT - Rutland
62,2012-2013,2012-11-09,2013-04-13,156,15,82,437,519,88,222,310,829,41,225,VT - Rutland
63,2013-2014,2013-10-31,2014-04-16,168,0,155,659,814,132,486,618,1432,44,367,VT - Rutland
64,2014-2015,2014-11-17,2015-04-09,144,0,157,662,819,113,541,654,1473,35,311,VT - Rutland
65,2015-2016,2015-11-24,2016-04-07,136,0,61,349,410,35,61,96,506,17,116,VT - Rutland
66,2016-2017,2016-11-21,2017-04-08,139,0,72,393,465,104,301,405,870,33,230,VT - Rutland
67,2017-2018,2017-11-11,2018-04-20,161,0,120,533,653,145,507,652,1305,35,277,VT - Rutland
68,2018-2019,2018-11-14,2019-03-27,134,1,113,511,624,109,306,415,1039,37,272,VT - Rutland
69,2019-2020,2019-11-08,2020-05-09,184,0,66,460,526,92,227,319,845,32,199,VT - Rutland
0,1950-1951,1950-11-22,1951-04-03,133,0,72,398,470,76,238,314,784,27,175,VT - Saint Johnsbury
1,1951-1952,1951-11-01,1952-04-03,155,5,94,536,630,172,724,896,1526,33,310,VT - Saint Johnsbury
3,1953-1954,1953-10-07,1954-04-18,194,16,87,553,640,152,359,511,1151,44,357,VT - Saint Johnsbury
4,1954-1955,1954-11-25,1955-04-27,154,7,101,511,612,137,551,688,1300,42,276,VT - Saint Johnsbury
5,1955-1956,1955-10-26,1956-04-22,180,10,128,616,744,139,604,743,1487,45,324,VT - Saint Johnsbury
7,1957-1958,1957-10-27,1958-04-28,184,9,82,480,562,142,581,723,1285,48,335,VT - Saint Johnsbury
8,1958-1959,1958-11-24,1959-04-02,130,5,170,707,877,143,1002,1145,2022,55,502,VT - Saint Johnsbury
9,1959-1960,1959-10-19,1960-04-01,166,6,85,505,590,114,786,900,1490,46,284,VT - Saint Johnsbury
10,1960-1961,1960-11-30,1961-04-11,133,12,121,607,728,69,481,550,1278,31,216,VT - Saint Johnsbury
11,1961-1962,1961-11-09,1962-04-25,168,8,110,553,663,119,575,694,1357,39,281,VT - Saint Johnsbury
12,1962-1963,1962-10-25,1963-05-11,199,4,113,645,758,151,863,1014,1772,46,359,VT - Saint Johnsbury
13,1963-1964,1963-11-25,1964-04-07,135,0,122,552,674,112,551,663,1337,41,275,VT - Saint Johnsbury
14,1964-1965,1964-11-19,1965-04-18,151,5,115,590,705,88,466,554,1259,37,273,VT - Saint Johnsbury
15,1965-1966,1965-11-18,1966-03-28,131,7,84,486,570,103,463,566,1136,33,224,VT - Saint Johnsbury
16,1966-1967,1966-11-06,1967-04-19,165,2,97,565,662,117,630,747,1409,35,229,VT - Saint Johnsbury
17,1967-1968,1967-11-14,1968-03-24,132,1,148,614,762,111,641,752,1514,31,265,VT - Saint Johnsbury
18,1968-1969,1968-11-12,1969-04-07,147,0,123,567,690,202,1237,1439,2129,45,367,VT - Saint Johnsbury
19,1969-1970,1969-10-22,1970-04-05,166,1,148,643,791,123,716,839,1630,37,262,VT - Saint Johnsbury
20,1970-1971,1970-11-15,1971-04-16,153,2,154,634,788,200,1200,1400,2188,46,434,VT - Saint Johnsbury
21,1971-1972,1971-11-09,1972-04-23,167,0,112,617,729,163,954,1117,1846,48,389,VT - Saint Johnsbury
22,1972-1973,1972-11-05,1973-04-14,161,0,96,506,602,132,768,900,1502,39,281,VT - Saint Johnsbury
23,1973-1974,1973-11-10,1974-04-24,166,0,114,523,637,116,458,574,1211,33,261,VT - Saint Johnsbury
25,1975-1976,1975-11-14,1976-04-26,165,2,134,598,732,147,742,889,1621,40,337,VT - Saint Johnsbury
26,1976-1977,1976-10-25,1977-04-09,167,6,146,586,732,131,738,869,1601,52,376,VT - Saint Johnsbury
27,1977-1978,1977-11-13,1978-04-05,144,0,138,618,756,154,731,885,1641,41,350,VT - Saint Johnsbury
28,1978-1979,1978-11-21,1979-04-10,141,0,152,569,721,152,681,833,1554,42,339,VT - Saint Johnsbury
29,1979-1980,1979-10-09,1980-04-04,179,0,103,515,618,66,223,289,907,33,193,VT - Saint Johnsbury
30,1980-1981,1980-11-02,1981-03-27,146,0,142,596,738,90,349,439,1177,37,242,VT - Saint Johnsbury
31,1981-1982,1981-10-24,1982-04-13,172,7,146,611,757,169,974,1143,1900,57,401,VT - Saint Johnsbury
32,1982-1983,1982-11-25,1983-04-19,146,4,67,405,472,84,208,292,764,30,166,VT - Saint Johnsbury
33,1983-1984,1983-11-13,1984-03-30,139,10,123,544,667,126,524,650,1317,40,299,VT - Saint Johnsbury
34,1984-1985,1984-11-13,1985-04-05,144,1,113,495,608,145,570,715,1323,45,346,VT - Saint Johnsbury
35,1985-1986,1985-11-15,1986-05-04,171,1,104,564,668,155,913,1068,1736,59,407,VT - Saint Johnsbury
36,1986-1987,1986-11-06,1987-04-29,175,1,97,545,642,143,795,938,1580,49,324,VT - Saint Johnsbury
38,1988-1989,1988-10-22,1989-04-20,181,3,89,603,692,112,456,568,1260,64,354,VT - Saint Johnsbury
39,1989-1990,1989-11-19,1990-04-12,145,0,136,604,740,144,555,699,1439,55,417,VT - Saint Johnsbury
40,1990-1991,1990-11-08,1991-04-11,155,2,67,444,511,110,397,507,1018,48,292,VT - Saint Johnsbury
41,1991-1992,1991-11-08,1992-04-18,163,2,115,608,723,137,537,674,1397,57,414,VT - Saint Johnsbury
42,1992-1993,1992-10-01,1993-04-04,186,2,99,572,671,145,476,621,1292,55,385,VT - Saint Johnsbury
43,1993-1994,1993-11-01,1994-04-21,172,3,159,650,809,152,584,736,1545,50,416,VT - Saint Johnsbury
44,1994-1995,1994-11-23,1995-04-16,145,0,77,444,521,81,272,353,874,42,244,VT - Saint Johnsbury
45,1995-1996,1995-10-30,1996-04-18,172,2,137,584,721,167,496,663,1384,75,469,VT - Saint Johnsbury
46,1996-1997,1996-11-02,1997-04-18,168,1,85,507,592,167,544,711,1303,75,445,VT - Saint Johnsbury
47,1997-1998,1997-10-24,1998-03-27,155,2,56,438,494,136,761,897,1391,65,328,VT - Saint Johnsbury
48,1998-1999,1998-11-17,1999-03-27,131,0,72,418,490,108,502,610,1100,49,293,VT - Saint Johnsbury
49,1999-2000,1999-11-13,2000-04-24,164,0,88,458,546,128,343,471,1017,53,354,VT - Saint Johnsbury
50,2000-2001,2000-10-29,2001-04-15,169,5,108,545,653,168,885,1053,1706,68,415,VT - Saint Johnsbury
51,2001-2002,2001-11-12,2002-04-29,169,0,39,365,404,123,643,766,1170,55,288,VT - Saint Johnsbury
52,2002-2003,2002-10-26,2003-04-25,182,2,139,653,792,126,695,821,1613,69,380,VT - Saint Johnsbury
53,2003-2004,2003-10-23,2004-05-04,195,0,135,605,740,139,796,935,1675,60,388,VT - Saint Johnsbury
54,2004-2005,2004-11-06,2005-03-30,145,8,109,540,649,97,371,468,1117,52,322,VT - Saint Johnsbury
55,2005-2006,2005-10-25,2006-04-05,163,1,82,434,516,113,352,465,981,68,379,VT - Saint Johnsbury
56,2006-2007,2006-11-20,2007-04-16,148,1,105,500,605,141,519,660,1265,49,352,VT - Saint Johnsbury
57,2007-2008,2007-11-17,2008-04-09,145,5,77,471,548,208,1036,1244,1792,78,478,VT - Saint Johnsbury
58,2008-2009,2008-10-30,2009-03-25,147,1,123,537,660,169,702,871,1531,56,430,VT - Saint Johnsbury
59,2009-2010,2009-10-13,2010-05-10,210,1,87,381,468,95,339,434,902,46,245,VT - Saint Johnsbury
60,2010-2011,2010-11-19,2011-04-23,156,0,128,506,634,171,704,875,1509,71,483,VT - Saint Johnsbury
61,2011-2012,2011-10-30,2012-03-30,153,0,57,356,413,96,263,359,772,50,236,VT - Saint Johnsbury
62,2012-2013,2012-11-06,2013-05-26,202,0,88,463,551,125,290,415,966,63,355,VT - Saint Johnsbury
63,2013-2014,2013-11-10,2014-04-16,158,1,146,624,770,149,559,708,1478,63,451,VT - Saint Johnsbury
64,2014-2015,2014-11-14,2015-04-24,162,1,150,645,795,156,719,875,1670,69,472,VT - Saint Johnsbury
65,2015-2016,2015-10-18,2016-04-26,192,0,54,389,443,60,150,210,653,35,155,VT - Saint Johnsbury
66,2016-2017,2016-11-21,2017-04-08,139,0,87,402,489,174,423,597,1086,67,414,VT - Saint Johnsbury
67,2017-2018,2017-11-10,2018-04-30,172,0,123,530,653,145,509,654,1307,61,422,VT - Saint Johnsbury
68,2018-2019,2018-10-18,2019-04-10,175,0,110,582,692,174,951,1125,1817,74,476,VT - Saint Johnsbury
69,2019-2020,2019-11-08,2020-05-10,185,0,70,457,527,124,517,641,1168,61,293,VT - Saint Johnsbury
0,1950-1951,1950-11-25,1951-03-14,110,15,23,194,217,9,17,26,243,3,14,VA - Blacksburg
3,1953-1954,1953-11-06,1954-03-16,131,1,12,204,216,7,3,10,226,4,14,VA - Blacksburg
4,1954-1955,1954-11-02,1955-03-25,144,17,23,225,248,24,3,27,275,10,46,VA - Blacksburg
5,1955-1956,1955-11-11,1956-04-08,150,3,17,223,240,20,26,46,286,10,36,VA - Blacksburg
6,1956-1957,1956-11-25,1957-03-08,104,1,13,135,148,6,3,9,157,6,21,VA - Blacksburg
7,1957-1958,1957-11-23,1958-03-25,123,1,46,232,278,39,55,94,372,14,67,VA - Blacksburg
8,1958-1959,1958-12-01,1959-02-28,90,0,33,216,249,10,21,31,280,3,19,VA - Blacksburg
12,1962-1963,1962-10-26,1963-03-12,138,7,41,317,358,63,104,167,525,17,106,VA - Blacksburg
13,1963-1964,1963-11-30,1964-03-31,123,2,27,261,288,71,177,248,536,19,112,VA - Blacksburg
15,1965-1966,1965-12-01,1966-03-08,98,1,30,215,245,72,229,301,546,11,116,VA - Blacksburg
16,1966-1967,1966-11-30,1967-03-18,109,13,22,226,248,17,120,137,385,7,36,VA - Blacksburg
17,1967-1968,1967-12-01,1968-03-04,95,1,31,268,299,31,164,195,494,12,64,VA - Blacksburg
18,1968-1969,1968-11-10,1969-03-12,123,7,26,284,310,42,72,114,424,7,54,VA - Blacksburg
19,1969-1970,1969-12-01,1970-02-28,90,3,35,259,294,29,46,75,369,7,61,VA - Blacksburg
20,1970-1971,1970-11-04,1971-04-08,156,1,35,336,371,38,31,69,440,10,64,VA - Blacksburg
21,1971-1972,1971-11-23,1972-03-24,123,3,20,232,252,22,38,60,312,9,49,VA - Blacksburg
22,1972-1973,1972-11-22,1973-03-23,122,1,20,238,258,12,14,26,284,4,27,VA - Blacksburg
23,1973-1974,1973-12-01,1974-02-28,90,5,8,160,168,25,42,67,235,6,37,VA - Blacksburg
24,1974-1975,1974-11-15,1975-03-12,118,2,8,230,238,44,76,120,358,10,65,VA - Blacksburg
26,1976-1977,1976-11-09,1977-02-28,112,4,61,349,410,26,82,108,518,8,50,VA - Blacksburg
27,1977-1978,1977-11-27,1978-04-27,152,4,68,343,411,53,199,252,663,11,91,VA - Blacksburg
28,1978-1979,1978-12-01,1979-03-12,102,0,26,245,271,26,50,76,347,7,56,VA - Blacksburg
29,1979-1980,1979-11-30,1980-03-14,106,1,24,241,265,36,80,116,381,9,68,VA - Blacksburg
30,1980-1981,1980-12-01,1981-03-25,115,5,21,255,276,23,17,40,316,4,33,VA - Blacksburg
31,1981-1982,1981-11-24,1982-04-09,137,17,37,273,310,50,60,110,420,16,103,VA - Blacksburg
32,1982-1983,1982-12-01,1983-04-19,140,7,16,231,247,46,94,140,387,9,70,VA - Blacksburg
33,1983-1984,1983-11-14,1984-03-10,118,15,30,213,243,16,19,35,278,7,28,VA - Blacksburg
34,1984-1985,1984-12-01,1985-02-28,90,11,22,169,191,11,27,38,229,7,29,VA - Blacksburg
35,1985-1986,1985-12-01,1986-03-03,93,11,52,257,309,21,31,52,361,7,46,VA - Blacksburg
36,1986-1987,1986-12-01,1987-04-06,127,4,19,217,236,76,153,229,465,13,108,VA - Blacksburg
37,1987-1988,1987-11-11,1988-04-12,154,10,30,251,281,22,46,68,349,9,48,VA - Blacksburg
38,1988-1989,1988-12-01,1989-03-09,99,9,22,161,183,32,38,70,253,9,54,VA - Blacksburg
39,1989-1990,1989-11-23,1990-04-07,136,19,31,214,245,16,72,88,333,5,26,VA - Blacksburg
40,1990-1991,1990-12-01,1991-03-14,104,1,10,157,167,5,3,8,175,4,13,VA - Blacksburg
41,1991-1992,1991-12-01,1992-04-05,127,2,6,152,158,14,9,23,181,4,21,VA - Blacksburg
42,1992-1993,1992-11-15,1993-04-06,143,13,12,196,208,49,62,111,319,10,71,VA - Blacksburg
43,1993-1994,1993-12-01,1994-04-01,122,8,27,201,228,36,58,94,322,13,68,VA - Blacksburg
45,1995-1996,1995-11-13,1996-03-22,131,4,54,305,359,95,165,260,619,24,188,VA - Blacksburg
46,1996-1997,1996-11-12,1997-04-18,158,0,24,239,263,36,89,125,388,14,75,VA - Blacksburg
47,1997-1998,1997-11-13,1998-03-16,124,0,8,188,196,64,70,134,330,17,89,VA - Blacksburg
48,1998-1999,1998-12-01,1999-03-16,106,0,17,183,200,41,42,83,283,18,83,VA - Blacksburg
49,1999-2000,1999-11-03,2000-04-09,159,2,19,226,245,32,66,98,343,15,77,VA - Blacksburg
50,2000-2001,2000-11-22,2001-04-18,148,0,24,296,320,29,18,47,367,15,67,VA - Blacksburg
51,2001-2002,2001-12-01,2002-04-07,128,0,11,210,221,14,5,19,240,9,36,VA - Blacksburg
52,2002-2003,2002-12-01,2003-04-01,122,0,30,229,259,56,90,146,405,22,117,VA - Blacksburg
53,2003-2004,2003-11-29,2004-03-23,116,1,22,230,252,54,125,179,431,20,114,VA - Blacksburg
54,2004-2005,2004-12-01,2005-04-03,124,0,24,213,237,36,41,77,314,19,84,VA - Blacksburg
55,2005-2006,2005-11-24,2006-03-26,123,0,6,184,190,35,28,63,253,18,72,VA - Blacksburg
56,2006-2007,2006-12-01,2007-04-08,129,0,16,202,218,16,11,27,245,13,52,VA - Blacksburg
57,2007-2008,2007-12-01,2008-02-29,91,0,13,147,160,16,28,44,204,9,42,VA - Blacksburg
58,2008-2009,2008-11-18,2009-03-13,116,0,25,245,270,37,24,61,331,23,99,VA - Blacksburg
59,2009-2010,2009-12-01,2010-03-09,99,0,42,231,273,79,345,424,697,27,169,VA - Blacksburg
60,2010-2011,2010-12-01,2011-03-29,119,0,36,232,268,34,80,114,382,21,105,VA - Blacksburg
61,2011-2012,2011-12-01,2012-03-06,97,0,7,145,152,17,13,30,182,8,38,VA - Blacksburg
62,2012-2013,2012-10-30,2013-04-05,158,0,18,253,271,46,44,90,361,23,92,VA - Blacksburg
63,2013-2014,2013-11-25,2014-03-31,127,0,30,287,317,48,56,104,421,17,109,VA - Blacksburg
64,2014-2015,2014-11-15,2015-03-29,135,0,29,265,294,44,80,124,418,18,109,VA - Blacksburg
65,2015-2016,2015-12-01,2016-04-09,131,0,21,178,199,35,77,112,311,10,73,VA - Blacksburg
66,2016-2017,2016-12-01,2017-04-07,128,0,16,149,165,14,20,34,199,9,41,VA - Blacksburg
67,2017-2018,2017-12-01,2018-04-17,138,0,34,233,267,49,40,89,356,20,94,VA - Blacksburg
68,2018-2019,2018-11-28,2019-03-09,102,0,17,162,179,28,43,71,250,8,45,VA - Blacksburg
69,2019-2020,2019-12-01,2020-04-15,137,0,1,132,133,10,2,12,145,7,22,VA - Blacksburg
0,1950-1951,1950-11-26,1951-03-26,121,7,12,152,164,18,17,35,199,6,35,VA - Charlottesville
1,1951-1952,1951-12-01,1952-03-03,94,2,6,90,96,12,16,28,124,6,26,VA - Charlottesville
2,1952-1953,1952-11-30,1953-04-21,143,0,2,75,77,23,22,45,122,9,34,VA - Charlottesville
3,1953-1954,1953-11-06,1954-04-04,150,0,9,117,126,29,29,58,184,8,46,VA - Charlottesville
4,1954-1955,1954-11-03,1955-02-28,118,0,9,127,136,21,19,40,176,8,36,VA - Charlottesville
5,1955-1956,1955-11-19,1956-03-19,122,1,4,119,123,20,15,35,158,8,31,VA - Charlottesville
6,1956-1957,1956-11-25,1957-04-13,140,1,8,97,105,24,26,50,155,12,51,VA - Charlottesville
7,1957-1958,1957-11-23,1958-03-25,123,0,16,147,163,60,72,132,295,13,78,VA - Charlottesville
8,1958-1959,1958-12-01,1959-04-13,134,0,15,154,169,9,10,19,188,4,23,VA - Charlottesville
9,1959-1960,1959-12-01,1960-03-26,117,0,11,137,148,66,162,228,376,14,96,VA - Charlottesville
10,1960-1961,1960-12-01,1961-03-22,112,0,22,158,180,60,233,293,473,13,102,VA - Charlottesville
11,1961-1962,1961-11-20,1962-03-14,115,0,18,144,162,71,121,192,354,20,108,VA - Charlottesville
12,1962-1963,1962-12-01,1963-03-12,102,0,22,186,208,39,111,150,358,14,78,VA - Charlottesville
13,1963-1964,1963-12-01,1964-04-01,123,0,14,134,148,53,137,190,338,13,78,VA - Charlottesville
14,1964-1965,1964-11-30,1965-03-20,111,0,15,136,151,23,49,72,223,9,53,VA - Charlottesville
15,1965-1966,1965-12-01,1966-02-28,90,0,15,119,134,55,148,203,337,9,82,VA - Charlottesville
16,1966-1967,1966-12-01,1967-03-19,109,0,12,138,150,50,128,178,328,12,84,VA - Charlottesville
17,1967-1968,1967-11-30,1968-03-02,94,0,18,147,165,27,78,105,270,12,55,VA - Charlottesville
18,1968-1969,1968-11-10,1969-03-10,121,0,9,149,158,43,43,86,244,9,52,VA - Charlottesville
19,1969-1970,1969-12-01,1970-02-28,90,0,22,142,164,36,131,167,331,7,62,VA - Charlottesville
20,1970-1971,1970-12-01,1971-04-07,128,1,13,144,157,37,72,109,266,8,55,VA - Charlottesville
21,1971-1972,1971-11-25,1972-02-29,97,1,8,95,103,29,42,71,174,6,36,VA - Charlottesville
22,1972-1973,1972-11-22,1973-04-13,143,1,9,110,119,16,15,31,150,7,29,VA - Charlottesville
23,1973-1974,1973-12-01,1974-03-13,103,1,4,80,84,18,32,50,134,9,39,VA - Charlottesville
24,1974-1975,1974-12-01,1975-03-15,105,1,5,89,94,38,44,82,176,12,60,VA - Charlottesville
25,1975-1976,1975-12-01,1976-03-11,102,0,13,123,136,10,12,22,158,6,20,VA - Charlottesville
26,1976-1977,1976-11-12,1977-02-28,109,9,25,207,232,19,101,120,352,9,36,VA - Charlottesville
27,1977-1978,1977-11-27,1978-03-14,108,0,21,211,232,50,272,322,554,23,99,VA - Charlottesville
28,1978-1979,1978-11-27,1979-02-28,94,0,20,158,178,45,111,156,334,14,83,VA - Charlottesville
29,1979-1980,1979-10-10,1980-03-15,158,5,16,136,152,64,104,168,320,15,99,VA - Charlottesville
30,1980-1981,1980-11-27,1981-03-19,113,0,21,156,177,7,2,9,186,6,16,VA - Charlottesville
31,1981-1982,1981-11-24,1982-04-09,137,3,25,169,194,49,119,168,362,13,78,VA - Charlottesville
34,1984-1985,1984-12-01,1985-02-28,90,13,13,116,129,6,12,18,147,1,7,VA - Charlottesville
36,1986-1987,1986-12-01,1987-03-11,101,8,7,118,125,27,64,91,216,6,42,VA - Charlottesville
40,1990-1991,1990-12-01,1991-03-14,104,15,1,81,82,10,2,12,94,5,15,VA - Charlottesville
41,1991-1992,1991-12-01,1992-02-29,91,4,2,95,97,3,0,3,100,2,6,VA - Charlottesville
42,1992-1993,1992-12-01,1993-03-15,105,16,5,129,134,33,3,36,170,9,50,VA - Charlottesville
44,1994-1995,1994-12-01,1995-02-28,90,9,6,77,83,0,38,38,121,0,0,VA - Charlottesville
46,1996-1997,1996-11-22,1997-02-28,99,16,8,110,118,19,35,54,172,5,28,VA - Charlottesville
47,1997-1998,1997-12-01,1998-02-28,90,9,0,53,53,15,25,40,93,5,21,VA - Charlottesville
48,1998-1999,1998-12-01,1999-03-16,106,7,8,106,114,23,23,46,160,8,45,VA - Charlottesville
49,1999-2000,1999-12-01,2000-02-29,91,0,8,98,106,21,78,99,205,6,34,VA - Charlottesville
50,2000-2001,2000-12-01,2001-02-28,90,1,5,113,118,8,12,20,138,3,16,VA - Charlottesville
51,2001-2002,2001-12-01,2002-02-28,90,2,1,59,60,7,7,14,74,5,15,VA - Charlottesville
52,2002-2003,2002-12-01,2003-03-31,121,2,13,155,168,57,117,174,342,18,105,VA - Charlottesville
53,2003-2004,2003-12-01,2004-02-29,91,0,11,132,143,33,76,109,252,12,66,VA - Charlottesville
54,2004-2005,2004-12-01,2005-03-06,96,0,12,115,127,25,39,64,191,10,46,VA - Charlottesville
55,2005-2006,2005-12-01,2006-03-22,112,0,4,89,93,24,35,59,152,7,34,VA - Charlottesville
56,2006-2007,2006-12-01,2007-04-08,129,2,4,117,121,9,17,26,147,5,21,VA - Charlottesville
57,2007-2008,2007-12-01,2008-02-29,91,0,5,84,89,5,3,8,97,2,10,VA - Charlottesville
58,2008-2009,2008-11-18,2009-03-13,116,0,13,149,162,15,20,35,197,8,25,VA - Charlottesville
59,2009-2010,2009-12-01,2010-03-03,93,0,13,120,133,75,297,372,505,13,107,VA - Charlottesville
60,2010-2011,2010-12-01,2011-03-27,117,0,13,122,135,14,23,37,172,9,32,VA - Charlottesville
61,2011-2012,2011-10-29,2012-03-06,130,3,3,66,69,15,10,25,94,5,20,VA - Charlottesville
62,2012-2013,2012-12-01,2013-03-26,116,0,8,95,103,44,43,87,190,12,67,VA - Charlottesville
63,2013-2014,2013-11-25,2014-03-27,123,0,19,195,214,55,82,137,351,16,100,VA - Charlottesville
64,2014-2015,2014-11-27,2015-03-08,102,0,18,159,177,32,82,114,291,7,57,VA - Charlottesville
65,2015-2016,2015-12-01,2016-03-04,95,1,9,92,101,27,59,86,187,6,48,VA - Charlottesville
66,2016-2017,2016-12-01,2017-03-14,104,0,7,83,90,6,11,17,107,4,19,VA - Charlottesville
67,2017-2018,2017-12-01,2018-04-10,131,0,18,143,161,16,9,25,186,11,32,VA - Charlottesville
68,2018-2019,2018-12-01,2019-03-09,99,0,7,89,96,33,45,78,174,7,44,VA - Charlottesville
69,2019-2020,2019-12-01,2020-02-29,91,0,0,53,53,3,3,6,59,1,4,VA - Charlottesville
0,1950-1951,1950-11-25,1951-02-28,96,0,6,123,129,7,4,11,140,4,14,VA - Danville
1,1951-1952,1951-12-01,1952-02-29,91,0,2,69,71,10,2,12,83,3,13,VA - Danville
2,1952-1953,1952-11-30,1953-03-02,93,0,0,59,59,5,0,5,64,2,7,VA - Danville
3,1953-1954,1953-12-01,1954-02-28,90,0,4,84,88,6,7,13,101,3,13,VA - Danville
4,1954-1955,1954-12-01,1955-02-28,90,0,2,110,112,22,17,39,151,4,27,VA - Danville
5,1955-1956,1955-12-01,1956-02-29,91,0,0,91,91,0,0,0,91,0,0,VA - Danville
6,1956-1957,1956-11-24,1957-02-28,97,0,4,74,78,2,1,3,81,1,6,VA - Danville
7,1957-1958,1957-12-01,1958-02-28,90,0,9,118,127,14,17,31,158,1,15,VA - Danville
8,1958-1959,1958-12-01,1959-02-28,90,0,8,123,131,18,27,45,176,4,32,VA - Danville
9,1959-1960,1959-12-01,1960-03-21,112,0,8,111,119,47,85,132,251,9,60,VA - Danville
10,1960-1961,1960-12-01,1961-02-28,90,3,13,122,135,4,3,7,142,2,13,VA - Danville
11,1961-1962,1961-12-01,1962-03-09,99,1,7,103,110,42,25,67,177,8,56,VA - Danville
12,1962-1963,1962-12-01,1963-02-28,90,3,9,148,157,5,7,12,169,4,8,VA - Danville
16,1966-1967,1966-12-01,1967-02-28,90,18,3,128,131,12,8,20,151,2,16,VA - Danville
18,1968-1969,1968-12-01,1969-03-04,94,1,1,127,128,17,13,30,158,3,24,VA - Danville
19,1969-1970,1969-12-01,1970-02-28,90,3,11,151,162,17,23,40,202,4,28,VA - Danville
20,1970-1971,1970-12-01,1971-03-27,117,5,5,118,123,0,7,7,130,0,0,VA - Danville
23,1973-1974,1973-12-01,1974-02-28,90,12,1,70,71,13,6,19,90,1,15,VA - Danville
25,1975-1976,1975-12-01,1976-02-29,91,0,2,126,128,0,0,0,128,0,0,VA - Danville
28,1978-1979,1978-12-01,1979-02-28,90,2,6,141,147,7,44,51,198,1,9,VA - Danville
29,1979-1980,1979-12-01,1980-03-05,96,11,5,123,128,25,47,72,200,5,40,VA - Danville
30,1980-1981,1980-12-01,1981-02-28,90,0,11,169,180,8,7,15,195,4,21,VA - Danville
31,1981-1982,1981-12-01,1982-04-09,130,17,14,139,153,20,16,36,189,4,26,VA - Danville
40,1990-1991,1990-12-01,1991-02-28,90,4,1,72,73,0,0,0,73,0,0,VA - Danville
41,1991-1992,1991-12-01,1992-04-05,127,3,1,99,100,2,0,2,102,1,3,VA - Danville
42,1992-1993,1992-12-01,1993-02-28,90,8,1,84,85,0,0,0,85,0,0,VA - Danville
43,1993-1994,1993-12-01,1994-02-28,90,18,16,134,150,0,0,0,150,0,0,VA - Danville
44,1994-1995,1994-12-01,1995-02-28,90,3,4,91,95,0,0,0,95,0,0,VA - Danville
45,1995-1996,1995-12-01,1996-03-09,100,16,14,145,159,0,25,25,184,0,0,VA - Danville
46,1996-1997,1996-12-01,1997-02-28,90,5,3,87,90,2,1,3,93,1,4,VA - Danville
47,1997-1998,1997-12-01,1998-02-28,90,8,0,66,66,6,4,10,76,1,8,VA - Danville
48,1998-1999,1998-12-01,1999-02-28,90,6,3,84,87,0,0,0,87,0,0,VA - Danville
49,1999-2000,1999-12-01,2000-02-29,91,2,5,102,107,21,45,66,173,7,35,VA - Danville
50,2000-2001,2000-12-01,2001-02-28,90,0,2,143,145,3,2,5,150,1,6,VA - Danville
51,2001-2002,2001-12-01,2002-02-28,90,0,2,90,92,9,13,22,114,1,11,VA - Danville
52,2002-2003,2002-12-01,2003-02-28,90,1,8,120,128,0,0,0,128,0,0,VA - Danville
53,2003-2004,2003-12-01,2004-02-29,91,0,7,129,136,35,0,35,171,7,47,VA - Danville
54,2004-2005,2004-12-01,2005-03-17,107,0,8,119,127,9,4,13,140,8,22,VA - Danville
55,2005-2006,2005-12-01,2006-02-28,90,0,1,90,91,4,3,7,98,3,7,VA - Danville
56,2006-2007,2006-12-01,2007-02-28,90,0,0,102,102,1,0,1,103,1,2,VA - Danville
57,2007-2008,2007-12-01,2008-02-29,91,0,0,78,78,5,4,9,87,2,6,VA - Danville
58,2008-2009,2008-12-01,2009-03-04,94,0,2,113,115,8,10,18,133,4,14,VA - Danville
59,2009-2010,2009-12-01,2010-03-02,92,3,3,119,122,20,27,47,169,8,28,VA - Danville
60,2010-2011,2010-12-01,2011-02-28,90,0,3,131,134,18,12,30,164,9,35,VA - Danville
61,2011-2012,2011-12-01,2012-02-29,91,0,1,78,79,4,3,7,86,1,5,VA - Danville
62,2012-2013,2012-12-01,2013-02-28,90,0,1,73,74,5,1,6,80,4,11,VA - Danville
63,2013-2014,2013-12-01,2014-03-25,115,0,7,152,159,19,27,46,205,10,42,VA - Danville
64,2014-2015,2014-12-01,2015-02-28,90,2,8,114,122,14,12,26,148,3,22,VA - Danville
65,2015-2016,2015-12-01,2016-02-29,91,2,6,84,90,15,24,39,129,5,31,VA - Danville
66,2016-2017,2016-12-01,2017-02-28,90,0,5,78,83,12,20,32,115,2,19,VA - Danville
67,2017-2018,2017-12-01,2018-03-24,114,13,6,130,136,28,27,55,191,6,35,VA - Danville
68,2018-2019,2018-12-01,2019-02-28,90,0,1,78,79,22,25,47,126,1,23,VA - Danville
69,2019-2020,2019-12-01,2020-02-29,91,0,0,61,61,2,0,2,63,1,3,VA - Danville
0,1950-1951,1950-11-26,1951-02-28,95,0,14,139,153,16,14,30,183,8,36,VA - Lynchburg
1,1951-1952,1951-12-01,1952-03-02,93,0,5,87,92,15,5,20,112,9,28,VA - Lynchburg
2,1952-1953,1952-11-29,1953-03-08,100,0,3,71,74,13,14,27,101,6,23,VA - Lynchburg
3,1953-1954,1953-11-06,1954-02-28,115,0,8,106,114,9,11,20,134,4,18,VA - Lynchburg
4,1954-1955,1954-11-02,1955-02-28,119,0,9,135,144,20,23,43,187,11,39,VA - Lynchburg
5,1955-1956,1955-11-19,1956-03-19,122,0,2,128,130,10,1,11,141,9,21,VA - Lynchburg
6,1956-1957,1956-11-24,1957-04-13,141,0,9,89,98,12,7,19,117,7,31,VA - Lynchburg
7,1957-1958,1957-12-01,1958-03-18,108,0,19,146,165,30,38,68,233,7,38,VA - Lynchburg
8,1958-1959,1958-12-01,1959-04-14,135,0,16,153,169,16,19,35,204,5,28,VA - Lynchburg
9,1959-1960,1959-12-01,1960-03-20,111,0,12,142,154,63,114,177,331,13,95,VA - Lynchburg
10,1960-1961,1960-12-01,1961-02-28,90,0,20,150,170,23,57,80,250,8,45,VA - Lynchburg
11,1961-1962,1961-11-19,1962-03-12,114,0,12,133,145,63,60,123,268,16,88,VA - Lynchburg
12,1962-1963,1962-11-25,1963-02-28,96,0,21,186,207,24,22,46,253,11,48,VA - Lynchburg
13,1963-1964,1963-12-01,1964-02-29,91,0,14,144,158,34,53,87,245,10,59,VA - Lynchburg
14,1964-1965,1964-11-30,1965-03-20,111,0,13,159,172,20,36,56,228,8,50,VA - Lynchburg
15,1965-1966,1965-12-01,1966-02-28,90,0,12,134,146,54,147,201,347,11,86,VA - Lynchburg
16,1966-1967,1966-12-01,1967-02-28,90,0,8,126,134,50,88,138,272,12,74,VA - Lynchburg
17,1967-1968,1967-12-01,1968-03-02,93,0,12,167,179,18,24,42,221,11,40,VA - Lynchburg
18,1968-1969,1968-11-09,1969-03-09,121,0,10,180,190,50,32,82,272,12,70,VA - Lynchburg
19,1969-1970,1969-12-01,1970-02-28,90,0,18,182,200,28,49,77,277,10,54,VA - Lynchburg
20,1970-1971,1970-11-04,1971-04-07,155,0,15,162,177,43,40,83,260,15,66,VA - Lynchburg
21,1971-1972,1971-11-24,1972-02-29,98,0,7,104,111,27,33,60,171,7,38,VA - Lynchburg
22,1972-1973,1972-11-22,1973-04-12,142,0,9,135,144,14,10,24,168,5,23,VA - Lynchburg
23,1973-1974,1973-12-01,1974-02-28,90,0,7,85,92,18,29,47,139,5,29,VA - Lynchburg
24,1974-1975,1974-11-30,1975-03-11,102,0,3,105,108,21,19,40,148,7,29,VA - Lynchburg
25,1975-1976,1975-12-01,1976-03-09,100,0,7,124,131,4,1,5,136,3,9,VA - Lynchburg
26,1976-1977,1976-11-30,1977-02-28,91,0,27,232,259,18,80,98,357,7,34,VA - Lynchburg
27,1977-1978,1977-11-27,1978-03-08,102,0,21,201,222,39,93,132,354,20,83,VA - Lynchburg
28,1978-1979,1978-12-01,1979-02-28,90,0,24,172,196,39,78,117,313,16,95,VA - Lynchburg
29,1979-1980,1979-12-01,1980-03-14,105,0,11,147,158,42,62,104,262,11,71,VA - Lynchburg
30,1980-1981,1980-12-01,1981-03-23,113,0,19,174,193,12,5,17,210,8,24,VA - Lynchburg
31,1981-1982,1981-11-24,1982-04-09,137,1,19,187,206,45,57,102,308,15,81,VA - Lynchburg
32,1982-1983,1982-12-01,1983-02-28,90,0,7,93,100,35,59,94,194,8,48,VA - Lynchburg
33,1983-1984,1983-12-01,1984-03-07,98,0,20,134,154,7,5,12,166,5,13,VA - Lynchburg
34,1984-1985,1984-12-01,1985-03-22,112,0,10,125,135,10,5,15,150,4,14,VA - Lynchburg
35,1985-1986,1985-12-01,1986-02-28,90,0,9,126,135,19,15,34,169,7,36,VA - Lynchburg
36,1986-1987,1986-12-01,1987-04-04,125,0,5,134,139,65,118,183,322,12,87,VA - Lynchburg
37,1987-1988,1987-11-11,1988-02-29,111,0,14,140,154,14,33,47,201,4,27,VA - Lynchburg
38,1988-1989,1988-12-01,1989-03-20,110,0,8,107,115,20,15,35,150,10,37,VA - Lynchburg
39,1989-1990,1989-11-22,1990-03-20,119,0,14,131,145,25,71,96,241,8,40,VA - Lynchburg
40,1990-1991,1990-12-01,1991-03-14,104,0,4,81,85,6,4,10,95,4,10,VA - Lynchburg
41,1991-1992,1991-12-01,1992-04-04,126,0,2,105,107,5,0,5,112,4,10,VA - Lynchburg
42,1992-1993,1992-12-01,1993-03-17,107,0,2,106,108,24,38,62,170,6,35,VA - Lynchburg
43,1993-1994,1993-12-01,1994-03-03,93,0,15,131,146,18,26,44,190,11,38,VA - Lynchburg
44,1994-1995,1994-12-01,1995-03-04,94,0,5,83,88,11,12,23,111,6,19,VA - Lynchburg
45,1995-1996,1995-12-01,1996-03-20,111,0,17,158,175,77,141,218,393,13,111,VA - Lynchburg
46,1996-1997,1996-12-01,1997-02-28,90,0,9,114,123,0,0,0,123,0,0,VA - Lynchburg
47,1997-1998,1997-12-01,1998-02-28,90,0,1,87,88,4,0,4,92,2,9,VA - Lynchburg
48,1998-1999,1998-12-01,1999-03-15,105,3,9,116,125,10,0,10,135,7,23,VA - Lynchburg
49,1999-2000,1999-12-01,2000-02-29,91,0,8,135,143,24,0,24,167,10,48,VA - Lynchburg
50,2000-2001,2000-12-01,2001-02-28,90,0,9,166,175,0,0,0,175,0,0,VA - Lynchburg
51,2001-2002,2001-12-01,2002-03-04,94,0,3,116,119,0,0,0,119,0,0,VA - Lynchburg
52,2002-2003,2002-12-01,2003-02-28,90,0,13,145,158,0,0,0,158,0,0,VA - Lynchburg
53,2003-2004,2003-12-01,2004-02-29,91,0,11,146,157,19,6,25,182,6,32,VA - Lynchburg
54,2004-2005,2004-12-01,2005-03-17,107,0,11,144,155,16,22,38,193,10,39,VA - Lynchburg
55,2005-2006,2005-12-01,2006-02-28,90,0,2,110,112,20,11,31,143,8,34,VA - Lynchburg
56,2006-2007,2006-12-01,2007-02-28,90,0,8,131,139,6,4,10,149,3,18,VA - Lynchburg
57,2007-2008,2007-12-01,2008-02-29,91,0,5,108,113,4,2,6,119,2,7,VA - Lynchburg
58,2008-2009,2008-12-01,2009-03-05,95,0,7,159,166,18,8,26,192,7,31,VA - Lynchburg
59,2009-2010,2009-12-01,2010-03-02,92,0,7,157,164,52,185,237,401,13,84,VA - Lynchburg
60,2010-2011,2010-12-01,2011-03-27,117,0,6,169,175,14,18,32,207,8,26,VA - Lynchburg
61,2011-2012,2011-12-01,2012-03-05,96,0,1,95,96,11,8,19,115,2,13,VA - Lynchburg
62,2012-2013,2012-12-01,2013-04-04,125,0,4,125,129,21,11,32,161,10,34,VA - Lynchburg
63,2013-2014,2013-12-01,2014-03-25,115,0,10,186,196,31,33,64,260,9,52,VA - Lynchburg
64,2014-2015,2014-12-01,2015-03-06,96,0,20,169,189,33,56,89,278,7,58,VA - Lynchburg
65,2015-2016,2015-12-01,2016-02-29,91,0,11,115,126,22,28,50,176,5,44,VA - Lynchburg
66,2016-2017,2016-12-01,2017-02-28,90,1,6,86,92,8,17,25,117,2,14,VA - Lynchburg
67,2017-2018,2017-12-01,2018-04-09,130,1,13,168,181,22,12,34,215,9,34,VA - Lynchburg
68,2018-2019,2018-12-01,2019-03-08,98,0,4,105,109,27,33,60,169,7,37,VA - Lynchburg
69,2019-2020,2019-12-01,2020-02-29,91,0,0,71,71,0,0,0,71,0,0,VA - Lynchburg
0,1950-1951,1950-11-28,1951-02-28,93,0,4,65,69,8,4,12,81,5,16,VA - Norfolk
1,1951-1952,1951-12-01,1952-02-29,91,0,2,46,48,0,0,0,48,0,0,VA - Norfolk
2,1952-1953,1952-12-01,1953-03-02,92,0,0,31,31,1,1,2,33,1,2,VA - Norfolk
3,1953-1954,1953-12-01,1954-02-28,90,0,2,45,47,3,1,4,51,2,5,VA - Norfolk
4,1954-1955,1954-12-01,1955-02-28,90,0,7,73,80,23,18,41,121,7,32,VA - Norfolk
5,1955-1956,1955-12-01,1956-02-29,91,0,3,60,63,2,0,2,65,2,4,VA - Norfolk
6,1956-1957,1956-12-01,1957-02-28,90,0,2,39,41,5,1,6,47,2,8,VA - Norfolk
7,1957-1958,1957-12-01,1958-02-28,90,0,9,72,81,8,7,15,96,4,12,VA - Norfolk
8,1958-1959,1958-12-01,1959-02-28,90,0,9,80,89,22,34,56,145,4,29,VA - Norfolk
9,1959-1960,1959-12-01,1960-03-12,103,3,3,56,59,15,3,18,77,6,23,VA - Norfolk
10,1960-1961,1960-12-01,1961-02-28,90,0,12,110,122,9,10,19,141,7,26,VA - Norfolk
11,1961-1962,1961-12-01,1962-03-07,97,0,9,87,96,19,17,36,132,8,33,VA - Norfolk
12,1962-1963,1962-12-01,1963-02-28,90,0,12,107,119,17,11,28,147,6,28,VA - Norfolk
13,1963-1964,1963-12-01,1964-04-01,123,0,9,80,89,12,5,17,106,6,18,VA - Norfolk
14,1964-1965,1964-12-01,1965-02-28,90,0,4,78,82,20,22,42,124,5,35,VA - Norfolk
15,1965-1966,1965-12-01,1966-02-28,90,0,6,83,89,22,60,82,171,6,36,VA - Norfolk
16,1966-1967,1966-12-01,1967-02-28,90,0,2,46,48,15,12,27,75,4,19,VA - Norfolk
17,1967-1968,1967-12-01,1968-03-01,92,0,9,104,113,13,8,21,134,9,26,VA - Norfolk
18,1968-1969,1968-12-01,1969-03-10,100,0,5,59,64,8,7,15,79,4,11,VA - Norfolk
19,1969-1970,1969-12-01,1970-02-28,90,0,14,91,105,10,6,16,121,7,26,VA - Norfolk
20,1970-1971,1970-12-01,1971-03-26,116,0,3,58,61,11,2,13,74,4,19,VA - Norfolk
21,1971-1972,1971-12-01,1972-02-29,91,0,2,33,35,2,0,2,37,1,2,VA - Norfolk
22,1972-1973,1972-12-01,1973-02-28,90,0,8,55,63,19,23,42,105,4,29,VA - Norfolk
23,1973-1974,1973-12-01,1974-03-26,116,0,1,29,30,13,5,18,48,3,16,VA - Norfolk
24,1974-1975,1974-12-01,1975-03-02,92,0,0,34,34,2,0,2,36,2,4,VA - Norfolk
25,1975-1976,1975-12-01,1976-02-29,91,0,6,83,89,0,0,0,89,0,0,VA - Norfolk
26,1976-1977,1976-12-01,1977-02-28,90,0,14,125,139,11,6,17,156,6,20,VA - Norfolk
27,1977-1978,1977-12-01,1978-03-03,93,0,6,89,95,19,20,39,134,9,32,VA - Norfolk
28,1978-1979,1978-12-01,1979-02-28,90,0,8,87,95,21,12,33,128,6,36,VA - Norfolk
29,1979-1980,1979-12-01,1980-03-05,96,0,8,87,95,57,88,145,240,9,79,VA - Norfolk
30,1980-1981,1980-12-01,1981-03-19,109,0,11,117,128,1,0,1,129,1,2,VA - Norfolk
31,1981-1982,1981-12-01,1982-02-28,90,0,7,75,82,9,7,16,98,6,19,VA - Norfolk
32,1982-1983,1982-12-01,1983-02-28,90,0,2,39,41,5,0,5,46,4,9,VA - Norfolk
33,1983-1984,1983-12-01,1984-02-29,91,0,11,73,84,7,7,14,98,1,8,VA - Norfolk
34,1984-1985,1984-12-01,1985-02-28,90,0,6,76,82,7,5,12,94,4,17,VA - Norfolk
35,1985-1986,1985-12-01,1986-02-28,90,0,7,70,77,8,4,12,89,5,15,VA - Norfolk
36,1986-1987,1986-12-01,1987-03-16,106,0,1,53,54,6,4,10,64,5,9,VA - Norfolk
37,1987-1988,1987-11-11,1988-02-29,111,0,5,67,72,7,4,11,83,3,10,VA - Norfolk
38,1988-1989,1988-12-01,1989-04-11,132,0,1,54,55,35,26,61,116,6,39,VA - Norfolk
39,1989-1990,1989-12-01,1990-02-28,90,0,11,61,72,1,0,1,73,1,3,VA - Norfolk
40,1990-1991,1990-12-01,1991-02-28,90,0,0,27,27,0,0,0,27,0,0,VA - Norfolk
41,1991-1992,1991-12-01,1992-02-29,91,0,0,39,39,0,0,0,39,0,0,VA - Norfolk
42,1992-1993,1992-12-01,1993-03-14,104,0,3,41,44,8,1,9,53,6,12,VA - Norfolk
43,1993-1994,1993-12-01,1994-03-03,93,0,13,81,94,18,15,33,127,10,38,VA - Norfolk
44,1994-1995,1994-12-01,1995-02-28,90,0,1,29,30,1,0,1,31,1,3,VA - Norfolk
45,1995-1996,1995-12-01,1996-03-09,100,17,10,86,96,24,40,64,160,7,42,VA - Norfolk
54,2004-2005,2004-12-01,2005-03-08,98,6,4,63,67,13,11,24,91,7,26,VA - Norfolk
55,2005-2006,2005-12-01,2006-02-28,90,0,1,32,33,3,1,4,37,3,6,VA - Norfolk
56,2006-2007,2006-12-01,2007-04-07,128,0,1,57,58,1,0,1,59,1,1,VA - Norfolk
57,2007-2008,2007-12-01,2008-02-29,91,0,1,31,32,1,0,1,33,1,2,VA - Norfolk
58,2008-2009,2008-12-01,2009-03-03,93,0,5,66,71,1,0,1,72,1,3,VA - Norfolk
59,2009-2010,2009-12-01,2010-03-03,93,1,3,65,68,16,18,34,102,8,27,VA - Norfolk
60,2010-2011,2010-12-01,2011-02-28,90,0,2,80,82,32,42,74,156,9,43,VA - Norfolk
61,2011-2012,2011-12-01,2012-02-29,91,0,0,18,18,2,0,2,20,2,4,VA - Norfolk
62,2012-2013,2012-12-01,2013-02-28,90,0,1,28,29,3,2,5,34,2,6,VA - Norfolk
63,2013-2014,2013-12-01,2014-03-04,94,0,9,82,91,20,31,51,142,6,39,VA - Norfolk
64,2014-2015,2014-12-01,2015-03-06,96,4,12,88,100,19,35,54,154,7,33,VA - Norfolk
65,2015-2016,2015-12-01,2016-02-29,91,1,4,38,42,11,1,12,54,8,24,VA - Norfolk
66,2016-2017,2016-12-01,2017-03-19,109,1,3,36,39,8,18,26,65,2,11,VA - Norfolk
67,2017-2018,2017-12-01,2018-03-13,103,0,10,66,76,21,44,65,141,5,30,VA - Norfolk
68,2018-2019,2018-12-01,2019-02-28,90,0,3,30,33,1,0,1,34,1,1,VA - Norfolk
69,2019-2020,2019-12-01,2020-02-29,91,0,0,15,15,2,0,2,17,2,3,VA - Norfolk
0,1950-1951,1950-12-01,1951-02-28,90,0,7,109,116,2,0,2,118,2,4,VA - Richmond
1,1951-1952,1951-12-01,1952-02-29,91,0,3,82,85,19,2,21,106,5,24,VA - Richmond
2,1952-1953,1952-11-30,1953-04-21,143,0,0,76,76,11,6,17,93,4,14,VA - Richmond
3,1953-1954,1953-11-06,1954-02-28,115,0,5,107,112,21,15,36,148,5,31,VA - Richmond
4,1954-1955,1954-12-01,1955-02-28,90,0,5,125,130,17,21,38,168,5,25,VA - Richmond
5,1955-1956,1955-12-01,1956-02-29,91,0,2,113,115,3,0,3,118,2,5,VA - Richmond
6,1956-1957,1956-12-01,1957-04-13,134,0,6,86,92,13,7,20,112,8,27,VA - Richmond
7,1957-1958,1957-12-01,1958-03-20,110,0,9,133,142,30,31,61,203,9,40,VA - Richmond
8,1958-1959,1958-12-01,1959-02-28,90,3,10,146,156,20,23,43,199,4,35,VA - Richmond
9,1959-1960,1959-12-01,1960-03-17,108,0,8,130,138,45,74,119,257,11,69,VA - Richmond
10,1960-1961,1960-12-01,1961-02-28,90,0,13,155,168,18,25,43,211,8,43,VA - Richmond
11,1961-1962,1961-12-01,1962-03-11,101,0,8,137,145,57,55,112,257,14,82,VA - Richmond
12,1962-1963,1962-11-05,1963-02-28,116,0,13,166,179,25,22,47,226,9,41,VA - Richmond
13,1963-1964,1963-12-01,1964-04-01,123,0,5,164,169,34,26,60,229,11,53,VA - Richmond
14,1964-1965,1964-11-30,1965-03-20,111,0,7,136,143,30,34,64,207,8,55,VA - Richmond
15,1965-1966,1965-12-01,1966-02-28,90,0,13,147,160,41,91,132,292,10,75,VA - Richmond
16,1966-1967,1966-11-30,1967-02-28,91,0,7,133,140,48,55,103,243,15,81,VA - Richmond
17,1967-1968,1967-12-01,1968-03-13,104,0,8,173,181,21,15,36,217,10,40,VA - Richmond
18,1968-1969,1968-11-12,1969-03-10,119,0,5,150,155,21,14,35,190,6,25,VA - Richmond
19,1969-1970,1969-12-01,1970-02-28,90,0,18,175,193,11,15,26,219,7,30,VA - Richmond
20,1970-1971,1970-12-01,1971-04-07,128,0,11,143,154,26,13,39,193,12,50,VA - Richmond
21,1971-1972,1971-12-01,1972-02-29,91,0,3,87,90,19,9,28,118,3,20,VA - Richmond
22,1972-1973,1972-11-22,1973-03-22,121,0,7,112,119,11,11,22,141,7,18,VA - Richmond
23,1973-1974,1973-12-01,1974-02-28,90,0,1,74,75,19,28,47,122,6,29,VA - Richmond
24,1974-1975,1974-12-01,1975-03-10,100,0,1,101,102,9,7,16,118,5,16,VA - Richmond
25,1975-1976,1975-12-01,1976-03-10,101,0,5,127,132,3,1,4,136,2,7,VA - Richmond
26,1976-1977,1976-11-12,1977-02-28,109,0,15,231,246,18,20,38,284,9,46,VA - Richmond
27,1977-1978,1977-12-01,1978-03-08,98,0,10,186,196,15,19,34,230,8,34,VA - Richmond
28,1978-1979,1978-12-01,1979-02-28,90,0,18,151,169,30,66,96,265,9,63,VA - Richmond
29,1979-1980,1979-12-01,1980-03-13,104,0,7,121,128,52,59,111,239,11,77,VA - Richmond
30,1980-1981,1980-12-01,1981-03-19,109,0,17,171,188,4,0,4,192,4,10,VA - Richmond
31,1981-1982,1981-12-01,1982-04-09,130,0,15,119,134,32,45,77,211,13,51,VA - Richmond
32,1982-1983,1982-12-01,1983-02-28,90,0,3,72,75,40,53,93,168,6,49,VA - Richmond
33,1983-1984,1983-11-25,1984-03-29,126,0,20,140,160,9,1,10,170,7,19,VA - Richmond
34,1984-1985,1984-12-01,1985-02-28,90,0,6,117,123,13,13,26,149,5,25,VA - Richmond
35,1985-1986,1985-12-01,1986-02-28,90,0,10,117,127,13,12,25,152,8,34,VA - Richmond
36,1986-1987,1986-12-01,1987-03-16,106,0,7,126,133,28,76,104,237,6,46,VA - Richmond
37,1987-1988,1987-11-11,1988-02-29,111,0,9,131,140,17,30,47,187,4,29,VA - Richmond
38,1988-1989,1988-12-01,1989-03-08,98,0,6,102,108,21,16,37,145,5,29,VA - Richmond
39,1989-1990,1989-11-23,1990-04-07,136,0,13,109,122,15,26,41,163,7,25,VA - Richmond
40,1990-1991,1990-12-01,1991-02-28,90,0,1,68,69,2,1,3,72,1,3,VA - Richmond
41,1991-1992,1991-11-08,1992-02-29,114,0,1,88,89,2,0,2,91,2,3,VA - Richmond
42,1992-1993,1992-12-01,1993-03-14,104,0,2,93,95,13,11,24,119,7,23,VA - Richmond
43,1993-1994,1993-12-01,1994-03-03,93,0,16,122,138,18,21,39,177,12,47,VA - Richmond
44,1994-1995,1994-12-01,1995-03-04,94,0,4,82,86,7,5,12,98,5,11,VA - Richmond
46,1996-1997,1996-12-01,1997-02-28,90,0,4,72,76,5,1,6,82,3,9,VA - Richmond
54,2004-2005,2004-12-01,2005-03-08,98,6,6,98,104,13,11,24,128,10,35,VA - Richmond
55,2005-2006,2005-12-01,2006-03-22,112,0,2,89,91,14,13,27,118,8,22,VA - Richmond
56,2006-2007,2006-12-01,2007-04-07,128,0,2,100,102,3,1,4,106,2,6,VA - Richmond
57,2007-2008,2007-12-01,2008-02-29,91,0,0,71,71,1,1,2,73,1,2,VA - Richmond
58,2008-2009,2008-12-01,2009-03-05,95,0,6,110,116,10,19,29,145,3,15,VA - Richmond
59,2009-2010,2009-12-01,2010-03-02,92,0,3,108,111,41,67,108,219,11,60,VA - Richmond
60,2010-2011,2010-12-01,2011-02-28,90,0,5,111,116,16,14,30,146,8,28,VA - Richmond
61,2011-2012,2011-12-01,2012-03-05,96,0,0,58,58,6,7,13,71,3,9,VA - Richmond
62,2012-2013,2012-12-01,2013-03-25,115,0,2,78,80,12,6,18,98,6,20,VA - Richmond
63,2013-2014,2013-12-01,2014-03-17,107,0,9,134,143,19,16,35,178,7,39,VA - Richmond
64,2014-2015,2014-12-01,2015-03-06,96,0,13,124,137,21,29,50,187,6,37,VA - Richmond
65,2015-2016,2015-12-01,2016-03-04,95,0,8,88,96,22,28,50,146,7,37,VA - Richmond
66,2016-2017,2016-12-01,2017-02-28,90,0,6,65,71,11,17,28,99,2,17,VA - Richmond
67,2017-2018,2017-12-01,2018-03-22,112,0,11,121,132,18,19,37,169,8,34,VA - Richmond
68,2018-2019,2018-12-01,2019-02-28,90,0,2,71,73,18,19,37,110,4,22,VA - Richmond
69,2019-2020,2019-11-12,2020-02-29,110,0,0,63,63,3,0,3,66,3,6,VA - Richmond
0,1950-1951,1950-11-24,1951-03-14,111,0,16,142,158,22,20,42,200,8,44,VA - Roanoke
1,1951-1952,1951-11-19,1952-03-02,105,0,5,108,113,12,8,20,133,6,22,VA - Roanoke
2,1952-1953,1952-11-29,1953-03-04,96,0,2,68,70,14,12,26,96,6,22,VA - Roanoke
3,1953-1954,1953-11-06,1954-02-28,115,2,6,111,117,15,9,24,141,4,23,VA - Roanoke
4,1954-1955,1954-11-02,1955-03-19,138,0,10,140,150,27,16,43,193,12,44,VA - Roanoke
5,1955-1956,1955-11-10,1956-04-07,150,2,5,140,145,14,1,15,160,8,24,VA - Roanoke
6,1956-1957,1956-11-24,1957-04-13,141,0,9,91,100,9,2,11,111,7,22,VA - Roanoke
7,1957-1958,1957-10-27,1958-03-25,150,0,18,161,179,40,21,61,240,11,49,VA - Roanoke
8,1958-1959,1958-12-01,1959-04-13,134,0,15,155,170,10,14,24,194,4,20,VA - Roanoke
9,1959-1960,1959-11-29,1960-03-21,114,0,17,145,162,91,125,216,378,16,128,VA - Roanoke
10,1960-1961,1960-12-01,1961-03-18,108,0,17,150,167,52,73,125,292,15,92,VA - Roanoke
11,1961-1962,1961-11-19,1962-03-10,112,0,9,125,134,41,19,60,194,16,68,VA - Roanoke
12,1962-1963,1962-11-25,1963-03-21,117,0,21,206,227,41,28,69,296,14,67,VA - Roanoke
13,1963-1964,1963-12-01,1964-03-30,121,0,13,145,158,66,68,134,292,14,95,VA - Roanoke
14,1964-1965,1964-11-30,1965-03-21,112,0,13,160,173,31,41,72,245,9,56,VA - Roanoke
15,1965-1966,1965-12-01,1966-02-28,90,0,18,128,146,74,125,199,345,12,112,VA - Roanoke
16,1966-1967,1966-12-01,1967-03-20,110,0,9,137,146,57,76,133,279,14,88,VA - Roanoke
17,1967-1968,1967-12-01,1968-03-01,92,0,10,137,147,45,78,123,270,9,65,VA - Roanoke
18,1968-1969,1968-11-09,1969-03-09,121,0,12,165,177,54,24,78,255,14,69,VA - Roanoke
19,1969-1970,1969-12-01,1970-04-06,127,0,19,193,212,39,39,78,290,12,67,VA - Roanoke
20,1970-1971,1970-11-04,1971-04-07,155,0,17,177,194,46,37,83,277,11,64,VA - Roanoke
21,1971-1972,1971-11-24,1972-02-29,98,0,7,114,121,32,16,48,169,9,47,VA - Roanoke
22,1972-1973,1972-12-01,1973-04-12,133,0,8,118,126,13,6,19,145,4,20,VA - Roanoke
23,1973-1974,1973-12-01,1974-02-28,90,0,6,73,79,24,24,48,127,7,34,VA - Roanoke
24,1974-1975,1974-11-30,1975-03-11,102,0,3,102,105,37,28,65,170,9,45,VA - Roanoke
25,1975-1976,1975-12-01,1976-03-17,108,0,5,123,128,5,1,6,134,3,8,VA - Roanoke
26,1976-1977,1976-11-12,1977-02-28,109,0,28,252,280,29,40,69,349,13,60,VA - Roanoke
27,1977-1978,1977-11-27,1978-03-08,102,0,26,210,236,51,127,178,414,21,100,VA - Roanoke
28,1978-1979,1978-11-26,1979-02-28,95,0,18,171,189,37,57,94,283,16,87,VA - Roanoke
29,1979-1980,1979-12-01,1980-03-14,105,0,14,137,151,42,48,90,241,11,68,VA - Roanoke
30,1980-1981,1980-12-01,1981-03-23,113,0,16,183,199,19,6,25,224,8,33,VA - Roanoke
31,1981-1982,1981-11-24,1982-04-09,137,1,26,199,225,47,45,92,317,19,93,VA - Roanoke
32,1982-1983,1982-12-01,1983-04-18,139,0,7,111,118,48,66,114,232,11,63,VA - Roanoke
33,1983-1984,1983-12-01,1984-04-10,132,0,17,158,175,18,6,24,199,11,34,VA - Roanoke
34,1984-1985,1984-12-01,1985-03-22,112,0,15,137,152,10,3,13,165,6,21,VA - Roanoke
35,1985-1986,1985-12-01,1986-02-28,90,0,11,138,149,16,8,24,173,7,33,VA - Roanoke
36,1986-1987,1986-12-01,1987-04-04,125,0,5,132,137,76,112,188,325,14,99,VA - Roanoke
37,1987-1988,1987-11-11,1988-02-29,111,0,15,141,156,12,28,40,196,5,28,VA - Roanoke
38,1988-1989,1988-12-01,1989-04-08,129,0,7,111,118,23,11,34,152,11,37,VA - Roanoke
39,1989-1990,1989-11-22,1990-03-20,119,0,17,136,153,25,79,104,257,10,41,VA - Roanoke
40,1990-1991,1990-12-01,1991-03-14,104,0,4,84,88,2,1,3,91,2,5,VA - Roanoke
41,1991-1992,1991-12-01,1992-04-05,127,0,1,106,107,7,4,11,118,4,13,VA - Roanoke
42,1992-1993,1992-12-01,1993-04-05,126,0,4,119,123,40,55,95,218,12,57,VA - Roanoke
43,1993-1994,1993-12-01,1994-03-03,93,0,16,146,162,24,47,71,233,14,51,VA - Roanoke
44,1994-1995,1994-12-01,1995-03-04,94,0,6,96,102,17,22,39,141,8,29,VA - Roanoke
45,1995-1996,1995-11-13,1996-03-20,129,0,19,176,195,75,130,205,400,12,108,VA - Roanoke
46,1996-1997,1996-12-01,1997-02-28,90,1,9,97,106,6,6,12,118,2,9,VA - Roanoke
47,1997-1998,1997-12-01,1998-02-28,90,0,3,51,54,16,22,38,92,3,18,VA - Roanoke
48,1998-1999,1998-12-01,1999-03-15,105,1,7,95,102,10,14,24,126,4,15,VA - Roanoke
49,1999-2000,1999-12-01,2000-02-29,91,0,7,93,100,18,40,58,158,6,29,VA - Roanoke
50,2000-2001,2000-12-01,2001-03-06,96,0,7,131,138,14,20,34,172,6,28,VA - Roanoke
51,2001-2002,2001-12-01,2002-02-28,90,0,1,71,72,6,5,11,83,3,9,VA - Roanoke
52,2002-2003,2002-12-01,2003-03-31,121,1,13,124,137,38,53,91,228,13,69,VA - Roanoke
53,2003-2004,2003-12-01,2004-02-29,91,0,8,111,119,31,64,95,214,9,47,VA - Roanoke
54,2004-2005,2004-12-01,2005-03-17,107,0,9,102,111,24,24,48,159,10,36,VA - Roanoke
55,2005-2006,2005-11-23,2006-02-28,98,0,1,70,71,17,14,31,102,8,26,VA - Roanoke
56,2006-2007,2006-12-01,2007-02-28,90,0,4,92,96,5,4,9,105,2,11,VA - Roanoke
57,2007-2008,2007-12-01,2008-02-29,91,0,2,75,77,8,2,10,87,3,10,VA - Roanoke
58,2008-2009,2008-11-18,2009-03-03,106,0,8,118,126,8,3,11,137,5,13,VA - Roanoke
59,2009-2010,2009-12-01,2010-03-02,92,0,11,106,117,62,180,242,359,12,78,VA - Roanoke
60,2010-2011,2010-12-01,2011-03-27,117,0,12,114,126,17,16,33,159,11,33,VA - Roanoke
61,2011-2012,2011-12-01,2012-03-05,96,0,1,59,60,9,4,13,73,3,13,VA - Roanoke
62,2012-2013,2012-12-01,2013-04-04,125,0,4,78,82,28,15,43,125,12,40,VA - Roanoke
63,2013-2014,2013-12-01,2014-03-25,115,0,16,162,178,39,45,84,262,9,63,VA - Roanoke
64,2014-2015,2014-11-18,2015-03-06,109,0,19,152,171,31,67,98,269,9,61,VA - Roanoke
65,2015-2016,2015-12-01,2016-03-03,94,0,9,100,109,33,49,82,191,7,56,VA - Roanoke
66,2016-2017,2016-12-01,2017-03-14,104,0,6,73,79,8,12,20,99,3,18,VA - Roanoke
67,2017-2018,2017-12-01,2018-03-25,115,0,14,132,146,22,7,29,175,10,35,VA - Roanoke
68,2018-2019,2018-12-01,2019-03-08,98,0,2,78,80,31,27,58,138,7,39,VA - Roanoke
69,2019-2020,2019-12-01,2020-02-29,91,0,0,53,53,2,0,2,55,1,3,VA - Roanoke
12,1962-1963,1962-12-01,1963-03-11,101,0,27,226,253,28,119,147,400,10,54,VA - Sterling (Dulles)
13,1963-1964,1963-12-01,1964-04-01,123,0,17,225,242,62,121,183,425,16,100,VA - Sterling (Dulles)
14,1964-1965,1964-11-30,1965-03-20,111,0,18,200,218,24,38,62,280,8,48,VA - Sterling (Dulles)
15,1965-1966,1965-12-01,1966-02-28,90,0,26,179,205,45,86,131,336,12,95,VA - Sterling (Dulles)
16,1966-1967,1966-11-29,1967-03-21,113,0,16,213,229,64,118,182,411,16,118,VA - Sterling (Dulles)
17,1967-1968,1967-11-30,1968-03-14,106,0,23,239,262,41,61,102,364,11,71,VA - Sterling (Dulles)
18,1968-1969,1968-11-10,1969-03-11,122,0,16,224,240,35,21,56,296,11,47,VA - Sterling (Dulles)
19,1969-1970,1969-12-01,1970-03-18,108,0,34,262,296,44,97,141,437,13,86,VA - Sterling (Dulles)
20,1970-1971,1970-12-01,1971-04-07,128,0,15,202,217,30,97,127,344,10,44,VA - Sterling (Dulles)
21,1971-1972,1971-11-24,1972-04-07,136,0,8,191,199,28,30,58,257,7,41,VA - Sterling (Dulles)
22,1972-1973,1972-10-19,1973-04-12,176,0,10,205,215,6,0,6,221,5,13,VA - Sterling (Dulles)
23,1973-1974,1973-12-01,1974-03-11,101,0,9,138,147,29,47,76,223,8,48,VA - Sterling (Dulles)
24,1974-1975,1974-12-01,1975-03-10,100,0,7,169,176,27,27,54,230,9,49,VA - Sterling (Dulles)
25,1975-1976,1975-12-01,1976-03-11,102,0,16,194,210,16,11,27,237,7,30,VA - Sterling (Dulles)
26,1976-1977,1976-11-12,1977-02-28,109,0,35,308,343,18,59,77,420,12,58,VA - Sterling (Dulles)
27,1977-1978,1977-11-27,1978-03-16,110,0,32,259,291,42,76,118,409,21,100,VA - Sterling (Dulles)
28,1978-1979,1978-11-26,1979-03-11,106,0,36,223,259,57,119,176,435,15,113,VA - Sterling (Dulles)
29,1979-1980,1979-10-10,1980-03-15,158,0,16,199,215,38,51,89,304,13,76,VA - Sterling (Dulles)
30,1980-1981,1980-12-01,1981-03-18,108,0,24,225,249,7,6,13,262,5,17,VA - Sterling (Dulles)
31,1981-1982,1981-11-24,1982-04-09,137,0,23,230,253,43,109,152,405,20,93,VA - Sterling (Dulles)
32,1982-1983,1982-12-01,1983-02-28,90,0,6,129,135,50,97,147,282,6,64,VA - Sterling (Dulles)
33,1983-1984,1983-11-25,1984-03-29,126,0,34,256,290,30,72,102,392,10,55,VA - Sterling (Dulles)
34,1984-1985,1984-12-01,1985-04-09,130,0,16,198,214,23,33,56,270,11,54,VA - Sterling (Dulles)
35,1985-1986,1985-12-01,1986-03-08,98,0,20,204,224,26,44,70,294,14,70,VA - Sterling (Dulles)
36,1986-1987,1986-12-01,1987-04-06,127,0,11,215,226,58,120,178,404,12,94,VA - Sterling (Dulles)
37,1987-1988,1987-11-11,1988-03-20,131,0,17,215,232,24,43,67,299,9,48,VA - Sterling (Dulles)
38,1988-1989,1988-12-01,1989-03-20,110,0,14,163,177,17,5,22,199,13,45,VA - Sterling (Dulles)
39,1989-1990,1989-11-22,1990-04-07,137,0,23,222,245,41,90,131,376,15,69,VA - Sterling (Dulles)
40,1990-1991,1990-12-01,1991-03-30,120,0,6,145,151,22,18,40,191,8,36,VA - Sterling (Dulles)
41,1991-1992,1991-12-01,1992-03-22,113,0,4,165,169,10,7,17,186,4,18,VA - Sterling (Dulles)
42,1992-1993,1992-12-01,1993-03-20,110,0,11,167,178,41,38,79,257,12,61,VA - Sterling (Dulles)
43,1993-1994,1993-12-01,1994-03-18,108,0,34,216,250,30,45,75,325,17,80,VA - Sterling (Dulles)
44,1994-1995,1994-12-01,1995-03-10,100,0,10,143,153,21,35,56,209,8,33,VA - Sterling (Dulles)
45,1995-1996,1995-11-23,1996-04-09,139,0,29,233,262,83,146,229,491,19,135,VA - Sterling (Dulles)
46,1996-1997,1996-11-14,1997-03-19,126,0,14,155,169,25,21,46,215,10,43,VA - Sterling (Dulles)
47,1997-1998,1997-12-01,1998-03-11,101,1,1,89,90,10,6,16,106,7,15,VA - Sterling (Dulles)
48,1998-1999,1998-12-01,1999-03-16,106,1,14,146,160,29,29,58,218,9,50,VA - Sterling (Dulles)
49,1999-2000,1999-12-01,2000-04-09,131,0,17,156,173,35,58,93,266,8,56,VA - Sterling (Dulles)
50,2000-2001,2000-12-01,2001-03-05,95,0,15,183,198,18,12,30,228,7,35,VA - Sterling (Dulles)
51,2001-2002,2001-12-01,2002-02-28,90,0,1,112,113,3,1,4,117,1,4,VA - Sterling (Dulles)
52,2002-2003,2002-12-01,2003-03-30,120,0,23,210,233,69,132,201,434,18,115,VA - Sterling (Dulles)
53,2003-2004,2003-12-01,2004-02-29,91,0,23,172,195,26,57,83,278,9,55,VA - Sterling (Dulles)
54,2004-2005,2004-12-01,2005-03-10,100,0,18,142,160,26,24,50,210,10,57,VA - Sterling (Dulles)
55,2005-2006,2005-11-23,2006-02-28,98,0,3,120,123,18,18,36,159,7,27,VA - Sterling (Dulles)
56,2006-2007,2006-12-01,2007-04-07,128,0,13,165,178,21,15,36,214,10,47,VA - Sterling (Dulles)
57,2007-2008,2007-12-01,2008-02-29,91,0,6,112,118,9,12,21,139,2,13,VA - Sterling (Dulles)
58,2008-2009,2008-12-01,2009-03-04,94,0,12,160,172,11,9,20,192,3,18,VA - Sterling (Dulles)
59,2009-2010,2009-12-01,2010-02-28,90,0,15,145,160,99,204,303,463,13,135,VA - Sterling (Dulles)
60,2010-2011,2010-12-01,2011-03-27,117,0,14,168,182,23,37,60,242,12,50,VA - Sterling (Dulles)
61,2011-2012,2011-10-29,2012-02-29,124,0,4,105,109,7,3,10,119,6,14,VA - Sterling (Dulles)
62,2012-2013,2012-12-01,2013-03-25,115,0,8,114,122,20,7,27,149,12,43,VA - Sterling (Dulles)
63,2013-2014,2013-11-24,2014-03-27,124,0,33,246,279,74,91,165,444,20,125,VA - Sterling (Dulles)
64,2014-2015,2014-11-26,2015-03-20,115,0,27,223,250,54,82,136,386,17,115,VA - Sterling (Dulles)
65,2015-2016,2015-12-01,2016-03-04,95,0,14,129,143,47,95,142,285,11,79,VA - Sterling (Dulles)
66,2016-2017,2016-12-01,2017-03-17,107,0,8,118,126,13,9,22,148,7,31,VA - Sterling (Dulles)
67,2017-2018,2017-12-01,2018-03-23,113,0,24,174,198,20,10,30,228,9,41,VA - Sterling (Dulles)
68,2018-2019,2018-11-15,2019-03-09,115,0,10,144,154,36,44,80,234,12,63,VA - Sterling (Dulles)
69,2019-2020,2019-12-01,2020-02-29,91,0,0,89,89,6,2,8,97,4,11,VA - Sterling (Dulles)
0,1950-1951,1950-12-01,1951-03-13,103,0,11,85,96,56,58,114,210,11,84,WA - Bellingham
1,1951-1952,1951-12-01,1952-02-29,91,0,16,93,109,24,20,44,153,12,63,WA - Bellingham
2,1952-1953,1952-12-01,1953-02-28,90,0,0,38,38,3,2,5,43,1,5,WA - Bellingham
3,1953-1954,1953-12-01,1954-02-28,90,0,15,71,86,22,40,62,148,7,45,WA - Bellingham
4,1954-1955,1954-12-01,1955-03-06,96,0,2,69,71,2,1,3,74,1,6,WA - Bellingham
5,1955-1956,1955-11-14,1956-03-12,120,2,14,125,139,30,19,49,188,11,53,WA - Bellingham
6,1956-1957,1956-12-01,1957-02-28,90,0,23,119,142,29,25,54,196,10,51,WA - Bellingham
7,1957-1958,1957-12-01,1958-02-28,90,0,0,28,28,0,0,0,28,0,0,WA - Bellingham
8,1958-1959,1958-12-01,1959-02-28,90,0,10,48,58,14,15,29,87,5,24,WA - Bellingham
9,1959-1960,1959-11-15,1960-03-05,112,0,3,72,75,10,7,17,92,3,15,WA - Bellingham
10,1960-1961,1960-12-01,1961-02-28,90,0,0,44,44,0,0,0,44,0,0,WA - Bellingham
11,1961-1962,1961-12-01,1962-03-05,95,0,7,68,75,21,18,39,114,7,29,WA - Bellingham
12,1962-1963,1962-12-01,1963-02-28,90,0,8,69,77,3,2,5,82,1,5,WA - Bellingham
13,1963-1964,1963-11-19,1964-03-23,126,0,0,48,48,2,0,2,50,2,3,WA - Bellingham
14,1964-1965,1964-11-27,1965-02-28,94,0,13,89,102,57,68,125,227,21,96,WA - Bellingham
15,1965-1966,1965-12-01,1966-03-01,91,0,4,74,78,36,20,56,134,13,54,WA - Bellingham
16,1966-1967,1966-12-01,1967-03-12,102,0,0,43,43,20,2,22,65,8,27,WA - Bellingham
17,1967-1968,1967-12-01,1968-04-12,134,0,5,60,65,10,4,14,79,6,15,WA - Bellingham
18,1968-1969,1968-12-01,1969-02-28,90,0,39,110,149,53,104,157,306,17,105,WA - Bellingham
19,1969-1970,1969-12-01,1970-02-28,90,0,1,47,48,11,12,23,71,4,16,WA - Bellingham
20,1970-1971,1970-11-20,1971-03-04,105,0,12,91,103,67,56,123,226,20,111,WA - Bellingham
21,1971-1972,1971-10-30,1972-04-11,165,0,19,107,126,36,27,63,189,14,55,WA - Bellingham
22,1972-1973,1972-12-01,1973-02-28,90,0,18,83,101,7,13,20,121,2,13,WA - Bellingham
23,1973-1974,1973-11-04,1974-03-08,125,0,2,42,44,18,4,22,66,9,26,WA - Bellingham
24,1974-1975,1974-12-01,1975-02-28,90,0,1,50,51,18,7,25,76,9,32,WA - Bellingham
25,1975-1976,1975-11-29,1976-04-15,139,0,3,66,69,19,3,22,91,6,28,WA - Bellingham
26,1976-1977,1976-12-01,1977-03-14,104,0,0,44,44,6,6,12,56,2,7,WA - Bellingham
27,1977-1978,1977-11-22,1978-02-28,99,0,6,51,57,16,12,28,85,7,25,WA - Bellingham
28,1978-1979,1978-11-19,1979-02-28,102,0,17,112,129,11,12,23,152,5,19,WA - Bellingham
29,1979-1980,1979-12-01,1980-03-14,105,0,9,67,76,14,12,26,102,6,31,WA - Bellingham
30,1980-1981,1980-12-01,1981-04-12,133,0,9,59,68,25,32,57,125,6,42,WA - Bellingham
31,1981-1982,1981-12-01,1982-03-31,121,0,9,68,77,49,46,95,172,14,79,WA - Bellingham
32,1982-1983,1982-12-01,1983-02-28,90,0,0,37,37,0,0,0,37,0,0,WA - Bellingham
33,1983-1984,1983-12-01,1984-02-29,91,0,17,78,95,2,0,2,97,1,3,WA - Bellingham
34,1984-1985,1984-10-31,1985-02-28,121,0,14,106,120,33,50,83,203,9,52,WA - Bellingham
35,1985-1986,1985-11-19,1986-02-28,102,0,23,99,122,32,58,90,212,10,64,WA - Bellingham
36,1986-1987,1986-12-01,1987-02-28,90,0,0,41,41,4,0,4,45,2,5,WA - Bellingham
37,1987-1988,1987-12-01,1988-02-29,91,0,0,63,63,1,0,1,64,1,4,WA - Bellingham
38,1988-1989,1988-11-24,1989-03-03,100,2,10,77,87,18,8,26,113,9,32,WA - Bellingham
39,1989-1990,1989-12-01,1990-03-23,113,0,3,48,51,6,4,10,61,5,11,WA - Bellingham
40,1990-1991,1990-12-01,1991-03-11,101,0,23,89,112,44,34,78,190,14,80,WA - Bellingham
41,1991-1992,1991-10-28,1992-02-29,125,0,0,31,31,3,2,5,36,1,4,WA - Bellingham
42,1992-1993,1992-12-01,1993-02-28,90,0,16,99,115,25,22,47,162,9,40,WA - Bellingham
43,1993-1994,1993-11-22,1994-02-28,99,0,4,58,62,2,0,2,64,2,3,WA - Bellingham
44,1994-1995,1994-12-01,1995-03-06,96,0,2,49,51,4,2,6,57,2,6,WA - Bellingham
45,1995-1996,1995-12-01,1996-02-29,91,0,8,71,79,16,30,46,125,7,30,WA - Bellingham
63,2013-2014,2013-12-01,2014-02-28,90,8,6,65,71,0,0,0,71,0,0,WA - Bellingham
64,2014-2015,2014-11-29,2015-02-28,92,3,1,38,39,0,0,0,39,0,0,WA - Bellingham
65,2015-2016,2015-12-01,2016-02-29,91,2,0,30,30,0,0,0,30,0,0,WA - Bellingham
69,2019-2020,2019-12-01,2020-02-29,91,17,5,34,39,0,0,0,39,0,0,WA - Bellingham
0,1950-1951,1950-12-01,1951-03-20,110,13,18,127,145,47,356,403,548,12,73,WA - Diablo Dam
1,1951-1952,1951-12-01,1952-02-29,91,13,31,145,176,139,543,682,858,29,206,WA - Diablo Dam
4,1954-1955,1954-12-01,1955-03-28,118,9,8,117,125,94,179,273,398,21,124,WA - Diablo Dam
8,1958-1959,1958-11-26,1959-03-13,108,20,21,82,103,37,109,146,249,7,50,WA - Diablo Dam
9,1959-1960,1959-11-13,1960-04-21,161,3,12,128,140,75,135,210,350,14,97,WA - Diablo Dam
11,1961-1962,1961-11-19,1962-03-25,127,11,20,125,145,76,182,258,403,18,100,WA - Diablo Dam
19,1969-1970,1969-12-01,1970-02-28,90,3,3,51,54,58,97,155,209,8,66,WA - Diablo Dam
21,1971-1972,1971-12-01,1972-03-08,99,7,31,148,179,101,641,742,921,22,142,WA - Diablo Dam
23,1973-1974,1973-11-07,1974-03-08,122,0,14,86,100,61,61,122,222,14,75,WA - Diablo Dam
24,1974-1975,1974-12-01,1975-03-17,107,12,8,102,110,90,408,498,608,21,129,WA - Diablo Dam
26,1976-1977,1976-12-01,1977-03-14,104,0,4,75,79,18,33,51,130,4,22,WA - Diablo Dam
27,1977-1978,1977-11-19,1978-02-28,102,16,17,96,113,95,330,425,538,12,115,WA - Diablo Dam
28,1978-1979,1978-11-16,1979-02-28,105,6,36,172,208,68,161,229,437,19,96,WA - Diablo Dam
29,1979-1980,1979-12-01,1980-03-17,108,3,19,104,123,51,238,289,412,14,76,WA - Diablo Dam
30,1980-1981,1980-12-01,1981-02-28,90,1,10,59,69,34,49,83,152,6,52,WA - Diablo Dam
31,1981-1982,1981-12-01,1982-02-28,90,0,14,86,100,135,219,354,454,24,178,WA - Diablo Dam
32,1982-1983,1982-11-16,1983-03-01,106,1,3,61,64,18,19,37,101,8,26,WA - Diablo Dam
33,1983-1984,1983-12-01,1984-02-29,91,2,24,112,136,30,62,92,228,8,44,WA - Diablo Dam
35,1985-1986,1985-11-12,1986-03-04,113,7,36,127,163,52,258,310,473,16,84,WA - Diablo Dam
36,1986-1987,1986-12-01,1987-03-03,93,4,3,59,62,16,14,30,92,6,23,WA - Diablo Dam
37,1987-1988,1987-12-01,1988-03-27,118,7,12,94,106,39,174,213,319,9,49,WA - Diablo Dam
38,1988-1989,1988-11-24,1989-03-07,104,6,27,136,163,58,85,143,306,13,91,WA - Diablo Dam
39,1989-1990,1989-12-01,1990-03-09,99,1,7,85,92,90,201,291,383,12,111,WA - Diablo Dam
40,1990-1991,1990-12-01,1991-03-11,101,3,35,125,160,120,191,311,471,18,169,WA - Diablo Dam
41,1991-1992,1991-12-01,1992-02-29,91,6,1,35,36,0,0,0,36,0,0,WA - Diablo Dam
42,1992-1993,1992-12-01,1993-02-28,90,6,43,159,202,61,238,299,501,8,88,WA - Diablo Dam
43,1993-1994,1993-11-23,1994-03-19,117,1,9,68,77,40,44,84,161,7,51,WA - Diablo Dam
44,1994-1995,1994-11-04,1995-03-07,124,1,15,105,120,96,137,233,353,17,118,WA - Diablo Dam
45,1995-1996,1995-12-01,1996-03-29,120,10,23,120,143,81,163,244,387,16,112,WA - Diablo Dam
46,1996-1997,1996-11-04,1997-02-28,117,6,34,124,158,147,531,678,836,22,215,WA - Diablo Dam
47,1997-1998,1997-12-01,1998-02-28,90,6,12,66,78,37,74,111,189,5,50,WA - Diablo Dam
48,1998-1999,1998-12-01,1999-02-28,90,9,10,70,80,40,89,129,209,10,53,WA - Diablo Dam
49,1999-2000,1999-12-01,2000-02-29,91,4,1,64,65,61,163,224,289,17,80,WA - Diablo Dam
50,2000-2001,2000-11-27,2001-03-28,122,19,5,86,91,46,45,91,182,10,62,WA - Diablo Dam
51,2001-2002,2001-11-30,2002-03-25,116,8,7,107,114,117,164,281,395,26,154,WA - Diablo Dam
52,2002-2003,2002-12-01,2003-03-10,100,1,1,63,64,25,26,51,115,4,29,WA - Diablo Dam
53,2003-2004,2003-11-23,2004-02-29,99,0,18,89,107,66,173,239,346,10,88,WA - Diablo Dam
54,2004-2005,2004-12-01,2005-03-30,120,0,12,83,95,23,26,49,144,9,40,WA - Diablo Dam
55,2005-2006,2005-11-29,2006-03-11,103,0,1,69,70,27,32,59,129,10,38,WA - Diablo Dam
56,2006-2007,2006-11-24,2007-03-01,98,1,15,96,111,61,117,178,289,19,87,WA - Diablo Dam
57,2007-2008,2007-11-27,2008-03-31,126,4,7,108,115,262,577,839,954,45,313,WA - Diablo Dam
58,2008-2009,2008-12-01,2009-04-03,124,3,30,162,192,200,520,720,912,36,275,WA - Diablo Dam
59,2009-2010,2009-11-15,2010-03-12,118,1,13,81,94,23,29,52,146,8,35,WA - Diablo Dam
60,2010-2011,2010-11-21,2011-04-15,146,10,24,135,159,88,168,256,415,24,129,WA - Diablo Dam
61,2011-2012,2011-11-18,2012-03-21,125,14,13,109,122,68,134,202,324,20,112,WA - Diablo Dam
62,2012-2013,2012-12-01,2013-03-21,111,0,4,84,88,43,162,205,293,14,57,WA - Diablo Dam
63,2013-2014,2013-12-01,2014-03-10,100,1,22,95,117,74,105,179,296,13,96,WA - Diablo Dam
64,2014-2015,2014-11-29,2015-02-28,92,4,9,54,63,9,22,31,94,3,14,WA - Diablo Dam
65,2015-2016,2015-11-17,2016-02-29,105,0,5,60,65,23,143,166,231,12,37,WA - Diablo Dam
66,2016-2017,2016-12-01,2017-03-12,102,0,42,164,206,160,728,888,1094,29,214,WA - Diablo Dam
67,2017-2018,2017-12-01,2018-04-02,123,0,12,99,111,61,168,229,340,18,86,WA - Diablo Dam
68,2018-2019,2018-12-01,2019-03-12,102,1,15,126,141,43,151,194,335,15,70,WA - Diablo Dam
69,2019-2020,2019-11-30,2020-03-31,123,2,13,91,104,87,203,290,394,18,129,WA - Diablo Dam
0,1950-1951,1950-11-11,1951-03-26,136,0,31,276,307,116,666,782,1089,35,177,WA - Northport
1,1951-1952,1951-12-01,1952-03-23,114,1,66,300,366,90,823,913,1279,26,180,WA - Northport
2,1952-1953,1952-11-26,1953-02-28,95,0,9,132,141,53,102,155,296,22,79,WA - Northport
3,1953-1954,1953-11-19,1954-03-02,104,1,37,152,189,100,429,529,718,21,171,WA - Northport
4,1954-1955,1954-11-29,1955-04-12,135,8,30,249,279,60,443,503,782,29,104,WA - Northport
5,1955-1956,1955-11-02,1956-03-27,147,2,79,322,401,122,976,1098,1499,48,254,WA - Northport
14,1964-1965,1964-11-25,1965-03-29,125,0,51,263,314,130,623,753,1067,36,222,WA - Northport
15,1965-1966,1965-11-24,1966-03-19,116,0,30,182,212,104,398,502,714,35,177,WA - Northport
16,1966-1967,1966-11-09,1967-03-12,124,3,8,147,155,75,220,295,450,26,111,WA - Northport
17,1967-1968,1967-11-28,1968-03-14,108,0,42,194,236,77,309,386,622,18,120,WA - Northport
18,1968-1969,1968-11-08,1969-03-18,131,1,84,322,406,167,856,1023,1429,43,300,WA - Northport
19,1969-1970,1969-11-19,1970-04-26,159,0,29,207,236,73,265,338,574,24,112,WA - Northport
20,1970-1971,1970-11-22,1971-03-26,125,0,52,253,305,133,595,728,1033,36,218,WA - Northport
21,1971-1972,1971-10-31,1972-03-07,129,0,67,277,344,120,678,798,1142,33,210,WA - Northport
22,1972-1973,1972-10-28,1973-02-28,124,0,68,236,304,52,212,264,568,18,98,WA - Northport
23,1973-1974,1973-11-04,1974-03-15,132,1,45,195,240,121,210,331,571,35,183,WA - Northport
24,1974-1975,1974-11-10,1975-04-06,148,0,34,255,289,150,722,872,1161,40,220,WA - Northport
25,1975-1976,1975-11-21,1976-03-26,127,2,34,216,250,107,474,581,831,31,162,WA - Northport
26,1976-1977,1976-11-15,1977-03-13,119,13,43,204,247,50,264,314,561,15,71,WA - Northport
27,1977-1978,1977-11-01,1978-03-13,133,1,54,245,299,118,780,898,1197,29,195,WA - Northport
28,1978-1979,1978-11-16,1979-03-11,116,0,116,355,471,96,711,807,1278,35,184,WA - Northport
29,1979-1980,1979-11-16,1980-03-07,113,5,43,211,254,65,357,422,676,18,103,WA - Northport
30,1980-1981,1980-11-25,1981-02-28,96,6,13,122,135,32,396,428,563,5,39,WA - Northport
32,1982-1983,1982-11-23,1983-02-28,98,0,15,202,217,68,548,616,833,16,115,WA - Northport
33,1983-1984,1983-12-01,1984-03-09,100,19,49,279,328,44,515,559,887,12,77,WA - Northport
34,1984-1985,1984-11-01,1985-03-30,150,14,104,321,425,107,828,935,1360,25,172,WA - Northport
35,1985-1986,1985-11-01,1986-03-11,131,2,87,303,390,79,645,724,1114,26,157,WA - Northport
36,1986-1987,1986-11-09,1987-02-28,112,3,35,172,207,40,57,97,304,15,55,WA - Northport
37,1987-1988,1987-11-30,1988-03-05,97,1,57,212,269,47,437,484,753,18,94,WA - Northport
38,1988-1989,1988-11-23,1989-03-14,112,8,56,254,310,71,470,541,851,26,139,WA - Northport
39,1989-1990,1989-11-23,1990-03-07,105,0,24,160,184,48,243,291,475,20,95,WA - Northport
40,1990-1991,1990-11-03,1991-03-12,130,2,98,273,371,82,418,500,871,22,178,WA - Northport
41,1991-1992,1991-11-04,1992-02-29,118,4,14,98,112,41,88,129,241,16,61,WA - Northport
42,1992-1993,1992-11-24,1993-03-14,111,2,79,296,375,69,626,695,1070,23,143,WA - Northport
43,1993-1994,1993-11-23,1994-03-01,99,5,37,156,193,55,293,348,541,18,89,WA - Northport
44,1994-1995,1994-11-04,1995-03-08,125,3,41,216,257,57,133,190,447,21,102,WA - Northport
45,1995-1996,1995-11-06,1996-03-04,120,5,60,262,322,75,398,473,795,26,151,WA - Northport
46,1996-1997,1996-11-16,1997-03-24,129,5,55,269,324,140,985,1125,1449,47,250,WA - Northport
47,1997-1998,1997-12-01,1998-02-28,90,3,22,123,145,41,223,264,409,14,72,WA - Northport
48,1998-1999,1998-12-01,1999-02-28,90,5,23,142,165,49,305,354,519,18,89,WA - Northport
49,1999-2000,1999-11-28,2000-02-29,94,0,19,146,165,61,353,414,579,22,106,WA - Northport
50,2000-2001,2000-11-15,2001-03-31,137,0,42,272,314,62,437,499,813,24,129,WA - Northport
51,2001-2002,2001-11-28,2002-03-19,112,7,29,206,235,77,444,521,756,28,130,WA - Northport
52,2002-2003,2002-12-01,2003-03-26,116,2,11,140,151,68,272,340,491,16,91,WA - Northport
53,2003-2004,2003-11-22,2004-03-05,105,2,45,191,236,96,473,569,805,28,177,WA - Northport
54,2004-2005,2004-11-01,2005-03-26,146,2,32,238,270,58,286,344,614,20,106,WA - Northport
55,2005-2006,2005-11-15,2006-03-08,114,8,37,200,237,31,99,130,367,10,47,WA - Northport
56,2006-2007,2006-11-03,2007-04-02,151,5,52,263,315,77,452,529,844,27,132,WA - Northport
58,2008-2009,2008-11-29,2009-04-02,125,8,32,170,202,94,628,722,924,32,181,WA - Northport
61,2011-2012,2011-11-08,2012-03-22,136,8,50,261,311,70,280,350,661,33,148,WA - Northport
62,2012-2013,2012-11-12,2013-03-07,116,2,41,161,202,53,321,374,576,27,114,WA - Northport
63,2013-2014,2013-11-22,2014-03-07,106,4,70,278,348,46,299,345,693,23,115,WA - Northport
64,2014-2015,2014-11-17,2015-02-28,104,0,38,158,196,38,179,217,413,14,72,WA - Northport
65,2015-2016,2015-11-17,2016-02-29,105,6,24,143,167,33,170,203,370,17,75,WA - Northport
66,2016-2017,2016-12-01,2017-03-14,104,0,82,326,408,67,526,593,1001,18,148,WA - Northport
67,2017-2018,2017-11-03,2018-03-05,123,0,51,231,282,66,325,391,673,25,130,WA - Northport
69,2019-2020,2019-12-01,2020-04-04,126,0,38,224,262,81,332,413,675,32,186,WA - Northport
0,1950-1951,1950-11-30,1951-03-13,104,0,2,62,64,36,34,70,134,15,51,WA - Olympia
1,1951-1952,1951-12-01,1952-02-29,91,0,2,70,72,32,29,61,133,12,48,WA - Olympia
2,1952-1953,1952-12-01,1953-03-17,107,0,1,47,48,3,1,4,52,2,5,WA - Olympia
3,1953-1954,1953-12-01,1954-04-09,130,0,1,84,85,35,47,82,167,15,60,WA - Olympia
4,1954-1955,1954-12-01,1955-04-23,144,0,0,89,89,26,9,35,124,13,39,WA - Olympia
5,1955-1956,1955-11-11,1956-03-09,120,0,9,119,128,64,33,97,225,28,115,WA - Olympia
6,1956-1957,1956-12-01,1957-02-28,90,0,5,84,89,29,55,84,173,15,55,WA - Olympia
7,1957-1958,1957-12-01,1958-03-08,98,0,0,20,20,2,0,2,22,2,2,WA - Olympia
8,1958-1959,1958-11-14,1959-03-13,120,0,3,62,65,33,21,54,119,12,52,WA - Olympia
9,1959-1960,1959-12-01,1960-03-09,100,0,0,84,84,25,17,42,126,10,33,WA - Olympia
10,1960-1961,1960-11-20,1961-03-05,106,0,0,59,59,16,9,25,84,5,17,WA - Olympia
11,1961-1962,1961-12-01,1962-03-05,95,0,3,93,96,23,22,45,141,10,35,WA - Olympia
12,1962-1963,1962-12-01,1963-02-28,90,0,5,73,78,3,3,6,84,1,5,WA - Olympia
13,1963-1964,1963-11-19,1964-03-12,115,0,0,60,60,7,0,7,67,5,10,WA - Olympia
14,1964-1965,1964-11-26,1965-03-25,120,0,5,93,98,47,24,71,169,25,72,WA - Olympia
15,1965-1966,1965-12-01,1966-04-12,133,0,1,60,61,60,26,86,147,20,72,WA - Olympia
16,1966-1967,1966-12-01,1967-03-09,99,0,0,41,41,10,2,12,53,6,14,WA - Olympia
17,1967-1968,1967-12-01,1968-02-29,91,0,2,72,74,34,22,56,130,14,47,WA - Olympia
18,1968-1969,1968-12-01,1969-02-28,90,0,18,110,128,109,171,280,408,33,188,WA - Olympia
19,1969-1970,1969-12-01,1970-04-07,128,0,1,83,84,5,2,7,91,2,7,WA - Olympia
20,1970-1971,1970-11-22,1971-04-11,141,0,4,98,102,51,26,77,179,19,71,WA - Olympia
21,1971-1972,1971-12-01,1972-04-12,134,0,8,121,129,77,99,176,305,27,103,WA - Olympia
22,1972-1973,1972-12-01,1973-02-28,90,0,13,108,121,14,16,30,151,10,42,WA - Olympia
23,1973-1974,1973-11-03,1974-02-28,118,0,1,77,78,14,2,16,94,9,21,WA - Olympia
24,1974-1975,1974-12-01,1975-03-19,109,0,0,69,69,31,33,64,133,11,44,WA - Olympia
25,1975-1976,1975-11-17,1976-02-29,105,0,1,78,79,22,7,29,108,10,35,WA - Olympia
26,1976-1977,1976-12-01,1977-03-27,117,0,2,77,79,5,2,7,86,4,8,WA - Olympia
27,1977-1978,1977-11-18,1978-02-28,103,0,1,72,73,10,4,14,87,7,21,WA - Olympia
28,1978-1979,1978-11-18,1979-02-28,103,0,8,151,159,30,45,75,234,11,54,WA - Olympia
29,1979-1980,1979-12-01,1980-03-15,106,0,4,103,107,48,41,89,196,12,67,WA - Olympia
30,1980-1981,1980-12-01,1981-04-11,132,0,0,55,55,7,2,9,64,5,13,WA - Olympia
31,1981-1982,1981-12-01,1982-03-31,121,0,2,86,88,33,14,47,135,15,53,WA - Olympia
32,1982-1983,1982-12-01,1983-02-28,90,0,0,40,40,0,0,0,40,0,0,WA - Olympia
33,1983-1984,1983-12-01,1984-02-29,91,0,6,85,91,8,5,13,104,6,24,WA - Olympia
34,1984-1985,1984-12-01,1985-02-28,90,0,2,92,94,26,9,35,129,12,42,WA - Olympia
35,1985-1986,1985-11-17,1986-02-28,104,0,9,111,120,35,66,101,221,9,57,WA - Olympia
36,1986-1987,1986-12-01,1987-02-28,90,0,0,46,46,0,0,0,46,0,0,WA - Olympia
37,1987-1988,1987-12-01,1988-04-30,152,0,0,92,92,5,0,5,97,4,9,WA - Olympia
38,1988-1989,1988-12-01,1989-03-05,95,0,8,107,115,40,57,97,212,11,62,WA - Olympia
39,1989-1990,1989-12-01,1990-03-08,98,0,0,51,51,43,35,78,129,13,58,WA - Olympia
40,1990-1991,1990-12-01,1991-02-28,90,0,12,106,118,9,7,16,134,5,22,WA - Olympia
41,1991-1992,1991-12-01,1992-02-29,91,0,0,36,36,0,0,0,36,0,0,WA - Olympia
42,1992-1993,1992-12-01,1993-02-28,90,0,0,109,109,21,16,37,146,9,28,WA - Olympia
43,1993-1994,1993-11-22,1994-02-28,99,0,0,59,59,5,0,5,64,5,8,WA - Olympia
44,1994-1995,1994-11-17,1995-02-28,104,5,0,86,86,14,12,26,112,7,27,WA - Olympia
45,1995-1996,1995-12-01,1996-02-29,91,8,2,69,71,4,0,4,75,1,5,WA - Olympia
54,2004-2005,2004-12-01,2005-02-28,90,6,0,65,65,0,0,0,65,0,0,WA - Olympia
59,2009-2010,2009-12-01,2010-02-28,90,0,3,75,78,0,0,0,78,0,0,WA - Olympia
60,2010-2011,2010-11-23,2011-02-28,98,7,4,84,88,0,0,0,88,0,0,WA - Olympia
61,2011-2012,2011-11-18,2012-03-13,117,0,2,87,89,25,25,50,139,7,38,WA - Olympia
62,2012-2013,2012-12-01,2013-02-28,90,0,0,50,50,1,0,1,51,1,2,WA - Olympia
63,2013-2014,2013-12-01,2014-02-28,90,0,7,73,80,6,4,10,90,2,8,WA - Olympia
64,2014-2015,2014-12-01,2015-02-28,90,0,0,44,44,0,0,0,44,0,0,WA - Olympia
65,2015-2016,2015-12-01,2016-02-29,91,0,1,37,38,0,0,0,38,0,0,WA - Olympia
66,2016-2017,2016-12-01,2017-02-28,90,2,1,84,85,0,0,0,85,0,0,WA - Olympia
67,2017-2018,2017-12-01,2018-02-28,90,11,2,58,60,0,0,0,60,0,0,WA - Olympia
68,2018-2019,2018-12-01,2019-02-28,90,0,2,80,82,0,0,0,82,0,0,WA - Olympia
69,2019-2020,2019-12-01,2020-02-29,91,2,0,37,37,0,0,0,37,0,0,WA - Olympia
0,1950-1951,1950-11-30,1951-03-11,102,1,3,55,58,41,21,62,120,20,62,WA - Seattle
1,1951-1952,1951-12-01,1952-02-29,91,0,3,55,58,16,16,32,90,9,29,WA - Seattle
2,1952-1953,1952-12-01,1953-02-28,90,0,0,18,18,0,0,0,18,0,0,WA - Seattle
3,1953-1954,1953-12-01,1954-03-11,101,0,4,43,47,32,50,82,129,13,53,WA - Seattle
4,1954-1955,1954-12-01,1955-03-25,115,0,1,55,56,20,6,26,82,9,26,WA - Seattle
5,1955-1956,1955-11-11,1956-03-10,121,0,13,89,102,35,17,52,154,13,57,WA - Seattle
6,1956-1957,1956-12-01,1957-02-28,90,0,6,69,75,26,49,75,150,13,43,WA - Seattle
7,1957-1958,1957-12-01,1958-02-28,90,0,0,5,5,0,0,0,5,0,0,WA - Seattle
8,1958-1959,1958-11-24,1959-02-28,97,0,2,26,28,15,9,24,52,5,23,WA - Seattle
9,1959-1960,1959-12-01,1960-03-04,95,0,0,35,35,11,4,15,50,5,17,WA - Seattle
10,1960-1961,1960-11-20,1961-03-04,105,0,0,29,29,10,5,15,44,3,14,WA - Seattle
11,1961-1962,1961-12-01,1962-03-09,99,0,3,48,51,18,12,30,81,8,24,WA - Seattle
12,1962-1963,1962-12-01,1963-02-28,90,0,6,47,53,7,1,8,61,5,14,WA - Seattle
13,1963-1964,1963-11-19,1964-02-29,103,0,0,33,33,3,0,3,36,2,5,WA - Seattle
14,1964-1965,1964-11-13,1965-02-28,108,0,5,38,43,29,14,43,86,17,45,WA - Seattle
15,1965-1966,1965-12-01,1966-03-20,110,0,0,27,27,33,17,50,77,12,38,WA - Seattle
16,1966-1967,1966-12-01,1967-02-28,90,0,0,9,9,10,5,15,24,2,12,WA - Seattle
17,1967-1968,1967-12-01,1968-04-16,138,0,0,22,22,19,5,24,46,11,26,WA - Seattle
18,1968-1969,1968-12-01,1969-02-28,90,0,19,60,79,91,122,213,292,23,140,WA - Seattle
19,1969-1970,1969-12-01,1970-02-28,90,0,0,5,5,0,0,0,5,0,0,WA - Seattle
20,1970-1971,1970-12-01,1971-03-16,106,0,1,34,35,24,20,44,79,13,33,WA - Seattle
21,1971-1972,1971-10-27,1972-04-17,174,1,6,52,58,47,55,102,160,22,59,WA - Seattle
22,1972-1973,1972-12-01,1973-03-18,108,0,12,48,60,14,19,33,93,8,28,WA - Seattle
23,1973-1974,1973-11-03,1974-02-28,118,0,1,26,27,7,0,7,34,4,8,WA - Seattle
24,1974-1975,1974-12-01,1975-04-02,123,0,1,37,38,19,15,34,72,7,26,WA - Seattle
25,1975-1976,1975-11-06,1976-03-01,117,0,0,30,30,10,2,12,42,8,16,WA - Seattle
26,1976-1977,1976-12-01,1977-03-14,104,0,0,19,19,4,1,5,24,3,4,WA - Seattle
27,1977-1978,1977-11-17,1978-02-28,104,0,0,17,17,5,1,6,23,3,7,WA - Seattle
28,1978-1979,1978-11-18,1979-02-28,103,0,6,50,56,11,12,23,79,7,14,WA - Seattle
29,1979-1980,1979-12-01,1980-03-14,105,0,5,46,51,20,24,44,95,9,31,WA - Seattle
30,1980-1981,1980-12-01,1981-02-28,90,0,0,19,19,3,0,3,22,2,6,WA - Seattle
31,1981-1982,1981-12-01,1982-03-29,119,0,2,29,31,13,8,21,52,5,20,WA - Seattle
32,1982-1983,1982-12-01,1983-02-28,90,0,0,12,12,0,0,0,12,0,0,WA - Seattle
33,1983-1984,1983-12-01,1984-02-29,91,0,7,37,44,1,0,1,45,1,3,WA - Seattle
34,1984-1985,1984-12-01,1985-02-28,90,0,3,49,52,10,2,12,64,4,14,WA - Seattle
35,1985-1986,1985-11-20,1986-02-28,101,0,10,60,70,27,45,72,142,6,39,WA - Seattle
36,1986-1987,1986-12-01,1987-02-28,90,0,0,20,20,2,0,2,22,1,2,WA - Seattle
37,1987-1988,1987-12-01,1988-02-29,91,0,0,27,27,0,0,0,27,0,0,WA - Seattle
38,1988-1989,1988-12-01,1989-03-05,95,0,7,57,64,20,37,57,121,4,28,WA - Seattle
39,1989-1990,1989-12-01,1990-02-28,90,0,1,23,24,13,12,25,49,2,17,WA - Seattle
40,1990-1991,1990-12-01,1991-03-05,95,0,11,49,60,11,15,26,86,8,22,WA - Seattle
41,1991-1992,1991-12-01,1992-02-29,91,0,0,10,10,0,0,0,10,0,0,WA - Seattle
42,1992-1993,1992-12-01,1993-02-28,90,0,1,52,53,17,5,22,75,12,28,WA - Seattle
43,1993-1994,1993-12-01,1994-03-21,111,0,0,29,29,4,1,5,34,4,7,WA - Seattle
44,1994-1995,1994-12-01,1995-02-28,90,0,0,19,19,5,1,6,25,4,10,WA - Seattle
45,1995-1996,1995-12-01,1996-02-29,91,0,2,37,39,18,7,25,64,11,29,WA - Seattle
54,2004-2005,2004-12-01,2005-02-28,90,4,0,28,28,0,0,0,28,0,0,WA - Seattle
58,2008-2009,2008-12-01,2009-03-15,105,0,6,53,59,36,45,81,140,19,59,WA - Seattle
59,2009-2010,2009-12-01,2010-02-28,90,0,3,24,27,0,0,0,27,0,0,WA - Seattle
60,2010-2011,2010-11-22,2011-02-28,99,0,4,36,40,10,6,16,56,4,15,WA - Seattle
61,2011-2012,2011-12-01,2012-03-13,104,0,2,29,31,15,13,28,59,5,21,WA - Seattle
62,2012-2013,2012-12-01,2013-02-28,90,0,0,20,20,1,1,2,22,1,1,WA - Seattle
63,2013-2014,2013-12-01,2014-02-28,90,0,3,29,32,5,3,8,40,2,6,WA - Seattle
64,2014-2015,2014-11-29,2015-02-28,92,0,0,12,12,1,0,1,13,1,3,WA - Seattle
65,2015-2016,2015-12-01,2016-02-29,91,0,0,7,7,0,0,0,7,0,0,WA - Seattle
66,2016-2017,2016-12-01,2017-02-28,90,0,0,37,37,17,18,35,72,6,21,WA - Seattle
67,2017-2018,2017-11-05,2018-02-28,116,0,0,21,21,7,6,13,34,4,10,WA - Seattle
68,2018-2019,2018-12-01,2019-03-07,97,0,1,25,26,29,32,61,87,7,37,WA - Seattle
69,2019-2020,2019-12-01,2020-02-29,91,0,0,10,10,2,0,2,12,2,4,WA - Seattle
0,1950-1951,1950-11-01,1951-03-22,142,0,37,213,250,107,165,272,522,54,213,WA - Spokane
1,1951-1952,1951-10-22,1952-03-19,150,0,83,305,388,120,582,702,1090,58,308,WA - Spokane
2,1952-1953,1952-11-23,1953-03-20,118,0,26,126,152,65,131,196,348,34,109,WA - Spokane
3,1953-1954,1953-11-20,1954-03-28,129,0,35,179,214,83,210,293,507,26,156,WA - Spokane
4,1954-1955,1954-11-28,1955-04-14,138,0,46,265,311,67,202,269,580,39,162,WA - Spokane
5,1955-1956,1955-11-02,1956-03-31,151,0,104,341,445,117,311,428,873,53,300,WA - Spokane
6,1956-1957,1956-10-27,1957-04-24,180,0,116,328,444,80,253,333,777,48,284,WA - Spokane
7,1957-1958,1957-10-22,1958-03-18,148,0,12,132,144,42,16,58,202,23,70,WA - Spokane
8,1958-1959,1958-11-13,1959-03-30,138,0,44,193,237,97,173,270,507,40,197,WA - Spokane
9,1959-1960,1959-11-03,1960-04-15,165,0,83,319,402,61,142,203,605,37,175,WA - Spokane
10,1960-1961,1960-11-10,1961-04-19,161,0,38,184,222,52,49,101,323,26,92,WA - Spokane
11,1961-1962,1961-11-02,1962-03-24,143,0,92,320,412,98,163,261,673,41,228,WA - Spokane
12,1962-1963,1962-11-15,1963-04-17,154,0,62,223,285,34,17,51,336,20,93,WA - Spokane
13,1963-1964,1963-11-20,1964-04-23,156,0,35,246,281,95,260,355,636,43,171,WA - Spokane
14,1964-1965,1964-11-12,1965-04-06,146,0,70,289,359,121,346,467,826,43,260,WA - Spokane
15,1965-1966,1965-11-23,1966-03-23,121,0,36,183,219,70,116,186,405,37,143,WA - Spokane
16,1966-1967,1966-11-09,1967-05-11,184,0,8,161,169,48,27,75,244,25,77,WA - Spokane
17,1967-1968,1967-11-26,1968-02-29,96,0,51,159,210,48,62,110,320,26,127,WA - Spokane
18,1968-1969,1968-11-15,1969-04-29,166,1,110,368,478,112,707,819,1297,47,311,WA - Spokane
19,1969-1970,1969-11-25,1970-05-12,169,0,49,208,257,62,108,170,427,33,132,WA - Spokane
20,1970-1971,1970-11-21,1971-03-27,127,0,45,216,261,55,122,177,438,37,144,WA - Spokane
21,1971-1972,1971-10-30,1972-04-17,171,0,78,313,391,101,322,423,814,52,263,WA - Spokane
22,1972-1973,1972-10-28,1973-03-13,137,0,70,233,303,27,36,63,366,16,85,WA - Spokane
23,1973-1974,1973-10-31,1974-05-14,196,0,65,219,284,89,158,247,531,42,170,WA - Spokane
24,1974-1975,1974-11-22,1975-04-06,136,0,51,286,337,131,404,535,872,53,265,WA - Spokane
25,1975-1976,1975-10-25,1976-04-01,160,0,42,240,282,77,50,127,409,40,146,WA - Spokane
26,1976-1977,1976-11-21,1977-03-19,119,0,62,218,280,30,36,66,346,22,94,WA - Spokane
27,1977-1978,1977-11-09,1978-03-13,125,0,62,219,281,101,283,384,665,37,197,WA - Spokane
28,1978-1979,1978-11-09,1979-03-30,142,0,170,447,617,91,546,637,1254,46,273,WA - Spokane
29,1979-1980,1979-11-19,1980-04-06,140,0,61,229,290,64,84,148,438,37,173,WA - Spokane
30,1980-1981,1980-11-15,1981-05-04,171,0,35,174,209,24,20,44,253,14,65,WA - Spokane
31,1981-1982,1981-11-28,1982-04-14,138,0,53,226,279,71,295,366,645,37,159,WA - Spokane
32,1982-1983,1982-11-12,1983-04-10,150,0,38,172,210,59,111,170,380,26,109,WA - Spokane
33,1983-1984,1983-11-19,1984-05-06,170,0,76,265,341,74,155,229,570,38,172,WA - Spokane
34,1984-1985,1984-10-27,1985-03-30,155,3,102,371,473,101,597,698,1171,43,223,WA - Spokane
35,1985-1986,1985-10-31,1986-04-29,181,0,118,379,497,95,513,608,1105,42,291,WA - Spokane
36,1986-1987,1986-11-07,1987-02-28,114,0,40,209,249,43,128,171,420,24,85,WA - Spokane
37,1987-1988,1987-11-16,1988-03-29,135,0,61,257,318,53,227,280,598,28,136,WA - Spokane
38,1988-1989,1988-11-08,1989-03-17,130,0,74,289,363,97,234,331,694,42,218,WA - Spokane
39,1989-1990,1989-11-25,1990-04-28,155,0,22,165,187,59,99,158,345,29,108,WA - Spokane
40,1990-1991,1990-11-19,1991-04-10,143,1,78,262,340,68,96,164,504,34,198,WA - Spokane
41,1991-1992,1991-10-26,1992-02-29,127,0,19,138,157,36,22,58,215,26,77,WA - Spokane
42,1992-1993,1992-11-10,1993-03-14,125,0,92,334,426,125,605,730,1156,42,294,WA - Spokane
43,1993-1994,1993-11-17,1994-03-21,125,0,46,184,230,34,31,65,295,22,79,WA - Spokane
44,1994-1995,1994-10-30,1995-03-05,127,0,32,192,224,46,38,84,308,27,97,WA - Spokane
46,1996-1997,1996-11-16,1997-04-04,140,0,53,254,307,112,364,476,783,42,233,WA - Spokane
47,1997-1998,1997-12-01,1998-03-08,98,0,27,134,161,35,41,76,237,25,87,WA - Spokane
48,1998-1999,1998-11-30,1999-05-13,165,0,32,174,206,68,60,128,334,39,116,WA - Spokane
49,1999-2000,1999-11-21,2000-05-11,173,0,28,179,207,65,92,157,364,41,124,WA - Spokane
50,2000-2001,2000-11-08,2001-04-11,155,0,69,321,390,75,537,612,1002,43,183,WA - Spokane
51,2001-2002,2001-10-12,2002-05-06,207,0,36,236,272,96,175,271,543,49,195,WA - Spokane
52,2002-2003,2002-12-01,2003-04-02,123,0,14,120,134,36,22,58,192,24,65,WA - Spokane
53,2003-2004,2003-11-01,2004-03-05,126,0,60,241,301,82,242,324,625,39,195,WA - Spokane
54,2004-2005,2004-11-27,2005-03-29,123,0,34,178,212,41,80,121,333,20,97,WA - Spokane
55,2005-2006,2005-11-13,2006-03-15,123,0,45,208,253,50,105,155,408,30,104,WA - Spokane
56,2006-2007,2006-11-02,2007-05-21,201,0,55,235,290,59,101,160,450,36,151,WA - Spokane
57,2007-2008,2007-11-19,2008-04-30,164,0,56,263,319,134,325,459,778,62,258,WA - Spokane
58,2008-2009,2008-11-27,2009-04-03,128,0,75,273,348,143,300,443,791,48,307,WA - Spokane
59,2009-2010,2009-11-13,2010-04-06,145,0,36,164,200,23,11,34,234,15,47,WA - Spokane
60,2010-2011,2010-11-13,2011-04-21,160,0,62,252,314,105,245,350,664,45,213,WA - Spokane
61,2011-2012,2011-11-12,2012-04-04,145,0,32,201,233,63,78,141,374,38,138,WA - Spokane
62,2012-2013,2012-11-08,2013-03-07,120,0,42,179,221,70,133,203,424,38,142,WA - Spokane
63,2013-2014,2013-11-03,2014-03-04,122,0,79,235,314,63,112,175,489,32,171,WA - Spokane
64,2014-2015,2014-11-11,2015-04-06,147,0,36,161,197,29,18,47,244,19,69,WA - Spokane
65,2015-2016,2015-11-16,2016-03-28,134,0,35,157,192,57,181,238,430,31,125,WA - Spokane
66,2016-2017,2016-11-16,2017-04-10,146,0,89,293,382,91,347,438,820,46,241,WA - Spokane
67,2017-2018,2017-11-03,2018-03-24,142,0,42,192,234,75,119,194,428,34,153,WA - Spokane
68,2018-2019,2018-11-09,2019-03-22,134,0,57,259,316,78,333,411,727,37,178,WA - Spokane
69,2019-2020,2019-09-28,2020-04-05,191,0,22,186,208,69,107,176,384,33,134,WA - Spokane
0,1950-1951,1950-12-01,1951-03-07,97,0,16,88,104,26,36,62,166,8,46,WA - Walla Walla
1,1951-1952,1951-12-01,1952-03-20,111,3,36,145,181,32,56,88,269,17,87,WA - Walla Walla
2,1952-1953,1952-11-22,1953-02-28,99,0,18,77,95,4,2,6,101,1,5,WA - Walla Walla
3,1953-1954,1953-12-01,1954-03-17,107,0,21,96,117,17,35,52,169,7,54,WA - Walla Walla
4,1954-1955,1954-12-01,1955-03-04,94,0,17,107,124,16,22,38,162,8,31,WA - Walla Walla
5,1955-1956,1955-11-11,1956-02-29,111,0,74,227,301,70,169,239,540,26,188,WA - Walla Walla
6,1956-1957,1956-11-18,1957-03-21,124,0,86,215,301,42,135,177,478,17,121,WA - Walla Walla
7,1957-1958,1957-12-01,1958-03-17,107,0,7,53,60,6,11,17,77,2,10,WA - Walla Walla
8,1958-1959,1958-11-15,1959-04-15,152,0,23,122,145,34,30,64,209,15,76,WA - Walla Walla
9,1959-1960,1959-11-13,1960-03-06,115,0,55,191,246,38,129,167,413,12,84,WA - Walla Walla
10,1960-1961,1960-11-28,1961-02-28,93,0,30,70,100,3,7,10,110,2,7,WA - Walla Walla
11,1961-1962,1961-11-24,1962-03-04,101,0,42,140,182,35,82,117,299,13,83,WA - Walla Walla
12,1962-1963,1962-12-01,1963-02-28,90,0,26,115,141,10,20,30,171,4,36,WA - Walla Walla
13,1963-1964,1963-11-29,1964-03-23,116,0,10,60,70,3,6,9,79,2,7,WA - Walla Walla
14,1964-1965,1964-12-01,1965-03-25,115,0,17,115,132,27,44,71,203,10,48,WA - Walla Walla
15,1965-1966,1965-12-01,1966-03-22,112,0,7,67,74,16,6,22,96,7,21,WA - Walla Walla
16,1966-1967,1966-12-01,1967-03-29,119,1,1,37,38,7,1,8,46,4,10,WA - Walla Walla
17,1967-1968,1967-11-27,1968-02-29,95,0,13,84,97,8,8,16,113,5,30,WA - Walla Walla
18,1968-1969,1968-11-07,1969-02-28,114,0,70,171,241,76,184,260,501,23,209,WA - Walla Walla
19,1969-1970,1969-11-26,1970-03-03,98,0,24,62,86,28,36,64,150,12,46,WA - Walla Walla
20,1970-1971,1970-11-22,1971-03-13,112,0,14,75,89,25,16,41,130,12,45,WA - Walla Walla
21,1971-1972,1971-10-30,1972-02-29,123,0,50,126,176,34,60,94,270,13,95,WA - Walla Walla
22,1972-1973,1972-12-01,1973-02-28,90,0,73,167,240,25,85,110,350,8,75,WA - Walla Walla
23,1973-1974,1973-10-31,1974-02-28,121,0,57,109,166,30,92,122,288,10,80,WA - Walla Walla
24,1974-1975,1974-12-01,1975-02-28,90,0,13,66,79,33,78,111,190,14,55,WA - Walla Walla
25,1975-1976,1975-11-19,1976-03-31,134,0,18,83,101,12,11,23,124,6,20,WA - Walla Walla
26,1976-1977,1976-12-01,1977-02-28,90,0,48,107,155,13,61,74,229,7,45,WA - Walla Walla
27,1977-1978,1977-11-19,1978-03-05,107,0,33,90,123,40,80,120,243,14,96,WA - Walla Walla
28,1978-1979,1978-11-11,1979-02-28,110,0,89,225,314,64,234,298,612,20,128,WA - Walla Walla
29,1979-1980,1979-11-24,1980-03-06,104,0,42,109,151,43,45,88,239,13,78,WA - Walla Walla
30,1980-1981,1980-11-14,1981-02-28,107,0,10,51,61,9,7,16,77,6,22,WA - Walla Walla
31,1981-1982,1981-11-27,1982-03-30,124,0,15,86,101,42,41,83,184,21,65,WA - Walla Walla
32,1982-1983,1982-11-14,1983-02-28,107,0,19,41,60,8,4,12,72,4,13,WA - Walla Walla
33,1983-1984,1983-11-28,1984-02-29,94,0,59,127,186,36,100,136,322,15,105,WA - Walla Walla
34,1984-1985,1984-11-30,1985-02-28,91,0,59,148,207,43,84,127,334,15,99,WA - Walla Walla
35,1985-1986,1985-11-10,1986-02-28,111,0,109,229,338,56,315,371,709,22,162,WA - Walla Walla
36,1986-1987,1986-12-01,1987-02-28,90,0,36,98,134,11,41,52,186,7,28,WA - Walla Walla
37,1987-1988,1987-11-30,1988-02-29,92,5,34,105,139,23,44,67,206,14,60,WA - Walla Walla
38,1988-1989,1988-12-01,1989-03-17,107,1,57,164,221,27,76,103,324,15,90,WA - Walla Walla
39,1989-1990,1989-11-29,1990-03-24,116,0,24,68,92,17,25,42,134,6,26,WA - Walla Walla
40,1990-1991,1990-12-01,1991-03-26,116,3,57,157,214,25,48,73,287,10,74,WA - Walla Walla
41,1991-1992,1991-10-29,1992-02-29,124,0,5,46,51,4,2,6,57,3,7,WA - Walla Walla
42,1992-1993,1992-11-24,1993-03-04,101,5,74,212,286,62,184,246,532,33,213,WA - Walla Walla
43,1993-1994,1993-11-22,1994-03-19,118,0,29,87,116,25,27,52,168,9,45,WA - Walla Walla
49,1999-2000,1999-12-01,2000-02-29,91,6,14,43,57,11,3,14,71,5,19,WA - Walla Walla
50,2000-2001,2000-11-19,2001-02-28,102,0,36,101,137,6,3,9,146,3,15,WA - Walla Walla
51,2001-2002,2001-11-09,2002-02-28,112,0,9,68,77,0,0,0,77,0,0,WA - Walla Walla
52,2002-2003,2002-10-30,2003-02-28,122,0,12,71,83,0,0,0,83,0,0,WA - Walla Walla
53,2003-2004,2003-12-01,2004-02-29,91,2,33,94,127,0,0,0,127,0,0,WA - Walla Walla
54,2004-2005,2004-12-01,2005-02-28,90,1,13,78,91,0,0,0,91,0,0,WA - Walla Walla
59,2009-2010,2009-12-01,2010-02-28,90,0,24,72,96,7,8,15,111,4,17,WA - Walla Walla
60,2010-2011,2010-11-21,2011-02-28,100,2,29,127,156,26,68,94,250,10,40,WA - Walla Walla
61,2011-2012,2011-11-20,2012-03-21,123,14,17,98,115,14,18,32,147,8,27,WA - Walla Walla
62,2012-2013,2012-11-26,2013-02-28,95,0,19,67,86,2,0,2,88,2,4,WA - Walla Walla
63,2013-2014,2013-11-22,2014-03-02,101,11,43,130,173,26,35,61,234,11,72,WA - Walla Walla
64,2014-2015,2014-11-13,2015-02-28,108,3,23,86,109,5,5,10,119,3,15,WA - Walla Walla
65,2015-2016,2015-11-21,2016-02-29,101,5,26,79,105,11,13,24,129,7,22,WA - Walla Walla
66,2016-2017,2016-12-01,2017-02-28,90,8,73,192,265,49,132,181,446,25,145,WA - Walla Walla
67,2017-2018,2017-11-07,2018-02-28,114,4,26,70,96,15,23,38,134,7,36,WA - Walla Walla
0,1950-1951,1950-11-20,1951-03-14,115,2,24,168,192,75,191,266,458,21,123,WA - Wenatchee
1,1951-1952,1951-12-01,1952-03-03,94,9,75,250,325,58,348,406,731,19,147,WA - Wenatchee
2,1952-1953,1952-11-24,1953-02-28,97,0,13,88,101,41,84,125,226,12,66,WA - Wenatchee
3,1953-1954,1953-12-01,1954-02-28,90,0,38,137,175,32,154,186,361,9,86,WA - Wenatchee
4,1954-1955,1954-12-01,1955-03-25,115,0,18,183,201,21,57,78,279,8,36,WA - Wenatchee
5,1955-1956,1955-11-03,1956-03-06,125,3,90,332,422,126,678,804,1226,28,216,WA - Wenatchee
6,1956-1957,1956-11-17,1957-03-12,116,1,99,283,382,50,185,235,617,15,95,WA - Wenatchee
7,1957-1958,1957-10-23,1958-02-28,129,1,2,97,99,13,11,24,123,6,23,WA - Wenatchee
8,1958-1959,1958-11-18,1959-02-28,103,0,33,163,196,36,96,132,328,16,73,WA - Wenatchee
9,1959-1960,1959-11-14,1960-03-07,115,1,38,199,237,30,76,106,343,16,73,WA - Wenatchee
10,1960-1961,1960-11-24,1961-03-07,104,0,26,144,170,28,92,120,290,11,56,WA - Wenatchee
11,1961-1962,1961-11-22,1962-03-11,110,1,42,203,245,54,144,198,443,17,96,WA - Wenatchee
12,1962-1963,1962-11-30,1963-02-28,91,1,28,143,171,6,14,20,191,4,19,WA - Wenatchee
13,1963-1964,1963-11-22,1964-02-29,100,0,13,142,155,44,190,234,389,20,81,WA - Wenatchee
14,1964-1965,1964-11-29,1965-02-28,92,1,38,167,205,54,272,326,531,19,126,WA - Wenatchee
15,1965-1966,1965-11-24,1966-03-21,118,0,26,168,194,53,269,322,516,16,92,WA - Wenatchee
16,1966-1967,1966-12-01,1967-02-28,90,0,1,72,73,6,8,14,87,3,9,WA - Wenatchee
17,1967-1968,1967-11-29,1968-02-29,93,0,21,155,176,42,90,132,308,15,82,WA - Wenatchee
18,1968-1969,1968-12-01,1969-03-13,103,1,98,279,377,86,564,650,1027,31,215,WA - Wenatchee
19,1969-1970,1969-12-01,1970-02-28,90,1,15,116,131,48,139,187,318,15,74,WA - Wenatchee
20,1970-1971,1970-11-22,1971-02-28,99,0,38,192,230,55,375,430,660,19,110,WA - Wenatchee
22,1972-1973,1972-12-01,1973-02-28,90,0,43,174,217,18,55,73,290,7,42,WA - Wenatchee
23,1973-1974,1973-11-04,1974-03-01,118,1,34,141,175,42,113,155,330,14,68,WA - Wenatchee
24,1974-1975,1974-12-01,1975-02-28,90,0,16,129,145,46,198,244,389,19,100,WA - Wenatchee
25,1975-1976,1975-11-29,1976-02-29,93,4,11,128,139,27,83,110,249,5,35,WA - Wenatchee
27,1977-1978,1977-11-21,1978-02-28,100,0,21,125,146,25,64,89,235,12,56,WA - Wenatchee
29,1979-1980,1979-12-01,1980-02-29,91,3,35,171,206,78,342,420,626,22,143,WA - Wenatchee
31,1981-1982,1981-12-01,1982-02-28,90,5,36,147,183,31,229,260,443,13,65,WA - Wenatchee
33,1983-1984,1983-11-23,1984-02-29,99,8,43,163,206,44,137,181,387,13,95,WA - Wenatchee
34,1984-1985,1984-11-01,1985-03-27,147,5,66,253,319,29,285,314,633,10,63,WA - Wenatchee
35,1985-1986,1985-11-17,1986-02-28,104,7,64,203,267,84,406,490,757,19,130,WA - Wenatchee
36,1986-1987,1986-12-01,1987-02-28,90,7,20,105,125,14,68,82,207,6,21,WA - Wenatchee
37,1987-1988,1987-12-01,1988-02-29,91,8,38,148,186,13,194,207,393,5,29,WA - Wenatchee
38,1988-1989,1988-12-01,1989-03-07,97,8,43,191,234,40,120,160,394,14,87,WA - Wenatchee
39,1989-1990,1989-12-01,1990-02-28,90,8,9,85,94,2,3,5,99,2,9,WA - Wenatchee
40,1990-1991,1990-12-01,1991-03-03,93,11,55,163,218,14,104,118,336,4,31,WA - Wenatchee
41,1991-1992,1991-10-29,1992-02-29,124,2,1,72,73,12,3,15,88,6,18,WA - Wenatchee
42,1992-1993,1992-11-27,1993-03-03,97,14,72,215,287,80,360,440,727,25,183,WA - Wenatchee
46,1996-1997,1996-11-19,1997-03-16,118,13,65,212,277,82,480,562,839,24,171,WA - Wenatchee
47,1997-1998,1997-12-01,1998-02-28,90,19,13,85,98,28,45,73,171,13,59,WA - Wenatchee
48,1998-1999,1998-12-01,1999-02-28,90,14,19,102,121,26,25,51,172,9,50,WA - Wenatchee
55,2005-2006,2005-12-01,2006-02-28,90,3,27,125,152,7,47,54,206,4,14,WA - Wenatchee
56,2006-2007,2006-11-26,2007-02-28,95,3,54,160,214,34,75,109,323,13,68,WA - Wenatchee
57,2007-2008,2007-11-26,2008-02-29,96,4,42,172,214,38,100,138,352,18,85,WA - Wenatchee
58,2008-2009,2008-12-01,2009-03-08,98,3,68,184,252,40,100,140,392,18,129,WA - Wenatchee
59,2009-2010,2009-12-01,2010-02-28,90,0,27,116,143,18,25,43,186,10,42,WA - Wenatchee
60,2010-2011,2010-11-22,2011-03-08,107,0,40,170,210,42,72,114,324,24,105,WA - Wenatchee
61,2011-2012,2011-11-17,2012-02-29,105,0,26,159,185,31,96,127,312,15,71,WA - Wenatchee
62,2012-2013,2012-12-01,2013-02-28,90,0,29,103,132,18,45,63,195,12,39,WA - Wenatchee
63,2013-2014,2013-12-01,2014-03-04,94,0,23,126,149,21,58,79,228,12,48,WA - Wenatchee
64,2014-2015,2014-11-22,2015-02-28,99,0,10,80,90,12,17,29,119,6,21,WA - Wenatchee
65,2015-2016,2015-11-24,2016-02-29,98,0,27,106,133,50,182,232,365,21,92,WA - Wenatchee
66,2016-2017,2016-12-01,2017-03-08,98,0,69,238,307,52,377,429,736,25,137,WA - Wenatchee
67,2017-2018,2017-11-05,2018-02-28,116,0,15,118,133,22,39,61,194,14,47,WA - Wenatchee
68,2018-2019,2018-12-01,2019-03-17,107,2,31,153,184,54,201,255,439,24,112,WA - Wenatchee
69,2019-2020,2019-11-27,2020-02-29,95,0,15,106,121,20,32,52,173,9,40,WA - Wenatchee
0,1950-1951,1950-11-19,1951-03-12,114,0,16,203,219,54,106,160,379,25,119,WA - Yakima
1,1951-1952,1951-12-01,1952-03-03,94,0,46,262,308,35,174,209,517,19,126,WA - Yakima
2,1952-1953,1952-11-23,1953-02-28,98,0,15,131,146,20,42,62,208,10,47,WA - Yakima
3,1953-1954,1953-12-01,1954-02-28,90,3,27,159,186,36,152,188,374,10,87,WA - Yakima
4,1954-1955,1954-12-01,1955-03-26,116,0,18,211,229,25,35,60,289,17,55,WA - Yakima
5,1955-1956,1955-10-10,1956-03-05,148,0,72,373,445,102,519,621,1066,36,246,WA - Yakima
6,1956-1957,1956-11-18,1957-03-12,115,0,82,319,401,39,93,132,533,16,89,WA - Yakima
7,1957-1958,1957-10-22,1958-02-28,130,0,1,152,153,5,1,6,159,4,11,WA - Yakima
8,1958-1959,1958-11-17,1959-02-28,104,0,26,166,192,30,36,66,258,20,82,WA - Yakima
9,1959-1960,1959-11-13,1960-03-06,115,0,44,292,336,31,93,124,460,21,105,WA - Yakima
10,1960-1961,1960-12-01,1961-03-08,98,0,31,148,179,18,28,46,225,10,45,WA - Yakima
11,1961-1962,1961-11-23,1962-03-05,103,0,32,195,227,31,39,70,297,15,68,WA - Yakima
12,1962-1963,1962-12-01,1963-02-28,90,0,26,173,199,23,36,59,258,6,53,WA - Yakima
13,1963-1964,1963-12-01,1964-02-29,91,0,13,157,170,15,23,38,208,9,26,WA - Yakima
14,1964-1965,1964-11-29,1965-03-26,118,0,31,231,262,75,324,399,661,23,159,WA - Yakima
15,1965-1966,1965-11-23,1966-03-05,103,0,16,181,197,48,197,245,442,16,85,WA - Yakima
16,1966-1967,1966-12-01,1967-02-28,90,0,0,91,91,10,12,22,113,5,18,WA - Yakima
17,1967-1968,1967-11-27,1968-02-29,95,0,15,169,184,28,46,74,258,17,83,WA - Yakima
18,1968-1969,1968-12-01,1969-03-05,95,0,73,284,357,65,403,468,825,35,235,WA - Yakima
19,1969-1970,1969-12-01,1970-02-28,90,0,19,117,136,38,78,116,252,18,73,WA - Yakima
20,1970-1971,1970-11-22,1971-03-26,125,0,20,212,232,58,102,160,392,25,106,WA - Yakima
21,1971-1972,1971-10-30,1972-03-05,128,0,43,283,326,48,113,161,487,22,124,WA - Yakima
22,1972-1973,1972-12-01,1973-02-28,90,0,46,202,248,23,49,72,320,12,73,WA - Yakima
23,1973-1974,1973-10-31,1974-03-01,122,0,38,198,236,52,116,168,404,20,113,WA - Yakima
24,1974-1975,1974-12-01,1975-03-21,111,0,15,166,181,49,129,178,359,23,108,WA - Yakima
25,1975-1976,1975-11-10,1976-02-29,112,0,10,190,200,27,29,56,256,13,47,WA - Yakima
26,1976-1977,1976-12-01,1977-02-28,90,0,40,195,235,9,9,18,253,8,46,WA - Yakima
27,1977-1978,1977-11-18,1978-03-04,107,0,19,146,165,29,53,82,247,19,78,WA - Yakima
28,1978-1979,1978-11-15,1979-02-28,106,0,89,335,424,35,156,191,615,16,107,WA - Yakima
29,1979-1980,1979-11-22,1980-03-05,105,0,42,214,256,69,351,420,676,31,151,WA - Yakima
30,1980-1981,1980-11-14,1981-02-28,107,0,8,87,95,18,47,65,160,6,27,WA - Yakima
31,1981-1982,1981-12-01,1982-03-31,121,0,39,226,265,42,231,273,538,20,103,WA - Yakima
32,1982-1983,1982-11-16,1983-02-28,105,0,19,133,152,29,95,124,276,16,56,WA - Yakima
33,1983-1984,1983-11-23,1984-02-29,99,0,42,194,236,31,211,242,478,15,85,WA - Yakima
34,1984-1985,1984-11-01,1985-03-26,146,0,75,326,401,41,341,382,783,17,105,WA - Yakima
35,1985-1986,1985-11-10,1986-02-28,111,0,103,331,434,57,348,405,839,25,161,WA - Yakima
36,1986-1987,1986-11-11,1987-02-28,110,0,26,192,218,29,127,156,374,17,66,WA - Yakima
37,1987-1988,1987-11-30,1988-02-29,92,0,31,184,215,30,178,208,423,12,61,WA - Yakima
38,1988-1989,1988-12-01,1989-03-06,96,0,35,233,268,32,73,105,373,16,89,WA - Yakima
39,1989-1990,1989-12-01,1990-02-28,90,0,14,130,144,6,1,7,151,5,17,WA - Yakima
40,1990-1991,1990-12-01,1991-03-01,91,0,49,248,297,6,6,12,309,5,29,WA - Yakima
41,1991-1992,1991-10-28,1992-02-29,125,0,1,140,141,8,3,11,152,6,18,WA - Yakima
42,1992-1993,1992-11-21,1993-04-06,137,0,62,311,373,88,411,499,872,36,223,WA - Yakima
43,1993-1994,1993-11-22,1994-03-21,120,0,28,177,205,22,16,38,243,11,50,WA - Yakima
44,1994-1995,1994-11-15,1995-03-22,128,0,12,175,187,25,22,47,234,16,45,WA - Yakima
45,1995-1996,1995-11-07,1996-02-29,115,0,52,221,273,30,107,137,410,18,111,WA - Yakima
46,1996-1997,1996-11-18,1997-03-15,118,0,54,271,325,91,553,644,969,21,182,WA - Yakima
51,2001-2002,2001-11-28,2002-03-17,110,0,3,163,166,42,73,115,281,19,72,WA - Yakima
52,2002-2003,2002-11-30,2003-02-28,91,0,3,89,92,14,8,22,114,6,20,WA - Yakima
53,2003-2004,2003-12-01,2004-03-03,94,0,27,169,196,48,133,181,377,22,110,WA - Yakima
54,2004-2005,2004-12-01,2005-02-28,90,0,15,172,187,25,67,92,279,12,56,WA - Yakima
55,2005-2006,2005-11-25,2006-02-28,96,0,21,190,211,14,17,31,242,9,35,WA - Yakima
56,2006-2007,2006-11-26,2007-03-02,97,0,44,219,263,24,78,102,365,15,69,WA - Yakima
57,2007-2008,2007-11-17,2008-03-28,133,0,23,228,251,44,56,100,351,24,96,WA - Yakima
58,2008-2009,2008-12-01,2009-02-28,90,0,48,215,263,30,92,122,385,19,122,WA - Yakima
59,2009-2010,2009-11-22,2010-04-02,132,0,22,191,213,24,54,78,291,9,49,WA - Yakima
60,2010-2011,2010-11-22,2011-03-08,107,0,26,205,231,39,114,153,384,17,79,WA - Yakima
61,2011-2012,2011-11-16,2012-03-22,128,0,13,246,259,38,98,136,395,11,75,WA - Yakima
62,2012-2013,2012-11-09,2013-02-28,112,6,17,150,167,24,79,103,270,11,40,WA - Yakima
63,2013-2014,2013-12-01,2014-03-02,92,0,24,199,223,29,35,64,287,8,60,WA - Yakima
64,2014-2015,2014-11-30,2015-02-28,91,1,9,94,103,3,2,5,108,2,5,WA - Yakima
65,2015-2016,2015-11-23,2016-02-29,99,3,17,140,157,43,187,230,387,19,79,WA - Yakima
66,2016-2017,2016-12-01,2017-02-28,90,0,54,245,299,57,327,384,683,24,147,WA - Yakima
67,2017-2018,2017-11-05,2018-03-23,139,0,7,144,151,8,1,9,160,7,23,WA - Yakima
0,1950-1951,1950-11-21,1951-03-21,121,8,29,273,302,36,74,110,412,26,145,WV - Beckley
2,1952-1953,1952-11-30,1953-04-21,143,0,7,168,175,59,52,111,286,21,112,WV - Beckley
3,1953-1954,1953-11-26,1954-03-16,111,0,20,233,253,61,65,126,379,21,128,WV - Beckley
4,1954-1955,1954-11-03,1955-03-27,145,9,26,302,328,38,107,145,473,13,84,WV - Beckley
5,1955-1956,1955-11-11,1956-04-09,151,1,26,299,325,54,122,176,501,17,102,WV - Beckley
6,1956-1957,1956-11-23,1957-04-13,142,2,16,200,216,54,51,105,321,16,107,WV - Beckley
7,1957-1958,1957-10-28,1958-03-25,149,5,52,297,349,100,160,260,609,27,193,WV - Beckley
8,1958-1959,1958-11-29,1959-04-04,127,8,30,309,339,29,36,65,404,12,91,WV - Beckley
9,1959-1960,1959-11-29,1960-04-10,134,6,39,288,327,137,296,433,760,29,245,WV - Beckley
10,1960-1961,1960-11-07,1961-04-18,163,1,36,308,344,73,167,240,584,24,192,WV - Beckley
11,1961-1962,1961-10-20,1962-04-14,177,1,23,255,278,68,103,171,449,22,148,WV - Beckley
12,1962-1963,1962-10-26,1963-03-23,149,1,53,364,417,97,212,309,726,28,237,WV - Beckley
13,1963-1964,1963-11-01,1964-04-01,153,0,52,293,345,110,222,332,677,45,260,WV - Beckley
14,1964-1965,1964-11-30,1965-03-22,113,1,42,240,282,74,93,167,449,35,230,WV - Beckley
15,1965-1966,1965-10-24,1966-04-09,168,0,51,268,319,91,158,249,568,44,254,WV - Beckley
16,1966-1967,1966-11-03,1967-03-20,138,0,38,242,280,93,128,221,501,36,220,WV - Beckley
17,1967-1968,1967-11-04,1968-03-24,142,0,52,303,355,91,204,295,650,33,224,WV - Beckley
18,1968-1969,1968-11-09,1969-03-29,141,0,52,282,334,82,96,178,512,45,212,WV - Beckley
19,1969-1970,1969-11-05,1970-04-07,154,0,65,317,382,99,151,250,632,51,311,WV - Beckley
20,1970-1971,1970-11-04,1971-04-08,156,0,63,278,341,100,113,213,554,41,259,WV - Beckley
21,1971-1972,1971-11-07,1972-04-02,148,0,31,228,259,60,66,126,385,33,156,WV - Beckley
22,1972-1973,1972-10-19,1973-04-12,176,0,33,202,235,50,42,92,327,37,160,WV - Beckley
23,1973-1974,1973-10-29,1974-04-09,163,0,19,169,188,61,64,125,313,32,154,WV - Beckley
24,1974-1975,1974-10-20,1975-04-04,167,0,21,209,230,99,113,212,442,44,212,WV - Beckley
25,1975-1976,1975-11-13,1976-03-17,126,0,37,198,235,55,63,118,353,34,187,WV - Beckley
26,1976-1977,1976-11-05,1977-04-06,153,0,83,386,469,125,355,480,949,54,352,WV - Beckley
27,1977-1978,1977-11-12,1978-04-21,161,0,86,343,429,118,330,448,877,58,392,WV - Beckley
28,1978-1979,1978-11-26,1979-03-26,121,0,55,253,308,97,155,252,560,35,244,WV - Beckley
29,1979-1980,1979-10-10,1980-04-29,203,0,52,277,329,102,155,257,586,37,248,WV - Beckley
30,1980-1981,1980-11-28,1981-03-24,117,0,54,274,328,80,115,195,523,41,241,WV - Beckley
31,1981-1982,1981-10-19,1982-04-10,174,0,56,276,332,109,103,212,544,46,288,WV - Beckley
32,1982-1983,1982-11-05,1983-04-19,166,0,29,192,221,84,100,184,405,31,163,WV - Beckley
33,1983-1984,1983-11-11,1984-04-07,149,0,53,268,321,102,105,207,528,48,261,WV - Beckley
34,1984-1985,1984-11-11,1985-04-10,151,0,48,265,313,102,198,300,613,48,295,WV - Beckley
35,1985-1986,1985-12-01,1986-04-23,144,0,47,252,299,95,113,208,507,45,275,WV - Beckley
36,1986-1987,1986-11-13,1987-04-08,147,0,26,197,223,104,159,263,486,34,193,WV - Beckley
37,1987-1988,1987-11-10,1988-04-28,171,0,49,242,291,85,85,170,461,43,234,WV - Beckley
38,1988-1989,1988-11-06,1989-05-07,183,0,24,189,213,63,45,108,321,35,148,WV - Beckley
39,1989-1990,1989-10-20,1990-04-12,175,0,48,237,285,105,141,246,531,45,248,WV - Beckley
40,1990-1991,1990-12-01,1991-03-30,120,0,13,134,147,34,27,61,208,22,100,WV - Beckley
41,1991-1992,1991-11-04,1992-04-27,176,0,20,175,195,67,39,106,301,36,150,WV - Beckley
42,1992-1993,1992-10-19,1993-04-22,186,0,26,199,225,109,126,235,460,45,210,WV - Beckley
43,1993-1994,1993-10-31,1994-04-07,159,0,50,246,296,126,162,288,584,51,303,WV - Beckley
44,1994-1995,1994-12-01,1995-04-02,123,0,35,168,203,70,87,157,360,34,186,WV - Beckley
46,1996-1997,1996-11-08,1997-04-18,162,0,33,209,242,50,67,117,359,33,153,WV - Beckley
47,1997-1998,1997-10-27,1998-03-24,149,2,27,174,201,128,186,314,515,43,230,WV - Beckley
48,1998-1999,1998-11-06,1999-03-16,131,10,32,189,221,67,60,127,348,34,174,WV - Beckley
54,2004-2005,2004-12-01,2005-04-03,124,0,36,201,237,81,95,176,413,25,174,WV - Beckley
55,2005-2006,2005-11-17,2006-03-26,130,0,27,209,236,60,41,101,337,19,104,WV - Beckley
56,2006-2007,2006-11-19,2007-04-07,140,0,43,215,258,43,37,80,338,16,114,WV - Beckley
57,2007-2008,2007-11-23,2008-02-29,99,2,21,171,192,24,16,40,232,10,61,WV - Beckley
58,2008-2009,2008-11-16,2009-04-07,143,3,48,249,297,80,84,164,461,31,191,WV - Beckley
59,2009-2010,2009-11-27,2010-03-23,117,2,72,232,304,187,381,568,872,43,364,WV - Beckley
60,2010-2011,2010-12-01,2011-04-01,122,0,58,221,279,130,221,351,630,44,300,WV - Beckley
61,2011-2012,2011-10-29,2012-04-23,178,0,10,127,137,53,66,119,256,21,99,WV - Beckley
62,2012-2013,2012-10-29,2013-03-28,151,0,28,193,221,106,110,216,437,38,200,WV - Beckley
63,2013-2014,2013-11-12,2014-04-15,155,3,49,295,344,117,126,243,587,42,281,WV - Beckley
64,2014-2015,2014-11-01,2015-03-28,148,0,47,266,313,95,184,279,592,29,220,WV - Beckley
65,2015-2016,2015-12-01,2016-04-09,131,0,32,163,195,64,95,159,354,22,154,WV - Beckley
66,2016-2017,2016-11-19,2017-04-07,140,0,26,159,185,41,40,81,266,18,105,WV - Beckley
67,2017-2018,2017-12-01,2018-04-09,130,2,47,224,271,74,85,159,430,28,161,WV - Beckley
68,2018-2019,2018-10-21,2019-03-09,140,0,29,164,193,66,48,114,307,29,160,WV - Beckley
69,2019-2020,2019-11-12,2020-04-14,155,0,13,137,150,42,34,76,226,22,92,WV - Beckley
0,1950-1951,1950-11-21,1951-04-03,134,15,23,249,272,58,103,161,433,18,122,WV - Bluefield
1,1951-1952,1951-11-03,1952-03-24,143,1,13,194,207,36,32,68,275,16,70,WV - Bluefield
2,1952-1953,1952-11-21,1953-04-20,151,9,5,148,153,44,40,84,237,16,80,WV - Bluefield
3,1953-1954,1953-11-26,1954-03-15,110,1,14,182,196,36,37,73,269,9,56,WV - Bluefield
4,1954-1955,1954-10-30,1955-03-27,149,0,24,241,265,60,96,156,421,17,106,WV - Bluefield
6,1956-1957,1956-11-22,1957-03-09,108,0,12,164,176,24,18,42,218,10,55,WV - Bluefield
7,1957-1958,1957-10-28,1958-03-22,146,0,29,296,325,84,106,190,515,27,169,WV - Bluefield
8,1958-1959,1958-11-28,1959-03-12,105,1,24,241,265,20,36,56,321,10,61,WV - Bluefield
9,1959-1960,1959-11-07,1960-04-10,156,13,89,292,381,104,249,353,734,33,264,WV - Bluefield
12,1962-1963,1962-10-25,1963-05-01,189,6,67,310,377,51,159,210,587,24,134,WV - Bluefield
13,1963-1964,1963-11-14,1964-04-01,140,0,56,249,305,73,140,213,518,27,171,WV - Bluefield
14,1964-1965,1964-11-22,1965-03-22,121,0,43,211,254,49,71,120,374,17,124,WV - Bluefield
15,1965-1966,1965-11-30,1966-03-08,99,0,48,185,233,56,146,202,435,14,109,WV - Bluefield
16,1966-1967,1966-11-03,1967-03-18,136,0,35,186,221,57,90,147,368,14,105,WV - Bluefield
17,1967-1968,1967-11-05,1968-03-04,121,1,53,253,306,62,131,193,499,12,113,WV - Bluefield
18,1968-1969,1968-11-10,1969-03-27,138,0,47,220,267,74,82,156,423,23,136,WV - Bluefield
19,1969-1970,1969-11-13,1970-03-16,124,0,60,244,304,53,92,145,449,22,140,WV - Bluefield
20,1970-1971,1970-11-04,1971-04-08,156,0,50,219,269,75,80,155,424,24,159,WV - Bluefield
21,1971-1972,1971-11-21,1972-03-25,126,0,33,182,215,29,40,69,284,13,71,WV - Bluefield
22,1972-1973,1972-11-21,1973-03-22,122,0,32,142,174,13,13,26,200,6,33,WV - Bluefield
23,1973-1974,1973-10-29,1974-03-31,154,0,20,136,156,38,67,105,261,16,81,WV - Bluefield
24,1974-1975,1974-10-20,1975-04-03,166,0,22,167,189,60,103,163,352,23,116,WV - Bluefield
25,1975-1976,1975-11-14,1976-03-17,125,0,37,171,208,20,31,51,259,9,52,WV - Bluefield
26,1976-1977,1976-11-05,1977-03-02,118,0,67,288,355,72,229,301,656,34,178,WV - Bluefield
27,1977-1978,1977-11-27,1978-04-27,152,0,81,293,374,72,226,298,672,31,199,WV - Bluefield
28,1978-1979,1978-12-01,1979-03-26,116,0,61,244,305,50,118,168,473,26,170,WV - Bluefield
29,1979-1980,1979-10-10,1980-04-16,190,0,56,236,292,44,94,138,430,24,147,WV - Bluefield
30,1980-1981,1980-11-28,1981-03-24,117,0,49,237,286,35,39,74,360,25,121,WV - Bluefield
31,1981-1982,1981-11-21,1982-03-27,127,0,57,228,285,42,56,98,383,29,151,WV - Bluefield
32,1982-1983,1982-12-01,1983-04-19,140,0,34,149,183,54,94,148,331,26,129,WV - Bluefield
33,1983-1984,1983-11-11,1984-03-21,132,4,47,188,235,35,97,132,367,24,99,WV - Bluefield
34,1984-1985,1984-11-12,1985-04-09,149,0,47,202,249,37,107,144,393,26,127,WV - Bluefield
35,1985-1986,1985-12-01,1986-04-17,138,0,37,227,264,58,65,123,387,33,197,WV - Bluefield
36,1986-1987,1986-11-15,1987-04-08,145,0,28,180,208,88,163,251,459,27,170,WV - Bluefield
37,1987-1988,1987-11-10,1988-04-07,150,0,46,221,267,36,57,93,360,23,130,WV - Bluefield
38,1988-1989,1988-12-01,1989-04-08,129,3,21,153,174,39,38,77,251,22,88,WV - Bluefield
39,1989-1990,1989-11-16,1990-04-12,148,0,45,204,249,47,117,164,413,28,143,WV - Bluefield
40,1990-1991,1990-12-01,1991-03-30,120,0,14,128,142,12,12,24,166,8,39,WV - Bluefield
41,1991-1992,1991-11-04,1992-04-05,154,0,21,177,198,32,9,41,239,24,97,WV - Bluefield
42,1992-1993,1992-11-06,1993-03-22,137,0,23,175,198,62,84,146,344,25,125,WV - Bluefield
43,1993-1994,1993-10-31,1994-03-29,150,0,40,218,258,58,92,150,408,27,146,WV - Bluefield
44,1994-1995,1994-12-01,1995-03-11,101,0,25,141,166,28,54,82,248,15,81,WV - Bluefield
45,1995-1996,1995-11-08,1996-04-10,155,0,63,273,336,113,214,327,663,42,276,WV - Bluefield
46,1996-1997,1996-11-10,1997-04-18,160,0,26,169,195,27,48,75,270,14,60,WV - Bluefield
47,1997-1998,1997-11-04,1998-03-22,139,9,19,135,154,87,151,238,392,24,143,WV - Bluefield
48,1998-1999,1998-12-01,1999-03-17,107,6,27,144,171,57,77,134,305,26,134,WV - Bluefield
49,1999-2000,1999-11-03,2000-04-09,159,4,25,147,172,42,108,150,322,21,112,WV - Bluefield
50,2000-2001,2000-11-18,2001-03-26,129,0,45,233,278,3,2,5,283,1,4,WV - Bluefield
53,2003-2004,2003-11-28,2004-04-04,129,2,28,177,205,73,131,204,409,32,149,WV - Bluefield
54,2004-2005,2004-12-01,2005-04-24,145,3,27,154,181,85,106,191,372,28,147,WV - Bluefield
55,2005-2006,2005-11-21,2006-03-26,126,0,17,145,162,62,64,126,288,35,127,WV - Bluefield
56,2006-2007,2006-10-24,2007-04-16,175,3,22,176,198,45,48,93,291,22,113,WV - Bluefield
57,2007-2008,2007-11-15,2008-03-08,115,3,13,125,138,28,24,52,190,14,63,WV - Bluefield
58,2008-2009,2008-10-28,2009-04-08,163,6,34,202,236,50,56,106,342,29,128,WV - Bluefield
59,2009-2010,2009-11-27,2010-03-11,105,13,55,180,235,105,366,471,706,36,234,WV - Bluefield
60,2010-2011,2010-11-06,2011-03-28,143,0,50,191,241,98,236,334,575,41,237,WV - Bluefield
61,2011-2012,2011-11-11,2012-03-05,116,0,7,83,90,35,31,66,156,18,76,WV - Bluefield
62,2012-2013,2012-10-29,2013-04-04,158,0,18,151,169,83,109,192,361,37,156,WV - Bluefield
63,2013-2014,2013-10-25,2014-04-15,173,0,33,229,262,77,118,195,457,34,201,WV - Bluefield
64,2014-2015,2014-11-01,2015-03-28,148,0,34,215,249,65,118,183,432,34,191,WV - Bluefield
65,2015-2016,2015-12-01,2016-04-09,131,13,23,127,150,55,95,150,300,25,137,WV - Bluefield
66,2016-2017,2016-12-01,2017-04-07,128,0,25,149,174,34,27,61,235,21,111,WV - Bluefield
67,2017-2018,2017-10-29,2018-04-16,170,0,49,245,294,70,76,146,440,26,149,WV - Bluefield
68,2018-2019,2018-11-15,2019-03-09,115,0,32,149,181,50,43,93,274,25,127,WV - Bluefield
69,2019-2020,2019-11-12,2020-04-14,155,0,13,136,149,27,16,43,192,18,71,WV - Bluefield
0,1950-1951,1950-11-24,1951-03-25,122,0,31,183,214,55,64,119,333,21,126,WV - Charleston
1,1951-1952,1951-11-02,1952-03-16,136,0,8,148,156,15,2,17,173,13,40,WV - Charleston
2,1952-1953,1952-11-29,1953-04-19,142,0,6,89,95,31,16,47,142,17,65,WV - Charleston
3,1953-1954,1953-11-06,1954-03-31,146,0,15,150,165,51,39,90,255,20,89,WV - Charleston
4,1954-1955,1954-11-03,1955-03-27,145,0,21,179,200,27,27,54,254,15,68,WV - Charleston
5,1955-1956,1955-11-19,1956-04-08,142,0,15,191,206,33,31,64,270,23,81,WV - Charleston
6,1956-1957,1956-11-23,1957-03-09,107,0,16,127,143,24,22,46,189,17,67,WV - Charleston
7,1957-1958,1957-10-27,1958-03-21,146,0,41,218,259,56,62,118,377,34,163,WV - Charleston
8,1958-1959,1958-11-28,1959-04-13,137,0,27,214,241,30,13,43,284,19,85,WV - Charleston
9,1959-1960,1959-11-25,1960-03-24,121,0,24,176,200,82,99,181,381,41,181,WV - Charleston
10,1960-1961,1960-11-30,1961-04-01,123,0,45,198,243,43,64,107,350,25,123,WV - Charleston
11,1961-1962,1961-10-20,1962-03-09,141,0,22,162,184,40,23,63,247,22,104,WV - Charleston
12,1962-1963,1962-10-25,1963-05-01,189,0,52,281,333,72,100,172,505,31,178,WV - Charleston
13,1963-1964,1963-11-29,1964-03-31,124,0,35,201,236,74,89,163,399,25,129,WV - Charleston
14,1964-1965,1964-11-22,1965-03-21,120,0,30,209,239,46,49,95,334,21,116,WV - Charleston
15,1965-1966,1965-11-29,1966-03-25,117,0,33,191,224,50,91,141,365,20,110,WV - Charleston
16,1966-1967,1966-11-28,1967-03-20,113,0,27,190,217,53,56,109,326,25,119,WV - Charleston
17,1967-1968,1967-11-06,1968-03-23,139,0,32,262,294,62,117,179,473,24,136,WV - Charleston
18,1968-1969,1968-11-12,1969-03-26,135,0,27,209,236,30,13,43,279,21,76,WV - Charleston
19,1969-1970,1969-11-14,1970-03-29,136,0,30,226,256,70,85,155,411,35,164,WV - Charleston
20,1970-1971,1970-11-15,1971-03-26,132,0,46,213,259,70,71,141,400,31,170,WV - Charleston
21,1971-1972,1971-11-21,1972-03-25,126,0,18,135,153,36,23,59,212,21,77,WV - Charleston
22,1972-1973,1972-10-19,1973-04-12,176,0,20,173,193,38,15,53,246,27,93,WV - Charleston
23,1973-1974,1973-12-01,1974-04-09,130,0,11,110,121,36,24,60,181,19,76,WV - Charleston
24,1974-1975,1974-10-20,1975-04-03,166,0,10,183,193,60,45,105,298,24,112,WV - Charleston
25,1975-1976,1975-12-01,1976-03-17,108,1,17,135,152,42,23,65,217,25,92,WV - Charleston
26,1976-1977,1976-11-11,1977-04-06,147,0,72,325,397,74,176,250,647,41,209,WV - Charleston
27,1977-1978,1977-11-12,1978-03-17,126,0,66,287,353,111,297,408,761,51,310,WV - Charleston
28,1978-1979,1978-12-01,1979-03-26,116,0,39,207,246,79,112,191,437,36,182,WV - Charleston
29,1979-1980,1979-11-12,1980-03-18,128,0,30,194,224,55,77,132,356,26,135,WV - Charleston
30,1980-1981,1980-11-18,1981-03-23,126,0,34,238,272,42,70,112,384,27,112,WV - Charleston
31,1981-1982,1981-11-20,1982-04-09,141,0,33,221,254,57,69,126,380,32,156,WV - Charleston
32,1982-1983,1982-12-01,1983-04-17,138,0,10,133,143,43,61,104,247,18,71,WV - Charleston
33,1983-1984,1983-11-11,1984-03-21,132,0,38,211,249,48,64,112,361,27,131,WV - Charleston
34,1984-1985,1984-12-01,1985-04-09,130,0,30,181,211,67,194,261,472,30,161,WV - Charleston
35,1985-1986,1985-12-01,1986-03-07,97,0,21,159,180,66,68,134,314,29,144,WV - Charleston
36,1986-1987,1986-11-15,1987-04-08,145,0,15,141,156,72,91,163,319,27,122,WV - Charleston
37,1987-1988,1987-11-10,1988-03-18,130,0,28,182,210,48,25,73,283,29,123,WV - Charleston
38,1988-1989,1988-12-01,1989-05-07,158,0,13,139,152,25,11,36,188,17,60,WV - Charleston
39,1989-1990,1989-11-16,1990-04-04,140,0,36,174,210,57,58,115,325,28,135,WV - Charleston
40,1990-1991,1990-12-01,1991-03-31,121,0,4,109,113,28,11,39,152,18,63,WV - Charleston
41,1991-1992,1991-11-11,1992-04-05,147,0,9,128,137,39,21,60,197,23,80,WV - Charleston
42,1992-1993,1992-11-14,1993-03-19,126,0,13,148,161,57,50,107,268,23,111,WV - Charleston
43,1993-1994,1993-10-31,1994-03-16,137,0,32,187,219,89,122,211,430,32,184,WV - Charleston
44,1994-1995,1994-12-01,1995-03-11,101,0,23,151,174,42,51,93,267,21,100,WV - Charleston
45,1995-1996,1995-11-11,1996-04-10,152,0,47,241,288,154,163,317,605,56,312,WV - Charleston
46,1996-1997,1996-11-10,1997-02-28,111,0,16,132,148,27,15,42,190,17,66,WV - Charleston
47,1997-1998,1997-11-04,1998-03-22,139,0,8,109,117,43,37,80,197,24,89,WV - Charleston
48,1998-1999,1998-12-01,1999-03-09,99,0,14,122,136,32,23,55,191,17,76,WV - Charleston
49,1999-2000,1999-12-01,2000-04-09,131,0,21,138,159,30,21,51,210,20,90,WV - Charleston
50,2000-2001,2000-11-21,2001-04-18,149,1,25,216,241,32,18,50,291,24,103,WV - Charleston
51,2001-2002,2001-12-01,2002-04-06,127,0,11,138,149,35,34,69,218,16,76,WV - Charleston
52,2002-2003,2002-11-23,2003-03-31,129,0,30,160,190,56,58,114,304,33,144,WV - Charleston
53,2003-2004,2003-11-29,2004-04-05,129,0,23,170,193,36,22,58,251,23,101,WV - Charleston
54,2004-2005,2004-12-01,2005-04-24,145,0,19,148,167,38,25,63,230,20,86,WV - Charleston
55,2005-2006,2005-11-23,2006-03-21,119,0,12,136,148,30,16,46,194,17,59,WV - Charleston
56,2006-2007,2006-12-01,2007-04-07,128,0,21,164,185,28,17,45,230,17,81,WV - Charleston
57,2007-2008,2007-12-01,2008-03-09,100,0,13,133,146,35,22,57,203,20,88,WV - Charleston
58,2008-2009,2008-11-17,2009-03-13,117,0,25,184,209,51,48,99,308,31,126,WV - Charleston
59,2009-2010,2009-12-01,2010-03-03,93,0,37,139,176,89,136,225,401,34,178,WV - Charleston
60,2010-2011,2010-12-01,2011-03-27,117,0,35,151,186,63,80,143,329,35,140,WV - Charleston
61,2011-2012,2011-12-01,2012-03-05,96,0,6,87,93,20,12,32,125,12,49,WV - Charleston
62,2012-2013,2012-10-29,2013-03-26,149,0,14,153,167,42,26,68,235,21,87,WV - Charleston
63,2013-2014,2013-11-12,2014-04-15,155,0,32,241,273,83,72,155,428,39,180,WV - Charleston
64,2014-2015,2014-11-13,2015-03-28,136,0,37,212,249,51,63,114,363,25,127,WV - Charleston
65,2015-2016,2015-12-01,2016-04-09,131,0,21,137,158,52,59,111,269,17,105,WV - Charleston
66,2016-2017,2016-11-19,2017-02-28,102,0,13,88,101,13,8,21,122,8,29,WV - Charleston
67,2017-2018,2017-12-01,2018-04-16,137,0,35,183,218,38,23,61,279,25,100,WV - Charleston
68,2018-2019,2018-11-16,2019-03-08,113,0,15,118,133,23,8,31,164,17,65,WV - Charleston
69,2019-2020,2019-11-12,2020-04-14,155,1,4,102,106,19,8,27,133,12,40,WV - Charleston
0,1950-1951,1950-11-21,1951-03-22,122,0,39,263,302,87,114,201,503,22,155,WV - Clarksburg
1,1951-1952,1951-11-03,1952-03-17,136,0,20,220,240,24,19,43,283,13,65,WV - Clarksburg
2,1952-1953,1952-11-29,1953-04-21,144,1,12,174,186,34,29,63,249,16,74,WV - Clarksburg
3,1953-1954,1953-11-29,1954-04-04,127,2,25,219,244,36,40,76,320,13,60,WV - Clarksburg
4,1954-1955,1954-12-01,1955-03-28,118,1,31,251,282,51,65,116,398,16,108,WV - Clarksburg
5,1955-1956,1955-11-19,1956-03-25,128,4,31,269,300,37,55,92,392,15,86,WV - Clarksburg
6,1956-1957,1956-11-23,1957-02-28,98,1,18,181,199,35,46,81,280,14,72,WV - Clarksburg
7,1957-1958,1957-10-27,1958-03-20,145,1,44,266,310,39,62,101,411,17,94,WV - Clarksburg
8,1958-1959,1958-11-28,1959-04-12,136,1,41,305,346,31,26,57,403,15,77,WV - Clarksburg
9,1959-1960,1959-11-29,1960-03-26,119,2,25,239,264,70,117,187,451,18,128,WV - Clarksburg
10,1960-1961,1960-11-30,1961-03-16,107,0,43,262,305,64,228,292,597,13,111,WV - Clarksburg
11,1961-1962,1961-12-01,1962-03-08,98,2,29,211,240,44,57,101,341,13,85,WV - Clarksburg
12,1962-1963,1962-10-26,1963-03-21,147,0,63,374,437,63,137,200,637,23,141,WV - Clarksburg
13,1963-1964,1963-11-30,1964-03-31,123,0,42,305,347,76,147,223,570,20,137,WV - Clarksburg
14,1964-1965,1964-11-22,1965-03-21,120,1,36,262,298,56,87,143,441,16,111,WV - Clarksburg
15,1965-1966,1965-11-29,1966-04-09,132,1,42,258,300,47,120,167,467,11,96,WV - Clarksburg
16,1966-1967,1966-11-29,1967-03-18,110,1,25,242,267,44,47,91,358,13,94,WV - Clarksburg
17,1967-1968,1967-11-30,1968-03-23,115,1,40,282,322,61,162,223,545,14,99,WV - Clarksburg
18,1968-1969,1968-11-20,1969-03-27,128,0,30,249,279,32,23,55,334,14,62,WV - Clarksburg
19,1969-1970,1969-11-14,1970-03-30,137,1,47,320,367,61,129,190,557,19,139,WV - Clarksburg
21,1971-1972,1971-11-25,1972-04-03,131,1,28,224,252,35,43,78,330,15,73,WV - Clarksburg
27,1977-1978,1977-11-27,1978-03-17,111,19,68,341,409,70,314,384,793,25,177,WV - Clarksburg
28,1978-1979,1978-12-01,1979-02-28,90,11,45,254,299,75,238,313,612,19,155,WV - Clarksburg
30,1980-1981,1980-11-18,1981-03-21,124,3,47,298,345,27,101,128,473,12,85,WV - Clarksburg
31,1981-1982,1981-12-01,1982-04-06,127,15,44,231,275,46,97,143,418,20,106,WV - Clarksburg
32,1982-1983,1982-12-01,1983-03-22,112,16,16,137,153,35,48,83,236,11,62,WV - Clarksburg
36,1986-1987,1986-11-14,1987-04-06,144,7,18,222,240,33,58,91,331,8,55,WV - Clarksburg
37,1987-1988,1987-11-11,1988-03-21,132,17,35,205,240,31,52,83,323,16,70,WV - Clarksburg
38,1988-1989,1988-12-01,1989-03-19,109,16,23,192,215,25,17,42,257,13,67,WV - Clarksburg
39,1989-1990,1989-11-24,1990-03-25,122,8,46,220,266,37,68,105,371,13,78,WV - Clarksburg
40,1990-1991,1990-12-01,1991-03-30,120,3,16,171,187,25,24,49,236,11,53,WV - Clarksburg
41,1991-1992,1991-11-05,1992-03-16,133,9,24,201,225,32,44,76,301,14,87,WV - Clarksburg
42,1992-1993,1992-12-01,1993-03-19,109,11,21,179,200,44,71,115,315,11,74,WV - Clarksburg
43,1993-1994,1993-12-01,1994-03-17,107,14,58,222,280,87,167,254,534,20,154,WV - Clarksburg
44,1994-1995,1994-12-01,1995-03-11,101,6,36,195,231,37,55,92,323,14,85,WV - Clarksburg
45,1995-1996,1995-11-09,1996-03-23,136,6,72,312,384,93,177,270,654,31,206,WV - Clarksburg
46,1996-1997,1996-11-12,1997-02-28,109,6,25,199,224,12,18,30,254,7,30,WV - Clarksburg
47,1997-1998,1997-11-16,1998-03-24,129,5,10,145,155,24,28,52,207,11,40,WV - Clarksburg
48,1998-1999,1998-12-01,1999-03-17,107,5,26,181,207,45,56,101,308,16,92,WV - Clarksburg
49,1999-2000,1999-12-01,2000-02-29,91,1,30,183,213,39,72,111,324,18,108,WV - Clarksburg
50,2000-2001,2000-11-18,2001-03-27,130,8,39,274,313,50,94,144,457,25,133,WV - Clarksburg
51,2001-2002,2001-12-01,2002-03-23,113,3,22,167,189,24,32,56,245,11,59,WV - Clarksburg
52,2002-2003,2002-11-23,2003-03-08,106,12,46,217,263,103,187,290,553,34,217,WV - Clarksburg
53,2003-2004,2003-11-29,2004-03-22,115,12,35,239,274,18,33,51,325,9,35,WV - Clarksburg
55,2005-2006,2005-11-18,2006-03-22,125,3,25,200,225,13,6,19,244,6,25,WV - Clarksburg
56,2006-2007,2006-12-01,2007-04-08,129,7,41,241,282,19,23,42,324,6,38,WV - Clarksburg
57,2007-2008,2007-12-01,2008-02-29,91,2,27,179,206,9,6,15,221,2,16,WV - Clarksburg
58,2008-2009,2008-11-22,2009-03-04,103,1,46,260,306,29,44,73,379,16,96,WV - Clarksburg
59,2009-2010,2009-12-01,2010-03-02,92,14,53,212,265,100,202,302,567,26,198,WV - Clarksburg
65,2015-2016,2015-12-01,2016-04-09,131,20,29,185,214,56,95,151,365,10,112,WV - Clarksburg
68,2018-2019,2018-11-28,2019-03-07,100,17,22,146,168,23,23,46,214,11,53,WV - Clarksburg
69,2019-2020,2019-11-12,2020-03-07,117,15,10,139,149,11,7,18,167,6,18,WV - Clarksburg
0,1950-1951,1950-11-20,1951-04-17,149,0,53,316,369,111,124,235,604,49,300,WV - Elkins
1,1951-1952,1951-11-03,1952-04-15,165,0,33,294,327,65,38,103,430,39,190,WV - Elkins
2,1952-1953,1952-10-29,1953-04-21,175,0,15,236,251,92,72,164,415,46,188,WV - Elkins
3,1953-1954,1953-11-07,1954-05-10,185,0,39,311,350,89,100,189,539,46,239,WV - Elkins
4,1954-1955,1954-11-03,1955-03-28,146,0,46,308,354,52,113,165,519,24,161,WV - Elkins
5,1955-1956,1955-11-04,1956-04-24,173,0,36,361,397,69,164,233,630,28,159,WV - Elkins
6,1956-1957,1956-11-23,1957-03-28,126,0,31,213,244,47,70,117,361,24,138,WV - Elkins
7,1957-1958,1957-10-28,1958-04-08,163,0,72,321,393,89,204,293,686,37,282,WV - Elkins
8,1958-1959,1958-11-27,1959-04-14,139,0,58,360,418,38,37,75,493,22,155,WV - Elkins
12,1962-1963,1962-10-25,1963-05-01,189,0,61,427,488,118,197,315,803,53,334,WV - Elkins
13,1963-1964,1963-11-02,1964-04-09,160,0,49,380,429,110,192,302,731,59,320,WV - Elkins
14,1964-1965,1964-11-22,1965-04-02,132,0,40,322,362,92,133,225,587,44,274,WV - Elkins
15,1965-1966,1965-10-24,1966-04-10,169,0,48,329,377,99,140,239,616,51,270,WV - Elkins
16,1966-1967,1966-11-28,1967-04-27,151,0,34,300,334,98,119,217,551,45,250,WV - Elkins
17,1967-1968,1967-11-04,1968-04-11,160,0,46,402,448,121,288,409,857,47,297,WV - Elkins
18,1968-1969,1968-10-29,1969-04-23,177,0,52,357,409,98,104,202,611,52,250,WV - Elkins
19,1969-1970,1969-11-05,1970-04-06,153,0,74,414,488,136,251,387,875,69,422,WV - Elkins
20,1970-1971,1970-11-04,1971-04-07,155,0,65,375,440,161,171,332,772,57,399,WV - Elkins
21,1971-1972,1971-11-09,1972-04-08,152,0,32,300,332,83,88,171,503,40,200,WV - Elkins
22,1972-1973,1972-10-19,1973-04-13,177,0,31,266,297,71,52,123,420,41,181,WV - Elkins
23,1973-1974,1973-10-29,1974-04-10,164,0,21,262,283,84,102,186,469,41,191,WV - Elkins
24,1974-1975,1974-11-12,1975-04-12,152,0,26,355,381,99,115,214,595,56,258,WV - Elkins
25,1975-1976,1975-11-13,1976-04-02,142,0,30,266,296,72,72,144,440,39,190,WV - Elkins
26,1976-1977,1976-11-05,1977-04-26,173,0,90,500,590,130,417,547,1137,56,375,WV - Elkins
27,1977-1978,1977-11-12,1978-03-19,128,1,100,471,571,115,385,500,1071,60,437,WV - Elkins
28,1978-1979,1978-11-26,1979-04-28,154,0,64,361,425,101,195,296,721,55,323,WV - Elkins
29,1979-1980,1979-10-09,1980-04-16,191,1,58,354,412,120,144,264,676,55,309,WV - Elkins
30,1980-1981,1980-10-25,1981-04-25,183,0,66,429,495,101,172,273,768,58,326,WV - Elkins
31,1981-1982,1981-10-19,1982-04-10,174,0,61,393,454,113,142,255,709,54,333,WV - Elkins
32,1982-1983,1982-11-05,1983-04-19,166,0,28,299,327,104,87,191,518,41,217,WV - Elkins
33,1983-1984,1983-11-04,1984-04-07,156,0,60,369,429,133,130,263,692,59,314,WV - Elkins
34,1984-1985,1984-11-06,1985-04-10,156,0,60,369,429,130,257,387,816,47,341,WV - Elkins
35,1985-1986,1985-12-01,1986-04-23,144,0,44,362,406,172,184,356,762,53,380,WV - Elkins
36,1986-1987,1986-11-13,1987-04-08,147,0,23,317,340,137,145,282,622,43,254,WV - Elkins
37,1987-1988,1987-11-10,1988-04-29,172,0,52,372,424,126,91,217,641,57,336,WV - Elkins
38,1988-1989,1988-11-02,1989-05-07,187,0,26,344,370,84,43,127,497,46,227,WV - Elkins
39,1989-1990,1989-10-08,1990-04-17,192,0,47,394,441,141,141,282,723,55,336,WV - Elkins
40,1990-1991,1990-12-01,1991-04-01,122,0,17,236,253,96,65,161,414,35,191,WV - Elkins
41,1991-1992,1991-11-04,1992-04-05,154,0,26,310,336,111,78,189,525,48,250,WV - Elkins
42,1992-1993,1992-10-18,1993-04-22,187,0,32,312,344,141,122,263,607,52,288,WV - Elkins
43,1993-1994,1993-10-31,1994-04-07,159,0,48,340,388,174,183,357,745,57,364,WV - Elkins
44,1994-1995,1994-11-01,1995-04-02,153,0,30,270,300,65,3,68,368,36,195,WV - Elkins
45,1995-1996,1995-11-08,1996-04-16,161,1,73,394,467,194,206,400,867,72,466,WV - Elkins
46,1996-1997,1996-11-10,1997-04-18,160,7,42,293,335,71,72,143,478,28,180,WV - Elkins
47,1997-1998,1997-11-08,1998-03-24,137,0,21,213,234,66,82,148,382,24,141,WV - Elkins
48,1998-1999,1998-11-09,1999-03-17,129,1,28,295,323,111,125,236,559,29,229,WV - Elkins
49,1999-2000,1999-11-03,2000-04-09,159,15,43,311,354,81,146,227,581,29,188,WV - Elkins
50,2000-2001,2000-11-21,2001-04-18,149,14,44,373,417,120,168,288,705,41,291,WV - Elkins
51,2001-2002,2001-10-28,2002-03-22,146,13,23,288,311,70,70,140,451,25,166,WV - Elkins
53,2003-2004,2003-11-29,2004-04-06,130,8,42,326,368,135,215,350,718,40,289,WV - Elkins
54,2004-2005,2004-11-26,2005-04-25,151,4,30,253,283,107,134,241,524,37,229,WV - Elkins
55,2005-2006,2005-10-24,2006-03-26,154,0,20,252,272,84,93,177,449,41,171,WV - Elkins
56,2006-2007,2006-10-24,2007-04-15,174,3,52,338,390,93,139,232,622,42,268,WV - Elkins
57,2007-2008,2007-11-15,2008-03-23,130,0,27,266,293,66,69,135,428,32,173,WV - Elkins
58,2008-2009,2008-10-28,2009-04-07,162,0,47,333,380,97,124,221,601,43,254,WV - Elkins
59,2009-2010,2009-11-27,2010-03-11,105,0,62,285,347,149,366,515,862,45,334,WV - Elkins
60,2010-2011,2010-12-01,2011-04-02,123,1,61,283,344,125,244,369,713,51,325,WV - Elkins
61,2011-2012,2011-10-29,2012-04-23,178,0,13,229,242,49,58,107,349,24,120,WV - Elkins
62,2012-2013,2012-10-29,2013-03-29,152,0,28,280,308,117,142,259,567,46,249,WV - Elkins
63,2013-2014,2013-11-12,2014-04-15,155,0,53,389,442,133,184,317,759,46,315,WV - Elkins
64,2014-2015,2014-11-14,2015-03-28,135,2,51,350,401,98,163,261,662,28,245,WV - Elkins
65,2015-2016,2015-12-01,2016-04-10,132,3,33,250,283,84,120,204,487,30,220,WV - Elkins
66,2016-2017,2016-11-19,2017-04-07,140,0,28,193,221,68,55,123,344,25,146,WV - Elkins
67,2017-2018,2017-12-01,2018-04-17,138,2,51,287,338,93,133,226,564,34,251,WV - Elkins
68,2018-2019,2018-11-16,2019-03-18,123,1,30,208,238,52,54,106,344,29,143,WV - Elkins
69,2019-2020,2019-11-12,2020-05-09,180,0,9,199,208,52,35,87,295,26,103,WV - Elkins
0,1950-1951,1950-11-24,1951-03-25,122,5,28,208,236,48,54,102,338,19,112,WV - Huntington
1,1951-1952,1951-11-03,1952-03-16,135,0,9,162,171,9,5,14,185,6,24,WV - Huntington
2,1952-1953,1952-11-29,1953-03-07,99,1,4,99,103,10,4,14,117,8,22,WV - Huntington
3,1953-1954,1953-11-27,1954-03-04,98,0,7,156,163,20,25,45,208,6,34,WV - Huntington
4,1954-1955,1954-12-01,1955-02-28,90,0,14,156,170,15,22,37,207,7,31,WV - Huntington
5,1955-1956,1955-11-29,1956-02-29,93,2,10,171,181,10,19,29,210,4,24,WV - Huntington
6,1956-1957,1956-11-23,1957-03-08,106,3,11,145,156,8,6,14,170,5,19,WV - Huntington
7,1957-1958,1957-12-01,1958-03-18,108,0,29,209,238,18,28,46,284,8,33,WV - Huntington
8,1958-1959,1958-11-28,1959-03-17,110,1,24,220,244,12,8,20,264,6,25,WV - Huntington
9,1959-1960,1959-11-27,1960-03-19,114,0,16,179,195,46,72,118,313,13,74,WV - Huntington
10,1960-1961,1960-12-01,1961-02-28,90,18,36,187,223,18,51,69,292,7,45,WV - Huntington
11,1961-1962,1961-12-01,1962-03-14,104,2,23,153,176,26,9,35,211,16,58,WV - Huntington
12,1962-1963,1962-12-01,1963-03-22,112,0,58,269,327,43,76,119,446,28,145,WV - Huntington
13,1963-1964,1963-11-14,1964-03-30,138,0,39,227,266,51,82,133,399,19,96,WV - Huntington
14,1964-1965,1964-11-30,1965-03-21,112,0,28,187,215,33,50,83,298,17,77,WV - Huntington
15,1965-1966,1965-11-29,1966-03-08,100,0,42,172,214,26,94,120,334,13,84,WV - Huntington
16,1966-1967,1966-11-02,1967-03-20,139,0,27,186,213,40,45,85,298,23,90,WV - Huntington
17,1967-1968,1967-11-06,1968-03-23,139,0,43,263,306,48,109,157,463,24,130,WV - Huntington
18,1968-1969,1968-11-19,1969-03-26,128,0,29,205,234,25,6,31,265,20,72,WV - Huntington
19,1969-1970,1969-11-14,1970-03-30,137,0,47,242,289,63,71,134,423,32,164,WV - Huntington
20,1970-1971,1970-11-15,1971-03-26,132,0,41,188,229,56,49,105,334,24,125,WV - Huntington
21,1971-1972,1971-11-24,1972-03-24,122,0,23,152,175,34,18,52,227,16,90,WV - Huntington
22,1972-1973,1972-10-19,1973-04-12,176,0,20,162,182,25,5,30,212,19,63,WV - Huntington
23,1973-1974,1973-12-01,1974-04-09,130,0,16,99,115,25,12,37,152,19,59,WV - Huntington
24,1974-1975,1974-10-20,1975-03-11,143,0,6,119,125,45,36,81,206,20,80,WV - Huntington
25,1975-1976,1975-11-14,1976-03-16,124,0,17,138,155,35,21,56,211,20,61,WV - Huntington
26,1976-1977,1976-11-22,1977-03-01,100,0,53,268,321,59,188,247,568,33,158,WV - Huntington
27,1977-1978,1977-11-12,1978-03-27,136,0,63,268,331,85,271,356,687,38,204,WV - Huntington
28,1978-1979,1978-12-01,1979-03-14,104,0,45,199,244,51,112,163,407,24,124,WV - Huntington
29,1979-1980,1979-11-29,1980-04-15,139,0,31,182,213,40,83,123,336,22,100,WV - Huntington
30,1980-1981,1980-11-18,1981-03-20,123,0,36,208,244,24,17,41,285,20,79,WV - Huntington
31,1981-1982,1981-12-01,1982-03-26,116,0,44,206,250,43,52,95,345,26,148,WV - Huntington
32,1982-1983,1982-12-01,1983-03-22,112,0,11,92,103,25,29,54,157,11,38,WV - Huntington
33,1983-1984,1983-12-01,1984-03-21,112,0,50,193,243,42,49,91,334,23,111,WV - Huntington
34,1984-1985,1984-11-18,1985-04-09,143,0,39,218,257,70,155,225,482,27,156,WV - Huntington
35,1985-1986,1985-12-01,1986-03-20,110,0,26,173,199,62,63,125,324,24,125,WV - Huntington
36,1986-1987,1986-11-15,1987-04-07,144,0,12,128,140,47,51,98,238,20,79,WV - Huntington
37,1987-1988,1987-11-10,1988-03-18,130,0,24,184,208,35,19,54,262,21,94,WV - Huntington
38,1988-1989,1988-12-01,1989-05-07,158,0,16,132,148,13,3,16,164,11,30,WV - Huntington
39,1989-1990,1989-11-16,1990-04-11,147,0,33,173,206,35,39,74,280,23,103,WV - Huntington
40,1990-1991,1990-12-01,1991-03-30,120,0,7,108,115,26,8,34,149,18,60,WV - Huntington
41,1991-1992,1991-11-11,1992-04-04,146,0,8,129,137,22,5,27,164,18,56,WV - Huntington
42,1992-1993,1992-11-07,1993-04-03,148,1,9,153,162,65,53,118,280,25,110,WV - Huntington
43,1993-1994,1993-10-31,1994-03-31,152,0,37,200,237,68,101,169,406,25,132,WV - Huntington
44,1994-1995,1994-12-01,1995-03-11,101,0,22,138,160,32,34,66,226,19,88,WV - Huntington
45,1995-1996,1995-11-13,1996-04-09,149,0,45,227,272,74,104,178,450,38,186,WV - Huntington
46,1996-1997,1996-11-14,1997-02-28,107,1,25,143,168,12,10,22,190,9,44,WV - Huntington
54,2004-2005,2004-12-01,2005-03-14,104,0,19,141,160,21,10,31,191,10,46,WV - Huntington
55,2005-2006,2005-11-23,2006-03-21,119,0,10,126,136,8,5,13,149,6,19,WV - Huntington
56,2006-2007,2006-12-01,2007-04-06,127,2,23,165,188,16,11,27,215,9,50,WV - Huntington
58,2008-2009,2008-11-17,2009-03-03,107,0,29,202,231,26,25,51,282,15,70,WV - Huntington
59,2009-2010,2009-12-01,2010-02-28,90,0,34,146,180,60,66,126,306,24,131,WV - Huntington
60,2010-2011,2010-12-01,2011-03-11,101,0,33,156,189,40,77,117,306,22,95,WV - Huntington
61,2011-2012,2011-12-01,2012-03-05,96,0,4,92,96,8,6,14,110,5,17,WV - Huntington
62,2012-2013,2012-10-30,2013-03-21,143,0,14,144,158,18,12,30,188,11,44,WV - Huntington
63,2013-2014,2013-11-12,2014-03-30,139,2,34,237,271,51,41,92,363,20,103,WV - Huntington
64,2014-2015,2014-11-14,2015-03-07,114,0,37,228,265,50,69,119,384,11,111,WV - Huntington
65,2015-2016,2015-12-01,2016-03-04,95,0,23,122,145,36,37,73,218,10,74,WV - Huntington
66,2016-2017,2016-12-01,2017-02-28,90,0,10,75,85,8,7,15,100,5,22,WV - Huntington
67,2017-2018,2017-12-01,2018-04-09,130,1,34,171,205,24,21,45,250,14,54,WV - Huntington
68,2018-2019,2018-11-27,2019-03-08,102,0,16,115,131,14,3,17,148,11,45,WV - Huntington
69,2019-2020,2019-11-11,2020-02-29,111,0,3,87,90,11,5,16,106,5,18,WV - Huntington
3,1953-1954,1953-11-06,1954-03-15,130,7,14,213,227,14,18,32,259,7,28,WV - Lewisburg
4,1954-1955,1954-11-02,1955-03-27,146,1,20,273,293,25,57,82,375,10,50,WV - Lewisburg
5,1955-1956,1955-11-10,1956-04-08,151,0,17,317,334,28,57,85,419,8,49,WV - Lewisburg
7,1957-1958,1957-11-23,1958-03-22,120,3,40,268,308,57,121,178,486,20,110,WV - Lewisburg
8,1958-1959,1958-12-01,1959-03-09,99,2,20,248,268,9,15,24,292,4,20,WV - Lewisburg
10,1960-1961,1960-12-01,1961-03-10,100,0,27,307,334,46,172,218,552,16,121,WV - Lewisburg
11,1961-1962,1961-10-20,1962-04-15,178,5,13,352,365,64,67,131,496,22,126,WV - Lewisburg
13,1963-1964,1963-11-29,1964-03-02,95,2,35,243,278,46,184,230,508,13,82,WV - Lewisburg
14,1964-1965,1964-11-30,1965-03-22,113,0,20,249,269,37,78,115,384,11,79,WV - Lewisburg
15,1965-1966,1965-11-30,1966-03-07,98,17,29,202,231,56,149,205,436,11,103,WV - Lewisburg
17,1967-1968,1967-12-01,1968-03-03,94,0,26,246,272,67,206,273,545,13,113,WV - Lewisburg
18,1968-1969,1968-11-10,1969-03-11,122,1,25,242,267,39,26,65,332,11,61,WV - Lewisburg
20,1970-1971,1970-11-24,1971-04-07,135,6,35,243,278,48,54,102,380,16,105,WV - Lewisburg
21,1971-1972,1971-11-22,1972-03-24,124,7,13,198,211,27,34,61,272,10,51,WV - Lewisburg
25,1975-1976,1975-12-01,1976-03-17,108,4,22,187,209,20,8,28,237,9,47,WV - Lewisburg
27,1977-1978,1977-11-26,1978-03-08,103,15,42,290,332,58,147,205,537,26,161,WV - Lewisburg
43,1993-1994,1993-10-31,1994-03-05,126,16,41,252,293,59,143,202,495,13,119,WV - Lewisburg
45,1995-1996,1995-11-12,1996-04-10,151,5,67,339,406,127,211,338,744,27,225,WV - Lewisburg
46,1996-1997,1996-11-13,1997-02-28,108,12,35,236,271,28,58,86,357,11,64,WV - Lewisburg
47,1997-1998,1997-11-16,1998-03-13,118,3,17,195,212,74,133,207,419,14,108,WV - Lewisburg
48,1998-1999,1998-12-01,1999-03-18,108,2,30,235,265,55,83,138,403,12,91,WV - Lewisburg
49,1999-2000,1999-12-01,2000-03-13,104,0,35,225,260,40,112,152,412,11,80,WV - Lewisburg
50,2000-2001,2000-11-22,2001-03-27,126,12,46,315,361,27,40,67,428,9,59,WV - Lewisburg
51,2001-2002,2001-12-01,2002-03-23,113,2,20,237,257,13,23,36,293,4,24,WV - Lewisburg
52,2002-2003,2002-12-01,2003-04-01,122,8,42,288,330,74,169,243,573,19,138,WV - Lewisburg
53,2003-2004,2003-11-29,2004-03-23,116,1,35,293,328,42,122,164,492,14,93,WV - Lewisburg
54,2004-2005,2004-12-01,2005-04-26,147,8,36,277,313,39,68,107,420,14,73,WV - Lewisburg
55,2005-2006,2005-11-18,2006-03-26,129,4,24,264,288,32,52,84,372,15,73,WV - Lewisburg
56,2006-2007,2006-12-01,2007-04-08,129,5,41,269,310,21,44,65,375,9,59,WV - Lewisburg
57,2007-2008,2007-11-16,2008-03-09,115,0,25,225,250,33,30,63,313,15,81,WV - Lewisburg
58,2008-2009,2008-11-18,2009-04-08,142,2,50,312,362,32,22,54,416,19,82,WV - Lewisburg
59,2009-2010,2009-12-01,2010-03-12,102,3,67,283,350,134,408,542,892,31,269,WV - Lewisburg
60,2010-2011,2010-12-01,2011-03-27,117,0,63,264,327,57,126,183,510,29,182,WV - Lewisburg
61,2011-2012,2011-10-29,2012-04-23,178,8,13,252,265,26,21,47,312,6,40,WV - Lewisburg
62,2012-2013,2012-10-30,2013-04-05,158,0,36,292,328,49,54,103,431,16,87,WV - Lewisburg
63,2013-2014,2013-11-13,2014-03-27,135,0,56,375,431,57,120,177,608,15,117,WV - Lewisburg
64,2014-2015,2014-11-15,2015-03-29,135,0,55,342,397,54,152,206,603,13,138,WV - Lewisburg
65,2015-2016,2015-12-01,2016-04-10,132,10,39,237,276,50,97,147,423,10,99,WV - Lewisburg
66,2016-2017,2016-11-21,2017-03-15,115,3,28,173,201,13,16,29,230,6,33,WV - Lewisburg
67,2017-2018,2017-12-01,2018-04-10,131,0,54,308,362,38,48,86,448,13,75,WV - Lewisburg
68,2018-2019,2018-11-28,2019-03-09,102,0,21,192,213,40,48,88,301,17,94,WV - Lewisburg
69,2019-2020,2019-11-13,2020-03-01,110,0,8,185,193,5,4,9,202,3,14,WV - Lewisburg
0,1950-1951,1950-11-10,1951-04-13,155,0,193,611,804,103,671,774,1578,44,333,WI - Appleton
1,1951-1952,1951-11-02,1952-04-12,163,0,152,516,668,107,514,621,1289,36,283,WI - Appleton
2,1952-1953,1952-10-16,1953-03-18,154,0,96,377,473,62,346,408,881,30,174,WI - Appleton
3,1953-1954,1953-11-22,1954-05-06,166,0,85,386,471,49,175,224,695,28,146,WI - Appleton
4,1954-1955,1954-11-01,1955-03-30,150,0,119,431,550,81,344,425,975,37,202,WI - Appleton
5,1955-1956,1955-11-07,1956-04-30,176,1,129,544,673,95,475,570,1243,40,253,WI - Appleton
6,1956-1957,1956-11-16,1957-04-10,146,0,140,491,631,67,350,417,1048,37,206,WI - Appleton
7,1957-1958,1957-11-08,1958-04-24,168,2,118,432,550,43,299,342,892,27,131,WI - Appleton
8,1958-1959,1958-11-21,1959-04-07,138,0,222,608,830,118,638,756,1586,37,338,WI - Appleton
9,1959-1960,1959-10-24,1960-05-08,198,2,116,471,587,88,273,361,948,35,204,WI - Appleton
10,1960-1961,1960-11-29,1961-04-16,139,0,126,413,539,37,43,80,619,24,167,WI - Appleton
11,1961-1962,1961-11-21,1962-03-29,129,0,200,526,726,94,718,812,1538,36,287,WI - Appleton
12,1962-1963,1962-10-24,1963-04-23,182,0,226,632,858,85,396,481,1339,41,329,WI - Appleton
13,1963-1964,1963-11-30,1964-04-08,131,0,116,449,565,58,112,170,735,35,193,WI - Appleton
14,1964-1965,1964-11-19,1965-04-17,150,0,195,581,776,82,243,325,1101,40,287,WI - Appleton
15,1965-1966,1965-11-28,1966-03-25,118,0,132,394,526,41,190,231,757,20,158,WI - Appleton
16,1966-1967,1966-11-03,1967-03-21,139,0,139,502,641,70,412,482,1123,31,234,WI - Appleton
17,1967-1968,1967-10-27,1968-04-24,181,0,139,479,618,31,71,102,720,24,152,WI - Appleton
18,1968-1969,1968-11-19,1969-03-31,133,0,135,465,600,60,418,478,1078,22,163,WI - Appleton
19,1969-1970,1969-11-14,1970-03-28,135,0,164,514,678,63,426,489,1167,33,234,WI - Appleton
20,1970-1971,1970-11-21,1971-04-03,134,0,179,544,723,85,656,741,1464,27,207,WI - Appleton
21,1971-1972,1971-11-08,1972-04-07,152,1,171,568,739,94,447,541,1280,34,266,WI - Appleton
22,1972-1973,1972-11-15,1973-04-11,148,1,124,399,523,55,269,324,847,25,177,WI - Appleton
23,1973-1974,1973-11-05,1974-04-14,161,0,143,452,595,68,306,374,969,39,243,WI - Appleton
24,1974-1975,1974-11-13,1975-04-02,141,0,104,428,532,82,369,451,983,43,225,WI - Appleton
25,1975-1976,1975-11-21,1976-03-22,123,0,127,465,592,86,590,676,1268,42,288,WI - Appleton
26,1976-1977,1976-10-18,1977-04-07,172,0,235,652,887,80,432,512,1399,42,341,WI - Appleton
27,1977-1978,1977-11-13,1978-03-19,127,0,195,557,752,87,561,648,1400,35,276,WI - Appleton
28,1978-1979,1978-11-19,1979-04-07,140,0,246,627,873,106,883,989,1862,41,332,WI - Appleton
29,1979-1980,1979-11-09,1980-04-23,167,0,118,481,599,60,145,205,804,26,159,WI - Appleton
30,1980-1981,1980-11-27,1981-03-18,112,0,130,387,517,46,224,270,787,22,170,WI - Appleton
31,1981-1982,1981-10-24,1982-04-05,164,1,185,560,745,84,465,549,1294,31,275,WI - Appleton
32,1982-1983,1982-11-04,1983-03-28,145,1,77,315,392,47,178,225,617,24,116,WI - Appleton
35,1985-1986,1985-11-09,1986-03-25,137,1,209,572,781,84,806,890,1671,28,245,WI - Appleton
36,1986-1987,1986-11-10,1987-04-02,144,2,72,367,439,55,143,198,637,25,137,WI - Appleton
37,1987-1988,1987-11-20,1988-03-21,123,5,153,436,589,68,437,505,1094,26,206,WI - Appleton
38,1988-1989,1988-11-06,1989-04-09,155,10,150,466,616,62,232,294,910,29,207,WI - Appleton
39,1989-1990,1989-10-20,1990-05-11,204,1,139,523,662,57,181,238,900,28,213,WI - Appleton
40,1990-1991,1990-11-05,1991-04-13,160,0,137,480,617,80,350,430,1047,28,203,WI - Appleton
41,1991-1992,1991-10-19,1992-04-14,179,0,95,425,520,67,114,181,701,34,197,WI - Appleton
42,1992-1993,1992-10-20,1993-04-20,183,1,120,502,622,71,209,280,902,30,172,WI - Appleton
43,1993-1994,1993-11-05,1994-05-01,178,1,223,609,832,85,319,404,1236,29,263,WI - Appleton
44,1994-1995,1994-11-26,1995-04-05,131,1,120,398,518,42,158,200,718,22,138,WI - Appleton
45,1995-1996,1995-11-03,1996-04-30,180,1,235,667,902,80,417,497,1399,32,241,WI - Appleton
46,1996-1997,1996-10-31,1997-05-01,183,0,174,542,716,102,421,523,1239,41,327,WI - Appleton
47,1997-1998,1997-10-27,1998-04-16,172,2,80,338,418,54,271,325,743,25,142,WI - Appleton
48,1998-1999,1998-11-20,1999-03-11,112,3,122,362,484,46,195,241,725,20,210,WI - Appleton
49,1999-2000,1999-12-01,2000-04-13,135,3,94,383,477,51,285,336,813,22,141,WI - Appleton
50,2000-2001,2000-11-13,2001-04-16,155,5,184,527,711,65,472,537,1248,36,260,WI - Appleton
51,2001-2002,2001-11-28,2002-04-22,146,2,92,344,436,51,158,209,645,27,142,WI - Appleton
53,2003-2004,2003-11-08,2004-04-11,156,16,129,403,532,51,269,320,852,28,157,WI - Appleton
54,2004-2005,2004-11-25,2005-05-02,159,4,121,445,566,64,266,330,896,29,192,WI - Appleton
55,2005-2006,2005-11-16,2006-03-24,129,10,102,398,500,70,290,360,860,34,195,WI - Appleton
56,2006-2007,2006-11-11,2007-04-12,153,1,135,419,554,72,286,358,912,34,219,WI - Appleton
57,2007-2008,2007-11-17,2008-04-29,165,17,134,430,564,124,675,799,1363,56,305,WI - Appleton
58,2008-2009,2008-11-08,2009-04-21,165,3,192,570,762,118,588,706,1468,46,403,WI - Appleton
59,2009-2010,2009-12-01,2010-05-08,159,0,104,365,469,76,494,570,1039,40,220,WI - Appleton
60,2010-2011,2010-11-21,2011-04-22,153,0,153,485,638,128,604,732,1370,46,340,WI - Appleton
61,2011-2012,2011-11-10,2012-03-10,122,0,55,280,335,45,126,171,506,25,128,WI - Appleton
62,2012-2013,2012-11-13,2013-04-15,154,0,118,450,568,106,479,585,1153,46,283,WI - Appleton
63,2013-2014,2013-11-13,2014-04-16,155,0,280,717,997,105,735,840,1837,54,516,WI - Appleton
64,2014-2015,2014-11-09,2015-03-28,140,0,180,515,695,59,314,373,1068,36,267,WI - Appleton
65,2015-2016,2015-11-22,2016-04-13,144,0,91,337,428,76,370,446,874,30,193,WI - Appleton
66,2016-2017,2016-11-19,2017-03-17,119,0,114,350,464,67,298,365,829,28,173,WI - Appleton
67,2017-2018,2017-11-11,2018-04-23,164,0,167,523,690,92,281,373,1063,40,297,WI - Appleton
68,2018-2019,2018-11-09,2019-04-13,156,0,173,515,688,111,439,550,1238,41,312,WI - Appleton
69,2019-2020,2019-10-29,2020-04-13,168,0,87,399,486,89,414,503,989,33,178,WI - Appleton
0,1950-1951,1950-11-08,1951-04-05,149,0,267,813,1080,95,791,886,1966,46,386,WI - Eau Claire
1,1951-1952,1951-10-31,1952-04-13,166,0,211,730,941,88,593,681,1622,36,314,WI - Eau Claire
2,1952-1953,1952-10-16,1953-04-18,185,0,148,606,754,53,406,459,1213,28,209,WI - Eau Claire
3,1953-1954,1953-11-22,1954-04-03,133,0,136,562,698,37,271,308,1006,28,201,WI - Eau Claire
4,1954-1955,1954-10-31,1955-03-29,150,0,186,637,823,46,474,520,1343,37,239,WI - Eau Claire
5,1955-1956,1955-10-29,1956-04-30,185,2,210,824,1034,69,570,639,1673,44,252,WI - Eau Claire
6,1956-1957,1956-11-15,1957-04-11,148,0,195,669,864,46,440,486,1350,26,198,WI - Eau Claire
7,1957-1958,1957-11-08,1958-04-07,151,0,161,562,723,41,299,340,1063,24,141,WI - Eau Claire
8,1958-1959,1958-11-23,1959-03-21,119,0,239,722,961,31,211,242,1203,22,195,WI - Eau Claire
9,1959-1960,1959-10-12,1960-05-09,211,0,151,639,790,49,221,270,1060,31,212,WI - Eau Claire
10,1960-1961,1960-11-05,1961-04-16,163,0,145,608,753,47,140,187,940,23,163,WI - Eau Claire
11,1961-1962,1961-11-06,1962-04-16,162,0,243,732,975,107,753,860,1835,45,423,WI - Eau Claire
12,1962-1963,1962-10-25,1963-04-23,181,0,248,711,959,65,393,458,1417,48,428,WI - Eau Claire
13,1963-1964,1963-11-23,1964-04-07,137,0,164,578,742,40,219,259,1001,28,179,WI - Eau Claire
14,1964-1965,1964-10-28,1965-04-27,182,2,274,825,1099,98,487,585,1684,38,354,WI - Eau Claire
15,1965-1966,1965-11-13,1966-04-20,159,0,212,629,841,62,286,348,1189,32,241,WI - Eau Claire
16,1966-1967,1966-11-01,1967-03-29,149,0,194,680,874,93,626,719,1593,38,367,WI - Eau Claire
17,1967-1968,1967-11-04,1968-04-24,173,0,173,602,775,35,155,190,965,27,170,WI - Eau Claire
18,1968-1969,1968-11-19,1969-04-28,161,0,208,651,859,118,900,1018,1877,39,376,WI - Eau Claire
19,1969-1970,1969-11-13,1970-04-20,159,0,219,729,948,79,665,744,1692,37,310,WI - Eau Claire
20,1970-1971,1970-11-14,1971-04-28,166,0,217,705,922,110,736,846,1768,43,356,WI - Eau Claire
21,1971-1972,1971-11-06,1972-04-22,169,0,241,744,985,96,804,900,1885,41,344,WI - Eau Claire
22,1972-1973,1972-11-13,1973-04-16,155,0,180,541,721,83,518,601,1322,27,240,WI - Eau Claire
23,1973-1974,1973-11-04,1974-04-06,154,0,195,616,811,71,491,562,1373,36,243,WI - Eau Claire
24,1974-1975,1974-11-12,1975-04-07,147,0,154,612,766,83,571,654,1420,40,279,WI - Eau Claire
25,1975-1976,1975-11-13,1976-03-30,139,0,182,579,761,65,325,390,1151,26,237,WI - Eau Claire
26,1976-1977,1976-10-21,1977-04-04,166,0,297,809,1106,80,317,397,1503,38,372,WI - Eau Claire
27,1977-1978,1977-11-10,1978-04-20,162,0,270,749,1019,80,544,624,1643,38,339,WI - Eau Claire
28,1978-1979,1978-11-15,1979-04-08,145,0,319,785,1104,92,939,1031,2135,44,410,WI - Eau Claire
29,1979-1980,1979-11-07,1980-04-11,157,0,180,609,789,65,272,337,1126,30,200,WI - Eau Claire
30,1980-1981,1980-11-17,1981-03-06,110,0,169,493,662,34,120,154,816,21,167,WI - Eau Claire
31,1981-1982,1981-10-22,1982-04-20,181,1,263,734,997,85,642,727,1724,41,362,WI - Eau Claire
32,1982-1983,1982-10-20,1983-04-15,178,0,110,446,556,74,400,474,1030,39,195,WI - Eau Claire
33,1983-1984,1983-11-09,1984-03-23,136,3,261,644,905,75,651,726,1631,42,300,WI - Eau Claire
34,1984-1985,1984-11-02,1985-04-08,158,0,194,609,803,81,407,488,1291,34,276,WI - Eau Claire
35,1985-1986,1985-11-08,1986-03-24,137,0,246,704,950,88,901,989,1939,37,330,WI - Eau Claire
36,1986-1987,1986-11-09,1987-03-31,143,0,97,439,536,40,129,169,705,22,120,WI - Eau Claire
37,1987-1988,1987-10-22,1988-04-27,189,0,186,627,813,49,274,323,1136,30,233,WI - Eau Claire
38,1988-1989,1988-11-05,1989-04-09,156,0,192,651,843,76,399,475,1318,34,299,WI - Eau Claire
39,1989-1990,1989-11-02,1990-04-16,166,0,163,634,797,61,242,303,1100,32,250,WI - Eau Claire
40,1990-1991,1990-10-18,1991-04-12,177,0,168,555,723,63,402,465,1188,33,227,WI - Eau Claire
41,1991-1992,1991-11-01,1992-04-13,165,0,129,506,635,78,512,590,1225,35,226,WI - Eau Claire
42,1992-1993,1992-10-16,1993-04-16,183,0,167,572,739,78,518,596,1335,43,208,WI - Eau Claire
43,1993-1994,1993-11-05,1994-04-29,176,0,258,670,928,81,393,474,1402,47,400,WI - Eau Claire
44,1994-1995,1994-11-26,1995-04-21,147,0,136,475,611,68,330,398,1009,35,206,WI - Eau Claire
45,1995-1996,1995-10-21,1996-04-15,178,0,252,747,999,125,673,798,1797,54,421,WI - Eau Claire
46,1996-1997,1996-10-31,1997-04-08,160,0,221,624,845,134,739,873,1718,61,520,WI - Eau Claire
47,1997-1998,1997-11-02,1998-03-22,141,0,89,374,463,89,250,339,802,48,254,WI - Eau Claire
48,1998-1999,1998-11-08,1999-03-13,126,0,141,429,570,70,413,483,1053,34,303,WI - Eau Claire
49,1999-2000,1999-12-01,2000-04-11,133,6,104,453,557,57,303,360,917,24,185,WI - Eau Claire
50,2000-2001,2000-11-08,2001-04-16,160,5,235,686,921,78,708,786,1707,35,286,WI - Eau Claire
51,2001-2002,2001-11-27,2002-04-28,153,3,97,398,495,96,236,332,827,45,304,WI - Eau Claire
52,2002-2003,2002-10-20,2003-04-05,168,0,177,591,768,62,117,179,947,48,366,WI - Eau Claire
53,2003-2004,2003-11-04,2004-03-22,140,0,153,507,660,89,344,433,1093,43,305,WI - Eau Claire
54,2004-2005,2004-11-27,2005-03-27,121,0,131,471,602,85,247,332,934,46,308,WI - Eau Claire
55,2005-2006,2005-11-15,2006-03-26,132,0,108,417,525,59,174,233,758,29,158,WI - Eau Claire
56,2006-2007,2006-11-10,2007-04-12,154,1,153,472,625,69,242,311,936,28,205,WI - Eau Claire
57,2007-2008,2007-11-09,2008-04-28,172,0,219,666,885,89,604,693,1578,40,296,WI - Eau Claire
58,2008-2009,2008-11-08,2009-04-05,149,0,228,697,925,78,399,477,1402,46,402,WI - Eau Claire
59,2009-2010,2009-10-10,2010-03-10,152,5,152,501,653,57,496,553,1206,28,178,WI - Eau Claire
60,2010-2011,2010-11-13,2011-04-20,159,3,217,616,833,99,858,957,1790,40,322,WI - Eau Claire
61,2011-2012,2011-11-10,2012-04-16,159,0,80,366,446,42,152,194,640,28,152,WI - Eau Claire
62,2012-2013,2012-11-06,2013-05-04,180,0,161,573,734,135,543,678,1412,52,335,WI - Eau Claire
63,2013-2014,2013-11-11,2014-04-14,155,0,315,809,1124,118,785,903,2027,55,505,WI - Eau Claire
64,2014-2015,2014-10-04,2015-04-10,189,0,229,608,837,67,372,439,1276,39,285,WI - Eau Claire
65,2015-2016,2015-10-28,2016-04-02,158,0,120,381,501,69,272,341,842,39,220,WI - Eau Claire
66,2016-2017,2016-11-20,2017-04-11,143,0,146,428,574,78,345,423,997,30,223,WI - Eau Claire
67,2017-2018,2017-10-27,2018-04-21,177,0,218,681,899,95,451,546,1445,46,358,WI - Eau Claire
68,2018-2019,2018-10-14,2019-04-15,184,0,227,655,882,147,503,650,1532,50,413,WI - Eau Claire
69,2019-2020,2019-10-28,2020-04-17,173,0,110,505,615,101,583,684,1299,43,252,WI - Eau Claire
0,1950-1951,1950-11-10,1951-04-02,144,0,214,646,860,82,520,602,1462,42,317,WI - Green Bay
1,1951-1952,1951-11-02,1952-04-14,165,0,158,605,763,81,352,433,1196,45,333,WI - Green Bay
2,1952-1953,1952-11-22,1953-04-16,146,0,102,427,529,65,260,325,854,37,210,WI - Green Bay
3,1953-1954,1953-11-22,1954-05-06,166,0,97,446,543,51,96,147,690,42,229,WI - Green Bay
4,1954-1955,1954-11-01,1955-03-30,150,0,139,518,657,63,205,268,925,35,196,WI - Green Bay
5,1955-1956,1955-11-06,1956-04-30,177,0,143,639,782,69,250,319,1101,42,246,WI - Green Bay
6,1956-1957,1956-11-16,1957-04-11,147,0,164,553,717,50,218,268,985,36,186,WI - Green Bay
7,1957-1958,1957-11-05,1958-04-24,171,0,133,469,602,42,155,197,799,32,148,WI - Green Bay
8,1958-1959,1958-11-21,1959-04-08,139,0,241,677,918,92,410,502,1420,39,314,WI - Green Bay
9,1959-1960,1959-10-24,1960-05-09,199,0,132,540,672,78,187,265,937,46,240,WI - Green Bay
10,1960-1961,1960-11-29,1961-04-16,139,0,145,425,570,34,51,85,655,23,150,WI - Green Bay
11,1961-1962,1961-11-21,1962-03-30,130,0,216,579,795,91,651,742,1537,44,335,WI - Green Bay
12,1962-1963,1962-10-24,1963-04-23,182,0,235,646,881,78,398,476,1357,46,390,WI - Green Bay
13,1963-1964,1963-11-24,1964-04-08,137,0,156,525,681,49,89,138,819,34,204,WI - Green Bay
14,1964-1965,1964-11-20,1965-04-17,149,0,207,567,774,79,222,301,1075,43,290,WI - Green Bay
15,1965-1966,1965-11-14,1966-04-26,164,0,144,477,621,49,185,234,855,34,206,WI - Green Bay
16,1966-1967,1966-11-03,1967-04-06,155,0,145,531,676,71,415,486,1162,37,250,WI - Green Bay
17,1967-1968,1967-10-25,1968-04-04,163,0,154,510,664,45,96,141,805,36,223,WI - Green Bay
18,1968-1969,1968-11-18,1969-03-31,134,0,162,512,674,61,414,475,1149,27,161,WI - Green Bay
19,1969-1970,1969-10-21,1970-03-28,159,0,202,624,826,65,434,499,1325,37,284,WI - Green Bay
20,1970-1971,1970-11-14,1971-04-03,141,0,215,633,848,102,727,829,1677,50,368,WI - Green Bay
21,1971-1972,1971-11-08,1972-04-22,167,0,191,627,818,112,430,542,1360,49,344,WI - Green Bay
22,1972-1973,1972-11-15,1973-04-13,150,0,126,420,546,60,257,317,863,34,214,WI - Green Bay
23,1973-1974,1973-11-05,1974-04-14,161,0,164,495,659,84,275,359,1018,43,287,WI - Green Bay
24,1974-1975,1974-11-13,1975-04-03,142,0,117,497,614,84,375,459,1073,46,257,WI - Green Bay
25,1975-1976,1975-11-13,1976-05-07,177,0,134,518,652,101,514,615,1267,53,357,WI - Green Bay
26,1976-1977,1976-10-18,1977-04-09,174,0,265,728,993,88,317,405,1398,47,392,WI - Green Bay
27,1977-1978,1977-11-10,1978-03-25,136,0,231,645,876,99,534,633,1509,41,343,WI - Green Bay
28,1978-1979,1978-11-19,1979-04-09,142,0,265,661,926,113,732,845,1771,53,415,WI - Green Bay
29,1979-1980,1979-11-09,1980-04-24,168,0,131,487,618,66,97,163,781,40,251,WI - Green Bay
30,1980-1981,1980-11-12,1981-03-18,127,0,151,438,589,49,240,289,878,27,198,WI - Green Bay
31,1981-1982,1981-10-24,1982-04-20,179,0,204,611,815,85,504,589,1404,43,307,WI - Green Bay
32,1982-1983,1982-11-04,1983-04-03,151,0,94,344,438,61,215,276,714,32,153,WI - Green Bay
33,1983-1984,1983-11-24,1984-03-23,121,0,215,513,728,70,374,444,1172,43,287,WI - Green Bay
34,1984-1985,1984-11-02,1985-04-17,167,0,158,499,657,108,327,435,1092,50,344,WI - Green Bay
35,1985-1986,1985-11-08,1986-04-15,159,0,209,594,803,95,815,910,1713,45,346,WI - Green Bay
36,1986-1987,1986-11-10,1987-04-04,146,0,84,380,464,56,181,237,701,27,151,WI - Green Bay
37,1987-1988,1987-11-18,1988-04-23,158,0,156,488,644,77,436,513,1157,37,261,WI - Green Bay
38,1988-1989,1988-11-05,1989-04-09,156,0,147,513,660,84,231,315,975,36,264,WI - Green Bay
39,1989-1990,1989-10-19,1990-05-11,205,0,139,509,648,70,240,310,958,34,214,WI - Green Bay
40,1990-1991,1990-11-05,1991-04-13,160,0,132,470,602,82,353,435,1037,29,202,WI - Green Bay
41,1991-1992,1991-11-02,1992-04-11,162,0,90,411,501,73,101,174,675,42,217,WI - Green Bay
42,1992-1993,1992-10-20,1993-04-20,183,0,121,478,599,94,220,314,913,52,235,WI - Green Bay
43,1993-1994,1993-11-05,1994-04-30,177,0,209,566,775,95,330,425,1200,41,317,WI - Green Bay
44,1994-1995,1994-11-27,1995-04-07,132,0,95,358,453,52,141,193,646,27,135,WI - Green Bay
45,1995-1996,1995-11-04,1996-04-30,179,0,207,632,839,117,438,555,1394,51,346,WI - Green Bay
46,1996-1997,1996-11-09,1997-05-01,174,0,158,538,696,119,424,543,1239,48,341,WI - Green Bay
47,1997-1998,1997-10-26,1998-04-16,173,0,77,337,414,76,264,340,754,43,200,WI - Green Bay
48,1998-1999,1998-11-15,1999-03-10,116,0,114,354,468,54,198,252,720,31,254,WI - Green Bay
49,1999-2000,1999-12-01,2000-04-11,133,0,105,426,531,61,310,371,902,36,245,WI - Green Bay
50,2000-2001,2000-11-13,2001-04-16,155,0,170,541,711,90,509,599,1310,51,344,WI - Green Bay
51,2001-2002,2001-12-01,2002-04-22,143,0,75,323,398,74,168,242,640,37,206,WI - Green Bay
52,2002-2003,2002-10-18,2003-04-09,174,0,160,536,696,72,188,260,956,45,274,WI - Green Bay
53,2003-2004,2003-11-07,2004-04-11,157,1,126,441,567,72,263,335,902,42,257,WI - Green Bay
54,2004-2005,2004-11-24,2005-03-26,123,2,121,421,542,89,262,351,893,42,268,WI - Green Bay
55,2005-2006,2005-11-16,2006-03-23,128,0,96,365,461,67,278,345,806,36,201,WI - Green Bay
56,2006-2007,2006-11-10,2007-04-12,154,0,120,377,497,72,259,331,828,33,203,WI - Green Bay
57,2007-2008,2007-11-21,2008-04-28,160,0,168,515,683,138,616,754,1437,63,424,WI - Green Bay
58,2008-2009,2008-11-08,2009-04-21,165,0,202,611,813,123,558,681,1494,49,399,WI - Green Bay
59,2009-2010,2009-12-01,2010-05-08,159,0,117,381,498,78,446,524,1022,35,203,WI - Green Bay
60,2010-2011,2010-11-24,2011-04-21,149,0,155,495,650,138,575,713,1363,45,337,WI - Green Bay
61,2011-2012,2011-11-09,2012-03-08,121,0,46,260,306,50,110,160,466,27,143,WI - Green Bay
62,2012-2013,2012-11-24,2013-04-14,142,0,113,433,546,111,456,567,1113,45,286,WI - Green Bay
63,2013-2014,2013-11-12,2014-04-15,155,0,277,726,1003,110,696,806,1809,47,492,WI - Green Bay
64,2014-2015,2014-11-09,2015-03-27,139,0,186,508,694,55,283,338,1032,36,255,WI - Green Bay
65,2015-2016,2015-11-21,2016-04-09,141,0,91,317,408,78,330,408,816,34,210,WI - Green Bay
66,2016-2017,2016-11-19,2017-03-30,132,0,98,310,408,73,250,323,731,27,158,WI - Green Bay
67,2017-2018,2017-11-10,2018-04-23,165,0,164,494,658,108,298,406,1064,43,315,WI - Green Bay
68,2018-2019,2018-11-09,2019-04-12,155,0,156,460,616,109,381,490,1106,41,282,WI - Green Bay
69,2019-2020,2019-10-28,2020-04-13,169,0,84,366,450,91,366,457,907,40,195,WI - Green Bay
0,1950-1951,1950-11-10,1951-04-02,144,0,223,680,903,99,592,691,1594,36,307,WI - La Crosse
1,1951-1952,1951-11-01,1952-04-13,165,0,161,554,715,96,398,494,1209,41,316,WI - La Crosse
2,1952-1953,1952-10-16,1953-03-24,160,0,109,429,538,56,447,503,1041,34,194,WI - La Crosse
3,1953-1954,1953-11-25,1954-04-03,130,0,91,399,490,34,66,100,590,21,122,WI - La Crosse
4,1954-1955,1954-11-01,1955-03-30,150,0,142,475,617,50,235,285,902,34,207,WI - La Crosse
5,1955-1956,1955-11-03,1956-04-30,180,0,162,650,812,81,490,571,1383,42,279,WI - La Crosse
6,1956-1957,1956-11-15,1957-04-04,141,0,136,479,615,43,109,152,767,27,157,WI - La Crosse
7,1957-1958,1957-11-08,1958-03-19,132,0,128,416,544,40,155,195,739,19,104,WI - La Crosse
8,1958-1959,1958-11-23,1959-04-01,130,0,212,631,843,112,496,608,1451,35,347,WI - La Crosse
9,1959-1960,1959-10-12,1960-05-07,209,0,131,488,619,57,158,215,834,34,206,WI - La Crosse
10,1960-1961,1960-11-05,1961-04-17,164,0,127,445,572,52,113,165,737,25,164,WI - La Crosse
11,1961-1962,1961-11-16,1962-04-13,149,0,202,553,755,114,504,618,1373,42,343,WI - La Crosse
12,1962-1963,1962-11-23,1963-04-22,151,2,213,549,762,66,318,384,1146,36,289,WI - La Crosse
13,1963-1964,1963-11-22,1964-04-01,132,0,135,447,582,54,126,180,762,28,165,WI - La Crosse
14,1964-1965,1964-11-19,1965-04-17,150,0,211,689,900,69,223,292,1192,29,255,WI - La Crosse
15,1965-1966,1965-11-18,1966-03-26,129,0,139,473,612,36,181,217,829,21,151,WI - La Crosse
16,1966-1967,1966-11-11,1967-03-23,133,0,124,525,649,74,393,467,1116,29,237,WI - La Crosse
17,1967-1968,1967-11-05,1968-03-22,139,0,121,434,555,18,28,46,601,15,78,WI - La Crosse
18,1968-1969,1968-11-19,1969-04-01,134,0,166,527,693,72,635,707,1400,28,245,WI - La Crosse
19,1969-1970,1969-11-14,1970-03-28,135,0,169,534,703,60,442,502,1205,27,225,WI - La Crosse
20,1970-1971,1970-11-14,1971-04-03,141,0,201,620,821,100,609,709,1530,36,291,WI - La Crosse
21,1971-1972,1971-11-06,1972-04-08,155,0,181,562,743,74,373,447,1190,33,233,WI - La Crosse
22,1972-1973,1972-11-22,1973-04-16,146,0,139,416,555,79,257,336,891,28,209,WI - La Crosse
23,1973-1974,1973-11-05,1974-04-14,161,0,149,495,644,59,271,330,974,32,194,WI - La Crosse
24,1974-1975,1974-11-14,1975-04-10,148,0,119,490,609,106,515,621,1230,40,251,WI - La Crosse
25,1975-1976,1975-11-21,1976-03-16,117,0,113,439,552,34,148,182,734,21,137,WI - La Crosse
26,1976-1977,1976-10-19,1977-04-04,168,0,245,665,910,47,278,325,1235,29,208,WI - La Crosse
27,1977-1978,1977-11-09,1978-03-21,133,9,245,682,927,77,599,676,1603,34,332,WI - La Crosse
28,1978-1979,1978-11-19,1979-04-05,138,0,220,623,843,93,759,852,1695,41,329,WI - La Crosse
29,1979-1980,1979-11-09,1980-04-10,154,0,122,464,586,51,150,201,787,24,144,WI - La Crosse
30,1980-1981,1980-11-24,1981-03-11,108,0,120,400,520,36,77,113,633,18,135,WI - La Crosse
31,1981-1982,1981-10-24,1982-04-09,168,0,207,627,834,54,520,574,1408,27,223,WI - La Crosse
32,1982-1983,1982-10-20,1983-04-09,172,0,101,403,504,61,198,259,763,30,151,WI - La Crosse
33,1983-1984,1983-11-12,1984-03-23,133,0,217,555,772,48,374,422,1194,26,187,WI - La Crosse
34,1984-1985,1984-11-02,1985-04-02,152,0,168,543,711,66,282,348,1059,33,241,WI - La Crosse
36,1986-1987,1986-11-09,1987-03-31,143,0,73,356,429,57,206,263,692,20,117,WI - La Crosse
37,1987-1988,1987-11-20,1988-03-20,122,0,157,432,589,54,320,374,963,21,190,WI - La Crosse
38,1988-1989,1988-11-06,1989-04-09,155,0,149,513,662,64,176,240,902,25,211,WI - La Crosse
39,1989-1990,1989-11-03,1990-03-23,141,0,119,448,567,47,111,158,725,21,172,WI - La Crosse
40,1990-1991,1990-11-08,1991-04-12,156,11,131,470,601,73,398,471,1072,21,180,WI - La Crosse
41,1991-1992,1991-10-18,1992-03-29,164,0,84,402,486,93,255,348,834,36,231,WI - La Crosse
42,1992-1993,1992-10-19,1993-04-19,183,0,130,503,633,89,355,444,1077,43,231,WI - La Crosse
43,1993-1994,1993-10-30,1994-04-05,158,0,196,583,779,72,312,384,1163,35,289,WI - La Crosse
44,1994-1995,1994-11-27,1995-04-11,136,0,100,366,466,49,100,149,615,27,156,WI - La Crosse
45,1995-1996,1995-10-31,1996-04-15,168,0,188,624,812,91,381,472,1284,36,281,WI - La Crosse
46,1996-1997,1996-11-09,1997-04-30,173,0,162,502,664,102,390,492,1156,48,332,WI - La Crosse
47,1997-1998,1997-11-02,1998-04-16,166,3,60,287,347,60,192,252,599,36,150,WI - La Crosse
48,1998-1999,1998-11-08,1999-03-11,124,0,105,340,445,68,240,308,753,29,260,WI - La Crosse
49,1999-2000,1999-10-01,2000-04-11,194,0,80,366,446,43,167,210,656,30,144,WI - La Crosse
50,2000-2001,2000-11-13,2001-04-16,155,0,191,576,767,78,578,656,1423,40,286,WI - La Crosse
51,2001-2002,2001-12-01,2002-04-27,148,0,67,302,369,57,80,137,506,32,173,WI - La Crosse
52,2002-2003,2002-10-24,2003-04-08,167,0,138,498,636,52,109,161,797,32,188,WI - La Crosse
53,2003-2004,2003-11-07,2004-03-17,132,0,108,383,491,57,211,268,759,33,179,WI - La Crosse
54,2004-2005,2004-11-27,2005-03-26,120,0,104,383,487,74,210,284,771,27,162,WI - La Crosse
55,2005-2006,2005-11-15,2006-03-18,124,0,86,345,431,65,190,255,686,30,156,WI - La Crosse
56,2006-2007,2006-11-10,2007-04-12,154,0,117,409,526,74,274,348,874,21,164,WI - La Crosse
57,2007-2008,2007-11-17,2008-04-28,164,0,181,562,743,104,580,684,1427,40,320,WI - La Crosse
58,2008-2009,2008-11-16,2009-03-28,133,0,181,587,768,83,413,496,1264,34,294,WI - La Crosse
59,2009-2010,2009-10-12,2010-03-11,151,0,146,441,587,63,516,579,1166,25,172,WI - La Crosse
60,2010-2011,2010-11-23,2011-04-20,149,0,164,507,671,97,623,720,1391,40,279,WI - La Crosse
61,2011-2012,2011-11-09,2012-03-04,117,0,57,273,330,33,144,177,507,20,113,WI - La Crosse
62,2012-2013,2012-11-12,2013-05-02,172,0,120,468,588,92,385,477,1065,42,255,WI - La Crosse
63,2013-2014,2013-11-11,2014-04-14,155,0,244,682,926,79,597,676,1602,47,399,WI - La Crosse
64,2014-2015,2014-11-11,2015-04-22,163,0,155,484,639,61,307,368,1007,35,207,WI - La Crosse
65,2015-2016,2015-11-20,2016-04-02,135,0,83,295,378,63,270,333,711,30,162,WI - La Crosse
66,2016-2017,2016-12-01,2017-03-16,106,0,91,279,370,55,275,330,700,21,130,WI - La Crosse
67,2017-2018,2017-11-10,2018-04-20,162,0,137,489,626,81,183,264,890,37,282,WI - La Crosse
68,2018-2019,2018-10-14,2019-04-27,196,0,160,506,666,99,415,514,1180,42,315,WI - La Crosse
69,2019-2020,2019-11-06,2020-04-13,160,0,72,359,431,61,276,337,768,30,157,WI - La Crosse
0,1950-1951,1950-11-10,1951-04-13,155,0,182,610,792,90,568,658,1450,40,314,WI - Madison
1,1951-1952,1951-10-24,1952-04-12,172,0,124,494,618,84,265,349,967,41,277,WI - Madison
2,1952-1953,1952-10-16,1953-04-19,186,0,80,382,462,51,98,149,611,31,148,WI - Madison
3,1953-1954,1953-11-26,1954-04-03,129,0,69,350,419,39,48,87,506,27,135,WI - Madison
4,1954-1955,1954-11-01,1955-03-27,147,0,113,448,561,61,176,237,798,35,196,WI - Madison
5,1955-1956,1955-11-03,1956-04-06,156,0,101,508,609,52,105,157,766,36,193,WI - Madison
6,1956-1957,1956-11-16,1957-04-05,141,0,109,451,560,52,124,176,736,28,148,WI - Madison
7,1957-1958,1957-11-08,1958-04-06,150,0,114,420,534,40,113,153,687,31,145,WI - Madison
8,1958-1959,1958-11-23,1959-04-08,137,0,186,630,816,99,449,548,1364,38,322,WI - Madison
9,1959-1960,1959-11-05,1960-04-17,165,0,132,543,675,81,336,417,1092,41,285,WI - Madison
10,1960-1961,1960-11-05,1961-04-17,164,0,106,471,577,39,56,95,672,21,131,WI - Madison
11,1961-1962,1961-10-19,1962-04-13,177,0,197,562,759,76,485,561,1320,40,291,WI - Madison
12,1962-1963,1962-10-24,1963-04-23,182,0,226,636,862,66,231,297,1159,39,299,WI - Madison
13,1963-1964,1963-11-30,1964-04-08,131,0,121,483,604,51,115,166,770,26,159,WI - Madison
14,1964-1965,1964-10-06,1965-04-17,194,0,171,596,767,78,202,280,1047,40,281,WI - Madison
15,1965-1966,1965-11-27,1966-05-11,166,0,134,492,626,43,150,193,819,24,157,WI - Madison
16,1966-1967,1966-11-03,1967-03-22,140,0,117,486,603,63,283,346,949,33,227,WI - Madison
17,1967-1968,1967-10-26,1968-04-24,182,0,115,481,596,29,34,63,659,27,164,WI - Madison
18,1968-1969,1968-11-18,1969-03-31,134,0,139,462,601,64,208,272,873,39,216,WI - Madison
19,1969-1970,1969-11-13,1970-04-02,141,0,167,556,723,65,367,432,1155,37,283,WI - Madison
20,1970-1971,1970-11-23,1971-04-03,132,0,164,549,713,107,621,728,1441,40,269,WI - Madison
21,1971-1972,1971-11-08,1972-04-08,153,0,143,564,707,83,218,301,1008,43,287,WI - Madison
22,1972-1973,1972-11-13,1973-04-14,153,0,113,412,525,77,159,236,761,39,235,WI - Madison
23,1973-1974,1973-11-15,1974-04-14,151,0,139,455,594,73,203,276,870,46,316,WI - Madison
24,1974-1975,1974-11-12,1975-04-09,149,0,84,453,537,98,276,374,911,55,255,WI - Madison
25,1975-1976,1975-11-12,1976-03-16,126,0,92,407,499,56,125,181,680,35,187,WI - Madison
26,1976-1977,1976-11-07,1977-04-05,150,0,213,668,881,52,177,229,1110,41,335,WI - Madison
27,1977-1978,1977-11-21,1978-04-02,133,0,211,615,826,89,575,664,1490,41,338,WI - Madison
28,1978-1979,1978-11-19,1979-04-27,160,0,217,632,849,116,805,921,1770,55,425,WI - Madison
29,1979-1980,1979-10-23,1980-04-15,176,0,133,527,660,57,122,179,839,38,247,WI - Madison
30,1980-1981,1980-11-27,1981-03-11,105,0,101,371,472,46,108,154,626,27,190,WI - Madison
31,1981-1982,1981-10-24,1982-04-11,170,0,183,614,797,85,416,501,1298,44,373,WI - Madison
32,1982-1983,1982-11-04,1983-04-16,164,0,86,395,481,64,155,219,700,35,178,WI - Madison
33,1983-1984,1983-11-24,1984-04-23,152,0,193,513,706,69,404,473,1179,40,249,WI - Madison
34,1984-1985,1984-11-02,1985-04-07,157,0,137,495,632,86,357,443,1075,46,332,WI - Madison
35,1985-1986,1985-11-08,1986-04-15,159,0,189,551,740,115,763,878,1618,48,383,WI - Madison
36,1986-1987,1986-11-10,1987-03-31,142,0,68,357,425,57,104,161,586,33,168,WI - Madison
37,1987-1988,1987-10-22,1988-04-27,189,0,136,485,621,100,333,433,1054,38,235,WI - Madison
38,1988-1989,1988-10-23,1989-05-06,196,0,113,477,590,61,191,252,842,34,230,WI - Madison
39,1989-1990,1989-10-19,1990-05-10,204,0,108,465,573,63,126,189,762,38,208,WI - Madison
40,1990-1991,1990-10-10,1991-04-12,185,0,110,471,581,89,382,471,1052,43,242,WI - Madison
41,1991-1992,1991-10-18,1992-04-01,167,0,66,365,431,74,141,215,646,43,224,WI - Madison
42,1992-1993,1992-10-19,1993-04-20,184,0,87,438,525,107,366,473,998,47,242,WI - Madison
43,1993-1994,1993-10-30,1994-05-01,184,0,174,554,728,110,401,511,1239,43,356,WI - Madison
44,1994-1995,1994-11-28,1995-04-09,133,0,87,365,452,78,313,391,843,29,166,WI - Madison
45,1995-1996,1995-10-21,1996-04-30,193,0,172,608,780,100,339,439,1219,48,348,WI - Madison
46,1996-1997,1996-11-10,1997-05-01,173,4,147,467,614,79,186,265,879,47,296,WI - Madison
48,1998-1999,1998-11-08,1999-03-13,126,1,99,325,424,54,182,236,660,25,206,WI - Madison
49,1999-2000,1999-12-01,2000-04-11,133,0,78,335,413,59,169,228,641,33,202,WI - Madison
50,2000-2001,2000-11-13,2001-04-16,155,0,155,510,665,88,518,606,1271,48,336,WI - Madison
51,2001-2002,2001-12-01,2002-04-21,142,0,64,284,348,48,100,148,496,27,145,WI - Madison
52,2002-2003,2002-10-28,2003-04-09,164,0,123,497,620,50,61,111,731,30,181,WI - Madison
53,2003-2004,2003-11-08,2004-05-02,177,0,107,410,517,52,156,208,725,30,178,WI - Madison
54,2004-2005,2004-11-24,2005-03-22,119,0,92,340,432,67,197,264,696,32,184,WI - Madison
55,2005-2006,2005-11-15,2006-05-11,178,0,89,352,441,78,231,309,750,37,188,WI - Madison
56,2006-2007,2006-10-21,2007-04-12,174,0,127,403,530,83,279,362,892,36,256,WI - Madison
57,2007-2008,2007-11-21,2008-04-12,144,0,158,482,640,148,583,731,1371,60,438,WI - Madison
58,2008-2009,2008-11-07,2009-04-05,150,0,169,534,703,104,414,518,1221,42,330,WI - Madison
59,2009-2010,2009-11-25,2010-04-08,135,0,109,388,497,79,406,485,982,32,170,WI - Madison
60,2010-2011,2010-11-23,2011-04-20,149,0,141,439,580,115,408,523,1103,47,334,WI - Madison
61,2011-2012,2011-11-09,2012-03-06,119,0,39,252,291,52,103,155,446,27,144,WI - Madison
62,2012-2013,2012-11-06,2013-04-14,160,0,98,416,514,104,434,538,1052,41,272,WI - Madison
63,2013-2014,2013-11-11,2014-04-14,155,0,222,630,852,91,450,541,1393,48,435,WI - Madison
64,2014-2015,2014-10-31,2015-03-25,146,0,163,487,650,56,258,314,964,31,223,WI - Madison
65,2015-2016,2015-11-20,2016-04-09,142,0,85,292,377,52,153,205,582,29,159,WI - Madison
66,2016-2017,2016-11-20,2017-03-17,118,0,93,299,392,63,218,281,673,24,158,WI - Madison
67,2017-2018,2017-11-10,2018-04-20,162,0,140,474,614,66,122,188,802,34,254,WI - Madison
68,2018-2019,2018-11-09,2019-04-28,171,0,152,475,627,91,237,328,955,44,327,WI - Madison
69,2019-2020,2019-10-28,2020-04-13,169,0,64,343,407,85,301,386,793,36,189,WI - Madison
0,1950-1951,1950-11-03,1951-04-15,164,0,150,480,630,121,480,601,1231,47,328,WI - Milwaukee
1,1951-1952,1951-11-02,1952-04-12,163,0,95,395,490,109,310,419,909,42,265,WI - Milwaukee
2,1952-1953,1952-11-27,1953-03-09,103,0,56,249,305,41,89,130,435,22,117,WI - Milwaukee
3,1953-1954,1953-11-05,1954-04-03,150,0,62,299,361,41,43,84,445,31,130,WI - Milwaukee
4,1954-1955,1954-11-01,1955-03-27,147,0,91,326,417,66,93,159,576,38,213,WI - Milwaukee
5,1955-1956,1955-11-02,1956-04-07,158,0,83,386,469,60,106,166,635,38,186,WI - Milwaukee
6,1956-1957,1956-11-22,1957-04-04,134,0,101,384,485,59,123,182,667,31,156,WI - Milwaukee
7,1957-1958,1957-11-09,1958-03-20,132,0,111,356,467,49,281,330,797,27,128,WI - Milwaukee
8,1958-1959,1958-11-21,1959-04-09,140,0,168,514,682,97,378,475,1157,41,298,WI - Milwaukee
9,1959-1960,1959-11-06,1960-05-09,186,0,111,412,523,141,554,695,1218,51,326,WI - Milwaukee
10,1960-1961,1960-10-19,1961-04-17,181,0,100,392,492,52,55,107,599,26,151,WI - Milwaukee
11,1961-1962,1961-11-19,1962-04-13,146,0,153,450,603,103,494,597,1200,44,293,WI - Milwaukee
12,1962-1963,1962-10-25,1963-03-19,146,0,218,504,722,53,149,202,924,37,261,WI - Milwaukee
13,1963-1964,1963-12-01,1964-04-01,123,0,120,406,526,68,152,220,746,35,205,WI - Milwaukee
14,1964-1965,1964-11-19,1965-04-17,150,0,151,457,608,110,251,361,969,47,302,WI - Milwaukee
15,1965-1966,1965-11-28,1966-05-11,165,0,123,374,497,78,232,310,807,34,223,WI - Milwaukee
16,1966-1967,1966-11-02,1967-03-22,141,0,112,410,522,94,261,355,877,44,270,WI - Milwaukee
17,1967-1968,1967-10-27,1968-04-24,181,0,98,381,479,32,28,60,539,28,131,WI - Milwaukee
18,1968-1969,1968-11-19,1969-03-31,133,0,100,363,463,51,144,195,658,32,167,WI - Milwaukee
19,1969-1970,1969-11-13,1970-04-03,142,0,156,429,585,64,212,276,861,42,240,WI - Milwaukee
20,1970-1971,1970-11-23,1971-04-03,132,0,161,459,620,89,385,474,1094,40,272,WI - Milwaukee
21,1971-1972,1971-11-07,1972-04-07,153,0,139,436,575,69,145,214,789,37,229,WI - Milwaukee
22,1972-1973,1972-11-13,1973-04-14,153,0,104,323,427,71,136,207,634,33,177,WI - Milwaukee
23,1973-1974,1973-11-05,1974-03-31,147,0,114,340,454,121,286,407,861,45,292,WI - Milwaukee
24,1974-1975,1974-11-14,1975-04-08,146,0,90,326,416,85,174,259,675,43,205,WI - Milwaukee
25,1975-1976,1975-11-12,1976-04-25,166,0,79,342,421,69,256,325,746,40,199,WI - Milwaukee
26,1976-1977,1976-10-26,1977-04-07,164,0,204,544,748,76,253,329,1077,46,324,WI - Milwaukee
27,1977-1978,1977-11-10,1978-03-27,138,0,187,471,658,124,474,598,1256,51,384,WI - Milwaukee
28,1978-1979,1978-11-20,1979-04-09,141,0,202,462,664,125,748,873,1537,52,369,WI - Milwaukee
29,1979-1980,1979-11-09,1980-04-24,168,0,104,363,467,78,206,284,751,43,239,WI - Milwaukee
30,1980-1981,1980-11-27,1981-03-19,113,0,122,352,474,67,219,286,760,30,198,WI - Milwaukee
31,1981-1982,1981-11-20,1982-04-11,143,0,182,499,681,98,531,629,1310,40,356,WI - Milwaukee
32,1982-1983,1982-11-04,1983-04-17,165,0,54,247,301,62,132,194,495,35,136,WI - Milwaukee
33,1983-1984,1983-11-10,1984-04-22,165,0,146,407,553,62,248,310,863,43,239,WI - Milwaukee
34,1984-1985,1984-12-01,1985-04-08,129,0,113,365,478,104,367,471,949,40,281,WI - Milwaukee
35,1985-1986,1985-11-20,1986-04-15,147,0,139,420,559,62,262,324,883,32,192,WI - Milwaukee
36,1986-1987,1986-11-10,1987-04-01,143,0,47,263,310,37,46,83,393,26,98,WI - Milwaukee
37,1987-1988,1987-10-22,1988-03-30,161,0,114,359,473,85,227,312,785,37,226,WI - Milwaukee
38,1988-1989,1988-11-05,1989-05-06,183,0,93,351,444,68,129,197,641,38,226,WI - Milwaukee
39,1989-1990,1989-10-19,1990-05-10,204,0,89,353,442,99,143,242,684,41,226,WI - Milwaukee
40,1990-1991,1990-11-09,1991-04-10,153,0,74,299,373,54,149,203,576,29,144,WI - Milwaukee
41,1991-1992,1991-11-03,1992-04-04,154,0,46,249,295,70,68,138,433,38,175,WI - Milwaukee
42,1992-1993,1992-10-19,1993-04-16,180,0,72,306,378,79,197,276,654,42,189,WI - Milwaukee
43,1993-1994,1993-11-27,1994-04-30,155,0,133,378,511,122,366,488,999,38,310,WI - Milwaukee
44,1994-1995,1994-11-28,1995-04-09,133,0,56,246,302,54,200,254,556,28,114,WI - Milwaukee
45,1995-1996,1995-11-07,1996-04-29,175,0,143,448,591,79,175,254,845,36,217,WI - Milwaukee
46,1996-1997,1996-11-11,1997-04-13,154,0,104,331,435,76,174,250,685,32,193,WI - Milwaukee
47,1997-1998,1997-11-11,1998-03-15,125,0,52,201,253,60,157,217,470,27,118,WI - Milwaukee
48,1998-1999,1998-11-03,1999-03-15,133,0,85,268,353,87,222,309,662,31,234,WI - Milwaukee
49,1999-2000,1999-12-01,2000-04-11,133,0,61,250,311,64,167,231,542,35,197,WI - Milwaukee
50,2000-2001,2000-10-07,2001-04-17,193,0,111,404,515,100,411,511,1026,47,292,WI - Milwaukee
51,2001-2002,2001-12-01,2002-04-22,143,0,51,222,273,58,72,130,403,29,142,WI - Milwaukee
52,2002-2003,2002-11-15,2003-04-09,146,0,107,364,471,61,94,155,626,34,177,WI - Milwaukee
53,2003-2004,2003-11-08,2004-04-12,157,0,91,313,404,66,236,302,706,37,187,WI - Milwaukee
54,2004-2005,2004-11-24,2005-03-18,115,0,86,270,356,73,201,274,630,34,190,WI - Milwaukee
55,2005-2006,2005-11-16,2006-03-24,129,0,66,256,322,64,128,192,514,35,152,WI - Milwaukee
56,2006-2007,2006-10-12,2007-04-12,183,0,104,305,409,84,265,349,758,29,214,WI - Milwaukee
57,2007-2008,2007-11-21,2008-04-12,144,0,109,348,457,143,434,577,1034,50,325,WI - Milwaukee
58,2008-2009,2008-11-08,2009-04-21,165,0,117,411,528,110,290,400,928,39,262,WI - Milwaukee
59,2009-2010,2009-11-25,2010-04-08,135,3,75,251,326,63,210,273,599,29,125,WI - Milwaukee
60,2010-2011,2010-11-26,2011-04-19,145,0,102,327,429,97,265,362,791,45,258,WI - Milwaukee
61,2011-2012,2011-11-10,2012-03-06,118,0,29,185,214,51,72,123,337,26,120,WI - Milwaukee
62,2012-2013,2012-11-24,2013-04-19,147,0,80,297,377,70,177,247,624,31,177,WI - Milwaukee
63,2013-2014,2013-11-11,2014-04-14,155,0,189,518,707,102,471,573,1280,52,382,WI - Milwaukee
64,2014-2015,2014-10-31,2015-03-27,148,0,139,386,525,72,270,342,867,38,271,WI - Milwaukee
65,2015-2016,2015-11-20,2016-04-08,141,0,69,228,297,60,153,213,510,25,142,WI - Milwaukee
66,2016-2017,2016-12-01,2017-03-18,108,0,65,219,284,56,114,170,454,23,123,WI - Milwaukee
67,2017-2018,2017-11-10,2018-04-20,162,0,96,331,427,73,112,185,612,36,217,WI - Milwaukee
68,2018-2019,2018-11-09,2019-04-28,171,0,105,331,436,88,230,318,754,40,216,WI - Milwaukee
69,2019-2020,2019-10-29,2020-04-14,169,0,39,232,271,63,118,181,452,33,133,WI - Milwaukee
0,1950-1951,1950-10-23,1951-04-23,183,2,220,825,1045,182,1185,1367,2412,59,532,WI - Minocqua
1,1951-1952,1951-10-28,1952-05-11,197,2,181,789,970,197,804,1001,1971,54,481,WI - Minocqua
3,1953-1954,1953-11-22,1954-05-06,166,1,154,667,821,128,751,879,1700,46,419,WI - Minocqua
4,1954-1955,1954-10-30,1955-04-08,161,5,173,681,854,101,918,1019,1873,33,239,WI - Minocqua
5,1955-1956,1955-11-03,1956-05-02,182,7,169,807,976,110,1093,1203,2179,35,276,WI - Minocqua
6,1956-1957,1956-11-06,1957-04-14,160,2,195,748,943,85,733,818,1761,40,291,WI - Minocqua
7,1957-1958,1957-10-25,1958-04-24,182,2,175,657,832,88,737,825,1657,27,214,WI - Minocqua
8,1958-1959,1958-11-24,1959-03-31,128,1,258,815,1073,79,711,790,1863,22,261,WI - Minocqua
9,1959-1960,1959-10-26,1960-05-10,198,2,171,788,959,119,747,866,1825,31,286,WI - Minocqua
10,1960-1961,1960-11-06,1961-04-01,147,2,167,668,835,84,446,530,1365,22,232,WI - Minocqua
11,1961-1962,1961-11-06,1962-04-18,164,4,232,796,1028,86,986,1072,2100,26,214,WI - Minocqua
12,1962-1963,1962-11-04,1963-03-30,147,0,264,814,1078,76,759,835,1913,25,282,WI - Minocqua
13,1963-1964,1963-11-02,1964-04-15,166,4,159,812,971,61,649,710,1681,20,184,WI - Minocqua
14,1964-1965,1964-11-18,1965-04-26,160,0,234,894,1128,108,1000,1108,2236,23,244,WI - Minocqua
15,1965-1966,1965-11-13,1966-05-02,171,1,163,725,888,83,781,864,1752,23,195,WI - Minocqua
16,1966-1967,1966-11-01,1967-05-11,192,6,176,770,946,214,946,1160,2106,67,651,WI - Minocqua
17,1967-1968,1967-10-25,1968-04-25,184,6,209,859,1068,108,528,636,1704,43,345,WI - Minocqua
18,1968-1969,1968-10-28,1969-05-11,196,0,157,727,884,246,1190,1436,2320,62,558,WI - Minocqua
19,1969-1970,1969-10-13,1970-04-22,192,4,205,809,1014,172,976,1148,2162,65,549,WI - Minocqua
20,1970-1971,1970-11-13,1971-05-12,181,0,223,770,993,237,1384,1621,2614,67,640,WI - Minocqua
21,1971-1972,1971-11-06,1972-04-25,172,1,214,818,1032,181,1123,1304,2336,58,503,WI - Minocqua
22,1972-1973,1972-10-19,1973-05-04,198,3,200,692,892,155,693,848,1740,49,399,WI - Minocqua
23,1973-1974,1973-11-04,1974-04-23,171,0,236,898,1134,147,735,882,2016,46,437,WI - Minocqua
24,1974-1975,1974-10-01,1975-04-20,202,1,183,750,933,208,1078,1286,2219,68,577,WI - Minocqua
25,1975-1976,1975-11-10,1976-05-06,179,1,214,745,959,183,925,1108,2067,61,592,WI - Minocqua
26,1976-1977,1976-10-16,1977-04-09,176,4,323,943,1266,138,682,820,2086,58,563,WI - Minocqua
27,1977-1978,1977-10-11,1978-04-20,192,2,241,843,1084,133,733,866,1950,53,467,WI - Minocqua
28,1978-1979,1978-11-12,1979-05-06,176,3,328,952,1280,152,1225,1377,2657,51,499,WI - Minocqua
29,1979-1980,1979-10-13,1980-05-08,209,4,205,787,992,133,928,1061,2053,45,306,WI - Minocqua
31,1981-1982,1981-10-19,1982-04-21,185,8,277,888,1165,154,1044,1198,2363,46,463,WI - Minocqua
32,1982-1983,1982-10-20,1983-04-18,181,4,146,552,698,241,755,996,1694,58,418,WI - Minocqua
33,1983-1984,1983-11-09,1984-05-01,175,0,266,822,1088,160,936,1096,2184,51,486,WI - Minocqua
34,1984-1985,1984-11-03,1985-04-17,166,0,230,764,994,174,762,936,1930,43,433,WI - Minocqua
35,1985-1986,1985-11-09,1986-05-02,175,1,282,832,1114,176,1199,1375,2489,48,532,WI - Minocqua
36,1986-1987,1986-10-14,1987-04-25,194,1,149,666,815,111,795,906,1721,36,291,WI - Minocqua
37,1987-1988,1987-10-03,1988-04-27,208,2,227,793,1020,154,775,929,1949,48,368,WI - Minocqua
38,1988-1989,1988-10-24,1989-05-06,195,1,235,836,1071,175,1028,1203,2274,52,450,WI - Minocqua
39,1989-1990,1989-10-31,1990-05-10,192,1,216,868,1084,111,811,922,2006,43,367,WI - Minocqua
40,1990-1991,1990-10-11,1991-04-24,196,2,216,832,1048,140,745,885,1933,36,334,WI - Minocqua
41,1991-1992,1991-10-15,1992-04-16,185,1,183,766,949,172,989,1161,2110,46,455,WI - Minocqua
42,1992-1993,1992-10-16,1993-04-19,186,1,201,758,959,203,948,1151,2110,50,441,WI - Minocqua
44,1994-1995,1994-11-22,1995-04-21,151,1,178,771,949,119,562,681,1630,29,292,WI - Minocqua
45,1995-1996,1995-09-22,1996-05-06,228,12,282,1005,1287,226,1339,1565,2852,57,502,WI - Minocqua
46,1996-1997,1996-10-31,1997-05-17,199,1,219,811,1030,238,1318,1556,2586,57,583,WI - Minocqua
47,1997-1998,1997-10-14,1998-03-29,167,2,108,571,679,167,800,967,1646,41,390,WI - Minocqua
48,1998-1999,1998-11-08,1999-04-11,155,2,170,615,785,161,856,1017,1802,39,388,WI - Minocqua
49,1999-2000,1999-11-24,2000-04-21,150,3,153,623,776,155,618,773,1549,40,357,WI - Minocqua
50,2000-2001,2000-10-07,2001-04-24,200,5,214,839,1053,172,1070,1242,2295,58,526,WI - Minocqua
51,2001-2002,2001-10-06,2002-05-03,210,2,115,727,842,228,732,960,1802,53,494,WI - Minocqua
52,2002-2003,2002-10-13,2003-04-19,189,1,239,973,1212,136,521,657,1869,37,374,WI - Minocqua
53,2003-2004,2003-10-01,2004-04-27,210,2,183,924,1107,233,1007,1240,2347,55,573,WI - Minocqua
54,2004-2005,2004-10-04,2005-05-02,211,6,174,705,879,185,987,1172,2051,48,469,WI - Minocqua
55,2005-2006,2005-11-14,2006-05-11,179,13,136,579,715,204,912,1116,1831,37,378,WI - Minocqua
57,2007-2008,2007-11-06,2008-04-29,176,11,238,838,1076,98,792,890,1966,37,278,WI - Minocqua
58,2008-2009,2008-10-28,2009-04-21,176,0,283,903,1186,80,634,714,1900,38,381,WI - Minocqua
59,2009-2010,2009-10-13,2010-05-08,208,3,175,659,834,62,539,601,1435,28,211,WI - Minocqua
60,2010-2011,2010-11-13,2011-04-23,162,12,218,707,925,97,504,601,1526,44,347,WI - Minocqua
61,2011-2012,2011-11-10,2012-03-13,125,9,131,492,623,78,519,597,1220,32,226,WI - Minocqua
62,2012-2013,2012-11-13,2013-05-04,173,0,207,730,937,106,749,855,1792,47,354,WI - Minocqua
63,2013-2014,2013-10-22,2014-04-30,191,2,415,1081,1496,140,1066,1206,2702,55,578,WI - Minocqua
64,2014-2015,2014-10-31,2015-04-23,175,0,307,840,1147,109,736,845,1992,42,344,WI - Minocqua
65,2015-2016,2015-11-13,2016-04-13,153,2,173,536,709,69,445,514,1223,39,269,WI - Minocqua
66,2016-2017,2016-11-19,2017-04-28,161,0,184,558,742,84,447,531,1273,43,312,WI - Minocqua
67,2017-2018,2017-10-28,2018-04-24,179,0,269,856,1125,129,906,1035,2160,48,443,WI - Minocqua
68,2018-2019,2018-10-13,2019-05-01,201,0,272,839,1111,142,766,908,2019,62,543,WI - Minocqua
69,2019-2020,2019-10-13,2020-04-17,188,0,192,695,887,134,875,1009,1896,62,465,WI - Minocqua
0,1950-1951,1950-11-10,1951-04-21,163,0,244,793,1037,128,731,859,1896,53,460,WI - Wausau
1,1951-1952,1951-11-01,1952-04-13,165,0,197,684,881,101,552,653,1534,41,377,WI - Wausau
2,1952-1953,1952-10-16,1953-04-19,186,0,141,575,716,88,496,584,1300,49,322,WI - Wausau
3,1953-1954,1953-11-22,1954-05-04,164,0,138,530,668,65,221,286,954,40,280,WI - Wausau
4,1954-1955,1954-10-30,1955-03-30,152,0,188,620,808,71,502,573,1381,39,257,WI - Wausau
5,1955-1956,1955-10-30,1956-05-01,185,0,186,771,957,120,688,808,1765,48,370,WI - Wausau
6,1956-1957,1956-11-15,1957-04-12,149,1,202,654,856,71,377,448,1304,38,269,WI - Wausau
7,1957-1958,1957-11-08,1958-04-24,168,0,157,551,708,62,330,392,1100,38,223,WI - Wausau
8,1958-1959,1958-11-21,1959-04-09,140,0,266,743,1009,94,443,537,1546,28,264,WI - Wausau
9,1959-1960,1959-10-24,1960-05-09,199,0,161,612,773,78,346,424,1197,38,246,WI - Wausau
10,1960-1961,1960-11-29,1961-04-01,124,0,155,491,646,45,140,185,831,16,123,WI - Wausau
11,1961-1962,1961-11-06,1962-04-13,159,0,247,670,917,113,809,922,1839,40,370,WI - Wausau
12,1962-1963,1962-10-25,1963-04-23,181,5,283,739,1022,58,418,476,1498,29,265,WI - Wausau
13,1963-1964,1963-11-23,1964-04-14,144,0,154,588,742,50,260,310,1052,30,200,WI - Wausau
14,1964-1965,1964-11-19,1965-04-26,159,6,256,720,976,82,497,579,1555,31,240,WI - Wausau
15,1965-1966,1965-11-13,1966-04-21,160,0,175,556,731,53,264,317,1048,26,168,WI - Wausau
16,1966-1967,1966-11-01,1967-03-29,149,0,179,631,810,89,672,761,1571,41,340,WI - Wausau
17,1967-1968,1967-11-04,1968-04-04,153,0,195,594,789,37,271,308,1097,25,196,WI - Wausau
18,1968-1969,1968-11-09,1969-04-28,171,0,181,640,821,92,834,926,1747,27,224,WI - Wausau
19,1969-1970,1969-10-22,1970-05-02,193,0,208,712,920,75,684,759,1679,36,297,WI - Wausau
20,1970-1971,1970-11-14,1971-04-28,166,3,222,697,919,109,872,981,1900,44,355,WI - Wausau
21,1971-1972,1971-11-06,1972-04-22,169,0,229,745,974,115,903,1018,1992,42,362,WI - Wausau
22,1972-1973,1972-10-23,1973-05-03,193,0,169,522,691,85,507,592,1283,37,264,WI - Wausau
23,1973-1974,1973-11-04,1974-04-07,155,0,183,591,774,68,460,528,1302,36,220,WI - Wausau
24,1974-1975,1974-10-18,1975-04-12,177,0,140,610,750,99,699,798,1548,45,298,WI - Wausau
25,1975-1976,1975-11-20,1976-04-01,134,0,173,579,752,85,549,634,1386,42,340,WI - Wausau
26,1976-1977,1976-11-07,1977-04-07,152,0,277,739,1016,68,381,449,1465,33,319,WI - Wausau
27,1977-1978,1977-11-18,1978-04-02,136,0,229,676,905,75,626,701,1606,33,301,WI - Wausau
28,1978-1979,1978-11-14,1979-04-08,146,8,291,732,1023,88,837,925,1948,42,335,WI - Wausau
29,1979-1980,1979-10-23,1980-04-04,165,0,167,592,759,62,251,313,1072,27,175,WI - Wausau
30,1980-1981,1980-11-14,1981-03-19,126,0,166,507,673,31,228,259,932,12,120,WI - Wausau
31,1981-1982,1981-10-24,1982-04-21,180,6,222,687,909,100,695,795,1704,37,318,WI - Wausau
32,1982-1983,1982-10-20,1983-04-10,173,0,105,411,516,65,361,426,942,33,145,WI - Wausau
33,1983-1984,1983-11-11,1984-03-23,134,3,230,585,815,64,509,573,1388,31,215,WI - Wausau
34,1984-1985,1984-11-02,1985-04-03,153,3,181,562,743,113,278,391,1134,34,321,WI - Wausau
35,1985-1986,1985-11-08,1986-04-15,159,0,227,653,880,98,872,970,1850,47,406,WI - Wausau
36,1986-1987,1986-11-09,1987-04-03,146,0,104,422,526,52,302,354,880,21,130,WI - Wausau
37,1987-1988,1987-10-20,1988-04-27,191,2,173,551,724,60,376,436,1160,31,202,WI - Wausau
38,1988-1989,1988-10-24,1989-04-28,187,0,195,640,835,114,528,642,1477,53,429,WI - Wausau
39,1989-1990,1989-10-20,1990-05-10,203,0,172,604,776,76,393,469,1245,41,282,WI - Wausau
40,1990-1991,1990-10-10,1991-04-13,186,3,171,579,750,113,594,707,1457,41,347,WI - Wausau
41,1991-1992,1991-11-01,1992-04-22,174,0,132,515,647,106,576,682,1329,45,280,WI - Wausau
42,1992-1993,1992-10-15,1993-04-20,188,0,159,609,768,118,632,750,1518,66,341,WI - Wausau
43,1993-1994,1993-10-27,1994-04-29,185,0,238,650,888,107,419,526,1414,54,408,WI - Wausau
44,1994-1995,1994-11-26,1995-04-21,147,0,133,455,588,73,294,367,955,33,201,WI - Wausau
45,1995-1996,1995-10-21,1996-05-05,198,0,243,744,987,148,873,1021,2008,61,443,WI - Wausau
46,1996-1997,1996-10-31,1997-04-08,160,0,193,556,749,115,838,953,1702,54,388,WI - Wausau
47,1997-1998,1997-11-02,1998-04-17,167,0,90,334,424,101,376,477,901,45,237,WI - Wausau
48,1998-1999,1998-11-08,1999-04-22,166,0,135,437,572,84,542,626,1198,47,315,WI - Wausau
49,1999-2000,1999-11-26,2000-04-20,147,0,106,422,528,81,456,537,1065,46,278,WI - Wausau
50,2000-2001,2000-11-14,2001-04-16,154,7,203,595,798,102,767,869,1667,55,408,WI - Wausau
51,2001-2002,2001-10-25,2002-04-28,186,2,99,390,489,92,242,334,823,49,264,WI - Wausau
52,2002-2003,2002-10-18,2003-04-16,181,17,206,626,832,69,264,333,1165,38,303,WI - Wausau
53,2003-2004,2003-10-27,2004-04-11,168,3,156,532,688,101,542,643,1331,53,332,WI - Wausau
54,2004-2005,2004-11-25,2005-03-29,125,0,165,495,660,83,523,606,1266,44,295,WI - Wausau
55,2005-2006,2005-11-15,2006-05-11,178,0,131,435,566,76,421,497,1063,45,257,WI - Wausau
56,2006-2007,2006-10-12,2007-04-12,183,3,171,504,675,84,407,491,1166,38,251,WI - Wausau
57,2007-2008,2007-11-22,2008-04-14,145,0,218,621,839,116,922,1038,1877,54,401,WI - Wausau
58,2008-2009,2008-11-09,2009-04-05,148,13,242,674,916,95,618,713,1629,43,379,WI - Wausau
59,2009-2010,2009-10-12,2010-05-08,209,0,139,459,598,56,514,570,1168,32,206,WI - Wausau
60,2010-2011,2010-11-14,2011-05-03,171,5,213,573,786,118,840,958,1744,50,392,WI - Wausau
61,2011-2012,2011-11-09,2012-04-20,164,0,84,355,439,69,405,474,913,41,220,WI - Wausau
62,2012-2013,2012-11-06,2013-04-25,171,0,157,535,692,120,657,777,1469,55,336,WI - Wausau
63,2013-2014,2013-11-11,2014-04-17,158,0,335,805,1140,132,956,1088,2228,63,575,WI - Wausau
64,2014-2015,2014-10-31,2015-04-10,162,0,255,618,873,85,568,653,1526,43,314,WI - Wausau
65,2015-2016,2015-10-28,2016-04-08,164,0,109,356,465,72,382,454,919,36,206,WI - Wausau
66,2016-2017,2016-11-19,2017-04-27,160,3,157,431,588,82,462,544,1132,29,214,WI - Wausau
67,2017-2018,2017-10-31,2018-04-21,173,1,220,623,843,131,543,674,1517,49,398,WI - Wausau
68,2018-2019,2018-10-14,2019-04-15,184,0,230,617,847,135,524,659,1506,42,349,WI - Wausau
69,2019-2020,2019-10-31,2020-04-15,168,2,143,482,625,101,792,893,1518,39,253,WI - Wausau
0,1950-1951,1950-11-10,1951-04-04,146,0,178,665,843,118,848,966,1809,36,331,WI - Wisconsin Dells
1,1951-1952,1951-11-02,1952-03-31,151,0,131,575,706,108,618,726,1432,36,315,WI - Wisconsin Dells
2,1952-1953,1952-10-16,1953-03-25,161,0,83,451,534,67,448,515,1049,38,221,WI - Wisconsin Dells
3,1953-1954,1953-11-25,1954-05-03,160,0,76,424,500,44,104,148,648,23,143,WI - Wisconsin Dells
4,1954-1955,1954-11-01,1955-03-30,150,1,113,511,624,67,298,365,989,29,173,WI - Wisconsin Dells
5,1955-1956,1955-11-07,1956-04-29,175,2,112,624,736,70,402,472,1208,29,174,WI - Wisconsin Dells
6,1956-1957,1956-11-16,1957-04-05,141,0,120,515,635,32,243,275,910,19,114,WI - Wisconsin Dells
7,1957-1958,1957-11-08,1958-03-06,119,0,103,407,510,31,197,228,738,17,82,WI - Wisconsin Dells
8,1958-1959,1958-11-23,1959-04-05,134,0,181,691,872,104,657,761,1633,33,328,WI - Wisconsin Dells
9,1959-1960,1959-11-05,1960-04-17,165,1,93,529,622,63,357,420,1042,28,205,WI - Wisconsin Dells
10,1960-1961,1960-11-05,1961-04-17,164,0,114,491,605,27,97,124,729,12,78,WI - Wisconsin Dells
11,1961-1962,1961-11-19,1962-04-12,145,0,184,575,759,102,794,896,1655,33,280,WI - Wisconsin Dells
12,1962-1963,1962-12-01,1963-03-24,114,5,213,599,812,64,463,527,1339,26,240,WI - Wisconsin Dells
13,1963-1964,1963-11-30,1964-04-08,131,1,118,469,587,37,160,197,784,20,116,WI - Wisconsin Dells
14,1964-1965,1964-11-19,1965-04-05,138,1,188,623,811,63,287,350,1161,27,213,WI - Wisconsin Dells
15,1965-1966,1965-11-27,1966-03-26,120,1,133,451,584,38,227,265,849,17,149,WI - Wisconsin Dells
16,1966-1967,1966-11-03,1967-03-23,141,0,128,542,670,63,483,546,1216,26,194,WI - Wisconsin Dells
17,1967-1968,1967-11-05,1968-03-22,139,0,133,482,615,24,92,116,731,18,132,WI - Wisconsin Dells
18,1968-1969,1968-11-19,1969-04-02,135,3,147,544,691,72,672,744,1435,27,217,WI - Wisconsin Dells
19,1969-1970,1969-11-13,1970-03-28,136,1,156,567,723,50,500,550,1273,14,138,WI - Wisconsin Dells
20,1970-1971,1970-11-14,1971-04-04,142,7,179,579,758,91,770,861,1619,21,207,WI - Wisconsin Dells
21,1971-1972,1971-11-07,1972-04-07,153,3,162,576,738,65,426,491,1229,28,215,WI - Wisconsin Dells
22,1972-1973,1972-10-15,1973-04-14,182,1,128,445,573,70,263,333,906,25,177,WI - Wisconsin Dells
23,1973-1974,1973-11-09,1974-04-14,157,0,141,483,624,63,322,385,1009,32,232,WI - Wisconsin Dells
24,1974-1975,1974-11-14,1975-04-03,141,9,83,469,552,78,417,495,1047,35,181,WI - Wisconsin Dells
25,1975-1976,1975-11-21,1976-03-18,119,1,114,464,578,80,317,397,975,27,202,WI - Wisconsin Dells
26,1976-1977,1976-10-19,1977-04-07,171,4,274,678,952,62,339,401,1353,33,294,WI - Wisconsin Dells
27,1977-1978,1977-11-21,1978-04-02,133,0,199,657,856,78,705,783,1639,28,279,WI - Wisconsin Dells
28,1978-1979,1978-11-12,1979-04-02,142,17,204,653,857,98,764,862,1719,38,330,WI - Wisconsin Dells
29,1979-1980,1979-10-23,1980-04-14,175,4,120,508,628,28,81,109,737,12,77,WI - Wisconsin Dells
30,1980-1981,1980-11-27,1981-03-06,100,8,111,379,490,34,72,106,596,12,93,WI - Wisconsin Dells
36,1986-1987,1986-11-09,1987-03-30,142,8,74,435,509,38,0,38,547,11,80,WI - Wisconsin Dells
38,1988-1989,1988-11-05,1989-04-09,156,11,124,549,673,36,50,86,759,15,128,WI - Wisconsin Dells
39,1989-1990,1989-11-16,1990-03-23,128,0,126,525,651,32,193,225,876,13,103,WI - Wisconsin Dells
40,1990-1991,1990-10-10,1991-04-12,185,1,136,597,733,65,535,600,1333,19,162,WI - Wisconsin Dells
41,1991-1992,1991-11-01,1992-04-01,153,0,99,438,537,55,151,206,743,23,166,WI - Wisconsin Dells
42,1992-1993,1992-10-19,1993-04-19,183,12,126,572,698,74,415,489,1187,24,163,WI - Wisconsin Dells
43,1993-1994,1993-11-07,1994-04-05,150,1,210,653,863,80,433,513,1376,27,303,WI - Wisconsin Dells
44,1994-1995,1994-11-30,1995-04-11,133,1,106,456,562,58,246,304,866,14,117,WI - Wisconsin Dells
45,1995-1996,1995-11-01,1996-04-15,167,11,206,736,942,51,423,474,1416,19,178,WI - Wisconsin Dells
46,1996-1997,1996-11-10,1997-04-13,155,3,160,580,740,89,477,566,1306,27,209,WI - Wisconsin Dells
47,1997-1998,1997-10-27,1998-03-22,147,11,65,337,402,69,320,389,791,22,124,WI - Wisconsin Dells
48,1998-1999,1998-11-21,1999-03-14,114,7,103,414,517,48,301,349,866,17,195,WI - Wisconsin Dells
49,1999-2000,1999-12-01,2000-04-11,133,8,76,395,471,36,143,179,650,16,105,WI - Wisconsin Dells
50,2000-2001,2000-11-15,2001-03-25,131,1,157,598,755,66,634,700,1455,27,235,WI - Wisconsin Dells
51,2001-2002,2001-12-01,2002-04-02,123,2,57,355,412,39,135,174,586,18,117,WI - Wisconsin Dells
52,2002-2003,2002-11-24,2003-04-07,135,1,136,555,691,29,114,143,834,13,96,WI - Wisconsin Dells
53,2003-2004,2003-11-08,2004-03-17,131,6,110,449,559,47,253,300,859,12,92,WI - Wisconsin Dells
54,2004-2005,2004-12-01,2005-03-21,111,11,96,427,523,44,231,275,798,17,114,WI - Wisconsin Dells
55,2005-2006,2005-11-15,2006-03-17,123,1,90,410,500,46,183,229,729,17,117,WI - Wisconsin Dells
56,2006-2007,2006-11-10,2007-04-12,154,3,124,471,595,60,281,341,936,16,138,WI - Wisconsin Dells
57,2007-2008,2007-11-22,2008-03-26,126,4,167,646,813,143,739,882,1695,36,382,WI - Wisconsin Dells
58,2008-2009,2008-11-09,2009-03-29,141,10,171,653,824,99,436,535,1359,28,324,WI - Wisconsin Dells
59,2009-2010,2009-12-01,2010-03-13,103,0,111,447,558,67,506,573,1131,24,179,WI - Wisconsin Dells
60,2010-2011,2010-11-24,2011-04-20,148,0,150,562,712,98,646,744,1456,30,262,WI - Wisconsin Dells
61,2011-2012,2011-11-09,2012-03-06,119,0,64,350,414,46,147,193,607,24,150,WI - Wisconsin Dells
63,2013-2014,2013-11-12,2014-04-15,155,3,247,797,1044,99,566,665,1709,49,448,WI - Wisconsin Dells
64,2014-2015,2014-11-12,2015-03-25,134,0,180,556,736,44,280,324,1060,25,217,WI - Wisconsin Dells
65,2015-2016,2015-11-21,2016-04-08,140,0,90,353,443,52,314,366,809,23,151,WI - Wisconsin Dells
66,2016-2017,2016-11-21,2017-04-28,159,0,103,395,498,62,295,357,855,29,184,WI - Wisconsin Dells
67,2017-2018,2017-11-10,2018-04-21,163,0,151,563,714,75,187,262,976,37,276,WI - Wisconsin Dells
68,2018-2019,2018-11-09,2019-04-14,157,0,165,571,736,100,374,474,1210,34,286,WI - Wisconsin Dells
69,2019-2020,2019-10-29,2020-04-13,168,7,73,445,518,73,265,338,856,25,153,WI - Wisconsin Dells
0,1950-1951,1950-09-29,1951-06-02,247,3,93,588,681,203,894,1097,1778,54,407,WY - Alta
1,1951-1952,1951-10-15,1952-05-22,221,0,121,713,834,253,1446,1699,2533,59,476,WY - Alta
2,1952-1953,1952-11-14,1953-05-22,190,7,70,677,747,186,1028,1214,1961,55,400,WY - Alta
3,1953-1954,1953-11-17,1954-04-30,165,1,68,546,614,195,920,1115,1729,47,389,WY - Alta
4,1954-1955,1954-10-12,1955-05-27,228,8,161,777,938,206,1061,1267,2205,56,433,WY - Alta
5,1955-1956,1955-10-05,1956-05-12,221,5,119,651,770,167,1095,1262,2032,45,323,WY - Alta
6,1956-1957,1956-10-19,1957-05-21,215,8,102,709,811,162,1463,1625,2436,38,281,WY - Alta
7,1957-1958,1957-09-19,1958-04-30,224,8,54,645,699,160,1335,1495,2194,46,315,WY - Alta
8,1958-1959,1958-11-10,1959-05-09,181,19,68,504,572,94,911,1005,1577,31,182,WY - Alta
12,1962-1963,1962-10-14,1963-04-27,196,7,99,549,648,163,461,624,1272,35,291,WY - Alta
13,1963-1964,1963-11-04,1964-05-10,189,9,130,699,829,235,1766,2001,2830,45,419,WY - Alta
14,1964-1965,1964-08-29,1965-05-07,252,4,102,627,729,157,1095,1252,1981,49,340,WY - Alta
16,1966-1967,1966-10-02,1967-05-06,217,4,85,564,649,193,1187,1380,2029,47,341,WY - Alta
17,1967-1968,1967-11-03,1968-05-15,195,1,91,601,692,113,1365,1478,2170,29,231,WY - Alta
18,1968-1969,1968-09-21,1969-04-25,217,13,96,686,782,162,1266,1428,2210,46,335,WY - Alta
19,1969-1970,1969-10-03,1970-05-15,225,5,73,645,718,126,1351,1477,2195,35,218,WY - Alta
20,1970-1971,1970-10-24,1971-05-17,206,8,107,671,778,149,1335,1484,2262,34,288,WY - Alta
21,1971-1972,1971-10-01,1972-04-30,213,9,146,700,846,158,1301,1459,2305,34,303,WY - Alta
22,1972-1973,1972-10-28,1973-05-05,190,9,114,728,842,150,1406,1556,2398,34,251,WY - Alta
23,1973-1974,1973-10-08,1974-05-21,226,9,101,701,802,184,1328,1512,2314,51,367,WY - Alta
24,1974-1975,1974-10-21,1975-05-23,215,10,105,872,977,213,1627,1840,2817,46,395,WY - Alta
25,1975-1976,1975-10-07,1976-06-14,252,9,85,896,981,230,1680,1910,2891,48,436,WY - Alta
26,1976-1977,1976-10-25,1977-04-17,175,7,75,856,931,91,852,943,1874,25,232,WY - Alta
27,1977-1978,1977-11-08,1978-04-15,159,13,62,667,729,150,1243,1393,2122,37,318,WY - Alta
29,1979-1980,1979-10-27,1980-05-25,212,18,67,637,704,146,1203,1349,2053,34,246,WY - Alta
30,1980-1981,1980-10-14,1981-06-14,244,6,29,515,544,124,680,804,1348,28,193,WY - Alta
33,1983-1984,1983-10-16,1984-05-11,209,20,143,651,794,182,1760,1942,2736,45,329,WY - Alta
35,1985-1986,1985-10-08,1986-05-22,227,18,94,536,630,216,1300,1516,2146,45,347,WY - Alta
36,1986-1987,1986-09-28,1987-04-12,197,18,108,546,654,92,1051,1143,1797,21,147,WY - Alta
37,1987-1988,1987-11-14,1988-05-09,178,9,137,575,712,142,918,1060,1772,33,244,WY - Alta
38,1988-1989,1988-09-18,1989-05-13,238,17,176,615,791,210,1501,1711,2502,42,382,WY - Alta
39,1989-1990,1989-10-26,1990-05-12,199,7,115,532,647,128,1000,1128,1775,34,269,WY - Alta
40,1990-1991,1990-10-06,1991-05-01,208,13,139,626,765,153,1123,1276,2041,36,292,WY - Alta
41,1991-1992,1991-10-23,1992-04-23,184,10,86,485,571,99,1062,1161,1732,28,202,WY - Alta
44,1994-1995,1994-10-03,1995-04-30,210,13,105,561,666,200,1421,1621,2287,42,349,WY - Alta
45,1995-1996,1995-10-03,1996-04-25,206,1,99,535,634,148,984,1132,1766,26,244,WY - Alta
46,1996-1997,1996-10-20,1997-05-02,195,5,132,587,719,180,1225,1405,2124,48,375,WY - Alta
47,1997-1998,1997-10-10,1998-06-04,238,1,105,581,686,104,1240,1344,2030,31,197,WY - Alta
48,1998-1999,1998-10-04,1999-05-16,225,1,120,557,677,171,993,1164,1841,41,300,WY - Alta
49,1999-2000,1999-11-21,2000-05-12,174,3,77,455,532,158,1020,1178,1710,36,283,WY - Alta
50,2000-2001,2000-10-13,2001-06-13,244,3,130,681,811,184,1126,1310,2121,39,338,WY - Alta
51,2001-2002,2001-10-09,2002-05-22,226,0,161,660,821,136,1055,1191,2012,37,296,WY - Alta
52,2002-2003,2002-10-29,2003-05-05,189,5,82,501,583,143,896,1039,1622,39,265,WY - Alta
53,2003-2004,2003-10-29,2004-05-13,198,7,122,541,663,157,1327,1484,2147,35,294,WY - Alta
54,2004-2005,2004-10-18,2005-06-09,235,14,92,531,623,108,945,1053,1676,32,196,WY - Alta
55,2005-2006,2005-10-03,2006-04-18,198,10,141,585,726,150,1250,1400,2126,34,306,WY - Alta
56,2006-2007,2006-09-21,2007-06-07,260,8,138,601,739,170,1010,1180,1919,41,310,WY - Alta
57,2007-2008,2007-10-07,2008-06-12,250,3,166,706,872,212,1396,1608,2480,41,378,WY - Alta
58,2008-2009,2008-10-09,2009-05-03,207,1,113,575,688,213,1255,1468,2156,40,359,WY - Alta
60,2010-2011,2010-10-25,2011-05-30,218,0,151,602,753,280,1888,2168,2921,60,466,WY - Alta
61,2011-2012,2011-10-06,2012-05-24,232,1,121,598,719,193,1180,1373,2092,44,345,WY - Alta
62,2012-2013,2012-10-25,2013-05-01,189,0,139,583,722,152,953,1105,1827,36,301,WY - Alta
63,2013-2014,2013-10-03,2014-04-29,209,3,124,575,699,191,1225,1416,2115,50,348,WY - Alta
64,2014-2015,2014-11-10,2015-04-26,168,0,92,436,528,132,942,1074,1602,26,220,WY - Alta
65,2015-2016,2015-11-04,2016-05-10,189,0,113,496,609,169,1151,1320,1929,38,293,WY - Alta
66,2016-2017,2016-10-17,2017-05-17,213,4,139,523,662,200,1000,1200,1862,50,388,WY - Alta
67,2017-2018,2017-09-16,2018-05-01,228,0,97,542,639,192,1007,1199,1838,43,314,WY - Alta
68,2018-2019,2018-10-29,2019-04-25,179,0,132,593,725,202,1748,1950,2675,40,335,WY - Alta
69,2019-2020,2019-10-10,2020-05-23,227,0,116,595,711,206,1321,1527,2238,43,363,WY - Alta
0,1950-1951,1950-11-12,1951-04-21,161,19,79,685,764,27,4,31,795,16,98,WY - Basin
1,1951-1952,1951-11-02,1952-04-08,159,12,94,689,783,24,153,177,960,11,88,WY - Basin
2,1952-1953,1952-11-16,1953-05-22,188,2,41,490,531,55,95,150,681,16,93,WY - Basin
3,1953-1954,1953-11-19,1954-05-02,165,0,30,508,538,46,29,75,613,12,82,WY - Basin
4,1954-1955,1954-11-30,1955-04-04,126,1,43,538,581,29,33,62,643,12,85,WY - Basin
5,1955-1956,1955-11-11,1956-03-27,138,0,116,652,768,32,124,156,924,20,144,WY - Basin
6,1956-1957,1956-11-04,1957-04-25,173,3,124,738,862,27,114,141,1003,16,142,WY - Basin
7,1957-1958,1957-09-19,1958-03-16,179,1,18,499,517,34,60,94,611,13,77,WY - Basin
8,1958-1959,1958-11-15,1959-04-25,162,2,95,590,685,57,247,304,989,19,162,WY - Basin
10,1960-1961,1960-11-09,1961-03-28,140,1,51,557,608,22,140,162,770,7,55,WY - Basin
11,1961-1962,1961-11-15,1962-03-13,119,0,163,675,838,38,423,461,1299,14,146,WY - Basin
12,1962-1963,1962-12-01,1963-02-28,90,0,99,419,518,16,109,125,643,10,124,WY - Basin
13,1963-1964,1963-11-21,1964-03-28,129,0,112,584,696,39,295,334,1030,21,151,WY - Basin
15,1965-1966,1965-12-01,1966-04-19,140,0,49,480,529,45,48,93,622,11,90,WY - Basin
16,1966-1967,1966-11-08,1967-05-03,177,1,51,505,556,59,75,134,690,31,162,WY - Basin
17,1967-1968,1967-11-23,1968-04-21,151,0,106,567,673,36,223,259,932,19,173,WY - Basin
19,1969-1970,1969-11-13,1970-04-30,169,3,40,522,562,22,35,57,619,11,63,WY - Basin
20,1970-1971,1970-11-22,1971-03-22,121,1,103,501,604,31,142,173,777,15,114,WY - Basin
21,1971-1972,1971-10-28,1972-02-29,125,2,85,510,595,21,100,121,716,9,74,WY - Basin
22,1972-1973,1972-09-25,1973-02-28,157,0,176,766,942,25,324,349,1291,10,121,WY - Basin
25,1975-1976,1975-11-18,1976-04-02,137,13,116,598,714,32,153,185,899,14,110,WY - Basin
35,1985-1986,1985-09-28,1986-04-14,199,16,128,698,826,38,442,480,1306,17,130,WY - Basin
36,1986-1987,1986-11-06,1987-03-30,145,18,100,444,544,31,153,184,728,15,96,WY - Basin
37,1987-1988,1987-10-09,1988-03-16,160,2,105,591,696,16,84,100,796,11,79,WY - Basin
38,1988-1989,1988-11-24,1989-03-21,118,0,169,685,854,33,150,183,1037,14,172,WY - Basin
39,1989-1990,1989-11-01,1990-04-11,162,0,120,595,715,48,228,276,991,21,169,WY - Basin
40,1990-1991,1990-11-07,1991-04-18,163,0,159,654,813,31,87,118,931,14,153,WY - Basin
41,1991-1992,1991-10-28,1992-03-18,143,3,45,498,543,25,59,84,627,8,54,WY - Basin
42,1992-1993,1992-11-03,1993-03-18,136,5,222,805,1027,34,369,403,1430,11,98,WY - Basin
43,1993-1994,1993-10-09,1994-04-28,202,0,70,583,653,34,39,73,726,10,87,WY - Basin
44,1994-1995,1994-11-03,1995-03-07,125,1,67,471,538,8,7,15,553,3,19,WY - Basin
45,1995-1996,1995-10-31,1996-03-29,151,0,171,653,824,41,163,204,1028,15,158,WY - Basin
46,1996-1997,1996-11-16,1997-04-11,147,5,132,555,687,30,149,179,866,12,114,WY - Basin
47,1997-1998,1997-11-12,1998-03-30,139,2,63,533,596,45,127,172,768,13,96,WY - Basin
48,1998-1999,1998-11-08,1999-03-10,123,5,50,398,448,20,17,37,485,9,64,WY - Basin
49,1999-2000,1999-12-01,2000-03-08,99,4,52,371,423,24,89,113,536,7,50,WY - Basin
50,2000-2001,2000-09-22,2001-03-06,166,7,148,747,895,42,198,240,1135,14,122,WY - Basin
51,2001-2002,2001-11-18,2002-04-02,136,3,100,579,679,38,80,118,797,12,103,WY - Basin
52,2002-2003,2002-10-21,2003-03-09,140,3,123,589,712,48,168,216,928,15,118,WY - Basin
53,2003-2004,2003-10-30,2004-02-29,123,4,82,543,625,16,162,178,803,4,28,WY - Basin
54,2004-2005,2004-10-31,2005-04-21,173,3,58,513,571,25,18,43,614,10,76,WY - Basin
55,2005-2006,2005-10-05,2006-03-20,167,4,59,480,539,14,10,24,563,7,46,WY - Basin
56,2006-2007,2006-10-30,2007-03-29,151,1,105,587,692,26,122,148,840,9,94,WY - Basin
57,2007-2008,2007-11-20,2008-04-20,153,4,88,593,681,22,98,120,801,8,79,WY - Basin
58,2008-2009,2008-10-10,2009-03-29,171,3,112,619,731,47,110,157,888,16,155,WY - Basin
60,2010-2011,2010-11-15,2011-03-09,115,3,161,621,782,38,216,254,1036,16,169,WY - Basin
61,2011-2012,2011-11-05,2012-02-29,117,2,45,486,531,18,24,42,573,8,60,WY - Basin
62,2012-2013,2012-11-09,2013-04-22,165,5,110,649,759,34,171,205,964,14,100,WY - Basin
63,2013-2014,2013-10-29,2014-05-08,192,0,161,667,828,61,199,260,1088,22,205,WY - Basin
64,2014-2015,2014-11-10,2015-03-05,116,0,142,508,650,38,231,269,919,15,105,WY - Basin
65,2015-2016,2015-11-26,2016-03-29,125,0,49,375,424,20,98,118,542,7,45,WY - Basin
66,2016-2017,2016-10-12,2017-04-03,174,0,139,507,646,43,326,369,1015,18,140,WY - Basin
67,2017-2018,2017-11-07,2018-04-08,153,0,107,546,653,46,271,317,970,18,160,WY - Basin
68,2018-2019,2018-10-14,2019-03-10,148,0,74,516,590,32,68,100,690,17,99,WY - Basin
69,2019-2020,2019-10-10,2020-04-12,186,0,34,488,522,49,198,247,769,17,106,WY - Basin
0,1950-1951,1950-09-30,1951-06-01,245,0,81,525,606,87,33,120,726,48,318,WY - Casper
1,1951-1952,1951-09-21,1952-05-22,245,0,87,534,621,122,106,228,849,47,333,WY - Casper
2,1952-1953,1952-10-13,1953-05-13,213,0,73,451,524,99,122,221,745,46,263,WY - Casper
3,1953-1954,1953-11-18,1954-05-02,166,0,56,414,470,104,113,217,687,40,274,WY - Casper
4,1954-1955,1954-10-24,1955-04-27,186,0,95,493,588,120,213,333,921,49,359,WY - Casper
5,1955-1956,1955-10-22,1956-05-13,205,0,91,530,621,121,163,284,905,58,352,WY - Casper
6,1956-1957,1956-10-24,1957-04-26,185,0,86,519,605,110,141,251,856,49,343,WY - Casper
7,1957-1958,1957-10-24,1958-04-25,184,0,47,423,470,116,97,213,683,57,297,WY - Casper
8,1958-1959,1958-11-07,1959-05-10,185,0,78,476,554,111,101,212,766,58,374,WY - Casper
9,1959-1960,1959-09-27,1960-04-29,216,0,112,571,683,83,123,206,889,49,346,WY - Casper
10,1960-1961,1960-10-09,1961-04-14,188,0,40,395,435,78,92,170,605,42,205,WY - Casper
11,1961-1962,1961-09-21,1962-04-21,213,0,155,607,762,98,178,276,1038,58,429,WY - Casper
12,1962-1963,1962-09-08,1963-04-28,233,0,91,478,569,70,65,135,704,49,325,WY - Casper
13,1963-1964,1963-10-30,1964-04-26,180,1,100,527,627,110,186,296,923,53,368,WY - Casper
14,1964-1965,1964-11-11,1965-05-09,180,0,109,561,670,105,148,253,923,51,370,WY - Casper
15,1965-1966,1965-09-15,1966-06-05,264,0,81,504,585,94,125,219,804,43,300,WY - Casper
16,1966-1967,1966-10-02,1967-05-13,224,0,60,497,557,121,110,231,788,64,343,WY - Casper
17,1967-1968,1967-10-23,1968-05-16,207,0,98,546,644,118,149,267,911,60,381,WY - Casper
18,1968-1969,1968-10-16,1969-06-13,241,0,82,552,634,91,104,195,829,44,286,WY - Casper
19,1969-1970,1969-10-03,1970-05-14,224,0,63,538,601,112,117,229,830,56,288,WY - Casper
20,1970-1971,1970-09-24,1971-05-18,237,0,84,537,621,133,145,278,899,62,340,WY - Casper
21,1971-1972,1971-09-16,1972-05-01,229,0,100,559,659,125,151,276,935,55,352,WY - Casper
22,1972-1973,1972-09-29,1973-05-03,217,0,147,596,743,164,231,395,1138,59,423,WY - Casper
23,1973-1974,1973-10-09,1974-05-02,206,0,93,476,569,119,145,264,833,53,379,WY - Casper
24,1974-1975,1974-09-11,1975-05-25,257,0,114,558,672,164,154,318,990,69,461,WY - Casper
25,1975-1976,1975-10-22,1976-05-15,207,0,87,479,566,102,171,273,839,46,311,WY - Casper
26,1976-1977,1976-10-17,1977-04-19,185,0,63,495,558,99,100,199,757,40,272,WY - Casper
27,1977-1978,1977-10-09,1978-05-18,222,0,107,557,664,157,204,361,1025,58,434,WY - Casper
28,1978-1979,1978-10-22,1979-05-10,201,0,190,706,896,174,299,473,1369,67,561,WY - Casper
29,1979-1980,1979-10-29,1980-05-13,198,0,112,582,694,150,222,372,1066,55,448,WY - Casper
30,1980-1981,1980-10-16,1981-05-04,201,0,42,395,437,93,75,168,605,43,266,WY - Casper
31,1981-1982,1981-10-13,1982-05-11,211,0,90,551,641,109,81,190,831,60,418,WY - Casper
32,1982-1983,1982-09-14,1983-05-12,241,0,57,417,474,213,269,482,956,64,385,WY - Casper
33,1983-1984,1983-09-19,1984-05-06,231,0,145,602,747,206,346,552,1299,72,524,WY - Casper
34,1984-1985,1984-09-23,1985-04-27,217,0,112,652,764,113,156,269,1033,57,403,WY - Casper
35,1985-1986,1985-09-22,1986-05-16,237,0,112,531,643,151,261,412,1055,59,413,WY - Casper
36,1986-1987,1986-10-02,1987-04-20,201,0,78,453,531,161,276,437,968,61,396,WY - Casper
37,1987-1988,1987-10-13,1988-05-02,203,0,91,535,626,98,197,295,921,47,298,WY - Casper
38,1988-1989,1988-11-09,1989-04-30,173,0,146,549,695,89,189,278,973,49,426,WY - Casper
39,1989-1990,1989-10-15,1990-05-11,209,1,52,477,529,84,102,186,715,48,268,WY - Casper
40,1990-1991,1990-10-06,1991-05-04,211,0,100,531,631,96,156,252,883,43,307,WY - Casper
41,1991-1992,1991-10-03,1992-03-31,181,0,41,363,404,70,114,184,588,37,204,WY - Casper
42,1992-1993,1992-10-06,1993-05-08,215,0,94,519,613,123,258,381,994,52,361,WY - Casper
43,1993-1994,1993-09-13,1994-04-28,228,0,57,429,486,104,132,236,722,58,327,WY - Casper
44,1994-1995,1994-09-21,1995-06-09,262,0,63,411,474,148,164,312,786,56,316,WY - Casper
54,2004-2005,2004-10-25,2005-04-29,187,5,46,424,470,87,19,106,576,35,211,WY - Casper
55,2005-2006,2005-10-04,2006-05-04,213,12,79,463,542,109,45,154,696,38,272,WY - Casper
56,2006-2007,2006-10-09,2007-05-06,210,0,81,498,579,95,129,224,803,39,279,WY - Casper
57,2007-2008,2007-10-20,2008-05-10,204,0,89,569,658,93,132,225,883,50,315,WY - Casper
58,2008-2009,2008-10-10,2009-04-26,199,0,81,519,600,109,100,209,809,41,308,WY - Casper
59,2009-2010,2009-09-30,2010-05-12,225,0,91,585,676,116,194,310,986,51,365,WY - Casper
60,2010-2011,2010-11-09,2011-05-19,192,2,96,499,595,101,181,282,877,48,301,WY - Casper
61,2011-2012,2011-10-25,2012-04-16,175,0,49,426,475,79,93,172,647,38,226,WY - Casper
62,2012-2013,2012-10-05,2013-05-02,210,0,79,540,619,125,116,241,860,45,336,WY - Casper
63,2013-2014,2013-09-27,2014-05-11,227,2,114,608,722,134,149,283,1005,58,450,WY - Casper
64,2014-2015,2014-09-11,2015-05-20,252,0,89,496,585,101,156,257,842,44,303,WY - Casper
65,2015-2016,2015-11-18,2016-04-30,165,0,76,405,481,127,217,344,825,42,303,WY - Casper
66,2016-2017,2016-11-17,2017-05-19,184,0,96,466,562,109,151,260,822,42,296,WY - Casper
67,2017-2018,2017-10-02,2018-04-17,198,1,79,538,617,110,192,302,919,46,320,WY - Casper
68,2018-2019,2018-10-05,2019-05-22,230,0,81,562,643,120,118,238,881,57,365,WY - Casper
69,2019-2020,2019-10-09,2020-04-16,191,0,95,519,614,146,247,393,1007,51,382,WY - Casper
0,1950-1951,1950-10-01,1951-04-26,208,1,67,497,564,60,69,129,693,38,280,WY - Cheyenne
1,1951-1952,1951-10-05,1952-04-22,201,2,64,509,573,85,110,195,768,41,241,WY - Cheyenne
2,1952-1953,1952-10-05,1953-05-12,220,0,59,456,515,91,142,233,748,39,243,WY - Cheyenne
3,1953-1954,1953-10-03,1954-05-03,213,1,45,404,449,70,74,144,593,35,212,WY - Cheyenne
4,1954-1955,1954-09-29,1955-05-02,216,1,72,484,556,70,157,227,783,34,242,WY - Cheyenne
5,1955-1956,1955-10-06,1956-05-13,221,0,78,504,582,68,159,227,809,35,238,WY - Cheyenne
6,1956-1957,1956-11-01,1957-05-18,199,0,56,448,504,106,187,293,797,47,323,WY - Cheyenne
7,1957-1958,1957-10-25,1958-04-26,184,0,52,422,474,73,94,167,641,48,244,WY - Cheyenne
8,1958-1959,1958-11-05,1959-05-22,199,1,73,465,538,110,158,268,806,54,333,WY - Cheyenne
9,1959-1960,1959-09-29,1960-04-30,215,3,97,515,612,62,89,151,763,35,241,WY - Cheyenne
10,1960-1961,1960-11-04,1961-05-16,194,0,52,431,483,93,151,244,727,43,243,WY - Cheyenne
11,1961-1962,1961-09-21,1962-04-10,202,1,128,589,717,73,168,241,958,43,333,WY - Cheyenne
12,1962-1963,1962-11-15,1963-04-27,164,0,91,444,535,57,115,172,707,34,244,WY - Cheyenne
13,1963-1964,1963-11-16,1964-05-08,175,0,73,493,566,51,55,106,672,42,243,WY - Cheyenne
14,1964-1965,1964-11-13,1965-05-25,194,0,71,470,541,59,75,134,675,41,242,WY - Cheyenne
15,1965-1966,1965-09-16,1966-04-21,218,1,50,435,485,31,38,69,554,25,122,WY - Cheyenne
16,1966-1967,1966-10-13,1967-05-14,214,3,29,364,393,85,49,134,527,43,209,WY - Cheyenne
17,1967-1968,1967-10-15,1968-05-16,215,1,47,465,512,55,79,134,646,35,192,WY - Cheyenne
18,1968-1969,1968-10-08,1969-04-15,190,0,51,433,484,43,60,103,587,28,143,WY - Cheyenne
19,1969-1970,1969-10-03,1970-04-23,203,0,44,449,493,84,147,231,724,38,185,WY - Cheyenne
20,1970-1971,1970-10-06,1971-05-18,225,0,63,459,522,101,132,233,755,46,248,WY - Cheyenne
21,1971-1972,1971-09-16,1972-05-13,241,1,49,430,479,66,60,126,605,31,182,WY - Cheyenne
22,1972-1973,1972-10-27,1973-05-01,187,0,110,506,616,109,234,343,959,56,357,WY - Cheyenne
23,1973-1974,1973-10-09,1974-04-13,187,0,73,372,445,90,150,240,685,36,236,WY - Cheyenne
24,1974-1975,1974-09-11,1975-05-06,238,1,71,525,596,68,65,133,729,43,258,WY - Cheyenne
25,1975-1976,1975-09-19,1976-04-28,223,1,54,444,498,76,165,241,739,35,266,WY - Cheyenne
26,1976-1977,1976-10-05,1977-04-18,196,1,40,499,539,58,45,103,642,39,199,WY - Cheyenne
27,1977-1978,1977-10-10,1978-05-09,212,1,73,465,538,76,117,193,731,36,251,WY - Cheyenne
28,1978-1979,1978-09-20,1979-05-10,233,0,105,514,619,112,232,344,963,47,286,WY - Cheyenne
29,1979-1980,1979-10-29,1980-05-12,197,0,73,453,526,171,455,626,1152,49,390,WY - Cheyenne
30,1980-1981,1980-10-15,1981-05-13,211,0,27,337,364,50,49,99,463,37,161,WY - Cheyenne
31,1981-1982,1981-10-17,1982-05-13,209,1,54,444,498,51,39,90,588,37,219,WY - Cheyenne
32,1982-1983,1982-10-08,1983-05-18,223,0,49,433,482,142,179,321,803,39,267,WY - Cheyenne
33,1983-1984,1983-10-11,1984-04-29,202,0,134,553,687,149,273,422,1109,58,466,WY - Cheyenne
34,1984-1985,1984-09-24,1985-05-13,232,0,81,560,641,57,75,132,773,41,241,WY - Cheyenne
35,1985-1986,1985-09-22,1986-05-16,237,1,79,421,500,102,188,290,790,56,330,WY - Cheyenne
36,1986-1987,1986-10-02,1987-04-21,202,1,55,409,464,78,104,182,646,43,211,WY - Cheyenne
37,1987-1988,1987-10-09,1988-05-02,207,0,87,494,581,104,258,362,943,49,331,WY - Cheyenne
38,1988-1989,1988-09-12,1989-04-27,228,0,95,475,570,70,113,183,753,39,291,WY - Cheyenne
39,1989-1990,1989-09-11,1990-05-12,244,0,63,449,512,127,226,353,865,55,359,WY - Cheyenne
40,1990-1991,1990-10-06,1991-04-29,206,0,76,464,540,82,95,177,717,47,313,WY - Cheyenne
41,1991-1992,1991-10-04,1992-05-27,237,0,40,358,398,88,143,231,629,37,211,WY - Cheyenne
42,1992-1993,1992-10-06,1993-06-07,245,0,75,461,536,125,314,439,975,58,336,WY - Cheyenne
43,1993-1994,1993-09-13,1994-04-29,229,0,53,455,508,118,179,297,805,57,323,WY - Cheyenne
44,1994-1995,1994-09-21,1995-05-23,245,0,57,378,435,100,109,209,644,51,274,WY - Cheyenne
45,1995-1996,1995-09-20,1996-05-26,250,3,78,496,574,95,98,193,767,44,266,WY - Cheyenne
46,1996-1997,1996-09-26,1997-05-28,245,0,96,489,585,99,117,216,801,50,331,WY - Cheyenne
47,1997-1998,1997-10-12,1998-06-05,237,0,49,430,479,79,93,172,651,49,225,WY - Cheyenne
48,1998-1999,1998-10-17,1999-05-17,213,0,53,365,418,78,84,162,580,39,205,WY - Cheyenne
49,1999-2000,1999-09-28,2000-05-17,233,0,22,339,361,70,56,126,487,35,156,WY - Cheyenne
50,2000-2001,2000-09-22,2001-05-20,241,1,70,475,545,131,95,226,771,55,341,WY - Cheyenne
51,2001-2002,2001-10-04,2002-05-24,233,0,57,493,550,64,47,111,661,41,232,WY - Cheyenne
52,2002-2003,2002-10-02,2003-05-10,221,3,62,363,425,106,65,171,596,45,256,WY - Cheyenne
53,2003-2004,2003-09-14,2004-05-25,255,0,48,369,417,73,54,127,544,39,184,WY - Cheyenne
54,2004-2005,2004-10-31,2005-05-11,193,0,38,326,364,96,50,146,510,41,229,WY - Cheyenne
55,2005-2006,2005-10-09,2006-05-09,213,0,67,377,444,85,89,174,618,35,242,WY - Cheyenne
56,2006-2007,2006-10-09,2007-06-07,242,0,71,447,518,78,87,165,683,30,242,WY - Cheyenne
57,2007-2008,2007-10-14,2008-05-10,210,0,72,476,548,71,108,179,727,42,218,WY - Cheyenne
58,2008-2009,2008-10-12,2009-05-10,211,0,51,413,464,103,86,189,653,39,250,WY - Cheyenne
59,2009-2010,2009-10-08,2010-05-13,218,0,74,480,554,155,162,317,871,56,363,WY - Cheyenne
60,2010-2011,2010-10-25,2011-05-19,207,0,64,428,492,90,69,159,651,56,269,WY - Cheyenne
61,2011-2012,2011-10-08,2012-05-11,217,0,38,414,452,79,92,171,623,37,212,WY - Cheyenne
62,2012-2013,2012-10-06,2013-05-03,210,3,76,495,571,125,121,246,817,45,317,WY - Cheyenne
63,2013-2014,2013-10-04,2014-05-13,222,0,86,482,568,136,156,292,860,57,379,WY - Cheyenne
64,2014-2015,2014-09-11,2015-05-11,243,0,69,387,456,85,82,167,623,42,265,WY - Cheyenne
65,2015-2016,2015-11-04,2016-05-16,195,0,51,358,409,135,182,317,726,47,265,WY - Cheyenne
66,2016-2017,2016-11-17,2017-05-20,185,0,52,350,402,82,76,158,560,32,210,WY - Cheyenne
67,2017-2018,2017-10-02,2018-04-24,205,0,35,410,445,84,64,148,593,46,250,WY - Cheyenne
68,2018-2019,2018-10-10,2019-05-22,225,0,63,457,520,121,78,199,719,51,312,WY - Cheyenne
69,2019-2020,2019-10-09,2020-04-17,192,0,60,440,500,109,133,242,742,51,322,WY - Cheyenne
0,1950-1951,1950-10-01,1951-04-19,201,18,80,592,672,50,54,104,776,22,173,WY - Gillette
5,1955-1956,1955-09-25,1956-04-28,217,18,124,641,765,102,280,382,1147,41,304,WY - Gillette
6,1956-1957,1956-10-24,1957-04-17,176,18,116,603,719,76,94,170,889,37,304,WY - Gillette
7,1957-1958,1957-10-07,1958-04-28,204,14,58,469,527,80,101,181,708,47,286,WY - Gillette
9,1959-1960,1959-09-29,1960-04-27,212,3,133,610,743,83,144,227,970,47,386,WY - Gillette
10,1960-1961,1960-11-04,1961-04-24,172,4,53,431,484,85,199,284,768,35,207,WY - Gillette
11,1961-1962,1961-10-08,1962-03-31,175,12,171,589,760,76,241,317,1077,43,373,WY - Gillette
12,1962-1963,1962-09-09,1963-04-23,227,2,98,506,604,106,167,273,877,48,363,WY - Gillette
13,1963-1964,1963-10-31,1964-05-11,194,3,90,526,616,95,230,325,941,51,320,WY - Gillette
14,1964-1965,1964-11-12,1965-05-10,180,1,121,578,699,142,342,484,1183,50,364,WY - Gillette
15,1965-1966,1965-09-16,1966-05-11,238,0,81,549,630,99,143,242,872,46,321,WY - Gillette
16,1966-1967,1966-10-14,1967-05-06,205,1,66,513,579,110,166,276,855,44,316,WY - Gillette
17,1967-1968,1967-10-24,1968-04-23,183,1,83,570,653,87,184,271,924,42,292,WY - Gillette
18,1968-1969,1968-11-05,1969-06-13,221,13,128,604,732,114,293,407,1139,49,365,WY - Gillette
19,1969-1970,1969-10-11,1970-05-14,216,2,85,525,610,126,206,332,942,53,336,WY - Gillette
20,1970-1971,1970-09-13,1971-05-19,249,0,104,592,696,126,299,425,1121,50,351,WY - Gillette
21,1971-1972,1971-09-28,1972-05-01,217,0,108,570,678,116,170,286,964,47,341,WY - Gillette
22,1972-1973,1972-09-25,1973-04-23,211,2,128,604,732,125,158,283,1015,44,395,WY - Gillette
23,1973-1974,1973-10-09,1974-04-13,187,0,91,476,567,96,152,248,815,42,263,WY - Gillette
24,1974-1975,1974-10-05,1975-05-25,233,1,87,563,650,115,110,225,875,54,344,WY - Gillette
25,1975-1976,1975-10-23,1976-04-30,191,1,81,474,555,101,208,309,864,51,333,WY - Gillette
26,1976-1977,1976-10-18,1977-04-18,183,5,79,561,640,130,456,586,1226,51,412,WY - Gillette
27,1977-1978,1977-10-10,1978-05-08,211,2,153,620,773,114,333,447,1220,52,416,WY - Gillette
28,1978-1979,1978-11-09,1979-05-09,182,1,223,725,948,130,553,683,1631,61,537,WY - Gillette
29,1979-1980,1979-10-21,1980-04-11,174,0,81,509,590,95,83,178,768,52,345,WY - Gillette
30,1980-1981,1980-09-16,1981-04-03,200,0,41,369,410,53,39,92,502,29,176,WY - Gillette
31,1981-1982,1981-10-21,1982-05-10,202,2,109,577,686,108,124,232,918,59,431,WY - Gillette
32,1982-1983,1982-09-30,1983-05-12,225,9,37,410,447,110,126,236,683,49,243,WY - Gillette
33,1983-1984,1983-09-19,1984-05-06,231,5,155,591,746,134,340,474,1220,53,356,WY - Gillette
34,1984-1985,1984-09-24,1985-04-24,213,2,117,580,697,63,103,166,863,41,232,WY - Gillette
35,1985-1986,1985-09-23,1986-05-23,243,1,152,537,689,102,317,419,1108,57,322,WY - Gillette
36,1986-1987,1986-10-11,1987-04-20,192,3,85,401,486,70,147,217,703,33,194,WY - Gillette
37,1987-1988,1987-10-09,1988-05-02,207,2,107,524,631,74,80,154,785,47,285,WY - Gillette
38,1988-1989,1988-09-19,1989-05-13,237,2,176,566,742,88,149,237,979,54,407,WY - Gillette
39,1989-1990,1989-10-15,1990-05-13,211,3,96,495,591,119,246,365,956,46,316,WY - Gillette
40,1990-1991,1990-10-06,1991-05-03,210,1,155,550,705,91,159,250,955,49,311,WY - Gillette
41,1991-1992,1991-10-24,1992-05-16,206,1,51,388,439,49,73,122,561,25,141,WY - Gillette
42,1992-1993,1992-10-06,1993-04-30,207,7,194,619,813,109,240,349,1162,60,440,WY - Gillette
43,1993-1994,1993-10-08,1994-04-30,205,4,116,519,635,115,171,286,921,60,430,WY - Gillette
44,1994-1995,1994-09-21,1995-05-14,236,2,89,431,520,76,57,133,653,45,236,WY - Gillette
45,1995-1996,1995-09-19,1996-04-28,223,11,146,612,758,107,284,391,1149,36,325,WY - Gillette
46,1996-1997,1996-09-25,1997-05-18,236,4,144,650,794,168,470,638,1432,53,414,WY - Gillette
47,1997-1998,1997-10-13,1998-06-04,235,1,77,475,552,104,259,363,915,38,246,WY - Gillette
48,1998-1999,1998-11-03,1999-04-14,163,1,59,402,461,92,176,268,729,27,195,WY - Gillette
49,1999-2000,1999-11-18,2000-04-16,151,0,25,335,360,70,113,183,543,24,142,WY - Gillette
50,2000-2001,2000-09-22,2001-04-22,213,3,109,588,697,98,345,443,1140,43,299,WY - Gillette
51,2001-2002,2001-10-18,2002-05-08,203,6,85,554,639,81,151,232,871,35,227,WY - Gillette
52,2002-2003,2002-10-02,2003-04-07,188,6,70,477,547,101,196,297,844,36,278,WY - Gillette
53,2003-2004,2003-10-30,2004-04-29,183,0,70,457,527,67,154,221,748,31,202,WY - Gillette
54,2004-2005,2004-10-29,2005-05-12,196,7,56,418,474,104,157,261,735,26,214,WY - Gillette
58,2008-2009,2008-10-10,2009-04-26,199,5,74,506,580,108,154,262,842,37,266,WY - Gillette
59,2009-2010,2009-10-05,2010-05-12,220,6,88,514,602,73,107,180,782,28,219,WY - Gillette
60,2010-2011,2010-10-27,2011-04-29,185,3,96,523,619,88,236,324,943,38,253,WY - Gillette
61,2011-2012,2011-11-01,2012-03-04,125,12,26,380,406,52,77,129,535,24,123,WY - Gillette
62,2012-2013,2012-10-05,2013-04-24,202,3,61,494,555,83,99,182,737,43,257,WY - Gillette
64,2014-2015,2014-09-11,2015-05-10,242,0,88,424,512,62,110,172,684,29,200,WY - Gillette
65,2015-2016,2015-11-20,2016-04-27,160,1,45,326,371,56,102,158,529,25,141,WY - Gillette
66,2016-2017,2016-11-17,2017-04-29,164,0,109,413,522,77,229,306,828,25,214,WY - Gillette
67,2017-2018,2017-12-01,2018-04-23,144,1,83,377,460,94,137,231,691,33,250,WY - Gillette
68,2018-2019,2018-09-28,2019-05-22,237,0,115,520,635,96,118,214,849,36,247,WY - Gillette
69,2019-2020,2019-10-10,2020-04-16,190,2,55,427,482,82,102,184,666,30,191,WY - Gillette
0,1950-1951,1950-10-01,1951-06-01,244,2,63,784,847,52,74,126,973,25,174,WY - Kaycee
1,1951-1952,1951-10-15,1952-03-31,169,13,64,727,791,37,33,70,861,22,147,WY - Kaycee
2,1952-1953,1952-11-21,1953-05-13,174,0,35,564,599,43,93,136,735,22,135,WY - Kaycee
3,1953-1954,1953-11-18,1954-05-02,166,2,46,504,550,69,137,206,756,32,160,WY - Kaycee
4,1954-1955,1954-10-24,1955-04-11,170,4,58,624,682,95,122,217,899,36,257,WY - Kaycee
5,1955-1956,1955-09-25,1956-04-23,212,0,92,751,843,83,257,340,1183,28,224,WY - Kaycee
6,1956-1957,1956-11-03,1957-04-27,176,0,71,657,728,53,51,104,832,30,193,WY - Kaycee
7,1957-1958,1957-10-07,1958-04-23,199,0,31,555,586,78,87,165,751,39,201,WY - Kaycee
8,1958-1959,1958-11-11,1959-05-05,176,5,69,597,666,73,214,287,953,36,248,WY - Kaycee
9,1959-1960,1959-10-29,1960-04-29,184,6,89,652,741,64,128,192,933,28,273,WY - Kaycee
10,1960-1961,1960-11-04,1961-04-26,174,2,18,517,535,51,55,106,641,21,125,WY - Kaycee
11,1961-1962,1961-09-29,1962-03-31,184,1,119,720,839,79,326,405,1244,37,271,WY - Kaycee
12,1962-1963,1962-11-21,1963-04-22,153,0,69,591,660,34,111,145,805,19,163,WY - Kaycee
13,1963-1964,1963-10-31,1964-04-12,165,2,54,641,695,43,85,128,823,30,186,WY - Kaycee
14,1964-1965,1964-11-14,1965-05-09,177,0,65,654,719,83,249,332,1051,37,269,WY - Kaycee
15,1965-1966,1965-09-16,1966-04-29,226,0,50,656,706,57,79,136,842,24,169,WY - Kaycee
16,1966-1967,1966-11-08,1967-05-13,187,2,32,540,572,100,168,268,840,36,243,WY - Kaycee
17,1967-1968,1967-10-26,1968-04-21,179,2,64,646,710,82,150,232,942,39,310,WY - Kaycee
18,1968-1969,1968-11-25,1969-06-13,201,0,67,623,690,60,155,215,905,31,214,WY - Kaycee
19,1969-1970,1969-10-12,1970-04-28,199,3,46,632,678,50,53,103,781,27,131,WY - Kaycee
20,1970-1971,1970-09-13,1971-04-26,226,0,50,669,719,50,83,133,852,29,180,WY - Kaycee
21,1971-1972,1971-10-27,1972-04-20,177,1,67,592,659,86,267,353,1012,35,258,WY - Kaycee
22,1972-1973,1972-09-25,1973-05-01,219,0,102,719,821,103,129,232,1053,34,252,WY - Kaycee
23,1973-1974,1973-10-10,1974-04-21,194,0,63,567,630,59,99,158,788,35,211,WY - Kaycee
24,1974-1975,1974-11-13,1975-05-20,189,2,50,591,641,82,106,188,829,42,258,WY - Kaycee
25,1975-1976,1975-10-23,1976-04-27,188,1,55,595,650,87,269,356,1006,42,299,WY - Kaycee
26,1976-1977,1976-10-17,1977-04-19,185,0,35,641,676,63,70,133,809,32,184,WY - Kaycee
27,1977-1978,1977-10-10,1978-05-07,210,0,76,679,755,65,186,251,1006,35,263,WY - Kaycee
28,1978-1979,1978-11-09,1979-05-10,183,0,157,892,1049,80,650,730,1779,35,257,WY - Kaycee
29,1979-1980,1979-11-09,1980-04-11,155,3,62,566,628,49,58,107,735,34,187,WY - Kaycee
30,1980-1981,1980-11-13,1981-04-04,143,0,24,418,442,31,53,84,526,17,108,WY - Kaycee
31,1981-1982,1981-11-24,1982-05-10,168,2,50,588,638,64,118,182,820,34,242,WY - Kaycee
32,1982-1983,1982-09-14,1983-05-12,241,3,18,478,496,46,93,139,635,25,114,WY - Kaycee
33,1983-1984,1983-11-08,1984-04-28,173,10,110,670,780,52,230,282,1062,19,136,WY - Kaycee
35,1985-1986,1985-09-28,1986-04-13,198,18,101,607,708,42,293,335,1043,16,121,WY - Kaycee
39,1989-1990,1989-10-31,1990-04-10,162,4,45,521,566,64,59,123,689,22,145,WY - Kaycee
40,1990-1991,1990-11-01,1991-04-26,177,4,99,605,704,73,201,274,978,22,212,WY - Kaycee
41,1991-1992,1991-10-23,1992-03-20,150,9,32,483,515,51,47,98,613,16,110,WY - Kaycee
47,1997-1998,1997-10-23,1998-06-03,224,14,59,599,658,118,257,375,1033,28,233,WY - Kaycee
48,1998-1999,1998-10-29,1999-04-22,176,14,52,478,530,53,81,134,664,17,125,WY - Kaycee
59,2009-2010,2009-10-09,2010-05-12,216,18,104,648,752,47,130,177,929,19,137,WY - Kaycee
60,2010-2011,2010-11-15,2011-04-30,167,7,90,593,683,47,139,186,869,18,128,WY - Kaycee
61,2011-2012,2011-11-02,2012-03-04,124,0,39,441,480,40,68,108,588,10,90,WY - Kaycee
62,2012-2013,2012-10-05,2013-04-24,202,3,61,594,655,54,77,131,786,18,119,WY - Kaycee
63,2013-2014,2013-09-27,2014-04-15,201,3,125,614,739,75,178,253,992,28,191,WY - Kaycee
64,2014-2015,2014-09-12,2015-05-20,251,1,83,590,673,57,208,265,938,15,126,WY - Kaycee
65,2015-2016,2015-11-21,2016-04-27,159,0,57,451,508,36,93,129,637,12,87,WY - Kaycee
66,2016-2017,2016-11-17,2017-05-19,184,0,87,539,626,59,143,202,828,12,113,WY - Kaycee
67,2017-2018,2017-10-14,2018-04-18,187,0,93,670,763,71,181,252,1015,19,152,WY - Kaycee
68,2018-2019,2018-09-28,2019-05-22,237,0,97,625,722,70,90,160,882,27,195,WY - Kaycee
69,2019-2020,2019-10-11,2020-04-17,190,0,62,619,681,91,198,289,970,24,179,WY - Kaycee
0,1950-1951,1950-10-01,1951-06-02,245,1,70,562,632,113,123,236,868,35,291,WY - Lander
1,1951-1952,1951-10-31,1952-05-15,198,0,95,637,732,89,275,364,1096,31,226,WY - Lander
2,1952-1953,1952-10-13,1953-05-12,212,0,75,557,632,155,364,519,1151,40,299,WY - Lander
3,1953-1954,1953-10-21,1954-05-03,195,0,44,454,498,112,188,300,798,32,222,WY - Lander
4,1954-1955,1954-10-24,1955-04-12,171,0,78,599,677,120,323,443,1120,33,314,WY - Lander
5,1955-1956,1955-09-24,1956-05-13,233,0,128,663,791,136,306,442,1233,38,285,WY - Lander
6,1956-1957,1956-10-24,1957-05-15,204,0,79,573,652,109,212,321,973,28,227,WY - Lander
7,1957-1958,1957-09-19,1958-05-14,238,0,46,528,574,130,317,447,1021,35,235,WY - Lander
8,1958-1959,1958-11-10,1959-05-23,195,0,92,548,640,195,418,613,1253,49,389,WY - Lander
9,1959-1960,1959-09-28,1960-04-29,215,0,126,647,773,123,427,550,1323,38,300,WY - Lander
10,1960-1961,1960-10-09,1961-04-25,199,0,62,548,610,109,323,432,1042,32,198,WY - Lander
11,1961-1962,1961-09-23,1962-04-07,197,0,193,725,918,156,555,711,1629,42,388,WY - Lander
12,1962-1963,1962-09-08,1963-04-25,230,0,124,578,702,123,306,429,1131,31,306,WY - Lander
13,1963-1964,1963-10-30,1964-05-11,195,0,95,613,708,133,397,530,1238,38,288,WY - Lander
14,1964-1965,1964-10-22,1965-05-10,201,0,80,561,641,100,144,244,885,32,233,WY - Lander
15,1965-1966,1965-09-15,1966-05-12,240,0,74,539,613,149,331,480,1093,38,300,WY - Lander
16,1966-1967,1966-10-02,1967-05-14,225,0,54,505,559,196,288,484,1043,47,348,WY - Lander
17,1967-1968,1967-10-26,1968-05-16,204,0,141,645,786,181,715,896,1682,46,398,WY - Lander
18,1968-1969,1968-10-16,1969-06-13,241,0,81,555,636,97,218,315,951,31,215,WY - Lander
19,1969-1970,1969-10-03,1970-04-29,209,0,58,536,594,170,222,392,986,49,310,WY - Lander
20,1970-1971,1970-09-12,1971-05-18,249,0,82,570,652,172,278,450,1102,41,313,WY - Lander
21,1971-1972,1971-09-16,1972-04-30,228,0,102,580,682,178,486,664,1346,46,338,WY - Lander
22,1972-1973,1972-10-05,1973-05-02,210,0,250,827,1077,300,1038,1338,2415,57,558,WY - Lander
23,1973-1974,1973-10-09,1974-05-21,225,0,91,550,641,140,325,465,1106,35,293,WY - Lander
24,1974-1975,1974-09-11,1975-05-25,257,0,92,630,722,185,350,535,1257,48,366,WY - Lander
25,1975-1976,1975-10-14,1976-06-14,245,0,117,603,720,123,397,520,1240,36,313,WY - Lander
26,1976-1977,1976-10-06,1977-05-05,212,0,67,576,643,153,498,651,1294,39,300,WY - Lander
27,1977-1978,1977-10-10,1978-05-30,233,0,101,544,645,112,300,412,1057,31,256,WY - Lander
28,1978-1979,1978-09-18,1979-06-08,264,0,282,894,1176,221,803,1024,2200,49,473,WY - Lander
29,1979-1980,1979-10-28,1980-05-12,198,0,123,644,767,176,482,658,1425,44,375,WY - Lander
30,1980-1981,1980-10-15,1981-04-04,172,0,52,405,457,97,171,268,725,31,207,WY - Lander
31,1981-1982,1981-10-24,1982-05-11,200,0,70,521,591,63,65,128,719,27,170,WY - Lander
32,1982-1983,1982-09-13,1983-05-16,246,0,90,523,613,227,544,771,1384,50,354,WY - Lander
33,1983-1984,1983-09-19,1984-05-06,231,0,225,723,948,223,1039,1262,2210,59,508,WY - Lander
34,1984-1985,1984-09-23,1985-04-27,217,0,111,610,721,78,192,270,991,32,205,WY - Lander
35,1985-1986,1985-09-22,1986-05-16,237,0,180,637,817,164,741,905,1722,43,390,WY - Lander
36,1986-1987,1986-10-02,1987-04-19,200,0,111,552,663,168,621,789,1452,46,366,WY - Lander
37,1987-1988,1987-10-13,1988-05-02,203,0,106,560,666,111,371,482,1148,41,269,WY - Lander
38,1988-1989,1988-09-18,1989-04-30,225,0,140,602,742,76,259,335,1077,33,284,WY - Lander
39,1989-1990,1989-10-02,1990-05-08,219,0,54,462,516,91,130,221,737,38,210,WY - Lander
40,1990-1991,1990-10-06,1991-05-03,210,0,109,571,680,144,375,519,1199,38,298,WY - Lander
41,1991-1992,1991-10-03,1992-03-21,171,0,89,487,576,102,489,591,1167,33,231,WY - Lander
42,1992-1993,1992-10-06,1993-06-03,241,0,217,728,945,141,826,967,1912,40,338,WY - Lander
43,1993-1994,1993-09-13,1994-04-27,227,0,65,538,603,126,397,523,1126,44,296,WY - Lander
44,1994-1995,1994-10-03,1995-06-09,250,0,80,476,556,151,184,335,891,53,293,WY - Lander
45,1995-1996,1995-09-20,1996-04-27,221,0,97,535,632,120,272,392,1024,28,226,WY - Lander
54,2004-2005,2004-10-22,2005-05-11,202,13,52,449,501,126,45,171,672,30,218,WY - Lander
55,2005-2006,2005-10-04,2006-05-04,213,14,80,492,572,98,53,151,723,24,184,WY - Lander
56,2006-2007,2006-10-09,2007-05-06,210,0,84,518,602,105,233,338,940,27,242,WY - Lander
57,2007-2008,2007-09-24,2008-05-26,246,0,130,645,775,140,542,682,1457,45,319,WY - Lander
58,2008-2009,2008-10-10,2009-04-27,200,0,66,493,559,161,181,342,901,31,283,WY - Lander
59,2009-2010,2009-09-30,2010-05-13,226,9,140,617,757,181,671,852,1609,41,358,WY - Lander
60,2010-2011,2010-11-09,2011-05-30,203,0,97,524,621,102,222,324,945,36,249,WY - Lander
61,2011-2012,2011-10-07,2012-05-25,232,0,73,479,552,92,351,443,995,33,201,WY - Lander
62,2012-2013,2012-10-05,2013-05-02,210,0,102,568,670,158,320,478,1148,40,348,WY - Lander
65,2015-2016,2015-11-16,2016-04-28,165,0,82,452,534,110,402,512,1046,32,214,WY - Lander
66,2016-2017,2016-11-17,2017-05-19,184,0,142,542,684,121,395,516,1200,24,258,WY - Lander
67,2017-2018,2017-10-02,2018-04-24,205,0,89,548,637,91,264,355,992,36,220,WY - Lander
68,2018-2019,2018-10-08,2019-05-23,228,0,122,626,748,116,291,407,1155,40,257,WY - Lander
69,2019-2020,2019-10-09,2020-04-18,193,0,125,644,769,137,726,863,1632,41,339,WY - Lander
0,1950-1951,1950-10-01,1951-06-01,244,1,71,718,789,27,32,59,848,11,90,WY - Redbird
1,1951-1952,1951-10-26,1952-04-08,166,0,78,645,723,34,102,136,859,9,75,WY - Redbird
3,1953-1954,1953-11-18,1954-03-31,134,12,30,451,481,45,99,144,625,13,95,WY - Redbird
4,1954-1955,1954-10-25,1955-04-13,171,1,66,582,648,101,326,427,1075,23,193,WY - Redbird
5,1955-1956,1955-10-23,1956-04-28,189,12,90,658,748,65,215,280,1028,20,152,WY - Redbird
6,1956-1957,1956-10-24,1957-04-13,172,0,99,628,727,72,202,274,1001,21,180,WY - Redbird
7,1957-1958,1957-10-24,1958-04-25,184,0,34,500,534,46,120,166,700,17,104,WY - Redbird
8,1958-1959,1958-11-16,1959-04-19,155,1,72,546,618,69,191,260,878,20,179,WY - Redbird
9,1959-1960,1959-11-04,1960-04-28,177,1,84,603,687,54,153,207,894,18,145,WY - Redbird
10,1960-1961,1960-11-04,1961-04-14,162,1,31,511,542,39,241,280,822,11,76,WY - Redbird
11,1961-1962,1961-09-30,1962-03-19,171,2,115,633,748,44,157,201,949,16,148,WY - Redbird
12,1962-1963,1962-12-01,1963-04-22,143,1,77,530,607,24,147,171,778,9,85,WY - Redbird
13,1963-1964,1963-11-21,1964-03-25,126,0,59,537,596,19,57,76,672,9,69,WY - Redbird
14,1964-1965,1964-11-15,1965-05-09,176,2,73,608,681,41,126,167,848,15,112,WY - Redbird
15,1965-1966,1965-09-16,1966-04-21,218,0,59,644,703,42,192,234,937,12,103,WY - Redbird
17,1967-1968,1967-11-02,1968-04-04,155,1,62,589,651,36,145,181,832,10,89,WY - Redbird
19,1969-1970,1969-10-12,1970-04-21,192,0,63,615,678,51,96,147,825,13,105,WY - Redbird
20,1970-1971,1970-09-13,1971-04-26,226,1,93,638,731,52,171,223,954,24,142,WY - Redbird
21,1971-1972,1971-10-27,1972-04-18,175,0,81,666,747,45,110,155,902,20,175,WY - Redbird
23,1973-1974,1973-11-01,1974-04-13,164,4,94,479,573,47,220,267,840,12,106,WY - Redbird
25,1975-1976,1975-10-23,1976-03-20,150,4,80,496,576,76,164,240,816,21,185,WY - Redbird
26,1976-1977,1976-11-12,1977-03-30,139,1,66,556,622,52,80,132,754,15,120,WY - Redbird
27,1977-1978,1977-10-10,1978-04-10,183,6,167,698,865,105,341,446,1311,35,336,WY - Redbird
28,1978-1979,1978-11-10,1979-04-11,153,13,221,819,1040,83,546,629,1669,22,274,WY - Redbird
29,1979-1980,1979-10-29,1980-04-11,166,0,82,607,689,90,175,265,954,25,261,WY - Redbird
31,1981-1982,1981-12-01,1982-04-08,129,10,113,559,672,68,153,221,893,21,210,WY - Redbird
32,1982-1983,1982-11-01,1983-05-12,193,2,35,478,513,67,119,186,699,17,112,WY - Redbird
34,1984-1985,1984-10-18,1985-03-22,156,3,90,654,744,69,105,174,918,16,168,WY - Redbird
35,1985-1986,1985-11-08,1986-05-09,183,4,136,566,702,129,506,635,1337,28,266,WY - Redbird
36,1986-1987,1986-11-07,1987-04-20,165,4,43,541,584,81,130,211,795,23,171,WY - Redbird
37,1987-1988,1987-10-09,1988-04-26,201,0,83,667,750,60,133,193,943,18,144,WY - Redbird
38,1988-1989,1988-11-18,1989-04-08,142,1,113,557,670,63,83,146,816,19,205,WY - Redbird
39,1989-1990,1989-10-29,1990-04-10,164,0,73,502,575,66,127,193,768,16,176,WY - Redbird
40,1990-1991,1990-10-07,1991-05-03,209,2,94,632,726,72,131,203,929,17,182,WY - Redbird
41,1991-1992,1991-10-28,1992-03-19,144,1,29,482,511,44,65,109,620,10,80,WY - Redbird
42,1992-1993,1992-11-10,1993-04-14,156,1,183,772,955,144,755,899,1854,33,333,WY - Redbird
43,1993-1994,1993-10-08,1994-04-28,203,2,76,571,647,118,205,323,970,26,230,WY - Redbird
44,1994-1995,1994-11-02,1995-04-11,161,0,48,481,529,70,84,154,683,18,161,WY - Redbird
45,1995-1996,1995-09-20,1996-04-21,215,1,106,709,815,102,134,236,1051,26,247,WY - Redbird
46,1996-1997,1996-10-17,1997-04-12,178,2,117,597,714,81,145,226,940,23,240,WY - Redbird
47,1997-1998,1997-10-24,1998-04-17,176,8,43,531,574,89,118,207,781,22,186,WY - Redbird
48,1998-1999,1998-11-03,1999-04-03,152,1,30,389,419,55,59,114,533,18,134,WY - Redbird
49,1999-2000,1999-10-16,2000-04-19,187,5,20,477,497,94,94,188,685,22,152,WY - Redbird
50,2000-2001,2000-09-23,2001-04-23,213,1,99,660,759,99,233,332,1091,23,216,WY - Redbird
51,2001-2002,2001-11-18,2002-05-01,165,0,61,558,619,76,137,213,832,17,142,WY - Redbird
52,2002-2003,2002-10-23,2003-04-04,164,1,53,500,553,69,115,184,737,21,160,WY - Redbird
53,2003-2004,2003-09-18,2004-04-11,207,0,66,511,577,66,149,215,792,20,140,WY - Redbird
54,2004-2005,2004-11-01,2005-05-12,193,0,55,478,533,63,115,178,711,14,111,WY - Redbird
55,2005-2006,2005-11-28,2006-04-24,148,1,65,443,508,64,98,162,670,17,147,WY - Redbird
56,2006-2007,2006-11-10,2007-04-13,155,2,65,508,573,53,60,113,686,14,130,WY - Redbird
57,2007-2008,2007-11-21,2008-05-02,164,1,88,583,671,94,255,349,1020,26,203,WY - Redbird
58,2008-2009,2008-11-06,2009-04-25,171,2,67,517,584,90,137,227,811,24,215,WY - Redbird
59,2009-2010,2009-10-08,2010-05-13,218,0,94,578,672,97,162,259,931,28,231,WY - Redbird
60,2010-2011,2010-11-09,2011-04-19,162,0,90,502,592,87,102,189,781,23,218,WY - Redbird
62,2012-2013,2012-10-05,2013-05-02,210,0,74,616,690,120,136,256,946,29,245,WY - Redbird
63,2013-2014,2013-10-04,2014-04-13,192,0,138,632,770,91,168,259,1029,25,267,WY - Redbird
64,2014-2015,2014-11-10,2015-05-10,182,0,83,516,599,73,218,291,890,17,153,WY - Redbird
65,2015-2016,2015-11-20,2016-04-26,159,0,45,436,481,65,109,174,655,18,137,WY - Redbird
66,2016-2017,2016-11-17,2017-04-28,163,0,105,520,625,81,283,364,989,24,244,WY - Redbird
67,2017-2018,2017-11-02,2018-04-14,164,0,106,606,712,114,393,507,1219,21,225,WY - Redbird
68,2018-2019,2018-09-28,2019-05-22,237,8,102,648,750,124,210,334,1084,23,201,WY - Redbird
69,2019-2020,2019-10-10,2020-04-13,187,1,25,500,525,97,135,232,757,22,174,WY - Redbird
0,1950-1951,1950-11-08,1951-03-18,131,0,96,500,596,33,115,148,744,8,79,WY - Wamsutter
1,1951-1952,1951-11-01,1952-04-03,155,1,164,672,836,36,243,279,1115,15,106,WY - Wamsutter
3,1953-1954,1953-11-18,1954-03-31,134,2,58,437,495,15,51,66,561,6,35,WY - Wamsutter
4,1954-1955,1954-10-26,1955-04-13,170,7,150,711,861,28,359,387,1248,13,84,WY - Wamsutter
5,1955-1956,1955-11-12,1956-04-28,169,1,128,574,702,22,112,134,836,10,63,WY - Wamsutter
6,1956-1957,1956-10-24,1957-04-25,184,0,129,655,784,36,161,197,981,17,101,WY - Wamsutter
7,1957-1958,1957-11-03,1958-04-21,170,1,99,563,662,32,123,155,817,20,104,WY - Wamsutter
8,1958-1959,1958-10-20,1959-05-07,200,0,92,629,721,55,363,418,1139,24,151,WY - Wamsutter
9,1959-1960,1959-10-01,1960-04-29,212,0,138,685,823,28,210,238,1061,18,101,WY - Wamsutter
10,1960-1961,1960-10-29,1961-04-11,165,0,66,567,633,28,68,96,729,19,103,WY - Wamsutter
11,1961-1962,1961-10-08,1962-05-17,222,0,202,734,936,41,293,334,1270,22,140,WY - Wamsutter
17,1967-1968,1967-11-02,1968-04-22,173,1,122,639,761,41,246,287,1048,16,108,WY - Wamsutter
19,1969-1970,1969-10-04,1970-05-10,219,16,86,642,728,76,127,203,931,38,216,WY - Wamsutter
25,1975-1976,1975-10-23,1976-04-17,178,17,96,653,749,33,50,83,832,13,89,WY - Wamsutter
26,1976-1977,1976-11-26,1977-04-03,129,2,53,561,614,21,14,35,649,7,53,WY - Wamsutter
40,1990-1991,1990-11-02,1991-04-13,163,15,106,598,704,29,34,63,767,11,69,WY - Wamsutter
62,2012-2013,2012-10-24,2013-04-22,181,0,142,629,771,86,305,391,1162,27,212,WY - Wamsutter
63,2013-2014,2013-09-27,2014-05-12,228,10,87,635,722,71,257,328,1050,19,156,WY - Wamsutter
64,2014-2015,2014-11-03,2015-04-18,167,3,88,460,548,86,203,289,837,25,177,WY - Wamsutter
65,2015-2016,2015-11-04,2016-05-08,187,0,123,579,702,140,370,510,1212,42,323,WY - Wamsutter
66,2016-2017,2016-11-17,2017-05-18,183,0,115,511,626,86,289,375,1001,28,202,WY - Wamsutter
67,2017-2018,2017-09-19,2018-04-21,215,0,42,539,581,78,149,227,808,26,175,WY - Wamsutter
68,2018-2019,2018-10-10,2019-05-23,226,0,144,718,862,116,631,747,1609,39,251,WY - Wamsutter
69,2019-2020,2019-10-20,2020-04-24,188,0,148,701,849,132,839,971,1820,38,292,WY - Wamsutter
