,Season,Start,End,Length,Msng,Tmax,Tmin,TempSc,Sfall,Sdepth,SnowSc,AWSSI,Events,RAWSSI,State,City,2010Pop
0,1950-1951,1950-11-24,1951-02-28,97,0,3,88,91,4,1,5,96,3,17,Alabama,Birmingham,212237
1,1951-1952,1951-12-01,1952-02-29,91,0,0,38,38,0,0,0,38,0,0,Alabama,Birmingham,212237
2,1952-1953,1952-12-01,1953-02-28,90,0,0,34,34,0,0,0,34,0,0,Alabama,Birmingham,212237
3,1953-1954,1953-12-01,1954-02-28,90,0,1,52,53,0,0,0,53,0,0,Alabama,Birmingham,212237
4,1954-1955,1954-12-01,1955-02-28,90,0,1,61,62,0,0,0,62,0,0,Alabama,Birmingham,212237
5,1955-1956,1955-12-01,1956-02-29,91,0,0,49,49,0,0,0,49,0,0,Alabama,Birmingham,212237
6,1956-1957,1956-12-01,1957-03-08,98,0,0,27,27,1,0,1,28,1,2,Alabama,Birmingham,212237
7,1957-1958,1957-12-01,1958-02-28,90,0,5,101,106,4,3,7,113,2,8,Alabama,Birmingham,212237
8,1958-1959,1958-12-01,1959-02-28,90,0,1,74,75,4,1,5,80,1,5,Alabama,Birmingham,212237
9,1959-1960,1959-12-01,1960-02-29,91,0,0,49,49,3,2,5,54,1,4,Alabama,Birmingham,212237
10,1960-1961,1960-12-01,1961-02-28,90,0,2,73,75,0,0,0,75,0,0,Alabama,Birmingham,212237
11,1961-1962,1961-12-01,1962-02-28,90,0,7,57,64,5,13,18,82,2,17,Alabama,Birmingham,212237
12,1962-1963,1962-12-01,1963-02-28,90,0,9,119,128,2,0,2,130,2,4,Alabama,Birmingham,212237
13,1963-1964,1963-12-01,1964-02-29,91,0,1,93,94,13,10,23,117,2,17,Alabama,Birmingham,212237
14,1964-1965,1964-12-01,1965-02-28,90,1,2,72,74,0,0,0,74,0,0,Alabama,Birmingham,212237
15,1965-1966,1965-12-01,1966-02-28,90,0,3,86,89,2,2,4,93,1,8,Alabama,Birmingham,212237
16,1966-1967,1966-12-01,1967-02-28,90,0,2,71,73,1,0,1,74,1,2,Alabama,Birmingham,212237
17,1967-1968,1967-12-01,1968-02-29,91,0,1,71,72,3,1,4,76,2,8,Alabama,Birmingham,212237
18,1968-1969,1968-12-01,1969-02-28,90,0,1,81,82,0,0,0,82,0,0,Alabama,Birmingham,212237
19,1969-1970,1969-12-01,1970-02-28,90,0,6,88,94,5,0,5,99,4,8,Alabama,Birmingham,212237
20,1970-1971,1970-12-01,1971-02-28,90,0,3,77,80,3,1,4,84,3,11,Alabama,Birmingham,212237
21,1971-1972,1971-12-01,1972-02-29,91,0,2,42,44,0,0,0,44,0,0,Alabama,Birmingham,212237
22,1972-1973,1972-12-01,1973-02-28,90,0,2,71,73,0,0,0,73,0,0,Alabama,Birmingham,212237
23,1973-1974,1973-12-01,1974-02-28,90,0,1,39,40,0,0,0,40,0,0,Alabama,Birmingham,212237
24,1974-1975,1974-12-01,1975-02-28,90,0,0,37,37,1,0,1,38,1,2,Alabama,Birmingham,212237
25,1975-1976,1975-12-01,1976-02-29,91,0,2,75,77,0,0,0,77,0,0,Alabama,Birmingham,212237
26,1976-1977,1976-11-29,1977-02-28,92,0,10,141,151,3,1,4,155,2,13,Alabama,Birmingham,212237
27,1977-1978,1977-12-01,1978-02-28,90,0,11,109,120,3,3,6,126,2,7,Alabama,Birmingham,212237
28,1978-1979,1978-12-01,1979-02-28,90,0,1,84,85,0,0,0,85,0,0,Alabama,Birmingham,212237
29,1979-1980,1979-12-01,1980-03-02,93,0,3,69,72,1,0,1,73,1,6,Alabama,Birmingham,212237
30,1980-1981,1980-12-01,1981-02-28,90,0,0,90,90,0,0,0,90,0,0,Alabama,Birmingham,212237
31,1981-1982,1981-12-01,1982-02-28,90,0,5,85,90,10,2,12,102,3,18,Alabama,Birmingham,212237
32,1982-1983,1982-12-01,1983-03-24,114,6,0,54,54,2,1,3,57,1,3,Alabama,Birmingham,212237
33,1983-1984,1983-12-01,1984-03-10,101,0,9,112,121,3,0,3,124,1,4,Alabama,Birmingham,212237
34,1984-1985,1984-12-01,1985-02-28,90,0,5,96,101,1,0,1,102,1,2,Alabama,Birmingham,212237
35,1985-1986,1985-12-01,1986-02-28,90,0,4,93,97,0,0,0,97,0,0,Alabama,Birmingham,212237
36,1986-1987,1986-12-01,1987-04-03,124,0,0,69,69,10,7,17,86,2,12,Alabama,Birmingham,212237
37,1987-1988,1987-12-01,1988-02-29,91,0,3,79,82,2,1,3,85,1,3,Alabama,Birmingham,212237
38,1988-1989,1988-12-01,1989-02-28,90,0,0,49,49,0,0,0,49,0,0,Alabama,Birmingham,212237
39,1989-1990,1989-12-01,1990-02-28,90,0,8,65,73,1,0,1,74,1,1,Alabama,Birmingham,212237
40,1990-1991,1990-12-01,1991-02-28,90,0,1,46,47,0,0,0,47,0,0,Alabama,Birmingham,212237
41,1991-1992,1991-12-01,1992-02-29,91,0,0,52,52,6,5,11,63,1,7,Alabama,Birmingham,212237
42,1992-1993,1992-12-01,1993-03-16,106,0,1,55,56,17,20,37,93,2,23,Alabama,Birmingham,212237
43,1993-1994,1993-12-01,1994-02-28,90,0,2,76,78,0,0,0,78,0,0,Alabama,Birmingham,212237
44,1994-1995,1994-12-01,1995-02-28,90,0,0,50,50,2,0,2,52,2,6,Alabama,Birmingham,212237
45,1995-1996,1995-12-01,1996-03-08,99,0,10,104,114,3,2,5,119,3,16,Alabama,Birmingham,212237
46,1996-1997,1996-12-01,1997-02-28,90,0,3,58,61,0,0,0,61,0,0,Alabama,Birmingham,212237
47,1997-1998,1997-12-01,1998-02-28,90,0,0,37,37,3,0,3,40,2,5,Alabama,Birmingham,212237
48,1998-1999,1998-12-01,1999-02-28,90,0,3,39,42,0,0,0,42,0,0,Alabama,Birmingham,212237
49,1999-2000,1999-12-01,2000-02-29,91,0,0,55,55,4,3,7,62,1,5,Alabama,Birmingham,212237
50,2000-2001,2000-12-01,2001-02-28,90,0,2,86,88,0,0,0,88,0,0,Alabama,Birmingham,212237
51,2001-2002,2001-12-01,2002-02-28,90,0,0,51,51,0,0,0,51,0,0,Alabama,Birmingham,212237
52,2002-2003,2002-12-01,2003-02-28,90,0,2,66,68,0,0,0,68,0,0,Alabama,Birmingham,212237
53,2003-2004,2003-12-01,2004-02-29,91,0,0,61,61,0,0,0,61,0,0,Alabama,Birmingham,212237
54,2004-2005,2004-12-01,2005-02-28,90,0,1,49,50,0,0,0,50,0,0,Alabama,Birmingham,212237
55,2005-2006,2005-12-01,2006-02-28,90,0,0,44,44,0,0,0,44,0,0,Alabama,Birmingham,212237
56,2006-2007,2006-12-01,2007-02-28,90,0,0,50,50,0,0,0,50,0,0,Alabama,Birmingham,212237
57,2007-2008,2007-12-01,2008-03-08,99,0,1,49,50,1,0,1,51,1,2,Alabama,Birmingham,212237
58,2008-2009,2008-12-01,2009-03-01,91,0,1,64,65,3,0,3,68,1,4,Alabama,Birmingham,212237
59,2009-2010,2009-12-01,2010-02-28,90,0,3,86,89,2,0,2,91,1,4,Alabama,Birmingham,212237
60,2010-2011,2010-12-01,2011-02-28,90,0,3,78,81,4,2,6,87,2,8,Alabama,Birmingham,212237
61,2011-2012,2011-12-01,2012-02-29,91,0,0,32,32,0,0,0,32,0,0,Alabama,Birmingham,212237
62,2012-2013,2012-12-01,2013-02-28,90,0,0,29,29,3,0,3,32,1,3,Alabama,Birmingham,212237
63,2013-2014,2013-12-01,2014-02-28,90,0,6,91,97,7,4,11,108,2,13,Alabama,Birmingham,212237
64,2014-2015,2014-12-01,2015-03-05,95,0,1,73,74,2,0,2,76,2,5,Alabama,Birmingham,212237
65,2015-2016,2015-12-01,2016-02-29,91,0,0,36,36,0,0,0,36,0,0,Alabama,Birmingham,212237
66,2016-2017,2016-12-01,2017-02-28,90,0,1,29,30,1,0,1,31,1,3,Alabama,Birmingham,212237
67,2017-2018,2017-12-01,2018-02-28,90,0,3,63,66,6,2,8,74,1,7,Alabama,Birmingham,212237
68,2018-2019,2018-12-01,2019-02-28,90,0,0,23,23,0,0,0,23,0,0,Alabama,Birmingham,212237
69,2019-2020,2019-12-01,2020-02-29,91,0,0,23,23,0,0,0,23,0,0,Alabama,Birmingham,212237
70,1950-1951,1950-11-24,1951-03-14,111,2,11,110,121,6,5,11,132,3,16,Alabama,Huntsville,180105
71,1951-1952,1951-12-01,1952-02-29,91,0,1,49,50,0,0,0,50,0,0,Alabama,Huntsville,180105
72,1952-1953,1952-12-01,1953-02-28,90,0,0,47,47,0,0,0,47,0,0,Alabama,Huntsville,180105
73,1953-1954,1953-12-01,1954-02-28,90,0,3,64,67,0,0,0,67,0,0,Alabama,Huntsville,180105
74,1954-1955,1954-12-01,1955-02-28,90,3,2,85,87,0,0,0,87,0,0,Alabama,Huntsville,180105
75,1955-1956,1955-11-28,1956-02-29,94,1,1,89,90,0,0,0,90,0,0,Alabama,Huntsville,180105
76,1956-1957,1956-12-01,1957-02-28,90,0,2,44,46,0,0,0,46,0,0,Alabama,Huntsville,180105
77,1958-1959,1958-12-01,1959-02-28,90,0,6,103,109,1,1,2,111,1,3,Alabama,Huntsville,180105
78,1959-1960,1959-12-01,1960-03-15,106,0,3,91,94,17,17,34,128,7,28,Alabama,Huntsville,180105
79,1960-1961,1960-12-01,1961-02-28,90,0,4,103,107,1,0,1,108,1,2,Alabama,Huntsville,180105
80,1961-1962,1961-12-01,1962-02-28,90,0,8,75,83,9,13,22,105,4,27,Alabama,Huntsville,180105
81,1962-1963,1962-12-01,1963-02-28,90,0,13,149,162,9,5,14,176,5,25,Alabama,Huntsville,180105
82,1963-1964,1963-12-01,1964-02-29,91,0,6,111,117,36,26,62,179,7,54,Alabama,Huntsville,180105
83,1964-1965,1964-12-01,1965-03-07,97,0,6,99,105,10,2,12,117,7,26,Alabama,Huntsville,180105
84,1965-1966,1965-12-01,1966-02-28,90,0,6,94,100,12,17,29,129,3,23,Alabama,Huntsville,180105
85,1966-1967,1966-11-02,1967-02-28,119,0,3,100,103,9,7,16,119,3,13,Alabama,Huntsville,180105
86,1967-1968,1967-12-01,1968-03-23,114,0,5,133,138,16,8,24,162,9,32,Alabama,Huntsville,180105
87,1968-1969,1968-12-01,1969-02-28,90,0,4,87,91,1,0,1,92,1,2,Alabama,Huntsville,180105
88,1969-1970,1969-11-14,1970-02-28,107,0,12,122,134,10,3,13,147,8,28,Alabama,Huntsville,180105
89,1970-1971,1970-11-24,1971-02-28,97,0,6,80,86,10,1,11,97,7,21,Alabama,Huntsville,180105
90,1971-1972,1971-12-01,1972-02-29,91,0,2,50,52,1,0,1,53,1,3,Alabama,Huntsville,180105
91,1972-1973,1972-12-01,1973-02-28,90,0,4,67,71,1,0,1,72,1,2,Alabama,Huntsville,180105
92,1973-1974,1973-12-01,1974-02-28,90,0,1,43,44,1,0,1,45,1,2,Alabama,Huntsville,180105
93,1974-1975,1974-11-14,1975-02-28,107,0,1,66,67,8,6,14,81,4,11,Alabama,Huntsville,180105
94,1975-1976,1975-12-01,1976-02-29,91,0,5,87,92,2,0,2,94,2,9,Alabama,Huntsville,180105
95,1976-1977,1976-11-28,1977-02-28,93,0,14,163,177,3,0,3,180,3,19,Alabama,Huntsville,180105
96,1977-1978,1977-12-01,1978-02-28,90,0,20,140,160,5,5,10,170,3,13,Alabama,Huntsville,180105
97,1978-1979,1978-12-01,1979-02-28,90,0,7,108,115,10,3,13,128,8,24,Alabama,Huntsville,180105
98,1979-1980,1979-12-01,1980-03-02,93,0,8,101,109,8,3,11,120,5,20,Alabama,Huntsville,180105
99,1980-1981,1980-12-01,1981-02-28,90,0,6,120,126,1,0,1,127,1,5,Alabama,Huntsville,180105
100,1981-1982,1981-12-01,1982-03-07,97,0,10,102,112,6,11,17,129,3,17,Alabama,Huntsville,180105
101,1982-1983,1982-12-01,1983-02-28,90,0,0,60,60,0,0,0,60,0,0,Alabama,Huntsville,180105
102,1983-1984,1983-12-01,1984-02-29,91,0,20,123,143,5,2,7,150,3,9,Alabama,Huntsville,180105
103,1984-1985,1984-12-01,1985-02-28,90,0,13,110,123,12,15,27,150,4,29,Alabama,Huntsville,180105
104,1985-1986,1985-12-01,1986-02-28,90,0,8,119,127,2,1,3,130,2,6,Alabama,Huntsville,180105
105,1986-1987,1986-12-01,1987-02-28,90,0,2,57,59,3,1,4,63,2,5,Alabama,Huntsville,180105
106,1987-1988,1987-12-01,1988-02-29,91,0,7,99,106,15,28,43,149,3,23,Alabama,Huntsville,180105
107,1988-1989,1988-12-01,1989-02-28,90,0,3,56,59,3,0,3,62,3,9,Alabama,Huntsville,180105
108,1989-1990,1989-12-01,1990-02-28,90,0,13,77,90,1,0,1,91,1,3,Alabama,Huntsville,180105
109,1990-1991,1990-12-01,1991-02-28,90,0,1,50,51,0,0,0,51,0,0,Alabama,Huntsville,180105
110,1991-1992,1991-12-01,1992-02-29,91,0,1,52,53,1,0,1,54,1,2,Alabama,Huntsville,180105
111,1992-1993,1992-12-01,1993-03-15,105,0,2,63,65,9,11,20,85,2,13,Alabama,Huntsville,180105
112,1993-1994,1993-12-01,1994-02-28,90,0,7,94,101,1,0,1,102,1,4,Alabama,Huntsville,180105
113,1994-1995,1994-12-01,1995-02-28,90,0,2,68,70,3,0,3,73,2,6,Alabama,Huntsville,180105
114,2002-2003,2002-12-01,2003-02-28,90,0,3,90,93,2,0,2,95,2,9,Alabama,Huntsville,180105
115,2003-2004,2003-12-01,2004-02-29,91,5,0,75,75,0,0,0,75,0,0,Alabama,Huntsville,180105
116,2004-2005,2004-12-01,2005-02-28,90,0,2,65,67,0,0,0,67,0,0,Alabama,Huntsville,180105
117,2005-2006,2005-12-01,2006-02-28,90,0,0,59,59,2,0,2,61,2,3,Alabama,Huntsville,180105
118,2006-2007,2006-12-01,2007-02-28,90,0,0,71,71,2,1,3,74,1,3,Alabama,Huntsville,180105
119,2007-2008,2007-12-01,2008-03-07,98,0,2,66,68,2,0,2,70,2,3,Alabama,Huntsville,180105
120,2008-2009,2008-12-01,2009-03-01,91,0,5,71,76,2,0,2,78,2,3,Alabama,Huntsville,180105
121,2009-2010,2009-12-01,2010-03-02,92,0,7,93,100,8,1,9,109,7,15,Alabama,Huntsville,180105
122,2010-2011,2010-12-01,2011-02-28,90,0,5,89,94,20,36,56,150,6,30,Alabama,Huntsville,180105
123,2011-2012,2011-12-01,2012-02-29,91,0,0,41,41,0,0,0,41,0,0,Alabama,Huntsville,180105
124,2012-2013,2012-12-01,2013-02-28,90,0,0,34,34,1,0,1,35,1,1,Alabama,Huntsville,180105
125,2013-2014,2013-12-01,2014-02-28,90,0,9,112,121,7,11,18,139,3,9,Alabama,Huntsville,180105
126,2014-2015,2014-12-01,2015-03-06,96,1,3,72,75,16,10,26,101,4,22,Alabama,Huntsville,180105
127,2015-2016,2015-12-01,2016-02-29,91,0,0,49,49,1,0,1,50,1,2,Alabama,Huntsville,180105
128,2016-2017,2016-12-01,2017-02-28,90,0,2,36,38,0,0,0,38,0,0,Alabama,Huntsville,180105
129,2017-2018,2017-12-01,2018-02-28,90,0,6,85,91,1,0,1,92,1,5,Alabama,Huntsville,180105
130,2018-2019,2018-12-01,2019-02-28,90,0,0,29,29,0,0,0,29,0,0,Alabama,Huntsville,180105
131,2019-2020,2019-12-01,2020-02-29,91,0,1,30,31,1,1,2,33,1,2,Alabama,Huntsville,180105
132,1950-1951,1950-12-01,1951-02-28,90,0,1,28,29,0,0,0,29,0,0,Alabama,Mobile,195111
133,1951-1952,1951-12-01,1952-02-29,91,0,0,8,8,0,0,0,8,0,0,Alabama,Mobile,195111
134,1952-1953,1952-12-01,1953-02-28,90,0,0,8,8,0,0,0,8,0,0,Alabama,Mobile,195111
135,1953-1954,1953-12-01,1954-03-06,96,0,0,13,13,2,1,3,16,1,2,Alabama,Mobile,195111
136,1954-1955,1954-12-01,1955-02-28,90,0,0,17,17,4,0,4,21,1,5,Alabama,Mobile,195111
137,1955-1956,1955-12-01,1956-02-29,91,0,0,17,17,0,0,0,17,0,0,Alabama,Mobile,195111
138,1956-1957,1956-12-01,1957-02-28,90,0,0,5,5,0,0,0,5,0,0,Alabama,Mobile,195111
139,1957-1958,1957-12-01,1958-02-28,90,0,0,42,42,2,1,3,45,1,4,Alabama,Mobile,195111
140,1958-1959,1958-12-01,1959-02-28,90,0,0,24,24,0,0,0,24,0,0,Alabama,Mobile,195111
141,1959-1960,1959-12-01,1960-02-29,91,0,0,19,19,0,0,0,19,0,0,Alabama,Mobile,195111
142,1960-1961,1960-12-01,1961-02-28,90,0,0,29,29,0,0,0,29,0,0,Alabama,Mobile,195111
143,1961-1962,1961-12-01,1962-02-28,90,0,3,31,34,0,0,0,34,0,0,Alabama,Mobile,195111
144,1962-1963,1962-12-01,1963-02-28,90,0,3,45,48,0,0,0,48,0,0,Alabama,Mobile,195111
145,1963-1964,1963-12-01,1964-02-29,91,0,0,29,29,4,2,6,35,1,5,Alabama,Mobile,195111
146,1964-1965,1964-12-01,1965-02-28,90,0,0,24,24,0,0,0,24,0,0,Alabama,Mobile,195111
147,1965-1966,1965-12-01,1966-02-28,90,0,1,20,21,0,0,0,21,0,0,Alabama,Mobile,195111
148,1966-1967,1966-12-01,1967-02-28,90,0,0,10,10,0,0,0,10,0,0,Alabama,Mobile,195111
149,1967-1968,1967-12-01,1968-02-29,91,0,0,25,25,2,0,2,27,1,2,Alabama,Mobile,195111
150,1968-1969,1968-12-01,1969-02-28,90,0,0,19,19,0,0,0,19,0,0,Alabama,Mobile,195111
151,1969-1970,1969-12-01,1970-02-28,90,0,1,26,27,0,0,0,27,0,0,Alabama,Mobile,195111
152,1970-1971,1970-12-01,1971-02-28,90,0,0,15,15,0,0,0,15,0,0,Alabama,Mobile,195111
153,1971-1972,1971-12-01,1972-02-29,91,0,0,12,12,0,0,0,12,0,0,Alabama,Mobile,195111
154,1972-1973,1972-12-01,1973-02-28,90,0,0,21,21,4,4,8,29,1,5,Alabama,Mobile,195111
155,1973-1974,1973-12-01,1974-02-28,90,0,0,12,12,0,0,0,12,0,0,Alabama,Mobile,195111
156,1974-1975,1974-12-01,1975-02-28,90,0,0,11,11,0,0,0,11,0,0,Alabama,Mobile,195111
157,1975-1976,1975-12-01,1976-02-29,91,0,0,21,21,0,0,0,21,0,0,Alabama,Mobile,195111
158,1976-1977,1976-12-01,1977-02-28,90,0,1,47,48,3,1,4,52,2,7,Alabama,Mobile,195111
159,1977-1978,1977-12-01,1978-02-28,90,0,0,45,45,1,0,1,46,1,2,Alabama,Mobile,195111
160,1978-1979,1978-12-01,1979-02-28,90,0,0,32,32,0,0,0,32,0,0,Alabama,Mobile,195111
161,1979-1980,1979-12-01,1980-02-29,91,0,0,23,23,0,0,0,23,0,0,Alabama,Mobile,195111
162,1980-1981,1980-12-01,1981-02-28,90,0,0,34,34,0,0,0,34,0,0,Alabama,Mobile,195111
163,1981-1982,1981-12-01,1982-02-28,90,0,1,39,40,0,0,0,40,0,0,Alabama,Mobile,195111
164,1982-1983,1982-12-01,1983-02-28,90,0,0,17,17,0,0,0,17,0,0,Alabama,Mobile,195111
165,1983-1984,1983-12-01,1984-02-29,91,0,3,46,49,0,0,0,49,0,0,Alabama,Mobile,195111
166,1984-1985,1984-12-01,1985-02-28,90,0,1,47,48,0,0,0,48,0,0,Alabama,Mobile,195111
167,1985-1986,1985-12-01,1986-02-28,90,0,0,30,30,0,0,0,30,0,0,Alabama,Mobile,195111
168,1986-1987,1986-12-01,1987-02-28,90,0,0,14,14,0,0,0,14,0,0,Alabama,Mobile,195111
169,1987-1988,1987-12-01,1988-02-29,91,0,0,30,30,2,1,3,33,1,2,Alabama,Mobile,195111
170,1988-1989,1988-12-01,1989-02-28,90,0,0,16,16,0,0,0,16,0,0,Alabama,Mobile,195111
171,1989-1990,1989-12-01,1990-02-28,90,0,3,30,33,0,0,0,33,0,0,Alabama,Mobile,195111
172,1990-1991,1990-12-01,1991-02-28,90,0,0,11,11,0,0,0,11,0,0,Alabama,Mobile,195111
173,1991-1992,1991-12-01,1992-02-29,91,0,0,13,13,0,0,0,13,0,0,Alabama,Mobile,195111
174,1992-1993,1992-12-01,1993-03-13,103,0,0,4,4,4,2,6,10,2,5,Alabama,Mobile,195111
175,1993-1994,1993-12-01,1994-02-28,90,0,0,22,22,0,0,0,22,0,0,Alabama,Mobile,195111
176,1994-1995,1994-12-01,1995-02-28,90,0,0,14,14,0,0,0,14,0,0,Alabama,Mobile,195111
177,1995-1996,1995-12-01,1996-02-29,91,14,1,53,54,0,0,0,54,0,0,Alabama,Mobile,195111
178,1996-1997,1996-12-01,1997-02-28,90,14,0,21,21,2,0,2,23,1,3,Alabama,Mobile,195111
179,1997-1998,1997-12-01,1998-02-28,90,15,0,9,9,1,0,1,10,1,1,Alabama,Mobile,195111
180,1998-1999,1998-12-01,1999-02-28,90,12,0,14,14,0,0,0,14,0,0,Alabama,Mobile,195111
181,1999-2000,1999-12-01,2000-02-29,91,0,0,18,18,0,0,0,18,0,0,Alabama,Mobile,195111
182,2000-2001,2000-12-01,2001-02-28,90,0,0,39,39,0,0,0,39,0,0,Alabama,Mobile,195111
183,2001-2002,2001-12-01,2002-02-28,90,0,0,26,26,0,0,0,26,0,0,Alabama,Mobile,195111
184,2002-2003,2002-12-01,2003-02-28,90,0,0,26,26,0,0,0,26,0,0,Alabama,Mobile,195111
185,2003-2004,2003-12-01,2004-02-29,91,0,0,22,22,0,0,0,22,0,0,Alabama,Mobile,195111
186,2004-2005,2004-12-01,2005-02-28,90,0,0,16,16,0,0,0,16,0,0,Alabama,Mobile,195111
187,2005-2006,2005-12-01,2006-02-28,90,0,0,18,18,0,0,0,18,0,0,Alabama,Mobile,195111
188,2006-2007,2006-12-01,2007-02-28,90,0,0,26,26,0,0,0,26,0,0,Alabama,Mobile,195111
189,2007-2008,2007-12-01,2008-02-29,91,0,0,17,17,0,0,0,17,0,0,Alabama,Mobile,195111
190,2008-2009,2008-12-01,2009-02-28,90,0,0,19,19,0,0,0,19,0,0,Alabama,Mobile,195111
191,2009-2010,2009-12-01,2010-02-28,90,0,0,46,46,1,0,1,47,1,2,Alabama,Mobile,195111
192,2010-2011,2010-12-01,2011-02-28,90,0,0,41,41,0,0,0,41,0,0,Alabama,Mobile,195111
193,2011-2012,2011-12-01,2012-02-29,91,0,0,11,11,0,0,0,11,0,0,Alabama,Mobile,195111
194,2012-2013,2012-12-01,2013-02-28,90,0,0,4,4,0,0,0,4,0,0,Alabama,Mobile,195111
195,2013-2014,2013-12-01,2014-02-28,90,0,1,43,44,2,2,4,48,1,4,Alabama,Mobile,195111
196,2014-2015,2014-12-01,2015-02-28,90,0,0,23,23,0,0,0,23,0,0,Alabama,Mobile,195111
197,2015-2016,2015-12-01,2016-02-29,91,0,0,14,14,0,0,0,14,0,0,Alabama,Mobile,195111
198,2016-2017,2016-12-01,2017-02-28,90,0,0,8,8,0,0,0,8,0,0,Alabama,Mobile,195111
199,2017-2018,2017-12-01,2018-02-28,90,2,0,30,30,3,0,3,33,2,6,Alabama,Mobile,195111
200,2018-2019,2018-12-01,2019-02-28,90,0,0,6,6,0,0,0,6,0,0,Alabama,Mobile,195111
201,2019-2020,2019-12-01,2020-02-29,91,0,0,15,15,0,0,0,15,0,0,Alabama,Mobile,195111
202,1950-1951,1950-11-25,1951-02-28,96,0,2,66,68,0,0,0,68,0,0,Alabama,Montgomery,205764
203,1951-1952,1951-12-01,1952-02-29,91,0,0,24,24,0,0,0,24,0,0,Alabama,Montgomery,205764
204,1952-1953,1952-12-01,1953-02-28,90,0,0,20,20,0,0,0,20,0,0,Alabama,Montgomery,205764
205,1953-1954,1953-12-01,1954-02-28,90,0,0,26,26,0,0,0,26,0,0,Alabama,Montgomery,205764
206,1954-1955,1954-12-01,1955-02-28,90,0,0,43,43,0,0,0,43,0,0,Alabama,Montgomery,205764
207,1955-1956,1955-12-01,1956-02-29,91,0,0,36,36,0,0,0,36,0,0,Alabama,Montgomery,205764
208,1956-1957,1956-12-01,1957-02-28,90,0,0,17,17,0,0,0,17,0,0,Alabama,Montgomery,205764
209,1957-1958,1957-12-01,1958-02-28,90,0,1,70,71,0,0,0,71,0,0,Alabama,Montgomery,205764
210,1958-1959,1958-12-01,1959-02-28,90,0,0,41,41,0,0,0,41,0,0,Alabama,Montgomery,205764
211,1959-1960,1959-12-01,1960-02-29,91,0,0,27,27,0,0,0,27,0,0,Alabama,Montgomery,205764
212,1960-1961,1960-12-01,1961-02-28,90,0,0,61,61,0,0,0,61,0,0,Alabama,Montgomery,205764
213,1961-1962,1961-12-01,1962-02-28,90,0,3,34,37,2,1,3,40,1,3,Alabama,Montgomery,205764
214,1962-1963,1962-12-01,1963-02-28,90,0,5,83,88,0,0,0,88,0,0,Alabama,Montgomery,205764
215,1963-1964,1963-12-01,1964-02-29,91,0,1,54,55,2,1,3,58,1,2,Alabama,Montgomery,205764
216,1964-1965,1964-12-01,1965-02-28,90,0,0,43,43,0,0,0,43,0,0,Alabama,Montgomery,205764
217,1965-1966,1965-12-01,1966-02-28,90,0,1,50,51,0,0,0,51,0,0,Alabama,Montgomery,205764
218,1966-1967,1966-12-01,1967-02-28,90,0,0,28,28,0,0,0,28,0,0,Alabama,Montgomery,205764
219,1967-1968,1967-12-01,1968-02-29,91,0,1,39,40,0,0,0,40,0,0,Alabama,Montgomery,205764
220,1968-1969,1968-12-01,1969-02-28,90,0,0,47,47,0,0,0,47,0,0,Alabama,Montgomery,205764
221,1969-1970,1969-12-01,1970-02-28,90,0,3,68,71,0,0,0,71,0,0,Alabama,Montgomery,205764
222,1970-1971,1970-12-01,1971-02-28,90,0,0,43,43,0,0,0,43,0,0,Alabama,Montgomery,205764
223,1971-1972,1971-12-01,1972-02-29,91,0,0,24,24,0,0,0,24,0,0,Alabama,Montgomery,205764
224,1972-1973,1972-12-01,1973-02-28,90,0,0,37,37,4,2,6,43,1,5,Alabama,Montgomery,205764
225,1973-1974,1973-12-01,1974-02-28,90,0,0,27,27,0,0,0,27,0,0,Alabama,Montgomery,205764
226,1974-1975,1974-12-01,1975-02-28,90,0,0,18,18,0,0,0,18,0,0,Alabama,Montgomery,205764
227,1975-1976,1975-12-01,1976-02-29,91,0,0,52,52,0,0,0,52,0,0,Alabama,Montgomery,205764
228,1976-1977,1976-12-01,1977-02-28,90,0,3,87,90,9,6,15,105,3,17,Alabama,Montgomery,205764
229,1977-1978,1977-12-01,1978-02-28,90,0,0,55,55,0,0,0,55,0,0,Alabama,Montgomery,205764
230,1978-1979,1978-12-01,1979-02-28,90,0,0,44,44,0,0,0,44,0,0,Alabama,Montgomery,205764
231,1979-1980,1979-12-01,1980-02-29,91,0,0,32,32,0,0,0,32,0,0,Alabama,Montgomery,205764
232,1980-1981,1980-12-01,1981-02-28,90,0,0,49,49,0,0,0,49,0,0,Alabama,Montgomery,205764
233,1981-1982,1981-12-01,1982-02-28,90,0,2,47,49,1,0,1,50,1,5,Alabama,Montgomery,205764
234,1982-1983,1982-12-01,1983-02-28,90,0,0,29,29,0,0,0,29,0,0,Alabama,Montgomery,205764
235,1983-1984,1983-12-01,1984-02-29,91,0,4,61,65,0,0,0,65,0,0,Alabama,Montgomery,205764
236,1984-1985,1984-12-01,1985-02-28,90,0,2,57,59,0,0,0,59,0,0,Alabama,Montgomery,205764
237,1985-1986,1985-12-01,1986-02-28,90,0,0,62,62,0,0,0,62,0,0,Alabama,Montgomery,205764
238,1986-1987,1986-12-01,1987-04-03,124,0,0,33,33,1,1,2,35,1,1,Alabama,Montgomery,205764
239,1987-1988,1987-12-01,1988-02-29,91,0,0,58,58,0,0,0,58,0,0,Alabama,Montgomery,205764
240,1988-1989,1988-12-01,1989-02-28,90,0,0,35,35,0,0,0,35,0,0,Alabama,Montgomery,205764
241,1989-1990,1989-12-01,1990-02-28,90,0,5,48,53,0,0,0,53,0,0,Alabama,Montgomery,205764
242,1990-1991,1990-12-01,1991-02-28,90,0,0,29,29,0,0,0,29,0,0,Alabama,Montgomery,205764
243,1991-1992,1991-12-01,1992-02-29,91,0,0,33,33,0,0,0,33,0,0,Alabama,Montgomery,205764
244,1992-1993,1992-12-01,1993-03-14,104,0,0,25,25,4,7,11,36,1,5,Alabama,Montgomery,205764
245,1993-1994,1993-12-01,1994-02-28,90,0,0,44,44,2,1,3,47,1,2,Alabama,Montgomery,205764
246,1994-1995,1994-12-01,1995-02-28,90,0,0,22,22,0,0,0,22,0,0,Alabama,Montgomery,205764
247,1995-1996,1995-12-01,1996-02-29,91,4,3,72,75,0,0,0,75,0,0,Alabama,Montgomery,205764
248,2004-2005,2004-12-01,2005-02-28,90,0,0,36,36,0,0,0,36,0,0,Alabama,Montgomery,205764
249,2005-2006,2005-12-01,2006-02-28,90,18,0,39,39,0,0,0,39,0,0,Alabama,Montgomery,205764
250,2006-2007,2006-12-01,2007-02-28,90,1,0,44,44,0,0,0,44,0,0,Alabama,Montgomery,205764
251,2007-2008,2007-12-01,2008-02-29,91,4,0,40,40,0,0,0,40,0,0,Alabama,Montgomery,205764
252,2008-2009,2008-12-01,2009-02-28,90,0,0,42,42,0,0,0,42,0,0,Alabama,Montgomery,205764
253,2009-2010,2009-12-01,2010-02-28,90,0,1,69,70,4,1,5,75,1,5,Alabama,Montgomery,205764
254,2010-2011,2010-12-01,2011-02-28,90,0,0,70,70,0,0,0,70,0,0,Alabama,Montgomery,205764
255,2011-2012,2011-12-01,2012-02-29,91,0,0,26,26,0,0,0,26,0,0,Alabama,Montgomery,205764
256,2012-2013,2012-12-01,2013-02-28,90,0,0,17,17,0,0,0,17,0,0,Alabama,Montgomery,205764
257,2013-2014,2013-12-01,2014-02-28,90,2,2,66,68,1,0,1,69,1,3,Alabama,Montgomery,205764
258,2014-2015,2014-12-01,2015-02-28,90,2,0,47,47,0,0,0,47,0,0,Alabama,Montgomery,205764
259,2015-2016,2015-12-01,2016-02-29,91,7,0,25,25,0,0,0,25,0,0,Alabama,Montgomery,205764
260,2016-2017,2016-12-01,2017-02-28,90,9,0,14,14,0,0,0,14,0,0,Alabama,Montgomery,205764
261,2017-2018,2017-12-01,2018-02-28,90,8,1,50,51,0,0,0,51,0,0,Alabama,Montgomery,205764
262,2018-2019,2018-12-01,2019-02-28,90,6,0,20,20,0,0,0,20,0,0,Alabama,Montgomery,205764
263,1950-1951,1950-11-24,1951-03-13,110,0,12,107,119,12,12,24,143,4,26,Alabama,Muscle Shoals,13146
264,1951-1952,1951-12-01,1952-02-29,91,2,3,41,44,0,0,0,44,0,0,Alabama,Muscle Shoals,13146
265,1952-1953,1952-11-30,1953-02-28,91,2,2,29,31,0,0,0,31,0,0,Alabama,Muscle Shoals,13146
266,1953-1954,1953-12-01,1954-02-28,90,0,3,50,53,3,2,5,58,1,4,Alabama,Muscle Shoals,13146
267,1954-1955,1954-12-01,1955-03-26,116,0,3,75,78,4,2,6,84,2,7,Alabama,Muscle Shoals,13146
268,1955-1956,1955-12-01,1956-02-29,91,0,0,58,58,3,1,4,62,1,4,Alabama,Muscle Shoals,13146
269,1956-1957,1956-12-01,1957-02-28,90,1,2,33,35,0,0,0,35,0,0,Alabama,Muscle Shoals,13146
270,1957-1958,1957-12-01,1958-02-28,90,2,11,109,120,4,8,12,132,2,8,Alabama,Muscle Shoals,13146
271,1958-1959,1958-12-01,1959-02-28,90,0,7,92,99,2,1,3,102,1,5,Alabama,Muscle Shoals,13146
272,1959-1960,1959-12-01,1960-03-14,105,0,5,76,81,24,19,43,124,5,30,Alabama,Muscle Shoals,13146
273,1960-1961,1960-12-01,1961-02-28,90,2,5,118,123,0,0,0,123,0,0,Alabama,Muscle Shoals,13146
274,1961-1962,1961-12-01,1962-02-28,90,2,11,89,100,0,12,12,112,0,0,Alabama,Muscle Shoals,13146
275,1962-1963,1962-12-01,1963-02-28,90,2,15,173,188,2,1,3,191,2,11,Alabama,Muscle Shoals,13146
276,1963-1964,1963-12-01,1964-02-29,91,3,4,121,125,24,28,52,177,4,33,Alabama,Muscle Shoals,13146
277,1964-1965,1964-12-01,1965-03-05,95,4,5,96,101,4,0,4,105,3,11,Alabama,Muscle Shoals,13146
278,1965-1966,1965-12-01,1966-02-28,90,0,7,90,97,16,15,31,128,3,26,Alabama,Muscle Shoals,13146
279,1966-1967,1966-12-01,1967-02-28,90,0,1,71,72,2,0,2,74,1,3,Alabama,Muscle Shoals,13146
280,1967-1968,1967-12-01,1968-03-24,115,0,6,115,121,29,25,54,175,8,45,Alabama,Muscle Shoals,13146
281,1968-1969,1968-12-01,1969-02-28,90,0,1,82,83,4,2,6,89,2,6,Alabama,Muscle Shoals,13146
282,1969-1970,1969-11-14,1970-02-28,107,0,10,97,107,5,1,6,113,4,16,Alabama,Muscle Shoals,13146
283,1970-1971,1970-11-24,1971-02-28,97,0,7,92,99,4,1,5,104,2,12,Alabama,Muscle Shoals,13146
284,1971-1972,1971-12-01,1972-02-29,91,0,3,49,52,0,0,0,52,0,0,Alabama,Muscle Shoals,13146
285,1972-1973,1972-12-01,1973-02-28,90,0,8,87,95,0,0,0,95,0,0,Alabama,Muscle Shoals,13146
286,1973-1974,1973-12-01,1974-02-28,90,0,2,55,57,0,0,0,57,0,0,Alabama,Muscle Shoals,13146
287,1974-1975,1974-12-01,1975-02-28,90,0,1,65,66,3,3,6,72,2,6,Alabama,Muscle Shoals,13146
288,1975-1976,1975-12-01,1976-02-29,91,0,4,91,95,0,0,0,95,0,0,Alabama,Muscle Shoals,13146
289,1976-1977,1976-11-29,1977-02-28,92,0,18,174,192,2,2,4,196,2,18,Alabama,Muscle Shoals,13146
290,1977-1978,1977-12-01,1978-02-28,90,0,19,147,166,10,12,22,188,4,20,Alabama,Muscle Shoals,13146
291,1978-1979,1978-12-01,1979-02-28,90,0,10,111,121,11,5,16,137,6,18,Alabama,Muscle Shoals,13146
292,1979-1980,1979-12-01,1980-03-02,93,0,7,82,89,4,2,6,95,2,10,Alabama,Muscle Shoals,13146
293,1980-1981,1980-12-01,1981-02-28,90,0,7,109,116,0,0,0,116,0,0,Alabama,Muscle Shoals,13146
294,1981-1982,1981-12-01,1982-02-28,90,0,14,100,114,3,10,13,127,1,8,Alabama,Muscle Shoals,13146
295,1982-1983,1982-12-01,1983-02-28,90,0,1,55,56,2,1,3,59,2,6,Alabama,Muscle Shoals,13146
296,1983-1984,1983-12-01,1984-02-29,91,0,15,113,128,7,4,11,139,5,14,Alabama,Muscle Shoals,13146
297,1984-1985,1984-12-01,1985-02-28,90,0,11,110,121,17,35,52,173,6,41,Alabama,Muscle Shoals,13146
298,1985-1986,1985-12-01,1986-02-28,90,0,7,114,121,1,1,2,123,1,3,Alabama,Muscle Shoals,13146
299,1986-1987,1986-12-01,1987-04-02,123,0,1,60,61,1,0,1,62,1,1,Alabama,Muscle Shoals,13146
300,1987-1988,1987-12-01,1988-02-29,91,3,7,94,101,4,25,29,130,2,10,Alabama,Muscle Shoals,13146
301,1988-1989,1988-12-01,1989-02-28,90,0,1,58,59,2,0,2,61,1,2,Alabama,Muscle Shoals,13146
302,1989-1990,1989-12-01,1990-02-28,90,0,12,81,93,4,5,9,102,2,13,Alabama,Muscle Shoals,13146
303,1990-1991,1990-12-01,1991-03-08,98,1,1,57,58,2,1,3,61,1,2,Alabama,Muscle Shoals,13146
304,1991-1992,1991-12-01,1992-02-29,91,0,1,40,41,0,0,0,41,0,0,Alabama,Muscle Shoals,13146
305,1992-1993,1992-12-01,1993-03-13,103,0,2,51,53,6,4,10,63,2,10,Alabama,Muscle Shoals,13146
306,1993-1994,1993-12-01,1994-02-28,90,0,4,81,85,0,0,0,85,0,0,Alabama,Muscle Shoals,13146
307,1994-1995,1994-12-01,1995-02-28,90,0,1,58,59,2,1,3,62,1,5,Alabama,Muscle Shoals,13146
308,2002-2003,2002-12-01,2003-02-28,90,0,5,87,92,3,0,3,95,2,10,Alabama,Muscle Shoals,13146
309,2003-2004,2003-12-01,2004-02-29,91,5,0,77,77,0,0,0,77,0,0,Alabama,Muscle Shoals,13146
310,2004-2005,2004-12-01,2005-02-28,90,4,1,57,58,0,0,0,58,0,0,Alabama,Muscle Shoals,13146
311,2005-2006,2005-12-01,2006-02-28,90,0,1,65,66,3,0,3,69,3,7,Alabama,Muscle Shoals,13146
312,2006-2007,2006-12-01,2007-02-28,90,8,0,71,71,1,0,1,72,1,3,Alabama,Muscle Shoals,13146
313,2007-2008,2007-12-01,2008-03-08,99,13,2,75,77,2,1,3,80,2,4,Alabama,Muscle Shoals,13146
314,2008-2009,2008-12-01,2009-03-01,91,10,3,88,91,2,1,3,94,1,3,Alabama,Muscle Shoals,13146
315,2009-2010,2009-12-01,2010-02-28,90,0,6,105,111,7,0,7,118,4,14,Alabama,Muscle Shoals,13146
316,2010-2011,2010-12-01,2011-02-28,90,2,4,100,104,22,31,53,157,7,32,Alabama,Muscle Shoals,13146
317,2011-2012,2011-12-01,2012-02-29,91,0,0,43,43,1,0,1,44,1,2,Alabama,Muscle Shoals,13146
318,2012-2013,2012-12-01,2013-02-28,90,0,0,38,38,0,0,0,38,0,0,Alabama,Muscle Shoals,13146
319,2013-2014,2013-12-01,2014-02-28,90,1,8,105,113,2,2,4,117,2,4,Alabama,Muscle Shoals,13146
320,2014-2015,2014-12-01,2015-03-05,95,6,4,76,80,5,4,9,89,2,8,Alabama,Muscle Shoals,13146
321,2015-2016,2015-12-01,2016-02-29,91,6,1,52,53,0,0,0,53,0,0,Alabama,Muscle Shoals,13146
322,2016-2017,2016-12-01,2017-02-28,90,5,3,43,46,0,0,0,46,0,0,Alabama,Muscle Shoals,13146
323,2017-2018,2017-12-01,2018-02-28,90,0,6,88,94,1,1,2,96,1,5,Alabama,Muscle Shoals,13146
324,2018-2019,2018-12-01,2019-02-28,90,7,0,32,32,0,0,0,32,0,0,Alabama,Muscle Shoals,13146
325,1950-1951,1950-11-25,1951-02-28,96,0,3,86,89,1,1,2,91,1,5,Alabama,Tuscaloosa,90468
326,1951-1952,1951-12-01,1952-02-29,91,0,0,37,37,0,0,0,37,0,0,Alabama,Tuscaloosa,90468
327,1952-1953,1952-12-01,1953-02-28,90,0,0,44,44,0,0,0,44,0,0,Alabama,Tuscaloosa,90468
328,1953-1954,1953-12-01,1954-02-28,90,0,0,49,49,0,0,0,49,0,0,Alabama,Tuscaloosa,90468
329,1954-1955,1954-12-01,1955-02-28,90,0,0,63,63,0,0,0,63,0,0,Alabama,Tuscaloosa,90468
330,1955-1956,1955-12-01,1956-02-29,91,0,0,50,50,0,0,0,50,0,0,Alabama,Tuscaloosa,90468
331,1956-1957,1956-12-01,1957-02-28,90,0,0,29,29,0,0,0,29,0,0,Alabama,Tuscaloosa,90468
332,1957-1958,1957-12-01,1958-02-28,90,0,3,94,97,0,0,0,97,0,0,Alabama,Tuscaloosa,90468
333,1958-1959,1958-12-01,1959-02-28,90,0,1,76,77,0,0,0,77,0,0,Alabama,Tuscaloosa,90468
334,1959-1960,1959-12-01,1960-02-29,91,14,0,53,53,10,5,15,68,1,11,Alabama,Tuscaloosa,90468
335,1960-1961,1960-12-01,1961-02-28,90,2,1,74,75,0,0,0,75,0,0,Alabama,Tuscaloosa,90468
336,1962-1963,1962-12-01,1963-02-28,90,0,7,116,123,0,0,0,123,0,0,Alabama,Tuscaloosa,90468
337,1963-1964,1963-12-01,1964-02-29,91,0,1,101,102,3,9,12,114,1,4,Alabama,Tuscaloosa,90468
338,1964-1965,1964-12-01,1965-02-28,90,0,0,59,59,0,0,0,59,0,0,Alabama,Tuscaloosa,90468
339,1965-1966,1965-12-01,1966-02-28,90,0,2,68,70,2,0,2,72,1,7,Alabama,Tuscaloosa,90468
340,1966-1967,1966-12-01,1967-02-28,90,0,0,58,58,0,0,0,58,0,0,Alabama,Tuscaloosa,90468
341,1967-1968,1967-12-01,1968-02-29,91,0,1,61,62,2,0,2,64,2,5,Alabama,Tuscaloosa,90468
342,1968-1969,1968-12-01,1969-02-28,90,0,0,81,81,0,0,0,81,0,0,Alabama,Tuscaloosa,90468
343,1969-1970,1969-12-01,1970-02-28,90,0,4,79,83,0,0,0,83,0,0,Alabama,Tuscaloosa,90468
344,1970-1971,1970-12-01,1971-02-28,90,0,1,62,63,2,0,2,65,1,4,Alabama,Tuscaloosa,90468
345,1971-1972,1971-12-01,1972-02-29,91,0,0,35,35,0,0,0,35,0,0,Alabama,Tuscaloosa,90468
346,1972-1973,1972-12-01,1973-02-28,90,0,0,51,51,0,0,0,51,0,0,Alabama,Tuscaloosa,90468
347,1973-1974,1973-12-01,1974-02-28,90,0,0,43,43,0,0,0,43,0,0,Alabama,Tuscaloosa,90468
348,1974-1975,1974-12-01,1975-02-28,90,0,0,34,34,0,0,0,34,0,0,Alabama,Tuscaloosa,90468
349,1975-1976,1975-12-01,1976-02-29,91,0,2,71,73,0,0,0,73,0,0,Alabama,Tuscaloosa,90468
350,1976-1977,1976-12-01,1977-02-28,90,0,5,122,127,6,6,12,139,1,12,Alabama,Tuscaloosa,90468
351,1977-1978,1977-12-01,1978-02-28,90,0,6,112,118,2,1,3,121,1,3,Alabama,Tuscaloosa,90468
352,1978-1979,1978-12-01,1979-02-28,90,0,0,63,63,0,0,0,63,0,0,Alabama,Tuscaloosa,90468
353,1979-1980,1979-12-01,1980-03-02,93,0,1,48,49,2,1,3,52,1,6,Alabama,Tuscaloosa,90468
354,1980-1981,1980-12-01,1981-02-28,90,0,0,79,79,0,0,0,79,0,0,Alabama,Tuscaloosa,90468
355,1981-1982,1981-12-01,1982-02-28,90,0,4,73,77,4,3,7,84,1,8,Alabama,Tuscaloosa,90468
356,1982-1983,1982-12-01,1983-02-28,90,0,0,29,29,0,0,0,29,0,0,Alabama,Tuscaloosa,90468
357,1983-1984,1983-12-01,1984-02-29,91,0,6,87,93,2,0,2,95,1,3,Alabama,Tuscaloosa,90468
358,1984-1985,1984-12-01,1985-02-28,90,0,3,89,92,1,1,2,94,1,7,Alabama,Tuscaloosa,90468
359,1985-1986,1985-12-01,1986-02-28,90,0,3,82,85,0,0,0,85,0,0,Alabama,Tuscaloosa,90468
360,1986-1987,1986-12-01,1987-02-28,90,0,0,47,47,0,0,0,47,0,0,Alabama,Tuscaloosa,90468
361,1987-1988,1987-12-01,1988-02-29,91,0,1,75,76,0,0,0,76,0,0,Alabama,Tuscaloosa,90468
362,1988-1989,1988-12-01,1989-02-28,90,0,0,43,43,0,0,0,43,0,0,Alabama,Tuscaloosa,90468
363,1989-1990,1989-12-01,1990-02-28,90,0,6,55,61,0,0,0,61,0,0,Alabama,Tuscaloosa,90468
364,1990-1991,1990-12-01,1991-02-28,90,0,0,42,42,0,0,0,42,0,0,Alabama,Tuscaloosa,90468
365,1991-1992,1991-12-01,1992-02-29,91,2,0,42,42,0,0,0,42,0,0,Alabama,Tuscaloosa,90468
366,1992-1993,1992-12-01,1993-03-13,103,1,0,37,37,5,0,5,42,2,8,Alabama,Tuscaloosa,90468
367,1993-1994,1993-12-01,1994-02-28,90,2,1,66,67,0,0,0,67,0,0,Alabama,Tuscaloosa,90468
368,2006-2007,2006-12-01,2007-02-28,90,7,0,56,56,0,0,0,56,0,0,Alabama,Tuscaloosa,90468
369,2008-2009,2008-12-01,2009-02-28,90,13,0,56,56,0,0,0,56,0,0,Alabama,Tuscaloosa,90468
370,2009-2010,2009-12-01,2010-02-28,90,16,1,65,66,2,0,2,68,1,3,Alabama,Tuscaloosa,90468
371,2010-2011,2010-12-01,2011-02-28,90,0,3,77,80,0,0,0,80,0,0,Alabama,Tuscaloosa,90468
372,2011-2012,2011-12-01,2012-02-29,91,1,0,35,35,0,0,0,35,0,0,Alabama,Tuscaloosa,90468
373,2012-2013,2012-12-01,2013-02-28,90,0,0,29,29,1,0,1,30,1,1,Alabama,Tuscaloosa,90468
374,2013-2014,2013-12-01,2014-02-28,90,1,3,80,83,2,0,2,85,2,5,Alabama,Tuscaloosa,90468
375,2014-2015,2014-12-01,2015-02-28,90,2,1,56,57,0,0,0,57,0,0,Alabama,Tuscaloosa,90468
376,2015-2016,2015-12-01,2016-02-29,91,4,0,43,43,0,0,0,43,0,0,Alabama,Tuscaloosa,90468
377,2016-2017,2016-12-01,2017-02-28,90,13,0,30,30,0,0,0,30,0,0,Alabama,Tuscaloosa,90468
378,2017-2018,2017-12-01,2018-02-28,90,13,2,59,61,0,0,0,61,0,0,Alabama,Tuscaloosa,90468
379,2018-2019,2018-12-01,2019-02-28,90,5,0,24,24,0,0,0,24,0,0,Alabama,Tuscaloosa,90468
380,2019-2020,2019-12-01,2020-02-29,91,9,0,22,22,0,0,0,22,0,0,Alabama,Tuscaloosa,90468
381,1950-1951,1950-10-22,1951-04-13,174,2,373,988,1361,88,893,981,2342,31,262,Alaska,Anchorage,291826
382,1951-1952,1951-10-04,1952-05-06,216,0,297,885,1182,104,701,805,1987,43,303,Alaska,Anchorage,291826
383,1952-1953,1952-10-19,1953-04-15,179,3,230,677,907,85,422,507,1414,41,245,Alaska,Anchorage,291826
384,1953-1954,1953-10-27,1954-04-14,170,0,291,819,1110,74,745,819,1929,41,273,Alaska,Anchorage,291826
385,1954-1955,1954-10-19,1955-05-06,200,0,267,741,1008,193,1018,1211,2219,63,487,Alaska,Anchorage,291826
386,1955-1956,1955-10-11,1956-04-27,200,0,427,1016,1443,193,1528,1721,3164,64,520,Alaska,Anchorage,291826
387,1956-1957,1956-10-13,1957-04-05,175,0,337,817,1154,108,697,805,1959,48,391,Alaska,Anchorage,291826
388,1957-1958,1957-11-08,1958-04-23,167,0,193,562,755,53,456,509,1264,32,196,Alaska,Anchorage,291826
389,1958-1959,1958-10-03,1959-04-26,206,0,319,825,1144,141,1188,1329,2473,48,345,Alaska,Anchorage,291826
390,1959-1960,1959-10-11,1960-04-20,193,0,203,656,859,131,1140,1271,2130,62,349,Alaska,Anchorage,291826
391,1960-1961,1960-10-22,1961-04-22,183,0,207,591,798,63,361,424,1222,36,236,Alaska,Anchorage,291826
392,1961-1962,1961-10-07,1962-04-28,204,0,364,862,1226,112,696,808,2034,51,342,Alaska,Anchorage,291826
393,1962-1963,1962-10-28,1963-05-09,194,0,226,603,829,124,447,571,1400,42,290,Alaska,Anchorage,291826
394,1963-1964,1963-10-25,1964-05-22,211,2,288,734,1022,98,469,567,1589,51,283,Alaska,Anchorage,291826
395,1964-1965,1964-10-16,1965-05-02,199,0,356,777,1133,120,920,1040,2173,45,290,Alaska,Anchorage,291826
396,1965-1966,1965-09-29,1966-04-18,202,0,327,842,1169,142,1283,1425,2594,56,388,Alaska,Anchorage,291826
397,1966-1967,1966-10-17,1967-04-14,180,0,331,825,1156,114,1061,1175,2331,52,322,Alaska,Anchorage,291826
398,1967-1968,1967-10-25,1968-04-28,187,0,241,563,804,116,526,642,1446,53,297,Alaska,Anchorage,291826
399,1968-1969,1968-09-29,1969-04-12,196,0,334,752,1086,90,1160,1250,2336,39,277,Alaska,Anchorage,291826
400,1969-1970,1969-10-28,1970-04-11,166,0,174,429,603,68,312,380,983,35,213,Alaska,Anchorage,291826
401,1970-1971,1970-10-15,1971-04-30,198,0,376,801,1177,90,629,719,1896,47,273,Alaska,Anchorage,291826
402,1971-1972,1971-10-04,1972-05-05,215,0,382,900,1282,118,1131,1249,2531,63,444,Alaska,Anchorage,291826
403,1972-1973,1972-09-28,1973-04-30,215,0,360,798,1158,79,914,993,2151,47,312,Alaska,Anchorage,291826
404,1973-1974,1973-10-08,1974-04-24,199,3,332,798,1130,93,675,768,1898,46,311,Alaska,Anchorage,291826
405,1974-1975,1974-10-04,1975-05-04,213,0,289,700,989,134,1058,1192,2181,71,426,Alaska,Anchorage,291826
406,1975-1976,1975-10-27,1976-04-26,183,0,354,735,1089,99,604,703,1792,52,345,Alaska,Anchorage,291826
407,1976-1977,1976-10-25,1977-04-30,188,0,96,349,445,108,442,550,995,56,281,Alaska,Anchorage,291826
408,1977-1978,1977-09-29,1978-04-09,193,0,223,586,809,108,1036,1144,1953,39,241,Alaska,Anchorage,291826
409,1978-1979,1978-10-21,1979-04-14,176,0,160,527,687,138,1038,1176,1863,54,291,Alaska,Anchorage,291826
410,1979-1980,1979-10-27,1980-04-12,169,0,214,518,732,103,387,490,1222,50,319,Alaska,Anchorage,291826
411,1980-1981,1980-10-07,1981-04-02,178,0,208,476,684,52,173,225,909,30,120,Alaska,Anchorage,291826
412,1981-1982,1981-09-24,1982-05-11,230,0,314,741,1055,76,508,584,1639,43,260,Alaska,Anchorage,291826
413,1982-1983,1982-10-07,1983-04-19,195,0,255,580,835,101,497,598,1433,37,254,Alaska,Anchorage,291826
414,1983-1984,1983-10-09,1984-04-22,197,0,196,521,717,121,1002,1123,1840,52,314,Alaska,Anchorage,291826
415,1984-1985,1984-10-20,1985-05-08,201,3,216,621,837,93,732,825,1662,45,266,Alaska,Anchorage,291826
416,1985-1986,1985-10-18,1986-05-10,205,0,215,597,812,67,196,263,1075,27,164,Alaska,Anchorage,291826
417,1986-1987,1986-10-30,1987-04-16,169,0,136,416,552,69,460,529,1081,43,183,Alaska,Anchorage,291826
418,1987-1988,1987-10-29,1988-04-18,173,0,171,474,645,126,1186,1312,1957,64,362,Alaska,Anchorage,291826
419,1988-1989,1988-10-06,1989-05-17,224,0,273,734,1007,100,721,821,1828,59,391,Alaska,Anchorage,291826
420,1989-1990,1989-10-16,1990-04-11,178,0,299,684,983,153,1079,1232,2215,67,484,Alaska,Anchorage,291826
421,1990-1991,1990-10-13,1991-04-15,185,0,313,726,1039,99,903,1002,2041,50,355,Alaska,Anchorage,291826
422,1991-1992,1991-10-13,1992-05-05,206,0,222,609,831,150,1510,1660,2491,53,383,Alaska,Anchorage,291826
423,1992-1993,1992-09-30,1993-04-12,195,0,230,605,835,120,846,966,1801,58,373,Alaska,Anchorage,291826
424,1993-1994,1993-10-17,1994-04-17,183,0,193,515,708,102,554,656,1364,48,256,Alaska,Anchorage,291826
425,1994-1995,1994-10-08,1995-04-16,191,0,292,723,1015,177,1500,1677,2692,56,449,Alaska,Anchorage,291826
426,1995-1996,1995-10-14,1996-04-10,180,0,291,655,946,105,483,588,1534,38,279,Alaska,Anchorage,291826
427,1996-1997,1996-09-21,1997-04-13,205,0,264,641,905,108,1234,1342,2247,43,266,Alaska,Anchorage,291826
428,1997-1998,1997-10-14,1998-04-28,197,3,192,539,731,93,1081,1174,1905,55,349,Alaska,Anchorage,291826
429,1998-1999,1998-10-17,1999-05-01,197,0,333,731,1064,144,1225,1369,2433,58,470,Alaska,Anchorage,291826
430,1999-2000,1999-10-13,2000-04-17,188,0,241,577,818,132,1166,1298,2116,53,394,Alaska,Anchorage,291826
431,2000-2001,2000-10-12,2001-05-05,206,0,109,397,506,103,628,731,1237,49,233,Alaska,Anchorage,291826
432,2001-2002,2001-10-11,2002-05-03,205,0,269,696,965,119,1377,1496,2461,45,287,Alaska,Anchorage,291826
433,2002-2003,2002-11-10,2003-04-16,158,0,118,334,452,62,346,408,860,31,189,Alaska,Anchorage,291826
434,2003-2004,2003-11-10,2004-04-22,165,1,258,605,863,165,1387,1552,2415,54,397,Alaska,Anchorage,291826
435,2004-2005,2004-09-25,2005-04-18,206,0,170,449,619,116,590,706,1325,42,224,Alaska,Anchorage,291826
436,2005-2006,2005-10-27,2006-05-08,194,0,272,601,873,107,885,992,1865,53,401,Alaska,Anchorage,291826
437,2006-2007,2006-10-26,2007-04-13,170,0,308,705,1013,123,1166,1289,2302,44,385,Alaska,Anchorage,291826
438,2007-2008,2007-10-23,2008-04-29,190,0,232,539,771,160,794,954,1725,55,432,Alaska,Anchorage,291826
439,2008-2009,2008-10-06,2009-04-13,190,0,313,693,1006,141,1006,1147,2153,64,455,Alaska,Anchorage,291826
440,2009-2010,2009-11-01,2010-04-22,173,0,195,491,686,111,1075,1186,1872,41,305,Alaska,Anchorage,291826
441,2010-2011,2010-11-02,2011-04-12,162,0,235,591,826,92,942,1034,1860,40,245,Alaska,Anchorage,291826
442,2011-2012,2011-10-30,2012-04-24,178,0,307,674,981,192,1512,1704,2685,73,608,Alaska,Anchorage,291826
443,2012-2013,2012-09-29,2013-05-18,232,0,223,615,838,139,1133,1272,2110,57,328,Alaska,Anchorage,291826
444,2013-2014,2013-11-07,2014-04-13,158,0,179,482,661,97,870,967,1628,42,281,Alaska,Anchorage,291826
445,2014-2015,2014-10-19,2015-04-21,185,0,131,386,517,39,400,439,956,23,103,Alaska,Anchorage,291826
446,2015-2016,2015-09-29,2016-03-22,176,0,118,347,465,58,234,292,757,26,141,Alaska,Anchorage,291826
447,2016-2017,2016-10-20,2017-04-17,180,0,258,636,894,118,1072,1190,2084,44,355,Alaska,Anchorage,291826
448,2017-2018,2017-10-20,2018-04-14,177,0,171,486,657,84,897,981,1638,33,216,Alaska,Anchorage,291826
449,2018-2019,2018-10-29,2019-04-24,178,0,131,381,512,94,799,893,1405,46,241,Alaska,Anchorage,291826
450,2019-2020,2019-10-16,2020-04-19,187,2,234,560,794,127,913,1040,1834,50,359,Alaska,Anchorage,291826
451,1950-1951,1950-09-26,1951-05-19,236,6,1088,1790,2878,163,2280,2443,5321,59,760,Alaska,Bettles,12
452,1951-1952,1951-10-01,1952-05-26,239,3,1008,1941,2949,150,2600,2750,5699,76,951,Alaska,Bettles,12
453,1952-1953,1952-09-18,1953-04-29,224,0,929,1741,2670,113,1488,1601,4271,58,595,Alaska,Bettles,12
454,1953-1954,1953-09-29,1954-05-08,222,1,1140,1928,3068,76,1180,1256,4324,43,606,Alaska,Bettles,12
455,1954-1955,1954-10-05,1955-05-17,225,5,1126,1942,3068,143,1896,2039,5107,44,605,Alaska,Bettles,12
456,1955-1956,1955-10-02,1956-05-22,234,0,1296,2198,3494,112,2362,2474,5968,49,693,Alaska,Bettles,12
457,1956-1957,1956-09-23,1957-05-19,239,1,1218,2092,3310,113,1939,2052,5362,40,482,Alaska,Bettles,12
458,1957-1958,1957-09-27,1958-05-14,230,1,846,1653,2499,100,1764,1864,4363,65,648,Alaska,Bettles,12
459,1958-1959,1958-10-02,1959-05-17,228,3,1136,2052,3188,84,2152,2236,5424,43,495,Alaska,Bettles,12
460,1959-1960,1959-10-05,1960-05-11,220,1,924,1769,2693,122,1743,1865,4558,55,744,Alaska,Bettles,12
461,1960-1961,1960-09-21,1961-05-05,227,0,903,1709,2612,72,860,932,3544,51,493,Alaska,Bettles,12
462,1961-1962,1961-10-03,1962-05-21,231,2,1081,1958,3039,96,2007,2103,5142,45,499,Alaska,Bettles,12
463,1962-1963,1962-10-10,1963-05-15,218,3,952,1706,2658,128,2436,2564,5222,42,431,Alaska,Bettles,12
464,1963-1964,1963-10-08,1964-05-30,236,0,1174,2045,3219,130,2362,2492,5711,51,589,Alaska,Bettles,12
465,1964-1965,1964-10-15,1965-05-24,222,3,1089,1909,2998,176,2371,2547,5545,77,896,Alaska,Bettles,12
466,1965-1966,1965-09-22,1966-05-17,238,0,1225,2057,3282,99,1945,2044,5326,60,790,Alaska,Bettles,12
467,1966-1967,1966-10-08,1967-05-20,225,8,1082,1912,2994,116,1868,1984,4978,67,719,Alaska,Bettles,12
468,1967-1968,1967-10-02,1968-05-26,238,0,962,1908,2870,155,2602,2757,5627,67,792,Alaska,Bettles,12
469,1968-1969,1968-09-26,1969-05-16,233,0,1116,1967,3083,65,1598,1663,4746,43,537,Alaska,Bettles,12
470,1969-1970,1969-08-09,1970-05-09,274,0,832,1581,2413,117,1107,1224,3637,56,580,Alaska,Bettles,12
471,1970-1971,1970-09-21,1971-05-21,243,0,1354,2391,3745,190,2292,2482,6227,59,995,Alaska,Bettles,12
472,1971-1972,1971-09-29,1972-05-20,235,3,1292,2298,3590,143,2729,2872,6462,61,753,Alaska,Bettles,12
473,1972-1973,1972-09-27,1973-05-13,229,0,1007,1842,2849,195,2567,2762,5611,65,808,Alaska,Bettles,12
474,1973-1974,1973-09-24,1974-05-06,225,8,1121,2030,3151,84,1612,1696,4847,44,554,Alaska,Bettles,12
475,1974-1975,1974-09-29,1975-05-05,219,0,1133,1980,3113,107,1390,1497,4610,55,740,Alaska,Bettles,12
476,1975-1976,1975-10-05,1976-05-03,212,0,1193,2007,3200,105,1606,1711,4911,56,691,Alaska,Bettles,12
477,1976-1977,1976-10-01,1977-05-10,222,0,815,1523,2338,148,1841,1989,4327,62,662,Alaska,Bettles,12
478,1977-1978,1977-10-05,1978-05-04,212,0,923,1622,2545,125,1572,1697,4242,55,631,Alaska,Bettles,12
479,1978-1979,1978-09-23,1979-05-05,225,0,953,1792,2745,135,1870,2005,4750,68,742,Alaska,Bettles,12
480,1979-1980,1979-09-14,1980-05-06,236,0,870,1648,2518,159,1578,1737,4255,85,851,Alaska,Bettles,12
481,1980-1981,1980-09-01,1981-05-08,250,0,779,1562,2341,149,1817,1966,4307,82,765,Alaska,Bettles,12
482,1981-1982,1981-09-22,1982-05-21,242,3,992,1766,2758,130,1698,1828,4586,76,765,Alaska,Bettles,12
483,1982-1983,1982-10-02,1983-05-01,212,3,959,1716,2675,99,1545,1644,4319,66,670,Alaska,Bettles,12
484,1983-1984,1983-09-23,1984-05-18,239,0,1109,1930,3039,160,1618,1778,4817,73,959,Alaska,Bettles,12
485,1984-1985,1984-09-30,1985-05-20,233,3,938,1696,2634,132,1513,1645,4279,71,771,Alaska,Bettles,12
486,1985-1986,1985-09-18,1986-05-21,246,15,871,1679,2550,74,1421,1495,4045,49,460,Alaska,Bettles,12
487,1986-1987,1986-09-23,1987-05-02,222,0,823,1660,2483,99,1435,1534,4017,63,780,Alaska,Bettles,12
488,1987-1988,1987-09-18,1988-05-03,229,0,793,1448,2241,174,2201,2375,4616,84,922,Alaska,Bettles,12
489,1988-1989,1988-09-29,1989-05-15,229,3,1006,1787,2793,158,1900,2058,4851,79,875,Alaska,Bettles,12
490,1989-1990,1989-10-09,1990-05-09,213,3,1117,1918,3035,129,1570,1699,4734,63,777,Alaska,Bettles,12
491,1990-1991,1990-09-25,1991-05-05,223,2,1055,1878,2933,200,2109,2309,5242,99,1366,Alaska,Bettles,12
492,1991-1992,1991-10-06,1992-05-19,227,0,920,1846,2766,102,1297,1399,4165,64,778,Alaska,Bettles,12
493,1992-1993,1992-09-09,1993-05-13,247,0,893,1757,2650,258,2469,2727,5377,76,879,Alaska,Bettles,12
494,1993-1994,1993-09-17,1994-05-29,255,0,842,1597,2439,168,2036,2204,4643,83,836,Alaska,Bettles,12
495,1994-1995,1994-09-19,1995-04-28,222,3,1003,1846,2849,137,2468,2605,5454,62,866,Alaska,Bettles,12
496,1995-1996,1995-10-11,1996-05-20,223,3,1076,1929,3005,91,1675,1766,4771,45,477,Alaska,Bettles,12
497,1996-1997,1996-09-11,1997-05-04,236,0,970,1777,2747,122,2363,2485,5232,67,786,Alaska,Bettles,12
498,1998-1999,1998-09-29,1999-05-11,225,0,970,1838,2808,114,1469,1583,4391,75,1016,Alaska,Bettles,12
499,1999-2000,1999-09-25,2000-05-20,239,0,944,1828,2772,148,1759,1907,4679,71,882,Alaska,Bettles,12
500,2000-2001,2000-09-16,2001-05-25,252,6,670,1502,2172,174,1971,2145,4317,99,1006,Alaska,Bettles,12
501,2001-2002,2001-09-30,2002-05-17,230,0,845,1708,2553,158,1807,1965,4518,88,1036,Alaska,Bettles,12
502,2002-2003,2002-09-19,2003-05-23,247,3,657,1412,2069,146,1877,2023,4092,61,507,Alaska,Bettles,12
503,2003-2004,2003-09-10,2004-05-09,243,3,880,1830,2710,146,1707,1853,4563,65,890,Alaska,Bettles,12
504,2004-2005,2004-09-15,2005-05-10,238,3,864,1740,2604,205,2289,2494,5098,88,981,Alaska,Bettles,12
505,2005-2006,2005-09-30,2006-05-12,225,8,977,1812,2789,138,1711,1849,4638,74,879,Alaska,Bettles,12
506,2006-2007,2006-10-02,2007-04-23,204,0,928,1742,2670,79,1175,1254,3924,58,775,Alaska,Bettles,12
507,2007-2008,2007-09-26,2008-05-12,230,0,895,1691,2586,153,1656,1809,4395,92,992,Alaska,Bettles,12
508,2008-2009,2008-09-30,2009-05-11,224,4,1054,1978,3032,178,2047,2225,5257,88,1224,Alaska,Bettles,12
509,2009-2010,2009-09-22,2010-05-10,231,0,957,1810,2767,109,1296,1405,4172,50,644,Alaska,Bettles,12
510,2010-2011,2010-09-27,2011-05-14,230,2,974,1947,2921,154,1808,1962,4883,66,785,Alaska,Bettles,12
511,2011-2012,2011-09-28,2012-05-11,227,0,1087,1947,3034,149,1846,1995,5029,78,1051,Alaska,Bettles,12
512,2012-2013,2012-09-27,2013-05-22,238,0,1005,1995,3000,97,1288,1385,4385,56,739,Alaska,Bettles,12
513,2013-2014,2013-09-18,2014-05-07,232,0,756,1625,2381,151,1698,1849,4230,78,821,Alaska,Bettles,12
514,2014-2015,2014-09-21,2015-05-03,225,0,724,1608,2332,129,1414,1543,3875,72,712,Alaska,Bettles,12
515,2015-2016,2015-09-18,2016-05-01,227,0,600,1358,1958,163,1772,1935,3893,72,728,Alaska,Bettles,12
516,2016-2017,2016-09-13,2017-05-07,237,3,928,1859,2787,133,1469,1602,4389,69,908,Alaska,Bettles,12
517,2017-2018,2017-09-30,2018-05-13,226,0,725,1519,2244,180,2146,2326,4570,92,942,Alaska,Bettles,12
518,2018-2019,2018-10-11,2019-05-20,222,2,627,1344,1971,232,2198,2430,4401,85,891,Alaska,Bettles,12
519,2019-2020,2019-09-17,2020-05-11,238,4,1035,1958,2993,183,1913,2096,5089,80,952,Alaska,Bettles,12
520,1980-1981,1980-10-09,1981-04-27,201,8,96,386,482,95,776,871,1353,25,143,Alaska,Cannery Creek,0
521,1982-1983,1982-10-25,1983-05-17,205,8,67,408,475,125,2523,2648,3123,34,193,Alaska,Cannery Creek,0
522,1984-1985,1984-11-02,1985-06-01,212,6,78,427,505,241,2052,2293,2798,52,341,Alaska,Cannery Creek,0
523,1985-1986,1985-10-25,1986-05-21,209,7,76,481,557,182,1876,2058,2615,41,289,Alaska,Cannery Creek,0
524,1987-1988,1987-10-30,1988-05-25,209,13,50,266,316,215,2442,2657,2973,70,308,Alaska,Cannery Creek,0
525,1988-1989,1988-10-27,1989-05-08,194,13,147,465,612,164,2026,2190,2802,45,294,Alaska,Cannery Creek,0
526,1989-1990,1989-10-23,1990-05-26,216,8,116,421,537,286,2513,2799,3336,54,408,Alaska,Cannery Creek,0
527,1990-1991,1990-10-13,1991-05-30,230,11,152,495,647,325,2597,2922,3569,72,504,Alaska,Cannery Creek,0
528,1991-1992,1991-11-13,1992-06-06,207,12,72,340,412,302,2585,2887,3299,64,434,Alaska,Cannery Creek,0
529,1992-1993,1992-10-12,1993-05-13,214,13,117,393,510,238,2116,2354,2864,62,368,Alaska,Cannery Creek,0
530,1993-1994,1993-11-03,1994-05-15,194,15,80,302,382,158,1636,1794,2176,58,267,Alaska,Cannery Creek,0
531,1994-1995,1994-10-23,1995-05-19,209,19,129,478,607,277,2473,2750,3357,62,458,Alaska,Cannery Creek,0
532,1996-1997,1996-11-08,1997-05-07,181,18,82,317,399,129,1482,1611,2010,43,208,Alaska,Cannery Creek,0
533,1997-1998,1997-11-21,1998-05-08,169,18,63,244,307,97,1355,1452,1759,35,160,Alaska,Cannery Creek,0
534,1998-1999,1998-11-17,1999-05-29,194,14,135,418,553,291,2456,2747,3300,66,436,Alaska,Cannery Creek,0
535,1999-2000,1999-10-27,2000-05-27,214,14,88,355,443,351,2697,3048,3491,79,527,Alaska,Cannery Creek,0
536,2001-2002,2001-10-20,2002-05-21,214,7,82,459,541,235,2308,2543,3084,62,360,Alaska,Cannery Creek,0
537,2002-2003,2002-11-19,2003-04-21,154,1,22,209,231,86,947,1033,1264,29,140,Alaska,Cannery Creek,0
538,2003-2004,2003-11-10,2004-05-13,186,5,102,370,472,215,2183,2398,2870,58,332,Alaska,Cannery Creek,0
539,2005-2006,2005-11-02,2006-05-15,195,10,77,389,466,170,1502,1672,2138,51,313,Alaska,Cannery Creek,0
540,2006-2007,2006-10-29,2007-05-23,207,12,141,532,673,240,2349,2589,3262,59,397,Alaska,Cannery Creek,0
541,2007-2008,2007-10-20,2008-05-27,221,17,113,394,507,216,2173,2389,2896,68,360,Alaska,Cannery Creek,0
542,2009-2010,2009-11-01,2010-05-24,205,3,61,303,364,237,2446,2683,3047,70,388,Alaska,Cannery Creek,0
543,2010-2011,2010-10-30,2011-05-09,192,0,119,432,551,153,1655,1808,2359,40,231,Alaska,Cannery Creek,0
544,2011-2012,2011-10-31,2012-06-18,232,17,131,431,562,475,3041,3516,4078,100,754,Alaska,Cannery Creek,0
545,2014-2015,2014-11-27,2015-04-13,138,0,41,204,245,50,146,196,441,25,97,Alaska,Cannery Creek,0
546,2015-2016,2015-11-09,2016-04-13,157,2,39,197,236,80,996,1076,1312,36,150,Alaska,Cannery Creek,0
547,2016-2017,2016-10-18,2017-04-30,195,11,120,419,539,161,1759,1920,2459,50,261,Alaska,Cannery Creek,0
548,2019-2020,2019-11-22,2020-05-11,172,12,90,382,472,185,1721,1906,2378,43,286,Alaska,Cannery Creek,0
549,1950-1951,1950-10-10,1951-04-29,202,7,747,1427,2174,110,1481,1591,3765,48,520,Alaska,Denali NP,0
550,1952-1953,1952-09-29,1953-04-20,204,0,496,1160,1656,68,1026,1094,2750,34,346,Alaska,Denali NP,0
551,1953-1954,1953-09-28,1954-04-27,212,3,645,1395,2040,80,1108,1188,3228,47,532,Alaska,Denali NP,0
552,1954-1955,1954-10-11,1955-06-12,245,17,550,1283,1833,132,1163,1295,3128,56,715,Alaska,Denali NP,0
553,1955-1956,1955-09-17,1956-05-09,236,4,868,1624,2492,153,1709,1862,4354,71,917,Alaska,Denali NP,0
554,1956-1957,1956-09-19,1957-05-05,229,1,648,1428,2076,149,1605,1754,3830,78,762,Alaska,Denali NP,0
555,1957-1958,1957-09-19,1958-05-04,228,0,502,1205,1707,137,1062,1199,2906,60,586,Alaska,Denali NP,0
556,1959-1960,1959-10-03,1960-05-10,221,0,496,1272,1768,100,1088,1188,2956,67,730,Alaska,Denali NP,0
557,1960-1961,1960-09-06,1961-04-24,231,1,514,1260,1774,83,782,865,2639,47,419,Alaska,Denali NP,0
558,1961-1962,1961-09-24,1962-05-19,238,0,684,1494,2178,195,1865,2060,4238,76,792,Alaska,Denali NP,0
559,1962-1963,1962-09-12,1963-05-13,244,9,506,1204,1710,116,1360,1476,3186,51,482,Alaska,Denali NP,0
560,1964-1965,1964-10-14,1965-05-04,203,3,690,1372,2062,90,1250,1340,3402,40,443,Alaska,Denali NP,0
561,1965-1966,1965-10-05,1966-05-14,222,7,636,1503,2139,170,2118,2288,4427,39,461,Alaska,Denali NP,0
562,1966-1967,1966-10-08,1967-05-20,225,9,546,1436,1982,218,1775,1993,3975,59,624,Alaska,Denali NP,0
563,1967-1968,1967-10-17,1968-05-13,210,16,543,1350,1893,151,1522,1673,3566,42,508,Alaska,Denali NP,0
564,1969-1970,1969-10-21,1970-05-30,222,14,479,1264,1743,65,825,890,2633,34,389,Alaska,Denali NP,0
565,1970-1971,1970-09-08,1971-05-23,258,19,863,1901,2764,255,2742,2997,5761,70,905,Alaska,Denali NP,0
566,1971-1972,1971-09-27,1972-05-14,231,1,789,1801,2590,144,1897,2041,4631,58,669,Alaska,Denali NP,0
567,1972-1973,1972-09-16,1973-06-02,260,4,630,1461,2091,106,1260,1366,3457,60,651,Alaska,Denali NP,0
568,1973-1974,1973-08-13,1974-04-25,256,7,761,1573,2334,94,1005,1099,3433,64,792,Alaska,Denali NP,0
569,1977-1978,1977-09-29,1978-04-30,214,15,583,1335,1918,111,1516,1627,3545,44,558,Alaska,Denali NP,0
570,1978-1979,1978-09-20,1979-04-28,221,2,517,1368,1885,128,1251,1379,3264,52,501,Alaska,Denali NP,0
571,1979-1980,1979-09-17,1980-06-19,277,1,519,1276,1795,121,1309,1430,3225,47,573,Alaska,Denali NP,0
572,1980-1981,1980-09-02,1981-04-27,238,5,479,1126,1605,106,946,1052,2657,45,503,Alaska,Denali NP,0
573,1982-1983,1982-09-30,1983-05-17,230,11,578,1408,1986,111,1621,1732,3718,56,600,Alaska,Denali NP,0
574,1983-1984,1983-09-05,1984-05-07,246,5,623,1312,1935,101,1142,1243,3178,52,602,Alaska,Denali NP,0
575,1984-1985,1984-08-26,1985-05-23,271,20,533,1314,1847,219,1933,2152,3999,60,612,Alaska,Denali NP,0
576,1985-1986,1985-10-03,1986-05-11,221,4,558,1255,1813,63,810,873,2686,38,443,Alaska,Denali NP,0
577,1987-1988,1987-09-21,1988-04-30,223,19,447,1103,1550,81,1066,1147,2697,53,555,Alaska,Denali NP,0
578,1989-1990,1989-10-08,1990-05-03,208,6,664,1375,2039,139,1613,1752,3791,65,795,Alaska,Denali NP,0
579,1990-1991,1990-09-30,1991-05-12,225,5,645,1417,2062,233,2364,2597,4659,84,1123,Alaska,Denali NP,0
580,1991-1992,1991-10-07,1992-05-25,232,2,621,1378,1999,199,2003,2202,4201,79,928,Alaska,Denali NP,0
581,1992-1993,1992-09-12,1993-05-10,241,12,536,1310,1846,233,3011,3244,5090,76,855,Alaska,Denali NP,0
582,1993-1994,1993-09-17,1994-05-03,229,6,518,1227,1745,170,1616,1786,3531,68,618,Alaska,Denali NP,0
583,1994-1995,1994-10-08,1995-05-22,227,6,601,1240,1841,112,1623,1735,3576,60,612,Alaska,Denali NP,0
584,1996-1997,1996-09-11,1997-06-02,265,11,669,1422,2091,116,1873,1989,4080,55,585,Alaska,Denali NP,0
585,1997-1998,1997-10-04,1998-05-09,218,3,500,1151,1651,112,1641,1753,3404,55,571,Alaska,Denali NP,0
586,1998-1999,1998-10-07,1999-05-10,216,3,712,1416,2128,77,1136,1213,3341,48,599,Alaska,Denali NP,0
587,1999-2000,1999-09-25,2000-05-21,240,2,611,1348,1959,170,1912,2082,4041,59,649,Alaska,Denali NP,0
588,2000-2001,2000-09-28,2001-05-14,229,2,278,943,1221,100,1328,1428,2649,59,429,Alaska,Denali NP,0
589,2001-2002,2001-10-11,2002-05-15,217,2,557,1295,1852,109,1281,1390,3242,64,550,Alaska,Denali NP,0
590,2003-2004,2003-07-17,2004-05-02,291,11,535,1240,1775,114,1288,1402,3177,62,729,Alaska,Denali NP,0
591,2004-2005,2004-09-05,2005-05-02,240,11,358,1096,1454,149,1450,1599,3053,70,560,Alaska,Denali NP,0
592,2005-2006,2005-09-29,2006-05-11,225,14,637,1289,1926,99,1330,1429,3355,54,607,Alaska,Denali NP,0
593,2006-2007,2006-10-06,2007-05-13,220,12,658,1394,2052,73,970,1043,3095,58,757,Alaska,Denali NP,0
594,2008-2009,2008-09-28,2009-05-03,218,3,727,1485,2212,113,1433,1546,3758,70,774,Alaska,Denali NP,0
595,2009-2010,2009-09-27,2010-04-29,215,4,528,1200,1728,76,1091,1167,2895,50,624,Alaska,Denali NP,0
596,2010-2011,2010-09-27,2011-05-12,228,9,582,1399,1981,131,1379,1510,3491,67,752,Alaska,Denali NP,0
597,2011-2012,2011-09-29,2012-05-15,230,2,733,1487,2220,122,1545,1667,3887,75,890,Alaska,Denali NP,0
598,2012-2013,2012-09-24,2013-05-25,244,13,698,1536,2234,131,1520,1651,3885,69,761,Alaska,Denali NP,0
599,2013-2014,2013-09-18,2014-05-05,230,6,449,1139,1588,94,1291,1385,2973,52,510,Alaska,Denali NP,0
600,2014-2015,2014-09-29,2015-04-30,214,0,430,1086,1516,74,1093,1167,2683,40,318,Alaska,Denali NP,0
601,2015-2016,2015-08-29,2016-05-17,263,0,350,969,1319,133,1723,1856,3175,53,460,Alaska,Denali NP,0
602,2016-2017,2016-10-16,2017-05-25,222,0,621,1331,1952,110,1181,1291,3243,54,697,Alaska,Denali NP,0
603,2017-2018,2017-09-29,2018-05-17,231,8,414,1073,1487,175,1773,1948,3435,81,714,Alaska,Denali NP,0
604,2018-2019,2018-10-08,2019-04-24,199,0,351,898,1249,78,725,803,2052,54,475,Alaska,Denali NP,0
605,2019-2020,2019-10-02,2020-05-11,223,3,658,1353,2011,161,1739,1900,3911,77,901,Alaska,Denali NP,0
606,1950-1951,1950-10-09,1951-04-25,199,0,982,1832,2814,101,1613,1714,4528,57,715,Alaska,Fairbanks,31535
607,1951-1952,1951-10-01,1952-05-08,221,3,787,1719,2506,95,1378,1473,3979,62,758,Alaska,Fairbanks,31535
608,1952-1953,1952-09-28,1953-04-15,200,0,721,1565,2286,45,846,891,3177,33,394,Alaska,Fairbanks,31535
609,1953-1954,1953-10-02,1954-04-18,199,0,844,1773,2617,67,808,875,3492,39,565,Alaska,Fairbanks,31535
610,1954-1955,1954-10-17,1955-04-29,195,0,805,1676,2481,105,1148,1253,3734,64,950,Alaska,Fairbanks,31535
611,1955-1956,1955-10-06,1956-04-28,206,0,1031,1952,2983,130,1591,1721,4704,72,1068,Alaska,Fairbanks,31535
612,1956-1957,1956-10-02,1957-05-02,213,0,879,1776,2655,126,1423,1549,4204,75,882,Alaska,Fairbanks,31535
613,1957-1958,1957-09-25,1958-05-03,221,0,652,1453,2105,69,878,947,3052,45,397,Alaska,Fairbanks,31535
614,1958-1959,1958-09-30,1959-05-03,216,3,905,1888,2793,98,1569,1667,4460,53,695,Alaska,Fairbanks,31535
615,1959-1960,1959-10-05,1960-04-30,209,3,703,1557,2260,108,1251,1359,3619,59,717,Alaska,Fairbanks,31535
616,1960-1961,1960-10-06,1961-04-25,202,0,699,1588,2287,73,1032,1105,3392,45,505,Alaska,Fairbanks,31535
617,1961-1962,1961-10-04,1962-05-09,218,0,874,1729,2603,158,1624,1782,4385,84,884,Alaska,Fairbanks,31535
618,1962-1963,1962-09-13,1963-05-03,233,3,732,1527,2259,115,1119,1234,3493,65,654,Alaska,Fairbanks,31535
619,1963-1964,1963-10-09,1964-05-14,219,0,891,1832,2723,98,1082,1180,3903,65,680,Alaska,Fairbanks,31535
620,1964-1965,1964-10-02,1965-05-04,215,0,980,1883,2863,92,1111,1203,4066,61,865,Alaska,Fairbanks,31535
621,1965-1966,1965-10-01,1966-05-19,231,0,1110,2083,3193,187,1705,1892,5085,72,1039,Alaska,Fairbanks,31535
622,1966-1967,1966-10-07,1967-05-04,210,0,945,1796,2741,160,1641,1801,4542,79,957,Alaska,Fairbanks,31535
623,1967-1968,1967-10-02,1968-05-11,223,0,761,1557,2318,127,1448,1575,3893,73,885,Alaska,Fairbanks,31535
624,1968-1969,1968-09-23,1969-04-18,208,0,981,1876,2857,101,1303,1404,4261,58,707,Alaska,Fairbanks,31535
625,1969-1970,1969-10-20,1970-04-24,187,0,656,1367,2023,62,786,848,2871,45,580,Alaska,Fairbanks,31535
626,1970-1971,1970-09-21,1971-05-08,230,0,1031,1910,2941,212,2275,2487,5428,88,1225,Alaska,Fairbanks,31535
627,1971-1972,1971-09-29,1972-05-02,217,0,1006,1892,2898,150,1521,1671,4569,89,1013,Alaska,Fairbanks,31535
628,1972-1973,1972-09-16,1973-04-27,224,0,776,1528,2304,125,1233,1358,3662,65,674,Alaska,Fairbanks,31535
629,1973-1974,1973-09-23,1974-04-24,214,0,968,1753,2721,92,1160,1252,3973,62,832,Alaska,Fairbanks,31535
630,1974-1975,1974-09-29,1975-04-27,211,0,849,1673,2522,149,1736,1885,4407,77,941,Alaska,Fairbanks,31535
631,1975-1976,1975-10-07,1976-04-17,194,0,996,1806,2802,96,1131,1227,4029,62,709,Alaska,Fairbanks,31535
632,1976-1977,1976-10-07,1977-04-27,203,3,569,1216,1785,96,1185,1281,3066,49,487,Alaska,Fairbanks,31535
633,1977-1978,1977-09-29,1978-05-27,241,0,815,1510,2325,82,1288,1370,3695,51,597,Alaska,Fairbanks,31535
634,1978-1979,1978-09-20,1979-04-26,219,0,801,1585,2386,110,1464,1574,3960,69,670,Alaska,Fairbanks,31535
635,1979-1980,1979-10-18,1980-04-12,178,0,582,1240,1822,83,889,972,2794,62,785,Alaska,Fairbanks,31535
636,1980-1981,1980-09-02,1981-04-15,226,0,598,1250,1848,76,995,1071,2919,52,441,Alaska,Fairbanks,31535
637,1981-1982,1981-09-26,1982-05-02,219,0,783,1523,2306,113,1140,1253,3559,71,796,Alaska,Fairbanks,31535
638,1982-1983,1982-09-30,1983-05-04,217,0,716,1416,2132,115,1640,1755,3887,68,694,Alaska,Fairbanks,31535
639,1983-1984,1983-09-24,1984-04-28,218,3,767,1475,2242,113,1212,1325,3567,70,804,Alaska,Fairbanks,31535
640,1984-1985,1984-10-07,1985-05-09,215,0,691,1504,2195,152,1730,1882,4077,72,769,Alaska,Fairbanks,31535
641,1985-1986,1985-09-21,1986-04-23,215,0,720,1492,2212,63,1105,1168,3380,44,590,Alaska,Fairbanks,31535
642,1986-1987,1986-10-04,1987-04-12,191,0,600,1276,1876,69,1005,1074,2950,45,503,Alaska,Fairbanks,31535
643,1987-1988,1987-10-25,1988-05-01,190,0,641,1221,1862,75,1062,1137,2999,58,679,Alaska,Fairbanks,31535
644,1988-1989,1988-09-29,1989-05-09,223,0,825,1633,2458,121,1546,1667,4125,79,1002,Alaska,Fairbanks,31535
645,1989-1990,1989-09-20,1990-04-20,213,0,915,1663,2578,120,1631,1751,4329,63,795,Alaska,Fairbanks,31535
646,1990-1991,1990-09-29,1991-05-06,220,0,806,1576,2382,219,2355,2574,4956,87,1141,Alaska,Fairbanks,31535
647,1991-1992,1991-10-11,1992-05-17,220,0,738,1605,2343,159,1664,1823,4166,92,1186,Alaska,Fairbanks,31535
648,1992-1993,1992-09-11,1993-04-23,225,0,653,1490,2143,202,2348,2550,4693,88,972,Alaska,Fairbanks,31535
649,1993-1994,1993-09-17,1994-04-22,218,0,656,1425,2081,102,1277,1379,3460,57,535,Alaska,Fairbanks,31535
650,1994-1995,1994-10-08,1995-04-18,193,0,830,1650,2480,135,1633,1768,4248,78,1019,Alaska,Fairbanks,31535
651,1995-1996,1995-10-12,1996-04-23,195,0,866,1674,2540,87,1095,1182,3722,41,484,Alaska,Fairbanks,31535
652,1996-1997,1996-09-21,1997-04-24,216,0,868,1748,2616,108,1562,1670,4286,57,737,Alaska,Fairbanks,31535
653,1997-1998,1997-10-03,1998-05-03,213,3,712,1446,2158,80,1204,1284,3442,55,695,Alaska,Fairbanks,31535
654,1998-1999,1998-10-14,1999-05-01,200,3,923,1758,2681,67,1001,1068,3749,56,938,Alaska,Fairbanks,31535
655,1999-2000,1999-09-25,2000-04-26,215,3,805,1598,2403,112,1458,1570,3973,59,759,Alaska,Fairbanks,31535
656,2000-2001,2000-09-29,2001-05-11,225,0,495,1283,1778,93,1224,1317,3095,55,495,Alaska,Fairbanks,31535
657,2001-2002,2001-09-30,2002-05-02,215,0,733,1588,2321,91,998,1089,3410,61,722,Alaska,Fairbanks,31535
658,2002-2003,2002-10-08,2003-04-18,193,0,510,1136,1646,65,984,1049,2695,35,336,Alaska,Fairbanks,31535
659,2003-2004,2003-09-25,2004-04-17,206,0,789,1573,2362,101,1246,1347,3709,63,828,Alaska,Fairbanks,31535
660,2004-2005,2004-09-26,2005-04-24,211,0,663,1460,2123,124,1486,1610,3733,72,687,Alaska,Fairbanks,31535
661,2005-2006,2005-09-28,2006-04-27,212,0,866,1625,2491,93,1131,1224,3715,61,743,Alaska,Fairbanks,31535
662,2006-2007,2006-09-29,2007-04-15,199,0,881,1705,2586,67,1007,1074,3660,58,864,Alaska,Fairbanks,31535
663,2007-2008,2007-10-06,2008-05-01,209,0,721,1515,2236,100,1230,1330,3566,64,748,Alaska,Fairbanks,31535
664,2008-2009,2008-09-27,2009-04-29,215,0,893,1753,2646,126,1499,1625,4271,77,1042,Alaska,Fairbanks,31535
665,2009-2010,2009-09-26,2010-05-05,222,0,747,1479,2226,45,962,1007,3233,33,454,Alaska,Fairbanks,31535
666,2010-2011,2010-10-07,2011-04-26,202,0,770,1678,2448,91,1310,1401,3849,44,525,Alaska,Fairbanks,31535
667,2011-2012,2011-10-13,2012-05-01,202,0,907,1720,2627,107,1289,1396,4023,75,1169,Alaska,Fairbanks,31535
668,2012-2013,2012-10-12,2013-05-17,218,0,921,1850,2771,111,1516,1627,4398,61,748,Alaska,Fairbanks,31535
669,2013-2014,2013-09-18,2014-04-21,216,0,583,1379,1962,81,1306,1387,3349,46,543,Alaska,Fairbanks,31535
670,2014-2015,2014-09-30,2015-04-17,200,0,600,1308,1908,70,1045,1115,3023,41,434,Alaska,Fairbanks,31535
671,2015-2016,2015-09-25,2016-04-08,197,0,494,1114,1608,91,1093,1184,2792,44,424,Alaska,Fairbanks,31535
672,2016-2017,2016-10-16,2017-04-26,193,0,792,1616,2408,125,1276,1401,3809,56,787,Alaska,Fairbanks,31535
673,2017-2018,2017-10-09,2018-05-03,207,0,582,1276,1858,133,1426,1559,3417,65,613,Alaska,Fairbanks,31535
674,2018-2019,2018-10-20,2019-04-24,187,0,535,1123,1658,97,1002,1099,2757,57,622,Alaska,Fairbanks,31535
675,2019-2020,2019-10-05,2020-04-24,203,0,828,1615,2443,133,1431,1564,4007,68,893,Alaska,Fairbanks,31535
676,1950-1951,1950-11-04,1951-03-26,143,0,174,449,623,136,478,614,1237,52,296,Alaska,Juneau,31275
677,1951-1952,1951-11-13,1952-04-08,148,0,132,403,535,154,541,695,1230,65,373,Alaska,Juneau,31275
678,1952-1953,1952-11-28,1953-03-31,124,0,82,217,299,70,67,137,436,40,186,Alaska,Juneau,31275
679,1953-1954,1953-11-02,1954-04-11,161,0,106,350,456,96,146,242,698,38,191,Alaska,Juneau,31275
680,1954-1955,1954-11-12,1955-04-23,163,0,63,246,309,134,204,338,647,56,273,Alaska,Juneau,31275
681,1955-1956,1955-10-28,1956-04-15,171,0,197,550,747,223,738,961,1708,64,410,Alaska,Juneau,31275
682,1956-1957,1956-10-24,1957-04-05,164,0,101,358,459,178,344,522,981,47,314,Alaska,Juneau,31275
683,1957-1958,1957-11-23,1958-03-20,118,1,39,189,228,120,155,275,503,45,219,Alaska,Juneau,31275
684,1958-1959,1958-10-07,1959-04-20,196,0,94,323,417,186,337,523,940,67,375,Alaska,Juneau,31275
685,1959-1960,1959-11-04,1960-04-09,158,0,30,184,214,105,123,228,442,49,189,Alaska,Juneau,31275
686,1960-1961,1960-11-11,1961-04-17,158,0,32,174,206,129,121,250,456,53,214,Alaska,Juneau,31275
687,1961-1962,1961-10-31,1962-04-10,162,0,89,357,446,164,352,516,962,57,357,Alaska,Juneau,31275
688,1962-1963,1962-11-15,1963-04-17,154,0,66,242,308,202,311,513,821,46,327,Alaska,Juneau,31275
689,1963-1964,1963-11-15,1964-05-12,180,0,65,243,308,149,192,341,649,63,267,Alaska,Juneau,31275
690,1964-1965,1964-11-06,1965-05-13,189,0,155,444,599,267,550,817,1416,57,520,Alaska,Juneau,31275
691,1965-1966,1965-10-19,1966-04-14,178,0,150,484,634,210,582,792,1426,55,375,Alaska,Juneau,31275
692,1966-1967,1966-10-22,1967-04-15,176,0,108,433,541,180,277,457,998,63,343,Alaska,Juneau,31275
693,1967-1968,1967-11-13,1968-04-19,159,0,106,347,453,129,182,311,764,44,258,Alaska,Juneau,31275
694,1968-1969,1968-11-13,1969-03-26,134,0,185,507,692,168,809,977,1669,60,343,Alaska,Juneau,31275
695,1969-1970,1969-11-11,1970-04-07,148,0,65,213,278,64,77,141,419,31,178,Alaska,Juneau,31275
696,1970-1971,1970-10-19,1971-04-15,179,0,182,482,664,244,564,808,1472,72,555,Alaska,Juneau,31275
697,1971-1972,1971-10-25,1972-04-28,187,0,191,535,726,254,1114,1368,2094,86,522,Alaska,Juneau,31275
698,1972-1973,1972-10-29,1973-04-05,159,0,108,354,462,187,470,657,1119,54,387,Alaska,Juneau,31275
699,1973-1974,1973-11-06,1974-04-03,149,0,140,480,620,168,543,711,1331,54,343,Alaska,Juneau,31275
700,1974-1975,1974-10-02,1975-04-20,201,0,81,301,382,151,235,386,768,57,266,Alaska,Juneau,31275
701,1975-1976,1975-10-30,1976-04-06,160,0,102,315,417,259,672,931,1348,78,494,Alaska,Juneau,31275
702,1976-1977,1976-10-28,1977-03-25,149,0,7,48,55,72,67,139,194,31,93,Alaska,Juneau,31275
703,1977-1978,1977-11-06,1978-04-09,155,0,113,331,444,79,229,308,752,33,161,Alaska,Juneau,31275
704,1978-1979,1978-11-10,1979-03-27,138,0,154,400,554,126,508,634,1188,50,296,Alaska,Juneau,31275
705,1979-1980,1979-11-25,1980-03-18,115,0,85,256,341,136,288,424,765,32,243,Alaska,Juneau,31275
706,1980-1981,1980-11-20,1981-04-16,148,0,52,172,224,92,140,232,456,25,171,Alaska,Juneau,31275
707,1981-1982,1981-11-19,1982-04-17,150,0,150,377,527,167,737,904,1431,36,302,Alaska,Juneau,31275
708,1982-1983,1982-10-27,1983-03-09,134,0,41,187,228,102,153,255,483,26,168,Alaska,Juneau,31275
709,1983-1984,1983-11-08,1984-03-17,131,4,70,208,278,93,204,297,575,21,150,Alaska,Juneau,31275
710,1985-1986,1985-10-26,1986-04-23,180,0,78,266,344,101,131,232,576,42,166,Alaska,Juneau,31275
711,1986-1987,1986-11-07,1987-03-12,126,0,47,150,197,51,135,186,383,20,99,Alaska,Juneau,31275
712,1987-1988,1987-11-05,1988-04-10,158,0,32,140,172,49,49,98,270,34,88,Alaska,Juneau,31275
713,1988-1989,1988-11-12,1989-03-30,139,0,78,287,365,112,375,487,852,53,229,Alaska,Juneau,31275
714,1989-1990,1989-10-27,1990-03-20,145,0,71,211,282,169,343,512,794,56,334,Alaska,Juneau,31275
715,1990-1991,1990-11-06,1991-04-01,147,0,91,296,387,195,842,1037,1424,65,370,Alaska,Juneau,31275
716,1991-1992,1991-10-29,1992-03-30,154,0,21,117,138,137,239,376,514,47,197,Alaska,Juneau,31275
717,1992-1993,1992-10-18,1993-03-25,159,0,56,277,333,149,512,661,994,46,263,Alaska,Juneau,31275
718,1993-1994,1993-11-17,1994-03-25,129,0,83,214,297,188,547,735,1032,53,316,Alaska,Juneau,31275
719,1994-1995,1994-11-02,1995-03-30,149,0,75,299,374,206,619,825,1199,60,355,Alaska,Juneau,31275
720,1995-1996,1995-11-09,1996-04-01,145,0,133,355,488,125,432,557,1045,40,254,Alaska,Juneau,31275
721,1996-1997,1996-10-19,1997-04-18,182,0,77,261,338,93,169,262,600,49,166,Alaska,Juneau,31275
722,1997-1998,1997-10-13,1998-03-26,165,0,43,169,212,59,166,225,437,27,102,Alaska,Juneau,31275
723,1998-1999,1998-11-11,1999-04-07,148,0,65,248,313,178,754,932,1245,59,313,Alaska,Juneau,31275
724,1999-2000,1999-11-24,2000-02-29,98,0,39,136,175,65,111,176,351,34,122,Alaska,Juneau,31275
725,2000-2001,2000-10-02,2001-03-31,181,0,31,181,212,45,98,143,355,22,77,Alaska,Juneau,31275
726,2001-2002,2001-10-26,2002-03-18,144,0,61,242,303,125,221,346,649,44,224,Alaska,Juneau,31275
727,2002-2003,2002-11-23,2003-03-31,129,0,50,175,225,78,115,193,418,24,134,Alaska,Juneau,31275
728,2003-2004,2003-11-13,2004-04-01,141,0,55,206,261,131,127,258,519,47,225,Alaska,Juneau,31275
729,2004-2005,2004-11-02,2005-04-03,153,0,52,200,252,118,216,334,586,39,208,Alaska,Juneau,31275
730,2005-2006,2005-11-03,2006-04-30,179,0,63,267,330,84,126,210,540,44,177,Alaska,Juneau,31275
731,2006-2007,2006-11-03,2007-04-07,156,0,101,314,415,253,662,915,1330,65,432,Alaska,Juneau,31275
732,2007-2008,2007-11-05,2008-04-20,168,0,79,256,335,156,202,358,693,57,290,Alaska,Juneau,31275
733,2008-2009,2008-10-24,2009-04-04,163,0,104,342,446,258,518,776,1222,71,449,Alaska,Juneau,31275
734,2009-2010,2009-10-31,2010-04-09,161,0,35,180,215,99,101,200,415,42,163,Alaska,Juneau,31275
735,2010-2011,2010-11-17,2011-04-11,146,0,103,321,424,118,304,422,846,45,260,Alaska,Juneau,31275
736,2011-2012,2011-11-04,2012-03-26,144,0,47,192,239,180,251,431,670,60,277,Alaska,Juneau,31275
737,2012-2013,2012-10-28,2013-04-28,183,0,71,275,346,121,243,364,710,54,253,Alaska,Juneau,31275
738,2013-2014,2013-11-16,2014-04-09,145,0,57,254,311,139,223,362,673,42,223,Alaska,Juneau,31275
739,2014-2015,2014-11-28,2015-03-15,108,0,31,121,152,73,121,194,346,22,130,Alaska,Juneau,31275
740,2015-2016,2015-11-14,2016-02-29,108,0,16,87,103,56,51,107,210,22,84,Alaska,Juneau,31275
741,2016-2017,2016-10-15,2017-03-28,165,0,74,293,367,98,220,318,685,37,180,Alaska,Juneau,31275
742,2017-2018,2017-11-10,2018-03-28,139,0,81,307,388,111,330,441,829,42,230,Alaska,Juneau,31275
743,2018-2019,2018-11-01,2019-04-23,174,2,40,228,268,74,269,343,611,28,136,Alaska,Juneau,31275
744,2019-2020,2019-11-10,2020-03-30,142,2,46,161,207,107,180,287,494,48,178,Alaska,Juneau,31275
745,1950-1951,1950-10-30,1951-05-01,184,1,56,201,257,260,1694,1954,2211,54,350,Alaska,Little Port Walter,0
746,1951-1952,1951-11-16,1952-04-19,156,0,39,175,214,261,1300,1561,1775,55,367,Alaska,Little Port Walter,0
747,1952-1953,1952-12-01,1953-04-02,123,1,34,104,138,113,202,315,453,24,151,Alaska,Little Port Walter,0
748,1953-1954,1953-11-01,1954-04-30,181,0,36,157,193,191,564,755,948,44,252,Alaska,Little Port Walter,0
749,1954-1955,1954-12-01,1955-04-27,148,3,18,128,146,152,626,778,924,33,198,Alaska,Little Port Walter,0
750,1955-1956,1955-11-05,1956-04-27,175,1,77,232,309,274,1474,1748,2057,63,374,Alaska,Little Port Walter,0
751,1956-1957,1956-11-01,1957-04-26,177,2,30,138,168,176,627,803,971,34,230,Alaska,Little Port Walter,0
752,1957-1958,1957-12-01,1958-03-12,102,0,4,61,65,111,270,381,446,27,145,Alaska,Little Port Walter,0
753,1958-1959,1958-11-12,1959-04-09,149,2,26,101,127,187,867,1054,1181,50,256,Alaska,Little Port Walter,0
754,1959-1960,1959-10-08,1960-04-02,178,5,3,81,84,132,275,407,491,39,170,Alaska,Little Port Walter,0
755,1960-1961,1960-11-19,1961-03-16,118,1,2,65,67,85,172,257,324,29,112,Alaska,Little Port Walter,0
756,1961-1962,1961-11-04,1962-03-29,146,4,29,136,165,173,410,583,748,42,261,Alaska,Little Port Walter,0
757,1962-1963,1962-11-27,1963-04-16,141,0,18,92,110,119,245,364,474,27,168,Alaska,Little Port Walter,0
758,1964-1965,1964-11-25,1965-05-09,166,18,73,196,269,262,1211,1473,1742,32,342,Alaska,Little Port Walter,0
759,1965-1966,1965-11-24,1966-04-13,141,15,38,170,208,128,778,906,1114,23,161,Alaska,Little Port Walter,0
760,1970-1971,1970-11-25,1971-05-12,169,19,55,188,243,311,1825,2136,2379,45,406,Alaska,Little Port Walter,0
761,1971-1972,1971-10-25,1972-05-24,213,10,60,247,307,291,2177,2468,2775,52,400,Alaska,Little Port Walter,0
762,1972-1973,1972-11-04,1973-04-18,166,12,14,136,150,225,1548,1773,1923,47,283,Alaska,Little Port Walter,0
763,1973-1974,1973-10-20,1974-05-02,195,15,42,181,223,341,1978,2319,2542,53,427,Alaska,Little Port Walter,0
764,1975-1976,1975-11-05,1976-04-17,165,1,19,142,161,273,908,1181,1342,52,351,Alaska,Little Port Walter,0
765,1977-1978,1977-11-09,1978-03-14,126,2,34,134,168,110,465,575,743,21,147,Alaska,Little Port Walter,0
766,1978-1979,1978-11-11,1979-04-15,156,0,48,170,218,213,1465,1678,1896,38,283,Alaska,Little Port Walter,0
767,1979-1980,1979-12-01,1980-03-30,121,1,26,118,144,161,469,630,774,35,233,Alaska,Little Port Walter,0
768,1980-1981,1980-12-01,1981-03-07,97,5,17,54,71,73,305,378,449,13,89,Alaska,Little Port Walter,0
769,1981-1982,1981-12-01,1982-04-29,150,7,49,160,209,165,1092,1257,1466,39,246,Alaska,Little Port Walter,0
770,1982-1983,1982-11-19,1983-02-28,102,1,7,54,61,75,135,210,271,18,97,Alaska,Little Port Walter,0
771,1983-1984,1983-12-01,1984-02-29,91,2,5,57,62,47,190,237,299,17,63,Alaska,Little Port Walter,0
772,1984-1985,1984-11-01,1985-04-30,181,16,14,119,133,140,310,450,583,35,179,Alaska,Little Port Walter,0
773,1985-1986,1985-11-02,1986-04-08,158,10,21,128,149,59,117,176,325,19,81,Alaska,Little Port Walter,0
774,1986-1987,1986-11-08,1987-04-18,162,7,9,62,71,41,48,89,160,13,54,Alaska,Little Port Walter,0
775,1987-1988,1987-11-17,1988-02-29,105,15,5,61,66,45,146,191,257,14,64,Alaska,Little Port Walter,0
776,1989-1990,1989-11-11,1990-03-24,134,2,14,106,120,187,602,789,909,36,241,Alaska,Little Port Walter,0
777,1990-1991,1990-11-06,1991-04-11,157,13,20,180,200,213,818,1031,1231,47,283,Alaska,Little Port Walter,0
778,1991-1992,1991-10-28,1992-02-29,125,11,3,55,58,47,52,99,157,9,58,Alaska,Little Port Walter,0
779,1992-1993,1992-10-17,1993-03-24,159,3,11,148,159,143,758,901,1060,37,200,Alaska,Little Port Walter,0
780,1993-1994,1993-11-15,1994-04-13,150,14,20,117,137,132,381,513,650,35,180,Alaska,Little Port Walter,0
781,1994-1995,1994-11-12,1995-03-30,139,8,8,139,147,138,611,749,896,37,180,Alaska,Little Port Walter,0
782,1995-1996,1995-11-07,1996-03-14,129,10,35,151,186,205,549,754,940,39,273,Alaska,Little Port Walter,0
783,1996-1997,1996-11-05,1997-04-01,148,9,29,145,174,134,425,559,733,33,176,Alaska,Little Port Walter,0
784,1997-1998,1997-12-01,1998-03-10,100,9,15,65,80,56,193,249,329,19,85,Alaska,Little Port Walter,0
785,2001-2002,2001-10-26,2002-04-22,179,12,17,182,199,266,1009,1275,1474,48,337,Alaska,Little Port Walter,0
786,2002-2003,2002-12-01,2003-03-31,121,4,9,83,92,69,118,187,279,13,84,Alaska,Little Port Walter,0
787,2003-2004,2003-12-01,2004-03-31,122,4,16,100,116,92,181,273,389,28,145,Alaska,Little Port Walter,0
788,2005-2006,2005-11-05,2006-04-30,177,1,15,144,159,118,339,457,616,33,168,Alaska,Little Port Walter,0
789,2006-2007,2006-11-04,2007-04-27,175,10,31,169,200,366,1235,1601,1801,69,461,Alaska,Little Port Walter,0
790,2007-2008,2007-10-31,2008-04-17,170,5,37,162,199,215,718,933,1132,46,301,Alaska,Little Port Walter,0
791,2008-2009,2008-11-14,2009-05-04,172,4,27,187,214,343,1805,2148,2362,65,444,Alaska,Little Port Walter,0
792,2009-2010,2009-11-12,2010-04-09,149,0,6,83,89,73,91,164,253,24,100,Alaska,Little Port Walter,0
793,2010-2011,2010-11-23,2011-04-11,140,13,29,113,142,137,349,486,628,32,182,Alaska,Little Port Walter,0
794,2011-2012,2011-11-04,2012-03-30,148,0,14,137,151,224,462,686,837,54,290,Alaska,Little Port Walter,0
795,2013-2014,2013-11-16,2014-04-09,145,0,17,100,117,88,216,304,421,28,123,Alaska,Little Port Walter,0
796,2014-2015,2014-11-29,2015-03-11,103,0,7,37,44,21,28,49,93,6,36,Alaska,Little Port Walter,0
797,2016-2017,2016-12-01,2017-03-31,121,13,15,120,135,111,309,420,555,29,151,Alaska,Little Port Walter,0
798,2017-2018,2017-11-13,2018-03-27,135,19,19,146,165,115,403,518,683,35,175,Alaska,Little Port Walter,0
799,2018-2019,2018-12-01,2019-04-25,146,9,9,106,115,49,144,193,308,19,77,Alaska,Little Port Walter,0
800,2019-2020,2019-12-01,2020-04-09,131,2,21,112,133,179,301,480,613,31,228,Alaska,Little Port Walter,0
801,1950-1951,1950-10-10,1951-05-01,204,0,1180,2120,3300,65,886,951,4251,45,605,Alaska,Northway,0
802,1951-1952,1951-09-29,1952-04-27,212,0,1051,2047,3098,75,1374,1449,4547,53,910,Alaska,Northway,0
803,1952-1953,1952-10-18,1953-04-20,185,0,973,1801,2774,50,1052,1102,3876,37,557,Alaska,Northway,0
804,1953-1954,1953-09-27,1954-04-30,216,0,1097,2087,3184,70,1027,1097,4281,53,713,Alaska,Northway,0
805,1954-1955,1954-10-10,1955-05-03,206,0,926,1794,2720,80,1218,1298,4018,59,795,Alaska,Northway,0
806,1955-1956,1955-10-06,1956-04-30,208,0,1297,2281,3578,112,1786,1898,5476,67,1348,Alaska,Northway,0
807,1956-1957,1956-09-20,1957-05-06,229,0,1088,2109,3197,111,2081,2192,5389,74,1004,Alaska,Northway,0
808,1957-1958,1957-10-11,1958-04-26,198,0,832,1670,2502,58,1051,1109,3611,38,553,Alaska,Northway,0
809,1958-1959,1958-09-20,1959-04-28,221,0,1199,2190,3389,48,1160,1208,4597,37,538,Alaska,Northway,0
810,1959-1960,1959-10-07,1960-04-25,202,0,925,1825,2750,49,1245,1294,4044,30,454,Alaska,Northway,0
811,1960-1961,1960-10-04,1961-05-13,222,0,958,1825,2783,66,1375,1441,4224,44,557,Alaska,Northway,0
812,1961-1962,1961-09-04,1962-05-17,256,3,1051,1975,3026,71,1156,1227,4253,52,621,Alaska,Northway,0
813,1962-1963,1962-08-30,1963-04-27,241,0,821,1641,2462,58,1072,1130,3592,46,503,Alaska,Northway,0
814,1963-1964,1963-10-09,1964-05-22,227,2,1046,1946,2992,59,1090,1149,4141,46,449,Alaska,Northway,0
815,1964-1965,1964-09-16,1965-05-07,234,0,1096,1987,3083,41,642,683,3766,35,475,Alaska,Northway,0
816,1965-1966,1965-09-27,1966-05-23,239,12,1186,2218,3404,66,1385,1451,4855,44,679,Alaska,Northway,0
817,1966-1967,1966-10-07,1967-05-16,222,0,1069,2092,3161,78,1432,1510,4671,45,546,Alaska,Northway,0
818,1967-1968,1967-10-03,1968-05-01,212,0,841,1692,2533,57,1114,1171,3704,41,473,Alaska,Northway,0
819,1968-1969,1968-09-20,1969-04-25,218,0,1135,2070,3205,48,993,1041,4246,36,518,Alaska,Northway,0
820,1969-1970,1969-08-10,1970-05-05,269,0,883,1695,2578,49,877,926,3504,30,434,Alaska,Northway,0
821,1970-1971,1970-09-07,1971-05-10,246,0,1112,2114,3226,55,1218,1273,4499,43,493,Alaska,Northway,0
822,1971-1972,1971-10-04,1972-05-09,219,0,1229,2335,3564,100,1881,1981,5545,37,676,Alaska,Northway,0
823,1972-1973,1972-09-18,1973-05-07,232,0,1014,1947,2961,57,1207,1264,4225,34,444,Alaska,Northway,0
824,1973-1974,1973-10-07,1974-04-24,200,0,1233,2208,3441,45,1442,1487,4928,32,500,Alaska,Northway,0
825,1974-1975,1974-08-22,1975-04-23,245,0,1005,1909,2914,49,1212,1261,4175,34,449,Alaska,Northway,0
826,1975-1976,1975-09-26,1976-04-26,214,0,1096,2086,3182,46,1012,1058,4240,27,365,Alaska,Northway,0
827,1976-1977,1976-10-11,1977-04-28,200,0,712,1491,2203,50,1129,1179,3382,35,412,Alaska,Northway,0
828,1977-1978,1977-09-22,1978-04-16,207,0,1017,1906,2923,54,1075,1129,4052,33,505,Alaska,Northway,0
829,1978-1979,1978-09-24,1979-04-26,215,0,1044,1981,3025,76,1358,1434,4459,47,629,Alaska,Northway,0
830,1979-1980,1979-10-19,1980-04-22,187,3,828,1732,2560,46,738,784,3344,34,496,Alaska,Northway,0
831,1980-1981,1980-09-01,1981-04-20,232,0,842,1734,2576,34,677,711,3287,30,440,Alaska,Northway,0
832,1981-1982,1981-09-25,1982-05-07,225,0,1068,2028,3096,88,1442,1530,4626,58,743,Alaska,Northway,0
833,1982-1983,1982-10-02,1983-04-25,206,0,991,1840,2831,90,1548,1638,4469,61,847,Alaska,Northway,0
834,1983-1984,1983-09-02,1984-05-11,253,3,902,1711,2613,67,851,918,3531,51,644,Alaska,Northway,0
835,1984-1985,1984-08-26,1985-04-30,248,0,844,1843,2687,95,1304,1399,4086,64,870,Alaska,Northway,0
836,1985-1986,1985-09-22,1986-05-17,238,6,917,1855,2772,87,1130,1217,3989,57,772,Alaska,Northway,0
837,1986-1987,1986-09-23,1987-04-21,211,3,793,1680,2473,68,863,931,3404,45,573,Alaska,Northway,0
838,1987-1988,1987-09-08,1988-04-30,236,0,852,1764,2616,83,1286,1369,3985,55,693,Alaska,Northway,0
839,1988-1989,1988-09-28,1989-05-23,238,0,1024,1936,2960,100,1497,1597,4557,64,930,Alaska,Northway,0
840,1989-1990,1989-10-09,1990-04-23,197,0,1008,1854,2862,76,1546,1622,4484,50,713,Alaska,Northway,0
841,1990-1991,1990-10-01,1991-04-20,202,0,943,1905,2848,86,1309,1395,4243,63,899,Alaska,Northway,0
842,1991-1992,1991-10-07,1992-05-18,225,0,845,1812,2657,74,1338,1412,4069,49,686,Alaska,Northway,0
843,1992-1993,1992-09-10,1993-04-20,223,6,807,1777,2584,87,1438,1525,4109,52,538,Alaska,Northway,0
844,1993-1994,1993-09-25,1994-04-19,207,0,851,1690,2541,70,1135,1205,3746,43,622,Alaska,Northway,0
845,1994-1995,1994-10-08,1995-05-16,221,4,931,1803,2734,85,1409,1494,4228,57,695,Alaska,Northway,0
846,1995-1996,1995-10-09,1996-04-22,197,0,1018,1920,2938,62,1027,1089,4027,42,572,Alaska,Northway,0
847,1996-1997,1996-09-22,1997-04-27,218,0,1177,2237,3414,74,1414,1488,4902,46,662,Alaska,Northway,0
848,1997-1998,1997-10-06,1998-05-04,211,0,826,1638,2464,74,1245,1319,3783,48,602,Alaska,Northway,0
849,1998-1999,1998-09-30,1999-05-07,220,2,1066,2012,3078,64,868,932,4010,43,692,Alaska,Northway,0
850,2000-2001,2000-09-26,2001-04-24,211,6,755,1543,2298,65,1148,1213,3511,41,437,Alaska,Northway,0
851,2010-2011,2010-09-26,2011-05-13,230,4,938,1937,2875,106,1400,1506,4381,57,803,Alaska,Northway,0
852,2011-2012,2011-10-09,2012-05-08,213,3,932,1744,2676,88,1232,1320,3996,66,919,Alaska,Northway,0
853,2012-2013,2012-10-01,2013-05-19,231,0,1075,2003,3078,139,1439,1578,4656,79,1072,Alaska,Northway,0
854,2013-2014,2013-09-19,2014-04-24,218,0,799,1722,2521,90,1080,1170,3691,49,582,Alaska,Northway,0
855,2014-2015,2014-09-03,2015-04-20,230,0,811,1573,2384,60,955,1015,3399,48,521,Alaska,Northway,0
856,2015-2016,2015-10-03,2016-05-17,228,0,654,1288,1942,69,791,860,2802,48,559,Alaska,Northway,0
857,2016-2017,2016-10-15,2017-04-14,182,0,910,1801,2711,58,639,697,3408,37,608,Alaska,Northway,0
858,2017-2018,2017-10-13,2018-05-01,201,0,856,1692,2548,57,871,928,3476,43,492,Alaska,Northway,0
859,2018-2019,2018-10-15,2019-04-03,171,0,747,1378,2125,50,815,865,2990,32,390,Alaska,Northway,0
860,2019-2020,2019-10-05,2020-04-24,203,4,912,1773,2685,80,1242,1322,4007,44,690,Alaska,Northway,0
861,1950-1951,1950-10-09,1951-04-30,204,5,1047,1805,2852,73,1831,1904,4756,54,691,Alaska,Tanana,246
862,1951-1952,1951-10-01,1952-05-19,232,3,931,1754,2685,111,2114,2225,4910,67,835,Alaska,Tanana,246
863,1952-1953,1952-09-28,1953-04-22,207,4,926,1705,2631,58,1420,1478,4109,41,548,Alaska,Tanana,246
864,1953-1954,1953-10-02,1954-05-01,212,0,925,1751,2676,85,1506,1591,4267,47,639,Alaska,Tanana,246
865,1954-1955,1954-10-07,1955-05-10,216,1,968,1811,2779,160,1435,1595,4374,47,764,Alaska,Tanana,246
866,1955-1956,1955-10-06,1956-05-03,211,0,1168,2116,3284,99,1779,1878,5162,61,855,Alaska,Tanana,246
867,1956-1957,1956-09-29,1957-04-29,213,5,1062,1889,2951,79,1323,1402,4353,55,720,Alaska,Tanana,246
868,1957-1958,1957-09-29,1958-04-23,207,0,799,1426,2225,41,657,698,2923,34,339,Alaska,Tanana,246
869,1958-1959,1958-09-30,1959-05-02,215,0,966,1947,2913,82,1581,1663,4576,45,557,Alaska,Tanana,246
870,1959-1960,1959-09-24,1960-04-28,218,0,851,1610,2461,84,1401,1485,3946,50,640,Alaska,Tanana,246
871,1960-1961,1960-09-22,1961-04-26,217,0,862,1611,2473,68,1075,1143,3616,52,609,Alaska,Tanana,246
872,1961-1962,1961-10-03,1962-05-09,219,3,972,1842,2814,92,1874,1966,4780,62,685,Alaska,Tanana,246
873,1962-1963,1962-10-11,1963-05-08,210,13,846,1643,2489,101,1787,1888,4377,51,502,Alaska,Tanana,246
874,1963-1964,1963-10-10,1964-05-20,224,10,942,1877,2819,68,1015,1083,3902,51,554,Alaska,Tanana,246
875,1964-1965,1964-10-16,1965-05-04,201,3,962,1709,2671,71,1460,1531,4202,56,684,Alaska,Tanana,246
876,1966-1967,1966-10-20,1967-05-06,199,3,895,1671,2566,105,1621,1726,4292,75,815,Alaska,Tanana,246
877,1967-1968,1967-10-16,1968-05-12,210,5,880,1725,2605,77,1700,1777,4382,43,494,Alaska,Tanana,246
878,1968-1969,1968-09-28,1969-04-23,208,0,1053,1860,2913,78,1272,1350,4263,36,542,Alaska,Tanana,246
879,1969-1970,1969-10-20,1970-04-25,188,0,793,1331,2124,37,696,733,2857,25,262,Alaska,Tanana,246
880,1970-1971,1970-09-23,1971-05-10,230,6,1130,2063,3193,114,2026,2140,5333,59,857,Alaska,Tanana,246
881,1971-1972,1971-09-29,1972-02-29,154,4,935,1446,2381,71,1155,1226,3607,50,529,Alaska,Tanana,246
882,1973-1974,1973-09-25,1974-04-25,213,0,1044,1958,3002,52,1063,1115,4117,45,588,Alaska,Tanana,246
883,1975-1976,1975-09-27,1976-05-10,227,3,1068,1986,3054,74,1460,1534,4588,44,488,Alaska,Tanana,246
884,1976-1977,1976-10-07,1977-05-06,212,4,683,1448,2131,92,1712,1804,3935,58,555,Alaska,Tanana,246
885,1978-1979,1978-09-24,1979-04-30,219,3,842,1707,2549,117,2372,2489,5038,54,590,Alaska,Tanana,246
886,1979-1980,1979-10-16,1980-04-27,195,0,807,1508,2315,68,1436,1504,3819,41,463,Alaska,Tanana,246
887,1980-1981,1980-09-03,1981-04-23,233,0,703,1418,2121,58,1125,1183,3304,38,363,Alaska,Tanana,246
888,1981-1982,1981-09-26,1982-05-09,226,3,886,1663,2549,89,1692,1781,4330,60,580,Alaska,Tanana,246
889,1982-1983,1982-10-01,1983-04-21,203,3,897,1565,2462,65,1607,1672,4134,51,601,Alaska,Tanana,246
890,1983-1984,1983-09-23,1984-05-13,234,14,947,1755,2702,88,1563,1651,4353,61,767,Alaska,Tanana,246
891,1984-1985,1984-10-04,1985-05-19,228,3,805,1627,2432,128,1804,1932,4364,58,722,Alaska,Tanana,246
892,1985-1986,1985-09-21,1986-05-04,226,6,778,1681,2459,57,1584,1641,4100,34,410,Alaska,Tanana,246
893,1986-1987,1986-09-30,1987-04-27,210,0,746,1533,2279,59,1431,1490,3769,32,396,Alaska,Tanana,246
894,1987-1988,1987-09-08,1988-05-01,237,0,725,1444,2169,66,1436,1502,3671,43,522,Alaska,Tanana,246
895,1988-1989,1988-10-02,1989-04-30,211,14,865,1661,2526,86,1773,1859,4385,54,577,Alaska,Tanana,246
896,1989-1990,1989-10-13,1990-04-26,196,3,975,1731,2706,87,1762,1849,4555,53,660,Alaska,Tanana,246
897,1990-1991,1990-09-26,1991-05-02,219,2,859,1653,2512,109,1772,1881,4393,72,894,Alaska,Tanana,246
898,1991-1992,1991-10-06,1992-05-17,225,0,868,1638,2506,67,1301,1368,3874,56,606,Alaska,Tanana,246
899,1992-1993,1992-09-11,1993-05-09,241,0,764,1562,2326,119,2048,2167,4493,76,798,Alaska,Tanana,246
900,1993-1994,1993-09-29,1994-04-27,211,4,739,1353,2092,72,1388,1460,3552,62,593,Alaska,Tanana,246
901,1995-1996,1995-10-08,1996-04-28,204,4,900,1704,2604,81,1060,1141,3745,36,433,Alaska,Tanana,246
902,1996-1997,1996-09-25,1997-04-27,215,2,856,1705,2561,99,1273,1372,3933,45,512,Alaska,Tanana,246
903,1997-1998,1997-10-03,1998-04-28,208,9,669,1280,1949,68,1002,1070,3019,48,592,Alaska,Tanana,246
904,1998-1999,1998-10-07,1999-04-25,201,2,894,1623,2517,84,1020,1104,3621,52,680,Alaska,Tanana,246
905,2010-2011,2010-09-30,2011-05-07,220,3,869,1679,2548,92,1298,1390,3938,53,638,Alaska,Tanana,246
906,2011-2012,2011-10-14,2012-05-03,203,1,993,1882,2875,114,1501,1615,4490,59,904,Alaska,Tanana,246
907,2012-2013,2012-10-13,2013-05-10,210,2,921,1856,2777,78,1163,1241,4018,48,623,Alaska,Tanana,246
908,2013-2014,2013-10-25,2014-04-24,182,6,667,1380,2047,61,942,1003,3050,42,514,Alaska,Tanana,246
909,2014-2015,2014-09-29,2015-04-21,205,0,623,1337,1960,52,940,992,2952,43,345,Alaska,Tanana,246
910,2015-2016,2015-09-25,2016-04-23,212,0,545,1234,1779,95,1376,1471,3250,43,390,Alaska,Tanana,246
911,2016-2017,2016-10-18,2017-05-01,196,3,832,1769,2601,93,1162,1255,3856,53,813,Alaska,Tanana,246
912,2017-2018,2017-10-17,2018-05-10,206,0,600,1281,1881,125,1445,1570,3451,58,526,Alaska,Tanana,246
913,2018-2019,2018-10-27,2019-05-09,195,4,593,1172,1765,102,1231,1333,3098,56,518,Alaska,Tanana,246
914,2019-2020,2019-10-06,2020-05-11,219,0,889,1819,2708,162,1791,1953,4661,73,923,Alaska,Tanana,246
915,1950-1951,1950-09-03,1951-06-16,287,2,1471,2130,3601,49,1306,1355,4956,42,409,Alaska,Utquagvik,0
916,1951-1952,1951-09-06,1952-06-19,288,0,1464,2187,3651,71,1489,1560,5211,62,569,Alaska,Utquagvik,0
917,1952-1953,1952-07-29,1953-06-15,322,2,1493,2141,3634,54,1027,1081,4715,52,625,Alaska,Utquagvik,0
918,1953-1954,1953-08-14,1954-06-14,305,0,1585,2390,3975,79,1536,1615,5590,73,902,Alaska,Utquagvik,0
919,1954-1955,1954-09-18,1955-06-21,277,3,1621,2275,3896,37,1476,1513,5409,33,395,Alaska,Utquagvik,0
920,1955-1956,1955-07-19,1956-06-23,341,0,1789,2666,4455,57,1287,1344,5799,52,650,Alaska,Utquagvik,0
921,1956-1957,1956-07-18,1957-06-24,342,0,1523,2290,3813,76,1574,1650,5463,73,970,Alaska,Utquagvik,0
922,1957-1958,1957-07-08,1958-06-16,344,0,1630,2187,3817,82,1123,1205,5022,68,604,Alaska,Utquagvik,0
923,1958-1959,1958-09-16,1959-06-11,269,0,1491,2206,3697,97,1612,1709,5406,79,755,Alaska,Utquagvik,0
924,1959-1960,1959-07-03,1960-06-18,352,0,1634,2428,4062,100,1481,1581,5643,92,1035,Alaska,Utquagvik,0
925,1960-1961,1960-08-20,1961-06-19,304,0,1760,2380,4140,66,1641,1707,5847,60,693,Alaska,Utquagvik,0
926,1961-1962,1961-07-08,1962-06-17,345,1,1322,2128,3450,136,1855,1991,5441,107,1110,Alaska,Utquagvik,0
927,1962-1963,1962-07-04,1963-06-09,341,8,1387,2149,3536,120,1576,1696,5232,91,897,Alaska,Utquagvik,0
928,1963-1964,1963-07-04,1964-06-30,363,0,1798,2550,4348,79,1319,1398,5746,67,731,Alaska,Utquagvik,0
929,1964-1965,1964-07-04,1965-06-22,354,0,1755,2488,4243,97,1458,1555,5798,81,824,Alaska,Utquagvik,0
930,1965-1966,1965-08-28,1966-06-12,289,0,1598,2414,4012,95,1709,1804,5816,74,786,Alaska,Utquagvik,0
931,1966-1967,1966-08-16,1967-06-28,317,0,1345,1971,3316,86,1265,1351,4667,78,636,Alaska,Utquagvik,0
932,1967-1968,1967-07-05,1968-06-30,362,0,1535,2294,3829,91,1677,1768,5597,83,960,Alaska,Utquagvik,0
933,1968-1969,1968-07-01,1969-06-12,347,0,1489,2118,3607,83,1365,1448,5055,71,695,Alaska,Utquagvik,0
934,1969-1970,1969-07-18,1970-06-18,336,0,1598,2221,3819,52,986,1038,4857,48,488,Alaska,Utquagvik,0
935,1970-1971,1970-09-01,1971-06-13,286,0,1829,2546,4375,50,1252,1302,5677,44,514,Alaska,Utquagvik,0
936,1971-1972,1971-08-09,1972-06-21,318,0,1607,2352,3959,57,1081,1138,5097,50,499,Alaska,Utquagvik,0
937,1972-1973,1972-08-30,1973-06-22,297,0,1460,2108,3568,107,1214,1321,4889,76,615,Alaska,Utquagvik,0
938,1973-1974,1973-07-06,1974-06-11,341,0,1550,2219,3769,85,1175,1260,5029,73,637,Alaska,Utquagvik,0
939,1974-1975,1974-09-10,1975-06-14,278,0,1787,2418,4205,67,1019,1086,5291,62,846,Alaska,Utquagvik,0
940,1975-1976,1975-07-25,1976-06-29,341,0,1903,2589,4492,57,908,965,5457,53,588,Alaska,Utquagvik,0
941,1976-1977,1976-09-03,1977-06-01,272,0,1619,2152,3771,78,1179,1257,5028,73,918,Alaska,Utquagvik,0
942,1977-1978,1977-07-04,1978-06-26,358,0,1366,1970,3336,63,889,952,4288,61,675,Alaska,Utquagvik,0
943,1978-1979,1978-08-05,1979-06-26,326,0,1485,2223,3708,53,996,1049,4757,48,408,Alaska,Utquagvik,0
944,1979-1980,1979-07-07,1980-06-04,334,0,1442,1935,3377,55,1295,1350,4727,52,458,Alaska,Utquagvik,0
945,1980-1981,1980-08-03,1981-06-26,328,0,1431,2093,3524,82,1427,1509,5033,73,767,Alaska,Utquagvik,0
946,1981-1982,1981-08-14,1982-06-11,302,0,1410,2014,3424,92,1366,1458,4882,86,795,Alaska,Utquagvik,0
947,1982-1983,1982-07-22,1983-06-23,337,0,1651,2193,3844,60,981,1041,4885,56,475,Alaska,Utquagvik,0
948,1983-1984,1983-07-13,1984-06-06,330,0,1741,2469,4210,89,1610,1699,5909,86,988,Alaska,Utquagvik,0
949,1984-1985,1984-08-23,1985-06-17,299,0,1531,2094,3625,60,834,894,4519,56,610,Alaska,Utquagvik,0
950,1985-1986,1985-08-11,1986-06-10,304,3,1479,2156,3635,69,1318,1387,5022,65,694,Alaska,Utquagvik,0
951,1986-1987,1986-08-22,1987-06-12,295,3,1482,2117,3599,74,1300,1374,4973,68,761,Alaska,Utquagvik,0
952,1987-1988,1987-08-30,1988-06-07,283,6,1367,2109,3476,70,1093,1163,4639,58,508,Alaska,Utquagvik,0
953,1988-1989,1988-08-25,1989-06-11,291,0,1419,2299,3718,66,1066,1132,4850,58,533,Alaska,Utquagvik,0
954,1989-1990,1989-09-18,1990-06-10,266,0,1556,2234,3790,51,718,769,4559,47,585,Alaska,Utquagvik,0
955,1990-1991,1990-07-07,1991-06-17,346,0,1506,2292,3798,84,1125,1209,5007,70,630,Alaska,Utquagvik,0
956,1991-1992,1991-08-05,1992-06-09,310,0,1577,2296,3873,90,1239,1329,5202,84,899,Alaska,Utquagvik,0
957,1992-1993,1992-08-03,1993-06-22,324,3,1333,2128,3461,108,1459,1567,5028,93,972,Alaska,Utquagvik,0
958,1993-1994,1993-08-03,1994-06-23,325,3,1335,1967,3302,102,1317,1419,4721,89,776,Alaska,Utquagvik,0
959,1994-1995,1994-08-24,1995-06-03,284,0,1531,2328,3859,74,1208,1282,5141,64,809,Alaska,Utquagvik,0
960,1995-1996,1995-08-05,1996-06-27,328,0,1228,2022,3250,71,1227,1298,4548,56,521,Alaska,Utquagvik,0
961,1996-1997,1996-08-09,1997-06-13,309,0,1389,2116,3505,76,1128,1204,4709,66,673,Alaska,Utquagvik,0
962,1997-1998,1997-09-23,1998-05-23,243,0,1221,1745,2966,90,1643,1733,4699,73,700,Alaska,Utquagvik,0
963,1998-1999,1998-09-28,1999-06-20,266,0,1305,1938,3243,88,1229,1317,4560,79,816,Alaska,Utquagvik,0
964,1999-2000,1999-08-28,2000-06-14,292,0,1510,2175,3685,119,1231,1350,5035,104,1215,Alaska,Utquagvik,0
965,2000-2001,2000-07-25,2001-06-19,330,0,1357,1969,3326,113,1398,1511,4837,92,807,Alaska,Utquagvik,0
966,2001-2002,2001-07-06,2002-06-28,358,3,1385,2134,3519,99,1225,1324,4843,80,874,Alaska,Utquagvik,0
967,2002-2003,2002-07-01,2003-06-14,349,0,1220,1813,3033,115,1265,1380,4413,99,891,Alaska,Utquagvik,0
968,2003-2004,2003-07-15,2004-06-03,325,1,1395,2037,3432,107,1282,1389,4821,82,899,Alaska,Utquagvik,0
969,2004-2005,2004-07-09,2005-06-22,349,0,1283,1856,3139,106,1246,1352,4491,96,910,Alaska,Utquagvik,0
970,2005-2006,2005-08-30,2006-06-06,281,3,1347,1964,3311,113,1505,1618,4929,90,1155,Alaska,Utquagvik,0
971,2006-2007,2006-08-16,2007-06-05,294,6,1280,1860,3140,103,1320,1423,4563,82,874,Alaska,Utquagvik,0
972,2007-2008,2007-09-29,2008-06-04,250,3,1215,1850,3065,111,1533,1644,4709,95,904,Alaska,Utquagvik,0
973,2008-2009,2008-07-30,2009-05-31,306,0,1247,1902,3149,153,1688,1841,4990,121,1368,Alaska,Utquagvik,0
974,2009-2010,2009-08-31,2010-06-14,288,0,1241,1887,3128,133,1504,1637,4765,112,1343,Alaska,Utquagvik,0
975,2010-2011,2010-09-22,2011-06-15,267,3,1141,1824,2965,141,1226,1367,4332,109,1113,Alaska,Utquagvik,0
976,2011-2012,2011-07-01,2012-06-07,343,0,1492,2112,3604,150,1479,1629,5233,117,1318,Alaska,Utquagvik,0
977,2012-2013,2012-07-21,2013-06-25,340,0,1264,1813,3077,156,1076,1232,4309,136,1403,Alaska,Utquagvik,0
978,2013-2014,2013-08-20,2014-06-14,299,0,1074,1721,2795,143,1040,1183,3978,131,1123,Alaska,Utquagvik,0
979,2014-2015,2014-07-23,2015-06-05,318,0,1165,1717,2882,133,1025,1158,4040,108,1077,Alaska,Utquagvik,0
980,2015-2016,2015-08-18,2016-06-16,304,0,1129,1602,2731,109,926,1035,3766,97,870,Alaska,Utquagvik,0
981,2016-2017,2016-08-03,2017-06-16,318,0,911,1575,2486,113,1005,1118,3604,100,908,Alaska,Utquagvik,0
982,2017-2018,2017-08-29,2018-06-13,289,1,847,1445,2292,90,1183,1273,3565,77,616,Alaska,Utquagvik,0
983,2018-2019,2018-07-07,2019-06-07,336,14,923,1534,2457,95,1087,1182,3639,71,677,Alaska,Utquagvik,0
984,1950-1951,1950-12-01,1951-05-16,167,0,11,400,411,105,149,254,665,22,164,Arizona,Flagstaff,65870
985,1951-1952,1951-11-22,1952-04-11,142,0,34,469,503,144,519,663,1166,30,229,Arizona,Flagstaff,65870
986,1952-1953,1952-11-15,1953-05-16,183,0,14,497,511,89,237,326,837,28,157,Arizona,Flagstaff,65870
987,1953-1954,1953-11-18,1954-05-01,165,0,11,456,467,121,271,392,859,23,188,Arizona,Flagstaff,65870
988,1954-1955,1954-11-02,1955-05-02,182,0,33,583,616,100,390,490,1106,27,191,Arizona,Flagstaff,65870
989,1955-1956,1955-11-14,1956-04-15,154,0,12,422,434,59,128,187,621,20,118,Arizona,Flagstaff,65870
990,1956-1957,1956-10-29,1957-05-15,199,0,13,433,446,79,195,274,720,28,139,Arizona,Flagstaff,65870
991,1957-1958,1957-10-22,1958-04-10,171,0,5,405,410,106,158,264,674,37,182,Arizona,Flagstaff,65870
992,1958-1959,1958-10-30,1959-03-24,146,0,9,414,423,75,139,214,637,13,112,Arizona,Flagstaff,65870
993,1959-1960,1959-10-01,1960-05-05,218,0,21,527,548,109,340,449,997,28,171,Arizona,Flagstaff,65870
994,1960-1961,1960-10-15,1961-05-13,211,0,8,469,477,79,115,194,671,25,130,Arizona,Flagstaff,65870
995,1961-1962,1961-10-08,1962-05-28,233,0,23,588,611,176,502,678,1289,46,310,Arizona,Flagstaff,65870
996,1962-1963,1962-11-15,1963-04-27,164,0,20,450,470,67,114,181,651,25,134,Arizona,Flagstaff,65870
997,1963-1964,1963-11-07,1964-05-07,183,0,18,562,580,120,183,303,883,31,207,Arizona,Flagstaff,65870
998,1964-1965,1964-11-10,1965-05-25,197,0,18,488,506,229,349,578,1084,48,352,Arizona,Flagstaff,65870
999,1965-1966,1965-09-19,1966-04-20,214,0,23,527,550,116,355,471,1021,35,226,Arizona,Flagstaff,65870
1000,1966-1967,1966-11-08,1967-04-22,166,0,11,415,426,85,126,211,637,16,133,Arizona,Flagstaff,65870
1001,1967-1968,1967-11-22,1968-05-13,174,0,23,444,467,208,644,852,1319,40,304,Arizona,Flagstaff,65870
1002,1968-1969,1968-11-13,1969-05-05,174,0,41,485,526,180,437,617,1143,41,329,Arizona,Flagstaff,65870
1003,1969-1970,1969-10-20,1970-04-29,192,0,9,428,437,136,106,242,679,36,211,Arizona,Flagstaff,65870
1004,1970-1971,1970-11-30,1971-05-29,181,0,33,441,474,79,240,319,793,28,170,Arizona,Flagstaff,65870
1005,1971-1972,1971-10-16,1972-04-14,182,0,24,562,586,68,116,184,770,20,123,Arizona,Flagstaff,65870
1006,1972-1973,1972-10-20,1973-05-06,199,0,47,630,677,292,883,1175,1852,72,506,Arizona,Flagstaff,65870
1007,1973-1974,1973-11-18,1974-04-02,136,0,18,344,362,101,289,390,752,28,175,Arizona,Flagstaff,65870
1008,1974-1975,1974-10-27,1975-05-21,207,0,31,546,577,199,355,554,1131,60,371,Arizona,Flagstaff,65870
1009,1975-1976,1975-11-27,1976-05-08,164,0,14,385,399,178,338,516,915,35,262,Arizona,Flagstaff,65870
1010,1976-1977,1976-11-26,1977-05-13,169,0,10,475,485,102,195,297,782,25,165,Arizona,Flagstaff,65870
1011,1977-1978,1977-11-06,1978-05-01,177,0,5,325,330,162,279,441,771,44,220,Arizona,Flagstaff,65870
1012,1978-1979,1978-11-03,1979-05-09,188,0,45,565,610,199,617,816,1426,50,350,Arizona,Flagstaff,65870
1013,1979-1980,1979-10-21,1980-04-24,187,0,10,434,444,248,408,656,1100,43,313,Arizona,Flagstaff,65870
1014,1980-1981,1980-10-15,1981-04-19,187,0,1,269,270,124,121,245,515,34,160,Arizona,Flagstaff,65870
1015,1981-1982,1981-11-27,1982-05-12,167,7,12,344,356,174,385,559,915,42,262,Arizona,Flagstaff,65870
1016,1982-1983,1982-11-08,1983-05-01,175,0,9,411,420,198,445,643,1063,52,311,Arizona,Flagstaff,65870
1017,1983-1984,1983-11-18,1984-04-29,164,0,2,389,391,50,89,139,530,26,97,Arizona,Flagstaff,65870
1018,1989-1990,1989-12-01,1990-05-29,180,0,12,415,427,159,316,475,902,33,246,Arizona,Flagstaff,65870
1019,1990-1991,1990-11-02,1991-04-01,151,0,17,425,442,174,261,435,877,32,257,Arizona,Flagstaff,65870
1020,1991-1992,1991-10-27,1992-04-02,159,0,8,366,374,218,394,612,986,48,315,Arizona,Flagstaff,65870
1021,1992-1993,1992-10-24,1993-05-04,193,0,8,393,401,198,414,612,1013,45,273,Arizona,Flagstaff,65870
1022,1993-1994,1993-11-11,1994-04-28,169,0,5,388,393,154,270,424,817,34,216,Arizona,Flagstaff,65870
1023,1997-1998,1997-11-12,1998-05-14,184,0,20,447,467,193,373,566,1033,42,294,Arizona,Flagstaff,65870
1024,1998-1999,1998-10-16,1999-05-01,198,1,14,416,430,106,113,219,649,26,175,Arizona,Flagstaff,65870
1025,1999-2000,1999-12-01,2000-04-01,123,2,6,309,315,103,109,212,527,25,163,Arizona,Flagstaff,65870
1026,2000-2001,2000-10-28,2001-04-22,177,11,12,425,437,179,363,542,979,38,279,Arizona,Flagstaff,65870
1027,2001-2002,2001-11-26,2002-03-25,120,0,12,379,391,55,98,153,544,11,103,Arizona,Flagstaff,65870
1028,2002-2003,2002-10-27,2003-04-16,172,1,7,355,362,79,167,246,608,20,137,Arizona,Flagstaff,65870
1029,2003-2004,2003-12-01,2004-03-06,97,0,14,289,303,68,84,152,455,17,115,Arizona,Flagstaff,65870
1030,2004-2005,2004-10-21,2005-04-28,190,0,10,346,356,180,407,587,943,41,253,Arizona,Flagstaff,65870
1031,2005-2006,2005-11-27,2006-04-06,131,0,6,377,383,61,47,108,491,15,101,Arizona,Flagstaff,65870
1032,2006-2007,2006-11-28,2007-05-05,159,0,20,378,398,76,166,242,640,33,175,Arizona,Flagstaff,65870
1033,2007-2008,2007-12-01,2008-05-23,175,0,19,445,464,138,476,614,1078,30,213,Arizona,Flagstaff,65870
1034,2008-2009,2008-11-09,2009-04-16,159,0,9,352,361,122,441,563,924,26,190,Arizona,Flagstaff,65870
1035,2009-2010,2009-10-28,2010-05-02,187,0,17,484,501,184,839,1023,1524,35,263,Arizona,Flagstaff,65870
1036,2010-2011,2010-11-21,2011-05-19,180,8,20,388,408,125,262,387,795,23,174,Arizona,Flagstaff,65870
1037,2011-2012,2011-11-05,2012-04-26,174,0,14,391,405,140,266,406,811,25,205,Arizona,Flagstaff,65870
1038,2012-2013,2012-11-09,2013-04-09,152,0,31,446,477,97,321,418,895,23,177,Arizona,Flagstaff,65870
1039,2013-2014,2013-10-10,2014-05-08,211,0,7,400,407,63,151,214,621,21,107,Arizona,Flagstaff,65870
1040,2014-2015,2014-12-01,2015-05-15,166,0,8,266,274,92,118,210,484,21,133,Arizona,Flagstaff,65870
1041,2015-2016,2015-11-04,2016-05-01,180,0,18,446,464,106,369,475,939,23,160,Arizona,Flagstaff,65870
1042,2016-2017,2016-11-27,2017-05-18,173,0,17,289,306,134,243,377,683,26,192,Arizona,Flagstaff,65870
1043,2017-2018,2017-12-01,2018-05-02,153,0,4,311,315,52,66,118,433,15,85,Arizona,Flagstaff,65870
1044,2018-2019,2018-10-07,2019-05-23,229,0,20,442,462,161,260,421,883,37,260,Arizona,Flagstaff,65870
1045,2019-2020,2019-11-20,2020-04-09,142,5,10,329,339,97,225,322,661,23,147,Arizona,Flagstaff,65870
1046,1950-1951,1950-12-01,1951-02-28,90,0,0,7,7,0,0,0,7,0,0,Arizona,Grand,48571
1047,1951-1952,1951-12-01,1952-02-29,91,0,0,22,22,0,0,0,22,0,0,Arizona,Grand,48571
1048,1952-1953,1952-12-01,1953-02-28,90,0,0,15,15,0,0,0,15,0,0,Arizona,Grand,48571
1049,1954-1955,1954-12-01,1955-02-28,90,16,0,35,35,0,0,0,35,0,0,Arizona,Grand,48571
1050,1955-1956,1955-12-01,1956-02-29,91,12,0,3,3,0,0,0,3,0,0,Arizona,Grand,48571
1051,1957-1958,1957-12-01,1958-02-28,90,16,0,1,1,0,0,0,1,0,0,Arizona,Grand,48571
1052,1960-1961,1960-12-01,1961-02-28,90,3,0,25,25,3,2,5,30,1,4,Arizona,Grand,48571
1053,1961-1962,1961-12-01,1962-02-28,90,3,0,36,36,0,0,0,36,0,0,Arizona,Grand,48571
1054,1962-1963,1962-12-01,1963-02-28,90,2,0,29,29,0,0,0,29,0,0,Arizona,Grand,48571
1055,1963-1964,1963-12-01,1964-02-29,91,0,0,55,55,0,0,0,55,0,0,Arizona,Grand,48571
1056,1966-1967,1966-12-01,1967-02-28,90,0,0,14,14,0,0,0,14,0,0,Arizona,Grand,48571
1057,1968-1969,1968-12-01,1969-02-28,90,20,0,23,23,0,0,0,23,0,0,Arizona,Grand,48571
1058,1972-1973,1972-12-01,1973-02-28,90,0,0,12,12,3,0,3,15,1,4,Arizona,Grand,48571
1059,1974-1975,1974-12-01,1975-02-28,90,4,0,12,12,0,0,0,12,0,0,Arizona,Grand,48571
1060,1975-1976,1975-12-01,1976-02-29,91,0,0,12,12,0,0,0,12,0,0,Arizona,Grand,48571
1061,1976-1977,1976-12-01,1977-02-28,90,0,0,15,15,0,0,0,15,0,0,Arizona,Grand,48571
1062,1977-1978,1977-12-01,1978-02-28,90,4,0,0,0,0,0,0,0,0,0,Arizona,Grand,48571
1063,1978-1979,1978-12-01,1979-02-28,90,1,0,36,36,2,1,3,39,1,3,Arizona,Grand,48571
1064,1979-1980,1979-12-01,1980-02-29,91,0,0,0,0,0,0,0,0,0,0,Arizona,Grand,48571
1065,1980-1981,1980-12-01,1981-02-28,90,0,0,2,2,0,0,0,2,0,0,Arizona,Grand,48571
1066,1981-1982,1981-12-01,1982-02-28,90,3,0,6,6,0,0,0,6,0,0,Arizona,Grand,48571
1067,1982-1983,1982-12-01,1983-02-28,90,3,0,6,6,0,0,0,6,0,0,Arizona,Grand,48571
1068,1985-1986,1985-12-01,1986-02-28,90,0,0,11,11,0,0,0,11,0,0,Arizona,Grand,48571
1069,1986-1987,1986-12-01,1987-02-28,90,4,0,28,28,0,0,0,28,0,0,Arizona,Grand,48571
1070,1987-1988,1987-12-01,1988-02-29,91,4,0,15,15,1,1,2,17,1,2,Arizona,Grand,48571
1071,1988-1989,1988-12-01,1989-02-28,90,6,1,28,29,0,0,0,29,0,0,Arizona,Grand,48571
1072,1989-1990,1989-12-01,1990-02-28,90,3,0,10,10,0,0,0,10,0,0,Arizona,Grand,48571
1073,1990-1991,1990-12-01,1991-02-28,90,2,0,25,25,0,0,0,25,0,0,Arizona,Grand,48571
1074,1991-1992,1991-12-01,1992-02-29,91,0,0,4,4,0,0,0,4,0,0,Arizona,Grand,48571
1075,1992-1993,1992-12-01,1993-02-28,90,0,0,13,13,0,0,0,13,0,0,Arizona,Grand,48571
1076,1993-1994,1993-12-01,1994-02-28,90,2,0,5,5,0,0,0,5,0,0,Arizona,Grand,48571
1077,1994-1995,1994-12-01,1995-02-28,90,5,0,1,1,0,0,0,1,0,0,Arizona,Grand,48571
1078,1995-1996,1995-12-01,1996-02-29,91,11,0,3,3,0,0,0,3,0,0,Arizona,Grand,48571
1079,1996-1997,1996-12-01,1997-02-28,90,2,0,4,4,0,0,0,4,0,0,Arizona,Grand,48571
1080,1997-1998,1997-12-01,1998-02-28,90,5,0,8,8,0,0,0,8,0,0,Arizona,Grand,48571
1081,1998-1999,1998-12-01,1999-02-28,90,16,0,23,23,0,0,0,23,0,0,Arizona,Grand,48571
1082,1999-2000,1999-12-01,2000-02-29,91,2,0,12,12,0,0,0,12,0,0,Arizona,Grand,48571
1083,2000-2001,2000-12-01,2001-02-28,90,17,0,10,10,0,0,0,10,0,0,Arizona,Grand,48571
1084,2001-2002,2001-12-01,2002-02-28,90,11,0,23,23,0,0,0,23,0,0,Arizona,Grand,48571
1085,2002-2003,2002-12-01,2003-02-28,90,16,0,9,9,0,0,0,9,0,0,Arizona,Grand,48571
1086,2003-2004,2003-12-01,2004-02-29,91,7,0,15,15,0,0,0,15,0,0,Arizona,Grand,48571
1087,2004-2005,2004-12-01,2005-02-28,90,11,0,6,6,0,0,0,6,0,0,Arizona,Grand,48571
1088,2007-2008,2007-12-01,2008-02-29,91,6,0,21,21,0,0,0,21,0,0,Arizona,Grand,48571
1089,2009-2010,2009-12-01,2010-02-28,90,12,0,14,14,0,0,0,14,0,0,Arizona,Grand,48571
1090,2012-2013,2012-12-01,2013-02-28,90,4,0,27,27,0,0,0,27,0,0,Arizona,Grand,48571
1091,2013-2014,2013-12-01,2014-02-28,90,0,0,31,31,0,0,0,31,0,0,Arizona,Grand,48571
1092,2014-2015,2014-12-01,2015-02-28,90,0,0,12,12,2,1,3,15,2,4,Arizona,Grand,48571
1093,2015-2016,2015-12-01,2016-02-29,91,0,0,23,23,0,0,0,23,0,0,Arizona,Grand,48571
1094,2016-2017,2016-12-01,2017-02-28,90,0,0,11,11,0,0,0,11,0,0,Arizona,Grand,48571
1095,2017-2018,2017-12-01,2018-02-28,90,0,0,11,11,0,0,0,11,0,0,Arizona,Grand,48571
1096,2018-2019,2018-12-01,2019-02-28,90,0,0,16,16,1,0,1,17,1,2,Arizona,Grand,48571
1097,2019-2020,2019-11-29,2020-02-29,93,5,0,20,20,1,0,1,21,1,2,Arizona,Grand,48571
1098,1950-1951,1950-12-01,1951-05-14,165,7,9,448,457,165,233,398,855,20,212,Arizona,Mc Nary,0
1099,1953-1954,1953-11-19,1954-05-01,164,18,8,400,408,105,139,244,652,17,161,Arizona,Mc Nary,0
1100,1954-1955,1954-11-03,1955-03-22,140,1,20,463,483,80,172,252,735,19,165,Arizona,Mc Nary,0
1101,1955-1956,1955-11-15,1956-04-15,153,10,13,411,424,116,275,391,815,23,182,Arizona,Mc Nary,0
1102,1956-1957,1956-10-29,1957-04-24,178,5,4,394,398,75,102,177,575,18,125,Arizona,Mc Nary,0
1103,1961-1962,1961-10-29,1962-03-26,149,18,21,399,420,266,587,853,1273,42,390,Arizona,Mc Nary,0
1104,1962-1963,1962-12-01,1963-03-20,110,3,14,301,315,117,199,316,631,18,177,Arizona,Mc Nary,0
1105,1963-1964,1963-11-08,1964-04-29,174,9,22,497,519,127,179,306,825,22,194,Arizona,Mc Nary,0
1106,1964-1965,1964-11-14,1965-04-13,151,2,20,354,374,218,382,600,974,32,292,Arizona,Mc Nary,0
1107,1965-1966,1965-12-01,1966-03-05,95,1,21,324,345,176,304,480,825,27,267,Arizona,Mc Nary,0
1108,1966-1967,1966-12-01,1967-04-13,134,6,8,324,332,49,46,95,427,11,98,Arizona,Mc Nary,0
1109,1967-1968,1967-11-29,1968-04-23,147,2,11,348,359,155,577,732,1091,21,210,Arizona,Mc Nary,0
1110,1968-1969,1968-11-13,1969-05-08,177,2,16,438,454,170,349,519,973,29,280,Arizona,Mc Nary,0
1111,1969-1970,1969-12-01,1970-05-01,152,1,9,344,353,85,113,198,551,22,144,Arizona,Mc Nary,0
1112,1970-1971,1970-12-01,1971-04-22,143,0,20,345,365,84,188,272,637,16,136,Arizona,Mc Nary,0
1113,1971-1972,1971-10-17,1972-04-14,181,0,8,387,395,121,200,321,716,20,168,Arizona,Mc Nary,0
1114,1972-1973,1972-10-30,1973-04-21,174,7,16,470,486,284,519,803,1289,56,436,Arizona,Mc Nary,0
1115,1973-1974,1973-11-19,1974-04-03,136,3,15,344,359,147,281,428,787,30,239,Arizona,Mc Nary,0
1116,1974-1975,1974-10-29,1975-04-18,172,7,19,414,433,239,366,605,1038,44,373,Arizona,Mc Nary,0
1117,1975-1976,1975-11-02,1976-04-20,171,15,7,396,403,150,217,367,770,26,234,Arizona,Mc Nary,0
1118,1976-1977,1976-11-13,1977-05-14,183,17,12,428,440,125,212,337,777,21,184,Arizona,Mc Nary,0
1119,1977-1978,1977-11-08,1978-05-06,180,14,7,277,284,116,233,349,633,29,176,Arizona,Mc Nary,0
1120,1981-1982,1981-11-29,1982-04-02,125,11,6,260,266,110,364,474,740,20,144,Arizona,Mc Nary,0
1121,1988-1989,1988-11-15,1989-03-28,134,4,18,340,358,88,220,308,666,31,184,Arizona,Mc Nary,0
1122,1989-1990,1989-11-29,1990-05-29,182,1,18,365,383,82,208,290,673,30,179,Arizona,Mc Nary,0
1123,1990-1991,1990-11-03,1991-04-14,163,1,14,370,384,150,436,586,970,35,253,Arizona,Mc Nary,0
1124,1991-1992,1991-10-28,1992-04-02,158,3,12,337,349,141,404,545,894,38,220,Arizona,Mc Nary,0
1125,1992-1993,1992-11-11,1993-04-07,148,5,18,303,321,142,436,578,899,42,254,Arizona,Mc Nary,0
1126,1993-1994,1993-11-13,1994-04-29,168,2,10,316,326,89,246,335,661,27,143,Arizona,Mc Nary,0
1127,1994-1995,1994-10-16,1995-05-17,214,6,8,313,321,110,276,386,707,32,179,Arizona,Mc Nary,0
1128,1995-1996,1995-11-02,1996-04-05,156,2,4,265,269,51,150,201,470,20,110,Arizona,Mc Nary,0
1129,1996-1997,1996-10-26,1997-04-12,169,0,19,325,344,146,440,586,930,33,235,Arizona,Mc Nary,0
1130,1997-1998,1997-10-25,1998-04-17,175,7,22,354,376,147,395,542,918,54,284,Arizona,Mc Nary,0
1131,1998-1999,1998-11-29,1999-05-02,155,7,9,266,275,65,111,176,451,21,113,Arizona,Mc Nary,0
1132,1999-2000,1999-12-01,2000-04-02,124,5,10,235,245,41,70,111,356,15,78,Arizona,Mc Nary,0
1133,2000-2001,2000-10-28,2001-05-05,190,5,14,344,358,134,317,451,809,39,227,Arizona,Mc Nary,0
1134,2001-2002,2001-11-23,2002-04-08,137,0,10,313,323,53,110,163,486,20,111,Arizona,Mc Nary,0
1135,2002-2003,2002-12-01,2003-04-23,144,8,9,244,253,113,258,371,624,30,179,Arizona,Mc Nary,0
1136,2003-2004,2003-12-01,2004-04-12,134,1,14,253,267,75,175,250,517,31,151,Arizona,Mc Nary,0
1137,2004-2005,2004-10-22,2005-04-11,172,0,12,273,285,108,189,297,582,40,182,Arizona,Mc Nary,0
1138,2005-2006,2005-11-28,2006-04-28,152,1,6,265,271,77,124,201,472,16,122,Arizona,Mc Nary,0
1139,2006-2007,2006-11-28,2007-03-30,123,3,19,305,324,78,240,318,642,28,165,Arizona,Mc Nary,0
1140,2007-2008,2007-12-01,2008-05-25,177,6,16,339,355,110,480,590,945,30,200,Arizona,Mc Nary,0
1141,2008-2009,2008-11-10,2009-04-12,154,8,12,299,311,122,485,607,918,35,202,Arizona,Mc Nary,0
1142,2009-2010,2009-10-28,2010-05-03,188,2,14,418,432,168,772,940,1372,42,261,Arizona,Mc Nary,0
1143,2011-2012,2011-10-07,2012-04-16,193,0,14,347,361,126,326,452,813,34,207,Arizona,Mc Nary,0
1144,2012-2013,2012-11-10,2013-04-18,160,2,28,396,424,98,351,449,873,29,203,Arizona,Mc Nary,0
1145,2013-2014,2013-11-05,2014-04-03,150,0,6,259,265,32,41,73,338,14,65,Arizona,Mc Nary,0
1146,2014-2015,2014-11-16,2015-05-16,182,0,7,261,268,39,41,80,348,20,89,Arizona,Mc Nary,0
1147,2015-2016,2015-10-30,2016-05-01,185,2,18,368,386,80,293,373,759,28,158,Arizona,Mc Nary,0
1148,2016-2017,2016-11-28,2017-04-29,153,0,11,221,232,65,157,222,454,22,112,Arizona,Mc Nary,0
1149,2017-2018,2017-12-01,2018-05-02,153,0,3,224,227,34,47,81,308,15,68,Arizona,Mc Nary,0
1150,2018-2019,2018-10-08,2019-05-24,229,0,18,345,363,129,287,416,779,38,232,Arizona,Mc Nary,0
1151,2019-2020,2019-11-21,2020-04-14,146,0,12,257,269,91,215,306,575,27,148,Arizona,Mc Nary,0
1152,1950-1951,1950-12-01,1951-03-03,93,0,1,91,92,36,19,55,147,10,52,Arizona,Payson,15301
1153,1951-1952,1951-12-01,1952-03-17,108,0,0,136,136,28,11,39,175,12,44,Arizona,Payson,15301
1154,1952-1953,1952-11-16,1953-03-02,107,0,0,197,197,44,35,79,276,8,52,Arizona,Payson,15301
1155,1953-1954,1953-11-18,1954-03-25,128,0,0,226,226,36,14,50,276,7,45,Arizona,Payson,15301
1156,1954-1955,1954-12-01,1955-02-28,90,0,0,233,233,18,19,37,270,5,28,Arizona,Payson,15301
1157,1955-1956,1955-12-01,1956-02-29,91,0,0,172,172,10,7,17,189,1,11,Arizona,Payson,15301
1158,1956-1957,1956-12-01,1957-02-28,90,0,0,110,110,14,8,22,132,4,18,Arizona,Payson,15301
1159,1957-1958,1957-12-01,1958-03-12,102,0,0,154,154,5,2,7,161,3,10,Arizona,Payson,15301
1160,1958-1959,1958-11-16,1959-02-28,105,0,0,188,188,12,8,20,208,3,19,Arizona,Payson,15301
1161,1962-1963,1962-12-01,1963-03-18,108,2,1,166,167,25,0,25,192,6,32,Arizona,Payson,15301
1162,1963-1964,1963-11-21,1964-04-03,135,1,0,286,286,16,0,16,302,4,20,Arizona,Payson,15301
1163,1964-1965,1964-11-15,1965-04-04,141,0,0,191,191,50,31,81,272,10,69,Arizona,Payson,15301
1164,1966-1967,1966-11-09,1967-04-12,155,7,0,226,226,23,3,26,252,7,37,Arizona,Payson,15301
1165,1967-1968,1967-11-29,1968-04-22,146,0,1,192,193,123,293,416,609,15,153,Arizona,Payson,15301
1166,1968-1969,1968-12-01,1969-03-14,104,1,0,193,193,54,52,106,299,12,72,Arizona,Payson,15301
1167,1969-1970,1969-12-01,1970-03-11,101,1,0,161,161,4,3,7,168,1,5,Arizona,Payson,15301
1168,1970-1971,1970-12-01,1971-04-18,139,1,4,223,227,21,26,47,274,6,32,Arizona,Payson,15301
1169,1971-1972,1971-10-29,1972-02-29,124,0,0,222,222,23,30,53,275,5,31,Arizona,Payson,15301
1170,1973-1974,1973-11-19,1974-02-28,102,2,0,178,178,27,12,39,217,8,36,Arizona,Payson,15301
1171,1974-1975,1974-12-01,1975-04-18,139,7,0,232,232,88,35,123,355,20,126,Arizona,Payson,15301
1172,1975-1976,1975-11-28,1976-04-17,142,0,0,199,199,46,36,82,281,8,56,Arizona,Payson,15301
1173,1976-1977,1976-12-01,1977-04-03,124,0,0,226,226,34,24,58,284,9,50,Arizona,Payson,15301
1174,1977-1978,1977-12-01,1978-04-08,129,0,0,113,113,24,6,30,143,7,31,Arizona,Payson,15301
1175,1978-1979,1978-11-15,1979-03-22,128,1,2,209,211,74,91,165,376,16,101,Arizona,Payson,15301
1176,1979-1980,1979-12-01,1980-03-31,122,16,0,126,126,10,0,10,136,3,13,Arizona,Payson,15301
1177,1980-1981,1980-12-01,1981-03-06,96,0,0,115,115,13,7,20,135,3,15,Arizona,Payson,15301
1178,1985-1986,1985-11-13,1986-03-18,126,7,0,126,126,55,39,94,220,10,68,Arizona,Payson,15301
1179,1987-1988,1987-12-01,1988-02-29,91,19,2,131,133,42,47,89,222,5,55,Arizona,Payson,15301
1180,1988-1989,1988-11-26,1989-03-26,121,11,0,232,232,28,11,39,271,7,39,Arizona,Payson,15301
1181,1991-1992,1991-11-30,1992-03-09,101,14,0,109,109,44,51,95,204,6,52,Arizona,Payson,15301
1182,1995-1996,1995-12-01,1996-02-29,91,20,0,111,111,22,14,36,147,4,32,Arizona,Payson,15301
1183,1999-2000,1999-12-01,2000-02-29,91,20,0,126,126,6,7,13,139,1,8,Arizona,Payson,15301
1184,2003-2004,2003-12-01,2004-02-29,91,18,0,130,130,3,0,3,133,1,4,Arizona,Payson,15301
1185,2004-2005,2004-12-01,2005-02-28,90,16,0,73,73,21,10,31,104,5,26,Arizona,Payson,15301
1186,2012-2013,2012-11-11,2013-03-09,119,0,0,195,195,45,23,68,263,11,61,Arizona,Payson,15301
1187,2013-2014,2013-12-01,2014-02-28,90,0,0,135,135,4,0,4,139,2,6,Arizona,Payson,15301
1188,2014-2015,2014-12-01,2015-02-28,90,0,0,98,98,16,21,37,135,2,19,Arizona,Payson,15301
1189,2015-2016,2015-11-16,2016-02-29,106,0,0,168,168,46,34,80,248,13,68,Arizona,Payson,15301
1190,2016-2017,2016-11-28,2017-02-28,93,0,0,91,91,16,5,21,112,4,19,Arizona,Payson,15301
1191,2017-2018,2017-12-01,2018-02-28,90,0,0,126,126,6,4,10,136,3,13,Arizona,Payson,15301
1192,2018-2019,2018-12-01,2019-03-13,103,0,1,138,139,62,63,125,264,8,81,Arizona,Payson,15301
1193,2019-2020,2019-11-29,2020-02-29,93,5,0,124,124,18,7,25,149,6,25,Arizona,Payson,15301
1194,1950-1951,1950-12-01,1951-02-28,90,0,0,3,3,0,0,0,3,0,0,Arizona,Phoenix,1445632
1195,1951-1952,1951-12-01,1952-02-29,91,0,0,9,9,0,0,0,9,0,0,Arizona,Phoenix,1445632
1196,1952-1953,1952-12-01,1953-02-28,90,0,0,1,1,0,0,0,1,0,0,Arizona,Phoenix,1445632
1197,1953-1954,1953-12-01,1954-02-28,90,0,0,17,17,0,0,0,17,0,0,Arizona,Phoenix,1445632
1198,1954-1955,1954-12-01,1955-02-28,90,0,0,20,20,0,0,0,20,0,0,Arizona,Phoenix,1445632
1199,1955-1956,1955-12-01,1956-02-29,91,0,0,4,4,0,0,0,4,0,0,Arizona,Phoenix,1445632
1200,1956-1957,1956-12-01,1957-02-28,90,0,0,3,3,0,0,0,3,0,0,Arizona,Phoenix,1445632
1201,1957-1958,1957-12-01,1958-02-28,90,0,0,2,2,0,0,0,2,0,0,Arizona,Phoenix,1445632
1202,1958-1959,1958-12-01,1959-02-28,90,0,0,2,2,0,0,0,2,0,0,Arizona,Phoenix,1445632
1203,1959-1960,1959-12-01,1960-02-29,91,0,0,10,10,0,0,0,10,0,0,Arizona,Phoenix,1445632
1204,1960-1961,1960-12-01,1961-02-28,90,0,0,10,10,0,0,0,10,0,0,Arizona,Phoenix,1445632
1205,1961-1962,1961-12-01,1962-02-28,90,0,0,9,9,0,0,0,9,0,0,Arizona,Phoenix,1445632
1206,1962-1963,1962-12-01,1963-02-28,90,0,0,14,14,0,0,0,14,0,0,Arizona,Phoenix,1445632
1207,1963-1964,1963-12-01,1964-02-29,91,0,0,42,42,0,0,0,42,0,0,Arizona,Phoenix,1445632
1208,1964-1965,1964-12-01,1965-02-28,90,0,0,7,7,0,0,0,7,0,0,Arizona,Phoenix,1445632
1209,1965-1966,1965-12-01,1966-02-28,90,0,0,18,18,0,0,0,18,0,0,Arizona,Phoenix,1445632
1210,1966-1967,1966-12-01,1967-02-28,90,0,0,23,23,0,0,0,23,0,0,Arizona,Phoenix,1445632
1211,1967-1968,1967-12-01,1968-02-29,91,0,0,10,10,0,0,0,10,0,0,Arizona,Phoenix,1445632
1212,1968-1969,1968-12-01,1969-02-28,90,0,0,13,13,0,0,0,13,0,0,Arizona,Phoenix,1445632
1213,1969-1970,1969-12-01,1970-02-28,90,0,0,11,11,0,0,0,11,0,0,Arizona,Phoenix,1445632
1214,1970-1971,1970-12-01,1971-02-28,90,0,0,15,15,0,0,0,15,0,0,Arizona,Phoenix,1445632
1215,1971-1972,1971-12-01,1972-02-29,91,0,0,16,16,0,0,0,16,0,0,Arizona,Phoenix,1445632
1216,1972-1973,1972-12-01,1973-02-28,90,0,0,5,5,0,0,0,5,0,0,Arizona,Phoenix,1445632
1217,1973-1974,1973-12-01,1974-02-28,90,0,0,2,2,0,0,0,2,0,0,Arizona,Phoenix,1445632
1218,1974-1975,1974-12-01,1975-02-28,90,0,0,11,11,0,0,0,11,0,0,Arizona,Phoenix,1445632
1219,1975-1976,1975-12-01,1976-02-29,91,0,0,4,4,0,0,0,4,0,0,Arizona,Phoenix,1445632
1220,1976-1977,1976-12-01,1977-02-28,90,0,0,4,4,0,0,0,4,0,0,Arizona,Phoenix,1445632
1221,1977-1978,1977-12-01,1978-02-28,90,0,0,0,0,0,0,0,0,0,0,Arizona,Phoenix,1445632
1222,1978-1979,1978-12-01,1979-02-28,90,0,0,7,7,0,0,0,7,0,0,Arizona,Phoenix,1445632
1223,1979-1980,1979-12-01,1980-02-29,91,0,0,0,0,0,0,0,0,0,0,Arizona,Phoenix,1445632
1224,1980-1981,1980-12-01,1981-02-28,90,0,0,0,0,0,0,0,0,0,0,Arizona,Phoenix,1445632
1225,1981-1982,1981-12-01,1982-02-28,90,0,0,0,0,0,0,0,0,0,0,Arizona,Phoenix,1445632
1226,1982-1983,1982-12-01,1983-02-28,90,0,0,0,0,0,0,0,0,0,0,Arizona,Phoenix,1445632
1227,1983-1984,1983-12-01,1984-02-29,91,0,0,0,0,0,0,0,0,0,0,Arizona,Phoenix,1445632
1228,1984-1985,1984-12-01,1985-02-28,90,0,0,3,3,0,0,0,3,0,0,Arizona,Phoenix,1445632
1229,1985-1986,1985-12-01,1986-02-28,90,0,0,0,0,1,0,1,1,1,1,Arizona,Phoenix,1445632
1230,1986-1987,1986-12-01,1987-02-28,90,0,0,3,3,0,0,0,3,0,0,Arizona,Phoenix,1445632
1231,1987-1988,1987-12-01,1988-02-29,91,0,0,2,2,0,0,0,2,0,0,Arizona,Phoenix,1445632
1232,1988-1989,1988-12-01,1989-02-28,90,0,0,4,4,0,0,0,4,0,0,Arizona,Phoenix,1445632
1233,1989-1990,1989-12-01,1990-02-28,90,0,0,2,2,0,0,0,2,0,0,Arizona,Phoenix,1445632
1234,1990-1991,1990-12-01,1991-02-28,90,0,0,2,2,2,0,2,4,2,2,Arizona,Phoenix,1445632
1235,1991-1992,1991-12-01,1992-02-29,91,0,0,0,0,0,0,0,0,0,0,Arizona,Phoenix,1445632
1236,1992-1993,1992-12-01,1993-02-28,90,0,0,0,0,0,0,0,0,0,0,Arizona,Phoenix,1445632
1237,1993-1994,1993-12-01,1994-02-28,90,0,0,0,0,0,0,0,0,0,0,Arizona,Phoenix,1445632
1238,1994-1995,1994-12-01,1995-02-28,90,0,0,0,0,0,0,0,0,0,0,Arizona,Phoenix,1445632
1239,1995-1996,1995-12-01,1996-02-29,91,0,0,0,0,0,0,0,0,0,0,Arizona,Phoenix,1445632
1240,1996-1997,1996-12-01,1997-02-28,90,0,0,0,0,0,0,0,0,0,0,Arizona,Phoenix,1445632
1241,1997-1998,1997-12-01,1998-02-28,90,0,0,0,0,0,0,0,0,0,0,Arizona,Phoenix,1445632
1242,1998-1999,1998-12-01,1999-02-28,90,0,0,1,1,0,0,0,1,0,0,Arizona,Phoenix,1445632
1243,1999-2000,1999-12-01,2000-02-29,91,0,0,1,1,0,0,0,1,0,0,Arizona,Phoenix,1445632
1244,2000-2001,2000-12-01,2001-02-28,90,0,0,0,0,0,0,0,0,0,0,Arizona,Phoenix,1445632
1245,2001-2002,2001-12-01,2002-02-28,90,0,0,0,0,0,0,0,0,0,0,Arizona,Phoenix,1445632
1246,2002-2003,2002-12-01,2003-02-28,90,0,0,0,0,0,0,0,0,0,0,Arizona,Phoenix,1445632
1247,2003-2004,2003-12-01,2004-02-29,91,0,0,2,2,0,0,0,2,0,0,Arizona,Phoenix,1445632
1248,2004-2005,2004-12-01,2005-02-28,90,0,0,0,0,0,0,0,0,0,0,Arizona,Phoenix,1445632
1249,2005-2006,2005-12-01,2006-02-28,90,1,0,0,0,0,0,0,0,0,0,Arizona,Phoenix,1445632
1250,2006-2007,2006-12-01,2007-02-28,90,12,0,2,2,0,0,0,2,0,0,Arizona,Phoenix,1445632
1251,2007-2008,2007-12-01,2008-02-29,91,8,0,0,0,0,0,0,0,0,0,Arizona,Phoenix,1445632
1252,2008-2009,2008-12-01,2009-02-28,90,8,0,0,0,0,0,0,0,0,0,Arizona,Phoenix,1445632
1253,2009-2010,2009-12-01,2010-02-28,90,5,0,0,0,0,0,0,0,0,0,Arizona,Phoenix,1445632
1254,2010-2011,2010-12-01,2011-02-28,90,4,0,5,5,0,0,0,5,0,0,Arizona,Phoenix,1445632
1255,2011-2012,2011-12-01,2012-02-29,91,8,0,0,0,0,0,0,0,0,0,Arizona,Phoenix,1445632
1256,2012-2013,2012-12-01,2013-02-28,90,0,0,4,4,0,0,0,4,0,0,Arizona,Phoenix,1445632
1257,2013-2014,2013-12-01,2014-02-28,90,0,0,0,0,0,0,0,0,0,0,Arizona,Phoenix,1445632
1258,2014-2015,2014-12-01,2015-02-28,90,1,0,1,1,0,0,0,1,0,0,Arizona,Phoenix,1445632
1259,2015-2016,2015-12-01,2016-02-29,91,4,0,0,0,0,0,0,0,0,0,Arizona,Phoenix,1445632
1260,2016-2017,2016-12-01,2017-02-28,90,7,0,0,0,0,0,0,0,0,0,Arizona,Phoenix,1445632
1261,2017-2018,2017-12-01,2018-02-28,90,0,0,0,0,0,0,0,0,0,0,Arizona,Phoenix,1445632
1262,2018-2019,2018-12-01,2019-02-28,90,4,0,1,1,0,0,0,1,0,0,Arizona,Phoenix,1445632
1263,1951-1952,1951-11-24,1952-03-17,115,3,0,220,220,66,36,102,322,14,88,Arizona,Prescott,39843
1264,1952-1953,1952-11-16,1953-03-02,107,0,0,215,215,31,23,54,269,7,39,Arizona,Prescott,39843
1265,1953-1954,1953-12-01,1954-03-25,115,2,0,217,217,40,19,59,276,7,49,Arizona,Prescott,39843
1266,1954-1955,1954-12-01,1955-02-28,90,2,3,228,231,29,39,68,299,8,45,Arizona,Prescott,39843
1267,1955-1956,1955-12-01,1956-02-29,91,1,0,145,145,12,1,13,158,6,22,Arizona,Prescott,39843
1268,1956-1957,1956-12-01,1957-02-28,90,1,1,140,141,12,32,44,185,3,19,Arizona,Prescott,39843
1269,1957-1958,1957-11-16,1958-02-28,105,18,0,186,186,4,0,4,190,2,5,Arizona,Prescott,39843
1270,1958-1959,1958-11-16,1959-02-28,105,19,1,195,196,14,0,14,210,2,16,Arizona,Prescott,39843
1271,1962-1963,1962-12-01,1963-04-17,138,2,2,212,214,17,11,28,242,4,21,Arizona,Prescott,39843
1272,1963-1964,1963-12-01,1964-04-03,125,7,0,300,300,32,23,55,355,6,43,Arizona,Prescott,39843
1273,1964-1965,1964-11-15,1965-04-12,149,5,3,257,260,49,37,86,346,10,65,Arizona,Prescott,39843
1274,1965-1966,1965-12-01,1966-03-03,93,6,1,202,203,39,18,57,260,11,54,Arizona,Prescott,39843
1275,1966-1967,1966-11-09,1967-04-13,156,0,1,284,285,23,17,40,325,8,47,Arizona,Prescott,39843
1276,1967-1968,1967-12-01,1968-04-22,144,6,5,260,265,75,334,409,674,16,108,Arizona,Prescott,39843
1277,1968-1969,1968-11-16,1969-03-14,119,2,3,241,244,56,70,126,370,15,88,Arizona,Prescott,39843
1278,1969-1970,1969-12-01,1970-04-29,150,0,0,226,226,16,5,21,247,9,32,Arizona,Prescott,39843
1279,1970-1971,1970-12-01,1971-04-19,140,0,7,232,239,23,20,43,282,12,47,Arizona,Prescott,39843
1280,1971-1972,1971-10-17,1972-02-29,136,0,1,263,264,22,29,51,315,10,49,Arizona,Prescott,39843
1281,1972-1973,1972-10-31,1973-05-06,188,0,1,294,295,93,75,168,463,35,145,Arizona,Prescott,39843
1282,1973-1974,1973-11-19,1974-03-10,112,0,1,225,226,43,38,81,307,15,71,Arizona,Prescott,39843
1283,1974-1975,1974-10-30,1975-04-18,171,0,1,289,290,41,26,67,357,23,89,Arizona,Prescott,39843
1284,1975-1976,1975-11-28,1976-04-17,142,1,3,228,231,35,46,81,312,11,53,Arizona,Prescott,39843
1285,1976-1977,1976-12-01,1977-04-04,125,0,0,257,257,36,32,68,325,11,57,Arizona,Prescott,39843
1286,1977-1978,1977-12-01,1978-05-01,152,0,0,138,138,42,23,65,203,15,61,Arizona,Prescott,39843
1287,1978-1979,1978-11-12,1979-04-03,143,0,7,283,290,75,113,188,478,23,115,Arizona,Prescott,39843
1288,1979-1980,1979-11-20,1980-04-24,157,0,0,190,190,25,12,37,227,10,36,Arizona,Prescott,39843
1289,1980-1981,1980-10-15,1981-04-03,171,0,0,212,212,29,15,44,256,8,37,Arizona,Prescott,39843
1290,1981-1982,1981-12-01,1982-04-02,123,0,1,190,191,44,39,83,274,13,74,Arizona,Prescott,39843
1291,1982-1983,1982-11-11,1983-02-28,110,0,2,174,176,24,25,49,225,9,45,Arizona,Prescott,39843
1292,1986-1987,1986-12-01,1987-03-24,114,10,4,185,189,67,83,150,339,11,88,Arizona,Prescott,39843
1293,1987-1988,1987-12-01,1988-04-22,144,5,6,204,210,30,70,100,310,8,56,Arizona,Prescott,39843
1294,1988-1989,1988-11-25,1989-02-28,96,12,1,193,194,5,0,5,199,3,11,Arizona,Prescott,39843
1295,1991-1992,1991-11-30,1992-03-09,101,11,1,144,145,20,22,42,187,3,23,Arizona,Prescott,39843
1296,1992-1993,1992-12-01,1993-02-28,90,4,1,128,129,5,0,5,134,3,10,Arizona,Prescott,39843
1297,1993-1994,1993-11-14,1994-04-27,165,20,0,199,199,10,1,11,210,3,14,Arizona,Prescott,39843
1298,1995-1996,1995-12-01,1996-03-13,104,16,1,138,139,4,6,10,149,2,7,Arizona,Prescott,39843
1299,2006-2007,2006-11-30,2007-02-28,91,20,1,142,143,4,0,4,147,3,8,Arizona,Prescott,39843
1300,2007-2008,2007-12-01,2008-02-29,91,11,0,175,175,1,3,4,179,1,2,Arizona,Prescott,39843
1301,2008-2009,2008-12-01,2009-02-28,90,2,0,155,155,0,0,0,155,0,0,Arizona,Prescott,39843
1302,2011-2012,2011-11-05,2012-04-14,162,0,0,247,247,31,25,56,303,12,50,Arizona,Prescott,39843
1303,2012-2013,2012-12-01,2013-03-09,99,0,3,221,224,17,14,31,255,10,37,Arizona,Prescott,39843
1304,2013-2014,2013-12-01,2014-04-03,124,0,0,173,173,2,1,3,176,2,7,Arizona,Prescott,39843
1305,2014-2015,2014-12-01,2015-02-28,90,0,1,109,110,8,4,12,122,3,13,Arizona,Prescott,39843
1306,2015-2016,2015-11-05,2016-04-26,174,0,1,232,233,18,10,28,261,13,38,Arizona,Prescott,39843
1307,2016-2017,2016-12-01,2017-02-28,90,0,0,114,114,18,18,36,150,7,29,Arizona,Prescott,39843
1308,2017-2018,2017-12-01,2018-03-01,91,4,0,147,147,8,2,10,157,5,19,Arizona,Prescott,39843
1309,2018-2019,2018-12-01,2019-03-14,104,0,3,182,185,45,46,91,276,9,71,Arizona,Prescott,39843
1310,2019-2020,2019-11-22,2020-03-19,119,5,1,177,178,21,13,34,212,7,31,Arizona,Prescott,39843
1311,1950-1951,1950-12-01,1951-02-28,90,0,0,12,12,4,0,4,16,2,6,Arizona,Tucson,5652
1312,1951-1952,1951-12-01,1952-03-09,100,0,0,18,18,4,0,4,22,1,4,Arizona,Tucson,5652
1313,1952-1953,1952-12-01,1953-02-28,90,0,0,22,22,1,0,1,23,1,1,Arizona,Tucson,5652
1314,1953-1954,1953-12-01,1954-02-28,90,0,0,21,21,0,0,0,21,0,0,Arizona,Tucson,5652
1315,1954-1955,1954-12-01,1955-02-28,90,0,0,44,44,0,0,0,44,0,0,Arizona,Tucson,5652
1316,1955-1956,1955-12-01,1956-04-02,124,0,0,13,13,4,0,4,17,2,4,Arizona,Tucson,5652
1317,1956-1957,1956-12-01,1957-02-28,90,0,0,6,6,0,0,0,6,0,0,Arizona,Tucson,5652
1318,1957-1958,1957-12-01,1958-02-28,90,0,0,9,9,0,0,0,9,0,0,Arizona,Tucson,5652
1319,1958-1959,1958-11-16,1959-02-28,105,0,0,19,19,9,1,10,29,1,10,Arizona,Tucson,5652
1320,1959-1960,1959-12-01,1960-02-29,91,0,0,33,33,3,0,3,36,2,5,Arizona,Tucson,5652
1321,1960-1961,1960-12-01,1961-02-28,90,0,0,13,13,0,0,0,13,0,0,Arizona,Tucson,5652
1322,1961-1962,1961-12-01,1962-02-28,90,0,0,12,12,0,0,0,12,0,0,Arizona,Tucson,5652
1323,1962-1963,1962-12-01,1963-02-28,90,0,0,14,14,0,0,0,14,0,0,Arizona,Tucson,5652
1324,1963-1964,1963-12-01,1964-04-04,126,1,0,42,42,9,4,13,55,3,10,Arizona,Tucson,5652
1325,1964-1965,1964-11-15,1965-02-28,106,0,0,19,19,6,4,10,29,3,8,Arizona,Tucson,5652
1326,1965-1966,1965-12-01,1966-02-28,90,0,0,22,22,3,0,3,25,2,4,Arizona,Tucson,5652
1327,1966-1967,1966-12-01,1967-02-28,90,0,0,23,23,0,0,0,23,0,0,Arizona,Tucson,5652
1328,1967-1968,1967-12-01,1968-02-29,91,0,0,10,10,2,0,2,12,1,2,Arizona,Tucson,5652
1329,1968-1969,1968-12-01,1969-02-28,90,0,0,17,17,2,0,2,19,2,3,Arizona,Tucson,5652
1330,1969-1970,1969-12-01,1970-02-28,90,0,0,18,18,0,0,0,18,0,0,Arizona,Tucson,5652
1331,1970-1971,1970-12-01,1971-02-28,90,0,0,28,28,0,0,0,28,0,0,Arizona,Tucson,5652
1332,1971-1972,1971-12-01,1972-02-29,91,0,0,24,24,9,7,16,40,1,10,Arizona,Tucson,5652
1333,1972-1973,1972-12-01,1973-02-28,90,0,0,18,18,0,0,0,18,0,0,Arizona,Tucson,5652
1334,1973-1974,1973-12-01,1974-02-28,90,0,0,19,19,1,0,1,20,1,2,Arizona,Tucson,5652
1335,1974-1975,1974-12-01,1975-03-11,101,0,0,28,28,1,0,1,29,1,1,Arizona,Tucson,5652
1336,1975-1976,1975-12-01,1976-04-16,138,0,0,17,17,7,3,10,27,2,7,Arizona,Tucson,5652
1337,1976-1977,1976-12-01,1977-02-28,90,0,0,8,8,0,0,0,8,0,0,Arizona,Tucson,5652
1338,1977-1978,1977-12-01,1978-02-28,90,0,0,5,5,0,0,0,5,0,0,Arizona,Tucson,5652
1339,1978-1979,1978-12-01,1979-02-28,90,0,0,18,18,2,1,3,21,1,3,Arizona,Tucson,5652
1340,1979-1980,1979-12-01,1980-02-29,91,0,0,2,2,0,0,0,2,0,0,Arizona,Tucson,5652
1341,1980-1981,1980-12-01,1981-02-28,90,0,0,3,3,0,0,0,3,0,0,Arizona,Tucson,5652
1342,1981-1982,1981-12-01,1982-02-28,90,0,0,9,9,0,0,0,9,0,0,Arizona,Tucson,5652
1343,1982-1983,1982-12-01,1983-02-28,90,0,0,8,8,0,0,0,8,0,0,Arizona,Tucson,5652
1344,1983-1984,1983-12-01,1984-02-29,91,0,0,10,10,0,0,0,10,0,0,Arizona,Tucson,5652
1345,1984-1985,1984-12-01,1985-02-28,90,0,0,8,8,4,0,4,12,2,5,Arizona,Tucson,5652
1346,1985-1986,1985-12-01,1986-02-28,90,0,0,10,10,0,0,0,10,0,0,Arizona,Tucson,5652
1347,1986-1987,1986-12-01,1987-02-28,90,0,0,14,14,7,1,8,22,2,8,Arizona,Tucson,5652
1348,1987-1988,1987-12-01,1988-02-29,91,0,0,15,15,5,2,7,22,2,7,Arizona,Tucson,5652
1349,1988-1989,1988-12-01,1989-02-28,90,0,0,22,22,0,0,0,22,0,0,Arizona,Tucson,5652
1350,1989-1990,1989-12-01,1990-02-28,90,0,0,21,21,8,0,8,29,5,10,Arizona,Tucson,5652
1351,1990-1991,1990-12-01,1991-03-16,106,0,0,10,10,2,0,2,12,2,3,Arizona,Tucson,5652
1352,1991-1992,1991-12-01,1992-02-29,91,0,0,6,6,0,0,0,6,0,0,Arizona,Tucson,5652
1353,1992-1993,1992-12-01,1993-02-28,90,0,0,6,6,0,0,0,6,0,0,Arizona,Tucson,5652
1354,1993-1994,1993-12-01,1994-02-28,90,0,0,13,13,0,0,0,13,0,0,Arizona,Tucson,5652
1355,1994-1995,1994-12-01,1995-02-28,90,0,0,2,2,0,0,0,2,0,0,Arizona,Tucson,5652
1356,1995-1996,1995-12-01,1996-02-29,91,0,0,5,5,0,0,0,5,0,0,Arizona,Tucson,5652
1357,1996-1997,1996-12-01,1997-02-28,90,0,0,13,13,0,0,0,13,0,0,Arizona,Tucson,5652
1358,1997-1998,1997-12-01,1998-02-28,90,0,0,11,11,0,0,0,11,0,0,Arizona,Tucson,5652
1359,1998-1999,1998-12-01,1999-02-28,90,0,0,19,19,0,0,0,19,0,0,Arizona,Tucson,5652
1360,1999-2000,1999-12-01,2000-02-29,91,0,0,14,14,0,0,0,14,0,0,Arizona,Tucson,5652
1361,2000-2001,2000-12-01,2001-02-28,90,0,0,8,8,0,0,0,8,0,0,Arizona,Tucson,5652
1362,2001-2002,2001-12-01,2002-02-28,90,0,0,22,22,1,0,1,23,1,2,Arizona,Tucson,5652
1363,2002-2003,2002-12-01,2003-02-28,90,0,0,7,7,0,0,0,7,0,0,Arizona,Tucson,5652
1364,2003-2004,2003-12-01,2004-02-29,91,0,0,16,16,0,0,0,16,0,0,Arizona,Tucson,5652
1365,2004-2005,2004-12-01,2005-02-28,90,0,0,6,6,0,0,0,6,0,0,Arizona,Tucson,5652
1366,2005-2006,2005-12-01,2006-02-28,90,0,0,8,8,0,0,0,8,0,0,Arizona,Tucson,5652
1367,2006-2007,2006-12-01,2007-02-28,90,0,0,20,20,0,0,0,20,0,0,Arizona,Tucson,5652
1368,2007-2008,2007-12-01,2008-02-29,91,0,0,18,18,0,0,0,18,0,0,Arizona,Tucson,5652
1369,2008-2009,2008-12-01,2009-02-28,90,0,0,6,6,0,0,0,6,0,0,Arizona,Tucson,5652
1370,2009-2010,2009-12-01,2010-02-28,90,0,0,5,5,0,0,0,5,0,0,Arizona,Tucson,5652
1371,2010-2011,2010-12-01,2011-02-28,90,0,0,20,20,0,0,0,20,0,0,Arizona,Tucson,5652
1372,2011-2012,2011-12-01,2012-02-29,91,0,0,11,11,0,0,0,11,0,0,Arizona,Tucson,5652
1373,2012-2013,2012-12-01,2013-02-28,90,0,0,28,28,3,0,3,31,1,3,Arizona,Tucson,5652
1374,2013-2014,2013-12-01,2014-02-28,90,0,0,2,2,0,0,0,2,0,0,Arizona,Tucson,5652
1375,2014-2015,2014-12-01,2015-02-28,90,0,0,9,9,0,0,0,9,0,0,Arizona,Tucson,5652
1376,2015-2016,2015-12-01,2016-02-29,91,0,0,14,14,0,0,0,14,0,0,Arizona,Tucson,5652
1377,2016-2017,2016-12-01,2017-02-28,90,0,0,6,6,0,0,0,6,0,0,Arizona,Tucson,5652
1378,2017-2018,2017-12-01,2018-02-28,90,0,0,4,4,0,0,0,4,0,0,Arizona,Tucson,5652
1379,2018-2019,2018-12-01,2019-02-28,90,0,0,14,14,3,0,3,17,2,4,Arizona,Tucson,5652
1380,2019-2020,2019-12-01,2020-02-29,91,0,0,8,8,0,0,0,8,0,0,Arizona,Tucson,5652
1381,1950-1951,1950-11-24,1951-03-13,110,0,29,209,238,17,26,43,281,8,54,Arkansas,Fayetteville,73580
1382,1951-1952,1951-11-01,1952-02-29,121,1,10,153,163,15,7,22,185,8,31,Arkansas,Fayetteville,73580
1383,1952-1953,1952-11-28,1953-02-28,93,0,5,121,126,6,5,11,137,4,18,Arkansas,Fayetteville,73580
1384,1953-1954,1953-12-01,1954-03-03,93,0,12,152,164,10,16,26,190,2,24,Arkansas,Fayetteville,73580
1385,1954-1955,1954-12-01,1955-03-26,116,0,3,152,155,15,11,26,181,5,27,Arkansas,Fayetteville,73580
1386,1955-1956,1955-11-28,1956-02-29,94,0,8,151,159,12,14,26,185,5,23,Arkansas,Fayetteville,73580
1387,1956-1957,1956-12-01,1957-04-13,134,0,9,121,130,2,1,3,133,1,4,Arkansas,Fayetteville,73580
1388,1957-1958,1957-12-01,1958-03-13,103,0,14,165,179,13,7,20,199,7,28,Arkansas,Fayetteville,73580
1389,1958-1959,1958-11-28,1959-02-28,93,0,15,186,201,22,27,49,250,6,50,Arkansas,Fayetteville,73580
1390,1960-1961,1960-12-01,1961-02-28,90,0,11,159,170,14,17,31,201,5,30,Arkansas,Fayetteville,73580
1391,1961-1962,1961-12-01,1962-02-28,90,0,18,151,169,5,9,14,183,4,29,Arkansas,Fayetteville,73580
1392,1962-1963,1962-12-01,1963-02-28,90,3,16,210,226,2,0,2,228,2,8,Arkansas,Fayetteville,73580
1393,1963-1964,1963-12-01,1964-03-10,101,0,12,228,240,15,13,28,268,4,30,Arkansas,Fayetteville,73580
1394,1964-1965,1964-11-21,1965-03-26,126,0,15,215,230,19,12,31,261,8,36,Arkansas,Fayetteville,73580
1395,1965-1966,1965-12-01,1966-02-28,90,0,14,161,175,20,15,35,210,7,47,Arkansas,Fayetteville,73580
1396,1966-1967,1966-12-01,1967-03-08,98,0,5,191,196,23,20,43,239,5,45,Arkansas,Fayetteville,73580
1397,1967-1968,1967-12-01,1968-03-14,105,0,11,184,195,25,19,44,239,6,39,Arkansas,Fayetteville,73580
1398,1968-1969,1968-12-01,1969-03-10,100,0,6,158,164,5,7,12,176,3,9,Arkansas,Fayetteville,73580
1399,1969-1970,1969-11-14,1970-03-16,123,0,25,224,249,34,58,92,341,8,66,Arkansas,Fayetteville,73580
1400,1970-1971,1970-11-23,1971-04-06,135,0,14,192,206,9,17,26,232,3,13,Arkansas,Fayetteville,73580
1401,1971-1972,1971-11-22,1972-02-29,100,0,7,121,128,14,4,18,146,7,27,Arkansas,Fayetteville,73580
1402,1972-1973,1972-11-21,1973-02-28,100,1,20,176,196,9,14,23,219,5,28,Arkansas,Fayetteville,73580
1403,1973-1974,1973-12-01,1974-03-21,111,0,15,143,158,9,6,15,173,5,29,Arkansas,Fayetteville,73580
1404,1974-1975,1974-11-30,1975-03-29,120,0,11,136,147,14,16,30,177,4,29,Arkansas,Fayetteville,73580
1405,1975-1976,1975-11-24,1976-02-29,98,0,9,151,160,12,9,21,181,2,17,Arkansas,Fayetteville,73580
1406,1976-1977,1976-11-11,1977-02-28,110,2,20,269,289,33,58,91,380,7,62,Arkansas,Fayetteville,73580
1407,1977-1978,1977-12-01,1978-03-08,98,0,41,231,272,35,58,93,365,11,77,Arkansas,Fayetteville,73580
1408,1978-1979,1978-12-01,1979-02-28,90,0,35,238,273,28,47,75,348,10,59,Arkansas,Fayetteville,73580
1409,1979-1980,1979-11-29,1980-03-01,94,0,13,137,150,12,27,39,189,3,17,Arkansas,Fayetteville,73580
1410,1980-1981,1980-11-17,1981-02-28,104,0,8,179,187,14,3,17,204,4,17,Arkansas,Fayetteville,73580
1411,1981-1982,1981-12-01,1982-02-28,90,10,21,179,200,11,17,28,228,3,23,Arkansas,Fayetteville,73580
1412,1982-1983,1982-12-01,1983-02-28,90,4,4,93,97,3,1,4,101,2,4,Arkansas,Fayetteville,73580
1413,1983-1984,1983-11-28,1984-02-29,94,7,55,221,276,13,30,43,319,5,50,Arkansas,Fayetteville,73580
1414,1984-1985,1984-12-01,1985-02-28,90,14,27,183,210,17,27,44,254,6,41,Arkansas,Fayetteville,73580
1415,1985-1986,1985-12-01,1986-02-28,90,11,14,163,177,11,12,23,200,3,21,Arkansas,Fayetteville,73580
1416,1986-1987,1986-11-13,1987-02-28,108,0,6,103,109,4,1,5,114,2,9,Arkansas,Fayetteville,73580
1417,1987-1988,1987-12-01,1988-03-19,110,9,15,186,201,16,31,47,248,5,33,Arkansas,Fayetteville,73580
1418,1988-1989,1988-12-01,1989-03-10,100,2,19,148,167,20,21,41,208,6,41,Arkansas,Fayetteville,73580
1419,1989-1990,1989-12-01,1990-02-28,90,0,19,153,172,5,4,9,181,2,9,Arkansas,Fayetteville,73580
1420,1990-1991,1990-12-01,1991-02-28,90,2,15,126,141,13,16,29,170,5,31,Arkansas,Fayetteville,73580
1421,1991-1992,1991-11-02,1992-02-29,120,0,1,101,102,7,5,12,114,3,12,Arkansas,Fayetteville,73580
1422,1992-1993,1992-12-01,1993-02-28,90,8,5,112,117,1,17,18,135,1,2,Arkansas,Fayetteville,73580
1423,1993-1994,1993-10-29,1994-03-10,133,5,13,171,184,10,12,22,206,7,27,Arkansas,Fayetteville,73580
1424,1994-1995,1994-12-01,1995-03-03,93,4,4,92,96,10,9,19,115,8,26,Arkansas,Fayetteville,73580
1425,1995-1996,1995-11-10,1996-03-27,139,0,27,214,241,26,38,64,305,11,51,Arkansas,Fayetteville,73580
1426,1996-1997,1996-11-24,1997-02-28,97,0,19,150,169,20,22,42,211,9,45,Arkansas,Fayetteville,73580
1427,2009-2010,2009-12-01,2010-03-21,111,9,18,179,197,49,0,49,246,4,58,Arkansas,Fayetteville,73580
1428,2010-2011,2010-12-01,2011-02-28,90,0,20,192,212,26,46,72,284,4,46,Arkansas,Fayetteville,73580
1429,2011-2012,2011-12-01,2012-02-29,91,0,3,97,100,3,1,4,104,3,7,Arkansas,Fayetteville,73580
1430,2012-2013,2012-12-01,2013-02-28,90,0,3,136,139,4,0,4,143,3,8,Arkansas,Fayetteville,73580
1431,2013-2014,2013-12-01,2014-03-16,106,0,24,240,264,25,38,63,327,7,56,Arkansas,Fayetteville,73580
1432,2014-2015,2014-11-17,2015-03-05,109,0,12,170,182,11,7,18,200,6,38,Arkansas,Fayetteville,73580
1433,2015-2016,2015-12-01,2016-02-29,91,0,2,113,115,0,0,0,115,0,0,Arkansas,Fayetteville,73580
1434,2016-2017,2016-12-01,2017-03-11,101,0,8,121,129,3,1,4,133,3,17,Arkansas,Fayetteville,73580
1435,2017-2018,2017-12-01,2018-02-28,90,0,17,160,177,1,0,1,178,1,2,Arkansas,Fayetteville,73580
1436,2018-2019,2018-11-12,2019-03-04,113,0,4,153,157,5,0,5,162,5,22,Arkansas,Fayetteville,73580
1437,2019-2020,2019-11-11,2020-02-29,111,0,2,95,97,3,0,3,100,3,8,Arkansas,Fayetteville,73580
1438,1950-1951,1950-12-01,1951-02-28,90,0,19,124,143,6,7,13,156,4,32,Arkansas,Fort Smith,86209
1439,1951-1952,1951-11-02,1952-02-29,120,0,2,90,92,8,3,11,103,3,12,Arkansas,Fort Smith,86209
1440,1952-1953,1952-11-28,1953-02-28,93,0,2,78,80,6,6,12,92,3,14,Arkansas,Fort Smith,86209
1441,1953-1954,1953-12-01,1954-02-28,90,0,5,97,102,7,17,24,126,2,14,Arkansas,Fort Smith,86209
1442,1954-1955,1954-12-01,1955-02-28,90,0,1,76,77,7,1,8,85,1,8,Arkansas,Fort Smith,86209
1443,1955-1956,1955-11-30,1956-02-29,92,0,5,88,93,8,7,15,108,5,16,Arkansas,Fort Smith,86209
1444,1956-1957,1956-12-01,1957-02-28,90,0,2,50,52,0,0,0,52,0,0,Arkansas,Fort Smith,86209
1445,1957-1958,1957-12-01,1958-03-12,102,0,5,96,101,11,7,18,119,5,18,Arkansas,Fort Smith,86209
1446,1958-1959,1958-11-28,1959-02-28,93,0,10,118,128,13,14,27,155,7,29,Arkansas,Fort Smith,86209
1447,1959-1960,1959-12-01,1960-03-14,105,0,8,108,116,27,19,46,162,8,42,Arkansas,Fort Smith,86209
1448,1960-1961,1960-12-01,1961-02-28,90,0,7,115,122,12,1,13,135,5,24,Arkansas,Fort Smith,86209
1449,1961-1962,1961-12-01,1962-02-28,90,0,14,109,123,5,13,18,141,3,15,Arkansas,Fort Smith,86209
1450,1962-1963,1962-12-01,1963-02-28,90,0,13,146,159,0,0,0,159,0,0,Arkansas,Fort Smith,86209
1451,1963-1964,1963-12-01,1964-02-29,91,0,6,154,160,8,9,17,177,3,20,Arkansas,Fort Smith,86209
1452,1964-1965,1964-12-01,1965-03-19,109,0,3,123,126,1,0,1,127,1,2,Arkansas,Fort Smith,86209
1453,1965-1966,1965-12-01,1966-02-28,90,0,8,114,122,11,15,26,148,5,23,Arkansas,Fort Smith,86209
1454,1966-1967,1966-12-01,1967-03-07,97,0,2,143,145,9,3,12,157,3,16,Arkansas,Fort Smith,86209
1455,1967-1968,1967-12-01,1968-03-12,103,0,7,105,112,17,2,19,131,8,30,Arkansas,Fort Smith,86209
1456,1968-1969,1968-12-01,1969-02-28,90,0,2,92,94,6,1,7,101,3,6,Arkansas,Fort Smith,86209
1457,1969-1970,1969-12-01,1970-03-12,102,0,13,120,133,12,19,31,164,7,35,Arkansas,Fort Smith,86209
1458,1970-1971,1970-12-01,1971-03-25,115,0,3,111,114,4,1,5,119,3,6,Arkansas,Fort Smith,86209
1459,1971-1972,1971-11-22,1972-02-29,100,0,5,88,93,11,2,13,106,7,21,Arkansas,Fort Smith,86209
1460,1972-1973,1972-11-21,1973-02-28,100,0,9,134,143,10,16,26,169,6,22,Arkansas,Fort Smith,86209
1461,1973-1974,1973-12-01,1974-02-28,90,0,6,100,106,3,4,7,113,2,9,Arkansas,Fort Smith,86209
1462,1974-1975,1974-11-29,1975-03-29,121,0,2,99,101,15,8,23,124,7,23,Arkansas,Fort Smith,86209
1463,1975-1976,1975-11-26,1976-02-29,96,0,4,128,132,13,4,17,149,3,18,Arkansas,Fort Smith,86209
1464,1976-1977,1976-11-13,1977-02-28,108,0,14,203,217,25,52,77,294,8,45,Arkansas,Fort Smith,86209
1465,1977-1978,1977-12-01,1978-03-08,98,0,22,174,196,33,46,79,275,13,64,Arkansas,Fort Smith,86209
1466,1978-1979,1978-12-01,1979-02-28,90,0,27,176,203,26,56,82,285,14,66,Arkansas,Fort Smith,86209
1467,1979-1980,1979-12-01,1980-03-01,92,0,7,105,112,6,3,9,121,5,16,Arkansas,Fort Smith,86209
1468,1980-1981,1980-11-26,1981-02-28,95,0,5,113,118,5,0,5,123,2,6,Arkansas,Fort Smith,86209
1469,1981-1982,1981-12-01,1982-03-06,96,0,11,136,147,19,10,29,176,8,41,Arkansas,Fort Smith,86209
1470,1982-1983,1982-12-01,1983-02-28,90,0,2,66,68,2,1,3,71,2,7,Arkansas,Fort Smith,86209
1471,1983-1984,1983-12-01,1984-03-10,101,0,33,169,202,9,2,11,213,7,30,Arkansas,Fort Smith,86209
1472,1984-1985,1984-12-01,1985-02-28,90,0,16,124,140,26,34,60,200,11,61,Arkansas,Fort Smith,86209
1473,1985-1986,1985-12-01,1986-02-28,90,0,7,132,139,12,3,15,154,6,24,Arkansas,Fort Smith,86209
1474,1986-1987,1986-12-01,1987-03-30,120,0,0,67,67,5,1,6,73,3,7,Arkansas,Fort Smith,86209
1475,1987-1988,1987-12-01,1988-03-17,108,0,9,125,134,22,35,57,191,6,39,Arkansas,Fort Smith,86209
1476,1988-1989,1988-12-01,1989-03-07,97,0,9,102,111,9,5,14,125,6,27,Arkansas,Fort Smith,86209
1477,1989-1990,1989-12-01,1990-02-28,90,0,11,123,134,1,0,1,135,1,3,Arkansas,Fort Smith,86209
1478,1990-1991,1990-12-01,1991-02-28,90,0,9,97,106,7,10,17,123,4,24,Arkansas,Fort Smith,86209
1479,1991-1992,1991-12-01,1992-02-29,91,0,0,47,47,0,0,0,47,0,0,Arkansas,Fort Smith,86209
1480,1992-1993,1992-12-01,1993-02-28,90,0,3,64,67,0,0,0,67,0,0,Arkansas,Fort Smith,86209
1481,1993-1994,1993-11-25,1994-03-09,105,0,5,92,97,8,8,16,113,4,15,Arkansas,Fort Smith,86209
1482,1994-1995,1994-12-01,1995-03-02,92,2,1,68,69,11,2,13,82,7,18,Arkansas,Fort Smith,86209
1483,1995-1996,1995-12-01,1996-03-08,99,1,14,132,146,1,1,2,148,1,2,Arkansas,Fort Smith,86209
1484,1996-1997,1996-12-01,1997-02-28,90,0,9,87,96,4,3,7,103,1,5,Arkansas,Fort Smith,86209
1485,1997-1998,1997-12-01,1998-02-28,90,0,0,39,39,0,0,0,39,0,0,Arkansas,Fort Smith,86209
1486,1998-1999,1998-12-01,1999-03-14,104,0,5,76,81,2,0,2,83,2,6,Arkansas,Fort Smith,86209
1487,1999-2000,1999-12-01,2000-02-29,91,1,3,61,64,14,17,31,95,1,16,Arkansas,Fort Smith,86209
1488,2000-2001,2000-12-01,2001-02-28,90,0,10,116,126,7,3,10,136,3,13,Arkansas,Fort Smith,86209
1489,2001-2002,2001-12-01,2002-03-03,93,12,4,88,92,0,0,0,92,0,0,Arkansas,Fort Smith,86209
1490,2003-2004,2003-12-01,2004-02-29,91,14,3,82,85,0,0,0,85,0,0,Arkansas,Fort Smith,86209
1491,2004-2005,2004-12-01,2005-02-28,90,8,2,62,64,2,2,4,68,1,4,Arkansas,Fort Smith,86209
1492,2005-2006,2005-12-01,2006-02-28,90,16,2,81,83,0,0,0,83,0,0,Arkansas,Fort Smith,86209
1493,2006-2007,2006-12-01,2007-02-28,90,14,5,74,79,3,2,5,84,3,14,Arkansas,Fort Smith,86209
1494,2009-2010,2009-12-01,2010-03-21,111,0,8,112,120,26,18,44,164,5,29,Arkansas,Fort Smith,86209
1495,2010-2011,2010-12-01,2011-02-28,90,0,10,108,118,17,2,19,137,5,31,Arkansas,Fort Smith,86209
1496,2011-2012,2011-12-01,2012-02-29,91,0,0,43,43,3,2,5,48,1,4,Arkansas,Fort Smith,86209
1497,2012-2013,2012-12-01,2013-02-28,90,1,1,63,64,12,8,20,84,2,14,Arkansas,Fort Smith,86209
1498,2013-2014,2013-12-01,2014-03-03,93,0,11,133,144,17,20,37,181,6,34,Arkansas,Fort Smith,86209
1499,2014-2015,2014-12-01,2015-03-05,95,0,4,94,98,11,7,18,116,6,27,Arkansas,Fort Smith,86209
1500,2015-2016,2015-12-01,2016-02-29,91,0,1,57,58,0,0,0,58,0,0,Arkansas,Fort Smith,86209
1501,2016-2017,2016-12-01,2017-02-28,90,0,4,58,62,3,3,6,68,1,10,Arkansas,Fort Smith,86209
1502,2017-2018,2017-12-01,2018-02-28,90,0,9,95,104,0,0,0,104,0,0,Arkansas,Fort Smith,86209
1503,2018-2019,2018-12-01,2019-02-28,90,0,0,45,45,2,0,2,47,1,3,Arkansas,Fort Smith,86209
1504,2019-2020,2019-12-01,2020-02-29,91,0,0,49,49,1,0,1,50,1,2,Arkansas,Fort Smith,86209
1505,1950-1951,1950-12-01,1951-03-12,102,0,14,92,106,9,10,19,125,5,31,Arkansas,Little Rock,193524
1506,1951-1952,1951-11-02,1952-02-29,120,0,2,55,57,2,0,2,59,2,3,Arkansas,Little Rock,193524
1507,1952-1953,1952-11-28,1953-02-28,93,0,0,29,29,2,0,2,31,1,3,Arkansas,Little Rock,193524
1508,1953-1954,1953-12-01,1954-02-28,90,0,3,53,56,6,6,12,68,3,11,Arkansas,Little Rock,193524
1509,1954-1955,1954-12-01,1955-02-28,90,0,1,52,53,3,0,3,56,3,5,Arkansas,Little Rock,193524
1510,1955-1956,1955-12-01,1956-02-29,91,0,3,48,51,6,3,9,60,4,11,Arkansas,Little Rock,193524
1511,1956-1957,1956-12-01,1957-02-28,90,0,1,32,33,0,0,0,33,0,0,Arkansas,Little Rock,193524
1512,1957-1958,1957-11-22,1958-02-28,99,0,3,66,69,7,1,8,77,2,8,Arkansas,Little Rock,193524
1513,1958-1959,1958-11-27,1959-02-28,94,0,7,87,94,8,12,20,114,4,15,Arkansas,Little Rock,193524
1514,1959-1960,1959-12-01,1960-03-25,116,0,3,70,73,36,27,63,136,10,47,Arkansas,Little Rock,193524
1515,1960-1961,1960-12-01,1961-02-28,90,0,6,110,116,9,1,10,126,1,10,Arkansas,Little Rock,193524
1516,1961-1962,1961-12-01,1962-02-28,90,0,11,85,96,9,16,25,121,2,16,Arkansas,Little Rock,193524
1517,1962-1963,1962-12-01,1963-02-28,90,0,10,143,153,6,0,6,159,5,21,Arkansas,Little Rock,193524
1518,1963-1964,1963-12-01,1964-02-29,91,0,5,135,140,13,15,28,168,1,18,Arkansas,Little Rock,193524
1519,1964-1965,1964-12-01,1965-03-20,110,0,5,90,95,10,6,16,111,5,22,Arkansas,Little Rock,193524
1520,1965-1966,1965-12-01,1966-02-28,90,0,7,91,98,33,29,62,160,10,59,Arkansas,Little Rock,193524
1521,1966-1967,1966-12-01,1967-02-28,90,0,3,89,92,3,3,6,98,2,8,Arkansas,Little Rock,193524
1522,1967-1968,1967-12-01,1968-02-29,91,0,12,92,104,11,3,14,118,5,23,Arkansas,Little Rock,193524
1523,1968-1969,1968-12-01,1969-02-28,90,0,1,63,64,3,0,3,67,1,3,Arkansas,Little Rock,193524
1524,1969-1970,1969-12-01,1970-02-28,90,0,10,103,113,7,4,11,124,4,19,Arkansas,Little Rock,193524
1525,1970-1971,1970-12-01,1971-03-25,115,0,5,74,79,12,5,17,96,5,18,Arkansas,Little Rock,193524
1526,1971-1972,1971-11-22,1972-02-29,100,0,3,52,55,10,3,13,68,5,15,Arkansas,Little Rock,193524
1527,1972-1973,1972-12-01,1973-02-28,90,0,9,76,85,5,6,11,96,3,11,Arkansas,Little Rock,193524
1528,1973-1974,1973-12-01,1974-02-28,90,0,5,65,70,1,0,1,71,1,4,Arkansas,Little Rock,193524
1529,1974-1975,1974-12-01,1975-03-14,104,0,1,61,62,6,4,10,72,3,11,Arkansas,Little Rock,193524
1530,1975-1976,1975-11-26,1976-02-29,96,0,4,87,91,3,0,3,94,2,6,Arkansas,Little Rock,193524
1531,1976-1977,1976-11-14,1977-02-28,107,0,8,124,132,7,6,13,145,3,16,Arkansas,Little Rock,193524
1532,1977-1978,1977-12-01,1978-02-28,90,0,16,115,131,21,27,48,179,10,42,Arkansas,Little Rock,193524
1533,1978-1979,1978-12-01,1979-02-28,90,0,15,115,130,16,18,34,164,6,23,Arkansas,Little Rock,193524
1534,1979-1980,1979-12-01,1980-02-29,91,0,6,57,63,2,1,3,66,2,5,Arkansas,Little Rock,193524
1535,1980-1981,1980-11-26,1981-02-28,95,0,6,89,95,2,1,3,98,1,2,Arkansas,Little Rock,193524
1536,1981-1982,1981-12-01,1982-02-28,90,0,13,92,105,16,14,30,135,3,20,Arkansas,Little Rock,193524
1537,1982-1983,1982-12-01,1983-02-28,90,0,0,48,48,0,0,0,48,0,0,Arkansas,Little Rock,193524
1538,1983-1984,1983-12-01,1984-03-10,101,0,31,135,166,14,6,20,186,8,43,Arkansas,Little Rock,193524
1539,1984-1985,1984-12-01,1985-02-28,90,0,14,95,109,17,17,34,143,5,34,Arkansas,Little Rock,193524
1540,1985-1986,1985-12-01,1986-02-28,90,0,4,92,96,2,0,2,98,1,5,Arkansas,Little Rock,193524
1541,1986-1987,1986-11-14,1987-03-30,137,0,1,52,53,3,0,3,56,2,4,Arkansas,Little Rock,193524
1542,1987-1988,1987-12-01,1988-02-29,91,0,11,91,102,22,30,52,154,4,36,Arkansas,Little Rock,193524
1543,1988-1989,1988-12-01,1989-03-05,95,0,5,59,64,5,0,5,69,2,7,Arkansas,Little Rock,193524
1544,1989-1990,1989-12-01,1990-02-28,90,0,11,74,85,0,0,0,85,0,0,Arkansas,Little Rock,193524
1545,1990-1991,1990-12-01,1991-02-28,90,0,6,60,66,0,0,0,66,0,0,Arkansas,Little Rock,193524
1546,1991-1992,1991-12-01,1992-02-29,91,0,0,29,29,0,0,0,29,0,0,Arkansas,Little Rock,193524
1547,1992-1993,1992-12-01,1993-02-28,90,0,0,44,44,0,0,0,44,0,0,Arkansas,Little Rock,193524
1548,1993-1994,1993-12-01,1994-02-28,90,0,4,76,80,2,2,4,84,2,6,Arkansas,Little Rock,193524
1549,1994-1995,1994-12-01,1995-03-03,93,0,1,43,44,12,5,17,61,3,15,Arkansas,Little Rock,193524
1550,1995-1996,1995-11-28,1996-02-29,94,0,9,93,102,3,1,4,106,3,10,Arkansas,Little Rock,193524
1551,1996-1997,1996-12-01,1997-02-28,90,0,6,60,66,6,6,12,78,1,7,Arkansas,Little Rock,193524
1552,1997-1998,1997-12-01,1998-02-28,90,0,0,22,22,0,0,0,22,0,0,Arkansas,Little Rock,193524
1553,1998-1999,1998-12-01,1999-02-28,90,0,5,57,62,0,0,0,62,0,0,Arkansas,Little Rock,193524
1554,1999-2000,1999-12-01,2000-02-29,91,0,2,50,52,11,16,27,79,2,15,Arkansas,Little Rock,193524
1555,2000-2001,2000-12-01,2001-02-28,90,0,12,96,108,1,2,3,111,1,3,Arkansas,Little Rock,193524
1556,2001-2002,2001-12-01,2002-03-03,93,0,1,69,70,6,8,14,84,2,8,Arkansas,Little Rock,193524
1557,2002-2003,2002-12-01,2003-02-28,90,0,4,80,84,9,11,20,104,6,17,Arkansas,Little Rock,193524
1558,2003-2004,2003-12-01,2004-02-29,91,1,1,61,62,3,2,5,67,1,3,Arkansas,Little Rock,193524
1559,2004-2005,2004-12-01,2005-02-28,90,0,2,50,52,4,6,10,62,1,6,Arkansas,Little Rock,193524
1560,2005-2006,2005-12-01,2006-02-28,90,0,1,49,50,2,3,5,55,2,6,Arkansas,Little Rock,193524
1561,2006-2007,2006-12-01,2007-02-28,90,0,3,61,64,4,1,5,69,3,10,Arkansas,Little Rock,193524
1562,2007-2008,2007-12-01,2008-03-08,99,0,1,67,68,5,2,7,75,3,7,Arkansas,Little Rock,193524
1563,2008-2009,2008-12-01,2009-02-28,90,0,4,70,74,1,0,1,75,1,2,Arkansas,Little Rock,193524
1564,2009-2010,2009-12-01,2010-02-28,90,0,5,89,94,12,17,29,123,2,14,Arkansas,Little Rock,193524
1565,2010-2011,2010-12-01,2011-02-28,90,0,8,81,89,20,24,44,133,6,33,Arkansas,Little Rock,193524
1566,2011-2012,2011-12-01,2012-02-29,91,0,0,33,33,4,2,6,39,3,6,Arkansas,Little Rock,193524
1567,2012-2013,2012-12-01,2013-02-28,90,0,1,49,50,16,21,37,87,3,22,Arkansas,Little Rock,193524
1568,2013-2014,2013-12-01,2014-03-17,107,0,10,117,127,13,12,25,152,9,33,Arkansas,Little Rock,193524
1569,2014-2015,2014-11-13,2015-03-07,115,0,4,82,86,17,14,31,117,8,31,Arkansas,Little Rock,193524
1570,2015-2016,2015-12-01,2016-02-29,91,0,0,34,34,8,8,16,50,2,10,Arkansas,Little Rock,193524
1571,2016-2017,2016-12-01,2017-02-28,90,0,3,46,49,1,0,1,50,1,5,Arkansas,Little Rock,193524
1572,2017-2018,2017-12-01,2018-02-28,90,0,9,88,97,3,3,6,103,2,12,Arkansas,Little Rock,193524
1573,2018-2019,2018-11-14,2019-02-28,107,0,0,54,54,1,0,1,55,1,2,Arkansas,Little Rock,193524
1574,2019-2020,2019-12-01,2020-02-29,91,0,0,37,37,0,0,0,37,0,0,Arkansas,Little Rock,193524
1575,1950-1951,1950-12-01,1951-02-28,90,5,12,109,121,6,4,10,131,1,14,Arkansas,Nashville,601222
1576,1951-1952,1951-12-01,1952-02-29,91,3,0,57,57,0,0,0,57,0,0,Arkansas,Nashville,601222
1577,1952-1953,1952-12-01,1953-02-28,90,3,1,63,64,0,0,0,64,0,0,Arkansas,Nashville,601222
1578,1953-1954,1953-12-01,1954-02-28,90,7,2,82,84,1,0,1,85,1,4,Arkansas,Nashville,601222
1579,1954-1955,1954-12-01,1955-02-28,90,0,0,72,72,0,0,0,72,0,0,Arkansas,Nashville,601222
1580,1955-1956,1955-12-01,1956-02-29,91,0,0,78,78,5,7,12,90,2,8,Arkansas,Nashville,601222
1581,1956-1957,1956-12-01,1957-02-28,90,1,2,41,43,0,0,0,43,0,0,Arkansas,Nashville,601222
1582,1957-1958,1957-12-01,1958-02-28,90,2,1,92,93,2,2,4,97,1,3,Arkansas,Nashville,601222
1583,1958-1959,1958-12-01,1959-02-28,90,0,5,109,114,3,4,7,121,1,5,Arkansas,Nashville,601222
1584,1959-1960,1959-12-01,1960-03-06,97,0,5,100,105,17,15,32,137,7,28,Arkansas,Nashville,601222
1585,1960-1961,1960-12-01,1961-02-28,90,0,4,106,110,2,1,3,113,2,7,Arkansas,Nashville,601222
1586,1961-1962,1961-12-01,1962-02-28,90,1,8,95,103,6,15,21,124,2,20,Arkansas,Nashville,601222
1587,1962-1963,1962-12-01,1963-02-28,90,2,11,137,148,0,0,0,148,0,0,Arkansas,Nashville,601222
1588,1963-1964,1963-12-01,1964-02-29,91,0,7,137,144,7,11,18,162,3,19,Arkansas,Nashville,601222
1589,1964-1965,1964-12-01,1965-03-20,110,2,2,116,118,7,5,12,130,3,20,Arkansas,Nashville,601222
1590,1965-1966,1965-12-01,1966-02-28,90,2,5,109,114,16,16,32,146,5,31,Arkansas,Nashville,601222
1591,1966-1967,1966-12-01,1967-02-28,90,0,3,133,136,0,0,0,136,0,0,Arkansas,Nashville,601222
1592,1967-1968,1967-12-01,1968-02-29,91,0,5,84,89,6,3,9,98,4,15,Arkansas,Nashville,601222
1593,1968-1969,1968-12-01,1969-02-28,90,0,0,68,68,0,0,0,68,0,0,Arkansas,Nashville,601222
1594,1969-1970,1969-12-01,1970-02-28,90,0,3,88,91,3,2,5,96,1,5,Arkansas,Nashville,601222
1595,1970-1971,1970-12-01,1971-03-03,93,0,1,77,78,2,2,4,82,2,7,Arkansas,Nashville,601222
1596,1971-1972,1971-11-23,1972-02-29,99,0,2,67,69,1,1,2,71,1,2,Arkansas,Nashville,601222
1597,1972-1973,1972-12-01,1973-02-28,90,0,3,90,93,2,5,7,100,2,6,Arkansas,Nashville,601222
1598,1973-1974,1973-12-01,1974-02-28,90,2,3,70,73,0,0,0,73,0,0,Arkansas,Nashville,601222
1599,1974-1975,1974-12-01,1975-02-28,90,0,1,72,73,3,2,5,78,2,6,Arkansas,Nashville,601222
1600,1975-1976,1975-12-01,1976-02-29,91,0,2,64,66,2,1,3,69,1,3,Arkansas,Nashville,601222
1601,1976-1977,1976-11-14,1977-02-28,107,0,5,116,121,7,6,13,134,3,14,Arkansas,Nashville,601222
1602,1977-1978,1977-12-01,1978-02-28,90,0,4,122,126,15,32,47,173,6,27,Arkansas,Nashville,601222
1603,1978-1979,1978-12-01,1979-02-28,90,0,6,116,122,11,13,24,146,5,20,Arkansas,Nashville,601222
1604,1979-1980,1979-12-01,1980-04-13,135,10,4,80,84,7,8,15,99,2,11,Arkansas,Nashville,601222
1605,1980-1981,1980-11-27,1981-02-28,94,0,3,83,86,2,1,3,89,2,3,Arkansas,Nashville,601222
1606,1981-1982,1981-12-01,1982-02-28,90,16,8,94,102,6,13,19,121,3,11,Arkansas,Nashville,601222
1607,1982-1983,1982-12-01,1983-02-28,90,14,0,50,50,2,2,4,54,1,3,Arkansas,Nashville,601222
1608,1984-1985,1984-12-01,1985-02-28,90,17,10,95,105,14,20,34,139,4,32,Arkansas,Nashville,601222
1609,1985-1986,1985-12-01,1986-02-28,90,1,3,84,87,0,0,0,87,0,0,Arkansas,Nashville,601222
1610,1986-1987,1986-12-01,1987-03-30,120,19,0,44,44,3,0,3,47,1,4,Arkansas,Nashville,601222
1611,1987-1988,1987-12-01,1988-02-29,91,2,5,90,95,11,24,35,130,3,20,Arkansas,Nashville,601222
1612,1988-1989,1988-12-01,1989-03-06,96,1,7,72,79,0,0,0,79,0,0,Arkansas,Nashville,601222
1613,1989-1990,1989-12-01,1990-02-28,90,0,10,86,96,1,0,1,97,1,2,Arkansas,Nashville,601222
1614,1990-1991,1990-12-01,1991-02-28,90,1,5,67,72,2,2,4,76,2,12,Arkansas,Nashville,601222
1615,1991-1992,1991-12-01,1992-02-29,91,2,0,37,37,4,7,11,48,1,5,Arkansas,Nashville,601222
1616,1992-1993,1992-12-01,1993-02-28,90,6,0,39,39,0,0,0,39,0,0,Arkansas,Nashville,601222
1617,1993-1994,1993-12-01,1994-02-28,90,2,2,71,73,1,0,1,74,1,3,Arkansas,Nashville,601222
1618,1994-1995,1994-12-01,1995-02-28,90,1,2,50,52,5,7,12,64,2,10,Arkansas,Nashville,601222
1619,1995-1996,1995-12-01,1996-02-29,91,1,5,124,129,3,3,6,135,1,6,Arkansas,Nashville,601222
1620,1996-1997,1996-12-01,1997-02-28,90,0,5,78,83,2,1,3,86,1,3,Arkansas,Nashville,601222
1621,1997-1998,1997-12-01,1998-02-28,90,1,0,50,50,0,0,0,50,0,0,Arkansas,Nashville,601222
1622,1998-1999,1998-12-01,1999-02-28,90,0,4,68,72,0,0,0,72,0,0,Arkansas,Nashville,601222
1623,1999-2000,1999-12-01,2000-02-29,91,0,2,80,82,20,33,53,135,2,24,Arkansas,Nashville,601222
1624,2000-2001,2000-12-01,2001-02-28,90,6,4,100,104,6,13,19,123,3,12,Arkansas,Nashville,601222
1625,2001-2002,2001-12-01,2002-02-28,90,0,0,93,93,7,7,14,107,1,8,Arkansas,Nashville,601222
1626,2002-2003,2002-12-01,2003-02-28,90,9,1,85,86,5,2,7,93,3,6,Arkansas,Nashville,601222
1627,2003-2004,2003-12-01,2004-02-29,91,4,0,82,82,4,4,8,90,1,5,Arkansas,Nashville,601222
1628,2004-2005,2004-12-01,2005-02-28,90,0,0,68,68,2,1,3,71,1,5,Arkansas,Nashville,601222
1629,2005-2006,2005-12-01,2006-02-28,90,0,2,101,103,1,0,1,104,1,1,Arkansas,Nashville,601222
1630,2006-2007,2006-12-01,2007-02-28,90,6,2,87,89,2,1,3,92,1,3,Arkansas,Nashville,601222
1631,2007-2008,2007-12-01,2008-03-04,95,2,0,80,80,2,1,3,83,1,3,Arkansas,Nashville,601222
1632,2008-2009,2008-12-01,2009-02-28,90,14,0,61,61,0,0,0,61,0,0,Arkansas,Nashville,601222
1633,2009-2010,2009-12-01,2010-03-21,111,0,1,99,100,3,1,4,104,3,5,Arkansas,Nashville,601222
1634,2010-2011,2010-12-01,2011-02-28,90,0,5,96,101,18,21,39,140,4,30,Arkansas,Nashville,601222
1635,2011-2012,2011-12-01,2012-02-29,91,3,0,49,49,3,2,5,54,1,5,Arkansas,Nashville,601222
1636,2012-2013,2012-12-01,2013-02-28,90,0,0,58,58,9,4,13,71,1,10,Arkansas,Nashville,601222
1637,2013-2014,2013-12-01,2014-03-04,94,1,3,107,110,2,2,4,114,1,3,Arkansas,Nashville,601222
1638,2014-2015,2014-12-01,2015-03-05,95,6,2,69,71,11,5,16,87,3,15,Arkansas,Nashville,601222
1639,2015-2016,2015-12-01,2016-02-29,91,1,0,60,60,0,0,0,60,0,0,Arkansas,Nashville,601222
1640,2016-2017,2016-12-01,2017-02-28,90,0,1,48,49,2,1,3,52,1,8,Arkansas,Nashville,601222
1641,2017-2018,2017-12-01,2018-02-28,90,0,5,76,81,3,2,5,86,1,5,Arkansas,Nashville,601222
1642,2018-2019,2018-12-01,2019-02-28,90,0,0,44,44,0,0,0,44,0,0,Arkansas,Nashville,601222
1643,2019-2020,2019-12-01,2020-02-29,91,0,0,47,47,0,0,0,47,0,0,Arkansas,Nashville,601222
1644,1950-1951,1950-11-24,1951-03-14,111,0,14,168,182,19,18,37,219,10,60,Arkansas,Pocahontas,6608
1645,1951-1952,1951-11-02,1952-02-29,120,1,1,123,124,9,4,13,137,2,11,Arkansas,Pocahontas,6608
1646,1952-1953,1952-11-29,1953-02-28,92,0,0,98,98,2,1,3,101,1,4,Arkansas,Pocahontas,6608
1647,1953-1954,1953-11-07,1954-02-28,114,1,2,119,121,6,2,8,129,3,11,Arkansas,Pocahontas,6608
1648,1954-1955,1954-12-01,1955-02-28,90,2,2,104,106,6,0,6,112,2,8,Arkansas,Pocahontas,6608
1649,1955-1956,1955-12-01,1956-02-29,91,6,3,107,110,7,0,7,117,1,8,Arkansas,Pocahontas,6608
1650,1956-1957,1956-12-01,1957-02-28,90,0,4,71,75,1,0,1,76,1,3,Arkansas,Pocahontas,6608
1651,1957-1958,1957-12-01,1958-03-17,107,10,5,156,161,7,0,7,168,1,8,Arkansas,Pocahontas,6608
1652,1958-1959,1958-12-01,1959-02-28,90,0,8,135,143,7,5,12,155,1,12,Arkansas,Pocahontas,6608
1653,1960-1961,1960-12-01,1961-02-28,90,14,6,143,149,9,0,9,158,3,18,Arkansas,Pocahontas,6608
1654,1961-1962,1961-12-01,1962-03-01,91,17,10,112,122,0,0,0,122,0,0,Arkansas,Pocahontas,6608
1655,1962-1963,1962-12-01,1963-02-28,90,18,12,213,225,0,4,4,229,0,0,Arkansas,Pocahontas,6608
1656,1963-1964,1963-12-01,1964-02-29,91,5,13,165,178,8,8,16,194,2,15,Arkansas,Pocahontas,6608
1657,1964-1965,1964-12-01,1965-03-05,95,1,9,129,138,15,0,15,153,4,24,Arkansas,Pocahontas,6608
1658,1965-1966,1965-12-01,1966-02-28,90,13,12,116,128,18,0,18,146,5,35,Arkansas,Pocahontas,6608
1659,1966-1967,1966-12-01,1967-03-06,96,5,7,138,145,28,4,32,177,5,39,Arkansas,Pocahontas,6608
1660,1967-1968,1967-12-01,1968-02-29,91,0,11,127,138,12,5,17,155,6,29,Arkansas,Pocahontas,6608
1661,1968-1969,1968-12-01,1969-02-28,90,0,4,114,118,3,0,3,121,1,4,Arkansas,Pocahontas,6608
1662,1970-1971,1970-12-01,1971-02-28,90,0,8,121,129,4,0,4,133,2,6,Arkansas,Pocahontas,6608
1663,1971-1972,1971-11-23,1972-02-29,99,0,5,91,96,3,2,5,101,1,4,Arkansas,Pocahontas,6608
1664,1972-1973,1972-12-01,1973-02-28,90,0,13,111,124,10,24,34,158,3,17,Arkansas,Pocahontas,6608
1665,1973-1974,1973-12-01,1974-02-28,90,0,12,98,110,6,8,14,124,3,14,Arkansas,Pocahontas,6608
1666,1974-1975,1974-12-01,1975-03-14,104,0,0,98,98,7,0,7,105,2,10,Arkansas,Pocahontas,6608
1667,1975-1976,1975-11-26,1976-02-29,96,0,5,109,114,10,10,20,134,5,18,Arkansas,Pocahontas,6608
1668,1976-1977,1976-11-11,1977-02-28,110,0,25,232,257,37,105,142,399,9,75,Arkansas,Pocahontas,6608
1669,1977-1978,1977-12-01,1978-03-04,94,2,28,189,217,36,105,141,358,13,69,Arkansas,Pocahontas,6608
1670,1978-1979,1978-12-01,1979-03-01,91,2,20,179,199,39,85,124,323,16,72,Arkansas,Pocahontas,6608
1671,1979-1980,1979-12-01,1980-03-01,92,4,10,119,129,27,40,67,196,7,43,Arkansas,Pocahontas,6608
1672,1980-1981,1980-11-26,1981-02-28,95,5,7,132,139,10,8,18,157,3,13,Arkansas,Pocahontas,6608
1673,1987-1988,1987-12-01,1988-02-29,91,14,12,118,130,11,0,11,141,2,25,Arkansas,Pocahontas,6608
1674,1988-1989,1988-12-01,1989-03-06,96,7,9,105,114,10,0,10,124,3,16,Arkansas,Pocahontas,6608
1675,1989-1990,1989-12-01,1990-03-01,91,10,18,112,130,4,0,4,134,1,5,Arkansas,Pocahontas,6608
1676,1990-1991,1990-12-01,1991-02-28,90,7,13,89,102,9,0,9,111,2,15,Arkansas,Pocahontas,6608
1677,1991-1992,1991-12-01,1992-02-29,91,1,1,54,55,0,0,0,55,0,0,Arkansas,Pocahontas,6608
1678,1992-1993,1992-12-01,1993-02-28,90,18,3,86,89,19,0,19,108,3,24,Arkansas,Pocahontas,6608
1679,1994-1995,1994-12-01,1995-02-28,90,4,3,79,82,0,0,0,82,0,0,Arkansas,Pocahontas,6608
1680,1996-1997,1996-12-01,1997-02-28,90,16,22,97,119,20,11,31,150,4,25,Arkansas,Pocahontas,6608
1681,1997-1998,1997-12-01,1998-03-13,103,3,2,93,95,4,0,4,99,2,6,Arkansas,Pocahontas,6608
1682,1998-1999,1998-12-01,1999-02-28,90,2,19,109,128,0,0,0,128,0,0,Arkansas,Pocahontas,6608
1683,1999-2000,1999-12-01,2000-02-29,91,5,3,93,96,9,12,21,117,2,15,Arkansas,Pocahontas,6608
1684,2000-2001,2000-12-01,2001-02-28,90,18,21,159,180,12,17,29,209,9,43,Arkansas,Pocahontas,6608
1685,2001-2002,2001-12-01,2002-03-04,94,3,4,100,104,4,3,7,111,2,6,Arkansas,Pocahontas,6608
1686,2002-2003,2002-12-01,2003-02-28,90,6,14,137,151,28,33,61,212,11,58,Arkansas,Pocahontas,6608
1687,2003-2004,2003-12-01,2004-02-29,91,0,7,126,133,3,8,11,144,1,5,Arkansas,Pocahontas,6608
1688,2004-2005,2004-12-01,2005-02-28,90,2,9,96,105,6,13,19,124,2,13,Arkansas,Pocahontas,6608
1689,2005-2006,2005-12-01,2006-02-28,90,7,8,106,114,7,11,18,132,3,17,Arkansas,Pocahontas,6608
1690,2006-2007,2006-12-01,2007-02-28,90,1,10,117,127,3,5,8,135,1,9,Arkansas,Pocahontas,6608
1691,2007-2008,2007-12-01,2008-03-08,99,3,9,131,140,12,6,18,158,3,16,Arkansas,Pocahontas,6608
1692,2008-2009,2008-12-01,2009-03-03,93,4,12,139,151,8,10,18,169,2,12,Arkansas,Pocahontas,6608
1693,2009-2010,2009-12-01,2010-02-28,90,0,16,162,178,28,52,80,258,5,44,Arkansas,Pocahontas,6608
1694,2010-2011,2010-12-01,2011-02-28,90,6,16,144,160,21,26,47,207,6,40,Arkansas,Pocahontas,6608
1695,2011-2012,2011-11-29,2012-02-29,93,12,1,76,77,10,4,14,91,3,13,Arkansas,Pocahontas,6608
1696,2012-2013,2012-12-01,2013-03-23,113,9,9,122,131,26,43,69,200,4,34,Arkansas,Pocahontas,6608
1697,2013-2014,2013-11-25,2014-03-09,105,11,33,224,257,16,56,72,329,3,27,Arkansas,Pocahontas,6608
1698,2014-2015,2014-11-17,2015-03-08,112,6,18,176,194,18,34,52,246,5,33,Arkansas,Pocahontas,6608
1699,2015-2016,2015-12-01,2016-02-29,91,0,6,91,97,11,19,30,127,2,17,Arkansas,Pocahontas,6608
1700,2016-2017,2016-12-01,2017-03-13,103,0,5,101,106,6,3,9,115,2,8,Arkansas,Pocahontas,6608
1701,2017-2018,2017-12-01,2018-04-07,128,0,16,164,180,3,2,5,185,2,9,Arkansas,Pocahontas,6608
1702,2018-2019,2018-11-15,2019-03-05,111,0,4,138,142,9,13,22,164,2,15,Arkansas,Pocahontas,6608
1703,2019-2020,2019-11-12,2020-02-29,110,2,3,112,115,2,1,3,118,1,6,Arkansas,Pocahontas,6608
1704,1950-1951,1950-12-01,1951-02-28,90,0,0,8,8,0,0,0,8,0,0,California,Bakersfield,347483
1705,1951-1952,1951-12-01,1952-02-29,91,0,0,18,18,0,0,0,18,0,0,California,Bakersfield,347483
1706,1952-1953,1952-12-01,1953-02-28,90,0,0,6,6,0,0,0,6,0,0,California,Bakersfield,347483
1707,1953-1954,1953-12-01,1954-02-28,90,0,0,11,11,0,0,0,11,0,0,California,Bakersfield,347483
1708,1954-1955,1954-12-01,1955-02-28,90,0,0,19,19,0,0,0,19,0,0,California,Bakersfield,347483
1709,1955-1956,1955-12-01,1956-02-29,91,0,0,7,7,0,0,0,7,0,0,California,Bakersfield,347483
1710,1956-1957,1956-12-01,1957-02-28,90,0,0,24,24,0,0,0,24,0,0,California,Bakersfield,347483
1711,1957-1958,1957-12-01,1958-02-28,90,0,0,4,4,0,0,0,4,0,0,California,Bakersfield,347483
1712,1958-1959,1958-12-01,1959-02-28,90,0,0,3,3,0,0,0,3,0,0,California,Bakersfield,347483
1713,1959-1960,1959-12-01,1960-02-29,91,0,0,13,13,0,0,0,13,0,0,California,Bakersfield,347483
1714,1960-1961,1960-12-01,1961-02-28,90,0,0,22,22,0,0,0,22,0,0,California,Bakersfield,347483
1715,1961-1962,1961-12-01,1962-02-28,90,0,0,27,27,0,0,0,27,0,0,California,Bakersfield,347483
1716,1962-1963,1962-12-01,1963-02-28,90,0,0,32,32,0,0,0,32,0,0,California,Bakersfield,347483
1717,1963-1964,1963-12-01,1964-02-29,91,0,0,18,18,0,0,0,18,0,0,California,Bakersfield,347483
1718,1964-1965,1964-12-01,1965-02-28,90,0,0,11,11,0,0,0,11,0,0,California,Bakersfield,347483
1719,1965-1966,1965-12-01,1966-02-28,90,0,0,16,16,0,0,0,16,0,0,California,Bakersfield,347483
1720,1966-1967,1966-12-01,1967-02-28,90,0,0,14,14,0,0,0,14,0,0,California,Bakersfield,347483
1721,1967-1968,1967-12-01,1968-02-29,91,0,0,4,4,0,0,0,4,0,0,California,Bakersfield,347483
1722,1968-1969,1968-12-01,1969-02-28,90,0,0,8,8,0,0,0,8,0,0,California,Bakersfield,347483
1723,1969-1970,1969-12-01,1970-02-28,90,0,0,9,9,0,0,0,9,0,0,California,Bakersfield,347483
1724,1970-1971,1970-12-01,1971-02-28,90,0,0,9,9,0,0,0,9,0,0,California,Bakersfield,347483
1725,1971-1972,1971-12-01,1972-02-29,91,0,0,22,22,0,0,0,22,0,0,California,Bakersfield,347483
1726,1972-1973,1972-12-01,1973-02-28,90,0,0,16,16,0,0,0,16,0,0,California,Bakersfield,347483
1727,1973-1974,1973-12-01,1974-03-08,98,0,0,3,3,2,0,2,5,1,2,California,Bakersfield,347483
1728,1974-1975,1974-12-01,1975-02-28,90,0,0,11,11,0,0,0,11,0,0,California,Bakersfield,347483
1729,1975-1976,1975-12-01,1976-02-29,91,0,0,7,7,0,0,0,7,0,0,California,Bakersfield,347483
1730,1976-1977,1976-12-01,1977-02-28,90,0,0,3,3,0,0,0,3,0,0,California,Bakersfield,347483
1731,1977-1978,1977-12-01,1978-02-28,90,0,0,1,1,0,0,0,1,0,0,California,Bakersfield,347483
1732,1978-1979,1978-12-01,1979-02-28,90,0,0,7,7,0,0,0,7,0,0,California,Bakersfield,347483
1733,1979-1980,1979-12-01,1980-02-29,91,0,0,0,0,0,0,0,0,0,0,California,Bakersfield,347483
1734,1980-1981,1980-12-01,1981-02-28,90,0,0,7,7,0,0,0,7,0,0,California,Bakersfield,347483
1735,1981-1982,1981-12-01,1982-02-28,90,0,0,4,4,0,0,0,4,0,0,California,Bakersfield,347483
1736,1982-1983,1982-12-01,1983-02-28,90,0,0,14,14,0,0,0,14,0,0,California,Bakersfield,347483
1737,1983-1984,1983-12-01,1984-02-29,91,0,0,2,2,0,0,0,2,0,0,California,Bakersfield,347483
1738,1984-1985,1984-12-01,1985-02-28,90,0,0,16,16,0,0,0,16,0,0,California,Bakersfield,347483
1739,1985-1986,1985-12-01,1986-02-28,90,0,0,7,7,0,0,0,7,0,0,California,Bakersfield,347483
1740,1986-1987,1986-12-01,1987-02-28,90,0,0,11,11,0,0,0,11,0,0,California,Bakersfield,347483
1741,1987-1988,1987-12-01,1988-02-29,91,0,0,19,19,0,0,0,19,0,0,California,Bakersfield,347483
1742,1988-1989,1988-12-01,1989-02-28,90,0,0,25,25,0,0,0,25,0,0,California,Bakersfield,347483
1743,1989-1990,1989-12-01,1990-02-28,90,0,0,31,31,0,0,0,31,0,0,California,Bakersfield,347483
1744,1990-1991,1990-12-01,1991-02-28,90,0,0,26,26,0,0,0,26,0,0,California,Bakersfield,347483
1745,1991-1992,1991-12-01,1992-02-29,91,0,0,13,13,0,0,0,13,0,0,California,Bakersfield,347483
1746,1992-1993,1992-12-01,1993-02-28,90,0,0,12,12,0,0,0,12,0,0,California,Bakersfield,347483
1747,1993-1994,1993-12-01,1994-02-28,90,0,0,4,4,0,0,0,4,0,0,California,Bakersfield,347483
1748,1994-1995,1994-12-01,1995-02-28,90,0,0,5,5,0,0,0,5,0,0,California,Bakersfield,347483
1749,1995-1996,1995-12-01,1996-02-29,91,0,0,2,2,0,0,0,2,0,0,California,Bakersfield,347483
1750,1996-1997,1996-12-01,1997-02-28,90,0,0,4,4,0,0,0,4,0,0,California,Bakersfield,347483
1751,1997-1998,1997-12-01,1998-02-28,90,0,0,13,13,0,0,0,13,0,0,California,Bakersfield,347483
1752,1998-1999,1998-12-01,1999-02-28,90,0,0,37,37,4,3,7,44,1,5,California,Bakersfield,347483
1753,1999-2000,1999-12-01,2000-02-29,91,0,0,10,10,0,0,0,10,0,0,California,Bakersfield,347483
1754,2000-2001,2000-12-01,2001-02-28,90,0,0,13,13,0,0,0,13,0,0,California,Bakersfield,347483
1755,2001-2002,2001-12-01,2002-02-28,90,0,0,15,15,0,0,0,15,0,0,California,Bakersfield,347483
1756,2002-2003,2002-12-01,2003-02-28,90,0,0,2,2,0,0,0,2,0,0,California,Bakersfield,347483
1757,2003-2004,2003-12-01,2004-02-29,91,0,0,2,2,0,0,0,2,0,0,California,Bakersfield,347483
1758,2004-2005,2004-12-01,2005-02-28,90,0,0,13,13,0,0,0,13,0,0,California,Bakersfield,347483
1759,2005-2006,2005-12-01,2006-02-28,90,0,0,2,2,0,0,0,2,0,0,California,Bakersfield,347483
1760,2006-2007,2006-12-01,2007-02-28,90,0,0,31,31,0,0,0,31,0,0,California,Bakersfield,347483
1761,2007-2008,2007-12-01,2008-02-29,91,0,0,12,12,0,0,0,12,0,0,California,Bakersfield,347483
1762,2008-2009,2008-12-01,2009-02-28,90,0,0,4,4,0,0,0,4,0,0,California,Bakersfield,347483
1763,2009-2010,2009-12-01,2010-02-28,90,0,0,3,3,0,0,0,3,0,0,California,Bakersfield,347483
1764,2010-2011,2010-12-01,2011-02-28,90,0,0,5,5,0,0,0,5,0,0,California,Bakersfield,347483
1765,2011-2012,2011-12-01,2012-02-29,91,0,0,22,22,0,0,0,22,0,0,California,Bakersfield,347483
1766,2012-2013,2012-12-01,2013-02-28,90,0,0,19,19,0,0,0,19,0,0,California,Bakersfield,347483
1767,2013-2014,2013-12-01,2014-02-28,90,0,0,8,8,0,0,0,8,0,0,California,Bakersfield,347483
1768,2014-2015,2014-12-01,2015-02-28,90,0,0,4,4,0,0,0,4,0,0,California,Bakersfield,347483
1769,2015-2016,2015-12-01,2016-02-29,91,0,0,7,7,0,0,0,7,0,0,California,Bakersfield,347483
1770,2016-2017,2016-12-01,2017-02-28,90,0,0,3,3,0,0,0,3,0,0,California,Bakersfield,347483
1771,2017-2018,2017-12-01,2018-02-28,90,0,0,5,5,0,0,0,5,0,0,California,Bakersfield,347483
1772,2018-2019,2018-12-01,2019-02-28,90,0,0,7,7,0,0,0,7,0,0,California,Bakersfield,347483
1773,2019-2020,2019-12-01,2020-02-29,91,0,0,3,3,0,0,0,3,0,0,California,Bakersfield,347483
1774,1950-1951,1950-12-01,1951-02-28,90,0,0,135,135,3,4,7,142,1,6,California,Bishop,3879
1775,1951-1952,1951-12-01,1952-03-17,108,0,1,224,225,47,70,117,342,11,68,California,Bishop,3879
1776,1952-1953,1952-12-01,1953-02-28,90,0,0,155,155,2,0,2,157,1,4,California,Bishop,3879
1777,1953-1954,1953-12-01,1954-02-28,90,0,0,179,179,0,0,0,179,0,0,California,Bishop,3879
1778,1954-1955,1954-12-01,1955-02-28,90,0,0,273,273,32,86,118,391,5,47,California,Bishop,3879
1779,1955-1956,1955-12-01,1956-04-13,135,0,0,231,231,18,5,23,254,4,22,California,Bishop,3879
1780,1956-1957,1956-12-01,1957-02-28,90,0,1,185,186,0,0,0,186,0,0,California,Bishop,3879
1781,1957-1958,1957-10-20,1958-04-03,166,0,0,225,225,5,2,7,232,4,9,California,Bishop,3879
1782,1958-1959,1958-12-01,1959-02-28,90,0,0,152,152,6,2,8,160,4,13,California,Bishop,3879
1783,1959-1960,1959-12-01,1960-02-29,91,0,0,197,197,2,1,3,200,2,8,California,Bishop,3879
1784,1960-1961,1960-12-01,1961-02-28,90,0,0,163,163,0,0,0,163,0,0,California,Bishop,3879
1785,1961-1962,1961-12-01,1962-03-09,99,0,4,175,179,5,1,6,185,5,23,California,Bishop,3879
1786,1962-1963,1962-12-01,1963-03-17,107,0,0,204,204,4,2,6,210,3,9,California,Bishop,3879
1787,1963-1964,1963-12-01,1964-05-05,157,0,0,250,250,11,17,28,278,4,18,California,Bishop,3879
1788,1964-1965,1964-11-16,1965-04-09,145,0,0,203,203,10,6,16,219,6,22,California,Bishop,3879
1789,1965-1966,1965-12-01,1966-02-28,90,0,0,190,190,0,0,0,190,0,0,California,Bishop,3879
1790,1966-1967,1966-12-01,1967-04-22,143,0,0,163,163,16,19,35,198,6,22,California,Bishop,3879
1791,1967-1968,1967-12-01,1968-02-29,91,0,3,185,188,19,34,53,241,4,36,California,Bishop,3879
1792,1968-1969,1968-12-01,1969-03-18,108,0,1,284,285,82,280,362,647,15,119,California,Bishop,3879
1793,1969-1970,1969-12-01,1970-03-30,120,0,0,180,180,7,1,8,188,2,9,California,Bishop,3879
1794,1970-1971,1970-12-01,1971-04-17,138,0,0,206,206,6,1,7,213,5,12,California,Bishop,3879
1795,1971-1972,1971-12-01,1972-02-29,91,0,0,204,204,2,3,5,209,1,3,California,Bishop,3879
1796,1972-1973,1972-12-01,1973-03-11,101,0,2,195,197,11,16,27,224,5,19,California,Bishop,3879
1797,1973-1974,1973-12-01,1974-03-03,93,0,8,182,190,22,81,103,293,7,40,California,Bishop,3879
1798,1974-1975,1974-12-01,1975-02-28,90,0,0,170,170,0,0,0,170,0,0,California,Bishop,3879
1799,1975-1976,1975-11-28,1976-03-02,96,0,1,187,188,31,33,64,252,5,44,California,Bishop,3879
1800,1976-1977,1976-12-01,1977-03-30,120,0,0,212,212,5,0,5,217,3,11,California,Bishop,3879
1801,1977-1978,1977-12-01,1978-02-28,90,0,0,91,91,11,5,16,107,8,21,California,Bishop,3879
1802,1978-1979,1978-10-30,1979-03-19,141,0,3,236,239,16,14,30,269,9,36,California,Bishop,3879
1803,1979-1980,1979-12-01,1980-05-11,163,1,0,197,197,11,0,11,208,4,15,California,Bishop,3879
1804,1980-1981,1980-12-01,1981-04-02,123,0,0,163,163,14,12,26,189,4,19,California,Bishop,3879
1805,1981-1982,1981-11-27,1982-03-29,123,0,4,199,203,39,58,97,300,7,52,California,Bishop,3879
1806,1982-1983,1982-11-09,1983-03-24,136,0,0,183,183,17,5,22,205,5,25,California,Bishop,3879
1807,1983-1984,1983-11-24,1984-02-29,98,0,0,149,149,2,0,2,151,1,4,California,Bishop,3879
1808,1984-1985,1984-11-27,1985-03-07,101,0,1,216,217,15,57,72,289,7,40,California,Bishop,3879
1809,1985-1986,1985-11-11,1986-02-28,110,0,0,188,188,3,2,5,193,2,5,California,Bishop,3879
1810,1986-1987,1986-12-01,1987-02-28,90,0,2,186,188,3,1,4,192,3,9,California,Bishop,3879
1811,1987-1988,1987-12-01,1988-05-05,157,0,2,225,227,23,13,36,263,8,40,California,Bishop,3879
1812,1988-1989,1988-12-01,1989-02-28,90,10,5,218,223,1,25,26,249,1,3,California,Bishop,3879
1813,1989-1990,1989-12-01,1990-02-28,90,0,1,186,187,1,0,1,188,1,2,California,Bishop,3879
1814,1990-1991,1990-12-01,1991-03-19,109,1,3,257,260,1,0,1,261,1,2,California,Bishop,3879
1815,1991-1992,1991-12-01,1992-02-29,91,5,0,140,140,3,1,4,144,3,7,California,Bishop,3879
1816,1992-1993,1992-12-01,1993-02-28,90,2,0,198,198,37,51,88,286,10,59,California,Bishop,3879
1817,1993-1994,1993-12-01,1994-03-25,115,8,0,224,224,3,0,3,227,3,7,California,Bishop,3879
1818,1994-1995,1994-12-01,1995-02-28,90,0,0,142,142,20,27,47,189,2,21,California,Bishop,3879
1819,1995-1996,1995-12-01,1996-02-29,91,6,0,130,130,0,0,0,130,0,0,California,Bishop,3879
1820,1996-1997,1996-12-01,1997-02-28,90,0,1,123,124,2,1,3,127,1,3,California,Bishop,3879
1821,1998-1999,1998-12-01,1999-04-07,128,3,1,221,222,19,12,31,253,4,24,California,Bishop,3879
1822,1999-2000,1999-12-01,2000-02-29,91,1,0,157,157,0,0,0,157,0,0,California,Bishop,3879
1823,2000-2001,2000-12-01,2001-02-28,90,0,0,187,187,17,25,42,229,3,24,California,Bishop,3879
1824,2001-2002,2001-11-29,2002-02-28,92,0,0,185,185,4,2,6,191,1,8,California,Bishop,3879
1825,2002-2003,2002-12-01,2003-02-28,90,0,0,126,126,1,0,1,127,1,2,California,Bishop,3879
1826,2003-2004,2003-12-01,2004-02-29,91,0,0,174,174,0,0,0,174,0,0,California,Bishop,3879
1827,2006-2007,2006-12-01,2007-02-28,90,3,1,195,196,2,0,2,198,1,3,California,Bishop,3879
1828,2010-2011,2010-12-01,2011-04-09,130,0,1,158,159,5,2,7,166,4,11,California,Bishop,3879
1829,2011-2012,2011-12-01,2012-02-29,91,0,0,205,205,7,5,12,217,2,10,California,Bishop,3879
1830,2012-2013,2012-12-01,2013-02-28,90,0,0,195,195,4,12,16,211,2,10,California,Bishop,3879
1831,2013-2014,2013-12-01,2014-04-01,122,0,0,180,180,2,0,2,182,2,6,California,Bishop,3879
1832,2014-2015,2014-12-01,2015-02-28,90,0,0,104,104,0,0,0,104,0,0,California,Bishop,3879
1833,2015-2016,2015-12-01,2016-02-29,91,0,0,170,170,3,2,5,175,1,4,California,Bishop,3879
1834,2016-2017,2016-12-01,2017-02-28,90,1,0,128,128,12,5,17,145,4,15,California,Bishop,3879
1835,2017-2018,2017-12-01,2018-02-28,90,0,0,162,162,1,0,1,163,1,4,California,Bishop,3879
1836,2018-2019,2018-12-01,2019-02-28,90,0,0,136,136,2,0,2,138,2,3,California,Bishop,3879
1837,2019-2020,2019-11-27,2020-02-29,95,0,3,165,168,10,8,18,186,3,19,California,Bishop,3879
1838,1955-1956,1955-11-14,1956-05-07,176,4,1,166,167,269,410,679,846,38,327,California,Cherry Valley Dam,0
1839,1956-1957,1956-10-24,1957-05-19,208,1,3,128,131,119,221,340,471,20,156,California,Cherry Valley Dam,0
1840,1957-1958,1957-12-01,1958-04-13,134,0,0,105,105,209,296,505,610,37,248,California,Cherry Valley Dam,0
1841,1958-1959,1958-11-15,1959-05-02,169,1,2,102,104,104,169,273,377,16,130,California,Cherry Valley Dam,0
1842,1959-1960,1959-12-01,1960-04-29,151,3,0,175,175,140,224,364,539,23,186,California,Cherry Valley Dam,0
1843,1960-1961,1960-11-13,1961-05-12,181,10,0,200,200,99,107,206,406,21,138,California,Cherry Valley Dam,0
1844,1962-1963,1962-12-01,1963-04-26,147,14,0,116,116,124,100,224,340,17,147,California,Cherry Valley Dam,0
1845,1964-1965,1964-11-10,1965-04-17,159,14,2,163,165,213,496,709,874,26,251,California,Cherry Valley Dam,0
1846,1965-1966,1965-11-26,1966-03-04,99,0,2,165,167,135,437,572,739,24,189,California,Cherry Valley Dam,0
1847,1966-1967,1966-12-01,1967-06-01,183,19,0,174,174,326,468,794,968,34,379,California,Cherry Valley Dam,0
1848,1967-1968,1967-11-28,1968-05-14,169,18,6,147,153,178,329,507,660,24,221,California,Cherry Valley Dam,0
1849,1973-1974,1973-11-16,1974-04-27,163,11,3,151,154,191,265,456,610,29,241,California,Cherry Valley Dam,0
1850,1976-1977,1976-12-01,1977-05-12,163,14,0,110,110,41,106,147,257,13,63,California,Cherry Valley Dam,0
1851,1979-1980,1979-12-01,1980-05-11,163,8,0,94,94,78,155,233,327,16,96,California,Cherry Valley Dam,0
1852,1980-1981,1980-12-01,1981-04-19,140,8,1,79,80,89,210,299,379,15,106,California,Cherry Valley Dam,0
1853,1981-1982,1981-10-29,1982-04-10,164,6,4,151,155,259,752,1011,1166,34,323,California,Cherry Valley Dam,0
1854,1982-1983,1982-11-08,1983-05-05,179,17,1,152,153,232,567,799,952,44,286,California,Cherry Valley Dam,0
1855,1983-1984,1983-11-13,1984-04-19,159,16,1,110,111,78,111,189,300,16,99,California,Cherry Valley Dam,0
1856,1985-1986,1985-10-20,1986-03-18,150,19,0,93,93,80,118,198,291,18,102,California,Cherry Valley Dam,0
1857,1986-1987,1986-11-28,1987-03-24,117,6,1,115,116,71,157,228,344,16,97,California,Cherry Valley Dam,0
1858,1988-1989,1988-11-14,1989-04-25,163,18,15,192,207,190,717,907,1114,31,268,California,Cherry Valley Dam,0
1859,1989-1990,1989-11-26,1990-03-15,110,15,4,124,128,142,368,510,638,18,182,California,Cherry Valley Dam,0
1860,1990-1991,1990-11-26,1991-05-18,174,4,9,175,184,193,413,606,790,20,241,California,Cherry Valley Dam,0
1861,1991-1992,1991-12-01,1992-03-16,107,11,1,64,65,92,263,355,420,15,110,California,Cherry Valley Dam,0
1862,1992-1993,1992-12-01,1993-03-28,118,13,6,124,130,186,865,1051,1181,29,231,California,Cherry Valley Dam,0
1863,1993-1994,1993-11-12,1994-04-27,167,9,2,113,115,136,395,531,646,18,163,California,Cherry Valley Dam,0
1864,1994-1995,1994-11-10,1995-05-13,185,12,3,128,131,244,731,975,1106,34,285,California,Cherry Valley Dam,0
1865,1995-1996,1995-12-01,1996-03-29,120,3,4,76,80,113,316,429,509,21,156,California,Cherry Valley Dam,0
1866,1997-1998,1997-11-16,1998-05-29,195,6,0,136,136,235,574,809,945,42,286,California,Cherry Valley Dam,0
1867,1998-1999,1998-11-07,1999-06-03,209,9,5,130,135,208,301,509,644,28,255,California,Cherry Valley Dam,0
1868,1999-2000,1999-12-01,2000-04-18,140,4,1,71,72,104,215,319,391,18,125,California,Cherry Valley Dam,0
1869,2000-2001,2000-10-29,2001-04-23,177,15,2,125,127,181,587,768,895,24,217,California,Cherry Valley Dam,0
1870,2001-2002,2001-11-25,2002-05-21,178,2,2,128,130,159,518,677,807,32,205,California,Cherry Valley Dam,0
1871,2002-2003,2002-12-01,2003-05-09,160,6,0,81,81,138,332,470,551,20,163,California,Cherry Valley Dam,0
1872,2003-2004,2003-11-01,2004-04-17,169,1,2,114,116,149,603,752,868,28,182,California,Cherry Valley Dam,0
1873,2004-2005,2004-10-21,2005-04-10,172,3,0,92,92,192,527,719,811,32,228,California,Cherry Valley Dam,0
1874,2005-2006,2005-12-01,2006-04-17,138,16,4,120,124,170,400,570,694,31,223,California,Cherry Valley Dam,0
1875,2006-2007,2006-11-27,2007-05-04,159,12,3,103,106,107,194,301,407,20,132,California,Cherry Valley Dam,0
1876,2007-2008,2007-12-01,2008-03-26,117,4,2,105,107,168,937,1105,1212,26,208,California,Cherry Valley Dam,0
1877,2008-2009,2008-12-01,2009-04-10,131,9,8,111,119,195,554,749,868,28,243,California,Cherry Valley Dam,0
1878,2014-2015,2014-12-01,2015-04-25,146,0,0,36,36,24,19,43,79,5,29,California,Cherry Valley Dam,0
1879,2016-2017,2016-11-27,2017-03-08,102,16,1,78,79,131,411,542,621,19,159,California,Cherry Valley Dam,0
1880,2017-2018,2017-11-27,2018-04-16,141,12,0,82,82,121,243,364,446,19,153,California,Cherry Valley Dam,0
1881,2018-2019,2018-11-30,2019-05-27,179,0,6,121,127,218,554,772,899,27,267,California,Cherry Valley Dam,0
1882,2019-2020,2019-11-27,2020-04-08,134,2,1,90,91,112,150,262,353,20,138,California,Cherry Valley Dam,0
1883,1950-1951,1950-12-01,1951-02-28,90,0,0,5,5,0,0,0,5,0,0,California,Death Valley,0
1884,1951-1952,1951-12-01,1952-02-29,91,0,0,15,15,0,0,0,15,0,0,California,Death Valley,0
1885,1952-1953,1952-12-01,1953-02-28,90,0,0,2,2,0,0,0,2,0,0,California,Death Valley,0
1886,1953-1954,1953-12-01,1954-02-28,90,0,0,12,12,0,0,0,12,0,0,California,Death Valley,0
1887,1954-1955,1954-12-01,1955-02-28,90,2,0,11,11,0,0,0,11,0,0,California,Death Valley,0
1888,1955-1956,1955-12-01,1956-02-29,91,1,0,9,9,0,0,0,9,0,0,California,Death Valley,0
1889,1956-1957,1956-12-01,1957-02-28,90,4,0,11,11,0,0,0,11,0,0,California,Death Valley,0
1890,1958-1959,1958-12-01,1959-02-28,90,0,0,2,2,0,0,0,2,0,0,California,Death Valley,0
1891,1959-1960,1959-12-01,1960-02-29,91,0,0,5,5,0,0,0,5,0,0,California,Death Valley,0
1892,1960-1961,1960-12-01,1961-02-28,90,0,0,9,9,0,0,0,9,0,0,California,Death Valley,0
1893,1961-1962,1961-12-01,1962-02-28,90,0,0,13,13,0,0,0,13,0,0,California,Death Valley,0
1894,1962-1963,1962-12-01,1963-02-28,90,0,0,22,22,0,0,0,22,0,0,California,Death Valley,0
1895,1963-1964,1963-12-01,1964-02-29,91,0,0,15,15,0,0,0,15,0,0,California,Death Valley,0
1896,1964-1965,1964-12-01,1965-02-28,90,0,0,11,11,0,0,0,11,0,0,California,Death Valley,0
1897,1965-1966,1965-12-01,1966-02-28,90,4,0,16,16,0,0,0,16,0,0,California,Death Valley,0
1898,1966-1967,1966-12-01,1967-02-28,90,2,0,8,8,0,0,0,8,0,0,California,Death Valley,0
1899,1967-1968,1967-12-01,1968-02-29,91,0,0,15,15,0,0,0,15,0,0,California,Death Valley,0
1900,1968-1969,1968-12-01,1969-02-28,90,0,0,18,18,0,0,0,18,0,0,California,Death Valley,0
1901,1969-1970,1969-12-01,1970-02-28,90,1,0,7,7,0,0,0,7,0,0,California,Death Valley,0
1902,1970-1971,1970-12-01,1971-02-28,90,0,0,5,5,0,0,0,5,0,0,California,Death Valley,0
1903,1971-1972,1971-12-01,1972-02-29,91,0,0,18,18,0,0,0,18,0,0,California,Death Valley,0
1904,1972-1973,1972-12-01,1973-02-28,90,1,0,21,21,0,0,0,21,0,0,California,Death Valley,0
1905,1973-1974,1973-12-01,1974-02-28,90,0,0,4,4,0,0,0,4,0,0,California,Death Valley,0
1906,1974-1975,1974-12-01,1975-02-28,90,0,0,4,4,0,0,0,4,0,0,California,Death Valley,0
1907,1975-1976,1975-12-01,1976-02-29,91,0,0,5,5,0,0,0,5,0,0,California,Death Valley,0
1908,1976-1977,1976-12-01,1977-02-28,90,0,0,16,16,0,0,0,16,0,0,California,Death Valley,0
1909,1977-1978,1977-12-01,1978-02-28,90,0,0,0,0,0,0,0,0,0,0,California,Death Valley,0
1910,1978-1979,1978-12-01,1979-02-28,90,0,0,9,9,0,0,0,9,0,0,California,Death Valley,0
1911,1979-1980,1979-12-01,1980-02-29,91,1,0,3,3,0,0,0,3,0,0,California,Death Valley,0
1912,1980-1981,1980-12-01,1981-02-28,90,0,0,1,1,0,0,0,1,0,0,California,Death Valley,0
1913,1981-1982,1981-12-01,1982-02-28,90,0,0,4,4,0,0,0,4,0,0,California,Death Valley,0
1914,1982-1983,1982-12-01,1983-02-28,90,2,0,15,15,0,0,0,15,0,0,California,Death Valley,0
1915,1983-1984,1983-12-01,1984-02-29,91,0,0,2,2,0,0,0,2,0,0,California,Death Valley,0
1916,1984-1985,1984-12-01,1985-02-28,90,0,0,14,14,0,0,0,14,0,0,California,Death Valley,0
1917,1985-1986,1985-12-01,1986-02-28,90,5,0,6,6,0,0,0,6,0,0,California,Death Valley,0
1918,1986-1987,1986-12-01,1987-02-28,90,2,0,1,1,0,0,0,1,0,0,California,Death Valley,0
1919,1988-1989,1988-12-01,1989-02-28,90,0,0,20,20,0,0,0,20,0,0,California,Death Valley,0
1920,1989-1990,1989-12-01,1990-02-28,90,0,0,25,25,0,0,0,25,0,0,California,Death Valley,0
1921,1990-1991,1990-12-01,1991-02-28,90,2,0,39,39,0,0,0,39,0,0,California,Death Valley,0
1922,1991-1992,1991-12-01,1992-02-29,91,0,0,6,6,0,0,0,6,0,0,California,Death Valley,0
1923,1992-1993,1992-12-01,1993-02-28,90,0,0,14,14,0,0,0,14,0,0,California,Death Valley,0
1924,1993-1994,1993-12-01,1994-02-28,90,0,0,12,12,0,0,0,12,0,0,California,Death Valley,0
1925,1994-1995,1994-12-01,1995-02-28,90,0,0,14,14,0,0,0,14,0,0,California,Death Valley,0
1926,1995-1996,1995-12-01,1996-02-29,91,0,0,6,6,0,0,0,6,0,0,California,Death Valley,0
1927,1996-1997,1996-12-01,1997-02-28,90,0,0,18,18,0,0,0,18,0,0,California,Death Valley,0
1928,1997-1998,1997-12-01,1998-02-28,90,0,0,13,13,0,0,0,13,0,0,California,Death Valley,0
1929,1998-1999,1998-12-01,1999-02-28,90,0,0,13,13,0,0,0,13,0,0,California,Death Valley,0
1930,1999-2000,1999-12-01,2000-02-29,91,0,0,15,15,0,0,0,15,0,0,California,Death Valley,0
1931,2000-2001,2000-12-01,2001-02-28,90,0,0,14,14,0,0,0,14,0,0,California,Death Valley,0
1932,2001-2002,2001-12-01,2002-02-28,90,3,0,13,13,0,0,0,13,0,0,California,Death Valley,0
1933,2002-2003,2002-12-01,2003-02-28,90,0,0,1,1,0,0,0,1,0,0,California,Death Valley,0
1934,2003-2004,2003-12-01,2004-02-29,91,0,0,4,4,0,0,0,4,0,0,California,Death Valley,0
1935,2004-2005,2004-12-01,2005-02-28,90,0,0,2,2,0,0,0,2,0,0,California,Death Valley,0
1936,2005-2006,2005-12-01,2006-02-28,90,0,0,4,4,0,0,0,4,0,0,California,Death Valley,0
1937,2006-2007,2006-12-01,2007-02-28,90,0,0,12,12,0,0,0,12,0,0,California,Death Valley,0
1938,2007-2008,2007-12-01,2008-02-29,91,0,0,6,6,0,0,0,6,0,0,California,Death Valley,0
1939,2008-2009,2008-12-01,2009-02-28,90,1,0,7,7,0,0,0,7,0,0,California,Death Valley,0
1940,2009-2010,2009-12-01,2010-02-28,90,0,0,11,11,0,0,0,11,0,0,California,Death Valley,0
1941,2010-2011,2010-12-01,2011-02-28,90,0,0,4,4,0,0,0,4,0,0,California,Death Valley,0
1942,2011-2012,2011-12-01,2012-02-29,91,0,0,8,8,0,0,0,8,0,0,California,Death Valley,0
1943,2012-2013,2012-12-01,2013-02-28,90,0,0,5,5,0,0,0,5,0,0,California,Death Valley,0
1944,2013-2014,2013-12-01,2014-02-28,90,0,0,8,8,0,0,0,8,0,0,California,Death Valley,0
1945,2014-2015,2014-12-01,2015-02-28,90,0,0,5,5,0,0,0,5,0,0,California,Death Valley,0
1946,2015-2016,2015-12-01,2016-02-29,91,0,0,10,10,0,0,0,10,0,0,California,Death Valley,0
1947,2016-2017,2016-12-01,2017-02-28,90,0,0,4,4,0,0,0,4,0,0,California,Death Valley,0
1948,2017-2018,2017-12-01,2018-02-28,90,0,0,0,0,0,0,0,0,0,0,California,Death Valley,0
1949,2018-2019,2018-12-01,2019-02-28,90,0,0,2,2,0,0,0,2,0,0,California,Death Valley,0
1950,2019-2020,2019-12-01,2020-02-29,91,0,0,1,1,0,0,0,1,0,0,California,Death Valley,0
1951,1950-1951,1950-12-01,1951-02-28,90,0,0,2,2,0,0,0,2,0,0,California,Eureka,27191
1952,1951-1952,1951-12-01,1952-02-29,91,0,0,5,5,3,0,3,8,2,3,California,Eureka,27191
1953,1952-1953,1952-12-01,1953-02-28,90,0,0,0,0,0,0,0,0,0,0,California,Eureka,27191
1954,1953-1954,1953-12-01,1954-02-28,90,0,0,1,1,0,0,0,1,0,0,California,Eureka,27191
1955,1954-1955,1954-12-01,1955-02-28,90,0,0,7,7,1,0,1,8,1,1,California,Eureka,27191
1956,1955-1956,1955-12-01,1956-02-29,91,0,0,6,6,0,0,0,6,0,0,California,Eureka,27191
1957,1956-1957,1956-12-01,1957-02-28,90,0,0,9,9,0,0,0,9,0,0,California,Eureka,27191
1958,1957-1958,1957-12-01,1958-02-28,90,0,0,0,0,0,0,0,0,0,0,California,Eureka,27191
1959,1958-1959,1958-12-01,1959-02-28,90,0,0,0,0,0,0,0,0,0,0,California,Eureka,27191
1960,1959-1960,1959-12-01,1960-02-29,91,0,0,6,6,0,0,0,6,0,0,California,Eureka,27191
1961,1960-1961,1960-12-01,1961-02-28,90,0,0,0,0,0,0,0,0,0,0,California,Eureka,27191
1962,1961-1962,1961-12-01,1962-02-28,90,0,0,7,7,1,0,1,8,1,2,California,Eureka,27191
1963,1962-1963,1962-12-01,1963-02-28,90,0,0,3,3,0,0,0,3,0,0,California,Eureka,27191
1964,1963-1964,1963-12-01,1964-02-29,91,0,0,0,0,0,0,0,0,0,0,California,Eureka,27191
1965,1964-1965,1964-12-01,1965-02-28,90,0,0,3,3,1,0,1,4,1,2,California,Eureka,27191
1966,1965-1966,1965-12-01,1966-03-02,92,0,0,6,6,2,1,3,9,2,3,California,Eureka,27191
1967,1966-1967,1966-12-01,1967-02-28,90,0,0,2,2,0,0,0,2,0,0,California,Eureka,27191
1968,1967-1968,1967-12-01,1968-02-29,91,0,0,5,5,0,0,0,5,0,0,California,Eureka,27191
1969,1968-1969,1968-12-01,1969-02-28,90,0,0,5,5,1,0,1,6,1,1,California,Eureka,27191
1970,1969-1970,1969-12-01,1970-02-28,90,0,0,0,0,0,0,0,0,0,0,California,Eureka,27191
1971,1970-1971,1970-12-01,1971-02-28,90,0,0,5,5,0,0,0,5,0,0,California,Eureka,27191
1972,1971-1972,1971-12-01,1972-02-29,91,0,0,8,8,2,0,2,10,2,4,California,Eureka,27191
1973,1972-1973,1972-12-01,1973-02-28,90,0,0,11,11,2,0,2,13,1,3,California,Eureka,27191
1974,1973-1974,1973-12-01,1974-02-28,90,0,0,5,5,0,0,0,5,0,0,California,Eureka,27191
1975,1974-1975,1974-12-01,1975-02-28,90,0,0,9,9,0,0,0,9,0,0,California,Eureka,27191
1976,1975-1976,1975-12-01,1976-03-01,92,0,0,6,6,1,0,1,7,1,2,California,Eureka,27191
1977,1976-1977,1976-12-01,1977-02-28,90,0,0,1,1,0,0,0,1,0,0,California,Eureka,27191
1978,1977-1978,1977-11-19,1978-02-28,102,0,0,2,2,1,0,1,3,1,2,California,Eureka,27191
1979,1978-1979,1978-12-01,1979-02-28,90,0,0,16,16,0,0,0,16,0,0,California,Eureka,27191
1980,1979-1980,1979-12-01,1980-02-29,91,0,0,3,3,0,0,0,3,0,0,California,Eureka,27191
1981,1980-1981,1980-12-01,1981-02-28,90,0,0,1,1,0,0,0,1,0,0,California,Eureka,27191
1982,1981-1982,1981-12-01,1982-02-28,90,0,0,4,4,0,0,0,4,0,0,California,Eureka,27191
1983,1982-1983,1982-12-01,1983-02-28,90,0,0,1,1,0,0,0,1,0,0,California,Eureka,27191
1984,1983-1984,1983-12-01,1984-02-29,91,0,0,3,3,2,0,2,5,1,3,California,Eureka,27191
1985,1984-1985,1984-12-01,1985-02-28,90,0,0,2,2,0,0,0,2,0,0,California,Eureka,27191
1986,1985-1986,1985-12-01,1986-02-28,90,0,0,1,1,0,0,0,1,0,0,California,Eureka,27191
1987,1986-1987,1986-12-01,1987-02-28,90,0,0,2,2,0,0,0,2,0,0,California,Eureka,27191
1988,1987-1988,1987-12-01,1988-02-29,91,0,0,2,2,0,0,0,2,0,0,California,Eureka,27191
1989,1988-1989,1988-12-01,1989-02-28,90,0,0,8,8,5,1,6,14,2,7,California,Eureka,27191
1990,1989-1990,1989-12-01,1990-02-28,90,0,0,4,4,2,0,2,6,1,2,California,Eureka,27191
1991,1990-1991,1990-12-01,1991-02-28,90,0,0,13,13,0,0,0,13,0,0,California,Eureka,27191
1992,1991-1992,1991-12-01,1992-02-29,91,0,0,1,1,0,0,0,1,0,0,California,Eureka,27191
1993,1992-1993,1992-12-01,1993-02-28,90,0,0,2,2,0,0,0,2,0,0,California,Eureka,27191
1994,1993-1994,1993-12-01,1994-02-28,90,0,0,0,0,0,0,0,0,0,0,California,Eureka,27191
1995,1994-1995,1994-12-01,1995-02-28,90,0,0,6,6,0,0,0,6,0,0,California,Eureka,27191
1996,1995-1996,1995-12-01,1996-02-29,91,0,0,2,2,0,0,0,2,0,0,California,Eureka,27191
1997,1996-1997,1996-12-01,1997-02-28,90,0,0,6,6,0,0,0,6,0,0,California,Eureka,27191
1998,1997-1998,1997-12-01,1998-02-28,90,0,0,4,4,0,0,0,4,0,0,California,Eureka,27191
1999,1998-1999,1998-12-01,1999-03-30,120,0,0,17,17,1,0,1,18,1,1,California,Eureka,27191
2000,1999-2000,1999-12-01,2000-02-29,91,0,0,0,0,0,0,0,0,0,0,California,Eureka,27191
2001,2000-2001,2000-12-01,2001-02-28,90,0,0,10,10,0,0,0,10,0,0,California,Eureka,27191
2002,2001-2002,2001-12-01,2002-02-28,90,0,0,7,7,2,0,2,9,2,2,California,Eureka,27191
2003,2002-2003,2002-12-01,2003-04-02,123,0,0,2,2,1,0,1,3,1,1,California,Eureka,27191
2004,2003-2004,2003-12-01,2004-02-29,91,0,0,2,2,0,0,0,2,0,0,California,Eureka,27191
2005,2004-2005,2004-12-01,2005-02-28,90,0,0,3,3,0,0,0,3,0,0,California,Eureka,27191
2006,2005-2006,2005-12-01,2006-02-28,90,0,0,8,8,0,0,0,8,0,0,California,Eureka,27191
2007,2006-2007,2006-12-01,2007-02-28,90,0,0,12,12,0,0,0,12,0,0,California,Eureka,27191
2008,2007-2008,2007-12-01,2008-02-29,91,0,0,14,14,0,0,0,14,0,0,California,Eureka,27191
2009,2008-2009,2008-12-01,2009-02-28,90,0,0,5,5,0,0,0,5,0,0,California,Eureka,27191
2010,2009-2010,2009-12-01,2010-02-28,90,0,0,6,6,0,0,0,6,0,0,California,Eureka,27191
2011,2010-2011,2010-12-01,2011-02-28,90,0,0,7,7,0,0,0,7,0,0,California,Eureka,27191
2012,2011-2012,2011-12-01,2012-02-29,91,0,0,7,7,0,0,0,7,0,0,California,Eureka,27191
2013,2012-2013,2012-12-01,2013-02-28,90,0,0,18,18,0,0,0,18,0,0,California,Eureka,27191
2014,2013-2014,2013-12-01,2014-02-28,90,0,0,13,13,0,0,0,13,0,0,California,Eureka,27191
2015,2014-2015,2014-12-01,2015-02-28,90,0,0,3,3,0,0,0,3,0,0,California,Eureka,27191
2016,2015-2016,2015-12-01,2016-02-29,91,0,0,5,5,0,0,0,5,0,0,California,Eureka,27191
2017,2016-2017,2016-12-01,2017-02-28,90,0,0,9,9,0,0,0,9,0,0,California,Eureka,27191
2018,2017-2018,2017-12-01,2018-02-28,90,0,0,6,6,0,0,0,6,0,0,California,Eureka,27191
2019,2018-2019,2018-12-01,2019-02-28,90,0,0,8,8,1,0,1,9,1,2,California,Eureka,27191
2020,2019-2020,2019-12-01,2020-02-29,91,0,0,3,3,0,0,0,3,0,0,California,Eureka,27191
2021,1950-1951,1950-12-01,1951-02-28,90,15,0,9,9,0,0,0,9,0,0,California,Fairfield,105321
2022,1951-1952,1951-12-01,1952-02-29,91,4,0,23,23,0,0,0,23,0,0,California,Fairfield,105321
2023,1953-1954,1953-12-01,1954-02-28,90,8,0,24,24,0,0,0,24,0,0,California,Fairfield,105321
2024,1955-1956,1955-12-01,1956-02-29,91,2,0,18,18,0,0,0,18,0,0,California,Fairfield,105321
2025,1957-1958,1957-12-01,1958-02-28,90,20,0,8,8,0,0,0,8,0,0,California,Fairfield,105321
2026,1958-1959,1958-12-01,1959-02-28,90,1,0,4,4,0,0,0,4,0,0,California,Fairfield,105321
2027,1959-1960,1959-12-01,1960-02-29,91,1,0,22,22,0,0,0,22,0,0,California,Fairfield,105321
2028,1960-1961,1960-12-01,1961-02-28,90,0,0,17,17,0,0,0,17,0,0,California,Fairfield,105321
2029,1961-1962,1961-12-01,1962-02-28,90,0,0,28,28,0,0,0,28,0,0,California,Fairfield,105321
2030,1962-1963,1962-12-01,1963-02-28,90,1,0,28,28,0,0,0,28,0,0,California,Fairfield,105321
2031,1964-1965,1964-12-01,1965-02-28,90,0,0,6,6,0,0,0,6,0,0,California,Fairfield,105321
2032,1965-1966,1965-12-01,1966-02-28,90,0,0,25,25,0,0,0,25,0,0,California,Fairfield,105321
2033,1966-1967,1966-12-01,1967-02-28,90,0,0,15,15,0,0,0,15,0,0,California,Fairfield,105321
2034,1967-1968,1967-12-01,1968-02-29,91,3,0,28,28,0,0,0,28,0,0,California,Fairfield,105321
2035,1968-1969,1968-12-01,1969-02-28,90,1,0,19,19,0,0,0,19,0,0,California,Fairfield,105321
2036,1969-1970,1969-12-01,1970-02-28,90,0,0,13,13,0,0,0,13,0,0,California,Fairfield,105321
2037,1970-1971,1970-12-01,1971-02-28,90,1,0,15,15,0,0,0,15,0,0,California,Fairfield,105321
2038,1971-1972,1971-12-01,1972-02-29,91,0,0,33,33,0,0,0,33,0,0,California,Fairfield,105321
2039,1972-1973,1972-12-01,1973-02-28,90,0,1,29,30,0,0,0,30,0,0,California,Fairfield,105321
2040,1973-1974,1973-12-01,1974-02-28,90,0,0,8,8,0,0,0,8,0,0,California,Fairfield,105321
2041,1974-1975,1974-12-01,1975-02-28,90,0,0,25,25,0,0,0,25,0,0,California,Fairfield,105321
2042,1975-1976,1975-12-01,1976-02-29,91,0,0,26,26,0,0,0,26,0,0,California,Fairfield,105321
2043,1976-1977,1976-12-01,1977-02-28,90,0,0,39,39,0,0,0,39,0,0,California,Fairfield,105321
2044,1977-1978,1977-12-01,1978-02-28,90,1,0,0,0,0,0,0,0,0,0,California,Fairfield,105321
2045,1978-1979,1978-12-01,1979-02-28,90,0,0,29,29,0,0,0,29,0,0,California,Fairfield,105321
2046,1979-1980,1979-12-01,1980-02-29,91,1,0,15,15,0,0,0,15,0,0,California,Fairfield,105321
2047,1980-1981,1980-12-01,1981-02-28,90,2,0,27,27,0,0,0,27,0,0,California,Fairfield,105321
2048,1981-1982,1981-12-01,1982-02-28,90,7,0,17,17,0,0,0,17,0,0,California,Fairfield,105321
2049,1982-1983,1982-12-01,1983-02-28,90,3,0,11,11,0,0,0,11,0,0,California,Fairfield,105321
2050,1983-1984,1983-12-01,1984-02-29,91,3,0,12,12,0,0,0,12,0,0,California,Fairfield,105321
2051,1984-1985,1984-12-01,1985-02-28,90,6,0,52,52,0,0,0,52,0,0,California,Fairfield,105321
2052,1985-1986,1985-12-01,1986-02-28,90,4,0,44,44,0,0,0,44,0,0,California,Fairfield,105321
2053,1986-1987,1986-12-01,1987-02-28,90,3,0,11,11,0,0,0,11,0,0,California,Fairfield,105321
2054,1987-1988,1987-12-01,1988-02-29,91,9,0,6,6,0,0,0,6,0,0,California,Fairfield,105321
2055,1988-1989,1988-12-01,1989-02-28,90,9,0,18,18,2,0,2,20,1,3,California,Fairfield,105321
2056,1989-1990,1989-12-01,1990-02-28,90,5,0,17,17,0,0,0,17,0,0,California,Fairfield,105321
2057,1990-1991,1990-12-01,1991-02-28,90,3,0,28,28,0,0,0,28,0,0,California,Fairfield,105321
2058,1991-1992,1991-12-01,1992-02-29,91,3,0,7,7,0,0,0,7,0,0,California,Fairfield,105321
2059,1992-1993,1992-12-01,1993-02-28,90,9,0,12,12,0,0,0,12,0,0,California,Fairfield,105321
2060,1993-1994,1993-12-01,1994-02-28,90,11,0,11,11,0,0,0,11,0,0,California,Fairfield,105321
2061,1994-1995,1994-12-01,1995-02-28,90,19,0,1,1,0,0,0,1,0,0,California,Fairfield,105321
2062,1995-1996,1995-12-01,1996-02-29,91,14,0,0,0,0,0,0,0,0,0,California,Fairfield,105321
2063,1996-1997,1996-12-01,1997-02-28,90,6,0,4,4,0,0,0,4,0,0,California,Fairfield,105321
2064,1997-1998,1997-12-01,1998-02-28,90,14,0,4,4,0,0,0,4,0,0,California,Fairfield,105321
2065,1998-1999,1998-12-01,1999-02-28,90,3,0,28,28,0,0,0,28,0,0,California,Fairfield,105321
2066,1999-2000,1999-12-01,2000-02-29,91,5,0,1,1,0,0,0,1,0,0,California,Fairfield,105321
2067,2000-2001,2000-12-01,2001-02-28,90,6,0,5,5,0,0,0,5,0,0,California,Fairfield,105321
2068,2001-2002,2001-12-01,2002-02-28,90,9,0,5,5,0,0,0,5,0,0,California,Fairfield,105321
2069,2002-2003,2002-12-01,2003-02-28,90,17,0,0,0,0,0,0,0,0,0,California,Fairfield,105321
2070,2003-2004,2003-12-01,2004-02-29,91,8,0,8,8,0,0,0,8,0,0,California,Fairfield,105321
2071,2004-2005,2004-12-01,2005-02-28,90,8,0,6,6,0,0,0,6,0,0,California,Fairfield,105321
2072,2005-2006,2005-12-01,2006-02-28,90,0,0,3,3,0,0,0,3,0,0,California,Fairfield,105321
2073,2006-2007,2006-12-01,2007-02-28,90,0,0,27,27,0,0,0,27,0,0,California,Fairfield,105321
2074,2007-2008,2007-12-01,2008-02-29,91,0,0,4,4,0,0,0,4,0,0,California,Fairfield,105321
2075,2008-2009,2008-12-01,2009-02-28,90,0,0,5,5,0,0,0,5,0,0,California,Fairfield,105321
2076,2009-2010,2009-12-01,2010-02-28,90,0,0,6,6,0,0,0,6,0,0,California,Fairfield,105321
2077,2016-2017,2016-12-01,2017-02-28,90,4,0,6,6,0,0,0,6,0,0,California,Fairfield,105321
2078,2017-2018,2017-12-01,2018-02-28,90,4,0,6,6,0,0,0,6,0,0,California,Fairfield,105321
2079,2018-2019,2018-12-01,2019-02-28,90,0,0,4,4,0,0,0,4,0,0,California,Fairfield,105321
2080,2019-2020,2019-12-01,2020-02-29,91,0,0,0,0,0,0,0,0,0,0,California,Fairfield,105321
2081,1950-1951,1950-12-01,1951-02-28,90,0,0,16,16,0,0,0,16,0,0,California,Fresno,494665
2082,1951-1952,1951-12-01,1952-02-29,91,0,0,26,26,0,0,0,26,0,0,California,Fresno,494665
2083,1952-1953,1952-12-01,1953-02-28,90,0,0,14,14,0,0,0,14,0,0,California,Fresno,494665
2084,1953-1954,1953-12-01,1954-02-28,90,0,0,23,23,0,0,0,23,0,0,California,Fresno,494665
2085,1954-1955,1954-12-01,1955-02-28,90,0,0,34,34,0,0,0,34,0,0,California,Fresno,494665
2086,1955-1956,1955-12-01,1956-02-29,91,0,0,15,15,0,0,0,15,0,0,California,Fresno,494665
2087,1956-1957,1956-12-01,1957-02-28,90,0,0,33,33,1,0,1,34,1,2,California,Fresno,494665
2088,1957-1958,1957-12-01,1958-02-28,90,0,0,10,10,0,0,0,10,0,0,California,Fresno,494665
2089,1958-1959,1958-12-01,1959-02-28,90,0,0,12,12,0,0,0,12,0,0,California,Fresno,494665
2090,1959-1960,1959-12-01,1960-02-29,91,0,0,32,32,0,0,0,32,0,0,California,Fresno,494665
2091,1960-1961,1960-12-01,1961-02-28,90,0,0,24,24,0,0,0,24,0,0,California,Fresno,494665
2092,1961-1962,1961-12-01,1962-02-28,90,0,0,25,25,3,0,3,28,2,4,California,Fresno,494665
2093,1962-1963,1962-12-01,1963-02-28,90,0,0,44,44,0,0,0,44,0,0,California,Fresno,494665
2094,1963-1964,1963-12-01,1964-02-29,91,0,0,31,31,0,0,0,31,0,0,California,Fresno,494665
2095,1964-1965,1964-12-01,1965-02-28,90,0,0,14,14,0,0,0,14,0,0,California,Fresno,494665
2096,1965-1966,1965-12-01,1966-02-28,90,0,0,40,40,0,0,0,40,0,0,California,Fresno,494665
2097,1966-1967,1966-12-01,1967-02-28,90,0,0,16,16,0,0,0,16,0,0,California,Fresno,494665
2098,1967-1968,1967-12-01,1968-02-29,91,0,0,24,24,0,0,0,24,0,0,California,Fresno,494665
2099,1968-1969,1968-12-01,1969-02-28,90,0,0,19,19,2,1,3,22,1,3,California,Fresno,494665
2100,1969-1970,1969-12-01,1970-02-28,90,0,0,29,29,0,0,0,29,0,0,California,Fresno,494665
2101,1970-1971,1970-12-01,1971-02-28,90,0,0,20,20,0,0,0,20,0,0,California,Fresno,494665
2102,1971-1972,1971-12-01,1972-02-29,91,0,0,28,28,0,0,0,28,0,0,California,Fresno,494665
2103,1972-1973,1972-12-01,1973-02-28,90,0,2,28,30,0,0,0,30,0,0,California,Fresno,494665
2104,1973-1974,1973-12-01,1974-02-28,90,0,0,5,5,0,0,0,5,0,0,California,Fresno,494665
2105,1974-1975,1974-12-01,1975-02-28,90,0,0,27,27,0,0,0,27,0,0,California,Fresno,494665
2106,1975-1976,1975-12-01,1976-02-29,91,0,0,41,41,0,0,0,41,0,0,California,Fresno,494665
2107,1976-1977,1976-12-01,1977-02-28,90,0,0,25,25,0,0,0,25,0,0,California,Fresno,494665
2108,1977-1978,1977-12-01,1978-02-28,90,0,0,0,0,0,0,0,0,0,0,California,Fresno,494665
2109,1978-1979,1978-12-01,1979-02-28,90,0,0,19,19,0,0,0,19,0,0,California,Fresno,494665
2110,1979-1980,1979-12-01,1980-02-29,91,0,0,14,14,0,0,0,14,0,0,California,Fresno,494665
2111,1980-1981,1980-12-01,1981-02-28,90,0,0,12,12,0,0,0,12,0,0,California,Fresno,494665
2112,1981-1982,1981-12-01,1982-02-28,90,0,0,17,17,0,0,0,17,0,0,California,Fresno,494665
2113,1982-1983,1982-12-01,1983-02-28,90,0,0,4,4,0,0,0,4,0,0,California,Fresno,494665
2114,1983-1984,1983-12-01,1984-02-29,91,0,0,0,0,0,0,0,0,0,0,California,Fresno,494665
2115,1984-1985,1984-12-01,1985-02-28,90,0,0,12,12,0,0,0,12,0,0,California,Fresno,494665
2116,1985-1986,1985-12-01,1986-02-28,90,0,0,4,4,0,0,0,4,0,0,California,Fresno,494665
2117,1986-1987,1986-12-01,1987-02-28,90,0,0,9,9,0,0,0,9,0,0,California,Fresno,494665
2118,1987-1988,1987-12-01,1988-02-29,91,0,0,32,32,0,0,0,32,0,0,California,Fresno,494665
2119,1988-1989,1988-12-01,1989-02-28,90,0,0,34,34,0,0,0,34,0,0,California,Fresno,494665
2120,1989-1990,1989-12-01,1990-02-28,90,0,0,35,35,0,0,0,35,0,0,California,Fresno,494665
2121,1990-1991,1990-12-01,1991-02-28,90,0,0,46,46,0,0,0,46,0,0,California,Fresno,494665
2122,1991-1992,1991-12-01,1992-02-29,91,0,0,11,11,0,0,0,11,0,0,California,Fresno,494665
2123,1992-1993,1992-12-01,1993-02-28,90,0,0,13,13,0,0,0,13,0,0,California,Fresno,494665
2124,1993-1994,1993-12-01,1994-02-28,90,0,0,13,13,0,0,0,13,0,0,California,Fresno,494665
2125,1994-1995,1994-12-01,1995-02-28,90,0,0,6,6,0,0,0,6,0,0,California,Fresno,494665
2126,1995-1996,1995-12-01,1996-02-29,91,0,0,4,4,0,0,0,4,0,0,California,Fresno,494665
2127,1996-1997,1996-12-01,1997-02-28,90,0,0,5,5,0,0,0,5,0,0,California,Fresno,494665
2128,1997-1998,1997-12-01,1998-02-28,90,0,0,11,11,0,0,0,11,0,0,California,Fresno,494665
2129,1998-1999,1998-12-01,1999-02-28,90,0,0,29,29,1,0,1,30,1,2,California,Fresno,494665
2130,1999-2000,1999-12-01,2000-02-29,91,0,0,14,14,0,0,0,14,0,0,California,Fresno,494665
2131,2000-2001,2000-12-01,2001-02-28,90,0,0,17,17,0,0,0,17,0,0,California,Fresno,494665
2132,2001-2002,2001-12-01,2002-02-28,90,0,0,17,17,0,0,0,17,0,0,California,Fresno,494665
2133,2002-2003,2002-12-01,2003-02-28,90,0,0,1,1,0,0,0,1,0,0,California,Fresno,494665
2134,2003-2004,2003-12-01,2004-02-29,91,0,0,5,5,0,0,0,5,0,0,California,Fresno,494665
2135,2004-2005,2004-12-01,2005-02-28,90,0,0,6,6,0,0,0,6,0,0,California,Fresno,494665
2136,2005-2006,2005-12-01,2006-02-28,90,0,0,2,2,0,0,0,2,0,0,California,Fresno,494665
2137,2006-2007,2006-12-01,2007-02-28,90,0,0,30,30,0,0,0,30,0,0,California,Fresno,494665
2138,2007-2008,2007-12-01,2008-02-29,91,0,0,12,12,0,0,0,12,0,0,California,Fresno,494665
2139,2008-2009,2008-12-01,2009-02-28,90,0,0,9,9,0,0,0,9,0,0,California,Fresno,494665
2140,2009-2010,2009-12-01,2010-02-28,90,0,0,5,5,0,0,0,5,0,0,California,Fresno,494665
2141,2010-2011,2010-12-01,2011-02-28,90,0,0,3,3,0,0,0,3,0,0,California,Fresno,494665
2142,2011-2012,2011-12-01,2012-02-29,91,0,0,21,21,0,0,0,21,0,0,California,Fresno,494665
2143,2012-2013,2012-12-01,2013-02-28,90,0,0,10,10,0,0,0,10,0,0,California,Fresno,494665
2144,2013-2014,2013-12-01,2014-02-28,90,0,0,10,10,0,0,0,10,0,0,California,Fresno,494665
2145,2014-2015,2014-12-01,2015-02-28,90,0,0,8,8,0,0,0,8,0,0,California,Fresno,494665
2146,2015-2016,2015-12-01,2016-02-29,91,0,0,11,11,0,0,0,11,0,0,California,Fresno,494665
2147,2016-2017,2016-12-01,2017-02-28,90,0,0,11,11,0,0,0,11,0,0,California,Fresno,494665
2148,2017-2018,2017-12-01,2018-02-28,90,0,0,6,6,0,0,0,6,0,0,California,Fresno,494665
2149,2018-2019,2018-12-01,2019-02-28,90,0,0,1,1,0,0,0,1,0,0,California,Fresno,494665
2150,2019-2020,2019-12-01,2020-02-29,91,0,0,1,1,0,0,0,1,0,0,California,Fresno,494665
2151,1950-1951,1950-12-01,1951-02-28,90,0,0,19,19,0,0,0,19,0,0,California,Orland,7291
2152,1951-1952,1951-12-01,1952-02-29,91,0,0,27,27,0,0,0,27,0,0,California,Orland,7291
2153,1952-1953,1952-12-01,1953-02-28,90,0,0,7,7,0,0,0,7,0,0,California,Orland,7291
2154,1953-1954,1953-12-01,1954-02-28,90,0,0,24,24,0,0,0,24,0,0,California,Orland,7291
2155,1954-1955,1954-12-01,1955-02-28,90,0,0,40,40,0,0,0,40,0,0,California,Orland,7291
2156,1955-1956,1955-12-01,1956-02-29,91,1,0,22,22,0,0,0,22,0,0,California,Orland,7291
2157,1956-1957,1956-12-01,1957-02-28,90,1,0,59,59,0,0,0,59,0,0,California,Orland,7291
2158,1957-1958,1957-12-01,1958-02-28,90,6,0,10,10,0,0,0,10,0,0,California,Orland,7291
2159,1958-1959,1958-12-01,1959-02-28,90,0,0,12,12,0,0,0,12,0,0,California,Orland,7291
2160,1959-1960,1959-12-01,1960-02-29,91,0,0,39,39,0,0,0,39,0,0,California,Orland,7291
2161,1960-1961,1960-12-01,1961-02-28,90,0,0,20,20,0,0,0,20,0,0,California,Orland,7291
2162,1961-1962,1961-12-01,1962-02-28,90,0,0,32,32,0,0,0,32,0,0,California,Orland,7291
2163,1962-1963,1962-12-01,1963-02-28,90,1,0,34,34,0,0,0,34,0,0,California,Orland,7291
2164,1963-1964,1963-12-01,1964-02-29,91,1,0,23,23,0,0,0,23,0,0,California,Orland,7291
2165,1964-1965,1964-12-01,1965-02-28,90,0,0,18,18,3,0,3,21,1,3,California,Orland,7291
2166,1965-1966,1965-12-01,1966-02-28,90,0,0,53,53,0,0,0,53,0,0,California,Orland,7291
2167,1966-1967,1966-12-01,1967-02-28,90,0,0,20,20,0,0,0,20,0,0,California,Orland,7291
2168,1967-1968,1967-12-01,1968-02-29,91,0,1,42,43,0,0,0,43,0,0,California,Orland,7291
2169,1968-1969,1968-12-01,1969-02-28,90,0,0,32,32,0,0,0,32,0,0,California,Orland,7291
2170,1969-1970,1969-12-01,1970-02-28,90,0,0,15,15,0,0,0,15,0,0,California,Orland,7291
2171,1970-1971,1970-12-01,1971-02-28,90,1,0,18,18,0,0,0,18,0,0,California,Orland,7291
2172,1971-1972,1971-12-01,1972-02-29,91,0,0,38,38,0,0,0,38,0,0,California,Orland,7291
2173,1972-1973,1972-12-01,1973-02-28,90,3,1,39,40,10,2,12,52,2,13,California,Orland,7291
2174,1973-1974,1973-12-01,1974-02-28,90,0,0,19,19,0,0,0,19,0,0,California,Orland,7291
2175,1974-1975,1974-12-01,1975-02-28,90,0,0,33,33,0,0,0,33,0,0,California,Orland,7291
2176,1975-1976,1975-12-01,1976-03-03,94,0,0,45,45,6,0,6,51,1,7,California,Orland,7291
2177,1976-1977,1976-12-01,1977-02-28,90,6,0,30,30,0,0,0,30,0,0,California,Orland,7291
2178,1977-1978,1977-12-01,1978-02-28,90,0,0,3,3,0,0,0,3,0,0,California,Orland,7291
2179,1978-1979,1978-12-01,1979-02-28,90,0,0,35,35,0,0,0,35,0,0,California,Orland,7291
2180,1979-1980,1979-12-01,1980-02-29,91,0,0,17,17,0,0,0,17,0,0,California,Orland,7291
2181,1980-1981,1980-12-01,1981-02-28,90,0,0,12,12,0,0,0,12,0,0,California,Orland,7291
2182,1981-1982,1981-12-01,1982-02-28,90,4,0,23,23,0,0,0,23,0,0,California,Orland,7291
2183,1982-1983,1982-12-01,1983-02-28,90,0,0,26,26,0,0,0,26,0,0,California,Orland,7291
2184,1983-1984,1983-12-01,1984-02-29,91,6,0,14,14,0,0,0,14,0,0,California,Orland,7291
2185,1984-1985,1984-12-01,1985-02-28,90,7,0,23,23,0,0,0,23,0,0,California,Orland,7291
2186,1985-1986,1985-12-01,1986-02-28,90,1,0,28,28,0,0,0,28,0,0,California,Orland,7291
2187,1986-1987,1986-12-01,1987-02-28,90,3,0,18,18,0,0,0,18,0,0,California,Orland,7291
2188,1987-1988,1987-12-01,1988-02-29,91,1,0,27,27,0,0,0,27,0,0,California,Orland,7291
2189,1989-1990,1989-12-01,1990-02-28,90,0,0,50,50,0,0,0,50,0,0,California,Orland,7291
2190,1990-1991,1990-12-01,1991-02-28,90,5,1,47,48,0,0,0,48,0,0,California,Orland,7291
2191,1991-1992,1991-12-01,1992-02-29,91,4,0,18,18,0,0,0,18,0,0,California,Orland,7291
2192,1992-1993,1992-12-01,1993-02-28,90,0,0,23,23,0,0,0,23,0,0,California,Orland,7291
2193,1993-1994,1993-12-01,1994-02-28,90,9,0,15,15,0,0,0,15,0,0,California,Orland,7291
2194,1994-1995,1994-12-01,1995-02-28,90,6,0,10,10,0,0,0,10,0,0,California,Orland,7291
2195,1995-1996,1995-12-01,1996-02-29,91,15,0,7,7,0,0,0,7,0,0,California,Orland,7291
2196,1996-1997,1996-12-01,1997-02-28,90,11,0,8,8,0,0,0,8,0,0,California,Orland,7291
2197,1997-1998,1997-12-01,1998-02-28,90,12,0,8,8,0,0,0,8,0,0,California,Orland,7291
2198,1998-1999,1998-12-01,1999-02-28,90,8,0,38,38,0,0,0,38,0,0,California,Orland,7291
2199,1999-2000,1999-12-01,2000-02-29,91,11,0,7,7,0,0,0,7,0,0,California,Orland,7291
2200,2000-2001,2000-12-01,2001-02-28,90,3,0,11,11,0,0,0,11,0,0,California,Orland,7291
2201,2001-2002,2001-12-01,2002-02-28,90,3,0,14,14,0,0,0,14,0,0,California,Orland,7291
2202,2002-2003,2002-12-01,2003-02-28,90,4,0,3,3,0,0,0,3,0,0,California,Orland,7291
2203,2003-2004,2003-12-01,2004-02-29,91,2,0,7,7,0,0,0,7,0,0,California,Orland,7291
2204,2004-2005,2004-12-01,2005-02-28,90,1,0,7,7,0,0,0,7,0,0,California,Orland,7291
2205,2005-2006,2005-12-01,2006-02-28,90,4,0,10,10,0,0,0,10,0,0,California,Orland,7291
2206,2006-2007,2006-12-01,2007-02-28,90,6,0,22,22,0,0,0,22,0,0,California,Orland,7291
2207,2007-2008,2007-12-01,2008-02-29,91,4,0,9,9,0,0,0,9,0,0,California,Orland,7291
2208,2008-2009,2008-12-01,2009-02-28,90,4,0,16,16,0,0,0,16,0,0,California,Orland,7291
2209,2009-2010,2009-12-01,2010-02-28,90,1,0,16,16,0,0,0,16,0,0,California,Orland,7291
2210,2015-2016,2015-12-01,2016-02-29,91,0,0,5,5,0,0,0,5,0,0,California,Orland,7291
2211,2016-2017,2016-12-01,2017-02-28,90,0,0,26,26,0,0,0,26,0,0,California,Orland,7291
2212,2017-2018,2017-12-01,2018-02-28,90,0,0,17,17,0,0,0,17,0,0,California,Orland,7291
2213,2018-2019,2018-12-01,2019-02-28,90,0,0,15,15,0,0,0,15,0,0,California,Orland,7291
2214,2019-2020,2019-12-01,2020-02-29,91,0,0,5,5,0,0,0,5,0,0,California,Orland,7291
2215,1950-1951,1950-10-27,1951-05-14,200,7,21,337,358,218,785,1003,1361,40,328,California,Tahoe City,0
2216,1951-1952,1951-10-24,1952-05-11,201,3,58,497,555,735,2316,3051,3606,67,971,California,Tahoe City,0
2217,1952-1953,1952-09-11,1953-05-25,257,18,26,429,455,368,1811,2179,2634,49,483,California,Tahoe City,0
2218,1953-1954,1953-10-19,1954-06-05,230,0,17,373,390,215,988,1203,1593,32,281,California,Tahoe City,0
2219,1954-1955,1954-11-16,1955-05-15,181,0,39,442,481,214,1133,1347,1828,32,301,California,Tahoe City,0
2220,1955-1956,1955-11-14,1956-05-12,181,17,38,380,418,371,1801,2172,2590,50,514,California,Tahoe City,0
2221,1956-1957,1956-10-23,1957-05-20,210,4,36,378,414,230,904,1134,1548,40,321,California,Tahoe City,0
2222,1957-1958,1957-10-20,1958-05-09,202,4,23,362,385,394,1686,2080,2465,49,496,California,Tahoe City,0
2223,1958-1959,1958-11-10,1959-05-22,194,13,15,294,309,166,492,658,967,27,231,California,Tahoe City,0
2224,1959-1960,1959-12-01,1960-05-24,176,1,22,348,370,210,803,1013,1383,34,291,California,Tahoe City,0
2225,1961-1962,1961-11-16,1962-05-16,182,0,37,394,431,326,1371,1697,2128,45,470,California,Tahoe City,0
2226,1962-1963,1962-10-14,1963-06-10,240,4,13,318,331,213,452,665,996,34,283,California,Tahoe City,0
2227,1963-1964,1963-11-04,1964-05-08,187,5,23,374,397,303,1201,1504,1901,47,416,California,Tahoe City,0
2228,1964-1965,1964-11-01,1965-05-07,188,4,27,314,341,358,1339,1697,2038,46,453,California,Tahoe City,0
2229,1965-1966,1965-11-18,1966-04-12,146,1,26,341,367,284,1505,1789,2156,38,392,California,Tahoe City,0
2230,1967-1968,1967-11-28,1968-05-14,169,3,20,330,350,316,1451,1767,2117,34,410,California,Tahoe City,0
2231,1968-1969,1968-11-12,1969-04-30,170,8,27,371,398,434,1761,2195,2593,55,589,California,Tahoe City,0
2232,1969-1970,1969-10-15,1970-05-10,208,17,4,322,326,157,560,717,1043,35,220,California,Tahoe City,0
2233,1972-1973,1972-10-18,1973-05-05,200,8,32,455,487,245,1080,1325,1812,56,380,California,Tahoe City,0
2234,1973-1974,1973-11-14,1974-05-18,186,2,21,345,366,257,749,1006,1372,52,380,California,Tahoe City,0
2235,1974-1975,1974-11-01,1975-05-21,202,12,27,403,430,324,1491,1815,2245,52,452,California,Tahoe City,0
2236,1975-1976,1975-10-10,1976-04-16,190,1,22,412,434,126,240,366,800,31,207,California,Tahoe City,0
2237,1977-1978,1977-11-05,1978-05-24,201,12,5,293,298,241,1094,1335,1633,44,315,California,Tahoe City,0
2238,1978-1979,1978-11-01,1979-05-10,191,2,22,454,476,268,1134,1402,1878,44,373,California,Tahoe City,0
2239,1979-1980,1979-10-20,1980-05-11,205,6,3,343,346,265,1075,1340,1686,42,342,California,Tahoe City,0
2240,1980-1981,1980-10-14,1981-04-02,171,0,4,268,272,119,394,513,785,22,157,California,Tahoe City,0
2241,1981-1982,1981-10-28,1982-06-05,221,6,16,397,413,367,1642,2009,2422,48,482,California,Tahoe City,0
2242,1982-1983,1982-09-16,1983-05-19,246,13,9,378,387,323,2318,2641,3028,58,422,California,Tahoe City,0
2243,1983-1984,1983-11-14,1984-04-27,166,16,4,284,288,227,1137,1364,1652,42,321,California,Tahoe City,0
2244,1984-1985,1984-10-17,1985-06-02,229,15,17,394,411,264,1557,1821,2232,37,351,California,Tahoe City,0
2245,1985-1986,1985-10-09,1986-05-07,211,3,10,319,329,252,1312,1564,1893,42,325,California,Tahoe City,0
2246,1986-1987,1986-09-25,1987-03-29,186,18,5,327,332,98,587,685,1017,23,147,California,Tahoe City,0
2247,1987-1988,1987-11-21,1988-06-07,200,9,9,334,343,141,635,776,1119,30,204,California,Tahoe City,0
2248,1988-1989,1988-11-14,1989-05-23,191,11,15,396,411,287,1462,1749,2160,44,407,California,Tahoe City,0
2249,1989-1990,1989-10-03,1990-04-30,210,10,5,366,371,210,816,1026,1397,30,288,California,Tahoe City,0
2250,1990-1991,1990-12-01,1991-05-17,168,13,15,356,371,120,518,638,1009,18,151,California,Tahoe City,0
2251,1991-1992,1991-11-30,1992-03-16,108,8,2,213,215,87,398,485,700,13,108,California,Tahoe City,0
2252,1992-1993,1992-12-01,1993-04-18,139,7,24,329,353,298,1695,1993,2346,45,408,California,Tahoe City,0
2253,1994-1995,1994-11-10,1995-06-16,219,11,13,386,399,483,2152,2635,3034,59,613,California,Tahoe City,0
2254,1995-1996,1995-12-01,1996-05-16,168,11,11,243,254,356,1139,1495,1749,41,459,California,Tahoe City,0
2255,1996-1997,1996-10-26,1997-04-09,166,16,10,251,261,251,870,1121,1382,28,297,California,Tahoe City,0
2256,1997-1998,1997-10-11,1998-05-29,231,20,8,357,365,332,1470,1802,2167,58,439,California,Tahoe City,0
2257,1998-1999,1998-11-07,1999-05-04,179,9,20,347,367,357,1563,1920,2287,45,468,California,Tahoe City,0
2258,1999-2000,1999-11-08,2000-05-11,186,11,0,263,263,191,822,1013,1276,35,246,California,Tahoe City,0
2259,2000-2001,2000-10-10,2001-04-21,194,9,14,341,355,226,729,955,1310,41,316,California,Tahoe City,0
2260,2001-2002,2001-11-25,2002-05-21,178,7,18,330,348,244,1123,1367,1715,40,335,California,Tahoe City,0
2261,2002-2003,2002-11-09,2003-05-08,181,12,11,253,264,270,866,1136,1400,33,330,California,Tahoe City,0
2262,2003-2004,2003-11-01,2004-05-11,193,9,8,310,318,269,1110,1379,1697,36,343,California,Tahoe City,0
2263,2004-2005,2004-10-20,2005-06-07,231,4,10,346,356,387,1431,1818,2174,49,471,California,Tahoe City,0
2264,2005-2006,2005-11-26,2006-05-27,183,3,15,333,348,287,873,1160,1508,49,414,California,Tahoe City,0
2265,2006-2007,2006-11-11,2007-05-04,175,12,18,308,326,169,387,556,882,25,225,California,Tahoe City,0
2266,2007-2008,2007-09-29,2008-04-23,208,14,24,379,403,246,1273,1519,1922,37,340,California,Tahoe City,0
2267,2008-2009,2008-11-04,2009-04-25,173,16,28,354,382,241,848,1089,1471,38,363,California,Tahoe City,0
2268,2013-2014,2013-10-28,2014-05-11,196,1,9,309,318,90,168,258,576,27,141,California,Tahoe City,0
2269,2014-2015,2014-11-01,2015-05-07,188,0,4,249,253,49,64,113,366,13,68,California,Tahoe City,0
2270,2015-2016,2015-11-03,2016-04-24,174,0,16,332,348,205,812,1017,1365,44,299,California,Tahoe City,0
2271,2016-2017,2016-10-03,2017-06-12,253,0,16,371,387,351,1668,2019,2406,54,466,California,Tahoe City,0
2272,2017-2018,2017-10-20,2018-04-18,181,1,16,303,319,203,494,697,1016,31,301,California,Tahoe City,0
2273,2018-2019,2018-11-22,2019-05-26,186,1,21,312,333,323,1375,1698,2031,50,430,California,Tahoe City,0
2274,2019-2020,2019-09-29,2020-06-08,254,3,11,366,377,187,574,761,1138,33,270,California,Tahoe City,0
2275,1950-1951,1950-11-09,1951-04-10,153,0,25,734,759,30,4,34,793,16,91,Colorado,Alamosa,8780
2276,1951-1952,1951-11-01,1952-05-17,199,0,52,823,875,43,52,95,970,24,131,Colorado,Alamosa,8780
2277,1952-1953,1952-11-03,1953-05-16,195,0,70,863,933,49,88,137,1070,31,176,Colorado,Alamosa,8780
2278,1953-1954,1953-11-05,1954-05-02,179,0,40,728,768,28,68,96,864,17,110,Colorado,Alamosa,8780
2279,1954-1955,1954-11-30,1955-05-18,170,0,40,808,848,28,14,42,890,15,109,Colorado,Alamosa,8780
2280,1955-1956,1955-10-27,1956-04-15,172,0,25,792,817,35,48,83,900,20,120,Colorado,Alamosa,8780
2281,1956-1957,1956-11-01,1957-05-20,201,0,23,760,783,44,37,81,864,22,117,Colorado,Alamosa,8780
2282,1957-1958,1957-11-04,1958-04-30,178,0,34,817,851,57,113,170,1021,30,177,Colorado,Alamosa,8780
2283,1958-1959,1958-10-28,1959-05-05,190,0,26,833,859,59,70,129,988,25,159,Colorado,Alamosa,8780
2284,1959-1960,1959-09-29,1960-04-29,214,0,72,927,999,76,114,190,1189,34,219,Colorado,Alamosa,8780
2285,1960-1961,1960-10-14,1961-05-14,213,2,44,861,905,76,83,159,1064,37,219,Colorado,Alamosa,8780
2286,1961-1962,1961-09-03,1962-04-02,212,0,65,882,947,79,124,203,1150,25,182,Colorado,Alamosa,8780
2287,1962-1963,1962-10-19,1963-04-05,169,0,50,825,875,54,101,155,1030,26,163,Colorado,Alamosa,8780
2288,1963-1964,1963-10-31,1964-04-27,180,1,47,1004,1051,42,43,85,1136,31,205,Colorado,Alamosa,8780
2289,1964-1965,1964-11-03,1965-05-26,205,0,123,949,1072,99,362,461,1533,44,295,Colorado,Alamosa,8780
2290,1965-1966,1965-10-18,1966-04-22,187,0,55,844,899,46,82,128,1027,25,155,Colorado,Alamosa,8780
2291,1966-1967,1966-10-16,1967-05-14,211,0,41,814,855,53,52,105,960,23,158,Colorado,Alamosa,8780
2292,1967-1968,1967-10-29,1968-04-28,183,0,99,933,1032,70,253,323,1355,28,206,Colorado,Alamosa,8780
2293,1968-1969,1968-10-17,1969-05-07,203,0,33,882,915,47,46,93,1008,28,160,Colorado,Alamosa,8780
2294,1969-1970,1969-10-11,1970-05-01,203,1,41,886,927,84,77,161,1088,30,205,Colorado,Alamosa,8780
2295,1970-1971,1970-09-22,1971-05-23,244,0,45,952,997,60,37,97,1094,29,181,Colorado,Alamosa,8780
2296,1971-1972,1971-09-18,1972-03-28,193,0,54,788,842,51,114,165,1007,22,156,Colorado,Alamosa,8780
2297,1972-1973,1972-10-23,1973-05-06,196,0,117,1051,1168,136,248,384,1552,47,360,Colorado,Alamosa,8780
2298,1973-1974,1973-09-26,1974-04-13,200,0,55,905,960,59,83,142,1102,27,222,Colorado,Alamosa,8780
2299,1974-1975,1974-10-29,1975-04-13,167,0,109,918,1027,60,179,239,1266,35,252,Colorado,Alamosa,8780
2300,1975-1976,1975-10-31,1976-04-18,171,0,60,809,869,30,79,109,978,17,91,Colorado,Alamosa,8780
2301,1976-1977,1976-10-26,1977-04-21,178,0,47,976,1023,44,108,152,1175,18,148,Colorado,Alamosa,8780
2302,1977-1978,1977-11-09,1978-05-06,179,0,11,688,699,43,20,63,762,23,109,Colorado,Alamosa,8780
2303,1978-1979,1978-10-22,1979-05-10,201,0,141,1052,1193,67,265,332,1525,36,242,Colorado,Alamosa,8780
2304,1979-1980,1979-10-21,1980-05-15,208,0,39,882,921,63,120,183,1104,33,163,Colorado,Alamosa,8780
2305,1980-1981,1980-10-27,1981-03-30,155,0,3,730,733,19,5,24,757,13,58,Colorado,Alamosa,8780
2306,1981-1982,1981-11-07,1982-05-13,188,0,42,775,817,39,50,89,906,25,131,Colorado,Alamosa,8780
2307,1982-1983,1982-10-11,1983-05-14,216,0,25,790,815,54,48,102,917,34,172,Colorado,Alamosa,8780
2308,1983-1984,1983-11-18,1984-04-29,164,0,144,1043,1187,63,489,552,1739,36,270,Colorado,Alamosa,8780
2309,1984-1985,1984-10-14,1985-05-13,212,0,43,792,835,44,74,118,953,25,127,Colorado,Alamosa,8780
2310,1985-1986,1985-10-31,1986-05-17,199,0,36,712,748,59,113,172,920,23,150,Colorado,Alamosa,8780
2311,1986-1987,1986-10-11,1987-04-13,185,0,38,804,842,72,120,192,1034,36,196,Colorado,Alamosa,8780
2312,1987-1988,1987-11-07,1988-04-17,163,0,110,988,1098,41,267,308,1406,24,160,Colorado,Alamosa,8780
2313,1988-1989,1988-11-15,1989-04-12,149,0,45,797,842,27,32,59,901,22,150,Colorado,Alamosa,8780
2314,1989-1990,1989-12-01,1990-05-03,154,0,28,689,717,52,73,125,842,22,133,Colorado,Alamosa,8780
2315,1990-1991,1990-10-08,1991-05-04,209,0,77,901,978,51,101,152,1130,32,198,Colorado,Alamosa,8780
2316,1991-1992,1991-10-30,1992-05-10,194,0,187,1060,1247,84,623,707,1954,29,224,Colorado,Alamosa,8780
2317,1992-1993,1992-11-11,1993-05-09,180,0,113,917,1030,52,377,429,1459,26,207,Colorado,Alamosa,8780
2318,1993-1994,1993-10-29,1994-04-11,165,0,35,823,858,36,50,86,944,15,108,Colorado,Alamosa,8780
2319,1994-1995,1994-10-16,1995-04-22,189,0,20,711,731,40,60,100,831,11,73,Colorado,Alamosa,8780
2320,1995-1996,1995-11-10,1996-04-28,171,1,21,724,745,24,10,34,779,16,103,Colorado,Alamosa,8780
2321,1996-1997,1996-10-21,1997-04-12,174,0,51,791,842,53,128,181,1023,21,168,Colorado,Alamosa,8780
2322,1997-1998,1997-10-24,1998-04-26,185,0,83,875,958,43,194,237,1195,24,131,Colorado,Alamosa,8780
2323,1998-1999,1998-10-31,1999-05-06,188,0,9,710,719,39,7,46,765,22,93,Colorado,Alamosa,8780
2324,1999-2000,1999-12-01,2000-04-02,124,0,13,586,599,17,15,32,631,10,58,Colorado,Alamosa,8780
2325,2000-2001,2000-11-12,2001-05-05,175,0,35,775,810,39,52,91,901,23,129,Colorado,Alamosa,8780
2326,2001-2002,2001-11-23,2002-03-25,123,0,50,727,777,28,69,97,874,16,116,Colorado,Alamosa,8780
2327,2002-2003,2002-11-04,2003-04-06,154,0,21,714,735,24,16,40,775,15,73,Colorado,Alamosa,8780
2328,2003-2004,2003-11-13,2004-05-01,171,0,61,749,810,40,130,170,980,19,110,Colorado,Alamosa,8780
2329,2004-2005,2004-10-13,2005-04-11,181,0,34,698,732,55,81,136,868,27,152,Colorado,Alamosa,8780
2330,2005-2006,2005-10-10,2006-04-29,202,0,13,840,853,24,15,39,892,14,86,Colorado,Alamosa,8780
2331,2006-2007,2006-10-25,2007-04-24,182,0,80,826,906,50,190,240,1146,22,148,Colorado,Alamosa,8780
2332,2007-2008,2007-11-23,2008-04-17,147,0,135,889,1024,60,296,356,1380,27,246,Colorado,Alamosa,8780
2333,2008-2009,2008-10-14,2009-04-17,186,0,25,786,811,48,91,139,950,25,138,Colorado,Alamosa,8780
2334,2009-2010,2009-10-21,2010-05-02,194,0,38,845,883,48,96,144,1027,27,150,Colorado,Alamosa,8780
2335,2010-2011,2010-10-25,2011-05-01,189,0,38,823,861,20,28,48,909,14,103,Colorado,Alamosa,8780
2336,2011-2012,2011-10-07,2012-05-07,214,1,31,869,900,35,46,81,981,24,143,Colorado,Alamosa,8780
2337,2012-2013,2012-11-11,2013-04-18,159,0,104,978,1082,34,162,196,1278,18,165,Colorado,Alamosa,8780
2338,2015-2016,2015-11-16,2016-05-01,168,0,43,734,777,63,61,124,901,24,165,Colorado,Alamosa,8780
2339,2016-2017,2016-11-27,2017-05-11,166,0,58,606,664,66,203,269,933,30,190,Colorado,Alamosa,8780
2340,2017-2018,2017-11-08,2018-04-20,164,0,4,698,702,17,8,25,727,12,62,Colorado,Alamosa,8780
2341,2018-2019,2018-10-31,2019-05-21,203,0,75,840,915,84,186,270,1185,39,263,Colorado,Alamosa,8780
2342,2019-2020,2019-10-30,2020-03-19,142,0,50,731,781,27,61,88,869,16,105,Colorado,Alamosa,8780
2343,1950-1951,1950-11-08,1951-06-03,208,0,53,437,490,33,27,60,550,24,174,Colorado,Colorado Springs,416427
2344,1951-1952,1951-09-21,1952-05-17,240,0,31,432,463,48,14,62,525,28,138,Colorado,Colorado Springs,416427
2345,1952-1953,1952-11-08,1953-05-13,187,0,32,400,432,42,25,67,499,26,127,Colorado,Colorado Springs,416427
2346,1953-1954,1953-10-23,1954-05-03,193,0,26,330,356,45,25,70,426,30,126,Colorado,Colorado Springs,416427
2347,1954-1955,1954-10-26,1955-04-12,169,1,31,458,489,40,49,89,578,24,142,Colorado,Colorado Springs,416427
2348,1955-1956,1955-11-12,1956-04-28,169,1,33,426,459,56,96,152,611,29,184,Colorado,Colorado Springs,416427
2349,1956-1957,1956-10-24,1957-05-16,205,0,27,437,464,128,109,237,701,39,277,Colorado,Colorado Springs,416427
2350,1957-1958,1957-09-14,1958-04-30,229,0,15,375,390,80,51,131,521,45,198,Colorado,Colorado Springs,416427
2351,1958-1959,1958-10-29,1959-04-21,175,0,33,414,447,82,62,144,591,36,213,Colorado,Colorado Springs,416427
2352,1959-1960,1959-09-28,1960-05-19,235,0,69,504,573,97,117,214,787,38,251,Colorado,Colorado Springs,416427
2353,1960-1961,1960-10-14,1961-05-14,213,0,31,413,444,63,60,123,567,38,168,Colorado,Colorado Springs,416427
2354,1961-1962,1961-09-03,1962-04-30,240,1,94,537,631,69,106,175,806,35,233,Colorado,Colorado Springs,416427
2355,1962-1963,1962-11-15,1963-03-14,120,0,56,321,377,41,35,76,453,23,169,Colorado,Colorado Springs,416427
2356,1963-1964,1963-10-31,1964-04-03,156,0,50,431,481,57,88,145,626,18,134,Colorado,Colorado Springs,416427
2357,1964-1965,1964-11-15,1965-04-27,164,0,64,379,443,61,87,148,591,29,196,Colorado,Colorado Springs,416427
2358,1965-1966,1965-09-20,1966-05-12,235,0,40,386,426,48,44,92,518,27,167,Colorado,Colorado Springs,416427
2359,1966-1967,1966-10-13,1967-04-14,184,0,23,369,392,43,32,75,467,14,96,Colorado,Colorado Springs,416427
2360,1967-1968,1967-11-02,1968-05-16,197,0,47,393,440,53,87,140,580,28,170,Colorado,Colorado Springs,416427
2361,1968-1969,1968-10-16,1969-04-26,193,0,42,400,442,64,61,125,567,30,179,Colorado,Colorado Springs,416427
2362,1969-1970,1969-10-03,1970-04-18,198,0,56,409,465,98,105,203,668,38,211,Colorado,Colorado Springs,416427
2363,1970-1971,1970-09-25,1971-04-22,210,0,52,404,456,51,38,89,545,27,132,Colorado,Colorado Springs,416427
2364,1971-1972,1971-09-16,1972-04-26,224,0,31,380,411,55,48,103,514,26,150,Colorado,Colorado Springs,416427
2365,1972-1973,1972-10-29,1973-05-01,185,0,89,431,520,115,168,283,803,45,317,Colorado,Colorado Springs,416427
2366,1973-1974,1973-10-10,1974-04-15,188,0,47,377,424,58,50,108,532,29,164,Colorado,Colorado Springs,416427
2367,1974-1975,1974-11-03,1975-06-10,220,0,42,426,468,49,36,85,553,35,177,Colorado,Colorado Springs,416427
2368,1975-1976,1975-10-23,1976-04-30,191,0,37,363,400,66,55,121,521,28,165,Colorado,Colorado Springs,416427
2369,1976-1977,1976-10-07,1977-04-04,180,0,33,403,436,61,36,97,533,30,194,Colorado,Colorado Springs,416427
2370,1977-1978,1977-10-31,1978-05-09,191,0,43,372,415,72,39,111,526,37,222,Colorado,Colorado Springs,416427
2371,1978-1979,1978-10-22,1979-05-10,201,0,101,473,574,105,147,252,826,45,305,Colorado,Colorado Springs,416427
2372,1979-1980,1979-10-29,1980-04-30,185,0,48,405,453,108,155,263,716,45,262,Colorado,Colorado Springs,416427
2373,1980-1981,1980-10-27,1981-05-09,195,0,19,292,311,39,19,58,369,29,124,Colorado,Colorado Springs,416427
2374,1981-1982,1981-10-30,1982-05-05,188,0,51,378,429,55,78,133,562,28,180,Colorado,Colorado Springs,416427
2375,1982-1983,1982-10-13,1983-05-13,213,0,43,369,412,63,71,134,546,35,156,Colorado,Colorado Springs,416427
2376,1983-1984,1983-11-08,1984-05-07,182,0,92,464,556,108,140,248,804,46,345,Colorado,Colorado Springs,416427
2377,1984-1985,1984-09-28,1985-04-25,210,0,62,432,494,113,105,218,712,41,268,Colorado,Colorado Springs,416427
2378,1985-1986,1985-09-28,1986-04-04,189,0,55,342,397,51,52,103,500,29,176,Colorado,Colorado Springs,416427
2379,1986-1987,1986-10-12,1987-04-12,183,0,34,363,397,119,164,283,680,33,228,Colorado,Colorado Springs,416427
2380,1987-1988,1987-11-15,1988-05-02,170,0,65,414,479,67,81,148,627,32,218,Colorado,Colorado Springs,416427
2381,1988-1989,1988-11-15,1989-04-30,167,0,63,396,459,61,75,136,595,25,198,Colorado,Colorado Springs,416427
2382,1989-1990,1989-10-16,1990-05-03,200,0,40,361,401,76,66,142,543,35,204,Colorado,Colorado Springs,416427
2383,1990-1991,1990-10-07,1991-05-05,211,0,51,401,452,49,34,83,535,28,144,Colorado,Colorado Springs,416427
2384,1991-1992,1991-10-28,1992-03-22,147,0,27,292,319,65,66,131,450,28,155,Colorado,Colorado Springs,416427
2385,1992-1993,1992-11-02,1993-04-15,165,0,56,392,448,46,25,71,519,25,151,Colorado,Colorado Springs,416427
2386,1993-1994,1993-09-13,1994-04-30,230,0,35,404,439,52,32,84,523,31,165,Colorado,Colorado Springs,416427
2387,1994-1995,1994-10-17,1995-04-26,192,0,36,347,383,66,46,112,495,28,175,Colorado,Colorado Springs,416427
2388,1995-1996,1995-09-21,1996-04-28,221,3,48,447,495,29,14,43,538,19,110,Colorado,Colorado Springs,416427
2389,1997-1998,1997-10-24,1998-04-18,177,0,24,397,421,87,67,154,575,26,150,Colorado,Colorado Springs,416427
2390,1998-1999,1998-10-31,1999-05-01,183,0,35,324,359,59,58,117,476,30,153,Colorado,Colorado Springs,416427
2391,1999-2000,1999-09-28,2000-04-15,201,0,19,294,313,60,70,130,443,23,110,Colorado,Colorado Springs,416427
2392,2000-2001,2000-09-23,2001-05-05,225,0,44,436,480,84,119,203,683,39,194,Colorado,Colorado Springs,416427
2393,2001-2002,2001-09-08,2002-03-25,199,1,28,396,424,29,14,43,467,21,107,Colorado,Colorado Springs,416427
2394,2002-2003,2002-10-22,2003-05-10,201,0,40,341,381,51,31,82,463,37,161,Colorado,Colorado Springs,416427
2395,2003-2004,2003-11-22,2004-04-30,161,0,21,316,337,37,31,68,405,22,96,Colorado,Colorado Springs,416427
2396,2004-2005,2004-10-31,2005-04-29,181,0,28,328,356,52,41,93,449,33,143,Colorado,Colorado Springs,416427
2397,2005-2006,2005-11-05,2006-05-10,187,3,36,391,427,25,22,47,474,14,105,Colorado,Colorado Springs,416427
2398,2006-2007,2006-10-17,2007-04-14,180,0,47,385,432,51,46,97,529,26,170,Colorado,Colorado Springs,416427
2399,2007-2008,2007-11-21,2008-05-01,163,0,39,406,445,53,39,92,537,29,148,Colorado,Colorado Springs,416427
2400,2008-2009,2008-11-27,2009-04-17,142,0,23,323,346,32,18,50,396,24,110,Colorado,Colorado Springs,416427
2401,2009-2010,2009-10-08,2010-04-26,201,0,53,405,458,53,53,106,564,30,154,Colorado,Colorado Springs,416427
2402,2010-2011,2010-11-28,2011-04-27,151,0,42,316,358,23,21,44,402,14,67,Colorado,Colorado Springs,416427
2403,2011-2012,2011-10-25,2012-03-03,131,3,15,292,307,35,52,87,394,17,85,Colorado,Colorado Springs,416427
2404,2012-2013,2012-10-25,2013-05-02,190,3,35,412,447,51,50,101,548,28,165,Colorado,Colorado Springs,416427
2405,2013-2014,2013-10-18,2014-05-11,206,0,60,422,482,53,82,135,617,26,185,Colorado,Colorado Springs,416427
2406,2014-2015,2014-11-10,2015-04-17,159,0,56,344,400,72,121,193,593,33,231,Colorado,Colorado Springs,416427
2407,2015-2016,2015-11-11,2016-05-01,173,0,28,308,336,76,94,170,506,32,169,Colorado,Colorado Springs,416427
2408,2016-2017,2016-12-01,2017-05-18,169,0,33,276,309,41,30,71,380,22,124,Colorado,Colorado Springs,416427
2409,2017-2018,2017-10-09,2018-04-24,198,0,15,342,357,40,22,62,419,25,113,Colorado,Colorado Springs,416427
2410,2018-2019,2018-10-10,2019-05-21,224,0,34,403,437,59,42,101,538,36,179,Colorado,Colorado Springs,416427
2411,2019-2020,2019-10-10,2020-04-16,190,0,31,361,392,79,80,159,551,36,195,Colorado,Colorado Springs,416427
2412,1950-1951,1950-11-02,1951-06-02,213,0,44,386,430,106,103,209,639,39,287,Colorado,Denver,600158
2413,1951-1952,1951-09-21,1952-04-22,215,0,29,382,411,119,80,199,610,43,251,Colorado,Denver,600158
2414,1952-1953,1952-10-14,1953-05-12,211,0,27,353,380,102,137,239,619,39,223,Colorado,Denver,600158
2415,1953-1954,1953-10-23,1954-05-02,192,0,19,296,315,61,82,143,458,30,151,Colorado,Denver,600158
2416,1954-1955,1954-10-25,1955-04-13,171,0,40,393,433,77,129,206,639,33,217,Colorado,Denver,600158
2417,1955-1956,1955-09-20,1956-04-23,217,0,36,374,410,67,81,148,558,28,178,Colorado,Denver,600158
2418,1956-1957,1956-10-24,1957-05-17,206,0,32,348,380,113,90,203,583,40,255,Colorado,Denver,600158
2419,1957-1958,1957-10-24,1958-04-29,188,0,16,307,323,87,74,161,484,45,198,Colorado,Denver,600158
2420,1958-1959,1958-10-28,1959-04-20,175,0,37,358,395,140,169,309,704,43,289,Colorado,Denver,600158
2421,1959-1960,1959-09-28,1960-04-30,216,0,65,415,480,111,179,290,770,41,292,Colorado,Denver,600158
2422,1960-1961,1960-10-14,1961-05-14,213,0,27,370,397,117,134,251,648,40,228,Colorado,Denver,600158
2423,1961-1962,1961-09-03,1962-04-30,240,0,105,515,620,117,219,336,956,43,355,Colorado,Denver,600158
2424,1962-1963,1962-09-08,1963-04-22,227,0,62,428,490,59,58,117,607,29,216,Colorado,Denver,600158
2425,1963-1964,1963-10-31,1964-05-08,191,0,39,456,495,87,86,173,668,38,244,Colorado,Denver,600158
2426,1964-1965,1964-11-14,1965-04-11,149,0,44,380,424,87,115,202,626,41,263,Colorado,Denver,600158
2427,1965-1966,1965-09-20,1966-05-12,235,0,21,415,436,67,94,161,597,32,176,Colorado,Denver,600158
2428,1966-1967,1966-10-13,1967-05-13,213,0,15,363,378,56,48,104,482,26,129,Colorado,Denver,600158
2429,1967-1968,1967-10-29,1968-04-27,182,0,28,435,463,92,108,200,663,37,244,Colorado,Denver,600158
2430,1968-1969,1968-10-08,1969-03-24,168,0,31,401,432,52,74,126,558,28,144,Colorado,Denver,600158
2431,1969-1970,1969-10-03,1970-04-18,198,0,32,428,460,100,125,225,685,44,222,Colorado,Denver,600158
2432,1970-1971,1970-09-24,1971-04-22,211,0,34,420,454,87,112,199,653,36,191,Colorado,Denver,600158
2433,1971-1972,1971-09-16,1972-04-29,227,0,27,398,425,112,89,201,626,33,212,Colorado,Denver,600158
2434,1972-1973,1972-10-29,1973-05-02,186,0,68,432,500,138,230,368,868,55,307,Colorado,Denver,600158
2435,1973-1974,1973-10-10,1974-04-29,202,0,47,396,443,133,271,404,847,47,307,Colorado,Denver,600158
2436,1974-1975,1974-09-12,1975-05-29,260,0,25,413,438,86,58,144,582,41,212,Colorado,Denver,600158
2437,1975-1976,1975-10-23,1976-04-30,191,0,31,331,362,79,115,194,556,34,197,Colorado,Denver,600158
2438,1976-1977,1976-10-26,1977-04-03,160,0,16,331,347,55,41,96,443,26,116,Colorado,Denver,600158
2439,1977-1978,1977-10-31,1978-05-08,190,0,33,337,370,70,48,118,488,29,168,Colorado,Denver,600158
2440,1978-1979,1978-10-22,1979-05-10,201,0,72,451,523,104,138,242,765,46,273,Colorado,Denver,600158
2441,1979-1980,1979-10-29,1980-04-24,179,0,43,368,411,127,261,388,799,50,262,Colorado,Denver,600158
2442,1980-1981,1980-10-27,1981-04-08,164,0,16,235,251,64,71,135,386,25,124,Colorado,Denver,600158
2443,1981-1982,1981-10-24,1982-04-20,179,0,37,318,355,46,77,123,478,28,135,Colorado,Denver,600158
2444,1982-1983,1982-10-19,1983-05-18,212,0,34,341,375,116,255,371,746,35,203,Colorado,Denver,600158
2445,1983-1984,1983-11-08,1984-04-29,174,0,95,443,538,110,222,332,870,42,311,Colorado,Denver,600158
2446,1984-1985,1984-09-25,1985-04-26,214,0,54,408,462,83,113,196,658,40,239,Colorado,Denver,600158
2447,1985-1986,1985-09-28,1986-04-17,202,0,52,324,376,95,144,239,615,34,223,Colorado,Denver,600158
2448,1986-1987,1986-10-10,1987-04-20,193,0,26,319,345,102,110,212,557,41,209,Colorado,Denver,600158
2449,1987-1988,1987-11-15,1988-05-02,170,0,51,399,450,93,232,325,775,33,233,Colorado,Denver,600158
2450,1988-1989,1988-11-15,1989-04-30,167,0,57,374,431,73,134,207,638,32,228,Colorado,Denver,600158
2451,1989-1990,1989-09-12,1990-05-09,240,0,36,326,362,98,124,222,584,41,238,Colorado,Denver,600158
2452,1990-1991,1990-10-07,1991-04-30,206,0,50,354,404,86,95,181,585,41,244,Colorado,Denver,600158
2453,1991-1992,1991-10-04,1992-03-31,180,0,16,297,313,110,196,306,619,33,210,Colorado,Denver,600158
2454,1992-1993,1992-10-29,1993-04-24,178,0,49,412,461,86,207,293,754,36,225,Colorado,Denver,600158
2455,1993-1994,1993-09-13,1994-04-29,229,0,21,353,374,96,100,196,570,40,203,Colorado,Denver,600158
2456,1994-1995,1994-09-21,1995-04-11,203,6,31,308,339,55,69,124,463,22,133,Colorado,Denver,600158
2457,1995-1996,1995-09-20,1996-04-28,222,2,52,403,455,74,44,118,573,35,224,Colorado,Denver,600158
2458,1996-1997,1996-09-25,1997-05-02,220,0,49,381,430,72,56,128,558,45,225,Colorado,Denver,600158
2459,1997-1998,1997-10-12,1998-04-20,191,1,20,331,351,106,86,192,543,40,201,Colorado,Denver,600158
2460,1998-1999,1998-11-07,1999-04-24,169,0,32,281,313,65,68,133,446,25,155,Colorado,Denver,600158
2461,1999-2000,1999-09-28,2000-04-16,202,2,6,266,272,62,63,125,397,21,110,Colorado,Denver,600158
2462,2000-2001,2000-09-24,2001-05-21,240,2,40,417,457,81,98,179,636,31,196,Colorado,Denver,600158
2463,2001-2002,2001-10-05,2002-05-24,232,1,34,378,412,47,57,104,516,27,147,Colorado,Denver,600158
2464,2002-2003,2002-10-24,2003-05-11,200,1,28,362,390,85,105,190,580,28,174,Colorado,Denver,600158
2465,2003-2004,2003-10-31,2004-05-01,184,1,24,350,374,50,74,124,498,24,115,Colorado,Denver,600158
2466,2004-2005,2004-11-01,2005-05-02,183,0,24,306,330,67,63,130,460,35,168,Colorado,Denver,600158
2467,2005-2006,2005-10-10,2006-05-10,213,1,41,352,393,45,48,93,486,21,128,Colorado,Denver,600158
2468,2006-2007,2006-10-18,2007-04-14,179,0,54,407,461,104,368,472,933,34,277,Colorado,Denver,600158
2469,2007-2008,2007-10-22,2008-05-14,206,0,38,421,459,72,130,202,661,41,220,Colorado,Denver,600158
2470,2008-2009,2008-11-14,2009-04-28,166,0,37,343,380,47,36,83,463,31,161,Colorado,Denver,600158
2471,2009-2010,2009-10-11,2010-05-12,214,6,48,416,464,72,143,215,679,37,206,Colorado,Denver,600158
2472,2010-2011,2010-11-10,2011-04-04,146,0,46,363,409,40,71,111,520,20,127,Colorado,Denver,600158
2473,2011-2012,2011-10-26,2012-04-04,162,0,33,353,386,76,151,227,613,25,176,Colorado,Denver,600158
2474,2012-2013,2012-10-05,2013-05-02,210,0,42,430,472,80,75,155,627,30,182,Colorado,Denver,600158
2475,2013-2014,2013-10-18,2014-05-13,208,4,67,397,464,57,77,134,598,34,197,Colorado,Denver,600158
2476,2014-2015,2014-11-11,2015-05-10,181,3,58,330,388,88,133,221,609,31,226,Colorado,Denver,600158
2477,2015-2016,2015-11-05,2016-05-02,180,0,33,312,345,104,198,302,647,37,201,Colorado,Denver,600158
2478,2016-2017,2016-11-18,2017-04-30,164,0,35,314,349,41,65,106,455,18,136,Colorado,Denver,600158
2479,2017-2018,2017-10-09,2018-04-22,196,0,36,359,395,42,46,88,483,25,127,Colorado,Denver,600158
2480,2018-2019,2018-10-14,2019-05-21,220,0,43,389,432,67,90,157,589,33,183,Colorado,Denver,600158
2481,2019-2020,2019-10-11,2020-04-17,190,0,39,359,398,99,165,264,662,35,227,Colorado,Denver,600158
2482,1964-1965,1964-10-24,1965-05-26,215,0,112,926,1038,239,1077,1316,2354,57,490,Colorado,Dillon,904
2483,1965-1966,1965-09-20,1966-05-12,235,1,89,1036,1125,144,514,658,1783,43,306,Colorado,Dillon,904
2484,1966-1967,1966-10-03,1967-05-20,230,0,86,870,956,203,646,849,1805,56,423,Colorado,Dillon,904
2485,1967-1968,1967-09-19,1968-05-26,251,2,76,1011,1087,184,708,892,1979,49,396,Colorado,Dillon,904
2486,1968-1969,1968-09-04,1969-06-26,296,0,101,1044,1145,190,517,707,1852,51,414,Colorado,Dillon,904
2487,1969-1970,1969-10-03,1970-06-11,252,0,111,1045,1156,262,865,1127,2283,53,461,Colorado,Dillon,904
2488,1970-1971,1970-09-22,1971-06-09,261,2,118,986,1104,235,284,519,1623,69,508,Colorado,Dillon,904
2489,1971-1972,1971-09-04,1972-05-14,254,5,95,962,1057,159,462,621,1678,46,371,Colorado,Dillon,904
2490,1972-1973,1972-09-29,1973-06-16,261,2,101,1043,1144,198,540,738,1882,56,411,Colorado,Dillon,904
2491,1973-1974,1973-09-26,1974-06-09,257,8,99,931,1030,272,615,887,1917,64,554,Colorado,Dillon,904
2492,1974-1975,1974-10-31,1975-06-10,223,0,108,961,1069,156,479,635,1704,45,372,Colorado,Dillon,904
2493,1975-1976,1975-10-08,1976-06-24,261,3,78,903,981,164,402,566,1547,45,350,Colorado,Dillon,904
2494,1976-1977,1976-09-27,1977-05-15,231,1,104,1018,1122,125,227,352,1474,34,288,Colorado,Dillon,904
2495,1977-1978,1977-09-23,1978-05-13,233,1,94,838,932,222,1065,1287,2219,74,540,Colorado,Dillon,904
2496,1978-1979,1978-09-20,1979-06-19,273,3,166,1070,1236,207,1034,1241,2477,75,580,Colorado,Dillon,904
2497,1979-1980,1979-10-16,1980-05-17,215,0,105,999,1104,192,1242,1434,2538,72,505,Colorado,Dillon,904
2498,1980-1981,1980-10-15,1981-05-18,216,0,50,786,836,102,137,239,1075,43,253,Colorado,Dillon,904
2499,1981-1982,1981-10-15,1982-05-26,224,1,118,876,994,199,669,868,1862,74,543,Colorado,Dillon,904
2500,1982-1983,1982-10-06,1983-06-14,252,9,91,995,1086,220,743,963,2049,82,546,Colorado,Dillon,904
2501,1983-1984,1983-10-03,1984-06-09,251,4,158,1016,1174,247,1250,1497,2671,93,689,Colorado,Dillon,904
2502,1984-1985,1984-09-25,1985-06-27,276,1,112,991,1103,143,592,735,1838,67,458,Colorado,Dillon,904
2503,1985-1986,1985-09-22,1986-05-16,237,6,69,841,910,194,732,926,1836,70,485,Colorado,Dillon,904
2504,1986-1987,1986-09-26,1987-05-04,221,3,89,947,1036,129,434,563,1599,60,382,Colorado,Dillon,904
2505,1987-1988,1987-10-16,1988-05-21,219,4,141,979,1120,158,761,919,2039,60,467,Colorado,Dillon,904
2506,1988-1989,1988-11-04,1989-05-15,193,3,109,852,961,147,410,557,1518,47,345,Colorado,Dillon,904
2507,1989-1990,1989-09-13,1990-05-16,246,1,98,914,1012,132,502,634,1646,56,368,Colorado,Dillon,904
2508,1990-1991,1990-10-08,1991-05-16,221,2,106,992,1098,158,343,501,1599,57,417,Colorado,Dillon,904
2509,1991-1992,1991-09-15,1992-06-01,261,1,70,939,1009,149,508,657,1666,63,434,Colorado,Dillon,904
2510,1992-1993,1992-09-25,1993-06-07,256,6,105,952,1057,190,744,934,1991,78,507,Colorado,Dillon,904
2511,1993-1994,1993-09-14,1994-05-04,233,6,100,964,1064,128,232,360,1424,62,419,Colorado,Dillon,904
2512,1994-1995,1994-10-06,1995-05-25,232,6,81,847,928,175,287,462,1390,69,434,Colorado,Dillon,904
2513,1995-1996,1995-09-30,1996-05-27,241,13,94,916,1010,278,1008,1286,2296,68,565,Colorado,Dillon,904
2514,1996-1997,1996-09-19,1997-05-02,226,8,104,924,1028,211,855,1066,2094,68,524,Colorado,Dillon,904
2515,1998-1999,1998-10-04,1999-05-11,220,4,75,828,903,142,329,471,1374,56,363,Colorado,Dillon,904
2516,1999-2000,1999-10-17,2000-05-18,215,6,61,820,881,146,417,563,1444,54,367,Colorado,Dillon,904
2517,2000-2001,2000-09-24,2001-05-21,240,8,84,957,1041,154,618,772,1813,53,380,Colorado,Dillon,904
2518,2001-2002,2001-09-08,2002-05-24,259,7,109,1030,1139,99,183,282,1421,39,298,Colorado,Dillon,904
2519,2002-2003,2002-10-27,2003-06-07,224,1,97,848,945,201,419,620,1565,63,493,Colorado,Dillon,904
2520,2003-2004,2003-11-04,2004-05-31,210,2,101,829,930,112,381,493,1423,50,341,Colorado,Dillon,904
2521,2004-2005,2004-10-13,2005-06-13,244,1,78,889,967,151,307,458,1425,54,354,Colorado,Dillon,904
2522,2005-2006,2005-10-10,2006-04-29,202,8,132,892,1024,162,843,1005,2029,60,456,Colorado,Dillon,904
2523,2006-2007,2006-09-21,2007-05-30,252,6,122,940,1062,184,349,533,1595,62,512,Colorado,Dillon,904
2524,2007-2008,2007-10-14,2008-06-08,239,0,174,1046,1220,212,1061,1273,2493,71,587,Colorado,Dillon,904
2525,2008-2009,2008-10-22,2009-05-04,195,0,112,821,933,174,656,830,1763,60,478,Colorado,Dillon,904
2526,2009-2010,2009-10-02,2010-06-13,255,0,120,1087,1207,141,355,496,1703,56,432,Colorado,Dillon,904
2527,2010-2011,2010-10-13,2011-06-20,251,3,137,982,1119,243,687,930,2049,86,656,Colorado,Dillon,904
2528,2011-2012,2011-10-09,2012-05-24,229,3,64,939,1003,105,224,329,1332,47,306,Colorado,Dillon,904
2529,2012-2013,2012-10-17,2013-05-30,226,0,133,1005,1138,202,547,749,1887,68,590,Colorado,Dillon,904
2530,2013-2014,2013-10-04,2014-05-15,224,4,119,947,1066,277,551,828,1894,76,623,Colorado,Dillon,904
2531,2014-2015,2014-10-02,2015-05-17,228,4,91,810,901,156,366,522,1423,54,394,Colorado,Dillon,904
2532,2015-2016,2015-10-23,2016-05-09,200,0,122,892,1014,177,762,939,1953,61,487,Colorado,Dillon,904
2533,2016-2017,2016-10-06,2017-05-23,230,0,105,790,895,256,699,955,1850,67,574,Colorado,Dillon,904
2534,2017-2018,2017-10-02,2018-05-05,216,0,58,819,877,202,391,593,1470,60,457,Colorado,Dillon,904
2535,2018-2019,2018-10-09,2019-06-23,258,0,109,987,1096,227,958,1185,2281,76,555,Colorado,Dillon,904
2536,2019-2020,2019-10-10,2020-06-09,244,2,124,979,1103,166,698,864,1967,65,476,Colorado,Dillon,904
2537,1950-1951,1950-11-08,1951-04-21,165,9,47,472,519,56,56,112,631,26,195,Colorado,Fort Collins,143986
2538,1951-1952,1951-10-21,1952-04-09,172,1,40,509,549,69,135,204,753,30,186,Colorado,Fort Collins,143986
2539,1952-1953,1952-10-06,1953-04-18,195,0,26,464,490,68,82,150,640,25,148,Colorado,Fort Collins,143986
2540,1953-1954,1953-11-18,1954-05-02,166,6,17,381,398,36,34,70,468,14,81,Colorado,Fort Collins,143986
2541,1954-1955,1954-10-25,1955-04-12,170,0,43,517,560,73,105,178,738,24,184,Colorado,Fort Collins,143986
2542,1955-1956,1955-11-11,1956-04-24,166,1,55,465,520,94,213,307,827,28,203,Colorado,Fort Collins,143986
2543,1956-1957,1956-11-01,1957-05-16,197,0,36,442,478,83,114,197,675,27,212,Colorado,Fort Collins,143986
2544,1957-1958,1957-10-25,1958-04-29,187,0,19,397,416,54,66,120,536,31,149,Colorado,Fort Collins,143986
2545,1958-1959,1958-10-29,1959-04-14,168,1,45,431,476,101,194,295,771,34,237,Colorado,Fort Collins,143986
2546,1959-1960,1959-09-29,1960-04-29,214,1,66,493,559,64,103,167,726,30,200,Colorado,Fort Collins,143986
2547,1962-1963,1962-11-14,1963-03-15,122,0,63,415,478,68,154,222,700,29,217,Colorado,Fort Collins,143986
2548,1963-1964,1963-12-01,1964-04-07,129,0,32,405,437,69,122,191,628,26,179,Colorado,Fort Collins,143986
2549,1964-1965,1964-11-14,1965-04-18,156,0,48,422,470,69,75,144,614,28,199,Colorado,Fort Collins,143986
2550,1965-1966,1965-12-01,1966-05-12,163,1,36,396,432,39,102,141,573,17,104,Colorado,Fort Collins,143986
2551,1966-1967,1966-10-14,1967-05-13,212,3,17,367,384,53,46,99,483,24,126,Colorado,Fort Collins,143986
2552,1968-1969,1968-11-06,1969-03-14,129,12,37,361,398,51,46,97,495,23,128,Colorado,Fort Collins,143986
2553,1969-1970,1969-10-11,1970-04-22,194,1,31,399,430,75,76,151,581,21,129,Colorado,Fort Collins,143986
2554,1970-1971,1970-10-07,1971-04-04,180,0,40,394,434,76,137,213,647,19,144,Colorado,Fort Collins,143986
2555,1973-1974,1973-11-02,1974-04-13,163,0,43,366,409,78,132,210,619,24,151,Colorado,Fort Collins,143986
2556,1975-1976,1975-10-23,1976-04-27,188,0,37,399,436,80,169,249,685,18,154,Colorado,Fort Collins,143986
2557,1976-1977,1976-10-26,1977-04-03,160,1,16,412,428,41,25,66,494,18,90,Colorado,Fort Collins,143986
2558,1977-1978,1977-11-19,1978-05-07,170,8,45,355,400,87,99,186,586,29,182,Colorado,Fort Collins,143986
2559,1979-1980,1979-10-29,1980-04-11,166,0,50,456,506,154,434,588,1094,42,317,Colorado,Fort Collins,143986
2560,1980-1981,1980-10-27,1981-04-04,160,19,13,307,320,56,45,101,421,17,97,Colorado,Fort Collins,143986
2561,1983-1984,1983-11-08,1984-04-26,171,0,81,449,530,120,236,356,886,38,302,Colorado,Fort Collins,143986
2562,1984-1985,1984-09-25,1985-04-26,214,1,48,443,491,64,156,220,711,30,173,Colorado,Fort Collins,143986
2563,1985-1986,1985-09-28,1986-04-26,211,0,54,378,432,108,319,427,859,37,260,Colorado,Fort Collins,143986
2564,1986-1987,1986-10-11,1987-04-20,192,0,14,366,380,94,109,203,583,38,180,Colorado,Fort Collins,143986
2565,1987-1988,1987-11-15,1988-04-22,160,0,49,416,465,128,210,338,803,36,271,Colorado,Fort Collins,143986
2566,1988-1989,1988-11-15,1989-05-01,168,0,56,425,481,88,246,334,815,32,228,Colorado,Fort Collins,143986
2567,1989-1990,1989-09-12,1990-04-05,206,0,37,358,395,112,184,296,691,36,247,Colorado,Fort Collins,143986
2568,1990-1991,1990-10-07,1991-05-04,210,0,47,417,464,56,95,151,615,24,163,Colorado,Fort Collins,143986
2569,1991-1992,1991-10-28,1992-03-22,147,0,10,309,319,77,98,175,494,23,120,Colorado,Fort Collins,143986
2570,1992-1993,1992-11-02,1993-04-13,163,0,59,406,465,95,284,379,844,36,239,Colorado,Fort Collins,143986
2571,1993-1994,1993-09-13,1994-04-30,230,0,22,394,416,89,89,178,594,41,203,Colorado,Fort Collins,143986
2572,1994-1995,1994-10-17,1995-04-27,193,0,25,339,364,62,84,146,510,31,155,Colorado,Fort Collins,143986
2573,1995-1996,1995-09-20,1996-04-13,207,0,43,394,437,74,85,159,596,28,193,Colorado,Fort Collins,143986
2574,1996-1997,1996-09-27,1997-04-24,210,0,45,368,413,84,102,186,599,36,205,Colorado,Fort Collins,143986
2575,1997-1998,1997-10-24,1998-04-18,177,0,14,321,335,81,79,160,495,26,142,Colorado,Fort Collins,143986
2576,1998-1999,1998-11-07,1999-05-10,185,0,31,270,301,60,71,131,432,28,148,Colorado,Fort Collins,143986
2577,1999-2000,1999-09-28,2000-04-16,202,0,0,259,259,60,41,101,360,21,89,Colorado,Fort Collins,143986
2578,2000-2001,2000-09-23,2001-05-20,240,0,23,394,417,81,62,143,560,34,164,Colorado,Fort Collins,143986
2579,2001-2002,2001-11-08,2002-05-24,198,2,18,384,402,67,75,142,544,27,149,Colorado,Fort Collins,143986
2580,2002-2003,2002-10-23,2003-05-10,200,0,16,321,337,102,122,224,561,30,190,Colorado,Fort Collins,143986
2581,2003-2004,2003-10-31,2004-04-12,165,3,16,306,322,41,85,126,448,17,79,Colorado,Fort Collins,143986
2582,2004-2005,2004-11-14,2005-05-01,169,0,16,282,298,76,123,199,497,26,148,Colorado,Fort Collins,143986
2583,2005-2006,2005-12-01,2006-03-22,112,1,26,264,290,40,41,81,371,18,118,Colorado,Fort Collins,143986
2584,2006-2007,2006-10-17,2007-04-08,174,0,29,378,407,80,440,520,927,26,175,Colorado,Fort Collins,143986
2585,2007-2008,2007-11-21,2008-04-10,142,0,27,348,375,60,192,252,627,25,128,Colorado,Fort Collins,143986
2586,2008-2009,2008-12-01,2009-04-27,148,1,25,294,319,60,66,126,445,23,129,Colorado,Fort Collins,143986
2587,2009-2010,2009-10-09,2010-05-12,216,0,38,386,424,126,289,415,839,35,229,Colorado,Fort Collins,143986
2588,2010-2011,2010-11-11,2011-04-23,164,0,28,327,355,35,45,80,435,17,104,Colorado,Fort Collins,143986
2589,2011-2012,2011-10-26,2012-02-29,127,0,7,287,294,72,128,200,494,16,104,Colorado,Fort Collins,143986
2590,2012-2013,2012-10-25,2013-05-02,190,0,20,391,411,112,111,223,634,31,197,Colorado,Fort Collins,143986
2591,2013-2014,2013-10-18,2014-05-12,207,2,49,393,442,73,155,228,670,32,228,Colorado,Fort Collins,143986
2592,2014-2015,2014-11-11,2015-05-10,181,0,39,321,360,64,140,204,564,30,197,Colorado,Fort Collins,143986
2593,2015-2016,2015-11-11,2016-05-01,173,0,22,295,317,104,276,380,697,28,171,Colorado,Fort Collins,143986
2594,2016-2017,2016-11-17,2017-05-19,184,0,28,287,315,49,78,127,442,21,118,Colorado,Fort Collins,143986
2595,2017-2018,2017-10-09,2018-04-21,195,0,25,321,346,53,60,113,459,25,144,Colorado,Fort Collins,143986
2596,2018-2019,2018-10-10,2019-05-21,224,0,26,383,409,75,56,131,540,29,172,Colorado,Fort Collins,143986
2597,2019-2020,2019-10-10,2020-04-18,192,0,19,354,373,104,215,319,692,38,216,Colorado,Fort Collins,143986
2598,1950-1951,1950-11-10,1951-04-26,168,0,28,282,310,38,54,92,402,17,79,Colorado,Grand Junction,58566
2599,1951-1952,1951-11-14,1952-03-24,132,0,46,310,356,46,12,58,414,38,137,Colorado,Grand Junction,58566
2600,1952-1953,1952-11-16,1953-04-11,147,0,20,275,295,48,20,68,363,28,101,Colorado,Grand Junction,58566
2601,1953-1954,1953-11-18,1954-03-25,128,0,7,236,243,22,9,31,274,14,49,Colorado,Grand Junction,58566
2602,1954-1955,1954-11-29,1955-04-12,135,0,55,361,416,59,81,140,556,27,166,Colorado,Grand Junction,58566
2603,1955-1956,1955-11-14,1956-03-14,122,0,11,222,233,34,14,48,281,18,69,Colorado,Grand Junction,58566
2604,1956-1957,1956-10-24,1957-04-25,184,0,50,354,404,70,299,369,773,32,156,Colorado,Grand Junction,58566
2605,1957-1958,1957-11-14,1958-03-10,117,0,4,202,206,33,16,49,255,22,61,Colorado,Grand Junction,58566
2606,1958-1959,1958-11-16,1959-03-19,124,0,7,228,235,29,13,42,277,19,65,Colorado,Grand Junction,58566
2607,1959-1960,1959-11-04,1960-03-16,134,0,22,274,296,47,44,91,387,30,124,Colorado,Grand Junction,58566
2608,1960-1961,1960-11-15,1961-04-07,144,0,2,272,274,20,4,24,298,12,35,Colorado,Grand Junction,58566
2609,1961-1962,1961-11-02,1962-04-30,180,0,49,351,400,38,123,161,561,26,109,Colorado,Grand Junction,58566
2610,1962-1963,1962-11-18,1963-04-02,136,0,86,356,442,46,186,232,674,18,119,Colorado,Grand Junction,58566
2611,1963-1964,1963-12-01,1964-04-25,147,0,16,360,376,31,72,103,479,19,75,Colorado,Grand Junction,58566
2612,1964-1965,1964-11-13,1965-04-09,148,0,15,256,271,50,65,115,386,24,102,Colorado,Grand Junction,58566
2613,1965-1966,1965-09-18,1966-04-19,214,0,9,279,288,46,62,108,396,26,106,Colorado,Grand Junction,58566
2614,1966-1967,1966-10-13,1967-04-25,195,0,32,284,316,29,110,139,455,16,68,Colorado,Grand Junction,58566
2615,1967-1968,1967-11-29,1968-04-19,143,0,90,392,482,40,238,278,760,26,144,Colorado,Grand Junction,58566
2616,1968-1969,1968-11-13,1969-03-12,120,0,32,314,346,44,76,120,466,27,117,Colorado,Grand Junction,58566
2617,1969-1970,1969-10-11,1970-04-29,201,0,13,266,279,43,12,55,334,26,80,Colorado,Grand Junction,58566
2618,1970-1971,1970-10-07,1971-04-20,196,0,25,340,365,24,23,47,412,18,94,Colorado,Grand Junction,58566
2619,1971-1972,1971-10-29,1972-02-29,124,0,28,299,327,28,80,108,435,17,94,Colorado,Grand Junction,58566
2620,1972-1973,1972-10-29,1973-04-18,172,0,88,447,535,60,294,354,889,35,176,Colorado,Grand Junction,58566
2621,1973-1974,1973-11-19,1974-04-13,146,0,65,400,465,56,281,337,802,27,139,Colorado,Grand Junction,58566
2622,1974-1975,1974-11-03,1975-05-06,185,0,39,362,401,66,94,160,561,31,148,Colorado,Grand Junction,58566
2623,1975-1976,1975-10-23,1976-04-16,177,0,32,387,419,43,88,131,550,23,114,Colorado,Grand Junction,58566
2624,1976-1977,1976-11-27,1977-04-02,127,0,19,372,391,16,11,27,418,12,44,Colorado,Grand Junction,58566
2625,1977-1978,1977-11-19,1978-03-14,116,0,13,173,186,34,46,80,266,20,63,Colorado,Grand Junction,58566
2626,1978-1979,1978-11-14,1979-05-08,176,0,112,462,574,82,414,496,1070,37,229,Colorado,Grand Junction,58566
2627,1979-1980,1979-11-19,1980-04-02,136,0,19,232,251,39,63,102,353,23,72,Colorado,Grand Junction,58566
2628,1980-1981,1980-12-01,1981-03-30,120,0,1,144,145,9,5,14,159,6,18,Colorado,Grand Junction,58566
2629,1981-1982,1981-10-30,1982-03-03,125,0,27,240,267,24,78,102,369,20,59,Colorado,Grand Junction,58566
2630,1982-1983,1982-12-01,1983-04-03,124,0,4,133,137,24,16,40,177,17,38,Colorado,Grand Junction,58566
2631,1983-1984,1983-11-08,1984-04-27,172,0,33,296,329,53,301,354,683,26,91,Colorado,Grand Junction,58566
2632,1984-1985,1984-10-17,1985-04-20,186,0,12,225,237,35,10,45,282,27,66,Colorado,Grand Junction,58566
2633,1985-1986,1985-11-09,1986-04-17,160,0,9,183,192,20,10,30,222,13,40,Colorado,Grand Junction,58566
2634,1986-1987,1986-10-12,1987-04-12,183,0,8,256,264,38,24,62,326,22,77,Colorado,Grand Junction,58566
2635,1987-1988,1987-11-14,1988-03-31,139,0,44,403,447,41,248,289,736,24,108,Colorado,Grand Junction,58566
2636,1988-1989,1988-11-25,1989-03-20,116,0,46,352,398,50,133,183,581,24,106,Colorado,Grand Junction,58566
2637,1989-1990,1989-12-01,1990-04-29,150,0,10,254,264,30,39,69,333,18,74,Colorado,Grand Junction,58566
2638,1990-1991,1990-11-26,1991-04-27,153,0,64,422,486,45,244,289,775,23,110,Colorado,Grand Junction,58566
2639,1991-1992,1991-10-28,1992-02-29,125,0,38,304,342,29,76,105,447,19,69,Colorado,Grand Junction,58566
2640,1992-1993,1992-11-10,1993-04-13,155,0,21,246,267,39,20,59,326,27,88,Colorado,Grand Junction,58566
2641,1993-1994,1993-11-14,1994-03-24,131,0,9,248,257,21,17,38,295,16,51,Colorado,Grand Junction,58566
2642,1994-1995,1994-11-13,1995-03-29,137,0,4,181,185,26,6,32,217,17,51,Colorado,Grand Junction,58566
2643,1995-1996,1995-10-22,1996-03-25,156,0,3,227,230,20,3,23,253,15,44,Colorado,Grand Junction,58566
2644,1996-1997,1996-10-20,1997-04-05,168,0,11,260,271,37,14,51,322,22,70,Colorado,Grand Junction,58566
2645,1997-1998,1997-10-24,1998-04-02,161,0,6,271,277,21,1,22,299,15,44,Colorado,Grand Junction,58566
2646,1998-1999,1998-11-08,1999-04-03,147,0,22,270,292,28,24,52,344,14,64,Colorado,Grand Junction,58566
2647,1999-2000,1999-12-01,2000-03-21,112,0,9,188,197,23,5,28,225,15,47,Colorado,Grand Junction,58566
2648,2000-2001,2000-11-05,2001-03-12,128,0,7,274,281,31,8,39,320,23,61,Colorado,Grand Junction,58566
2649,2001-2002,2001-11-25,2002-03-14,110,0,14,300,314,30,10,40,354,21,78,Colorado,Grand Junction,58566
2650,2002-2003,2002-11-25,2003-05-09,166,0,4,199,203,21,5,26,229,14,45,Colorado,Grand Junction,58566
2651,2003-2004,2003-11-22,2004-02-29,100,0,40,294,334,33,91,124,458,16,78,Colorado,Grand Junction,58566
2652,2004-2005,2004-10-31,2005-03-30,151,0,15,212,227,34,56,90,317,16,66,Colorado,Grand Junction,58566
2653,2005-2006,2005-12-01,2006-03-30,120,0,12,239,251,21,11,32,283,13,39,Colorado,Grand Junction,58566
2654,2006-2007,2006-10-26,2007-04-12,169,0,36,310,346,28,42,70,416,17,80,Colorado,Grand Junction,58566
2655,2007-2008,2007-12-01,2008-05-01,153,0,52,337,389,40,123,163,552,30,136,Colorado,Grand Junction,58566
2656,2008-2009,2008-12-01,2009-04-04,125,0,32,276,308,34,125,159,467,18,96,Colorado,Grand Junction,58566
2657,2009-2010,2009-10-27,2010-04-29,185,0,67,440,507,43,254,297,804,24,102,Colorado,Grand Junction,58566
2658,2010-2011,2010-11-15,2011-04-30,167,0,37,295,332,23,55,78,410,15,64,Colorado,Grand Junction,58566
2659,2011-2012,2011-12-01,2012-03-02,93,0,4,217,221,16,5,21,242,12,36,Colorado,Grand Junction,58566
2660,2012-2013,2012-11-10,2013-04-17,159,0,79,408,487,38,144,182,669,23,133,Colorado,Grand Junction,58566
2661,2013-2014,2013-10-03,2014-02-28,149,0,56,370,426,38,247,285,711,17,103,Colorado,Grand Junction,58566
2662,2014-2015,2014-11-13,2015-04-16,155,0,13,248,261,20,23,43,304,13,47,Colorado,Grand Junction,58566
2663,2015-2016,2015-11-05,2016-03-23,140,0,37,329,366,46,145,191,557,27,128,Colorado,Grand Junction,58566
2664,2016-2017,2016-11-17,2017-02-28,104,0,12,183,195,25,17,42,237,15,54,Colorado,Grand Junction,58566
2665,2017-2018,2017-12-01,2018-03-18,108,0,1,230,231,15,6,21,252,10,38,Colorado,Grand Junction,58566
2666,2018-2019,2018-11-24,2019-02-28,97,0,23,219,242,31,40,71,313,20,83,Colorado,Grand Junction,58566
2667,2019-2020,2019-10-29,2020-03-27,151,0,20,288,308,24,15,39,347,16,58,Colorado,Grand Junction,58566
2668,1950-1951,1950-11-09,1951-03-17,129,9,31,413,444,23,17,40,484,11,79,Colorado,Lamar,7804
2669,1952-1953,1952-11-24,1953-04-11,139,7,17,341,358,16,24,40,398,8,39,Colorado,Lamar,7804
2670,1953-1954,1953-11-19,1954-05-01,164,1,14,350,364,39,51,90,454,14,90,Colorado,Lamar,7804
2671,1954-1955,1954-11-29,1955-03-26,118,3,12,369,381,17,16,33,414,13,77,Colorado,Lamar,7804
2672,1955-1956,1955-10-23,1956-04-09,170,5,29,477,506,40,68,108,614,19,121,Colorado,Lamar,7804
2673,1956-1957,1956-11-01,1957-04-12,163,6,24,396,420,35,8,43,463,18,98,Colorado,Lamar,7804
2674,1957-1958,1957-11-03,1958-03-28,146,0,22,349,371,50,39,89,460,24,116,Colorado,Lamar,7804
2675,1958-1959,1958-11-17,1959-04-11,146,0,31,399,430,47,47,94,524,15,123,Colorado,Lamar,7804
2676,1959-1960,1959-10-30,1960-04-29,183,1,66,485,551,65,194,259,810,18,163,Colorado,Lamar,7804
2677,1960-1961,1960-11-08,1961-04-08,152,0,14,353,367,48,78,126,493,17,84,Colorado,Lamar,7804
2678,1962-1963,1962-11-16,1963-03-13,118,2,39,399,438,33,24,57,495,18,128,Colorado,Lamar,7804
2679,1963-1964,1963-12-01,1964-04-07,129,0,25,424,449,40,46,86,535,23,119,Colorado,Lamar,7804
2680,1964-1965,1964-11-18,1965-03-25,128,0,24,398,422,29,23,52,474,21,106,Colorado,Lamar,7804
2681,1966-1967,1966-12-01,1967-03-07,97,0,17,315,332,18,32,50,382,8,46,Colorado,Lamar,7804
2682,1967-1968,1967-10-29,1968-03-11,135,0,19,325,344,30,24,54,398,15,84,Colorado,Lamar,7804
2683,1968-1969,1968-12-01,1969-03-17,107,0,20,317,337,36,56,92,429,7,59,Colorado,Lamar,7804
2684,1969-1970,1969-10-11,1970-04-30,202,1,13,366,379,41,17,58,437,13,65,Colorado,Lamar,7804
2685,1970-1971,1970-10-07,1971-03-05,150,3,25,317,342,30,31,61,403,11,57,Colorado,Lamar,7804
2686,1971-1972,1971-10-29,1972-03-28,152,0,24,307,331,24,23,47,378,10,62,Colorado,Lamar,7804
2687,1973-1974,1973-11-19,1974-04-03,136,0,49,328,377,41,140,181,558,13,93,Colorado,Lamar,7804
2688,1974-1975,1974-11-30,1975-04-02,124,0,18,319,337,25,43,68,405,9,59,Colorado,Lamar,7804
2689,1975-1976,1975-11-19,1976-03-04,107,0,21,254,275,40,53,93,368,9,78,Colorado,Lamar,7804
2690,1976-1977,1976-10-26,1977-03-11,137,4,21,351,372,28,23,51,423,11,67,Colorado,Lamar,7804
2691,1977-1978,1977-12-01,1978-03-03,93,1,42,302,344,25,59,84,428,12,87,Colorado,Lamar,7804
2692,1978-1979,1978-11-11,1979-04-03,144,0,74,395,469,43,61,104,573,18,138,Colorado,Lamar,7804
2693,1979-1980,1979-10-30,1980-04-07,161,1,33,352,385,90,100,190,575,22,143,Colorado,Lamar,7804
2694,1980-1981,1980-11-13,1981-03-21,129,0,13,283,296,28,24,52,348,11,72,Colorado,Lamar,7804
2695,1981-1982,1981-12-01,1982-03-05,95,0,41,298,339,20,58,78,417,9,71,Colorado,Lamar,7804
2696,1982-1983,1982-12-01,1983-04-13,134,0,15,277,292,33,91,124,416,13,66,Colorado,Lamar,7804
2697,1983-1984,1983-11-26,1984-04-02,129,5,79,371,450,75,122,197,647,21,194,Colorado,Lamar,7804
2698,1984-1985,1984-09-28,1985-03-30,184,16,35,325,360,35,76,111,471,11,79,Colorado,Lamar,7804
2699,1985-1986,1985-09-28,1986-02-28,154,12,29,272,301,22,14,36,337,12,61,Colorado,Lamar,7804
2700,1987-1988,1987-11-15,1988-04-02,140,20,31,444,475,62,79,141,616,16,123,Colorado,Lamar,7804
2701,1988-1989,1988-12-01,1989-03-21,111,8,31,408,439,13,7,20,459,6,67,Colorado,Lamar,7804
2702,1989-1990,1989-12-01,1990-03-25,115,0,30,375,405,62,92,154,559,8,92,Colorado,Lamar,7804
2703,1990-1991,1990-11-03,1991-03-17,135,0,40,403,443,26,25,51,494,7,63,Colorado,Lamar,7804
2704,1991-1992,1991-10-31,1992-02-29,122,2,12,385,397,54,58,112,509,13,102,Colorado,Lamar,7804
2705,1992-1993,1992-11-11,1993-04-04,145,1,63,464,527,88,231,319,846,20,172,Colorado,Lamar,7804
2706,1993-1994,1993-10-29,1994-04-28,182,3,24,474,498,37,38,75,573,11,66,Colorado,Lamar,7804
2707,1994-1995,1994-11-21,1995-04-20,151,3,20,307,327,42,41,83,410,13,86,Colorado,Lamar,7804
2708,1995-1996,1995-09-21,1996-04-14,207,1,37,509,546,28,26,54,600,11,88,Colorado,Lamar,7804
2709,1996-1997,1996-11-17,1997-04-12,147,0,36,420,456,44,45,89,545,13,107,Colorado,Lamar,7804
2710,1997-1998,1997-10-25,1998-03-21,148,0,23,346,369,83,115,198,567,12,115,Colorado,Lamar,7804
2711,1998-1999,1998-12-01,1999-03-19,109,5,23,293,316,43,37,80,396,10,78,Colorado,Lamar,7804
2712,1999-2000,1999-11-23,2000-03-16,115,7,4,301,305,22,16,38,343,6,36,Colorado,Lamar,7804
2713,2000-2001,2000-12-01,2001-03-26,116,4,34,365,399,72,94,166,565,13,126,Colorado,Lamar,7804
2714,2001-2002,2001-11-28,2002-03-09,102,4,19,356,375,25,25,50,425,6,57,Colorado,Lamar,7804
2715,2002-2003,2002-10-30,2003-03-05,127,6,27,333,360,39,37,76,436,8,62,Colorado,Lamar,7804
2716,2003-2004,2003-11-23,2004-02-29,99,0,13,336,349,16,11,27,376,7,40,Colorado,Lamar,7804
2717,2004-2005,2004-11-29,2005-03-26,118,0,21,296,317,29,33,62,379,9,81,Colorado,Lamar,7804
2718,2005-2006,2005-12-01,2006-03-24,114,1,23,329,352,29,32,61,413,5,42,Colorado,Lamar,7804
2719,2006-2007,2006-11-30,2007-04-14,136,0,84,455,539,110,447,557,1096,14,182,Colorado,Lamar,7804
2720,2007-2008,2007-11-24,2008-03-03,101,1,24,370,394,28,28,56,450,11,83,Colorado,Lamar,7804
2721,2008-2009,2008-11-28,2009-04-02,126,11,22,337,359,37,29,66,425,8,71,Colorado,Lamar,7804
2722,2013-2014,2013-11-22,2014-04-14,144,1,69,441,510,58,90,148,658,15,136,Colorado,Lamar,7804
2723,2014-2015,2014-11-11,2015-03-05,115,0,49,340,389,52,65,117,506,13,126,Colorado,Lamar,7804
2724,2015-2016,2015-11-18,2016-03-19,123,0,12,304,316,26,15,41,357,7,45,Colorado,Lamar,7804
2725,2016-2017,2016-12-01,2017-05-01,152,1,32,345,377,42,47,89,466,9,88,Colorado,Lamar,7804
2726,2017-2018,2017-12-01,2018-04-07,128,0,26,394,420,11,7,18,438,4,30,Colorado,Lamar,7804
2727,2018-2019,2018-10-15,2019-03-30,167,0,36,441,477,51,54,105,582,12,111,Colorado,Lamar,7804
2728,2019-2020,2019-10-29,2020-02-29,124,0,13,372,385,28,17,45,430,10,68,Colorado,Lamar,7804
2729,1950-1951,1950-11-09,1951-04-10,153,0,37,412,449,37,23,60,509,22,162,Colorado,Pueblo,106595
2730,1951-1952,1951-10-26,1952-04-09,167,0,20,385,405,53,30,83,488,19,125,Colorado,Pueblo,106595
2731,1952-1953,1952-11-08,1953-05-13,187,1,15,391,406,43,46,89,495,21,105,Colorado,Pueblo,106595
2732,1953-1954,1953-11-18,1954-05-02,166,0,10,303,313,40,37,77,390,20,97,Colorado,Pueblo,106595
2733,1954-1955,1954-11-29,1955-04-12,135,0,18,384,402,24,28,52,454,18,100,Colorado,Pueblo,106595
2734,1955-1956,1955-10-23,1956-04-09,170,0,31,450,481,59,99,158,639,26,187,Colorado,Pueblo,106595
2735,1956-1957,1956-11-01,1957-04-08,159,0,16,365,381,52,30,82,463,23,138,Colorado,Pueblo,106595
2736,1957-1958,1957-10-24,1958-04-29,188,0,9,330,339,47,11,58,397,36,121,Colorado,Pueblo,106595
2737,1958-1959,1958-11-17,1959-04-21,156,1,29,374,403,58,60,118,521,27,161,Colorado,Pueblo,106595
2738,1959-1960,1959-09-29,1960-04-29,214,2,53,477,530,77,136,213,743,33,221,Colorado,Pueblo,106595
2739,1960-1961,1960-11-08,1961-04-25,169,0,15,357,372,46,41,87,459,27,109,Colorado,Pueblo,106595
2740,1961-1962,1961-10-29,1962-04-30,184,1,65,504,569,79,105,184,753,31,231,Colorado,Pueblo,106595
2741,1962-1963,1962-11-16,1963-03-13,118,0,45,375,420,33,59,92,512,21,139,Colorado,Pueblo,106595
2742,1963-1964,1963-12-01,1964-04-04,126,0,22,423,445,42,62,104,549,20,131,Colorado,Pueblo,106595
2743,1964-1965,1964-11-16,1965-03-29,134,0,28,401,429,50,54,104,533,27,169,Colorado,Pueblo,106595
2744,1965-1966,1965-11-26,1966-05-12,168,0,15,402,417,34,35,69,486,24,104,Colorado,Pueblo,106595
2745,1966-1967,1966-10-31,1967-04-13,165,0,10,366,376,16,13,29,405,11,55,Colorado,Pueblo,106595
2746,1967-1968,1967-11-02,1968-04-18,169,0,38,404,442,60,96,156,598,22,134,Colorado,Pueblo,106595
2747,1968-1969,1968-11-06,1969-03-15,130,0,16,313,329,39,48,87,416,22,106,Colorado,Pueblo,106595
2748,1969-1970,1969-10-11,1970-04-30,202,0,13,328,341,49,43,92,433,22,89,Colorado,Pueblo,106595
2749,1970-1971,1970-10-07,1971-04-05,181,1,17,354,371,48,41,89,460,20,91,Colorado,Pueblo,106595
2750,1971-1972,1971-09-17,1972-03-31,197,0,25,401,426,50,41,91,517,19,126,Colorado,Pueblo,106595
2751,1972-1973,1972-10-31,1973-05-02,184,0,60,433,493,81,111,192,685,32,235,Colorado,Pueblo,106595
2752,1973-1974,1973-11-19,1974-04-13,146,0,41,358,399,35,51,86,485,14,84,Colorado,Pueblo,106595
2753,1974-1975,1974-11-03,1975-04-18,167,0,23,396,419,39,26,65,484,24,110,Colorado,Pueblo,106595
2754,1975-1976,1975-11-09,1976-03-29,142,0,27,383,410,38,28,66,476,25,126,Colorado,Pueblo,106595
2755,1976-1977,1976-10-26,1977-03-21,147,1,21,428,449,26,19,45,494,18,105,Colorado,Pueblo,106595
2756,1977-1978,1977-11-20,1978-05-06,168,0,30,368,398,28,10,38,436,21,118,Colorado,Pueblo,106595
2757,1978-1979,1978-11-11,1979-05-09,180,0,78,465,543,50,62,112,655,25,170,Colorado,Pueblo,106595
2758,1979-1980,1979-11-09,1980-04-25,169,0,32,394,426,65,62,127,553,32,163,Colorado,Pueblo,106595
2759,1980-1981,1980-11-14,1981-04-04,142,1,8,266,274,27,15,42,316,12,54,Colorado,Pueblo,106595
2760,1981-1982,1981-11-26,1982-05-05,161,20,33,317,350,34,33,67,417,17,94,Colorado,Pueblo,106595
2761,1982-1983,1982-11-22,1983-04-13,143,0,15,307,322,39,13,52,374,22,86,Colorado,Pueblo,106595
2762,1983-1984,1983-11-08,1984-05-07,182,0,75,463,538,63,115,178,716,31,207,Colorado,Pueblo,106595
2763,1984-1985,1984-09-28,1985-03-30,184,0,40,387,427,57,49,106,533,27,144,Colorado,Pueblo,106595
2764,1985-1986,1985-09-28,1986-04-03,188,0,41,378,419,64,98,162,581,25,174,Colorado,Pueblo,106595
2765,1986-1987,1986-11-01,1987-04-06,157,0,17,382,399,50,66,116,515,22,105,Colorado,Pueblo,106595
2766,1987-1988,1987-11-17,1988-05-02,168,0,49,490,539,97,150,247,786,35,242,Colorado,Pueblo,106595
2767,1988-1989,1988-11-25,1989-04-30,157,0,44,424,468,47,60,107,575,18,128,Colorado,Pueblo,106595
2768,1989-1990,1989-12-01,1990-05-03,154,0,32,339,371,98,75,173,544,29,197,Colorado,Pueblo,106595
2769,1990-1991,1990-10-08,1991-04-30,205,0,40,465,505,44,28,72,577,20,112,Colorado,Pueblo,106595
2770,1991-1992,1991-10-29,1992-03-22,146,1,12,339,351,71,57,128,479,22,135,Colorado,Pueblo,106595
2771,1992-1993,1992-11-02,1993-03-12,131,3,42,433,475,43,52,95,570,20,132,Colorado,Pueblo,106595
2772,1993-1994,1993-10-28,1994-04-30,185,1,15,527,542,87,50,137,679,27,171,Colorado,Pueblo,106595
2773,1994-1995,1994-11-03,1995-04-26,175,0,22,436,458,63,40,103,561,23,130,Colorado,Pueblo,106595
2774,1995-1996,1995-09-20,1996-04-05,199,5,29,581,610,33,16,49,659,20,110,Colorado,Pueblo,106595
2775,1996-1997,1996-09-27,1997-04-24,210,1,37,535,572,49,32,81,653,28,163,Colorado,Pueblo,106595
2776,1997-1998,1997-10-24,1998-04-18,177,1,18,451,469,61,31,92,561,24,109,Colorado,Pueblo,106595
2777,1998-1999,1998-12-01,1999-04-15,136,0,24,343,367,31,30,61,428,15,89,Colorado,Pueblo,106595
2778,1999-2000,1999-10-16,2000-04-02,170,0,4,389,393,27,14,41,434,14,56,Colorado,Pueblo,106595
2779,2000-2001,2000-11-10,2001-05-21,193,0,31,485,516,44,79,123,639,18,115,Colorado,Pueblo,106595
2780,2001-2002,2001-11-27,2002-03-25,119,0,18,473,491,27,22,49,540,15,94,Colorado,Pueblo,106595
2781,2002-2003,2002-10-23,2003-04-07,167,0,16,369,385,35,29,64,449,21,88,Colorado,Pueblo,106595
2782,2003-2004,2003-11-22,2004-04-30,161,0,9,359,368,34,25,59,427,17,69,Colorado,Pueblo,106595
2783,2004-2005,2004-11-10,2005-04-10,152,0,15,360,375,30,13,43,418,20,74,Colorado,Pueblo,106595
2784,2005-2006,2005-12-01,2006-03-22,112,0,20,354,374,28,27,55,429,15,95,Colorado,Pueblo,106595
2785,2006-2007,2006-11-29,2007-04-13,136,0,34,377,411,47,46,93,504,26,170,Colorado,Pueblo,106595
2786,2007-2008,2007-11-21,2008-04-17,149,0,17,463,480,41,33,74,554,26,129,Colorado,Pueblo,106595
2787,2008-2009,2008-11-27,2009-04-18,143,0,20,371,391,22,13,35,426,15,73,Colorado,Pueblo,106595
2788,2009-2010,2009-10-10,2010-03-24,166,0,28,468,496,43,30,73,569,23,122,Colorado,Pueblo,106595
2789,2010-2011,2010-11-28,2011-04-24,148,0,39,412,451,36,54,90,541,18,136,Colorado,Pueblo,106595
2790,2011-2012,2011-10-26,2012-04-03,161,1,13,377,390,46,63,109,499,20,116,Colorado,Pueblo,106595
2791,2012-2013,2012-10-25,2013-05-01,189,0,20,488,508,39,16,55,563,25,122,Colorado,Pueblo,106595
2792,2013-2014,2013-10-18,2014-04-14,179,0,48,422,470,45,35,80,550,22,144,Colorado,Pueblo,106595
2793,2014-2015,2014-11-10,2015-03-05,116,0,41,353,394,64,57,121,515,25,194,Colorado,Pueblo,106595
2794,2015-2016,2015-11-20,2016-04-30,163,0,12,306,318,49,54,103,421,19,100,Colorado,Pueblo,106595
2795,2016-2017,2016-12-01,2017-04-30,151,0,24,282,306,40,40,80,386,13,93,Colorado,Pueblo,106595
2796,2017-2018,2017-11-07,2018-02-28,114,0,13,328,341,25,15,40,381,15,70,Colorado,Pueblo,106595
2797,2018-2019,2018-10-14,2019-03-05,143,1,17,385,402,29,22,51,453,19,115,Colorado,Pueblo,106595
2798,2019-2020,2019-10-10,2020-04-17,191,0,17,410,427,53,49,102,529,29,145,Colorado,Pueblo,106595
2799,1958-1959,1958-11-16,1959-03-31,136,20,64,377,441,94,241,335,776,19,171,Colorado,Sedgwick,146
2800,1959-1960,1959-10-01,1960-04-17,200,0,92,472,564,99,387,486,1050,24,199,Colorado,Sedgwick,146
2801,1960-1961,1960-11-04,1961-04-14,162,16,28,352,380,93,89,182,562,23,160,Colorado,Sedgwick,146
2802,1961-1962,1961-11-02,1962-04-08,158,0,87,478,565,56,86,142,707,23,185,Colorado,Sedgwick,146
2803,1962-1963,1962-11-15,1963-04-03,140,0,75,370,445,63,170,233,678,16,118,Colorado,Sedgwick,146
2804,1963-1964,1963-11-22,1964-04-12,143,1,41,402,443,53,71,124,567,19,124,Colorado,Sedgwick,146
2805,1964-1965,1964-12-01,1965-03-26,116,0,43,397,440,38,64,102,542,15,113,Colorado,Sedgwick,146
2806,1965-1966,1965-12-01,1966-04-19,140,0,71,383,454,54,274,328,782,16,135,Colorado,Sedgwick,146
2807,1966-1967,1966-10-14,1967-04-30,199,0,25,370,395,38,34,72,467,12,86,Colorado,Sedgwick,146
2808,1967-1968,1967-11-02,1968-04-07,158,0,52,411,463,57,182,239,702,17,121,Colorado,Sedgwick,146
2809,1968-1969,1968-12-01,1969-03-13,103,1,55,357,412,37,97,134,546,16,121,Colorado,Sedgwick,146
2810,1969-1970,1969-10-05,1970-03-31,178,0,30,388,418,82,66,148,566,16,121,Colorado,Sedgwick,146
2811,1970-1971,1970-11-08,1971-04-27,171,2,57,403,460,94,180,274,734,21,191,Colorado,Sedgwick,146
2812,1971-1972,1971-10-29,1972-02-29,124,6,38,348,386,16,23,39,425,5,50,Colorado,Sedgwick,146
2813,1972-1973,1972-10-30,1973-04-26,179,6,107,452,559,108,277,385,944,18,194,Colorado,Sedgwick,146
2814,1973-1974,1973-10-11,1974-03-23,164,2,70,365,435,67,213,280,715,19,167,Colorado,Sedgwick,146
2815,1974-1975,1974-11-29,1975-04-11,134,14,27,378,405,27,56,83,488,7,51,Colorado,Sedgwick,146
2816,1975-1976,1975-10-24,1976-03-15,144,7,57,352,409,66,182,248,657,15,144,Colorado,Sedgwick,146
2817,1976-1977,1976-11-12,1977-04-20,160,4,29,410,439,74,124,198,637,11,113,Colorado,Sedgwick,146
2818,1977-1978,1977-11-09,1978-03-15,127,1,89,440,529,45,166,211,740,15,139,Colorado,Sedgwick,146
2819,1978-1979,1978-11-11,1979-05-10,181,0,116,529,645,80,320,400,1045,20,188,Colorado,Sedgwick,146
2820,1979-1980,1979-11-05,1980-04-10,158,1,74,408,482,129,383,512,994,23,241,Colorado,Sedgwick,146
2821,1980-1981,1980-11-14,1981-04-04,142,3,22,315,337,47,70,117,454,14,105,Colorado,Sedgwick,146
2822,1981-1982,1981-11-19,1982-04-03,136,5,53,399,452,47,99,146,598,18,168,Colorado,Sedgwick,146
2823,1982-1983,1982-10-19,1983-04-13,177,1,28,343,371,73,177,250,621,16,124,Colorado,Sedgwick,146
2824,1983-1984,1983-11-09,1984-04-30,174,7,121,481,602,136,466,602,1204,29,319,Colorado,Sedgwick,146
2825,1984-1985,1984-09-28,1985-04-06,191,4,66,460,526,45,225,270,796,17,129,Colorado,Sedgwick,146
2826,1985-1986,1985-09-29,1986-04-05,189,6,100,414,514,103,463,566,1080,19,197,Colorado,Sedgwick,146
2827,1986-1987,1986-10-11,1987-03-30,171,0,25,330,355,78,93,171,526,23,152,Colorado,Sedgwick,146
2828,1987-1988,1987-11-16,1988-04-23,160,12,81,416,497,94,336,430,927,21,185,Colorado,Sedgwick,146
2829,1988-1989,1988-11-27,1989-04-11,136,4,63,409,472,51,84,135,607,16,149,Colorado,Sedgwick,146
2830,1989-1990,1989-11-15,1990-05-09,176,1,51,375,426,51,148,199,625,15,146,Colorado,Sedgwick,146
2831,1990-1991,1990-10-08,1991-03-30,174,2,66,392,458,50,75,125,583,15,106,Colorado,Sedgwick,146
2832,1991-1992,1991-10-29,1992-03-19,143,3,21,279,300,59,162,221,521,13,110,Colorado,Sedgwick,146
2833,1992-1993,1992-10-29,1993-04-13,167,0,93,479,572,70,258,328,900,20,178,Colorado,Sedgwick,146
2834,1993-1994,1993-09-14,1994-04-30,229,1,44,411,455,54,115,169,624,17,112,Colorado,Sedgwick,146
2835,1994-1995,1994-11-04,1995-04-26,174,16,48,346,394,38,91,129,523,12,80,Colorado,Sedgwick,146
2836,1995-1996,1995-09-21,1996-04-28,221,1,54,457,511,41,35,76,587,13,113,Colorado,Sedgwick,146
2837,1996-1997,1996-10-31,1997-04-12,164,7,66,423,489,32,31,63,552,13,108,Colorado,Sedgwick,146
2838,1997-1998,1997-10-25,1998-03-09,136,4,24,284,308,39,57,96,404,11,82,Colorado,Sedgwick,146
2839,1998-1999,1998-11-03,1999-04-10,159,2,31,290,321,34,46,80,401,14,96,Colorado,Sedgwick,146
2840,1999-2000,1999-11-23,2000-04-16,146,3,9,230,239,32,51,83,322,9,60,Colorado,Sedgwick,146
2841,2000-2001,2000-09-24,2001-04-23,212,16,47,395,442,67,100,167,609,17,139,Colorado,Sedgwick,146
2842,2001-2002,2001-10-05,2002-03-25,172,11,36,377,413,38,96,134,547,9,84,Colorado,Sedgwick,146
2843,2002-2003,2002-10-23,2003-04-08,168,2,29,342,371,45,71,116,487,16,122,Colorado,Sedgwick,146
2844,2003-2004,2003-10-31,2004-04-12,165,2,26,355,381,34,68,102,483,10,80,Colorado,Sedgwick,146
2845,2004-2005,2004-11-02,2005-04-29,179,0,33,300,333,48,89,137,470,12,90,Colorado,Sedgwick,146
2846,2005-2006,2005-12-01,2006-04-07,128,5,39,278,317,35,57,92,409,10,88,Colorado,Sedgwick,146
2847,2006-2007,2006-10-18,2007-04-07,172,9,69,397,466,47,372,419,885,10,103,Colorado,Sedgwick,146
2848,2007-2008,2007-11-21,2008-05-03,165,3,58,478,536,55,185,240,776,19,143,Colorado,Sedgwick,146
2849,2008-2009,2008-11-11,2009-04-10,151,11,55,423,478,39,60,99,577,14,112,Colorado,Sedgwick,146
2850,2009-2010,2009-10-10,2010-04-07,180,3,77,459,536,60,113,173,709,19,147,Colorado,Sedgwick,146
2851,2011-2012,2011-10-26,2012-02-29,127,10,27,363,390,26,88,114,504,9,62,Colorado,Sedgwick,146
2852,2012-2013,2012-10-06,2013-05-02,209,4,67,458,525,65,158,223,748,22,150,Colorado,Sedgwick,146
2853,2013-2014,2013-10-18,2014-05-08,203,0,100,501,601,48,124,172,773,23,161,Colorado,Sedgwick,146
2854,2014-2015,2014-11-04,2015-05-20,198,1,79,434,513,48,153,201,714,20,149,Colorado,Sedgwick,146
2855,2015-2016,2015-11-11,2016-05-02,174,0,50,356,406,62,220,282,688,17,118,Colorado,Sedgwick,146
2856,2016-2017,2016-11-18,2017-02-28,103,0,63,334,397,22,48,70,467,10,80,Colorado,Sedgwick,146
2857,2017-2018,2017-10-09,2018-04-21,195,2,71,458,529,65,129,194,723,24,184,Colorado,Sedgwick,146
2858,2018-2019,2018-10-10,2019-05-22,225,0,80,492,572,58,84,142,714,26,162,Colorado,Sedgwick,146
2859,2019-2020,2019-10-11,2020-04-18,191,0,36,423,459,53,85,138,597,30,170,Colorado,Sedgwick,146
2860,1954-1955,1954-12-01,1955-04-09,130,14,15,327,342,8,38,46,388,2,14,Colorado,Trinidad,9096
2861,1955-1956,1955-12-01,1956-03-15,106,11,11,238,249,4,39,43,292,1,9,Colorado,Trinidad,9096
2862,1956-1957,1956-11-02,1957-04-28,178,10,3,296,299,60,31,91,390,23,108,Colorado,Trinidad,9096
2863,1957-1958,1957-11-16,1958-04-12,148,6,10,310,320,31,55,86,406,11,63,Colorado,Trinidad,9096
2864,1958-1959,1958-11-17,1959-04-21,156,1,14,304,318,82,90,172,490,22,157,Colorado,Trinidad,9096
2865,1961-1962,1961-10-29,1962-03-31,154,9,34,383,417,49,60,109,526,11,79,Colorado,Trinidad,9096
2866,1963-1964,1963-11-25,1964-04-07,135,12,23,374,397,93,117,210,607,22,174,Colorado,Trinidad,9096
2867,1964-1965,1964-11-16,1965-04-27,163,5,20,353,373,82,89,171,544,25,184,Colorado,Trinidad,9096
2868,1965-1966,1965-12-01,1966-04-20,141,0,10,297,307,47,55,102,409,14,95,Colorado,Trinidad,9096
2869,1967-1968,1967-11-02,1968-04-28,179,2,15,320,335,91,131,222,557,27,176,Colorado,Trinidad,9096
2870,1968-1969,1968-11-10,1969-04-17,159,10,18,310,328,38,73,111,439,9,74,Colorado,Trinidad,9096
2871,1970-1971,1970-12-01,1971-04-05,126,7,26,253,279,43,39,82,361,8,79,Colorado,Trinidad,9096
2872,1971-1972,1971-10-29,1972-04-15,170,2,8,268,276,66,78,144,420,18,122,Colorado,Trinidad,9096
2873,1985-1986,1985-10-30,1986-05-17,200,12,25,275,300,58,43,101,401,11,89,Colorado,Trinidad,9096
2874,1988-1989,1988-11-15,1989-04-10,147,9,29,318,347,71,62,133,480,15,139,Colorado,Trinidad,9096
2875,1989-1990,1989-10-18,1990-05-04,199,6,10,313,323,93,88,181,504,20,154,Colorado,Trinidad,9096
2876,1991-1992,1991-10-29,1992-04-01,156,16,14,281,295,61,95,156,451,15,122,Colorado,Trinidad,9096
2877,1998-1999,1998-11-01,1999-04-15,166,17,11,236,247,75,41,116,363,17,133,Colorado,Trinidad,9096
2878,1999-2000,1999-10-17,2000-04-11,178,20,2,306,308,75,56,131,439,11,105,Colorado,Trinidad,9096
2879,2001-2002,2001-11-27,2002-04-09,134,20,10,292,302,40,26,66,368,14,85,Colorado,Trinidad,9096
2880,2005-2006,2005-11-15,2006-03-20,126,15,5,257,262,42,26,68,330,10,64,Colorado,Trinidad,9096
2881,2006-2007,2006-10-26,2007-04-13,170,8,25,379,404,114,296,410,814,20,208,Colorado,Trinidad,9096
2882,2007-2008,2007-10-21,2008-04-17,180,12,14,344,358,83,130,213,571,22,160,Colorado,Trinidad,9096
2883,2008-2009,2008-11-30,2009-04-12,134,18,9,260,269,65,41,106,375,13,100,Colorado,Trinidad,9096
2884,2013-2014,2013-11-22,2014-05-12,172,17,29,356,385,52,20,72,457,20,124,Colorado,Trinidad,9096
2885,2014-2015,2014-11-12,2015-03-25,134,0,30,310,340,78,87,165,505,22,180,Colorado,Trinidad,9096
2886,2015-2016,2015-11-16,2016-05-01,168,0,15,273,288,86,59,145,433,20,134,Colorado,Trinidad,9096
2887,2016-2017,2016-12-01,2017-04-30,151,1,8,224,232,73,83,156,388,12,109,Colorado,Trinidad,9096
2888,2017-2018,2017-10-26,2018-04-13,170,1,4,238,242,28,13,41,283,13,56,Colorado,Trinidad,9096
2889,2018-2019,2018-10-14,2019-04-11,180,0,18,334,352,74,53,127,479,25,174,Colorado,Trinidad,9096
2890,2019-2020,2019-10-23,2020-04-13,174,1,13,359,372,75,108,183,555,18,147,Colorado,Trinidad,9096
2891,1950-1951,1950-12-01,1951-03-22,112,0,24,142,166,20,17,37,203,13,53,Connecticut,Bridgeport,144229
2892,1951-1952,1951-11-20,1952-03-16,118,0,17,170,187,35,23,58,245,18,60,Connecticut,Bridgeport,144229
2893,1952-1953,1952-12-01,1953-03-08,98,0,6,112,118,13,10,23,141,7,25,Connecticut,Bridgeport,144229
2894,1953-1954,1953-11-06,1954-02-28,115,0,17,143,160,26,41,67,227,13,63,Connecticut,Bridgeport,144229
2895,1954-1955,1954-12-01,1955-04-04,125,0,22,174,196,19,6,25,221,15,51,Connecticut,Bridgeport,144229
2896,1955-1956,1955-11-19,1956-03-25,128,0,27,200,227,51,42,93,320,20,100,Connecticut,Bridgeport,144229
2897,1956-1957,1956-12-01,1957-04-04,125,0,22,175,197,30,35,65,262,14,71,Connecticut,Bridgeport,144229
2898,1957-1958,1957-12-01,1958-04-11,132,2,32,169,201,70,131,201,402,17,104,Connecticut,Bridgeport,144229
2899,1958-1959,1958-11-30,1959-04-12,134,0,39,248,287,22,27,49,336,12,49,Connecticut,Bridgeport,144229
2900,1959-1960,1959-11-18,1960-03-22,126,0,16,164,180,33,60,93,273,16,72,Connecticut,Bridgeport,144229
2901,1960-1961,1960-12-01,1961-03-19,109,0,51,243,294,66,236,302,596,19,129,Connecticut,Bridgeport,144229
2902,1961-1962,1961-11-20,1962-03-21,122,0,33,203,236,40,101,141,377,18,83,Connecticut,Bridgeport,144229
2903,1962-1963,1962-11-18,1963-03-21,124,0,51,255,306,45,71,116,422,23,101,Connecticut,Bridgeport,144229
2904,1963-1964,1963-12-01,1964-03-12,103,0,34,190,224,58,121,179,403,21,118,Connecticut,Bridgeport,144229
2905,1964-1965,1964-12-01,1965-04-02,123,0,38,212,250,60,144,204,454,22,124,Connecticut,Bridgeport,144229
2906,1965-1966,1965-12-01,1966-03-13,103,0,22,163,185,33,80,113,298,14,63,Connecticut,Bridgeport,144229
2907,1966-1967,1966-12-01,1967-03-25,115,0,35,195,230,87,143,230,460,27,157,Connecticut,Bridgeport,144229
2908,1967-1968,1967-11-30,1968-03-13,105,0,38,216,254,31,66,97,351,19,85,Connecticut,Bridgeport,144229
2909,1968-1969,1968-11-12,1969-03-07,116,0,27,163,190,44,80,124,314,15,66,Connecticut,Bridgeport,144229
2910,1969-1970,1969-12-01,1970-04-02,123,0,35,230,265,50,135,185,450,25,121,Connecticut,Bridgeport,144229
2911,1970-1971,1970-12-01,1971-04-07,128,0,35,194,229,43,71,114,343,27,83,Connecticut,Bridgeport,144229
2912,1971-1972,1971-12-01,1972-04-08,130,0,21,174,195,36,50,86,281,20,71,Connecticut,Bridgeport,144229
2913,1972-1973,1972-11-15,1973-02-28,106,0,31,173,204,16,15,31,235,11,41,Connecticut,Bridgeport,144229
2914,1973-1974,1973-12-01,1974-03-30,120,0,25,160,185,52,128,180,365,19,103,Connecticut,Bridgeport,144229
2915,1974-1975,1974-11-25,1975-04-04,131,0,9,126,135,29,24,53,188,13,47,Connecticut,Bridgeport,144229
2916,1975-1976,1975-12-01,1976-03-17,108,0,28,174,202,42,70,112,314,17,94,Connecticut,Bridgeport,144229
2917,1976-1977,1976-11-30,1977-03-23,114,0,52,217,269,41,133,174,443,21,84,Connecticut,Bridgeport,144229
2918,1977-1978,1977-11-27,1978-03-19,113,0,61,227,288,77,215,292,580,21,111,Connecticut,Bridgeport,144229
2919,1978-1979,1978-11-21,1979-02-28,100,0,49,173,222,26,44,70,292,12,59,Connecticut,Bridgeport,144229
2920,1979-1980,1979-12-01,1980-03-31,122,0,30,168,198,14,11,25,223,6,28,Connecticut,Bridgeport,144229
2921,1980-1981,1980-11-17,1981-03-17,121,0,47,237,284,18,78,96,380,12,49,Connecticut,Bridgeport,144229
2922,1981-1982,1981-12-01,1982-04-09,130,0,38,230,268,33,97,130,398,14,79,Connecticut,Bridgeport,144229
2923,1982-1983,1982-12-01,1983-04-19,140,0,21,147,168,32,89,121,289,10,54,Connecticut,Bridgeport,144229
2924,1983-1984,1983-12-01,1984-03-30,121,0,43,199,242,32,86,118,360,16,80,Connecticut,Bridgeport,144229
2925,1984-1985,1984-12-01,1985-03-04,94,0,26,148,174,30,53,83,257,15,74,Connecticut,Bridgeport,144229
2926,1985-1986,1985-11-26,1986-03-21,116,0,33,196,229,30,53,83,312,17,77,Connecticut,Bridgeport,144229
2927,1986-1987,1986-11-18,1987-03-13,116,0,17,178,195,33,58,91,286,19,62,Connecticut,Bridgeport,144229
2928,1987-1988,1987-10-04,1988-03-15,164,0,31,186,217,36,77,113,330,17,70,Connecticut,Bridgeport,144229
2929,1988-1989,1988-12-01,1989-03-24,114,0,22,166,188,24,25,49,237,12,55,Connecticut,Bridgeport,144229
2930,1989-1990,1989-11-22,1990-04-07,137,0,36,204,240,48,50,98,338,20,105,Connecticut,Bridgeport,144229
2931,1990-1991,1990-12-01,1991-03-30,120,0,12,115,127,35,31,66,193,14,56,Connecticut,Bridgeport,144229
2932,1991-1992,1991-12-01,1992-03-25,116,0,15,168,183,27,25,52,235,13,56,Connecticut,Bridgeport,144229
2933,1992-1993,1992-12-01,1993-03-21,111,0,18,183,201,44,55,99,300,19,78,Connecticut,Bridgeport,144229
2934,1993-1994,1993-12-01,1994-03-19,109,0,63,251,314,79,226,305,619,28,190,Connecticut,Bridgeport,144229
2935,1994-1995,1994-12-01,1995-02-28,90,0,20,124,144,15,29,44,188,4,21,Connecticut,Bridgeport,144229
2936,1995-1996,1995-11-13,1996-04-10,150,0,49,241,290,109,264,373,663,31,193,Connecticut,Bridgeport,144229
2937,2001-2002,2001-12-01,2002-03-20,110,0,2,90,92,15,14,29,121,7,25,Connecticut,Bridgeport,144229
2938,2002-2003,2002-11-27,2003-04-08,133,3,48,230,278,90,163,253,531,20,143,Connecticut,Bridgeport,144229
2939,2004-2005,2004-11-13,2005-03-24,132,0,26,179,205,79,172,251,456,22,137,Connecticut,Bridgeport,144229
2940,2005-2006,2005-11-24,2006-03-06,103,0,13,132,145,51,70,121,266,10,71,Connecticut,Bridgeport,144229
2941,2006-2007,2006-12-01,2007-03-22,112,0,27,165,192,21,42,63,255,8,42,Connecticut,Bridgeport,144229
2942,2007-2008,2007-12-01,2008-03-01,92,0,6,114,120,30,51,81,201,11,51,Connecticut,Bridgeport,144229
2943,2008-2009,2008-11-30,2009-03-07,98,0,33,191,224,62,146,208,432,18,113,Connecticut,Bridgeport,144229
2944,2009-2010,2009-12-01,2010-03-05,95,0,24,147,171,57,121,178,349,17,84,Connecticut,Bridgeport,144229
2945,2010-2011,2010-11-08,2011-03-24,137,3,26,202,228,93,386,479,707,20,134,Connecticut,Bridgeport,144229
2946,2011-2012,2011-10-29,2012-02-29,124,0,4,80,84,21,13,34,118,7,29,Connecticut,Bridgeport,144229
2947,2012-2013,2012-11-07,2013-03-19,133,3,17,131,148,93,162,255,403,19,124,Connecticut,Bridgeport,144229
2948,2013-2014,2013-11-12,2014-04-16,156,0,46,242,288,82,240,322,610,24,149,Connecticut,Bridgeport,144229
2949,2014-2015,2014-11-26,2015-03-30,125,0,48,259,307,87,326,413,720,29,182,Connecticut,Bridgeport,144229
2950,2015-2016,2015-12-01,2016-04-04,126,0,14,110,124,40,68,108,232,11,59,Connecticut,Bridgeport,144229
2951,2016-2017,2016-12-01,2017-03-22,112,0,11,109,120,56,106,162,282,11,80,Connecticut,Bridgeport,144229
2952,2017-2018,2017-12-01,2018-04-03,124,0,33,165,198,67,83,150,348,16,95,Connecticut,Bridgeport,144229
2953,2018-2019,2018-11-15,2019-03-10,116,1,17,154,171,34,38,72,243,11,50,Connecticut,Bridgeport,144229
2954,2019-2020,2019-12-01,2020-02-29,91,0,6,83,89,16,19,35,124,7,24,Connecticut,Bridgeport,144229
2955,1950-1951,1950-12-01,1951-03-22,112,0,25,201,226,48,69,117,343,19,107,Connecticut,Hartford,124775
2956,1951-1952,1951-11-03,1952-03-19,138,0,26,242,268,68,152,220,488,27,120,Connecticut,Hartford,124775
2957,1952-1953,1952-11-30,1953-03-08,99,0,11,164,175,39,66,105,280,16,71,Connecticut,Hartford,124775
2958,1953-1954,1953-11-06,1954-04-01,147,0,32,248,280,39,60,99,379,21,116,Connecticut,Hartford,124775
2959,1954-1955,1954-12-01,1955-04-04,125,0,39,241,280,37,40,77,357,21,84,Connecticut,Hartford,124775
2960,1955-1956,1955-11-19,1956-04-23,157,0,49,317,366,106,205,311,677,32,185,Connecticut,Hartford,124775
2961,1956-1957,1956-11-18,1957-04-12,146,0,39,308,347,68,133,201,548,31,161,Connecticut,Hartford,124775
2962,1957-1958,1957-12-01,1958-04-12,133,0,48,266,314,77,199,276,590,25,145,Connecticut,Hartford,124775
2963,1958-1959,1958-11-03,1959-03-30,148,0,65,405,470,66,102,168,638,28,151,Connecticut,Hartford,124775
2964,1959-1960,1959-11-18,1960-03-26,130,1,38,298,336,67,210,277,613,27,146,Connecticut,Hartford,124775
2965,1960-1961,1960-12-01,1961-04-13,134,0,82,442,524,110,472,582,1106,24,221,Connecticut,Hartford,124775
2966,1961-1962,1961-11-20,1962-03-16,117,0,53,312,365,60,219,279,644,22,141,Connecticut,Hartford,124775
2967,1962-1963,1962-11-18,1963-03-22,125,0,77,398,475,81,351,432,907,33,198,Connecticut,Hartford,124775
2968,1963-1964,1963-12-01,1964-03-18,109,0,61,319,380,79,259,338,718,28,184,Connecticut,Hartford,124775
2969,1964-1965,1964-12-01,1965-04-19,140,0,64,309,373,80,195,275,648,33,179,Connecticut,Hartford,124775
2970,1965-1966,1965-12-01,1966-03-17,107,0,33,213,246,79,162,241,487,27,134,Connecticut,Hartford,124775
2971,1966-1967,1966-12-01,1967-04-24,145,0,42,274,316,123,290,413,729,35,212,Connecticut,Hartford,124775
2972,1967-1968,1967-11-09,1968-03-24,137,0,63,323,386,55,224,279,665,23,142,Connecticut,Hartford,124775
2973,1968-1969,1968-11-10,1969-03-30,141,0,61,322,383,88,317,405,788,30,172,Connecticut,Hartford,124775
2974,1969-1970,1969-12-01,1970-04-03,124,0,86,351,437,95,358,453,890,34,230,Connecticut,Hartford,124775
2975,1970-1971,1970-12-01,1971-04-24,145,0,77,333,410,101,356,457,867,37,209,Connecticut,Hartford,124775
2976,1971-1972,1971-11-24,1972-04-11,140,0,46,296,342,85,153,238,580,31,168,Connecticut,Hartford,124775
2977,1972-1973,1972-10-19,1973-04-11,175,0,43,261,304,55,81,136,440,26,111,Connecticut,Hartford,124775
2978,1973-1974,1973-12-01,1974-04-10,131,0,47,258,305,50,132,182,487,26,136,Connecticut,Hartford,124775
2979,1974-1975,1974-11-25,1975-04-07,134,0,21,252,273,64,113,177,450,28,140,Connecticut,Hartford,124775
2980,1975-1976,1975-11-24,1976-03-19,117,0,72,297,369,66,181,247,616,29,199,Connecticut,Hartford,124775
2981,1976-1977,1976-11-10,1977-05-09,181,0,76,385,461,78,318,396,857,34,202,Connecticut,Hartford,124775
2982,1977-1978,1977-11-23,1978-03-26,124,0,70,331,401,117,458,575,976,31,213,Connecticut,Hartford,124775
2983,1978-1979,1978-11-21,1979-04-10,141,0,84,323,407,50,120,170,577,23,139,Connecticut,Hartford,124775
2984,1979-1980,1979-10-10,1980-03-25,168,1,41,298,339,26,37,63,402,12,57,Connecticut,Hartford,124775
2985,1980-1981,1980-11-17,1981-03-07,111,0,75,342,417,27,70,97,514,16,102,Connecticut,Hartford,124775
2986,1981-1982,1981-12-01,1982-04-11,132,0,64,320,384,83,181,264,648,31,180,Connecticut,Hartford,124775
2987,1982-1983,1982-12-01,1983-04-20,141,0,40,231,271,66,158,224,495,17,114,Connecticut,Hartford,124775
2988,1983-1984,1983-12-01,1984-04-01,123,0,64,319,383,67,137,204,587,30,177,Connecticut,Hartford,124775
2989,1984-1985,1984-11-13,1985-04-08,147,0,50,303,353,39,73,112,465,24,125,Connecticut,Hartford,124775
2990,1985-1986,1985-11-16,1986-04-06,142,0,42,307,349,37,46,83,432,22,104,Connecticut,Hartford,124775
2991,1986-1987,1986-11-11,1987-04-28,169,0,27,308,335,73,242,315,650,22,125,Connecticut,Hartford,124775
2992,1987-1988,1987-11-10,1988-03-21,133,0,43,306,349,84,189,273,622,21,128,Connecticut,Hartford,124775
2993,1988-1989,1988-12-01,1989-03-24,114,0,34,262,296,25,13,38,334,16,81,Connecticut,Hartford,124775
2994,1989-1990,1989-11-23,1990-04-07,136,0,58,297,355,59,138,197,552,23,131,Connecticut,Hartford,124775
2995,1990-1991,1990-12-01,1991-03-30,120,0,22,196,218,41,48,89,307,14,75,Connecticut,Hartford,124775
2996,1991-1992,1991-11-11,1992-04-16,158,0,30,279,309,39,23,62,371,23,92,Connecticut,Hartford,124775
2997,1992-1993,1992-12-01,1993-03-26,116,0,41,280,321,91,207,298,619,28,158,Connecticut,Hartford,124775
2998,1993-1994,1993-11-25,1994-03-29,125,0,87,358,445,126,377,503,948,41,308,Connecticut,Hartford,124775
2999,1994-1995,1994-11-27,1995-04-08,133,0,29,238,267,33,66,99,366,14,69,Connecticut,Hartford,124775
3000,1995-1996,1995-11-13,1996-03-14,123,0,70,330,400,150,374,524,924,36,296,Connecticut,Hartford,124775
3001,2000-2001,2000-11-25,2001-03-18,114,12,47,296,343,79,129,208,551,24,134,Connecticut,Hartford,124775
3002,2002-2003,2002-11-27,2003-04-08,133,8,71,350,421,112,302,414,835,25,184,Connecticut,Hartford,124775
3003,2014-2015,2014-11-26,2015-03-28,123,1,66,361,427,88,480,568,995,28,209,Connecticut,Hartford,124775
3004,2015-2016,2015-12-01,2016-04-06,128,1,21,184,205,41,78,119,324,16,84,Connecticut,Hartford,124775
3005,2017-2018,2017-12-01,2018-04-16,137,0,53,271,324,84,142,226,550,28,151,Connecticut,Hartford,124775
3006,2018-2019,2018-11-15,2019-03-13,119,0,37,263,300,56,146,202,502,20,114,Connecticut,Hartford,124775
3007,2019-2020,2019-11-13,2020-04-18,158,0,14,202,216,48,86,134,350,16,80,Connecticut,Hartford,124775
3008,1950-1951,1950-11-21,1951-04-18,149,0,87,360,447,127,367,494,941,53,313,Connecticut,Norfolk,242803
3009,1951-1952,1951-11-02,1952-04-13,164,4,96,419,515,161,633,794,1309,53,352,Connecticut,Norfolk,242803
3010,1952-1953,1952-10-21,1953-04-21,183,0,63,352,415,132,340,472,887,63,314,Connecticut,Norfolk,242803
3011,1953-1954,1953-11-07,1954-05-12,187,1,89,381,470,98,252,350,820,47,286,Connecticut,Norfolk,242803
3012,1955-1956,1955-11-05,1956-04-29,177,1,134,490,624,264,880,1144,1768,82,564,Connecticut,Norfolk,242803
3013,1956-1957,1956-11-10,1957-04-14,156,5,92,418,510,138,390,528,1038,57,346,Connecticut,Norfolk,242803
3014,1957-1958,1957-10-28,1958-04-20,175,1,117,413,530,214,1000,1214,1744,60,433,Connecticut,Norfolk,242803
3015,1958-1959,1958-10-14,1959-04-13,182,0,134,533,667,148,338,486,1153,60,406,Connecticut,Norfolk,242803
3016,1959-1960,1959-11-03,1960-04-10,160,3,117,433,550,178,801,979,1529,64,420,Connecticut,Norfolk,242803
3017,1960-1961,1960-10-25,1961-05-27,215,1,156,533,689,225,1153,1378,2067,63,492,Connecticut,Norfolk,242803
3018,1962-1963,1962-10-26,1963-05-12,199,1,169,577,746,186,1060,1246,1992,63,480,Connecticut,Norfolk,242803
3019,1963-1964,1963-11-03,1964-04-21,171,0,134,471,605,190,800,990,1595,62,478,Connecticut,Norfolk,242803
3020,1964-1965,1964-10-21,1965-04-19,181,0,134,497,631,134,479,613,1244,61,403,Connecticut,Norfolk,242803
3021,1965-1966,1965-11-02,1966-05-04,184,0,104,440,544,143,609,752,1296,55,359,Connecticut,Norfolk,242803
3022,1966-1967,1966-11-06,1967-05-26,202,1,122,487,609,223,819,1042,1651,63,498,Connecticut,Norfolk,242803
3023,1967-1968,1967-11-08,1968-03-25,139,0,150,502,652,120,622,742,1394,53,385,Connecticut,Norfolk,242803
3024,1968-1969,1968-11-10,1969-04-07,149,0,143,476,619,191,1063,1254,1873,59,435,Connecticut,Norfolk,242803
3025,1969-1970,1969-10-24,1970-05-07,196,0,160,575,735,173,905,1078,1813,66,478,Connecticut,Norfolk,242803
3026,1970-1971,1970-10-17,1971-04-30,196,0,142,523,665,209,1129,1338,2003,67,479,Connecticut,Norfolk,242803
3027,1971-1972,1971-11-09,1972-04-21,165,0,113,479,592,190,591,781,1373,69,440,Connecticut,Norfolk,242803
3028,1972-1973,1972-10-19,1973-04-12,176,5,94,389,483,109,409,518,1001,43,242,Connecticut,Norfolk,242803
3029,1973-1974,1973-11-06,1974-04-20,166,0,105,425,530,91,290,381,911,39,266,Connecticut,Norfolk,242803
3030,1974-1975,1974-10-04,1975-04-27,206,3,86,448,534,155,694,849,1383,56,357,Connecticut,Norfolk,242803
3031,1975-1976,1975-11-15,1976-05-20,188,0,127,471,598,140,504,644,1242,56,428,Connecticut,Norfolk,242803
3032,1976-1977,1976-10-25,1977-05-11,199,0,172,557,729,190,702,892,1621,57,465,Connecticut,Norfolk,242803
3033,1978-1979,1978-11-16,1979-04-15,151,2,160,447,607,138,588,726,1333,54,368,Connecticut,Norfolk,242803
3034,1980-1981,1980-11-02,1981-03-27,146,0,147,510,657,115,431,546,1203,49,355,Connecticut,Norfolk,242803
3035,1981-1982,1981-10-24,1982-04-15,174,3,143,520,663,141,884,1025,1688,59,425,Connecticut,Norfolk,242803
3036,1982-1983,1982-10-17,1983-04-23,189,0,80,371,451,165,462,627,1078,44,312,Connecticut,Norfolk,242803
3037,1983-1984,1983-11-18,1984-04-11,146,0,125,442,567,165,568,733,1300,54,398,Connecticut,Norfolk,242803
3038,1984-1985,1984-11-13,1985-04-13,152,2,105,402,507,91,312,403,910,39,243,Connecticut,Norfolk,242803
3039,1985-1986,1985-11-17,1986-04-24,159,0,121,427,548,102,492,594,1142,51,300,Connecticut,Norfolk,242803
3040,1986-1987,1986-11-06,1987-05-01,177,2,99,432,531,159,872,1031,1562,50,320,Connecticut,Norfolk,242803
3041,1987-1988,1987-10-04,1988-04-20,200,0,114,483,597,175,720,895,1492,53,380,Connecticut,Norfolk,242803
3042,1988-1989,1988-10-27,1989-04-14,170,1,104,426,530,87,155,242,772,43,243,Connecticut,Norfolk,242803
3043,1989-1990,1989-11-19,1990-04-07,140,0,124,429,553,121,372,493,1046,48,349,Connecticut,Norfolk,242803
3044,1990-1991,1990-11-12,1991-04-14,154,4,67,334,401,99,177,276,677,40,249,Connecticut,Norfolk,242803
3045,1991-1992,1991-11-12,1992-04-26,167,1,94,412,506,82,138,220,726,49,281,Connecticut,Norfolk,242803
3046,1992-1993,1992-11-09,1993-04-23,166,4,104,443,547,155,750,905,1452,40,307,Connecticut,Norfolk,242803
3047,1993-1994,1993-11-02,1994-04-10,160,2,150,514,664,143,912,1055,1719,46,377,Connecticut,Norfolk,242803
3048,1994-1995,1994-11-24,1995-04-09,137,1,71,367,438,60,284,344,782,24,156,Connecticut,Norfolk,242803
3049,1995-1996,1995-11-09,1996-04-18,162,0,148,495,643,230,802,1032,1675,59,496,Connecticut,Norfolk,242803
3050,1996-1997,1996-11-12,1997-04-21,161,2,67,391,458,147,293,440,898,39,273,Connecticut,Norfolk,242803
3051,1997-1998,1997-11-13,1998-04-10,149,2,43,309,352,92,432,524,876,34,181,Connecticut,Norfolk,242803
3052,1998-1999,1998-11-08,1999-04-12,156,13,56,318,374,72,307,379,753,33,185,Connecticut,Norfolk,242803
3053,1999-2000,1999-11-17,2000-04-27,163,4,93,363,456,73,358,431,887,25,166,Connecticut,Norfolk,242803
3054,2000-2001,2000-10-30,2001-04-14,167,4,87,396,483,140,964,1104,1587,37,252,Connecticut,Norfolk,242803
3055,2003-2004,2003-10-23,2004-04-06,167,2,148,417,565,95,496,591,1156,28,216,Connecticut,Norfolk,242803
3056,2004-2005,2004-11-10,2005-04-06,148,9,126,427,553,131,670,801,1354,30,276,Connecticut,Norfolk,242803
3057,2005-2006,2005-10-26,2006-04-05,162,3,88,349,437,115,382,497,934,34,256,Connecticut,Norfolk,242803
3058,2006-2007,2006-12-01,2007-04-16,137,0,96,358,454,67,287,354,808,31,197,Connecticut,Norfolk,242803
3059,2007-2008,2007-11-20,2008-03-31,133,0,77,340,417,120,643,763,1180,43,259,Connecticut,Norfolk,242803
3060,2008-2009,2008-10-29,2009-03-28,151,0,121,416,537,114,598,712,1249,38,311,Connecticut,Norfolk,242803
3061,2009-2010,2009-10-16,2010-03-26,162,0,98,306,404,107,570,677,1081,38,216,Connecticut,Norfolk,242803
3062,2010-2011,2010-11-08,2011-04-23,167,0,122,424,546,145,839,984,1530,46,351,Connecticut,Norfolk,242803
3063,2011-2012,2011-10-28,2012-04-01,157,0,44,246,290,76,168,244,534,26,151,Connecticut,Norfolk,242803
3064,2012-2013,2012-11-08,2013-04-08,152,3,75,324,399,111,556,667,1066,42,237,Connecticut,Norfolk,242803
3065,2013-2014,2013-11-12,2014-04-16,156,0,146,503,649,121,673,794,1443,42,350,Connecticut,Norfolk,242803
3066,2014-2015,2014-11-14,2015-04-12,150,0,154,503,657,130,769,899,1556,51,395,Connecticut,Norfolk,242803
3067,2015-2016,2015-11-24,2016-04-06,135,0,63,267,330,50,122,172,502,20,123,Connecticut,Norfolk,242803
3068,2016-2017,2016-10-28,2017-04-08,163,0,76,338,414,131,446,577,991,46,299,Connecticut,Norfolk,242803
3069,2017-2018,2017-11-08,2018-04-20,164,0,113,419,532,161,534,695,1227,57,380,Connecticut,Norfolk,242803
3070,2018-2019,2018-11-15,2019-04-06,143,0,100,393,493,89,333,422,915,43,242,Connecticut,Norfolk,242803
3071,2019-2020,2019-11-08,2020-05-10,185,0,56,318,374,92,175,267,641,48,209,Connecticut,Norfolk,242803
3072,1950-1951,1950-11-25,1951-03-21,117,0,14,106,120,15,8,23,143,8,29,District of Columbia,Washington,601723
3073,1951-1952,1951-12-01,1952-03-03,94,0,6,64,70,14,5,19,89,6,19,District of Columbia,Washington,601723
3074,1952-1953,1952-11-29,1953-03-08,100,0,1,57,58,13,8,21,79,8,22,District of Columbia,Washington,601723
3075,1953-1954,1953-11-06,1954-02-28,115,0,9,84,93,26,34,60,153,7,38,District of Columbia,Washington,601723
3076,1954-1955,1954-12-01,1955-02-28,90,0,13,104,117,11,5,16,133,7,23,District of Columbia,Washington,601723
3077,1955-1956,1955-11-19,1956-03-19,122,0,7,112,119,20,10,30,149,12,32,District of Columbia,Washington,601723
3078,1956-1957,1956-11-24,1957-04-13,141,0,11,86,97,25,20,45,142,15,45,District of Columbia,Washington,601723
3079,1957-1958,1957-11-23,1958-03-21,119,0,19,113,132,57,56,113,245,15,74,District of Columbia,Washington,601723
3080,1958-1959,1958-11-30,1959-02-28,91,0,18,126,144,6,3,9,153,3,14,District of Columbia,Washington,601723
3081,1959-1960,1959-12-01,1960-03-17,108,0,10,90,100,32,55,87,187,9,50,District of Columbia,Washington,601723
3082,1960-1961,1960-12-01,1961-02-28,90,0,32,153,185,55,170,225,410,10,83,District of Columbia,Washington,601723
3083,1961-1962,1961-11-19,1962-03-07,109,0,13,121,134,26,22,48,182,18,52,District of Columbia,Washington,601723
3084,1962-1963,1962-12-01,1963-03-21,111,0,24,167,191,31,71,102,293,12,51,District of Columbia,Washington,601723
3085,1963-1964,1963-12-01,1964-04-01,123,0,13,140,153,50,77,127,280,14,76,District of Columbia,Washington,601723
3086,1964-1965,1964-11-30,1965-03-21,112,0,12,132,144,21,25,46,190,10,47,District of Columbia,Washington,601723
3087,1965-1966,1965-12-01,1966-02-28,90,0,11,109,120,41,73,114,234,8,69,District of Columbia,Washington,601723
3088,1966-1967,1966-12-01,1967-03-21,111,0,8,114,122,52,70,122,244,14,80,District of Columbia,Washington,601723
3089,1967-1968,1967-11-30,1968-03-12,104,0,14,148,162,32,35,67,229,12,49,District of Columbia,Washington,601723
3090,1968-1969,1968-12-01,1969-03-09,99,0,6,106,112,15,5,20,132,8,21,District of Columbia,Washington,601723
3091,1969-1970,1969-12-01,1970-02-28,90,0,20,135,155,22,21,43,198,11,42,District of Columbia,Washington,601723
3092,1970-1971,1970-12-01,1971-03-26,116,0,13,114,127,19,18,37,164,9,31,District of Columbia,Washington,601723
3093,1971-1972,1971-11-24,1972-04-08,137,0,5,95,100,25,10,35,135,10,33,District of Columbia,Washington,601723
3094,1972-1973,1972-12-01,1973-02-28,90,0,7,86,93,1,0,1,94,1,2,District of Columbia,Washington,601723
3095,1973-1974,1973-12-01,1974-02-28,90,0,2,50,52,25,29,54,106,6,32,District of Columbia,Washington,601723
3096,1974-1975,1974-12-01,1975-03-10,100,0,2,55,57,19,10,29,86,8,27,District of Columbia,Washington,601723
3097,1975-1976,1975-12-01,1976-03-09,100,0,7,84,91,4,1,5,96,4,11,District of Columbia,Washington,601723
3098,1976-1977,1976-11-12,1977-02-28,109,0,18,187,205,18,60,78,283,10,40,District of Columbia,Washington,601723
3099,1977-1978,1977-11-27,1978-03-10,104,0,12,145,157,34,60,94,251,15,62,District of Columbia,Washington,601723
3100,1978-1979,1978-11-26,1979-02-28,95,0,21,116,137,52,103,155,292,14,84,District of Columbia,Washington,601723
3101,1979-1980,1979-10-10,1980-03-14,157,0,8,85,93,29,36,65,158,12,50,District of Columbia,Washington,601723
3102,1980-1981,1980-12-01,1981-02-28,90,0,15,100,115,6,4,10,125,4,11,District of Columbia,Washington,601723
3103,1981-1982,1981-12-01,1982-03-07,97,0,21,128,149,34,86,120,269,16,68,District of Columbia,Washington,601723
3104,1982-1983,1982-12-01,1983-02-28,90,0,2,58,60,38,63,101,161,4,45,District of Columbia,Washington,601723
3105,1983-1984,1983-11-25,1984-03-13,110,0,21,123,144,12,25,37,181,7,24,District of Columbia,Washington,601723
3106,1984-1985,1984-12-01,1985-02-28,90,0,14,105,119,15,14,29,148,9,37,District of Columbia,Washington,601723
3107,1985-1986,1985-12-01,1986-02-28,90,0,17,107,124,23,28,51,175,14,51,District of Columbia,Washington,601723
3108,1986-1987,1986-12-01,1987-02-28,90,0,9,79,88,42,91,133,221,7,59,District of Columbia,Washington,601723
3109,1987-1988,1987-11-11,1988-03-21,132,0,16,121,137,32,70,102,239,7,49,District of Columbia,Washington,601723
3110,1988-1989,1988-12-01,1989-03-08,98,0,7,82,89,12,2,14,103,9,22,District of Columbia,Washington,601723
3111,1989-1990,1989-11-22,1990-04-07,137,0,20,120,140,22,68,90,230,12,35,District of Columbia,Washington,601723
3112,1990-1991,1990-12-01,1991-02-28,90,0,3,56,59,11,8,19,78,4,15,District of Columbia,Washington,601723
3113,1991-1992,1991-12-01,1992-02-29,91,0,1,73,74,8,9,17,91,3,14,District of Columbia,Washington,601723
3114,1992-1993,1992-12-01,1993-03-17,107,0,6,90,96,17,20,37,133,5,23,District of Columbia,Washington,601723
3115,1993-1994,1993-12-01,1994-03-18,108,0,28,144,172,23,38,61,233,15,60,District of Columbia,Washington,601723
3116,1994-1995,1994-12-01,1995-03-08,98,0,6,80,86,13,23,36,122,4,17,District of Columbia,Washington,601723
3117,1995-1996,1995-11-11,1996-03-09,120,0,24,142,166,65,130,195,361,16,106,District of Columbia,Washington,601723
3118,1996-1997,1996-11-14,1997-02-28,107,0,8,67,75,11,6,17,92,7,19,District of Columbia,Washington,601723
3119,1997-1998,1997-12-01,1998-02-28,90,0,0,29,29,1,0,1,30,1,1,District of Columbia,Washington,601723
3120,1998-1999,1998-12-01,1999-03-14,104,0,12,73,85,19,12,31,116,6,33,District of Columbia,Washington,601723
3121,1999-2000,1999-12-01,2000-02-29,91,0,11,74,85,22,72,94,179,6,34,District of Columbia,Washington,601723
3122,2000-2001,2000-12-01,2001-03-05,95,0,7,101,108,12,9,21,129,6,21,District of Columbia,Washington,601723
3123,2001-2002,2001-12-01,2002-02-28,90,0,1,46,47,5,2,7,54,3,8,District of Columbia,Washington,601723
3124,2002-2003,2002-12-01,2003-03-02,92,0,14,107,121,58,101,159,280,19,89,District of Columbia,Washington,601723
3125,2003-2004,2003-12-01,2004-02-29,91,0,18,110,128,17,42,59,187,8,39,District of Columbia,Washington,601723
3126,2004-2005,2004-12-01,2005-03-09,99,0,15,99,114,19,18,37,151,11,49,District of Columbia,Washington,601723
3127,2005-2006,2005-12-01,2006-02-28,90,0,3,62,65,20,16,36,101,7,27,District of Columbia,Washington,601723
3128,2006-2007,2006-12-01,2007-04-07,128,0,9,109,118,16,17,33,151,11,41,District of Columbia,Washington,601723
3129,2007-2008,2007-12-01,2008-02-29,91,0,2,51,53,7,6,13,66,3,9,District of Columbia,Washington,601723
3130,2008-2009,2008-12-01,2009-03-04,94,0,12,112,124,11,11,22,146,4,20,District of Columbia,Washington,601723
3131,2009-2010,2009-12-01,2010-02-28,90,0,11,89,100,82,170,252,352,13,108,District of Columbia,Washington,601723
3132,2010-2011,2010-12-01,2011-03-27,117,0,5,96,101,21,24,45,146,13,40,District of Columbia,Washington,601723
3133,2011-2012,2011-12-01,2012-02-29,91,0,1,34,35,5,1,6,41,5,11,District of Columbia,Washington,601723
3134,2012-2013,2012-12-01,2013-03-25,115,0,4,52,56,9,1,10,66,8,22,District of Columbia,Washington,601723
3135,2013-2014,2013-12-01,2014-03-25,115,0,15,125,140,40,51,91,231,16,72,District of Columbia,Washington,601723
3136,2014-2015,2014-12-01,2015-03-08,98,0,16,109,125,28,40,68,193,14,66,District of Columbia,Washington,601723
3137,2015-2016,2015-12-01,2016-03-04,95,0,10,71,81,31,51,82,163,8,55,District of Columbia,Washington,601723
3138,2016-2017,2016-12-01,2017-03-16,106,0,4,54,58,6,5,11,69,4,13,District of Columbia,Washington,601723
3139,2017-2018,2017-12-01,2018-03-22,112,0,16,100,116,14,6,20,136,8,26,District of Columbia,Washington,601723
3140,2018-2019,2018-11-15,2019-03-01,107,0,6,57,63,26,29,55,118,11,38,District of Columbia,Washington,601723
3141,2019-2020,2019-12-01,2020-02-29,91,0,0,42,42,3,0,3,45,3,4,District of Columbia,Washington,601723
3142,1950-1951,1950-12-01,1951-03-22,112,4,10,143,153,6,3,9,162,4,14,Delaware,Dover,4213
3143,1951-1952,1951-12-01,1952-03-03,94,1,4,86,90,21,16,37,127,5,29,Delaware,Dover,4213
3144,1953-1954,1953-11-06,1954-02-28,115,0,5,109,114,30,57,87,201,6,42,Delaware,Dover,4213
3145,1954-1955,1954-12-01,1955-03-18,108,0,10,125,135,21,14,35,170,11,38,Delaware,Dover,4213
3146,1955-1956,1955-11-19,1956-03-19,122,0,7,139,146,21,16,37,183,7,28,Delaware,Dover,4213
3147,1956-1957,1956-12-01,1957-02-28,90,0,6,99,105,10,10,20,125,5,20,Delaware,Dover,4213
3148,1957-1958,1957-12-01,1958-03-21,111,0,16,154,170,38,66,104,274,10,60,Delaware,Dover,4213
3149,1958-1959,1958-12-01,1959-02-28,90,2,13,171,184,9,7,16,200,3,16,Delaware,Dover,4213
3150,1959-1960,1959-12-01,1960-03-16,107,5,7,119,126,19,47,66,192,5,25,Delaware,Dover,4213
3151,1960-1961,1960-12-01,1961-02-28,90,3,23,202,225,46,219,265,490,11,89,Delaware,Dover,4213
3152,1963-1964,1963-12-01,1964-04-01,123,3,15,157,172,41,73,114,286,9,60,Delaware,Dover,4213
3153,1964-1965,1964-12-01,1965-03-21,111,0,12,142,154,19,30,49,203,8,43,Delaware,Dover,4213
3154,1965-1966,1965-12-01,1966-02-28,90,0,16,130,146,32,75,107,253,7,56,Delaware,Dover,4213
3155,1966-1967,1966-12-01,1967-03-18,108,0,10,148,158,61,99,160,318,11,87,Delaware,Dover,4213
3156,1967-1968,1967-11-30,1968-03-01,93,0,17,163,180,34,37,71,251,11,61,Delaware,Dover,4213
3157,1968-1969,1968-12-01,1969-03-09,99,0,8,139,147,37,43,80,227,6,43,Delaware,Dover,4213
3158,1969-1970,1969-12-01,1970-02-28,90,0,16,166,182,15,25,40,222,6,33,Delaware,Dover,4213
3159,1970-1971,1970-12-01,1971-03-04,94,0,16,123,139,10,9,19,158,4,19,Delaware,Dover,4213
3160,1971-1972,1971-12-01,1972-04-08,130,0,5,113,118,26,7,33,151,7,33,Delaware,Dover,4213
3161,1972-1973,1972-12-01,1973-02-28,90,0,11,93,104,2,2,4,108,1,3,Delaware,Dover,4213
3162,1973-1974,1973-12-01,1974-02-28,90,0,4,90,94,17,18,35,129,5,31,Delaware,Dover,4213
3163,1974-1975,1974-12-01,1975-02-28,90,1,1,76,77,8,4,12,89,3,12,Delaware,Dover,4213
3164,1975-1976,1975-12-01,1976-03-17,108,1,13,126,139,14,10,24,163,6,27,Delaware,Dover,4213
3165,1976-1977,1976-12-01,1977-02-28,90,0,23,197,220,21,15,36,256,8,32,Delaware,Dover,4213
3166,1977-1978,1977-12-01,1978-03-16,106,0,16,202,218,51,58,109,327,12,74,Delaware,Dover,4213
3167,1979-1980,1979-10-10,1980-03-03,146,1,10,144,154,30,20,50,204,9,56,Delaware,Dover,4213
3168,1980-1981,1980-12-01,1981-03-20,110,0,19,181,200,8,1,9,209,6,17,Delaware,Dover,4213
3169,1981-1982,1981-12-01,1982-02-28,90,5,18,141,159,35,60,95,254,10,60,Delaware,Dover,4213
3170,1982-1983,1982-12-01,1983-02-28,90,1,4,83,87,33,56,89,176,5,42,Delaware,Dover,4213
3171,1983-1984,1983-12-01,1984-03-10,101,2,15,145,160,10,18,28,188,4,19,Delaware,Dover,4213
3172,1984-1985,1984-12-01,1985-02-28,90,7,12,118,130,21,16,37,167,6,37,Delaware,Dover,4213
3173,1985-1986,1985-12-01,1986-02-28,90,0,13,137,150,30,35,65,215,10,58,Delaware,Dover,4213
3174,1986-1987,1986-12-01,1987-03-10,100,5,7,122,129,46,108,154,283,5,56,Delaware,Dover,4213
3175,1987-1988,1987-12-01,1988-02-29,91,9,10,122,132,17,45,62,194,4,26,Delaware,Dover,4213
3176,1988-1989,1988-12-01,1989-03-09,99,18,8,108,116,12,17,29,145,3,20,Delaware,Dover,4213
3177,1990-1991,1990-12-01,1991-02-28,90,7,1,75,76,13,12,25,101,2,15,Delaware,Dover,4213
3178,1991-1992,1991-12-01,1992-02-29,91,1,5,103,108,3,1,4,112,2,10,Delaware,Dover,4213
3179,1993-1994,1993-12-01,1994-03-02,92,6,28,151,179,13,29,42,221,8,45,Delaware,Dover,4213
3180,1994-1995,1994-12-01,1995-02-28,90,5,7,88,95,3,4,7,102,1,4,Delaware,Dover,4213
3181,1995-1996,1995-12-01,1996-03-09,100,2,27,150,177,47,109,156,333,9,73,Delaware,Dover,4213
3182,1996-1997,1996-12-01,1997-02-28,90,3,9,80,89,9,10,19,108,4,15,Delaware,Dover,4213
3183,1997-1998,1997-12-01,1998-02-28,90,11,1,48,49,0,0,0,49,0,0,Delaware,Dover,4213
3184,1998-1999,1998-12-01,1999-02-28,90,0,8,88,96,3,3,6,102,2,8,Delaware,Dover,4213
3185,1999-2000,1999-12-01,2000-02-29,91,0,11,109,120,27,70,97,217,5,38,Delaware,Dover,4213
3186,2000-2001,2000-12-01,2001-02-28,90,11,9,127,136,16,13,29,165,6,30,Delaware,Dover,4213
3187,2001-2002,2001-12-01,2002-02-28,90,3,1,64,65,3,6,9,74,1,5,Delaware,Dover,4213
3188,2002-2003,2002-12-01,2003-03-03,93,1,14,148,162,63,147,210,372,10,83,Delaware,Dover,4213
3189,2003-2004,2003-12-01,2004-02-29,91,6,17,120,137,11,30,41,178,4,20,Delaware,Dover,4213
3190,2004-2005,2004-12-01,2005-03-09,99,0,16,128,144,17,38,55,199,4,30,Delaware,Dover,4213
3191,2006-2007,2006-12-01,2007-03-07,97,1,8,108,116,9,3,12,128,5,20,Delaware,Dover,4213
3192,2007-2008,2007-12-01,2008-02-29,91,3,6,85,91,7,5,12,103,5,16,Delaware,Dover,4213
3193,2009-2010,2009-12-01,2010-02-28,90,2,9,126,135,96,164,260,395,19,134,Delaware,Dover,4213
3194,2014-2015,2014-12-01,2015-03-08,98,0,17,166,183,23,34,57,240,6,40,Delaware,Dover,4213
3195,2015-2016,2015-12-01,2016-03-04,95,0,10,95,105,26,38,64,169,7,43,Delaware,Dover,4213
3196,2016-2017,2016-12-01,2017-02-28,90,0,5,67,72,9,11,20,92,3,14,Delaware,Dover,4213
3197,2017-2018,2017-12-01,2018-03-21,111,14,19,127,146,21,18,39,185,7,31,Delaware,Dover,4213
3198,2019-2020,2019-12-01,2020-02-29,91,4,1,68,69,0,0,0,69,0,0,Delaware,Dover,4213
3199,1950-1951,1950-11-26,1951-02-28,95,0,19,159,178,13,4,17,195,11,43,Delaware,Wilmington,106476
3200,1951-1952,1951-12-01,1952-03-04,95,0,9,116,125,23,30,53,178,5,30,Delaware,Wilmington,106476
3201,1952-1953,1952-11-29,1953-03-10,102,0,3,89,92,24,19,43,135,10,37,Delaware,Wilmington,106476
3202,1953-1954,1953-11-06,1954-03-31,146,0,16,160,176,33,58,91,267,8,55,Delaware,Wilmington,106476
3203,1954-1955,1954-12-01,1955-03-18,108,0,16,150,166,22,23,45,211,12,38,Delaware,Wilmington,106476
3204,1955-1956,1955-11-19,1956-03-28,131,0,19,192,211,38,52,90,301,14,60,Delaware,Wilmington,106476
3205,1956-1957,1956-12-01,1957-03-01,91,0,16,125,141,16,17,33,174,12,46,Delaware,Wilmington,106476
3206,1957-1958,1957-12-01,1958-03-24,114,0,32,179,211,70,109,179,390,14,98,Delaware,Wilmington,106476
3207,1958-1959,1958-11-30,1959-04-12,134,0,26,225,251,14,8,22,273,10,33,Delaware,Wilmington,106476
3208,1959-1960,1959-11-18,1960-03-22,126,0,13,166,179,35,55,90,269,18,76,Delaware,Wilmington,106476
3209,1960-1961,1960-12-01,1961-03-22,112,0,40,240,280,66,208,274,554,21,144,Delaware,Wilmington,106476
3210,1961-1962,1961-11-20,1962-03-10,111,0,19,190,209,38,37,75,284,19,79,Delaware,Wilmington,106476
3211,1962-1963,1962-10-26,1963-03-11,137,0,43,253,296,27,53,80,376,13,59,Delaware,Wilmington,106476
3212,1963-1964,1963-12-01,1964-03-30,121,0,27,197,224,54,84,138,362,17,93,Delaware,Wilmington,106476
3213,1964-1965,1964-12-01,1965-04-02,123,0,23,203,226,28,40,68,294,12,51,Delaware,Wilmington,106476
3214,1965-1966,1965-12-01,1966-02-28,90,0,27,163,190,39,86,125,315,13,84,Delaware,Wilmington,106476
3215,1966-1967,1966-12-01,1967-03-23,113,0,20,176,196,67,115,182,378,23,123,Delaware,Wilmington,106476
3216,1967-1968,1967-11-30,1968-03-12,104,0,29,196,225,23,40,63,288,11,47,Delaware,Wilmington,106476
3217,1968-1969,1968-12-01,1969-03-07,97,0,14,148,162,26,22,48,210,12,44,Delaware,Wilmington,106476
3218,1969-1970,1969-11-30,1970-03-29,120,0,35,212,247,27,52,79,326,13,58,Delaware,Wilmington,106476
3219,1970-1971,1970-12-01,1971-04-07,128,0,25,180,205,21,19,40,245,13,46,Delaware,Wilmington,106476
3220,1971-1972,1971-12-01,1972-04-07,129,0,13,149,162,16,22,38,200,9,35,Delaware,Wilmington,106476
3221,1972-1973,1972-12-01,1973-02-28,90,0,9,101,110,3,1,4,114,3,8,Delaware,Wilmington,106476
3222,1973-1974,1973-12-01,1974-02-28,90,0,14,119,133,27,39,66,199,7,41,Delaware,Wilmington,106476
3223,1974-1975,1974-12-01,1975-03-14,104,0,7,105,112,16,7,23,135,10,32,Delaware,Wilmington,106476
3224,1975-1976,1975-12-01,1976-03-17,108,0,18,154,172,22,16,38,210,10,47,Delaware,Wilmington,106476
3225,1976-1977,1976-11-29,1977-02-28,92,0,49,247,296,27,77,104,400,14,73,Delaware,Wilmington,106476
3226,1977-1978,1977-11-27,1978-03-17,111,0,48,265,313,62,182,244,557,20,114,Delaware,Wilmington,106476
3227,1978-1979,1978-11-27,1979-03-11,105,0,49,219,268,61,106,167,435,18,138,Delaware,Wilmington,106476
3228,1979-1980,1979-12-01,1980-03-31,122,0,20,175,195,23,22,45,240,16,62,Delaware,Wilmington,106476
3229,1980-1981,1980-11-17,1981-03-06,110,0,37,215,252,18,36,54,306,13,51,Delaware,Wilmington,106476
3230,1981-1982,1981-12-01,1982-04-09,130,0,29,218,247,38,90,128,375,18,80,Delaware,Wilmington,106476
3231,1982-1983,1982-12-01,1983-04-20,141,0,7,125,132,35,61,96,228,7,48,Delaware,Wilmington,106476
3232,1983-1984,1983-12-01,1984-03-13,104,0,43,244,287,20,51,71,358,10,61,Delaware,Wilmington,106476
3233,1984-1985,1984-12-01,1985-04-09,130,0,16,159,175,23,29,52,227,12,56,Delaware,Wilmington,106476
3234,1985-1986,1985-12-01,1986-03-08,98,0,25,173,198,24,33,57,255,14,58,Delaware,Wilmington,106476
3235,1986-1987,1986-12-01,1987-04-06,127,0,11,154,165,63,105,168,333,17,89,Delaware,Wilmington,106476
3236,1987-1988,1987-11-11,1988-02-29,111,0,23,167,190,24,36,60,250,12,53,Delaware,Wilmington,106476
3237,1988-1989,1988-12-01,1989-03-09,99,0,18,134,152,18,13,31,183,9,37,Delaware,Wilmington,106476
3238,1989-1990,1989-11-22,1990-04-07,137,0,24,172,196,31,42,73,269,18,64,Delaware,Wilmington,106476
3239,1990-1991,1990-12-01,1991-03-30,120,0,7,109,116,20,19,39,155,7,31,Delaware,Wilmington,106476
3240,1991-1992,1991-12-01,1992-03-22,113,0,10,124,134,7,2,9,143,7,23,Delaware,Wilmington,106476
3241,1992-1993,1992-12-01,1993-03-21,111,0,11,147,158,38,48,86,244,13,62,Delaware,Wilmington,106476
3242,1993-1994,1993-12-01,1994-03-18,108,0,41,187,228,27,70,97,325,15,75,Delaware,Wilmington,106476
3243,1994-1995,1994-12-01,1995-02-28,90,0,13,121,134,13,33,46,180,4,22,Delaware,Wilmington,106476
3244,1996-1997,1996-11-28,1997-04-01,125,16,16,130,146,21,14,35,181,8,31,Delaware,Wilmington,106476
3245,1997-1998,1997-12-01,1998-02-28,90,0,0,67,67,0,0,0,67,0,0,Delaware,Wilmington,106476
3246,1998-1999,1998-12-01,1999-03-15,105,3,16,125,141,14,6,20,161,6,33,Delaware,Wilmington,106476
3247,1999-2000,1999-12-01,2000-04-09,131,11,21,133,154,27,74,101,255,7,43,Delaware,Wilmington,106476
3248,2000-2001,2000-12-01,2001-03-26,116,0,18,170,188,18,25,43,231,10,47,Delaware,Wilmington,106476
3249,2001-2002,2001-12-01,2002-02-28,90,0,3,83,86,4,2,6,92,2,9,Delaware,Wilmington,106476
3250,2002-2003,2002-12-01,2003-03-10,100,5,31,182,213,66,147,213,426,18,119,Delaware,Wilmington,106476
3251,2003-2004,2003-12-01,2004-03-19,110,0,35,177,212,30,67,97,309,16,80,Delaware,Wilmington,106476
3252,2004-2005,2004-12-01,2005-03-09,99,0,29,155,184,42,63,105,289,15,92,Delaware,Wilmington,106476
3253,2005-2006,2005-11-23,2006-04-05,134,0,4,132,136,31,33,64,200,10,46,Delaware,Wilmington,106476
3254,2006-2007,2006-12-01,2007-03-19,109,0,19,146,165,24,18,42,207,15,59,Delaware,Wilmington,106476
3255,2007-2008,2007-12-01,2008-02-29,91,0,5,99,104,15,8,23,127,6,26,Delaware,Wilmington,106476
3256,2008-2009,2008-11-21,2009-03-05,105,2,22,158,180,26,21,47,227,12,54,Delaware,Wilmington,106476
3257,2009-2010,2009-12-01,2010-02-28,90,0,19,131,150,100,175,275,425,17,134,Delaware,Wilmington,106476
3258,2010-2011,2010-12-01,2011-02-28,90,0,22,162,184,39,84,123,307,15,81,Delaware,Wilmington,106476
3259,2011-2012,2011-10-29,2012-02-29,124,0,5,92,97,10,6,16,113,6,20,Delaware,Wilmington,106476
3260,2012-2013,2012-12-01,2013-03-25,115,0,10,105,115,13,4,17,132,11,33,Delaware,Wilmington,106476
3261,2013-2014,2013-11-24,2014-03-26,123,0,38,230,268,81,143,224,492,19,136,Delaware,Wilmington,106476
3262,2014-2015,2014-11-26,2015-03-21,116,3,32,204,236,37,53,90,326,16,85,Delaware,Wilmington,106476
3263,2015-2016,2015-12-01,2016-03-04,95,0,13,111,124,37,52,89,213,11,60,Delaware,Wilmington,106476
3264,2016-2017,2016-12-01,2017-03-16,106,0,8,106,114,16,10,26,140,10,37,Delaware,Wilmington,106476
3265,2017-2018,2017-12-01,2018-03-23,113,0,26,164,190,39,40,79,269,13,65,Delaware,Wilmington,106476
3266,2018-2019,2018-11-15,2019-03-06,112,0,13,139,152,28,28,56,208,12,57,Delaware,Wilmington,106476
3267,2019-2020,2019-12-01,2020-02-29,91,0,2,80,82,4,0,4,86,4,8,Delaware,Wilmington,106476
3268,1950-1951,1950-12-01,1951-02-28,90,0,0,14,14,0,0,0,14,0,0,Florida,Gainesville,124354
3269,1951-1952,1951-12-01,1952-02-29,91,0,0,5,5,0,0,0,5,0,0,Florida,Gainesville,124354
3270,1952-1953,1952-12-01,1953-02-28,90,0,0,4,4,0,0,0,4,0,0,Florida,Gainesville,124354
3271,1953-1954,1953-12-01,1954-02-28,90,0,0,5,5,0,0,0,5,0,0,Florida,Gainesville,124354
3272,1954-1955,1954-12-01,1955-02-28,90,3,0,13,13,0,0,0,13,0,0,Florida,Gainesville,124354
3273,1955-1956,1955-12-01,1956-02-29,91,0,0,7,7,0,0,0,7,0,0,Florida,Gainesville,124354
3274,1956-1957,1956-12-01,1957-02-28,90,1,0,4,4,0,0,0,4,0,0,Florida,Gainesville,124354
3275,1957-1958,1957-12-01,1958-02-28,90,0,0,44,44,0,0,0,44,0,0,Florida,Gainesville,124354
3276,1958-1959,1958-12-01,1959-02-28,90,0,0,17,17,0,0,0,17,0,0,Florida,Gainesville,124354
3277,1959-1960,1959-12-01,1960-02-29,91,0,0,22,22,0,0,0,22,0,0,Florida,Gainesville,124354
3278,1960-1961,1960-12-01,1961-02-28,90,0,0,22,22,0,0,0,22,0,0,Florida,Gainesville,124354
3279,1961-1962,1961-12-01,1962-02-28,90,0,0,22,22,0,0,0,22,0,0,Florida,Gainesville,124354
3280,1962-1963,1962-12-01,1963-02-28,90,0,0,33,33,0,0,0,33,0,0,Florida,Gainesville,124354
3281,1963-1964,1963-12-01,1964-02-29,91,0,0,26,26,0,0,0,26,0,0,Florida,Gainesville,124354
3282,1964-1965,1964-12-01,1965-02-28,90,0,0,13,13,0,0,0,13,0,0,Florida,Gainesville,124354
3283,1965-1966,1965-12-01,1966-02-28,90,0,0,19,19,0,0,0,19,0,0,Florida,Gainesville,124354
3284,1966-1967,1966-12-01,1967-02-28,90,0,0,15,15,0,0,0,15,0,0,Florida,Gainesville,124354
3285,1967-1968,1967-12-01,1968-02-29,91,0,0,20,20,0,0,0,20,0,0,Florida,Gainesville,124354
3286,1968-1969,1968-12-01,1969-02-28,90,0,0,18,18,0,0,0,18,0,0,Florida,Gainesville,124354
3287,1969-1970,1969-12-01,1970-02-28,90,0,0,19,19,0,0,0,19,0,0,Florida,Gainesville,124354
3288,1970-1971,1970-12-01,1971-02-28,90,0,0,22,22,0,0,0,22,0,0,Florida,Gainesville,124354
3289,1971-1972,1971-12-01,1972-02-29,91,0,0,6,6,0,0,0,6,0,0,Florida,Gainesville,124354
3290,1972-1973,1972-12-01,1973-02-28,90,0,0,11,11,0,0,0,11,0,0,Florida,Gainesville,124354
3291,1973-1974,1973-12-01,1974-02-28,90,0,0,11,11,0,0,0,11,0,0,Florida,Gainesville,124354
3292,1974-1975,1974-12-01,1975-02-28,90,0,0,8,8,0,0,0,8,0,0,Florida,Gainesville,124354
3293,1975-1976,1975-12-01,1976-02-29,91,0,0,22,22,0,0,0,22,0,0,Florida,Gainesville,124354
3294,1976-1977,1976-12-01,1977-02-28,90,0,0,27,27,0,0,0,27,0,0,Florida,Gainesville,124354
3295,1977-1978,1977-12-01,1978-02-28,90,0,0,26,26,0,0,0,26,0,0,Florida,Gainesville,124354
3296,1978-1979,1978-12-01,1979-02-28,90,0,0,17,17,0,0,0,17,0,0,Florida,Gainesville,124354
3297,1979-1980,1979-12-01,1980-02-29,91,0,0,17,17,0,0,0,17,0,0,Florida,Gainesville,124354
3298,1980-1981,1980-12-01,1981-02-28,90,0,0,26,26,0,0,0,26,0,0,Florida,Gainesville,124354
3299,1981-1982,1981-12-01,1982-02-28,90,0,0,21,21,0,0,0,21,0,0,Florida,Gainesville,124354
3300,1982-1983,1982-12-01,1983-02-28,90,0,0,12,12,0,0,0,12,0,0,Florida,Gainesville,124354
3301,1983-1984,1983-12-01,1984-02-29,91,0,0,14,14,0,0,0,14,0,0,Florida,Gainesville,124354
3302,1984-1985,1984-12-01,1985-02-28,90,0,1,28,29,0,0,0,29,0,0,Florida,Gainesville,124354
3303,1985-1986,1985-12-01,1986-02-28,90,0,0,19,19,0,0,0,19,0,0,Florida,Gainesville,124354
3304,1986-1987,1986-12-01,1987-02-28,90,0,0,9,9,0,0,0,9,0,0,Florida,Gainesville,124354
3305,1987-1988,1987-12-01,1988-02-29,91,0,0,19,19,0,0,0,19,0,0,Florida,Gainesville,124354
3306,1988-1989,1988-12-01,1989-02-28,90,0,0,11,11,0,0,0,11,0,0,Florida,Gainesville,124354
3307,1989-1990,1989-12-01,1990-02-28,90,0,1,21,22,0,0,0,22,0,0,Florida,Gainesville,124354
3308,1990-1991,1990-12-01,1991-02-28,90,0,0,6,6,0,0,0,6,0,0,Florida,Gainesville,124354
3309,1991-1992,1991-12-01,1992-02-29,91,0,0,11,11,0,0,0,11,0,0,Florida,Gainesville,124354
3310,1992-1993,1992-12-01,1993-02-28,90,0,0,3,3,0,0,0,3,0,0,Florida,Gainesville,124354
3311,1993-1994,1993-12-01,1994-02-28,90,0,0,11,11,0,0,0,11,0,0,Florida,Gainesville,124354
3312,1994-1995,1994-12-01,1995-02-28,90,0,0,11,11,0,0,0,11,0,0,Florida,Gainesville,124354
3313,1995-1996,1995-12-01,1996-02-29,91,0,0,26,26,0,0,0,26,0,0,Florida,Gainesville,124354
3314,1996-1997,1996-12-01,1997-02-28,90,0,0,11,11,0,0,0,11,0,0,Florida,Gainesville,124354
3315,1997-1998,1997-12-01,1998-02-28,90,0,0,3,3,0,0,0,3,0,0,Florida,Gainesville,124354
3316,1998-1999,1998-12-01,1999-02-28,90,0,0,16,16,0,0,0,16,0,0,Florida,Gainesville,124354
3317,1999-2000,1999-12-01,2000-02-29,91,0,0,18,18,0,0,0,18,0,0,Florida,Gainesville,124354
3318,2000-2001,2000-12-01,2001-02-28,90,0,0,35,35,0,0,0,35,0,0,Florida,Gainesville,124354
3319,2001-2002,2001-12-01,2002-02-28,90,0,0,16,16,0,0,0,16,0,0,Florida,Gainesville,124354
3320,2002-2003,2002-12-01,2003-02-28,90,0,0,23,23,0,0,0,23,0,0,Florida,Gainesville,124354
3321,2003-2004,2003-12-01,2004-02-29,91,0,0,18,18,0,0,0,18,0,0,Florida,Gainesville,124354
3322,2009-2010,2009-12-01,2010-02-28,90,0,0,35,35,0,0,0,35,0,0,Florida,Gainesville,124354
3323,2010-2011,2010-12-01,2011-02-28,90,0,0,34,34,0,0,0,34,0,0,Florida,Gainesville,124354
3324,2011-2012,2011-12-01,2012-02-29,91,0,0,11,11,0,0,0,11,0,0,Florida,Gainesville,124354
3325,2012-2013,2012-12-01,2013-02-28,90,0,0,9,9,0,0,0,9,0,0,Florida,Gainesville,124354
3326,2013-2014,2013-12-01,2014-02-28,90,0,0,12,12,0,0,0,12,0,0,Florida,Gainesville,124354
3327,2014-2015,2014-12-01,2015-02-28,90,1,0,14,14,0,0,0,14,0,0,Florida,Gainesville,124354
3328,2015-2016,2015-12-01,2016-02-29,91,2,0,12,12,0,0,0,12,0,0,Florida,Gainesville,124354
3329,2016-2017,2016-12-01,2017-02-28,90,3,0,3,3,0,0,0,3,0,0,Florida,Gainesville,124354
3330,2017-2018,2017-12-01,2018-02-28,90,0,0,20,20,0,0,0,20,0,0,Florida,Gainesville,124354
3331,2018-2019,2018-12-01,2019-02-28,90,0,0,4,4,0,0,0,4,0,0,Florida,Gainesville,124354
3332,2019-2020,2019-12-01,2020-02-29,91,0,0,5,5,0,0,0,5,0,0,Florida,Gainesville,124354
3333,1950-1951,1950-12-01,1951-02-28,90,0,0,8,8,0,0,0,8,0,0,Florida,Jacksonville,821784
3334,1951-1952,1951-12-01,1952-02-29,91,0,0,2,2,0,0,0,2,0,0,Florida,Jacksonville,821784
3335,1952-1953,1952-12-01,1953-02-28,90,0,0,2,2,0,0,0,2,0,0,Florida,Jacksonville,821784
3336,1953-1954,1953-12-01,1954-02-28,90,0,0,2,2,0,0,0,2,0,0,Florida,Jacksonville,821784
3337,1954-1955,1954-12-01,1955-02-28,90,0,0,6,6,0,0,0,6,0,0,Florida,Jacksonville,821784
3338,1955-1956,1955-12-01,1956-02-29,91,0,0,10,10,0,0,0,10,0,0,Florida,Jacksonville,821784
3339,1956-1957,1956-12-01,1957-02-28,90,0,0,2,2,0,0,0,2,0,0,Florida,Jacksonville,821784
3340,1957-1958,1957-12-01,1958-02-28,90,0,0,31,31,2,0,2,33,1,3,Florida,Jacksonville,821784
3341,1958-1959,1958-12-01,1959-02-28,90,0,0,14,14,0,0,0,14,0,0,Florida,Jacksonville,821784
3342,1959-1960,1959-12-01,1960-02-29,91,0,0,13,13,0,0,0,13,0,0,Florida,Jacksonville,821784
3343,1960-1961,1960-12-01,1961-02-28,90,0,0,17,17,0,0,0,17,0,0,Florida,Jacksonville,821784
3344,1961-1962,1961-12-01,1962-02-28,90,0,0,11,11,0,0,0,11,0,0,Florida,Jacksonville,821784
3345,1962-1963,1962-12-01,1963-02-28,90,0,0,23,23,0,0,0,23,0,0,Florida,Jacksonville,821784
3346,1963-1964,1963-12-01,1964-02-29,91,0,0,14,14,0,0,0,14,0,0,Florida,Jacksonville,821784
3347,1964-1965,1964-12-01,1965-02-28,90,0,0,8,8,0,0,0,8,0,0,Florida,Jacksonville,821784
3348,1965-1966,1965-12-01,1966-02-28,90,0,0,15,15,0,0,0,15,0,0,Florida,Jacksonville,821784
3349,1966-1967,1966-12-01,1967-02-28,90,0,0,7,7,0,0,0,7,0,0,Florida,Jacksonville,821784
3350,1967-1968,1967-12-01,1968-02-29,91,0,0,8,8,0,0,0,8,0,0,Florida,Jacksonville,821784
3351,1968-1969,1968-12-01,1969-02-28,90,0,0,7,7,0,0,0,7,0,0,Florida,Jacksonville,821784
3352,1969-1970,1969-12-01,1970-02-28,90,0,0,21,21,0,0,0,21,0,0,Florida,Jacksonville,821784
3353,1970-1971,1970-12-01,1971-02-28,90,0,0,21,21,0,0,0,21,0,0,Florida,Jacksonville,821784
3354,1971-1972,1971-12-01,1972-02-29,91,0,0,4,4,0,0,0,4,0,0,Florida,Jacksonville,821784
3355,1972-1973,1972-12-01,1973-02-28,90,0,0,11,11,0,0,0,11,0,0,Florida,Jacksonville,821784
3356,1973-1974,1973-12-01,1974-02-28,90,0,0,14,14,0,0,0,14,0,0,Florida,Jacksonville,821784
3357,1974-1975,1974-12-01,1975-02-28,90,0,0,10,10,0,0,0,10,0,0,Florida,Jacksonville,821784
3358,1975-1976,1975-12-01,1976-02-29,91,0,0,32,32,0,0,0,32,0,0,Florida,Jacksonville,821784
3359,1976-1977,1976-12-01,1977-02-28,90,0,0,37,37,0,0,0,37,0,0,Florida,Jacksonville,821784
3360,1977-1978,1977-12-01,1978-02-28,90,0,0,31,31,0,0,0,31,0,0,Florida,Jacksonville,821784
3361,1978-1979,1978-12-01,1979-02-28,90,0,0,33,33,0,0,0,33,0,0,Florida,Jacksonville,821784
3362,1979-1980,1979-12-01,1980-02-29,91,0,0,15,15,0,0,0,15,0,0,Florida,Jacksonville,821784
3363,1980-1981,1980-12-01,1981-02-28,90,0,0,33,33,0,0,0,33,0,0,Florida,Jacksonville,821784
3364,1981-1982,1981-12-01,1982-02-28,90,0,0,25,25,0,0,0,25,0,0,Florida,Jacksonville,821784
3365,1982-1983,1982-12-01,1983-02-28,90,0,0,15,15,0,0,0,15,0,0,Florida,Jacksonville,821784
3366,1983-1984,1983-12-01,1984-02-29,91,0,1,28,29,0,0,0,29,0,0,Florida,Jacksonville,821784
3367,1984-1985,1984-12-01,1985-02-28,90,0,1,38,39,0,0,0,39,0,0,Florida,Jacksonville,821784
3368,1985-1986,1985-12-01,1986-03-01,91,0,0,22,22,1,0,1,23,1,1,Florida,Jacksonville,821784
3369,1986-1987,1986-12-01,1987-02-28,90,0,0,11,11,0,0,0,11,0,0,Florida,Jacksonville,821784
3370,1987-1988,1987-12-01,1988-02-29,91,0,0,20,20,0,0,0,20,0,0,Florida,Jacksonville,821784
3371,1988-1989,1988-12-01,1989-02-28,90,0,0,17,17,0,0,0,17,0,0,Florida,Jacksonville,821784
3372,1989-1990,1989-12-01,1990-02-28,90,0,0,16,16,1,1,2,18,1,3,Florida,Jacksonville,821784
3373,1990-1991,1990-12-01,1991-02-28,90,0,0,10,10,0,0,0,10,0,0,Florida,Jacksonville,821784
3374,1991-1992,1991-12-01,1992-02-29,91,0,0,11,11,0,0,0,11,0,0,Florida,Jacksonville,821784
3375,1992-1993,1992-12-01,1993-02-28,90,0,0,4,4,0,0,0,4,0,0,Florida,Jacksonville,821784
3376,1993-1994,1993-12-01,1994-02-28,90,0,0,15,15,0,0,0,15,0,0,Florida,Jacksonville,821784
3377,1994-1995,1994-12-01,1995-02-28,90,0,0,8,8,0,0,0,8,0,0,Florida,Jacksonville,821784
3378,1995-1996,1995-12-01,1996-02-29,91,0,0,26,26,0,0,0,26,0,0,Florida,Jacksonville,821784
3379,1996-1997,1996-12-01,1997-02-28,90,0,0,10,10,0,0,0,10,0,0,Florida,Jacksonville,821784
3380,1997-1998,1997-12-01,1998-02-28,90,0,0,4,4,0,0,0,4,0,0,Florida,Jacksonville,821784
3381,1998-1999,1998-12-01,1999-02-28,90,0,0,15,15,0,0,0,15,0,0,Florida,Jacksonville,821784
3382,1999-2000,1999-12-01,2000-02-29,91,0,0,19,19,0,0,0,19,0,0,Florida,Jacksonville,821784
3383,2000-2001,2000-12-01,2001-02-28,90,0,0,34,34,0,0,0,34,0,0,Florida,Jacksonville,821784
3384,2001-2002,2001-12-01,2002-02-28,90,0,0,9,9,0,0,0,9,0,0,Florida,Jacksonville,821784
3385,2002-2003,2002-12-01,2003-02-28,90,0,0,19,19,0,0,0,19,0,0,Florida,Jacksonville,821784
3386,2003-2004,2003-12-01,2004-02-29,91,0,0,22,22,0,0,0,22,0,0,Florida,Jacksonville,821784
3387,2004-2005,2004-12-01,2005-02-28,90,0,0,13,13,0,0,0,13,0,0,Florida,Jacksonville,821784
3388,2005-2006,2005-12-01,2006-02-28,90,0,0,9,9,0,0,0,9,0,0,Florida,Jacksonville,821784
3389,2006-2007,2006-12-01,2007-02-28,90,5,0,10,10,0,0,0,10,0,0,Florida,Jacksonville,821784
3390,2007-2008,2007-12-01,2008-02-29,91,5,0,11,11,0,0,0,11,0,0,Florida,Jacksonville,821784
3391,2008-2009,2008-12-01,2009-02-28,90,3,0,25,25,0,0,0,25,0,0,Florida,Jacksonville,821784
3392,2009-2010,2009-12-01,2010-02-28,90,0,0,28,28,0,0,0,28,0,0,Florida,Jacksonville,821784
3393,2010-2011,2010-12-01,2011-02-28,90,0,0,37,37,0,0,0,37,0,0,Florida,Jacksonville,821784
3394,2011-2012,2011-12-01,2012-02-29,91,0,0,12,12,0,0,0,12,0,0,Florida,Jacksonville,821784
3395,2012-2013,2012-12-01,2013-02-28,90,0,0,11,11,0,0,0,11,0,0,Florida,Jacksonville,821784
3396,2013-2014,2013-12-01,2014-02-28,90,0,0,10,10,0,0,0,10,0,0,Florida,Jacksonville,821784
3397,2014-2015,2014-12-01,2015-02-28,90,3,0,11,11,0,0,0,11,0,0,Florida,Jacksonville,821784
3398,2015-2016,2015-12-01,2016-02-29,91,3,0,12,12,0,0,0,12,0,0,Florida,Jacksonville,821784
3399,2016-2017,2016-12-01,2017-02-28,90,2,0,4,4,0,0,0,4,0,0,Florida,Jacksonville,821784
3400,2017-2018,2017-12-01,2018-02-28,90,0,0,12,12,0,0,0,12,0,0,Florida,Jacksonville,821784
3401,2018-2019,2018-12-01,2019-02-28,90,0,0,4,4,0,0,0,4,0,0,Florida,Jacksonville,821784
3402,2019-2020,2019-12-01,2020-02-29,91,0,0,3,3,0,0,0,3,0,0,Florida,Jacksonville,821784
3403,1950-1951,1950-12-01,1951-02-28,90,0,0,0,0,0,0,0,0,0,0,Florida,Melbourne,76068
3404,1951-1952,1951-12-01,1952-02-29,91,0,0,0,0,0,0,0,0,0,0,Florida,Melbourne,76068
3405,1952-1953,1952-12-01,1953-02-28,90,0,0,0,0,0,0,0,0,0,0,Florida,Melbourne,76068
3406,1953-1954,1953-12-01,1954-02-28,90,1,0,0,0,0,0,0,0,0,0,Florida,Melbourne,76068
3407,1954-1955,1954-12-01,1955-02-28,90,0,0,1,1,0,0,0,1,0,0,Florida,Melbourne,76068
3408,1955-1956,1955-12-01,1956-02-29,91,4,0,0,0,0,0,0,0,0,0,Florida,Melbourne,76068
3409,1957-1958,1957-12-01,1958-02-28,90,1,0,5,5,0,0,0,5,0,0,Florida,Melbourne,76068
3410,1958-1959,1958-12-01,1959-02-28,90,0,0,1,1,0,0,0,1,0,0,Florida,Melbourne,76068
3411,1960-1961,1960-12-01,1961-02-28,90,1,0,3,3,0,0,0,3,0,0,Florida,Melbourne,76068
3412,1961-1962,1961-12-01,1962-02-28,90,1,0,2,2,0,0,0,2,0,0,Florida,Melbourne,76068
3413,1962-1963,1962-12-01,1963-02-28,90,0,0,4,4,0,0,0,4,0,0,Florida,Melbourne,76068
3414,1963-1964,1963-12-01,1964-02-29,91,0,0,1,1,0,0,0,1,0,0,Florida,Melbourne,76068
3415,1964-1965,1964-12-01,1965-02-28,90,0,0,3,3,0,0,0,3,0,0,Florida,Melbourne,76068
3416,1965-1966,1965-12-01,1966-02-28,90,0,0,6,6,0,0,0,6,0,0,Florida,Melbourne,76068
3417,1966-1967,1966-12-01,1967-02-28,90,0,0,3,3,0,0,0,3,0,0,Florida,Melbourne,76068
3418,1967-1968,1967-12-01,1968-02-29,91,0,0,0,0,0,0,0,0,0,0,Florida,Melbourne,76068
3419,1968-1969,1968-12-01,1969-02-28,90,0,0,2,2,0,0,0,2,0,0,Florida,Melbourne,76068
3420,1969-1970,1969-12-01,1970-02-28,90,0,0,6,6,0,0,0,6,0,0,Florida,Melbourne,76068
3421,1970-1971,1970-12-01,1971-02-28,90,0,0,4,4,0,0,0,4,0,0,Florida,Melbourne,76068
3422,1971-1972,1971-12-01,1972-02-29,91,0,0,0,0,0,0,0,0,0,0,Florida,Melbourne,76068
3423,1972-1973,1972-12-01,1973-02-28,90,0,0,2,2,0,0,0,2,0,0,Florida,Melbourne,76068
3424,1973-1974,1973-12-01,1974-02-28,90,0,0,1,1,0,0,0,1,0,0,Florida,Melbourne,76068
3425,1974-1975,1974-12-01,1975-02-28,90,0,0,1,1,0,0,0,1,0,0,Florida,Melbourne,76068
3426,1975-1976,1975-12-01,1976-02-29,91,0,0,1,1,0,0,0,1,0,0,Florida,Melbourne,76068
3427,1976-1977,1976-12-01,1977-02-28,90,0,0,10,10,0,0,0,10,0,0,Florida,Melbourne,76068
3428,1977-1978,1977-12-01,1978-02-28,90,2,0,4,4,0,0,0,4,0,0,Florida,Melbourne,76068
3429,1978-1979,1978-12-01,1979-02-28,90,0,0,1,1,0,0,0,1,0,0,Florida,Melbourne,76068
3430,1979-1980,1979-12-01,1980-02-29,91,3,0,1,1,0,0,0,1,0,0,Florida,Melbourne,76068
3431,1980-1981,1980-12-01,1981-02-28,90,0,0,5,5,0,0,0,5,0,0,Florida,Melbourne,76068
3432,1981-1982,1981-12-01,1982-02-28,90,0,0,6,6,0,0,0,6,0,0,Florida,Melbourne,76068
3433,1982-1983,1982-12-01,1983-02-28,90,4,0,0,0,0,0,0,0,0,0,Florida,Melbourne,76068
3434,1983-1984,1983-12-01,1984-02-29,91,1,0,5,5,0,0,0,5,0,0,Florida,Melbourne,76068
3435,1984-1985,1984-12-01,1985-02-28,90,1,0,5,5,0,0,0,5,0,0,Florida,Melbourne,76068
3436,1985-1986,1985-12-01,1986-02-28,90,0,0,4,4,0,0,0,4,0,0,Florida,Melbourne,76068
3437,1987-1988,1987-12-01,1988-02-29,91,0,0,0,0,0,0,0,0,0,0,Florida,Melbourne,76068
3438,1988-1989,1988-12-01,1989-02-28,90,2,0,2,2,0,0,0,2,0,0,Florida,Melbourne,76068
3439,1990-1991,1990-12-01,1991-02-28,90,0,0,1,1,0,0,0,1,0,0,Florida,Melbourne,76068
3440,1991-1992,1991-12-01,1992-02-29,91,0,0,0,0,0,0,0,0,0,0,Florida,Melbourne,76068
3441,1992-1993,1992-12-01,1993-02-28,90,0,0,0,0,0,0,0,0,0,0,Florida,Melbourne,76068
3442,1993-1994,1993-12-01,1994-02-28,90,0,0,1,1,0,0,0,1,0,0,Florida,Melbourne,76068
3443,1994-1995,1994-12-01,1995-02-28,90,0,0,2,2,0,0,0,2,0,0,Florida,Melbourne,76068
3444,1995-1996,1995-12-01,1996-02-29,91,0,0,8,8,0,0,0,8,0,0,Florida,Melbourne,76068
3445,1996-1997,1996-12-01,1997-02-28,90,0,0,1,1,0,0,0,1,0,0,Florida,Melbourne,76068
3446,1997-1998,1997-12-01,1998-02-28,90,0,0,0,0,0,0,0,0,0,0,Florida,Melbourne,76068
3447,1998-1999,1998-12-01,1999-02-28,90,0,0,1,1,0,0,0,1,0,0,Florida,Melbourne,76068
3448,1999-2000,1999-12-01,2000-02-29,91,0,0,1,1,0,0,0,1,0,0,Florida,Melbourne,76068
3449,2009-2010,2009-12-01,2010-02-28,90,0,0,8,8,0,0,0,8,0,0,Florida,Melbourne,76068
3450,2010-2011,2010-12-01,2011-02-28,90,0,0,7,7,0,0,0,7,0,0,Florida,Melbourne,76068
3451,2011-2012,2011-12-01,2012-02-29,91,0,0,1,1,0,0,0,1,0,0,Florida,Melbourne,76068
3452,2012-2013,2012-12-01,2013-02-28,90,0,0,0,0,0,0,0,0,0,0,Florida,Melbourne,76068
3453,2013-2014,2013-12-01,2014-02-28,90,0,0,1,1,0,0,0,1,0,0,Florida,Melbourne,76068
3454,2014-2015,2014-12-01,2015-02-28,90,1,0,0,0,0,0,0,0,0,0,Florida,Melbourne,76068
3455,2015-2016,2015-12-01,2016-02-29,91,0,0,0,0,0,0,0,0,0,0,Florida,Melbourne,76068
3456,2016-2017,2016-12-01,2017-02-28,90,0,0,0,0,0,0,0,0,0,0,Florida,Melbourne,76068
3457,2017-2018,2017-12-01,2018-02-28,90,0,0,1,1,0,0,0,1,0,0,Florida,Melbourne,76068
3458,2018-2019,2018-12-01,2019-02-28,90,0,0,0,0,0,0,0,0,0,0,Florida,Melbourne,76068
3459,2019-2020,2019-12-01,2020-02-29,91,0,0,0,0,0,0,0,0,0,0,Florida,Melbourne,76068
3460,1950-1951,1950-12-01,1951-02-28,90,1,0,4,4,0,0,0,4,0,0,Florida,Orlando,238300
3461,1951-1952,1951-12-01,1952-02-29,91,0,0,0,0,0,0,0,0,0,0,Florida,Orlando,238300
3462,1952-1953,1952-12-01,1953-02-28,90,0,0,1,1,0,0,0,1,0,0,Florida,Orlando,238300
3463,1953-1954,1953-12-01,1954-02-28,90,0,0,0,0,0,0,0,0,0,0,Florida,Orlando,238300
3464,1954-1955,1954-12-01,1955-02-28,90,0,0,4,4,0,0,0,4,0,0,Florida,Orlando,238300
3465,1955-1956,1955-12-01,1956-02-29,91,0,0,2,2,0,0,0,2,0,0,Florida,Orlando,238300
3466,1956-1957,1956-12-01,1957-02-28,90,0,0,0,0,0,0,0,0,0,0,Florida,Orlando,238300
3467,1957-1958,1957-12-01,1958-02-28,90,0,0,14,14,0,0,0,14,0,0,Florida,Orlando,238300
3468,1958-1959,1958-12-01,1959-02-28,90,0,0,4,4,0,0,0,4,0,0,Florida,Orlando,238300
3469,1959-1960,1959-12-01,1960-02-29,91,0,0,3,3,0,0,0,3,0,0,Florida,Orlando,238300
3470,1960-1961,1960-12-01,1961-02-28,90,0,0,3,3,0,0,0,3,0,0,Florida,Orlando,238300
3471,1961-1962,1961-12-01,1962-02-28,90,0,0,2,2,0,0,0,2,0,0,Florida,Orlando,238300
3472,1962-1963,1962-12-01,1963-02-28,90,0,0,5,5,0,0,0,5,0,0,Florida,Orlando,238300
3473,1963-1964,1963-12-01,1964-02-29,91,0,0,1,1,0,0,0,1,0,0,Florida,Orlando,238300
3474,1964-1965,1964-12-01,1965-02-28,90,0,0,2,2,0,0,0,2,0,0,Florida,Orlando,238300
3475,1965-1966,1965-12-01,1966-02-28,90,0,0,3,3,0,0,0,3,0,0,Florida,Orlando,238300
3476,1966-1967,1966-12-01,1967-02-28,90,0,0,2,2,0,0,0,2,0,0,Florida,Orlando,238300
3477,1967-1968,1967-12-01,1968-02-29,91,0,0,1,1,0,0,0,1,0,0,Florida,Orlando,238300
3478,1968-1969,1968-12-01,1969-02-28,90,0,0,2,2,0,0,0,2,0,0,Florida,Orlando,238300
3479,1969-1970,1969-12-01,1970-02-28,90,0,0,5,5,0,0,0,5,0,0,Florida,Orlando,238300
3480,1970-1971,1970-12-01,1971-02-28,90,0,0,3,3,0,0,0,3,0,0,Florida,Orlando,238300
3481,1971-1972,1971-12-01,1972-02-29,91,0,0,0,0,0,0,0,0,0,0,Florida,Orlando,238300
3482,1972-1973,1972-12-01,1973-02-28,90,0,0,0,0,0,0,0,0,0,0,Florida,Orlando,238300
3483,1973-1974,1973-12-01,1974-02-28,90,0,0,3,3,0,0,0,3,0,0,Florida,Orlando,238300
3484,1974-1975,1974-12-01,1975-02-28,90,0,0,0,0,0,0,0,0,0,0,Florida,Orlando,238300
3485,1975-1976,1975-12-01,1976-02-29,91,0,0,5,5,0,0,0,5,0,0,Florida,Orlando,238300
3486,1976-1977,1976-12-01,1977-02-28,90,0,0,11,11,0,0,0,11,0,0,Florida,Orlando,238300
3487,1977-1978,1977-12-01,1978-02-28,90,0,0,6,6,0,0,0,6,0,0,Florida,Orlando,238300
3488,1978-1979,1978-12-01,1979-02-28,90,0,0,1,1,0,0,0,1,0,0,Florida,Orlando,238300
3489,1979-1980,1979-12-01,1980-02-29,91,0,0,2,2,0,0,0,2,0,0,Florida,Orlando,238300
3490,1980-1981,1980-12-01,1981-02-28,90,0,0,11,11,0,0,0,11,0,0,Florida,Orlando,238300
3491,1981-1982,1981-12-01,1982-02-28,90,0,0,6,6,0,0,0,6,0,0,Florida,Orlando,238300
3492,1982-1983,1982-12-01,1983-02-28,90,0,0,0,0,0,0,0,0,0,0,Florida,Orlando,238300
3493,1983-1984,1983-12-01,1984-02-29,91,0,0,5,5,0,0,0,5,0,0,Florida,Orlando,238300
3494,1984-1985,1984-12-01,1985-02-28,90,0,0,8,8,0,0,0,8,0,0,Florida,Orlando,238300
3495,1985-1986,1985-12-01,1986-02-28,90,0,0,5,5,0,0,0,5,0,0,Florida,Orlando,238300
3496,1986-1987,1986-12-01,1987-02-28,90,0,0,1,1,0,0,0,1,0,0,Florida,Orlando,238300
3497,1987-1988,1987-12-01,1988-02-29,91,0,0,0,0,0,0,0,0,0,0,Florida,Orlando,238300
3498,1988-1989,1988-12-01,1989-02-28,90,0,0,2,2,0,0,0,2,0,0,Florida,Orlando,238300
3499,1989-1990,1989-12-01,1990-02-28,90,0,0,5,5,0,0,0,5,0,0,Florida,Orlando,238300
3500,1990-1991,1990-12-01,1991-02-28,90,0,0,1,1,0,0,0,1,0,0,Florida,Orlando,238300
3501,1991-1992,1991-12-01,1992-02-29,91,0,0,0,0,0,0,0,0,0,0,Florida,Orlando,238300
3502,1992-1993,1992-12-01,1993-02-28,90,0,0,0,0,0,0,0,0,0,0,Florida,Orlando,238300
3503,1993-1994,1993-12-01,1994-02-28,90,0,0,0,0,0,0,0,0,0,0,Florida,Orlando,238300
3504,1994-1995,1994-12-01,1995-02-28,90,0,0,1,1,0,0,0,1,0,0,Florida,Orlando,238300
3505,1995-1996,1995-12-01,1996-02-29,91,0,0,5,5,0,0,0,5,0,0,Florida,Orlando,238300
3506,1996-1997,1996-12-01,1997-02-28,90,0,0,2,2,0,0,0,2,0,0,Florida,Orlando,238300
3507,1997-1998,1997-12-01,1998-02-28,90,0,0,0,0,0,0,0,0,0,0,Florida,Orlando,238300
3508,1998-1999,1998-12-01,1999-02-28,90,0,0,1,1,0,0,0,1,0,0,Florida,Orlando,238300
3509,1999-2000,1999-12-01,2000-02-29,91,0,0,1,1,0,0,0,1,0,0,Florida,Orlando,238300
3510,2000-2001,2000-12-01,2001-02-28,90,0,0,7,7,0,0,0,7,0,0,Florida,Orlando,238300
3511,2001-2002,2001-12-01,2002-02-28,90,0,0,2,2,0,0,0,2,0,0,Florida,Orlando,238300
3512,2002-2003,2002-12-01,2003-02-28,90,0,0,2,2,0,0,0,2,0,0,Florida,Orlando,238300
3513,2003-2004,2003-12-01,2004-02-29,91,0,0,0,0,0,0,0,0,0,0,Florida,Orlando,238300
3514,2004-2005,2004-12-01,2005-02-28,90,0,0,0,0,0,0,0,0,0,0,Florida,Orlando,238300
3515,2005-2006,2005-12-01,2006-02-28,90,0,0,0,0,0,0,0,0,0,0,Florida,Orlando,238300
3516,2006-2007,2006-12-01,2007-02-28,90,0,0,0,0,0,0,0,0,0,0,Florida,Orlando,238300
3517,2007-2008,2007-12-01,2008-02-29,91,0,0,1,1,0,0,0,1,0,0,Florida,Orlando,238300
3518,2008-2009,2008-12-01,2009-02-28,90,0,0,4,4,0,0,0,4,0,0,Florida,Orlando,238300
3519,2009-2010,2009-12-01,2010-02-28,90,0,0,6,6,0,0,0,6,0,0,Florida,Orlando,238300
3520,2010-2011,2010-12-01,2011-02-28,90,0,0,9,9,0,0,0,9,0,0,Florida,Orlando,238300
3521,2011-2012,2011-12-01,2012-02-29,91,0,0,3,3,0,0,0,3,0,0,Florida,Orlando,238300
3522,2012-2013,2012-12-01,2013-02-28,90,0,0,0,0,0,0,0,0,0,0,Florida,Orlando,238300
3523,2013-2014,2013-12-01,2014-02-28,90,0,0,1,1,0,0,0,1,0,0,Florida,Orlando,238300
3524,2014-2015,2014-12-01,2015-02-28,90,0,0,0,0,0,0,0,0,0,0,Florida,Orlando,238300
3525,2015-2016,2015-12-01,2016-02-29,91,0,0,0,0,0,0,0,0,0,0,Florida,Orlando,238300
3526,2016-2017,2016-12-01,2017-02-28,90,0,0,0,0,0,0,0,0,0,0,Florida,Orlando,238300
3527,2017-2018,2017-12-01,2018-02-28,90,0,0,3,3,0,0,0,3,0,0,Florida,Orlando,238300
3528,2018-2019,2018-12-01,2019-02-28,90,0,0,0,0,0,0,0,0,0,0,Florida,Orlando,238300
3529,2019-2020,2019-12-01,2020-02-29,91,0,0,0,0,0,0,0,0,0,0,Florida,Orlando,238300
3530,1950-1951,1950-12-01,1951-02-28,90,0,1,21,22,0,0,0,22,0,0,Florida,Pensacola,51923
3531,1951-1952,1951-12-01,1952-02-29,91,2,0,5,5,0,0,0,5,0,0,Florida,Pensacola,51923
3532,1952-1953,1952-12-01,1953-02-28,90,0,0,5,5,0,0,0,5,0,0,Florida,Pensacola,51923
3533,1953-1954,1953-12-01,1954-03-06,96,0,0,8,8,3,0,3,11,1,3,Florida,Pensacola,51923
3534,1954-1955,1954-12-01,1955-02-28,90,0,0,9,9,0,0,0,9,0,0,Florida,Pensacola,51923
3535,1955-1956,1955-12-01,1956-02-29,91,0,0,10,10,0,0,0,10,0,0,Florida,Pensacola,51923
3536,1956-1957,1956-12-01,1957-02-28,90,1,0,3,3,0,0,0,3,0,0,Florida,Pensacola,51923
3537,1957-1958,1957-12-01,1958-02-28,90,0,0,35,35,0,0,0,35,0,0,Florida,Pensacola,51923
3538,1958-1959,1958-12-01,1959-02-28,90,0,0,15,15,0,0,0,15,0,0,Florida,Pensacola,51923
3539,1959-1960,1959-12-01,1960-02-29,91,0,0,10,10,0,0,0,10,0,0,Florida,Pensacola,51923
3540,1960-1961,1960-12-01,1961-02-28,90,0,0,18,18,0,0,0,18,0,0,Florida,Pensacola,51923
3541,1961-1962,1961-12-01,1962-02-28,90,0,2,29,31,0,0,0,31,0,0,Florida,Pensacola,51923
3542,1962-1963,1962-12-01,1963-02-28,90,0,3,34,37,0,0,0,37,0,0,Florida,Pensacola,51923
3543,1963-1964,1963-12-01,1964-02-29,91,0,0,29,29,0,0,0,29,0,0,Florida,Pensacola,51923
3544,1964-1965,1964-12-01,1965-02-28,90,0,0,16,16,0,0,0,16,0,0,Florida,Pensacola,51923
3545,1965-1966,1965-12-01,1966-02-28,90,0,1,22,23,0,0,0,23,0,0,Florida,Pensacola,51923
3546,1966-1967,1966-12-01,1967-02-28,90,0,0,8,8,0,0,0,8,0,0,Florida,Pensacola,51923
3547,1967-1968,1967-12-01,1968-02-29,91,0,0,19,19,0,0,0,19,0,0,Florida,Pensacola,51923
3548,1968-1969,1968-12-01,1969-02-28,90,0,0,18,18,0,0,0,18,0,0,Florida,Pensacola,51923
3549,1969-1970,1969-12-01,1970-02-28,90,0,0,19,19,0,0,0,19,0,0,Florida,Pensacola,51923
3550,1970-1971,1970-12-01,1971-02-28,90,0,0,18,18,0,0,0,18,0,0,Florida,Pensacola,51923
3551,1971-1972,1971-12-01,1972-02-29,91,0,0,8,8,0,0,0,8,0,0,Florida,Pensacola,51923
3552,1972-1973,1972-12-01,1973-02-28,90,0,0,13,13,3,2,5,18,2,5,Florida,Pensacola,51923
3553,1973-1974,1973-12-01,1974-02-28,90,0,0,9,9,0,0,0,9,0,0,Florida,Pensacola,51923
3554,1974-1975,1974-12-01,1975-02-28,90,0,0,8,8,0,0,0,8,0,0,Florida,Pensacola,51923
3555,1975-1976,1975-12-01,1976-02-29,91,0,0,13,13,0,0,0,13,0,0,Florida,Pensacola,51923
3556,1976-1977,1976-12-01,1977-02-28,90,0,1,39,40,4,0,4,44,2,7,Florida,Pensacola,51923
3557,1977-1978,1977-12-01,1978-02-28,90,0,0,30,30,0,0,0,30,0,0,Florida,Pensacola,51923
3558,1979-1980,1979-12-01,1980-02-29,91,0,0,19,19,0,0,0,19,0,0,Florida,Pensacola,51923
3559,1980-1981,1980-12-01,1981-02-28,90,0,0,33,33,0,0,0,33,0,0,Florida,Pensacola,51923
3560,1981-1982,1981-12-01,1982-02-28,90,0,1,29,30,0,0,0,30,0,0,Florida,Pensacola,51923
3561,1982-1983,1982-12-01,1983-02-28,90,0,0,10,10,0,0,0,10,0,0,Florida,Pensacola,51923
3562,1983-1984,1983-12-01,1984-02-29,91,0,1,29,30,0,0,0,30,0,0,Florida,Pensacola,51923
3563,1984-1985,1984-12-01,1985-02-28,90,0,1,22,23,0,0,0,23,0,0,Florida,Pensacola,51923
3564,1985-1986,1985-12-01,1986-02-28,90,0,0,21,21,0,0,0,21,0,0,Florida,Pensacola,51923
3565,1986-1987,1986-12-01,1987-02-28,90,0,0,8,8,0,0,0,8,0,0,Florida,Pensacola,51923
3566,1987-1988,1987-12-01,1988-02-29,91,0,0,15,15,0,0,0,15,0,0,Florida,Pensacola,51923
3567,1988-1989,1988-12-01,1989-02-28,90,0,0,11,11,0,0,0,11,0,0,Florida,Pensacola,51923
3568,1989-1990,1989-12-01,1990-02-28,90,0,1,22,23,0,0,0,23,0,0,Florida,Pensacola,51923
3569,1990-1991,1990-12-01,1991-02-28,90,0,0,6,6,0,0,0,6,0,0,Florida,Pensacola,51923
3570,1991-1992,1991-12-01,1992-02-29,91,0,0,10,10,0,0,0,10,0,0,Florida,Pensacola,51923
3571,1992-1993,1992-12-01,1993-02-28,90,0,0,1,1,0,0,0,1,0,0,Florida,Pensacola,51923
3572,1993-1994,1993-12-01,1994-02-28,90,0,0,13,13,0,0,0,13,0,0,Florida,Pensacola,51923
3573,1994-1995,1994-12-01,1995-02-28,90,2,0,8,8,0,0,0,8,0,0,Florida,Pensacola,51923
3574,1995-1996,1995-12-01,1996-02-29,91,0,1,36,37,0,0,0,37,0,0,Florida,Pensacola,51923
3575,1996-1997,1996-12-01,1997-02-28,90,0,0,13,13,0,0,0,13,0,0,Florida,Pensacola,51923
3576,1997-1998,1997-12-01,1998-02-28,90,14,0,4,4,0,0,0,4,0,0,Florida,Pensacola,51923
3577,1998-1999,1998-12-01,1999-02-28,90,16,0,10,10,0,0,0,10,0,0,Florida,Pensacola,51923
3578,1999-2000,1999-12-01,2000-02-29,91,14,0,10,10,0,0,0,10,0,0,Florida,Pensacola,51923
3579,2000-2001,2000-12-01,2001-02-28,90,14,0,29,29,0,0,0,29,0,0,Florida,Pensacola,51923
3580,2001-2002,2001-12-01,2002-02-28,90,14,0,11,11,0,0,0,11,0,0,Florida,Pensacola,51923
3581,2002-2003,2002-12-01,2003-02-28,90,14,0,16,16,0,0,0,16,0,0,Florida,Pensacola,51923
3582,2003-2004,2003-12-01,2004-02-29,91,14,0,15,15,0,0,0,15,0,0,Florida,Pensacola,51923
3583,2004-2005,2004-12-01,2005-02-28,90,14,0,11,11,0,0,0,11,0,0,Florida,Pensacola,51923
3584,2005-2006,2005-12-01,2006-02-28,90,14,0,5,5,0,0,0,5,0,0,Florida,Pensacola,51923
3585,2006-2007,2006-12-01,2007-02-28,90,14,0,10,10,0,0,0,10,0,0,Florida,Pensacola,51923
3586,2007-2008,2007-12-01,2008-02-29,91,14,0,8,8,0,0,0,8,0,0,Florida,Pensacola,51923
3587,2008-2009,2008-12-01,2009-02-28,90,8,0,13,13,0,0,0,13,0,0,Florida,Pensacola,51923
3588,2009-2010,2009-12-01,2010-02-28,90,0,0,30,30,0,0,0,30,0,0,Florida,Pensacola,51923
3589,2010-2011,2010-12-01,2011-02-28,90,0,0,24,24,0,0,0,24,0,0,Florida,Pensacola,51923
3590,2011-2012,2011-12-01,2012-02-29,91,0,0,6,6,0,0,0,6,0,0,Florida,Pensacola,51923
3591,2012-2013,2012-12-01,2013-02-28,90,0,0,3,3,0,0,0,3,0,0,Florida,Pensacola,51923
3592,2013-2014,2013-12-01,2014-02-28,90,1,1,19,20,2,1,3,23,1,3,Florida,Pensacola,51923
3593,2014-2015,2014-12-01,2015-02-28,90,6,0,11,11,0,0,0,11,0,0,Florida,Pensacola,51923
3594,2015-2016,2015-12-01,2016-02-29,91,3,0,5,5,0,0,0,5,0,0,Florida,Pensacola,51923
3595,2016-2017,2016-12-01,2017-02-28,90,9,0,2,2,0,0,0,2,0,0,Florida,Pensacola,51923
3596,2017-2018,2017-12-01,2018-02-28,90,2,0,15,15,0,0,0,15,0,0,Florida,Pensacola,51923
3597,2018-2019,2018-12-01,2019-02-28,90,5,0,0,0,0,0,0,0,0,0,Florida,Pensacola,51923
3598,1950-1951,1950-12-01,1951-02-28,90,0,0,1,1,0,0,0,1,0,0,Florida,Tampa,335709
3599,1951-1952,1951-12-01,1952-02-29,91,0,0,0,0,0,0,0,0,0,0,Florida,Tampa,335709
3600,1952-1953,1952-12-01,1953-02-28,90,0,0,0,0,0,0,0,0,0,0,Florida,Tampa,335709
3601,1953-1954,1953-12-01,1954-02-28,90,0,0,0,0,0,0,0,0,0,0,Florida,Tampa,335709
3602,1954-1955,1954-12-01,1955-02-28,90,0,0,1,1,0,0,0,1,0,0,Florida,Tampa,335709
3603,1955-1956,1955-12-01,1956-02-29,91,0,0,1,1,0,0,0,1,0,0,Florida,Tampa,335709
3604,1956-1957,1956-12-01,1957-02-28,90,0,0,0,0,0,0,0,0,0,0,Florida,Tampa,335709
3605,1957-1958,1957-12-01,1958-02-28,90,0,0,9,9,0,0,0,9,0,0,Florida,Tampa,335709
3606,1958-1959,1958-12-01,1959-02-28,90,0,0,2,2,0,0,0,2,0,0,Florida,Tampa,335709
3607,1959-1960,1959-12-01,1960-02-29,91,0,0,2,2,0,0,0,2,0,0,Florida,Tampa,335709
3608,1960-1961,1960-12-01,1961-02-28,90,0,0,4,4,0,0,0,4,0,0,Florida,Tampa,335709
3609,1961-1962,1961-12-01,1962-02-28,90,0,0,1,1,0,0,0,1,0,0,Florida,Tampa,335709
3610,1962-1963,1962-12-01,1963-02-28,90,0,0,5,5,0,0,0,5,0,0,Florida,Tampa,335709
3611,1963-1964,1963-12-01,1964-02-29,91,0,0,4,4,0,0,0,4,0,0,Florida,Tampa,335709
3612,1964-1965,1964-12-01,1965-02-28,90,0,0,3,3,0,0,0,3,0,0,Florida,Tampa,335709
3613,1965-1966,1965-12-01,1966-02-28,90,0,0,7,7,0,0,0,7,0,0,Florida,Tampa,335709
3614,1966-1967,1966-12-01,1967-02-28,90,0,0,3,3,0,0,0,3,0,0,Florida,Tampa,335709
3615,1967-1968,1967-12-01,1968-02-29,91,0,0,2,2,0,0,0,2,0,0,Florida,Tampa,335709
3616,1968-1969,1968-12-01,1969-02-28,90,0,0,3,3,0,0,0,3,0,0,Florida,Tampa,335709
3617,1969-1970,1969-12-01,1970-02-28,90,0,0,7,7,0,0,0,7,0,0,Florida,Tampa,335709
3618,1970-1971,1970-12-01,1971-02-28,90,0,0,7,7,0,0,0,7,0,0,Florida,Tampa,335709
3619,1971-1972,1971-12-01,1972-02-29,91,0,0,0,0,0,0,0,0,0,0,Florida,Tampa,335709
3620,1972-1973,1972-12-01,1973-02-28,90,0,0,3,3,0,0,0,3,0,0,Florida,Tampa,335709
3621,1973-1974,1973-12-01,1974-02-28,90,0,0,5,5,0,0,0,5,0,0,Florida,Tampa,335709
3622,1974-1975,1974-12-01,1975-02-28,90,0,0,0,0,0,0,0,0,0,0,Florida,Tampa,335709
3623,1975-1976,1975-12-01,1976-02-29,91,0,0,5,5,0,0,0,5,0,0,Florida,Tampa,335709
3624,1976-1977,1976-12-01,1977-02-28,90,0,0,8,8,1,0,1,9,1,2,Florida,Tampa,335709
3625,1977-1978,1977-12-01,1978-02-28,90,0,0,8,8,0,0,0,8,0,0,Florida,Tampa,335709
3626,1978-1979,1978-12-01,1979-02-28,90,0,0,3,3,0,0,0,3,0,0,Florida,Tampa,335709
3627,1979-1980,1979-12-01,1980-02-29,91,0,0,2,2,0,0,0,2,0,0,Florida,Tampa,335709
3628,1980-1981,1980-12-01,1981-02-28,90,0,0,7,7,0,0,0,7,0,0,Florida,Tampa,335709
3629,1981-1982,1981-12-01,1982-02-28,90,0,0,8,8,0,0,0,8,0,0,Florida,Tampa,335709
3630,1982-1983,1982-12-01,1983-02-28,90,0,0,0,0,0,0,0,0,0,0,Florida,Tampa,335709
3631,1983-1984,1983-12-01,1984-02-29,91,0,0,7,7,0,0,0,7,0,0,Florida,Tampa,335709
3632,1984-1985,1984-12-01,1985-02-28,90,0,0,5,5,0,0,0,5,0,0,Florida,Tampa,335709
3633,1985-1986,1985-12-01,1986-02-28,90,0,0,3,3,0,0,0,3,0,0,Florida,Tampa,335709
3634,1986-1987,1986-12-01,1987-02-28,90,0,0,0,0,0,0,0,0,0,0,Florida,Tampa,335709
3635,1987-1988,1987-12-01,1988-02-29,91,0,0,0,0,0,0,0,0,0,0,Florida,Tampa,335709
3636,1988-1989,1988-12-01,1989-02-28,90,0,0,1,1,0,0,0,1,0,0,Florida,Tampa,335709
3637,1989-1990,1989-12-01,1990-02-28,90,0,0,4,4,0,0,0,4,0,0,Florida,Tampa,335709
3638,1990-1991,1990-12-01,1991-02-28,90,0,0,0,0,0,0,0,0,0,0,Florida,Tampa,335709
3639,1991-1992,1991-12-01,1992-02-29,91,0,0,0,0,0,0,0,0,0,0,Florida,Tampa,335709
3640,1992-1993,1992-12-01,1993-02-28,90,0,0,0,0,0,0,0,0,0,0,Florida,Tampa,335709
3641,1993-1994,1993-12-01,1994-02-28,90,0,0,0,0,0,0,0,0,0,0,Florida,Tampa,335709
3642,1994-1995,1994-12-01,1995-02-28,90,0,0,1,1,0,0,0,1,0,0,Florida,Tampa,335709
3643,1995-1996,1995-12-01,1996-02-29,91,0,0,3,3,0,0,0,3,0,0,Florida,Tampa,335709
3644,1996-1997,1996-12-01,1997-02-28,90,0,0,1,1,0,0,0,1,0,0,Florida,Tampa,335709
3645,1997-1998,1997-12-01,1998-02-28,90,0,0,0,0,0,0,0,0,0,0,Florida,Tampa,335709
3646,1998-1999,1998-12-01,1999-02-28,90,0,0,1,1,0,0,0,1,0,0,Florida,Tampa,335709
3647,1999-2000,1999-12-01,2000-02-29,91,0,0,1,1,0,0,0,1,0,0,Florida,Tampa,335709
3648,2000-2001,2000-12-01,2001-02-28,90,0,0,3,3,0,0,0,3,0,0,Florida,Tampa,335709
3649,2001-2002,2001-12-01,2002-02-28,90,0,0,0,0,0,0,0,0,0,0,Florida,Tampa,335709
3650,2002-2003,2002-12-01,2003-02-28,90,0,0,1,1,0,0,0,1,0,0,Florida,Tampa,335709
3651,2003-2004,2003-12-01,2004-02-29,91,0,0,0,0,0,0,0,0,0,0,Florida,Tampa,335709
3652,2004-2005,2004-12-01,2005-02-28,90,0,0,1,1,0,0,0,1,0,0,Florida,Tampa,335709
3653,2005-2006,2005-12-01,2006-02-28,90,0,0,0,0,0,0,0,0,0,0,Florida,Tampa,335709
3654,2006-2007,2006-12-01,2007-02-28,90,0,0,0,0,0,0,0,0,0,0,Florida,Tampa,335709
3655,2007-2008,2007-12-01,2008-02-29,91,0,0,1,1,0,0,0,1,0,0,Florida,Tampa,335709
3656,2008-2009,2008-12-01,2009-02-28,90,0,0,1,1,0,0,0,1,0,0,Florida,Tampa,335709
3657,2009-2010,2009-12-01,2010-02-28,90,0,0,5,5,0,0,0,5,0,0,Florida,Tampa,335709
3658,2010-2011,2010-12-01,2011-02-28,90,0,0,3,3,0,0,0,3,0,0,Florida,Tampa,335709
3659,2011-2012,2011-12-01,2012-02-29,91,0,0,0,0,0,0,0,0,0,0,Florida,Tampa,335709
3660,2012-2013,2012-12-01,2013-02-28,90,0,0,0,0,0,0,0,0,0,0,Florida,Tampa,335709
3661,2013-2014,2013-12-01,2014-02-28,90,0,0,0,0,0,0,0,0,0,0,Florida,Tampa,335709
3662,2014-2015,2014-12-01,2015-02-28,90,0,0,0,0,0,0,0,0,0,0,Florida,Tampa,335709
3663,2015-2016,2015-12-01,2016-02-29,91,0,0,0,0,0,0,0,0,0,0,Florida,Tampa,335709
3664,2016-2017,2016-12-01,2017-02-28,90,0,0,0,0,0,0,0,0,0,0,Florida,Tampa,335709
3665,2017-2018,2017-12-01,2018-02-28,90,0,0,1,1,0,0,0,1,0,0,Florida,Tampa,335709
3666,2018-2019,2018-12-01,2019-02-28,90,0,0,0,0,0,0,0,0,0,0,Florida,Tampa,335709
3667,2019-2020,2019-12-01,2020-02-29,91,0,0,0,0,0,0,0,0,0,0,Florida,Tampa,335709
3668,1950-1951,1950-11-25,1951-02-28,96,0,2,43,45,0,0,0,45,0,0,Georgia,Albany,97856
3669,1951-1952,1951-12-01,1952-02-29,91,0,0,13,13,0,0,0,13,0,0,Georgia,Albany,97856
3670,1952-1953,1952-12-01,1953-02-28,90,0,0,14,14,0,0,0,14,0,0,Georgia,Albany,97856
3671,1953-1954,1953-12-01,1954-02-28,90,0,0,17,17,0,0,0,17,0,0,Georgia,Albany,97856
3672,1954-1955,1954-12-01,1955-02-28,90,1,0,26,26,0,0,0,26,0,0,Georgia,Albany,97856
3673,1955-1956,1955-12-01,1956-02-29,91,0,0,23,23,0,0,0,23,0,0,Georgia,Albany,97856
3674,1956-1957,1956-12-01,1957-02-28,90,1,0,19,19,0,0,0,19,0,0,Georgia,Albany,97856
3675,1957-1958,1957-12-01,1958-02-28,90,0,0,59,59,1,0,1,60,1,3,Georgia,Albany,97856
3676,1958-1959,1958-12-01,1959-02-28,90,1,0,35,35,0,0,0,35,0,0,Georgia,Albany,97856
3677,1959-1960,1959-12-01,1960-02-29,91,1,0,35,35,0,0,0,35,0,0,Georgia,Albany,97856
3678,1960-1961,1960-12-01,1961-02-28,90,0,0,52,52,0,0,0,52,0,0,Georgia,Albany,97856
3679,1961-1962,1961-12-01,1962-02-28,90,1,0,29,29,0,0,0,29,0,0,Georgia,Albany,97856
3680,1962-1963,1962-12-01,1963-02-28,90,0,0,51,51,0,0,0,51,0,0,Georgia,Albany,97856
3681,1963-1964,1963-12-01,1964-02-29,91,17,0,80,80,0,0,0,80,0,0,Georgia,Albany,97856
3682,1964-1965,1964-12-01,1965-02-28,90,1,0,49,49,0,0,0,49,0,0,Georgia,Albany,97856
3683,1965-1966,1965-12-01,1966-02-28,90,0,1,72,73,0,0,0,73,0,0,Georgia,Albany,97856
3684,1966-1967,1966-12-01,1967-02-28,90,0,0,48,48,0,0,0,48,0,0,Georgia,Albany,97856
3685,1968-1969,1968-12-01,1969-02-28,90,0,0,78,78,0,0,0,78,0,0,Georgia,Albany,97856
3686,1969-1970,1969-12-01,1970-02-28,90,0,1,94,95,0,0,0,95,0,0,Georgia,Albany,97856
3687,1970-1971,1970-12-01,1971-02-28,90,0,0,55,55,0,0,0,55,0,0,Georgia,Albany,97856
3688,1971-1972,1971-12-01,1972-02-29,91,0,0,28,28,0,0,0,28,0,0,Georgia,Albany,97856
3689,1973-1974,1973-12-01,1974-02-28,90,2,0,28,28,0,0,0,28,0,0,Georgia,Albany,97856
3690,1974-1975,1974-12-01,1975-02-28,90,1,0,28,28,0,0,0,28,0,0,Georgia,Albany,97856
3691,1975-1976,1975-12-01,1976-02-29,91,6,0,56,56,0,0,0,56,0,0,Georgia,Albany,97856
3692,1976-1977,1976-12-01,1977-02-28,90,2,1,94,95,0,0,0,95,0,0,Georgia,Albany,97856
3693,1977-1978,1977-12-01,1978-02-28,90,4,0,78,78,0,0,0,78,0,0,Georgia,Albany,97856
3694,1978-1979,1978-12-01,1979-02-28,90,3,1,78,79,0,0,0,79,0,0,Georgia,Albany,97856
3695,1979-1980,1979-12-01,1980-03-03,94,7,1,83,84,0,0,0,84,0,0,Georgia,Albany,97856
3696,1980-1981,1980-12-01,1981-02-28,90,0,0,86,86,0,0,0,86,0,0,Georgia,Albany,97856
3697,1982-1983,1982-12-01,1983-02-28,90,0,0,54,54,0,0,0,54,0,0,Georgia,Albany,97856
3698,1983-1984,1983-12-01,1984-02-29,91,6,2,58,60,0,0,0,60,0,0,Georgia,Albany,97856
3699,1985-1986,1985-12-01,1986-02-28,90,3,2,75,77,0,0,0,77,0,0,Georgia,Albany,97856
3700,1986-1987,1986-12-01,1987-02-28,90,19,0,44,44,0,0,0,44,0,0,Georgia,Albany,97856
3701,1987-1988,1987-12-01,1988-02-29,91,2,0,57,57,0,0,0,57,0,0,Georgia,Albany,97856
3702,1988-1989,1988-12-01,1989-02-28,90,0,0,53,53,0,0,0,53,0,0,Georgia,Albany,97856
3703,1989-1990,1989-12-01,1990-02-28,90,0,2,62,64,0,0,0,64,0,0,Georgia,Albany,97856
3704,1990-1991,1990-12-01,1991-02-28,90,0,0,33,33,0,0,0,33,0,0,Georgia,Albany,97856
3705,1991-1992,1991-12-01,1992-02-29,91,0,0,55,55,0,0,0,55,0,0,Georgia,Albany,97856
3706,1992-1993,1992-12-01,1993-02-28,90,0,0,29,29,0,0,0,29,0,0,Georgia,Albany,97856
3707,1993-1994,1993-12-01,1994-02-28,90,0,0,45,45,0,0,0,45,0,0,Georgia,Albany,97856
3708,1994-1995,1994-12-01,1995-02-28,90,1,0,25,25,0,0,0,25,0,0,Georgia,Albany,97856
3709,1996-1997,1996-12-01,1997-02-28,90,2,0,14,14,0,0,0,14,0,0,Georgia,Albany,97856
3710,1997-1998,1997-12-01,1998-02-28,90,3,0,28,28,0,0,0,28,0,0,Georgia,Albany,97856
3711,1998-1999,1998-12-01,1999-02-28,90,1,0,26,26,0,0,0,26,0,0,Georgia,Albany,97856
3712,1999-2000,1999-12-01,2000-02-29,91,0,0,42,42,0,0,0,42,0,0,Georgia,Albany,97856
3713,2009-2010,2009-12-01,2010-02-28,90,16,0,50,50,2,0,2,52,1,2,Georgia,Albany,97856
3714,2010-2011,2010-12-01,2011-02-28,90,4,0,56,56,0,0,0,56,0,0,Georgia,Albany,97856
3715,2011-2012,2011-12-01,2012-02-29,91,19,0,21,21,0,0,0,21,0,0,Georgia,Albany,97856
3716,2012-2013,2012-12-01,2013-02-28,90,14,0,15,15,0,0,0,15,0,0,Georgia,Albany,97856
3717,2013-2014,2013-12-01,2014-02-28,90,15,1,33,34,0,0,0,34,0,0,Georgia,Albany,97856
3718,2014-2015,2014-12-01,2015-02-28,90,5,0,32,32,0,0,0,32,0,0,Georgia,Albany,97856
3719,2015-2016,2015-12-01,2016-02-29,91,5,0,22,22,0,0,0,22,0,0,Georgia,Albany,97856
3720,2016-2017,2016-12-01,2017-02-28,90,8,0,7,7,0,0,0,7,0,0,Georgia,Albany,97856
3721,2017-2018,2017-12-01,2018-02-28,90,9,0,29,29,1,0,1,30,1,3,Georgia,Albany,97856
3722,2018-2019,2018-12-01,2019-02-28,90,9,0,10,10,0,0,0,10,0,0,Georgia,Albany,97856
3723,2019-2020,2019-12-01,2020-02-29,91,18,0,8,8,0,0,0,8,0,0,Georgia,Albany,97856
3724,1950-1951,1950-11-25,1951-02-28,96,0,1,60,61,0,0,0,61,0,0,Georgia,Alma,3466
3725,1951-1952,1951-12-01,1952-02-29,91,0,0,17,17,0,0,0,17,0,0,Georgia,Alma,3466
3726,1952-1953,1952-12-01,1953-02-28,90,0,0,31,31,0,0,0,31,0,0,Georgia,Alma,3466
3727,1953-1954,1953-12-01,1954-02-28,90,0,0,27,27,0,0,0,27,0,0,Georgia,Alma,3466
3728,1954-1955,1954-12-01,1955-02-28,90,0,0,48,48,0,0,0,48,0,0,Georgia,Alma,3466
3729,1955-1956,1955-12-01,1956-02-29,91,0,0,44,44,0,0,0,44,0,0,Georgia,Alma,3466
3730,1956-1957,1956-12-01,1957-02-28,90,0,0,28,28,0,0,0,28,0,0,Georgia,Alma,3466
3731,1957-1958,1957-12-01,1958-02-28,90,0,0,69,69,0,0,0,69,0,0,Georgia,Alma,3466
3732,1958-1959,1958-12-01,1959-02-28,90,0,0,48,48,0,0,0,48,0,0,Georgia,Alma,3466
3733,1959-1960,1959-12-01,1960-02-29,91,0,0,33,33,0,0,0,33,0,0,Georgia,Alma,3466
3734,1960-1961,1960-12-01,1961-02-28,90,0,0,56,56,0,0,0,56,0,0,Georgia,Alma,3466
3735,1961-1962,1961-12-01,1962-02-28,90,0,0,31,31,0,0,0,31,0,0,Georgia,Alma,3466
3736,1962-1963,1962-12-01,1963-02-28,90,0,1,61,62,0,0,0,62,0,0,Georgia,Alma,3466
3737,1963-1964,1963-12-01,1964-02-29,91,0,0,50,50,0,0,0,50,0,0,Georgia,Alma,3466
3738,1964-1965,1964-12-01,1965-02-28,90,0,0,26,26,0,0,0,26,0,0,Georgia,Alma,3466
3739,1965-1966,1965-12-01,1966-02-28,90,0,0,40,40,0,0,0,40,0,0,Georgia,Alma,3466
3740,1966-1967,1966-12-01,1967-02-28,90,0,0,25,25,0,0,0,25,0,0,Georgia,Alma,3466
3741,1967-1968,1967-12-01,1968-02-29,91,0,0,38,38,1,0,1,39,1,2,Georgia,Alma,3466
3742,1968-1969,1968-12-01,1969-02-28,90,0,0,36,36,0,0,0,36,0,0,Georgia,Alma,3466
3743,1969-1970,1969-12-01,1970-02-28,90,0,1,51,52,0,0,0,52,0,0,Georgia,Alma,3466
3744,1970-1971,1970-12-01,1971-02-28,90,0,0,29,29,0,0,0,29,0,0,Georgia,Alma,3466
3745,1971-1972,1971-12-01,1972-02-29,91,0,0,11,11,0,0,0,11,0,0,Georgia,Alma,3466
3746,1972-1973,1972-12-01,1973-02-28,90,0,0,23,23,6,7,13,36,1,7,Georgia,Alma,3466
3747,1973-1974,1973-12-01,1974-02-28,90,0,0,18,18,0,0,0,18,0,0,Georgia,Alma,3466
3748,1974-1975,1974-12-01,1975-02-28,90,0,0,13,13,0,0,0,13,0,0,Georgia,Alma,3466
3749,1975-1976,1975-12-01,1976-02-29,91,0,0,29,29,0,0,0,29,0,0,Georgia,Alma,3466
3750,1976-1977,1976-12-01,1977-02-28,90,0,2,47,49,0,0,0,49,0,0,Georgia,Alma,3466
3751,1977-1978,1977-12-01,1978-02-28,90,0,0,45,45,0,0,0,45,0,0,Georgia,Alma,3466
3752,1978-1979,1978-12-01,1979-02-28,90,0,0,40,40,0,0,0,40,0,0,Georgia,Alma,3466
3753,1979-1980,1979-12-01,1980-02-29,91,0,0,28,28,0,0,0,28,0,0,Georgia,Alma,3466
3754,1980-1981,1980-12-01,1981-02-28,90,0,0,48,48,0,0,0,48,0,0,Georgia,Alma,3466
3755,1981-1982,1981-12-01,1982-02-28,90,0,1,34,35,0,0,0,35,0,0,Georgia,Alma,3466
3756,1982-1983,1982-12-01,1983-02-28,90,0,0,20,20,0,0,0,20,0,0,Georgia,Alma,3466
3757,1983-1984,1983-12-01,1984-02-29,91,0,1,40,41,0,0,0,41,0,0,Georgia,Alma,3466
3758,1984-1985,1984-12-01,1985-02-28,90,0,1,45,46,0,0,0,46,0,0,Georgia,Alma,3466
3759,1985-1986,1985-12-01,1986-02-28,90,0,0,33,33,0,0,0,33,0,0,Georgia,Alma,3466
3760,1986-1987,1986-12-01,1987-02-28,90,0,0,11,11,0,0,0,11,0,0,Georgia,Alma,3466
3761,1987-1988,1987-12-01,1988-02-29,91,0,0,33,33,0,0,0,33,0,0,Georgia,Alma,3466
3762,1988-1989,1988-12-01,1989-02-28,90,0,0,17,17,0,0,0,17,0,0,Georgia,Alma,3466
3763,1989-1990,1989-12-01,1990-02-28,90,0,0,16,16,3,1,4,20,1,6,Georgia,Alma,3466
3764,1990-1991,1990-12-01,1991-02-28,90,0,0,14,14,0,0,0,14,0,0,Georgia,Alma,3466
3765,1991-1992,1991-12-01,1992-02-29,91,0,0,11,11,0,0,0,11,0,0,Georgia,Alma,3466
3766,1992-1993,1992-12-01,1993-02-28,90,0,0,3,3,0,0,0,3,0,0,Georgia,Alma,3466
3767,1993-1994,1993-12-01,1994-02-28,90,0,0,19,19,0,0,0,19,0,0,Georgia,Alma,3466
3768,1994-1995,1994-12-01,1995-02-28,90,0,0,12,12,0,0,0,12,0,0,Georgia,Alma,3466
3769,1995-1996,1995-12-01,1996-02-29,91,0,0,42,42,0,0,0,42,0,0,Georgia,Alma,3466
3770,1996-1997,1996-12-01,1997-02-28,90,0,0,12,12,0,0,0,12,0,0,Georgia,Alma,3466
3771,1997-1998,1997-12-01,1998-02-28,90,0,0,6,6,0,0,0,6,0,0,Georgia,Alma,3466
3772,1998-1999,1998-12-01,1999-02-28,90,0,0,21,21,0,0,0,21,0,0,Georgia,Alma,3466
3773,1999-2000,1999-12-01,2000-02-29,91,0,0,26,26,0,0,0,26,0,0,Georgia,Alma,3466
3774,2000-2001,2000-12-01,2001-02-28,90,0,0,50,50,0,0,0,50,0,0,Georgia,Alma,3466
3775,2001-2002,2001-12-01,2002-02-28,90,0,0,26,26,0,0,0,26,0,0,Georgia,Alma,3466
3776,2002-2003,2002-12-01,2003-02-28,90,0,0,36,36,0,0,0,36,0,0,Georgia,Alma,3466
3777,2003-2004,2003-12-01,2004-02-29,91,0,0,32,32,0,0,0,32,0,0,Georgia,Alma,3466
3778,2004-2005,2004-12-01,2005-02-28,90,0,0,20,20,0,0,0,20,0,0,Georgia,Alma,3466
3779,2005-2006,2005-12-01,2006-02-28,90,0,0,20,20,0,0,0,20,0,0,Georgia,Alma,3466
3780,2006-2007,2006-12-01,2007-02-28,90,0,0,22,22,0,0,0,22,0,0,Georgia,Alma,3466
3781,2007-2008,2007-12-01,2008-02-29,91,0,0,20,20,0,0,0,20,0,0,Georgia,Alma,3466
3782,2008-2009,2008-12-01,2009-02-28,90,0,0,37,37,0,0,0,37,0,0,Georgia,Alma,3466
3783,2009-2010,2009-12-01,2010-02-28,90,0,0,46,46,0,0,0,46,0,0,Georgia,Alma,3466
3784,2010-2011,2010-12-01,2011-02-28,90,0,0,56,56,0,0,0,56,0,0,Georgia,Alma,3466
3785,2011-2012,2011-12-01,2012-02-29,91,0,0,22,22,0,0,0,22,0,0,Georgia,Alma,3466
3786,2012-2013,2012-12-01,2013-02-28,90,0,0,12,12,0,0,0,12,0,0,Georgia,Alma,3466
3787,2013-2014,2013-12-01,2014-02-28,90,0,1,23,24,0,0,0,24,0,0,Georgia,Alma,3466
3788,2014-2015,2014-12-01,2015-02-28,90,3,0,23,23,0,0,0,23,0,0,Georgia,Alma,3466
3789,2015-2016,2015-12-01,2016-02-29,91,2,0,18,18,0,0,0,18,0,0,Georgia,Alma,3466
3790,2016-2017,2016-12-01,2017-02-28,90,1,0,8,8,0,0,0,8,0,0,Georgia,Alma,3466
3791,2017-2018,2017-12-01,2018-02-28,90,0,0,29,29,4,0,4,33,1,6,Georgia,Alma,3466
3792,2018-2019,2018-12-01,2019-02-28,90,0,0,11,11,0,0,0,11,0,0,Georgia,Alma,3466
3793,2019-2020,2019-12-01,2020-02-29,91,0,0,12,12,0,0,0,12,0,0,Georgia,Alma,3466
3794,1950-1951,1950-11-25,1951-02-28,96,0,5,73,78,0,0,0,78,0,0,Georgia,Atlanta,420003
3795,1951-1952,1951-12-01,1952-02-29,91,0,0,34,34,4,1,5,39,1,4,Georgia,Atlanta,420003
3796,1952-1953,1952-12-01,1953-02-28,90,0,0,27,27,2,0,2,29,1,2,Georgia,Atlanta,420003
3797,1953-1954,1953-12-01,1954-02-28,90,0,0,40,40,1,0,1,41,1,1,Georgia,Atlanta,420003
3798,1954-1955,1954-12-01,1955-02-28,90,0,1,41,42,1,0,1,43,1,2,Georgia,Atlanta,420003
3799,1955-1956,1955-12-01,1956-02-29,91,0,0,39,39,0,0,0,39,0,0,Georgia,Atlanta,420003
3800,1956-1957,1956-12-01,1957-02-28,90,0,1,19,20,0,0,0,20,0,0,Georgia,Atlanta,420003
3801,1957-1958,1957-12-01,1958-02-28,90,0,6,90,96,3,1,4,100,1,4,Georgia,Atlanta,420003
3802,1958-1959,1958-12-01,1959-02-28,90,0,1,51,52,4,0,4,56,2,6,Georgia,Atlanta,420003
3803,1959-1960,1959-12-01,1960-03-12,103,0,3,54,57,7,5,12,69,2,9,Georgia,Atlanta,420003
3804,1960-1961,1960-12-01,1961-02-28,90,0,4,73,77,1,1,2,79,1,3,Georgia,Atlanta,420003
3805,1961-1962,1961-12-01,1962-02-28,90,0,4,62,66,6,5,11,77,2,9,Georgia,Atlanta,420003
3806,1962-1963,1962-12-01,1963-02-28,90,0,7,115,122,0,0,0,122,0,0,Georgia,Atlanta,420003
3807,1963-1964,1963-12-01,1964-02-29,91,0,3,86,89,6,3,9,98,4,13,Georgia,Atlanta,420003
3808,1964-1965,1964-12-01,1965-03-05,95,0,2,68,70,5,5,10,80,3,11,Georgia,Atlanta,420003
3809,1965-1966,1965-12-01,1966-02-28,90,0,4,74,78,3,0,3,81,3,10,Georgia,Atlanta,420003
3810,1966-1967,1966-12-01,1967-02-28,90,0,1,54,55,3,1,4,59,1,4,Georgia,Atlanta,420003
3811,1967-1968,1967-12-01,1968-02-29,91,0,3,80,83,8,3,11,94,6,15,Georgia,Atlanta,420003
3812,1968-1969,1968-11-11,1969-02-28,110,0,1,98,99,4,1,5,104,3,8,Georgia,Atlanta,420003
3813,1969-1970,1969-12-01,1970-02-28,90,0,5,93,98,4,0,4,102,4,8,Georgia,Atlanta,420003
3814,1970-1971,1970-11-24,1971-02-28,97,0,3,79,82,2,2,4,86,1,4,Georgia,Atlanta,420003
3815,1971-1972,1971-12-01,1972-02-29,91,0,1,42,43,2,1,3,46,1,3,Georgia,Atlanta,420003
3816,1972-1973,1972-12-01,1973-02-28,90,0,4,58,62,2,0,2,64,1,3,Georgia,Atlanta,420003
3817,1973-1974,1973-12-01,1974-02-28,90,0,1,44,45,0,0,0,45,0,0,Georgia,Atlanta,420003
3818,1974-1975,1974-12-01,1975-02-28,90,0,0,43,43,0,0,0,43,0,0,Georgia,Atlanta,420003
3819,1975-1976,1975-11-23,1976-02-29,99,0,1,83,84,1,1,2,86,1,1,Georgia,Atlanta,420003
3820,1976-1977,1976-12-01,1977-02-28,90,0,8,147,155,2,1,3,158,1,4,Georgia,Atlanta,420003
3821,1977-1978,1977-12-01,1978-02-28,90,0,6,113,119,1,0,1,120,1,2,Georgia,Atlanta,420003
3822,1978-1979,1978-12-01,1979-02-28,90,0,2,88,90,9,7,16,106,4,16,Georgia,Atlanta,420003
3823,1979-1980,1979-12-01,1980-03-03,94,0,2,56,58,6,3,9,67,3,12,Georgia,Atlanta,420003
3824,1980-1981,1980-12-01,1981-02-28,90,0,2,78,80,0,0,0,80,0,0,Georgia,Atlanta,420003
3825,1981-1982,1981-12-01,1982-02-28,90,0,8,88,96,11,4,15,111,4,25,Georgia,Atlanta,420003
3826,1982-1983,1982-12-01,1983-03-25,115,0,0,42,42,16,7,23,65,6,21,Georgia,Atlanta,420003
3827,1983-1984,1983-12-01,1984-02-29,91,0,7,75,82,3,0,3,85,2,6,Georgia,Atlanta,420003
3828,1984-1985,1984-12-01,1985-02-28,90,0,4,74,78,4,1,5,83,4,18,Georgia,Atlanta,420003
3829,1985-1986,1985-12-01,1986-02-28,90,0,1,75,76,1,0,1,77,1,7,Georgia,Atlanta,420003
3830,1986-1987,1986-12-01,1987-03-12,102,0,0,32,32,6,2,8,40,3,9,Georgia,Atlanta,420003
3831,1987-1988,1987-12-01,1988-02-29,91,0,4,55,59,6,4,10,69,1,9,Georgia,Atlanta,420003
3832,1988-1989,1988-12-01,1989-02-28,90,0,0,33,33,1,0,1,34,1,3,Georgia,Atlanta,420003
3833,1989-1990,1989-12-01,1990-02-28,90,0,4,44,48,3,0,3,51,2,4,Georgia,Atlanta,420003
3834,1990-1991,1990-12-01,1991-02-28,90,0,0,30,30,3,0,3,33,1,3,Georgia,Atlanta,420003
3835,1991-1992,1991-12-01,1992-02-29,91,0,0,28,28,7,6,13,41,1,8,Georgia,Atlanta,420003
3836,1992-1993,1992-12-01,1993-03-14,104,0,0,31,31,6,5,11,42,1,8,Georgia,Atlanta,420003
3837,1993-1994,1993-12-01,1994-02-28,90,0,3,50,53,4,1,5,58,2,5,Georgia,Atlanta,420003
3838,1994-1995,1994-12-01,1995-02-28,90,0,1,34,35,2,0,2,37,2,6,Georgia,Atlanta,420003
3839,1997-1998,1997-12-01,1998-02-28,90,20,0,30,30,1,1,2,32,1,2,Georgia,Atlanta,420003
3840,1998-1999,1998-12-01,1999-02-28,90,0,2,30,32,1,0,1,33,1,2,Georgia,Atlanta,420003
3841,1999-2000,1999-12-01,2000-02-29,91,0,0,39,39,0,0,0,39,0,0,Georgia,Atlanta,420003
3842,2000-2001,2000-12-01,2001-02-28,90,0,4,68,72,5,4,9,81,3,13,Georgia,Atlanta,420003
3843,2005-2006,2005-12-01,2006-02-28,90,0,0,41,41,0,0,0,41,0,0,Georgia,Atlanta,420003
3844,2006-2007,2006-12-01,2007-02-28,90,0,0,41,41,1,0,1,42,1,1,Georgia,Atlanta,420003
3845,2007-2008,2007-12-01,2008-02-29,91,0,2,39,41,3,1,4,45,2,5,Georgia,Atlanta,420003
3846,2008-2009,2008-12-01,2009-03-02,92,0,2,57,59,6,1,7,66,1,6,Georgia,Atlanta,420003
3847,2009-2010,2009-12-01,2010-03-02,92,0,3,74,77,7,4,11,88,3,10,Georgia,Atlanta,420003
3848,2010-2011,2010-12-01,2011-02-28,90,0,4,64,68,11,16,27,95,6,21,Georgia,Atlanta,420003
3849,2011-2012,2011-12-01,2012-02-29,91,0,0,21,21,0,0,0,21,0,0,Georgia,Atlanta,420003
3850,2012-2013,2012-12-01,2013-02-28,90,0,0,18,18,0,0,0,18,0,0,Georgia,Atlanta,420003
3851,2013-2014,2013-11-27,2014-02-28,94,0,3,73,76,7,5,12,88,4,13,Georgia,Atlanta,420003
3852,2014-2015,2014-12-01,2015-02-28,90,0,1,45,46,0,0,0,46,0,0,Georgia,Atlanta,420003
3853,2015-2016,2015-12-01,2016-02-29,91,0,0,29,29,2,0,2,31,2,4,Georgia,Atlanta,420003
3854,2016-2017,2016-12-01,2017-02-28,90,0,1,18,19,0,0,0,19,0,0,Georgia,Atlanta,420003
3855,2017-2018,2017-12-01,2018-02-28,90,0,2,49,51,7,8,15,66,4,14,Georgia,Atlanta,420003
3856,2018-2019,2018-12-01,2019-02-28,90,0,0,17,17,0,0,0,17,0,0,Georgia,Atlanta,420003
3857,2019-2020,2019-12-01,2020-02-29,91,0,0,13,13,0,0,0,13,0,0,Georgia,Atlanta,420003
3858,1950-1951,1950-11-25,1951-02-28,96,0,2,78,80,0,0,0,80,0,0,Georgia,Augusta,195844
3859,1951-1952,1951-12-01,1952-02-29,91,0,0,35,35,1,0,1,36,1,1,Georgia,Augusta,195844
3860,1952-1953,1952-12-01,1953-02-28,90,0,0,41,41,0,0,0,41,0,0,Georgia,Augusta,195844
3861,1953-1954,1953-12-01,1954-02-28,90,0,0,50,50,0,0,0,50,0,0,Georgia,Augusta,195844
3862,1954-1955,1954-12-01,1955-02-28,90,0,0,65,65,1,0,1,66,1,2,Georgia,Augusta,195844
3863,1955-1956,1955-12-01,1956-02-29,91,0,0,60,60,0,0,0,60,0,0,Georgia,Augusta,195844
3864,1956-1957,1956-12-01,1957-02-28,90,0,0,33,33,0,0,0,33,0,0,Georgia,Augusta,195844
3865,1957-1958,1957-12-01,1958-02-28,90,0,1,81,82,2,1,3,85,1,3,Georgia,Augusta,195844
3866,1958-1959,1958-12-01,1959-02-28,90,0,0,70,70,1,1,2,72,1,3,Georgia,Augusta,195844
3867,1959-1960,1959-12-01,1960-03-11,102,0,0,59,59,1,0,1,60,1,2,Georgia,Augusta,195844
3868,1960-1961,1960-12-01,1961-02-28,90,0,1,90,91,1,0,1,92,1,2,Georgia,Augusta,195844
3869,1961-1962,1961-12-01,1962-02-28,90,0,1,44,45,0,0,0,45,0,0,Georgia,Augusta,195844
3870,1962-1963,1962-12-01,1963-02-28,90,0,1,84,85,0,0,0,85,0,0,Georgia,Augusta,195844
3871,1963-1964,1963-12-01,1964-02-29,91,0,0,79,79,0,0,0,79,0,0,Georgia,Augusta,195844
3872,1964-1965,1964-12-01,1965-02-28,90,0,0,53,53,0,0,0,53,0,0,Georgia,Augusta,195844
3873,1965-1966,1965-12-01,1966-02-28,90,0,1,70,71,2,0,2,73,2,4,Georgia,Augusta,195844
3874,1966-1967,1966-12-01,1967-02-28,90,0,0,65,65,4,2,6,71,1,5,Georgia,Augusta,195844
3875,1967-1968,1967-12-01,1968-02-29,91,0,1,83,84,4,2,6,90,3,6,Georgia,Augusta,195844
3876,1968-1969,1968-12-01,1969-02-28,90,0,0,85,85,0,0,0,85,0,0,Georgia,Augusta,195844
3877,1969-1970,1969-12-01,1970-02-28,90,0,3,114,117,2,1,3,120,1,5,Georgia,Augusta,195844
3878,1970-1971,1970-12-01,1971-02-28,90,0,0,67,67,0,0,0,67,0,0,Georgia,Augusta,195844
3879,1971-1972,1971-12-01,1972-02-29,91,0,1,29,30,1,0,1,31,1,2,Georgia,Augusta,195844
3880,1972-1973,1972-12-01,1973-02-28,90,0,0,62,62,22,27,49,111,3,27,Georgia,Augusta,195844
3881,1973-1974,1973-12-01,1974-02-28,90,0,0,40,40,0,0,0,40,0,0,Georgia,Augusta,195844
3882,1974-1975,1974-12-01,1975-02-28,90,0,0,37,37,0,0,0,37,0,0,Georgia,Augusta,195844
3883,1975-1976,1975-12-01,1976-02-29,91,0,0,69,69,0,0,0,69,0,0,Georgia,Augusta,195844
3884,1976-1977,1976-12-01,1977-02-28,90,0,2,111,113,1,0,1,114,1,2,Georgia,Augusta,195844
3885,1977-1978,1977-12-01,1978-02-28,90,0,0,94,94,2,1,3,97,1,3,Georgia,Augusta,195844
3886,1978-1979,1978-12-01,1979-02-28,90,0,1,79,80,4,6,10,90,1,7,Georgia,Augusta,195844
3887,1979-1980,1979-12-01,1980-03-03,94,0,1,74,75,8,5,13,88,2,12,Georgia,Augusta,195844
3888,1980-1981,1980-12-01,1981-02-28,90,0,0,93,93,0,0,0,93,0,0,Georgia,Augusta,195844
3889,1981-1982,1981-12-01,1982-02-28,90,0,4,96,100,2,0,2,102,1,5,Georgia,Augusta,195844
3890,1982-1983,1982-12-01,1983-02-28,90,0,0,50,50,0,0,0,50,0,0,Georgia,Augusta,195844
3891,1983-1984,1983-12-01,1984-02-29,91,0,1,69,70,0,0,0,70,0,0,Georgia,Augusta,195844
3892,1984-1985,1984-12-01,1985-02-28,90,0,1,64,65,0,0,0,65,0,0,Georgia,Augusta,195844
3893,1985-1986,1985-12-01,1986-02-28,90,0,0,76,76,0,0,0,76,0,0,Georgia,Augusta,195844
3894,1986-1987,1986-12-01,1987-02-28,90,0,0,38,38,0,0,0,38,0,0,Georgia,Augusta,195844
3895,1987-1988,1987-12-01,1988-02-29,91,0,2,76,78,3,6,9,87,1,6,Georgia,Augusta,195844
3896,1988-1989,1988-12-01,1989-02-28,90,0,0,50,50,4,4,8,58,1,5,Georgia,Augusta,195844
3897,1989-1990,1989-12-01,1990-02-28,90,0,2,44,46,2,0,2,48,2,4,Georgia,Augusta,195844
3898,1990-1991,1990-12-01,1991-02-28,90,0,0,33,33,0,0,0,33,0,0,Georgia,Augusta,195844
3899,1991-1992,1991-12-01,1992-02-29,91,0,0,47,47,3,3,6,53,1,4,Georgia,Augusta,195844
3900,1992-1993,1992-12-01,1993-02-28,90,0,0,28,28,0,0,0,28,0,0,Georgia,Augusta,195844
3901,1993-1994,1993-12-01,1994-02-28,90,0,1,65,66,2,1,3,69,1,3,Georgia,Augusta,195844
3902,1994-1995,1994-12-01,1995-02-28,90,0,0,40,40,0,0,0,40,0,0,Georgia,Augusta,195844
3903,1995-1996,1995-12-01,1996-02-29,91,8,1,83,84,3,0,3,87,2,8,Georgia,Augusta,195844
3904,1996-1997,1996-12-01,1997-02-28,90,0,0,54,54,0,0,0,54,0,0,Georgia,Augusta,195844
3905,1997-1998,1997-12-01,1998-02-28,90,2,0,35,35,0,0,0,35,0,0,Georgia,Augusta,195844
3906,1998-1999,1998-12-01,1999-02-28,90,0,0,47,47,0,0,0,47,0,0,Georgia,Augusta,195844
3907,1999-2000,1999-12-01,2000-02-29,91,0,0,73,73,1,1,2,75,1,1,Georgia,Augusta,195844
3908,2000-2001,2000-12-01,2001-02-28,90,0,0,88,88,0,0,0,88,0,0,Georgia,Augusta,195844
3909,2001-2002,2001-12-01,2002-02-28,90,0,0,59,59,5,6,11,70,2,7,Georgia,Augusta,195844
3910,2002-2003,2002-12-01,2003-02-28,90,0,0,68,68,0,0,0,68,0,0,Georgia,Augusta,195844
3911,2003-2004,2003-12-01,2004-02-29,91,0,0,87,87,0,0,0,87,0,0,Georgia,Augusta,195844
3912,2004-2005,2004-12-01,2005-02-28,90,0,0,58,58,0,0,0,58,0,0,Georgia,Augusta,195844
3913,2005-2006,2005-12-01,2006-02-28,90,0,0,52,52,0,0,0,52,0,0,Georgia,Augusta,195844
3914,2006-2007,2006-12-01,2007-02-28,90,0,0,50,50,0,0,0,50,0,0,Georgia,Augusta,195844
3915,2007-2008,2007-12-01,2008-02-29,91,0,0,48,48,0,0,0,48,0,0,Georgia,Augusta,195844
3916,2008-2009,2008-12-01,2009-02-28,90,0,0,63,63,0,0,0,63,0,0,Georgia,Augusta,195844
3917,2009-2010,2009-12-01,2010-02-28,90,0,0,75,75,12,5,17,92,1,13,Georgia,Augusta,195844
3918,2010-2011,2010-12-01,2011-02-28,90,0,1,93,94,5,1,6,100,2,8,Georgia,Augusta,195844
3919,2011-2012,2011-12-01,2012-02-29,91,0,0,44,44,0,0,0,44,0,0,Georgia,Augusta,195844
3920,2012-2013,2012-12-01,2013-02-28,90,0,0,35,35,0,0,0,35,0,0,Georgia,Augusta,195844
3921,2013-2014,2013-12-01,2014-02-28,90,0,2,74,76,5,4,9,85,3,10,Georgia,Augusta,195844
3922,2014-2015,2014-12-01,2015-02-28,90,0,0,71,71,0,0,0,71,0,0,Georgia,Augusta,195844
3923,2015-2016,2015-12-01,2016-02-29,91,0,0,38,38,1,0,1,39,1,2,Georgia,Augusta,195844
3924,2016-2017,2016-12-01,2017-02-28,90,1,0,16,16,0,0,0,16,0,0,Georgia,Augusta,195844
3925,2017-2018,2017-12-01,2018-02-28,90,0,0,57,57,0,0,0,57,0,0,Georgia,Augusta,195844
3926,2018-2019,2018-12-01,2019-02-28,90,0,0,30,30,0,0,0,30,0,0,Georgia,Augusta,195844
3927,2019-2020,2019-12-01,2020-02-29,91,0,0,18,18,0,0,0,18,0,0,Georgia,Augusta,195844
3928,1950-1951,1950-12-01,1951-02-28,90,0,0,19,19,0,0,0,19,0,0,Georgia,Brunswick,15383
3929,1951-1952,1951-12-01,1952-02-29,91,0,0,7,7,0,0,0,7,0,0,Georgia,Brunswick,15383
3930,1952-1953,1952-12-01,1953-02-28,90,0,0,6,6,0,0,0,6,0,0,Georgia,Brunswick,15383
3931,1953-1954,1953-12-01,1954-02-28,90,0,0,8,8,0,0,0,8,0,0,Georgia,Brunswick,15383
3932,1954-1955,1954-12-01,1955-02-28,90,0,0,20,20,0,0,0,20,0,0,Georgia,Brunswick,15383
3933,1955-1956,1955-12-01,1956-02-29,91,0,0,13,13,0,0,0,13,0,0,Georgia,Brunswick,15383
3934,1956-1957,1956-12-01,1957-02-28,90,0,0,4,4,0,0,0,4,0,0,Georgia,Brunswick,15383
3935,1957-1958,1957-12-01,1958-02-28,90,0,0,36,36,2,2,4,40,1,3,Georgia,Brunswick,15383
3936,1958-1959,1958-12-01,1959-02-28,90,0,0,21,21,0,0,0,21,0,0,Georgia,Brunswick,15383
3937,1959-1960,1959-12-01,1960-02-29,91,0,0,15,15,0,0,0,15,0,0,Georgia,Brunswick,15383
3938,1960-1961,1960-12-01,1961-02-28,90,0,0,25,25,0,0,0,25,0,0,Georgia,Brunswick,15383
3939,1961-1962,1961-12-01,1962-02-28,90,0,0,12,12,0,0,0,12,0,0,Georgia,Brunswick,15383
3940,1962-1963,1962-12-01,1963-02-28,90,0,0,31,31,0,0,0,31,0,0,Georgia,Brunswick,15383
3941,1963-1964,1963-12-01,1964-02-29,91,0,0,17,17,0,0,0,17,0,0,Georgia,Brunswick,15383
3942,1964-1965,1964-12-01,1965-02-28,90,0,0,13,13,0,0,0,13,0,0,Georgia,Brunswick,15383
3943,1965-1966,1965-12-01,1966-02-28,90,0,0,17,17,0,0,0,17,0,0,Georgia,Brunswick,15383
3944,1966-1967,1966-12-01,1967-02-28,90,0,0,9,9,0,0,0,9,0,0,Georgia,Brunswick,15383
3945,1967-1968,1967-12-01,1968-02-29,91,0,0,16,16,0,0,0,16,0,0,Georgia,Brunswick,15383
3946,1968-1969,1968-12-01,1969-02-28,90,0,0,17,17,0,0,0,17,0,0,Georgia,Brunswick,15383
3947,1969-1970,1969-12-01,1970-02-28,90,0,0,27,27,0,0,0,27,0,0,Georgia,Brunswick,15383
3948,1970-1971,1970-12-01,1971-02-28,90,0,0,17,17,0,0,0,17,0,0,Georgia,Brunswick,15383
3949,1971-1972,1971-12-01,1972-02-29,91,2,0,5,5,0,0,0,5,0,0,Georgia,Brunswick,15383
3950,1972-1973,1972-12-01,1973-02-28,90,0,0,13,13,1,0,1,14,1,2,Georgia,Brunswick,15383
3951,1973-1974,1973-12-01,1974-02-28,90,0,0,8,8,0,0,0,8,0,0,Georgia,Brunswick,15383
3952,1974-1975,1974-12-01,1975-02-28,90,0,0,5,5,0,0,0,5,0,0,Georgia,Brunswick,15383
3953,1975-1976,1975-12-01,1976-02-29,91,0,0,15,15,0,0,0,15,0,0,Georgia,Brunswick,15383
3954,1976-1977,1976-12-01,1977-02-28,90,0,0,27,27,0,0,0,27,0,0,Georgia,Brunswick,15383
3955,1977-1978,1977-12-01,1978-02-28,90,0,0,23,23,0,0,0,23,0,0,Georgia,Brunswick,15383
3956,1978-1979,1978-12-01,1979-02-28,90,0,0,16,16,0,0,0,16,0,0,Georgia,Brunswick,15383
3957,1979-1980,1979-12-01,1980-02-29,91,2,0,10,10,0,0,0,10,0,0,Georgia,Brunswick,15383
3958,1980-1981,1980-12-01,1981-02-28,90,0,0,22,22,0,0,0,22,0,0,Georgia,Brunswick,15383
3959,1981-1982,1981-12-01,1982-02-28,90,0,0,19,19,0,0,0,19,0,0,Georgia,Brunswick,15383
3960,1982-1983,1982-12-01,1983-02-28,90,0,0,7,7,0,0,0,7,0,0,Georgia,Brunswick,15383
3961,1983-1984,1983-12-01,1984-02-29,91,0,1,24,25,0,0,0,25,0,0,Georgia,Brunswick,15383
3962,1984-1985,1984-12-01,1985-02-28,90,0,1,27,28,0,0,0,28,0,0,Georgia,Brunswick,15383
3963,1985-1986,1985-12-01,1986-02-28,90,0,0,18,18,0,0,0,18,0,0,Georgia,Brunswick,15383
3964,1986-1987,1986-12-01,1987-02-28,90,3,0,5,5,0,0,0,5,0,0,Georgia,Brunswick,15383
3965,1987-1988,1987-12-01,1988-02-29,91,0,0,14,14,0,0,0,14,0,0,Georgia,Brunswick,15383
3966,1988-1989,1988-12-01,1989-02-28,90,0,0,11,11,0,0,0,11,0,0,Georgia,Brunswick,15383
3967,1989-1990,1989-12-01,1990-02-28,90,0,2,18,20,6,10,16,36,1,11,Georgia,Brunswick,15383
3968,1990-1991,1990-12-01,1991-02-28,90,0,0,8,8,0,0,0,8,0,0,Georgia,Brunswick,15383
3969,1991-1992,1991-12-01,1992-02-29,91,0,0,4,4,0,0,0,4,0,0,Georgia,Brunswick,15383
3970,1992-1993,1992-12-01,1993-02-28,90,0,0,1,1,0,0,0,1,0,0,Georgia,Brunswick,15383
3971,1993-1994,1993-12-01,1994-02-28,90,0,0,14,14,0,0,0,14,0,0,Georgia,Brunswick,15383
3972,1994-1995,1994-12-01,1995-02-28,90,0,0,8,8,0,0,0,8,0,0,Georgia,Brunswick,15383
3973,1995-1996,1995-12-01,1996-02-29,91,2,0,26,26,0,0,0,26,0,0,Georgia,Brunswick,15383
3974,1996-1997,1996-12-01,1997-02-28,90,0,0,7,7,0,0,0,7,0,0,Georgia,Brunswick,15383
3975,1997-1998,1997-12-01,1998-02-28,90,2,0,2,2,0,0,0,2,0,0,Georgia,Brunswick,15383
3976,1998-1999,1998-12-01,1999-02-28,90,4,0,8,8,0,0,0,8,0,0,Georgia,Brunswick,15383
3977,1999-2000,1999-12-01,2000-02-29,91,0,0,10,10,0,0,0,10,0,0,Georgia,Brunswick,15383
3978,2000-2001,2000-12-01,2001-02-28,90,0,0,23,23,0,0,0,23,0,0,Georgia,Brunswick,15383
3979,2001-2002,2001-12-01,2002-02-28,90,0,0,6,6,0,0,0,6,0,0,Georgia,Brunswick,15383
3980,2002-2003,2002-12-01,2003-02-28,90,0,0,12,12,0,0,0,12,0,0,Georgia,Brunswick,15383
3981,2003-2004,2003-12-01,2004-02-29,91,0,0,10,10,0,0,0,10,0,0,Georgia,Brunswick,15383
3982,2004-2005,2004-12-01,2005-02-28,90,8,0,11,11,0,0,0,11,0,0,Georgia,Brunswick,15383
3983,2005-2006,2005-12-01,2006-02-28,90,6,0,5,5,0,0,0,5,0,0,Georgia,Brunswick,15383
3984,2006-2007,2006-12-01,2007-02-28,90,5,0,6,6,0,0,0,6,0,0,Georgia,Brunswick,15383
3985,2007-2008,2007-12-01,2008-02-29,91,7,0,7,7,0,0,0,7,0,0,Georgia,Brunswick,15383
3986,2008-2009,2008-12-01,2009-02-28,90,3,0,8,8,0,0,0,8,0,0,Georgia,Brunswick,15383
3987,2009-2010,2009-12-01,2010-02-28,90,0,0,19,19,0,0,0,19,0,0,Georgia,Brunswick,15383
3988,2010-2011,2010-12-01,2011-02-28,90,0,0,19,19,0,0,0,19,0,0,Georgia,Brunswick,15383
3989,2011-2012,2011-12-01,2012-02-29,91,0,0,4,4,0,0,0,4,0,0,Georgia,Brunswick,15383
3990,2012-2013,2012-12-01,2013-02-28,90,0,0,3,3,0,0,0,3,0,0,Georgia,Brunswick,15383
3991,2013-2014,2013-12-01,2014-02-28,90,0,0,9,9,0,0,0,9,0,0,Georgia,Brunswick,15383
3992,2014-2015,2014-12-01,2015-02-28,90,3,0,7,7,0,0,0,7,0,0,Georgia,Brunswick,15383
3993,2015-2016,2015-12-01,2016-02-29,91,4,0,4,4,0,0,0,4,0,0,Georgia,Brunswick,15383
3994,2016-2017,2016-12-01,2017-02-28,90,2,0,1,1,0,0,0,1,0,0,Georgia,Brunswick,15383
3995,2017-2018,2017-12-01,2018-02-28,90,0,1,11,12,0,0,0,12,0,0,Georgia,Brunswick,15383
3996,2018-2019,2018-12-01,2019-02-28,90,0,0,1,1,0,0,0,1,0,0,Georgia,Brunswick,15383
3997,2019-2020,2019-12-01,2020-02-29,91,0,0,0,0,0,0,0,0,0,0,Georgia,Brunswick,15383
3998,1950-1951,1950-11-25,1951-02-28,96,0,1,38,39,0,0,0,39,0,0,Georgia,Savannah,136286
3999,1951-1952,1951-12-01,1952-02-29,91,0,0,14,14,0,0,0,14,0,0,Georgia,Savannah,136286
4000,1952-1953,1952-12-01,1953-02-28,90,0,0,16,16,0,0,0,16,0,0,Georgia,Savannah,136286
4001,1953-1954,1953-12-01,1954-02-28,90,0,0,20,20,0,0,0,20,0,0,Georgia,Savannah,136286
4002,1954-1955,1954-12-01,1955-02-28,90,0,0,39,39,0,0,0,39,0,0,Georgia,Savannah,136286
4003,1955-1956,1955-12-01,1956-02-29,91,0,0,27,27,0,0,0,27,0,0,Georgia,Savannah,136286
4004,1956-1957,1956-12-01,1957-02-28,90,0,0,17,17,0,0,0,17,0,0,Georgia,Savannah,136286
4005,1957-1958,1957-12-01,1958-02-28,90,0,0,58,58,2,0,2,60,1,3,Georgia,Savannah,136286
4006,1958-1959,1958-12-01,1959-02-28,90,0,0,39,39,0,0,0,39,0,0,Georgia,Savannah,136286
4007,1959-1960,1959-12-01,1960-02-29,91,0,0,31,31,0,0,0,31,0,0,Georgia,Savannah,136286
4008,1960-1961,1960-12-01,1961-02-28,90,0,0,56,56,0,0,0,56,0,0,Georgia,Savannah,136286
4009,1961-1962,1961-12-01,1962-02-28,90,0,0,28,28,0,0,0,28,0,0,Georgia,Savannah,136286
4010,1962-1963,1962-12-01,1963-02-28,90,0,0,48,48,0,0,0,48,0,0,Georgia,Savannah,136286
4011,1963-1964,1963-12-01,1964-02-29,91,0,0,42,42,0,0,0,42,0,0,Georgia,Savannah,136286
4012,1964-1965,1964-12-01,1965-02-28,90,0,0,33,33,0,0,0,33,0,0,Georgia,Savannah,136286
4013,1965-1966,1965-12-01,1966-02-28,90,0,0,53,53,0,0,0,53,0,0,Georgia,Savannah,136286
4014,1966-1967,1966-12-01,1967-02-28,90,0,0,39,39,0,0,0,39,0,0,Georgia,Savannah,136286
4015,1967-1968,1967-12-01,1968-02-29,91,0,1,45,46,4,4,8,54,1,5,Georgia,Savannah,136286
4016,1968-1969,1968-12-01,1969-02-28,90,0,0,51,51,0,0,0,51,0,0,Georgia,Savannah,136286
4017,1969-1970,1969-12-01,1970-02-28,90,0,1,56,57,0,0,0,57,0,0,Georgia,Savannah,136286
4018,1970-1971,1970-12-01,1971-02-28,90,0,0,38,38,0,0,0,38,0,0,Georgia,Savannah,136286
4019,1971-1972,1971-12-01,1972-02-29,91,0,0,17,17,0,0,0,17,0,0,Georgia,Savannah,136286
4020,1972-1973,1972-12-01,1973-02-28,90,0,0,25,25,4,3,7,32,1,5,Georgia,Savannah,136286
4021,1973-1974,1973-12-01,1974-02-28,90,0,0,20,20,0,0,0,20,0,0,Georgia,Savannah,136286
4022,1974-1975,1974-12-01,1975-02-28,90,0,0,10,10,0,0,0,10,0,0,Georgia,Savannah,136286
4023,1975-1976,1975-12-01,1976-02-29,91,0,0,37,37,0,0,0,37,0,0,Georgia,Savannah,136286
4024,1976-1977,1976-12-01,1977-02-28,90,0,2,50,52,3,0,3,55,2,7,Georgia,Savannah,136286
4025,1977-1978,1977-12-01,1978-02-28,90,0,0,49,49,0,0,0,49,0,0,Georgia,Savannah,136286
4026,1978-1979,1978-12-01,1979-02-28,90,0,0,37,37,0,0,0,37,0,0,Georgia,Savannah,136286
4027,1979-1980,1979-12-01,1980-03-02,93,0,1,27,28,0,0,0,28,0,0,Georgia,Savannah,136286
4028,1980-1981,1980-12-01,1981-02-28,90,0,0,42,42,0,0,0,42,0,0,Georgia,Savannah,136286
4029,1981-1982,1981-12-01,1982-02-28,90,0,1,35,36,0,0,0,36,0,0,Georgia,Savannah,136286
4030,1982-1983,1982-12-01,1983-02-28,90,0,0,15,15,0,0,0,15,0,0,Georgia,Savannah,136286
4031,1983-1984,1983-12-01,1984-02-29,91,0,1,33,34,0,0,0,34,0,0,Georgia,Savannah,136286
4032,1984-1985,1984-12-01,1985-02-28,90,0,1,40,41,0,0,0,41,0,0,Georgia,Savannah,136286
4033,1985-1986,1985-12-01,1986-03-01,91,0,0,32,32,3,0,3,35,2,6,Georgia,Savannah,136286
4034,1986-1987,1986-12-01,1987-02-28,90,0,0,10,10,0,0,0,10,0,0,Georgia,Savannah,136286
4035,1987-1988,1987-12-01,1988-02-29,91,0,0,34,34,0,0,0,34,0,0,Georgia,Savannah,136286
4036,1988-1989,1988-12-01,1989-02-28,90,0,0,22,22,2,1,3,25,1,3,Georgia,Savannah,136286
4037,1989-1990,1989-12-01,1990-02-28,90,0,2,22,24,6,8,14,38,3,16,Georgia,Savannah,136286
4038,1990-1991,1990-12-01,1991-02-28,90,0,0,11,11,0,0,0,11,0,0,Georgia,Savannah,136286
4039,1991-1992,1991-12-01,1992-02-29,91,0,0,10,10,0,0,0,10,0,0,Georgia,Savannah,136286
4040,1992-1993,1992-12-01,1993-03-13,103,0,0,6,6,1,0,1,7,1,1,Georgia,Savannah,136286
4041,1993-1994,1993-12-01,1994-02-28,90,0,0,23,23,0,0,0,23,0,0,Georgia,Savannah,136286
4042,1994-1995,1994-12-01,1995-02-28,90,0,0,9,9,0,0,0,9,0,0,Georgia,Savannah,136286
4043,1995-1996,1995-12-01,1996-02-29,91,0,0,34,34,1,0,1,35,1,2,Georgia,Savannah,136286
4044,2002-2003,2002-12-01,2003-02-28,90,0,0,35,35,0,0,0,35,0,0,Georgia,Savannah,136286
4045,2003-2004,2003-12-01,2004-02-29,91,0,0,29,29,0,0,0,29,0,0,Georgia,Savannah,136286
4046,2004-2005,2004-12-01,2005-02-28,90,0,0,21,21,0,0,0,21,0,0,Georgia,Savannah,136286
4047,2005-2006,2005-12-01,2006-02-28,90,0,0,22,22,0,0,0,22,0,0,Georgia,Savannah,136286
4048,2006-2007,2006-12-01,2007-02-28,90,0,0,24,24,0,0,0,24,0,0,Georgia,Savannah,136286
4049,2007-2008,2007-12-01,2008-02-29,91,0,0,16,16,0,0,0,16,0,0,Georgia,Savannah,136286
4050,2008-2009,2008-12-01,2009-02-28,90,0,0,28,28,0,0,0,28,0,0,Georgia,Savannah,136286
4051,2009-2010,2009-12-01,2010-02-28,90,0,0,39,39,1,1,2,41,1,1,Georgia,Savannah,136286
4052,2010-2011,2010-12-01,2011-02-28,90,0,0,48,48,0,0,0,48,0,0,Georgia,Savannah,136286
4053,2011-2012,2011-12-01,2012-02-29,91,0,0,16,16,0,0,0,16,0,0,Georgia,Savannah,136286
4054,2012-2013,2012-12-01,2013-02-28,90,0,0,11,11,0,0,0,11,0,0,Georgia,Savannah,136286
4055,2013-2014,2013-12-01,2014-02-28,90,0,1,20,21,0,0,0,21,0,0,Georgia,Savannah,136286
4056,2014-2015,2014-12-01,2015-02-28,90,0,0,19,19,0,0,0,19,0,0,Georgia,Savannah,136286
4057,2015-2016,2015-12-01,2016-02-29,91,0,0,15,15,0,0,0,15,0,0,Georgia,Savannah,136286
4058,2016-2017,2016-12-01,2017-02-28,90,0,0,6,6,0,0,0,6,0,0,Georgia,Savannah,136286
4059,2017-2018,2017-12-01,2018-02-28,90,0,1,30,31,2,1,3,34,1,5,Georgia,Savannah,136286
4060,2018-2019,2018-12-01,2019-02-28,90,0,0,7,7,0,0,0,7,0,0,Georgia,Savannah,136286
4061,2019-2020,2019-12-01,2020-02-29,91,0,0,5,5,0,0,0,5,0,0,Georgia,Savannah,136286
4062,1950-1951,1950-12-01,1951-03-30,120,0,18,159,177,44,17,61,238,22,84,Idaho,Boise,205671
4063,1951-1952,1951-12-01,1952-03-23,114,0,42,248,290,68,94,162,452,33,149,Idaho,Boise,205671
4064,1952-1953,1952-11-27,1953-04-12,137,1,6,145,151,21,6,27,178,17,39,Idaho,Boise,205671
4065,1953-1954,1953-12-01,1954-04-30,151,0,7,163,170,29,9,38,208,18,56,Idaho,Boise,205671
4066,1954-1955,1954-12-01,1955-04-19,140,0,45,298,343,42,85,127,470,23,99,Idaho,Boise,205671
4067,1955-1956,1955-11-01,1956-03-05,126,1,40,220,260,56,57,113,373,40,161,Idaho,Boise,205671
4068,1956-1957,1956-11-01,1957-03-03,123,1,49,263,312,39,70,109,421,20,109,Idaho,Boise,205671
4069,1957-1958,1957-12-01,1958-03-15,105,0,10,120,130,25,3,28,158,16,41,Idaho,Boise,205671
4070,1958-1959,1958-11-16,1959-03-10,115,0,10,129,139,15,8,23,162,10,33,Idaho,Boise,205671
4071,1959-1960,1959-11-13,1960-03-12,121,0,32,300,332,38,47,85,417,27,127,Idaho,Boise,205671
4072,1960-1961,1960-11-15,1961-03-11,117,0,3,157,160,15,3,18,178,13,30,Idaho,Boise,205671
4073,1961-1962,1961-11-20,1962-03-11,112,0,75,232,307,34,120,154,461,18,93,Idaho,Boise,205671
4074,1962-1963,1962-11-17,1963-04-20,155,0,31,198,229,20,8,28,257,12,61,Idaho,Boise,205671
4075,1963-1964,1963-11-22,1964-05-02,163,0,42,290,332,66,108,174,506,36,149,Idaho,Boise,205671
4076,1964-1965,1964-11-15,1965-04-10,147,0,17,191,208,61,36,97,305,33,114,Idaho,Boise,205671
4077,1965-1966,1965-11-26,1966-04-26,152,0,18,213,231,29,38,67,298,19,69,Idaho,Boise,205671
4078,1966-1967,1966-10-13,1967-04-28,198,0,11,176,187,37,33,70,257,18,74,Idaho,Boise,205671
4079,1967-1968,1967-11-29,1968-04-21,145,0,22,199,221,20,22,42,263,17,70,Idaho,Boise,205671
4080,1968-1969,1968-11-13,1969-04-07,146,0,13,131,144,68,60,128,272,36,128,Idaho,Boise,205671
4081,1969-1970,1969-10-12,1970-05-12,213,0,10,185,195,28,11,39,234,20,50,Idaho,Boise,205671
4082,1970-1971,1970-10-26,1971-03-16,142,0,16,149,165,24,8,32,197,21,66,Idaho,Boise,205671
4083,1971-1972,1971-10-27,1972-04-29,186,0,24,212,236,50,42,92,328,32,102,Idaho,Boise,205671
4084,1972-1973,1972-12-01,1973-03-17,107,0,58,204,262,31,65,96,358,13,105,Idaho,Boise,205671
4085,1973-1974,1973-11-20,1974-03-08,109,0,32,126,158,45,31,76,234,25,94,Idaho,Boise,205671
4086,1974-1975,1974-11-23,1975-05-03,162,0,19,189,208,41,63,104,312,31,87,Idaho,Boise,205671
4087,1975-1976,1975-11-22,1976-04-15,146,0,31,206,237,44,31,75,312,27,88,Idaho,Boise,205671
4088,1976-1977,1976-11-27,1977-03-28,122,0,57,324,381,27,131,158,539,19,76,Idaho,Boise,205671
4089,1977-1978,1977-11-19,1978-02-28,102,0,5,85,90,31,29,60,150,20,63,Idaho,Boise,205671
4090,1978-1979,1978-11-11,1979-04-11,152,0,78,345,423,44,90,134,557,36,174,Idaho,Boise,205671
4091,1979-1980,1979-11-22,1980-03-27,127,0,20,169,189,25,37,62,251,18,73,Idaho,Boise,205671
4092,1980-1981,1980-11-23,1981-04-03,132,0,15,167,182,13,22,35,217,7,25,Idaho,Boise,205671
4093,1981-1982,1981-11-24,1982-04-06,134,0,47,247,294,55,185,240,534,32,134,Idaho,Boise,205671
4094,1982-1983,1982-11-10,1983-05-08,180,0,19,164,183,21,55,76,259,16,54,Idaho,Boise,205671
4095,1983-1984,1983-11-28,1984-04-24,149,0,90,294,384,57,281,338,722,27,167,Idaho,Boise,205671
4096,1984-1985,1984-11-27,1985-04-19,144,0,88,361,449,37,155,192,641,28,169,Idaho,Boise,205671
4097,1985-1986,1985-11-09,1986-02-28,112,0,113,352,465,58,279,337,802,26,143,Idaho,Boise,205671
4098,1986-1987,1986-11-07,1987-02-28,114,0,24,209,233,13,4,17,250,8,32,Idaho,Boise,205671
4099,1987-1988,1987-11-24,1988-04-07,136,0,27,235,262,23,60,83,345,17,53,Idaho,Boise,205671
4100,1988-1989,1988-11-24,1989-03-03,100,0,70,294,364,34,147,181,545,20,112,Idaho,Boise,205671
4101,1989-1990,1989-11-26,1990-03-11,106,0,9,186,195,25,11,36,231,19,60,Idaho,Boise,205671
4102,1990-1991,1990-11-21,1991-03-25,125,0,86,300,386,31,122,153,539,17,130,Idaho,Boise,205671
4103,1991-1992,1991-10-29,1992-02-29,124,0,3,156,159,10,0,10,169,8,19,Idaho,Boise,205671
4104,1992-1993,1992-11-09,1993-03-04,116,0,60,265,325,56,115,171,496,32,169,Idaho,Boise,205671
4105,1993-1994,1993-11-23,1994-02-28,98,0,15,171,186,15,22,37,223,9,32,Idaho,Boise,205671
4106,1994-1995,1994-11-16,1995-03-23,128,0,24,165,189,40,69,109,298,23,93,Idaho,Boise,205671
4107,1995-1996,1995-11-10,1996-03-25,137,0,30,142,172,33,29,62,234,19,66,Idaho,Boise,205671
4108,1996-1997,1996-12-01,1997-03-03,93,0,8,122,130,28,31,59,189,14,49,Idaho,Boise,205671
4109,1997-1998,1997-12-01,1998-03-08,98,0,3,102,105,14,5,19,124,9,21,Idaho,Boise,205671
4110,1998-1999,1998-12-01,1999-04-03,124,0,18,138,156,40,17,57,213,21,66,Idaho,Boise,205671
4111,1999-2000,1999-11-21,2000-03-09,110,0,13,103,116,28,7,35,151,23,62,Idaho,Boise,205671
4112,2000-2001,2000-11-08,2001-03-02,115,0,34,198,232,33,47,80,312,22,71,Idaho,Boise,205671
4113,2001-2002,2001-11-24,2002-03-19,116,0,17,174,191,51,21,72,263,25,95,Idaho,Boise,205671
4114,2002-2003,2002-12-01,2003-04-06,127,0,3,90,93,12,1,13,106,11,23,Idaho,Boise,205671
4115,2003-2004,2003-11-22,2004-03-04,104,0,22,134,156,34,39,73,229,21,74,Idaho,Boise,205671
4116,2004-2005,2004-11-27,2005-02-28,94,0,11,121,132,10,0,10,142,10,34,Idaho,Boise,205671
4117,2005-2006,2005-11-08,2006-03-25,138,0,23,183,206,24,8,32,238,19,51,Idaho,Boise,205671
4118,2006-2007,2006-11-27,2007-03-02,96,0,18,169,187,18,8,26,213,15,46,Idaho,Boise,205671
4119,2007-2008,2007-11-20,2008-03-26,128,0,24,176,200,49,53,102,302,29,104,Idaho,Boise,205671
4120,2008-2009,2008-10-10,2009-04-03,176,0,21,166,187,50,53,103,290,24,89,Idaho,Boise,205671
4121,2009-2010,2009-11-13,2010-04-02,141,0,22,138,160,31,38,69,229,18,58,Idaho,Boise,205671
4122,2010-2011,2010-11-20,2011-03-27,128,0,20,162,182,39,48,87,269,25,74,Idaho,Boise,205671
4123,2011-2012,2011-11-04,2012-03-20,138,0,0,168,168,16,1,17,185,10,23,Idaho,Boise,205671
4124,2012-2013,2012-12-01,2013-03-22,112,0,51,201,252,27,71,98,350,18,75,Idaho,Boise,205671
4125,2013-2014,2013-11-16,2014-02-28,105,0,45,184,229,25,34,59,288,15,69,Idaho,Boise,205671
4126,2014-2015,2014-11-12,2015-02-28,109,0,27,131,158,23,70,93,251,13,50,Idaho,Boise,205671
4127,2015-2016,2015-11-15,2016-02-29,107,0,34,141,175,20,35,55,230,15,53,Idaho,Boise,205671
4128,2016-2017,2016-12-01,2017-04-08,129,0,74,243,317,57,216,273,590,25,163,Idaho,Boise,205671
4129,2017-2018,2017-12-01,2018-04-12,133,0,17,143,160,35,61,96,256,18,72,Idaho,Boise,205671
4130,2018-2019,2018-12-01,2019-02-28,90,0,9,124,133,34,36,70,203,23,66,Idaho,Boise,205671
4131,2019-2020,2019-10-29,2020-02-29,124,0,1,117,118,27,16,43,161,18,52,Idaho,Boise,205671
4132,1951-1952,1951-10-20,1952-04-17,181,0,206,654,860,167,1308,1475,2335,49,414,Idaho,Dubois,677
4133,1952-1953,1952-11-18,1953-04-07,141,0,116,404,520,59,760,819,1339,22,123,Idaho,Dubois,677
4134,1953-1954,1953-11-17,1954-04-30,165,2,85,422,507,61,409,470,977,25,147,Idaho,Dubois,677
4135,1956-1957,1956-10-27,1957-03-31,156,7,123,534,657,56,314,370,1027,21,129,Idaho,Dubois,677
4136,1958-1959,1958-11-12,1959-05-18,188,14,86,471,557,71,362,433,990,26,168,Idaho,Dubois,677
4137,1960-1961,1960-11-09,1961-03-20,132,2,59,381,440,40,425,465,905,16,81,Idaho,Dubois,677
4138,1961-1962,1961-10-22,1962-04-29,190,4,179,602,781,88,549,637,1418,33,263,Idaho,Dubois,677
4139,1962-1963,1962-11-17,1963-04-27,162,0,101,451,552,19,19,38,590,9,66,Idaho,Dubois,677
4140,1964-1965,1964-10-30,1965-04-09,162,11,113,516,629,94,806,900,1529,45,266,Idaho,Dubois,677
4141,1965-1966,1965-11-11,1966-03-22,132,1,90,418,508,50,433,483,991,33,183,Idaho,Dubois,677
4142,1966-1967,1966-11-09,1967-04-05,148,3,102,416,518,58,777,835,1353,25,161,Idaho,Dubois,677
4143,1967-1968,1967-11-22,1968-03-18,118,0,116,418,534,70,689,759,1293,36,247,Idaho,Dubois,677
4144,1968-1969,1968-11-05,1969-04-08,155,5,133,533,666,110,1009,1119,1785,43,283,Idaho,Dubois,677
4145,1969-1970,1969-10-02,1970-05-12,223,0,68,490,558,68,340,408,966,42,186,Idaho,Dubois,677
4146,1970-1971,1970-10-23,1971-04-02,162,0,153,541,694,78,983,1061,1755,39,251,Idaho,Dubois,677
4147,1971-1972,1971-10-28,1972-03-26,151,0,170,543,713,103,882,985,1698,43,384,Idaho,Dubois,677
4148,1973-1974,1973-11-02,1974-03-30,149,0,131,484,615,59,763,822,1437,22,146,Idaho,Dubois,677
4149,1974-1975,1974-10-21,1975-05-20,212,2,152,634,786,119,967,1086,1872,39,266,Idaho,Dubois,677
4150,1975-1976,1975-10-22,1976-06-14,237,0,128,559,687,79,744,823,1510,26,181,Idaho,Dubois,677
4151,1976-1977,1976-11-26,1977-05-17,173,0,91,476,567,36,225,261,828,14,89,Idaho,Dubois,677
4152,1977-1978,1977-10-31,1978-04-17,169,0,91,417,508,69,588,657,1165,31,147,Idaho,Dubois,677
4153,1978-1979,1978-09-18,1979-05-29,254,0,211,701,912,89,922,1011,1923,36,245,Idaho,Dubois,677
4154,1979-1980,1979-11-04,1980-05-26,205,0,82,476,558,68,456,524,1082,20,109,Idaho,Dubois,677
4155,1980-1981,1980-11-14,1981-05-07,175,0,35,331,366,44,190,234,600,13,74,Idaho,Dubois,677
4156,1981-1982,1981-10-30,1982-05-28,211,5,122,536,658,79,677,756,1414,43,232,Idaho,Dubois,677
4157,1982-1983,1982-10-01,1983-05-16,228,1,70,466,536,102,950,1052,1588,49,203,Idaho,Dubois,677
4158,1983-1984,1983-09-19,1984-06-11,267,2,159,591,750,102,889,991,1741,48,263,Idaho,Dubois,677
4159,1984-1985,1984-10-24,1985-05-11,200,5,171,675,846,76,967,1043,1889,33,195,Idaho,Dubois,677
4160,1985-1986,1985-10-08,1986-04-29,204,3,125,522,647,97,754,851,1498,41,270,Idaho,Dubois,677
4161,1986-1987,1986-11-06,1987-03-19,134,1,61,404,465,43,257,300,765,19,88,Idaho,Dubois,677
4162,1987-1988,1987-11-16,1988-04-25,162,1,90,474,564,62,376,438,1002,36,191,Idaho,Dubois,677
4163,1989-1990,1989-10-28,1990-06-12,228,1,83,527,610,65,392,457,1067,26,161,Idaho,Dubois,677
4164,1990-1991,1990-11-05,1991-05-02,179,2,123,542,665,55,245,300,965,30,157,Idaho,Dubois,677
4165,1991-1992,1991-10-23,1992-04-23,184,1,61,436,497,61,601,662,1159,30,144,Idaho,Dubois,677
4166,1992-1993,1992-11-02,1993-05-08,188,5,137,582,719,115,1118,1233,1952,49,317,Idaho,Dubois,677
4167,1993-1994,1993-11-19,1994-04-07,140,0,84,433,517,58,522,580,1097,25,150,Idaho,Dubois,677
4168,1994-1995,1994-10-04,1995-06-06,246,1,91,499,590,113,995,1108,1698,55,291,Idaho,Dubois,677
4169,1995-1996,1995-10-21,1996-04-21,184,0,73,479,552,88,470,558,1110,35,189,Idaho,Dubois,677
4170,1996-1997,1996-10-19,1997-04-09,173,1,87,473,560,83,519,602,1162,39,209,Idaho,Dubois,677
4171,1997-1998,1997-10-24,1998-04-13,172,1,56,431,487,84,816,900,1387,37,169,Idaho,Dubois,677
4172,1998-1999,1998-11-06,1999-05-16,192,3,89,493,582,94,779,873,1455,41,215,Idaho,Dubois,677
4173,1999-2000,1999-11-20,2000-05-12,175,3,59,387,446,70,675,745,1191,41,202,Idaho,Dubois,677
4174,2000-2001,2000-11-05,2001-06-13,221,5,101,546,647,72,824,896,1543,38,199,Idaho,Dubois,677
4175,2001-2002,2001-10-11,2002-05-08,210,1,138,593,731,86,947,1033,1764,43,293,Idaho,Dubois,677
4176,2002-2003,2002-10-24,2003-05-06,195,7,48,414,462,61,344,405,867,37,165,Idaho,Dubois,677
4177,2003-2004,2003-11-03,2004-04-28,178,0,91,454,545,63,668,731,1276,30,161,Idaho,Dubois,677
4178,2004-2005,2004-10-18,2005-04-20,185,0,65,424,489,63,569,632,1121,31,134,Idaho,Dubois,677
4179,2005-2006,2005-11-04,2006-04-17,165,0,139,503,642,77,955,1032,1674,38,204,Idaho,Dubois,677
4180,2006-2007,2006-10-25,2007-05-22,210,3,106,488,594,56,357,413,1007,27,143,Idaho,Dubois,677
4181,2007-2008,2007-11-21,2008-05-01,163,12,167,606,773,108,1083,1191,1964,43,307,Idaho,Dubois,677
4182,2008-2009,2008-12-01,2009-04-29,150,3,125,463,588,94,728,822,1410,49,325,Idaho,Dubois,677
4183,2009-2010,2009-10-05,2010-05-06,214,1,123,425,548,96,661,757,1305,54,247,Idaho,Dubois,677
4184,2010-2011,2010-10-26,2011-04-21,178,0,88,338,426,114,1012,1126,1552,70,300,Idaho,Dubois,677
4185,2011-2012,2011-10-06,2012-04-07,185,6,65,409,474,70,275,345,819,38,169,Idaho,Dubois,677
4186,2012-2013,2012-10-25,2013-04-08,166,4,110,397,507,87,595,682,1189,57,298,Idaho,Dubois,677
4187,2014-2015,2014-11-02,2015-04-15,165,0,68,322,390,41,218,259,649,25,96,Idaho,Dubois,677
4188,2015-2016,2015-11-04,2016-03-28,146,4,102,379,481,95,594,689,1170,52,298,Idaho,Dubois,677
4189,2016-2017,2016-10-05,2017-05-18,226,4,135,387,522,138,707,845,1367,72,412,Idaho,Dubois,677
4190,2017-2018,2017-10-20,2018-03-24,156,0,74,354,428,70,207,277,705,37,195,Idaho,Dubois,677
4191,2019-2020,2019-09-29,2020-04-15,200,15,110,472,582,85,766,851,1433,49,292,Idaho,Dubois,677
4192,1960-1961,1960-10-08,1961-05-06,211,2,36,605,641,97,189,286,927,47,228,Idaho,Idaho Falls,56813
4193,1961-1962,1961-09-21,1962-05-14,236,4,107,648,755,148,372,520,1275,62,402,Idaho,Idaho Falls,56813
4194,1962-1963,1962-09-08,1963-04-27,232,2,62,606,668,90,170,260,928,37,227,Idaho,Idaho Falls,56813
4195,1964-1965,1964-11-11,1965-05-25,196,2,68,560,628,116,443,559,1187,55,290,Idaho,Idaho Falls,56813
4196,1965-1966,1965-09-16,1966-05-22,249,2,65,631,696,139,496,635,1331,54,339,Idaho,Idaho Falls,56813
4197,1966-1967,1966-10-13,1967-06-01,232,0,44,547,591,106,431,537,1128,56,279,Idaho,Idaho Falls,56813
4198,1967-1968,1967-11-21,1968-04-26,158,2,66,557,623,113,506,619,1242,49,327,Idaho,Idaho Falls,56813
4199,1968-1969,1968-09-21,1969-04-25,217,0,71,647,718,146,702,848,1566,58,365,Idaho,Idaho Falls,56813
4200,1969-1970,1969-10-02,1970-05-14,225,0,49,611,660,119,367,486,1146,59,291,Idaho,Idaho Falls,56813
4201,1970-1971,1970-10-26,1971-05-17,204,0,88,572,660,166,616,782,1442,63,413,Idaho,Idaho Falls,56813
4202,1971-1972,1971-10-01,1972-04-30,213,3,106,571,677,210,914,1124,1801,71,489,Idaho,Idaho Falls,56813
4203,1972-1973,1972-10-23,1973-06-17,238,0,103,728,831,134,671,805,1636,64,373,Idaho,Idaho Falls,56813
4204,1973-1974,1973-11-01,1974-05-20,201,2,92,565,657,139,660,799,1456,71,393,Idaho,Idaho Falls,56813
4205,1975-1976,1975-10-08,1976-06-14,251,9,73,607,680,159,622,781,1461,63,387,Idaho,Idaho Falls,56813
4206,1976-1977,1976-11-27,1977-05-18,173,0,60,583,643,66,227,293,936,28,168,Idaho,Idaho Falls,56813
4207,1977-1978,1977-10-10,1978-05-30,233,1,43,418,461,123,615,738,1199,55,262,Idaho,Idaho Falls,56813
4208,1979-1980,1979-11-01,1980-05-26,208,1,64,508,572,103,275,378,950,48,244,Idaho,Idaho Falls,56813
4209,1980-1981,1980-10-14,1981-05-08,207,4,28,467,495,63,160,223,718,32,134,Idaho,Idaho Falls,56813
4210,1982-1983,1982-10-07,1983-05-18,224,6,60,529,589,133,568,701,1290,66,282,Idaho,Idaho Falls,56813
4211,1983-1984,1983-11-08,1984-05-06,181,5,104,623,727,137,1045,1182,1909,69,370,Idaho,Idaho Falls,56813
4212,1984-1985,1984-10-14,1985-04-22,191,10,107,740,847,144,1060,1204,2051,47,292,Idaho,Idaho Falls,56813
4213,1986-1987,1986-09-26,1987-04-19,206,8,54,572,626,63,236,299,925,28,147,Idaho,Idaho Falls,56813
4214,1987-1988,1987-11-14,1988-05-07,176,2,91,624,715,81,428,509,1224,38,215,Idaho,Idaho Falls,56813
4215,1988-1989,1988-11-09,1989-05-15,188,6,123,561,684,139,840,979,1663,46,291,Idaho,Idaho Falls,56813
4216,1989-1990,1989-10-28,1990-05-08,193,7,74,535,609,81,368,449,1058,34,225,Idaho,Idaho Falls,56813
4217,1990-1991,1990-11-04,1991-05-09,187,8,106,614,720,98,320,418,1138,33,253,Idaho,Idaho Falls,56813
4218,1991-1992,1991-10-25,1992-04-17,176,8,48,492,540,50,249,299,839,29,121,Idaho,Idaho Falls,56813
4219,1992-1993,1992-11-01,1993-05-06,187,7,121,658,779,147,1070,1217,1996,56,381,Idaho,Idaho Falls,56813
4220,1993-1994,1993-11-13,1994-04-28,167,6,69,530,599,70,334,404,1003,31,184,Idaho,Idaho Falls,56813
4221,1994-1995,1994-11-02,1995-06-06,217,16,71,478,549,95,461,556,1105,43,205,Idaho,Idaho Falls,56813
4222,2001-2002,2001-11-23,2002-06-09,199,11,127,561,688,129,737,866,1554,39,287,Idaho,Idaho Falls,56813
4223,2002-2003,2002-10-01,2003-04-15,197,9,42,449,491,51,194,245,736,24,119,Idaho,Idaho Falls,56813
4224,2003-2004,2003-10-30,2004-05-13,197,4,93,481,574,129,664,793,1367,37,243,Idaho,Idaho Falls,56813
4225,2004-2005,2004-10-28,2005-04-28,183,7,43,454,497,72,188,260,757,33,179,Idaho,Idaho Falls,56813
4226,2005-2006,2005-10-29,2006-04-17,171,20,102,458,560,145,550,695,1255,46,286,Idaho,Idaho Falls,56813
4227,2006-2007,2006-09-21,2007-05-05,227,9,84,563,647,54,109,163,810,24,123,Idaho,Idaho Falls,56813
4228,2010-2011,2010-10-07,2011-04-13,189,20,123,498,621,159,626,785,1406,51,343,Idaho,Idaho Falls,56813
4229,2011-2012,2011-10-06,2012-04-13,191,3,63,521,584,99,332,431,1015,33,213,Idaho,Idaho Falls,56813
4230,2012-2013,2012-10-25,2013-03-26,153,1,100,467,567,87,422,509,1076,29,212,Idaho,Idaho Falls,56813
4231,2013-2014,2013-11-03,2014-05-12,191,0,67,480,547,92,320,412,959,30,199,Idaho,Idaho Falls,56813
4232,2014-2015,2014-11-10,2015-04-15,157,0,54,330,384,55,203,258,642,15,122,Idaho,Idaho Falls,56813
4233,2016-2017,2016-11-17,2017-04-27,162,0,110,467,577,127,677,804,1381,46,316,Idaho,Idaho Falls,56813
4234,2017-2018,2017-10-14,2018-04-12,181,2,56,454,510,79,311,390,900,30,176,Idaho,Idaho Falls,56813
4235,2018-2019,2018-11-11,2019-04-10,151,0,82,523,605,130,951,1081,1686,43,275,Idaho,Idaho Falls,56813
4236,2019-2020,2019-10-09,2020-05-23,228,11,75,587,662,140,754,894,1556,49,359,Idaho,Idaho Falls,56813
4237,1950-1951,1950-11-12,1951-03-07,116,0,11,107,118,15,10,25,143,12,36,Idaho,Lewiston,31894
4238,1951-1952,1951-12-01,1952-03-31,122,0,24,169,193,30,76,106,299,23,85,Idaho,Lewiston,31894
4239,1952-1953,1952-11-22,1953-04-01,131,0,5,91,96,6,0,6,102,6,11,Idaho,Lewiston,31894
4240,1953-1954,1953-12-01,1954-02-28,90,0,11,80,91,10,13,23,114,7,37,Idaho,Lewiston,31894
4241,1954-1955,1954-12-01,1955-03-24,114,0,10,185,195,37,21,58,253,22,78,Idaho,Lewiston,31894
4242,1955-1956,1955-11-01,1956-03-13,134,0,51,236,287,75,97,172,459,37,171,Idaho,Lewiston,31894
4243,1956-1957,1956-11-19,1957-02-28,102,0,76,212,288,48,146,194,482,21,150,Idaho,Lewiston,31894
4244,1957-1958,1957-12-01,1958-03-17,107,0,1,62,63,2,0,2,65,1,3,Idaho,Lewiston,31894
4245,1958-1959,1958-11-15,1959-02-28,106,0,9,97,106,15,4,19,125,11,37,Idaho,Lewiston,31894
4246,1959-1960,1959-11-13,1960-03-06,115,0,38,199,237,38,95,133,370,19,107,Idaho,Lewiston,31894
4247,1960-1961,1960-12-01,1961-04-20,141,0,12,98,110,18,6,24,134,13,42,Idaho,Lewiston,31894
4248,1961-1962,1961-11-23,1962-03-27,125,0,31,153,184,44,57,101,285,21,95,Idaho,Lewiston,31894
4249,1962-1963,1962-12-01,1963-03-12,102,0,36,151,187,14,22,36,223,9,58,Idaho,Lewiston,31894
4250,1963-1964,1963-12-01,1964-03-25,116,0,8,115,123,30,15,45,168,19,56,Idaho,Lewiston,31894
4251,1964-1965,1964-11-17,1965-03-27,131,0,16,159,175,52,114,166,341,20,83,Idaho,Lewiston,31894
4252,1965-1966,1965-12-01,1966-03-21,111,0,2,94,96,37,21,58,154,13,52,Idaho,Lewiston,31894
4253,1966-1967,1966-11-09,1967-03-11,123,0,0,55,55,7,1,8,63,6,13,Idaho,Lewiston,31894
4254,1967-1968,1967-11-28,1968-02-29,94,0,17,96,113,22,14,36,149,14,60,Idaho,Lewiston,31894
4255,1968-1969,1968-12-01,1969-02-28,90,0,57,178,235,68,165,233,468,28,200,Idaho,Lewiston,31894
4256,1969-1970,1969-12-01,1970-03-04,94,0,14,69,83,30,20,50,133,21,62,Idaho,Lewiston,31894
4257,1970-1971,1970-11-22,1971-03-05,104,0,13,106,119,21,13,34,153,13,59,Idaho,Lewiston,31894
4258,1971-1972,1971-10-27,1972-04-17,174,0,27,156,183,35,23,58,241,26,99,Idaho,Lewiston,31894
4259,1972-1973,1972-12-01,1973-02-28,90,0,50,157,207,21,20,41,248,12,70,Idaho,Lewiston,31894
4260,1973-1974,1973-10-31,1974-03-02,123,0,42,122,164,23,72,95,259,14,56,Idaho,Lewiston,31894
4261,1974-1975,1974-12-01,1975-02-28,90,0,7,92,99,34,29,63,162,21,71,Idaho,Lewiston,31894
4262,1975-1976,1975-11-28,1976-04-01,126,0,8,108,116,13,1,14,130,12,31,Idaho,Lewiston,31894
4263,1976-1977,1976-11-26,1977-03-27,122,0,20,123,143,14,16,30,173,11,30,Idaho,Lewiston,31894
4264,1977-1978,1977-11-19,1978-03-03,105,0,19,74,93,36,36,72,165,18,80,Idaho,Lewiston,31894
4265,1978-1979,1978-11-10,1979-04-01,143,0,101,253,354,33,138,171,525,22,98,Idaho,Lewiston,31894
4266,1979-1980,1979-11-24,1980-03-30,128,0,23,122,145,35,37,72,217,15,69,Idaho,Lewiston,31894
4267,1980-1981,1980-11-23,1981-02-28,98,0,8,65,73,10,4,14,87,6,23,Idaho,Lewiston,31894
4268,1981-1982,1981-12-01,1982-02-28,90,0,25,104,129,26,48,74,203,17,59,Idaho,Lewiston,31894
4269,1982-1983,1982-11-24,1983-02-28,97,0,9,63,72,6,3,9,81,4,13,Idaho,Lewiston,31894
4270,1983-1984,1983-12-01,1984-02-29,91,0,42,137,179,17,46,63,242,11,65,Idaho,Lewiston,31894
4271,1984-1985,1984-11-25,1985-03-21,117,0,38,176,214,44,58,102,316,23,106,Idaho,Lewiston,31894
4272,1985-1986,1985-11-11,1986-02-28,110,0,73,193,266,25,43,68,334,20,111,Idaho,Lewiston,31894
4273,1986-1987,1986-11-08,1987-02-28,113,0,12,107,119,5,15,20,139,3,8,Idaho,Lewiston,31894
4274,1987-1988,1987-12-01,1988-02-29,91,0,22,96,118,10,6,16,134,9,32,Idaho,Lewiston,31894
4275,1988-1989,1988-11-14,1989-03-05,112,0,39,160,199,44,56,100,299,17,83,Idaho,Lewiston,31894
4276,1989-1990,1989-12-01,1990-02-28,90,0,3,55,58,6,3,9,67,5,14,Idaho,Lewiston,31894
4277,1990-1991,1990-12-01,1991-03-14,104,0,31,113,144,13,6,19,163,8,39,Idaho,Lewiston,31894
4278,1991-1992,1991-11-30,1992-02-29,92,0,2,61,63,0,0,0,63,0,0,Idaho,Lewiston,31894
4279,1992-1993,1992-11-27,1993-03-02,96,0,40,167,207,37,94,131,338,21,102,Idaho,Lewiston,31894
4280,1993-1994,1993-11-13,1994-02-28,108,0,15,102,117,12,6,18,135,7,29,Idaho,Lewiston,31894
4281,2004-2005,2004-12-01,2005-02-28,90,2,7,75,82,5,2,7,89,4,14,Idaho,Lewiston,31894
4282,2005-2006,2005-12-01,2006-03-15,105,0,19,98,117,8,4,12,129,5,15,Idaho,Lewiston,31894
4283,2006-2007,2006-11-28,2007-02-28,93,0,22,106,128,14,16,30,158,12,46,Idaho,Lewiston,31894
4284,2007-2008,2007-11-19,2008-02-29,103,0,14,98,112,25,20,45,157,13,41,Idaho,Lewiston,31894
4285,2008-2009,2008-12-01,2009-03-10,100,1,38,123,161,28,46,74,235,17,91,Idaho,Lewiston,31894
4286,2009-2010,2009-12-01,2010-02-28,90,0,17,81,98,5,2,7,105,3,14,Idaho,Lewiston,31894
4287,2010-2011,2010-11-21,2011-03-01,101,0,24,120,144,32,31,63,207,19,67,Idaho,Lewiston,31894
4288,2011-2012,2011-11-19,2012-02-29,103,0,7,99,106,21,20,41,147,8,31,Idaho,Lewiston,31894
4289,2012-2013,2012-12-01,2013-02-28,90,0,4,69,73,7,3,10,83,6,20,Idaho,Lewiston,31894
4290,2013-2014,2013-11-27,2014-03-02,96,0,33,121,154,29,24,53,207,17,85,Idaho,Lewiston,31894
4291,2014-2015,2014-11-13,2015-02-28,108,0,15,83,98,2,1,3,101,2,5,Idaho,Lewiston,31894
4292,2015-2016,2015-11-28,2016-02-29,94,0,9,68,77,12,4,16,93,9,23,Idaho,Lewiston,31894
4293,2016-2017,2016-12-01,2017-03-09,99,0,46,173,219,56,90,146,365,26,118,Idaho,Lewiston,31894
4294,2017-2018,2017-12-01,2018-02-28,90,0,19,85,104,23,34,57,161,12,61,Idaho,Lewiston,31894
4295,2018-2019,2018-12-01,2019-03-13,103,1,24,134,158,53,112,165,323,25,106,Idaho,Lewiston,31894
4296,2019-2020,2019-11-29,2020-03-15,108,0,3,60,63,21,24,45,108,9,38,Idaho,Lewiston,31894
4297,1952-1953,1952-11-25,1953-03-20,116,5,8,95,103,28,16,44,147,10,38,Idaho,Moscow,23800
4298,1953-1954,1953-12-01,1954-03-21,111,2,16,131,147,55,80,135,282,20,111,Idaho,Moscow,23800
4299,1954-1955,1954-12-01,1955-04-26,147,5,18,232,250,79,140,219,469,32,133,Idaho,Moscow,23800
4300,1958-1959,1958-11-14,1959-04-15,153,16,22,141,163,63,62,125,288,22,96,Idaho,Moscow,23800
4301,1960-1961,1960-11-15,1961-03-04,110,1,18,117,135,22,49,71,206,10,39,Idaho,Moscow,23800
4302,1963-1964,1963-12-01,1964-04-22,144,20,17,216,233,89,277,366,599,26,126,Idaho,Moscow,23800
4303,1964-1965,1964-11-15,1965-04-02,139,3,33,216,249,112,233,345,594,34,187,Idaho,Moscow,23800
4304,1965-1966,1965-11-25,1966-03-21,117,3,22,168,190,82,105,187,377,24,138,Idaho,Moscow,23800
4305,1966-1967,1966-10-22,1967-04-29,190,3,4,140,144,62,17,79,223,29,98,Idaho,Moscow,23800
4306,1967-1968,1967-11-28,1968-02-29,94,3,33,149,182,49,82,131,313,21,123,Idaho,Moscow,23800
4307,1968-1969,1968-11-15,1969-03-19,125,1,72,314,386,166,772,938,1324,49,359,Idaho,Moscow,23800
4308,1969-1970,1969-12-01,1970-03-06,96,1,28,129,157,48,128,176,333,18,94,Idaho,Moscow,23800
4309,1970-1971,1970-11-18,1971-04-24,158,3,39,229,268,103,157,260,528,36,189,Idaho,Moscow,23800
4310,1972-1973,1972-10-28,1973-03-31,155,4,68,257,325,37,77,114,439,20,107,Idaho,Moscow,23800
4311,1973-1974,1973-10-31,1974-04-12,164,1,52,221,273,115,213,328,601,38,189,Idaho,Moscow,23800
4312,1974-1975,1974-11-25,1975-04-17,144,1,28,246,274,127,478,605,879,45,230,Idaho,Moscow,23800
4313,1975-1976,1975-10-27,1976-04-01,158,4,24,258,282,116,138,254,536,31,180,Idaho,Moscow,23800
4314,1976-1977,1976-11-26,1977-04-01,127,0,30,198,228,35,37,72,300,20,76,Idaho,Moscow,23800
4315,1977-1978,1977-11-09,1978-04-21,164,5,29,175,204,69,120,189,393,27,116,Idaho,Moscow,23800
4316,1978-1979,1978-11-10,1979-04-02,144,0,118,395,513,104,630,734,1247,47,252,Idaho,Moscow,23800
4317,1979-1980,1979-11-23,1980-03-30,129,4,41,202,243,49,154,203,446,15,90,Idaho,Moscow,23800
4318,1980-1981,1980-12-01,1981-04-03,124,1,16,111,127,30,28,58,185,11,61,Idaho,Moscow,23800
4319,1981-1982,1981-11-23,1982-04-06,135,17,53,200,253,110,290,400,653,40,213,Idaho,Moscow,23800
4320,1982-1983,1982-10-18,1983-02-28,134,11,27,146,173,30,59,89,262,15,62,Idaho,Moscow,23800
4321,1983-1984,1983-11-23,1984-05-06,166,3,70,232,302,46,94,140,442,29,131,Idaho,Moscow,23800
4322,1984-1985,1984-10-27,1985-03-30,155,9,82,337,419,122,575,697,1116,47,259,Idaho,Moscow,23800
4323,1985-1986,1985-11-11,1986-02-28,110,2,92,287,379,65,417,482,861,24,174,Idaho,Moscow,23800
4324,1986-1987,1986-11-07,1987-03-28,142,3,23,194,217,36,72,108,325,15,66,Idaho,Moscow,23800
4325,1987-1988,1987-11-16,1988-03-30,136,3,35,207,242,49,151,200,442,22,98,Idaho,Moscow,23800
4326,1988-1989,1988-11-14,1989-03-17,124,0,48,253,301,140,467,607,908,37,221,Idaho,Moscow,23800
4327,1989-1990,1989-12-01,1990-04-28,149,0,12,151,163,42,51,93,256,22,90,Idaho,Moscow,23800
4328,1990-1991,1990-11-21,1991-03-26,126,1,58,193,251,56,118,174,425,20,123,Idaho,Moscow,23800
4329,1991-1992,1991-10-27,1992-02-29,126,0,2,102,104,19,10,29,133,10,30,Idaho,Moscow,23800
4330,1992-1993,1992-11-09,1993-03-11,123,2,49,294,343,112,603,715,1058,39,236,Idaho,Moscow,23800
4331,1993-1994,1993-11-13,1994-04-04,143,3,18,169,187,34,28,62,249,15,60,Idaho,Moscow,23800
4332,1994-1995,1994-11-01,1995-03-05,125,1,29,177,206,68,100,168,374,27,133,Idaho,Moscow,23800
4333,1995-1996,1995-11-07,1996-04-20,166,1,39,214,253,107,184,291,544,26,170,Idaho,Moscow,23800
4334,1996-1997,1996-10-19,1997-04-03,167,3,20,196,216,141,155,296,512,40,210,Idaho,Moscow,23800
4335,1997-1998,1997-12-01,1998-03-05,95,1,12,120,132,42,111,153,285,20,78,Idaho,Moscow,23800
4336,1998-1999,1998-11-09,1999-05-08,181,6,23,177,200,77,49,126,326,29,117,Idaho,Moscow,23800
4337,1999-2000,1999-11-21,2000-05-11,173,2,10,151,161,84,110,194,355,28,122,Idaho,Moscow,23800
4338,2000-2001,2000-11-08,2001-04-08,152,3,30,249,279,68,384,452,731,29,119,Idaho,Moscow,23800
4339,2001-2002,2001-11-25,2002-05-08,165,3,25,216,241,127,292,419,660,45,209,Idaho,Moscow,23800
4340,2002-2003,2002-10-30,2003-05-18,201,1,6,156,162,46,19,65,227,21,68,Idaho,Moscow,23800
4341,2003-2004,2003-11-03,2004-03-05,124,1,23,179,202,88,257,345,547,33,167,Idaho,Moscow,23800
4342,2004-2005,2004-10-24,2005-03-29,157,2,13,179,192,30,62,92,284,15,60,Idaho,Moscow,23800
4343,2005-2006,2005-11-29,2006-04-15,138,3,29,179,208,37,112,149,357,16,68,Idaho,Moscow,23800
4344,2006-2007,2006-11-24,2007-04-10,138,1,40,205,245,51,140,191,436,24,113,Idaho,Moscow,23800
4345,2007-2008,2007-11-19,2008-04-09,143,1,33,238,271,129,419,548,819,42,214,Idaho,Moscow,23800
4346,2008-2009,2008-12-01,2009-04-02,123,3,40,239,279,150,249,399,678,41,272,Idaho,Moscow,23800
4347,2009-2010,2009-11-13,2010-05-06,175,8,27,172,199,40,25,65,264,17,69,Idaho,Moscow,23800
4348,2010-2011,2010-11-18,2011-04-07,141,2,39,213,252,123,293,416,668,37,214,Idaho,Moscow,23800
4349,2011-2012,2011-11-12,2012-04-04,145,0,8,190,198,89,116,205,403,32,140,Idaho,Moscow,23800
4350,2012-2013,2012-11-08,2013-03-22,135,0,21,178,199,63,111,174,373,26,106,Idaho,Moscow,23800
4351,2013-2014,2013-11-04,2014-02-28,117,0,49,218,267,60,89,149,416,21,111,Idaho,Moscow,23800
4352,2014-2015,2014-11-12,2015-04-14,154,0,20,152,172,22,23,45,217,11,32,Idaho,Moscow,23800
4353,2015-2016,2015-11-05,2016-04-04,152,0,23,163,186,56,163,219,405,22,93,Idaho,Moscow,23800
4354,2016-2017,2016-11-28,2017-04-15,139,0,66,297,363,118,484,602,965,40,236,Idaho,Moscow,23800
4355,2017-2018,2017-11-05,2018-04-02,149,0,29,230,259,63,141,204,463,22,126,Idaho,Moscow,23800
4356,2018-2019,2018-11-24,2019-03-22,119,0,31,278,309,118,329,447,756,38,230,Idaho,Moscow,23800
4357,2019-2020,2019-10-09,2020-04-01,176,0,16,272,288,70,90,160,448,26,132,Idaho,Moscow,23800
4358,1950-1951,1950-11-09,1951-04-30,173,0,36,302,338,40,65,105,443,27,104,Idaho,Pocatello,54255
4359,1951-1952,1951-10-21,1952-04-15,178,0,98,511,609,85,294,379,988,44,247,Idaho,Pocatello,54255
4360,1952-1953,1952-11-14,1953-05-21,189,0,37,310,347,63,115,178,525,36,125,Idaho,Pocatello,54255
4361,1953-1954,1953-10-21,1954-04-30,192,0,18,299,317,48,47,95,412,26,95,Idaho,Pocatello,54255
4362,1954-1955,1954-10-24,1955-05-31,220,0,100,561,661,87,282,369,1030,45,243,Idaho,Pocatello,54255
4363,1955-1956,1955-11-12,1956-04-02,143,0,77,371,448,67,159,226,674,40,203,Idaho,Pocatello,54255
4364,1956-1957,1956-10-24,1957-04-06,165,0,61,430,491,42,103,145,636,27,151,Idaho,Pocatello,54255
4365,1957-1958,1957-11-01,1958-04-22,173,0,22,343,365,57,56,113,478,43,139,Idaho,Pocatello,54255
4366,1958-1959,1958-11-15,1959-04-19,156,0,31,261,292,39,61,100,392,22,97,Idaho,Pocatello,54255
4367,1959-1960,1959-11-13,1960-04-24,164,0,81,466,547,58,165,223,770,37,243,Idaho,Pocatello,54255
4368,1960-1961,1960-11-14,1961-05-05,173,0,21,330,351,36,31,67,418,25,74,Idaho,Pocatello,54255
4369,1961-1962,1961-10-21,1962-04-08,170,0,93,455,548,95,170,265,813,39,255,Idaho,Pocatello,54255
4370,1962-1963,1962-11-16,1963-04-22,158,0,50,345,395,50,45,95,490,26,142,Idaho,Pocatello,54255
4371,1963-1964,1963-11-21,1964-05-01,163,0,100,544,644,93,544,637,1281,54,288,Idaho,Pocatello,54255
4372,1964-1965,1964-11-10,1965-05-07,179,0,31,356,387,45,46,91,478,37,128,Idaho,Pocatello,54255
4373,1965-1966,1965-09-16,1966-04-26,223,0,40,437,477,56,104,160,637,37,165,Idaho,Pocatello,54255
4374,1966-1967,1966-10-13,1967-05-02,202,0,32,361,393,59,38,97,490,35,134,Idaho,Pocatello,54255
4375,1967-1968,1967-11-21,1968-04-26,158,0,64,436,500,59,147,206,706,34,192,Idaho,Pocatello,54255
4376,1968-1969,1968-11-15,1969-03-19,125,0,56,376,432,80,158,238,670,46,239,Idaho,Pocatello,54255
4377,1969-1970,1969-12-01,1970-04-30,151,0,35,239,274,50,52,102,376,33,105,Idaho,Pocatello,54255
4378,1970-1971,1970-10-22,1971-04-26,187,0,63,385,448,67,86,153,601,41,194,Idaho,Pocatello,54255
4379,1971-1972,1971-10-01,1972-04-13,196,0,84,413,497,93,137,230,727,46,230,Idaho,Pocatello,54255
4380,1972-1973,1972-10-28,1973-04-20,175,0,116,466,582,84,161,245,827,48,285,Idaho,Pocatello,54255
4381,1973-1974,1973-10-29,1974-04-20,174,0,64,327,391,83,93,176,567,48,233,Idaho,Pocatello,54255
4382,1974-1975,1974-10-21,1975-05-20,212,0,70,389,459,101,81,182,641,67,275,Idaho,Pocatello,54255
4383,1975-1976,1975-10-07,1976-04-29,206,0,42,356,398,94,79,173,571,46,203,Idaho,Pocatello,54255
4384,1976-1977,1976-11-25,1977-05-16,173,0,66,427,493,41,87,128,621,29,139,Idaho,Pocatello,54255
4385,1977-1978,1977-10-30,1978-05-05,188,0,24,211,235,48,22,70,305,36,108,Idaho,Pocatello,54255
4386,1978-1979,1978-11-09,1979-05-29,202,0,152,518,670,86,164,250,920,58,373,Idaho,Pocatello,54255
4387,1979-1980,1979-10-28,1980-04-10,166,0,62,343,405,59,72,131,536,33,143,Idaho,Pocatello,54255
4388,1980-1981,1980-10-15,1981-06-14,243,0,32,348,380,52,55,107,487,31,113,Idaho,Pocatello,54255
4389,1981-1982,1981-10-12,1982-05-09,210,0,92,429,521,105,309,414,935,57,311,Idaho,Pocatello,54255
4390,1982-1983,1982-10-18,1983-05-15,210,0,42,316,358,97,80,177,535,54,190,Idaho,Pocatello,54255
4391,1983-1984,1983-09-19,1984-05-06,231,0,134,529,663,137,498,635,1298,74,432,Idaho,Pocatello,54255
4392,1984-1985,1984-10-14,1985-04-22,191,0,145,621,766,94,348,442,1208,59,384,Idaho,Pocatello,54255
4393,1985-1986,1985-10-07,1986-05-08,214,0,128,489,617,102,338,440,1057,49,279,Idaho,Pocatello,54255
4394,1986-1987,1986-11-06,1987-04-19,165,0,49,402,451,55,104,159,610,38,166,Idaho,Pocatello,54255
4395,1987-1988,1987-11-14,1988-05-01,170,0,58,400,458,57,93,150,608,42,182,Idaho,Pocatello,54255
4396,1988-1989,1988-11-10,1989-05-12,184,0,130,448,578,94,254,348,926,61,363,Idaho,Pocatello,54255
4397,1989-1990,1989-10-27,1990-05-08,194,0,24,364,388,62,33,95,483,34,142,Idaho,Pocatello,54255
4398,1990-1991,1990-10-16,1991-05-10,207,0,95,474,569,82,184,266,835,48,285,Idaho,Pocatello,54255
4399,1991-1992,1991-10-27,1992-04-22,179,0,25,365,390,36,52,88,478,26,89,Idaho,Pocatello,54255
4400,1992-1993,1992-10-30,1993-05-08,191,0,117,528,645,145,540,685,1330,72,441,Idaho,Pocatello,54255
4401,1993-1994,1993-11-04,1994-04-26,174,0,37,398,435,56,124,180,615,39,155,Idaho,Pocatello,54255
4402,1994-1995,1994-11-03,1995-06-05,215,0,41,334,375,60,112,172,547,42,161,Idaho,Pocatello,54255
4403,1995-1996,1995-10-21,1996-04-27,190,3,37,299,336,52,108,160,496,33,126,Idaho,Pocatello,54255
4404,1996-1997,1996-10-25,1997-04-01,159,0,32,291,323,71,61,132,455,41,164,Idaho,Pocatello,54255
4405,1997-1998,1997-10-11,1998-03-29,170,0,37,311,348,60,62,122,470,35,127,Idaho,Pocatello,54255
4406,1998-1999,1998-11-09,1999-05-15,188,0,57,328,385,52,73,125,510,27,121,Idaho,Pocatello,54255
4407,1999-2000,1999-12-01,2000-03-29,120,0,22,228,250,42,40,82,332,29,111,Idaho,Pocatello,54255
4408,2000-2001,2000-10-29,2001-04-20,174,0,86,511,597,58,194,252,849,37,160,Idaho,Pocatello,54255
4409,2001-2002,2001-11-24,2002-04-19,147,0,116,443,559,80,176,256,815,37,218,Idaho,Pocatello,54255
4410,2002-2003,2002-10-29,2003-04-26,180,0,32,314,346,33,39,72,418,24,85,Idaho,Pocatello,54255
4411,2003-2004,2003-11-13,2004-04-28,168,0,71,341,412,106,316,422,834,45,265,Idaho,Pocatello,54255
4412,2004-2005,2004-10-31,2005-04-27,179,0,50,346,396,66,135,201,597,35,153,Idaho,Pocatello,54255
4413,2005-2006,2005-11-26,2006-04-18,144,0,60,321,381,62,53,115,496,38,171,Idaho,Pocatello,54255
4414,2006-2007,2006-10-25,2007-04-19,177,0,64,418,482,40,50,90,572,26,130,Idaho,Pocatello,54255
4415,2007-2008,2007-09-29,2008-05-01,216,0,74,466,540,69,77,146,686,45,196,Idaho,Pocatello,54255
4416,2008-2009,2008-10-11,2009-04-16,188,0,54,426,480,84,158,242,722,41,218,Idaho,Pocatello,54255
4417,2009-2010,2009-10-05,2010-05-06,214,0,50,447,497,53,41,94,591,37,138,Idaho,Pocatello,54255
4418,2010-2011,2010-11-08,2011-05-26,200,0,83,382,465,87,177,264,729,46,215,Idaho,Pocatello,54255
4419,2011-2012,2011-11-04,2012-04-06,155,0,23,372,395,27,28,55,450,20,62,Idaho,Pocatello,54255
4420,2012-2013,2012-10-24,2013-04-22,181,0,83,412,495,61,147,208,703,38,194,Idaho,Pocatello,54255
4421,2013-2014,2013-11-16,2014-04-02,138,0,54,337,391,49,62,111,502,26,163,Idaho,Pocatello,54255
4422,2014-2015,2014-11-11,2015-04-15,156,0,42,276,318,33,41,74,392,17,85,Idaho,Pocatello,54255
4423,2015-2016,2015-11-16,2016-03-30,136,0,67,329,396,54,120,174,570,31,156,Idaho,Pocatello,54255
4424,2016-2017,2016-11-28,2017-04-28,152,0,99,385,484,134,371,505,989,49,332,Idaho,Pocatello,54255
4425,2017-2018,2017-10-14,2018-03-26,164,0,32,282,314,50,84,134,448,31,130,Idaho,Pocatello,54255
4426,2018-2019,2018-11-17,2019-04-10,145,0,57,362,419,69,126,195,614,43,183,Idaho,Pocatello,54255
4427,2019-2020,2019-10-09,2020-04-16,191,0,30,413,443,61,110,171,614,37,155,Idaho,Pocatello,54255
4428,1950-1951,1950-11-11,1951-04-02,143,2,43,329,372,183,959,1142,1514,52,313,Idaho,Priest River,1751
4429,1951-1952,1951-10-16,1952-04-09,177,8,79,417,496,205,1272,1477,1973,63,396,Idaho,Priest River,1751
4430,1952-1953,1952-11-25,1953-04-14,141,0,20,223,243,94,461,555,798,41,157,Idaho,Priest River,1751
4431,1953-1954,1953-11-16,1954-04-03,139,1,38,282,320,143,919,1062,1382,37,255,Idaho,Priest River,1751
4432,1954-1955,1954-12-01,1955-05-13,164,3,58,364,422,143,934,1077,1499,55,269,Idaho,Priest River,1751
4433,1955-1956,1955-10-27,1956-04-08,165,2,105,431,536,195,1390,1585,2121,73,424,Idaho,Priest River,1751
4434,1956-1957,1956-10-24,1957-03-30,158,1,112,432,544,136,917,1053,1597,51,325,Idaho,Priest River,1751
4435,1957-1958,1957-10-22,1958-03-20,150,2,16,223,239,91,682,773,1012,42,154,Idaho,Priest River,1751
4436,1958-1959,1958-11-04,1959-04-01,149,0,52,314,366,156,1052,1208,1574,51,282,Idaho,Priest River,1751
4437,1959-1960,1959-11-11,1960-04-15,157,5,90,389,479,113,970,1083,1562,51,258,Idaho,Priest River,1751
4438,1960-1961,1960-11-10,1961-03-17,128,5,39,219,258,79,429,508,766,26,124,Idaho,Priest River,1751
4439,1961-1962,1961-10-23,1962-04-02,162,0,92,426,518,148,1129,1277,1795,41,294,Idaho,Priest River,1751
4440,1962-1963,1962-11-22,1963-02-28,99,0,60,223,283,37,116,153,436,13,80,Idaho,Priest River,1751
4441,1963-1964,1963-11-06,1964-04-08,155,5,44,297,341,143,1081,1224,1565,58,255,Idaho,Priest River,1751
4442,1964-1965,1964-11-02,1965-04-05,155,3,69,354,423,156,1091,1247,1670,47,299,Idaho,Priest River,1751
4443,1965-1966,1965-11-23,1966-03-30,128,4,38,231,269,150,971,1121,1390,37,223,Idaho,Priest River,1751
4444,1967-1968,1967-11-26,1968-04-12,139,0,57,302,359,109,726,835,1194,28,193,Idaho,Priest River,1751
4445,1968-1969,1968-11-08,1969-04-04,148,0,108,402,510,233,1286,1519,2029,57,450,Idaho,Priest River,1751
4446,1969-1970,1969-11-16,1970-04-01,137,1,56,282,338,123,901,1024,1362,31,203,Idaho,Priest River,1751
4447,1970-1971,1970-11-21,1971-04-04,135,0,64,307,371,150,1067,1217,1588,48,265,Idaho,Priest River,1751
4448,1971-1972,1971-09-29,1972-03-13,167,4,89,364,453,147,858,1005,1458,40,288,Idaho,Priest River,1751
4449,1972-1973,1972-10-28,1973-03-09,133,1,99,300,399,72,436,508,907,26,149,Idaho,Priest River,1751
4450,1973-1974,1973-11-03,1974-03-27,145,0,73,255,328,154,786,940,1268,40,243,Idaho,Priest River,1751
4451,1974-1975,1974-11-23,1975-04-18,147,0,55,281,336,160,1077,1237,1573,47,272,Idaho,Priest River,1751
4452,1975-1976,1975-10-25,1976-04-04,163,0,71,317,388,140,781,921,1309,43,233,Idaho,Priest River,1751
4453,1976-1977,1976-11-15,1977-03-06,112,2,65,222,287,42,433,475,762,15,83,Idaho,Priest River,1751
4454,1977-1978,1977-11-09,1978-03-24,136,0,59,227,286,142,996,1138,1424,38,223,Idaho,Priest River,1751
4455,1978-1979,1978-11-10,1979-03-28,139,2,163,457,620,111,1027,1138,1758,39,247,Idaho,Priest River,1751
4456,1979-1980,1979-10-19,1980-03-30,164,3,67,291,358,103,698,801,1159,30,180,Idaho,Priest River,1751
4457,1980-1981,1980-11-15,1981-02-28,106,0,45,158,203,54,175,229,432,17,89,Idaho,Priest River,1751
4458,1981-1982,1981-11-28,1982-04-03,127,5,79,260,339,119,680,799,1138,31,237,Idaho,Priest River,1751
4459,1982-1983,1982-11-12,1983-03-05,114,2,55,169,224,86,587,673,897,22,123,Idaho,Priest River,1751
4460,1983-1984,1983-11-22,1984-03-25,125,2,102,288,390,86,893,979,1369,25,154,Idaho,Priest River,1751
4461,1984-1985,1984-10-23,1985-04-08,168,4,146,431,577,160,1235,1395,1972,34,301,Idaho,Priest River,1751
4462,1985-1986,1985-11-09,1986-03-21,133,1,127,349,476,90,963,1053,1529,22,177,Idaho,Priest River,1751
4463,1986-1987,1986-11-09,1987-03-19,131,3,49,206,255,44,570,614,869,16,73,Idaho,Priest River,1751
4464,1987-1988,1987-11-15,1988-03-29,136,1,73,288,361,77,577,654,1015,42,211,Idaho,Priest River,1751
4465,1988-1989,1988-11-08,1989-04-04,148,2,107,356,463,129,916,1045,1508,43,265,Idaho,Priest River,1751
4466,1989-1990,1989-11-15,1990-03-28,134,7,48,214,262,134,604,738,1000,32,209,Idaho,Priest River,1751
4467,1990-1991,1990-11-03,1991-03-27,145,18,95,300,395,83,644,727,1122,22,165,Idaho,Priest River,1751
4468,1991-1992,1991-10-30,1992-02-29,123,1,22,164,186,49,345,394,580,23,86,Idaho,Priest River,1751
4469,1992-1993,1992-11-09,1993-03-29,141,5,111,397,508,139,1060,1199,1707,38,283,Idaho,Priest River,1751
4470,1993-1994,1993-11-14,1994-03-22,129,3,53,257,310,79,834,913,1223,34,141,Idaho,Priest River,1751
4471,1994-1995,1994-11-01,1995-03-11,131,3,67,281,348,105,756,861,1209,39,198,Idaho,Priest River,1751
4472,1995-1996,1995-11-07,1996-03-13,128,4,77,307,384,69,337,406,790,33,173,Idaho,Priest River,1751
4473,1996-1997,1996-11-06,1997-04-18,164,5,86,375,461,234,1963,2197,2658,62,405,Idaho,Priest River,1751
4474,1997-1998,1997-11-15,1998-03-15,121,3,42,201,243,69,476,545,788,31,128,Idaho,Priest River,1751
4475,1998-1999,1998-12-01,1999-03-30,120,9,38,216,254,93,645,738,992,40,168,Idaho,Priest River,1751
4476,1999-2000,1999-11-23,2000-04-14,144,14,30,248,278,102,845,947,1225,37,179,Idaho,Priest River,1751
4477,2000-2001,2000-11-08,2001-04-03,147,16,61,345,406,94,856,950,1356,44,212,Idaho,Priest River,1751
4478,2001-2002,2001-11-28,2002-03-30,123,6,37,252,289,124,953,1077,1366,44,233,Idaho,Priest River,1751
4479,2002-2003,2002-11-25,2003-03-26,122,5,23,188,211,62,395,457,668,19,87,Idaho,Priest River,1751
4480,2003-2004,2003-10-31,2004-03-21,143,5,52,323,375,113,903,1016,1391,43,250,Idaho,Priest River,1751
4481,2004-2005,2004-11-27,2005-03-20,114,12,37,265,302,64,413,477,779,26,135,Idaho,Priest River,1751
4482,2005-2006,2005-11-06,2006-03-22,137,7,49,291,340,65,435,500,840,33,130,Idaho,Priest River,1751
4483,2006-2007,2006-11-23,2007-03-18,116,4,58,262,320,112,831,943,1263,41,222,Idaho,Priest River,1751
4484,2007-2008,2007-11-21,2008-04-17,149,3,66,342,408,193,1402,1595,2003,56,347,Idaho,Priest River,1751
4485,2008-2009,2008-11-06,2009-04-13,159,4,73,378,451,147,1064,1211,1662,42,308,Idaho,Priest River,1751
4486,2010-2011,2010-11-19,2011-04-02,135,3,64,365,429,130,1002,1132,1561,46,280,Idaho,Priest River,1751
4487,2011-2012,2011-11-14,2012-04-09,148,0,42,276,318,115,918,1033,1351,40,205,Idaho,Priest River,1751
4488,2012-2013,2012-11-09,2013-03-27,139,0,29,234,263,103,833,936,1199,41,172,Idaho,Priest River,1751
4489,2013-2014,2013-11-16,2014-03-22,127,0,62,313,375,85,582,667,1042,40,188,Idaho,Priest River,1751
4490,2014-2015,2014-11-12,2015-04-06,146,3,32,245,277,50,275,325,602,21,86,Idaho,Priest River,1751
4491,2015-2016,2015-11-24,2016-03-02,100,0,26,151,177,77,497,574,751,32,123,Idaho,Priest River,1751
4492,2016-2017,2016-11-19,2017-03-28,130,0,73,323,396,88,855,943,1339,43,210,Idaho,Priest River,1751
4493,2017-2018,2017-11-02,2018-04-03,153,0,47,277,324,145,910,1055,1379,49,248,Idaho,Priest River,1751
4494,2018-2019,2018-11-09,2019-04-01,144,0,59,321,380,122,862,984,1364,42,249,Idaho,Priest River,1751
4495,2019-2020,2019-11-12,2020-03-31,141,7,37,237,274,97,768,865,1139,33,176,Idaho,Priest River,1751
4496,1950-1951,1950-11-09,1951-03-23,135,2,60,392,452,69,407,476,928,21,138,Idaho,Richfield,482
4497,1951-1952,1951-11-26,1952-04-05,132,4,126,539,665,123,988,1111,1776,32,245,Idaho,Richfield,482
4498,1952-1953,1952-11-17,1953-03-05,109,3,31,266,297,47,219,266,563,15,87,Idaho,Richfield,482
4499,1953-1954,1953-12-01,1954-03-11,101,2,21,249,270,27,79,106,376,6,40,Idaho,Richfield,482
4500,1954-1955,1954-12-01,1955-03-21,111,0,92,459,551,35,369,404,955,16,92,Idaho,Richfield,482
4501,1955-1956,1955-11-12,1956-03-18,128,4,87,398,485,102,358,460,945,30,199,Idaho,Richfield,482
4502,1956-1957,1956-11-03,1957-02-28,118,1,62,408,470,34,234,268,738,12,76,Idaho,Richfield,482
4503,1957-1958,1957-11-19,1958-03-07,109,1,28,291,319,40,252,292,611,13,78,Idaho,Richfield,482
4504,1958-1959,1958-11-16,1959-02-28,105,1,24,239,263,34,104,138,401,9,54,Idaho,Richfield,482
4505,1959-1960,1959-12-01,1960-04-22,144,3,77,434,511,41,284,325,836,15,85,Idaho,Richfield,482
4506,1960-1961,1960-11-28,1961-03-07,100,0,17,261,278,18,29,47,325,4,24,Idaho,Richfield,482
4507,1961-1962,1961-11-21,1962-03-18,118,2,88,418,506,54,313,367,873,13,114,Idaho,Richfield,482
4508,1962-1963,1962-11-18,1963-02-28,103,1,43,267,310,11,17,28,338,4,23,Idaho,Richfield,482
4509,1963-1964,1963-11-22,1964-04-03,134,1,115,583,698,87,965,1052,1750,27,204,Idaho,Richfield,482
4510,1964-1965,1964-11-12,1965-03-18,127,0,40,324,364,44,147,191,555,17,98,Idaho,Richfield,482
4511,1965-1966,1965-11-27,1966-03-21,115,3,45,343,388,25,213,238,626,12,56,Idaho,Richfield,482
4512,1966-1967,1966-12-01,1967-02-28,90,1,28,217,245,14,40,54,299,7,43,Idaho,Richfield,482
4513,1967-1968,1967-11-27,1968-02-29,95,0,75,368,443,50,506,556,999,12,96,Idaho,Richfield,482
4514,1968-1969,1968-11-15,1969-04-02,139,0,76,455,531,99,797,896,1427,28,212,Idaho,Richfield,482
4515,1969-1970,1969-12-01,1970-03-29,119,0,42,271,313,30,141,171,484,11,60,Idaho,Richfield,482
4516,1970-1971,1970-12-01,1971-03-19,109,0,58,333,391,37,183,220,611,14,78,Idaho,Richfield,482
4517,1971-1972,1971-10-29,1972-03-04,128,0,83,411,494,66,568,634,1128,21,132,Idaho,Richfield,482
4518,1972-1973,1972-11-22,1973-03-04,103,0,99,370,469,37,298,335,804,17,96,Idaho,Richfield,482
4519,1973-1974,1973-11-05,1974-03-18,134,1,65,383,448,72,504,576,1024,23,135,Idaho,Richfield,482
4520,1974-1975,1974-12-01,1975-05-20,171,1,69,418,487,70,442,512,999,24,147,Idaho,Richfield,482
4521,1975-1976,1975-11-18,1976-03-30,134,0,54,427,481,67,531,598,1079,19,127,Idaho,Richfield,482
4522,1976-1977,1976-11-27,1977-03-30,124,1,41,422,463,12,114,126,589,4,21,Idaho,Richfield,482
4523,1977-1978,1977-11-19,1978-05-05,168,15,27,322,349,78,419,497,846,14,113,Idaho,Richfield,482
4524,1978-1979,1978-11-10,1979-03-13,124,1,114,466,580,38,351,389,969,16,109,Idaho,Richfield,482
4525,1979-1980,1979-11-23,1980-02-29,99,3,46,284,330,48,314,362,692,10,70,Idaho,Richfield,482
4526,1980-1981,1980-11-24,1981-02-28,97,4,17,234,251,22,112,134,385,3,26,Idaho,Richfield,482
4527,1982-1983,1982-11-21,1983-05-11,172,8,36,336,372,37,309,346,718,13,65,Idaho,Richfield,482
4528,1983-1984,1983-11-22,1984-03-31,131,8,118,516,634,73,924,997,1631,21,161,Idaho,Richfield,482
4529,1985-1986,1985-11-09,1986-03-16,128,16,120,456,576,76,714,790,1366,27,194,Idaho,Richfield,482
4530,1988-1989,1988-11-10,1989-03-06,117,4,132,499,631,61,553,614,1245,15,120,Idaho,Richfield,482
4531,1989-1990,1989-11-17,1990-03-11,115,2,41,323,364,28,106,134,498,11,61,Idaho,Richfield,482
4532,1997-1998,1997-12-01,1998-03-29,119,14,31,268,299,24,63,87,386,8,40,Idaho,Richfield,482
4533,1998-1999,1998-12-01,1999-03-20,110,16,61,361,422,64,379,443,865,16,115,Idaho,Richfield,482
4534,2002-2003,2002-10-31,2003-02-28,121,17,19,255,274,23,98,121,395,6,36,Idaho,Richfield,482
4535,2008-2009,2008-10-11,2009-04-02,174,10,86,537,623,68,637,705,1328,14,143,Idaho,Richfield,482
4536,2009-2010,2009-10-05,2010-04-05,183,12,72,495,567,62,481,543,1110,20,132,Idaho,Richfield,482
4537,2012-2013,2012-11-14,2013-03-08,115,0,83,373,456,28,213,241,697,11,73,Idaho,Richfield,482
4538,2013-2014,2013-12-01,2014-02-28,90,0,56,288,344,31,64,95,439,9,71,Idaho,Richfield,482
4539,2014-2015,2014-11-12,2015-02-28,109,1,51,265,316,32,165,197,513,7,54,Idaho,Richfield,482
4540,2015-2016,2015-11-27,2016-02-29,95,9,82,353,435,45,451,496,931,12,84,Idaho,Richfield,482
4541,2016-2017,2016-12-01,2017-03-21,111,4,112,418,530,104,754,858,1388,25,223,Idaho,Richfield,482
4542,2017-2018,2017-12-01,2018-03-18,108,15,31,291,322,25,97,122,444,7,59,Idaho,Richfield,482
4543,2018-2019,2018-11-28,2019-03-15,108,2,42,327,369,42,207,249,618,12,85,Idaho,Richfield,482
4544,2019-2020,2019-10-29,2020-02-29,124,0,38,348,386,52,253,305,691,17,108,Idaho,Richfield,482
4545,1950-1951,1950-11-10,1951-04-01,143,0,124,480,604,65,359,424,1028,41,298,Illinois,Aurora,197899
4546,1951-1952,1951-11-02,1952-04-04,155,4,71,422,493,90,310,400,893,29,202,Illinois,Aurora,197899
4547,1952-1953,1952-11-27,1953-04-19,144,1,35,295,330,45,66,111,441,23,142,Illinois,Aurora,197899
4548,1953-1954,1953-11-25,1954-04-04,131,0,44,330,374,50,80,130,504,27,127,Illinois,Aurora,197899
4549,1954-1955,1954-11-01,1955-03-27,147,4,60,357,417,52,128,180,597,31,179,Illinois,Aurora,197899
4550,1955-1956,1955-11-02,1956-03-17,137,0,55,347,402,40,35,75,477,29,119,Illinois,Aurora,197899
4551,1956-1957,1956-11-22,1957-04-11,141,0,71,346,417,55,127,182,599,36,203,Illinois,Aurora,197899
4552,1957-1958,1957-11-22,1958-03-21,120,0,89,353,442,43,257,300,742,24,103,Illinois,Aurora,197899
4553,1958-1959,1958-11-27,1959-04-20,145,0,128,458,586,77,276,353,939,38,269,Illinois,Aurora,197899
4554,1959-1960,1959-10-26,1960-05-09,197,0,88,426,514,69,229,298,812,33,184,Illinois,Aurora,197899
4555,1961-1962,1961-11-19,1962-03-17,119,3,118,429,547,57,454,511,1058,34,206,Illinois,Aurora,197899
4556,1962-1963,1962-10-25,1963-03-13,140,1,160,497,657,46,188,234,891,30,236,Illinois,Aurora,197899
4557,1963-1964,1963-12-01,1964-03-30,121,3,87,382,469,29,168,197,666,13,76,Illinois,Aurora,197899
4558,1964-1965,1964-11-19,1965-03-29,131,0,110,423,533,79,196,275,808,32,231,Illinois,Aurora,197899
4559,1965-1966,1965-11-28,1966-04-05,129,0,96,352,448,29,106,135,583,21,108,Illinois,Aurora,197899
4560,1966-1967,1966-12-01,1967-04-23,144,4,86,356,442,76,320,396,838,30,210,Illinois,Aurora,197899
4561,1967-1968,1967-10-26,1968-03-21,148,1,82,384,466,36,75,111,577,25,122,Illinois,Aurora,197899
4562,1968-1969,1968-11-19,1969-03-31,133,0,86,348,434,25,113,138,572,17,90,Illinois,Aurora,197899
4563,1969-1970,1969-11-13,1970-04-02,141,0,123,421,544,77,249,326,870,36,235,Illinois,Aurora,197899
4564,1970-1971,1970-11-23,1971-04-03,132,2,98,360,458,40,130,170,628,24,120,Illinois,Aurora,197899
4565,1972-1973,1972-10-18,1973-04-12,177,1,56,318,374,38,92,130,504,24,109,Illinois,Aurora,197899
4566,1973-1974,1973-12-01,1974-03-30,120,0,68,279,347,65,250,315,662,27,172,Illinois,Aurora,197899
4567,1974-1975,1974-11-13,1975-04-03,142,17,33,278,311,65,151,216,527,35,145,Illinois,Aurora,197899
4568,1976-1977,1976-11-22,1977-03-22,121,9,171,533,704,37,185,222,926,22,179,Illinois,Aurora,197899
4569,1977-1978,1977-11-25,1978-03-28,124,3,152,514,666,67,390,457,1123,30,254,Illinois,Aurora,197899
4570,1978-1979,1978-11-20,1979-03-25,126,5,161,521,682,88,769,857,1539,29,250,Illinois,Aurora,197899
4571,1981-1982,1981-11-20,1982-04-09,141,18,126,514,640,62,298,360,1000,31,284,Illinois,Aurora,197899
4572,1982-1983,1982-11-04,1983-03-25,142,9,32,241,273,9,43,52,325,6,30,Illinois,Aurora,197899
4573,1983-1984,1983-11-24,1984-03-22,120,0,144,437,581,55,317,372,953,32,235,Illinois,Aurora,197899
4574,1985-1986,1985-11-20,1986-03-20,121,5,107,429,536,39,133,172,708,22,160,Illinois,Aurora,197899
4575,1987-1988,1987-12-01,1988-03-18,109,1,84,336,420,53,210,263,683,18,136,Illinois,Aurora,197899
4576,1988-1989,1988-11-06,1989-03-18,133,3,62,357,419,52,162,214,633,21,145,Illinois,Aurora,197899
4577,1989-1990,1989-11-18,1990-03-19,122,4,68,321,389,40,138,178,567,15,121,Illinois,Aurora,197899
4578,1990-1991,1990-12-01,1991-03-14,104,8,65,338,403,32,110,142,545,13,94,Illinois,Aurora,197899
4579,1991-1992,1991-11-02,1992-03-22,142,16,36,257,293,23,41,64,357,9,59,Illinois,Aurora,197899
4580,1993-1994,1993-11-06,1994-03-05,120,9,120,427,547,50,162,212,759,22,194,Illinois,Aurora,197899
4581,1994-1995,1994-12-01,1995-03-09,99,9,63,331,394,23,90,113,507,8,60,Illinois,Aurora,197899
4582,1996-1997,1996-11-10,1997-03-15,126,18,92,367,459,61,117,178,637,21,175,Illinois,Aurora,197899
4583,1997-1998,1997-10-27,1998-03-16,141,4,31,248,279,46,180,226,505,19,91,Illinois,Aurora,197899
4584,1998-1999,1998-12-01,1999-03-16,106,7,53,310,363,58,186,244,607,17,166,Illinois,Aurora,197899
4585,1999-2000,1999-12-01,2000-04-08,130,6,48,292,340,40,144,184,524,11,89,Illinois,Aurora,197899
4586,2000-2001,2000-11-20,2001-03-25,126,9,88,479,567,60,300,360,927,21,182,Illinois,Aurora,197899
4587,2001-2002,2001-12-01,2002-03-26,116,4,28,192,220,39,99,138,358,12,69,Illinois,Aurora,197899
4588,2003-2004,2003-11-28,2004-03-17,111,7,76,260,336,27,117,144,480,14,84,Illinois,Aurora,197899
4589,2004-2005,2004-11-25,2005-03-17,113,2,66,239,305,41,79,120,425,14,93,Illinois,Aurora,197899
4590,2005-2006,2005-11-17,2006-03-25,129,1,57,261,318,27,85,112,430,13,72,Illinois,Aurora,197899
4591,2006-2007,2006-12-01,2007-04-11,132,2,102,299,401,41,142,183,584,16,114,Illinois,Aurora,197899
4592,2007-2008,2007-12-01,2008-03-22,113,3,92,328,420,68,191,259,679,19,141,Illinois,Aurora,197899
4593,2008-2009,2008-11-21,2009-04-06,137,8,125,406,531,85,298,383,914,26,235,Illinois,Aurora,197899
4594,2009-2010,2009-12-01,2010-02-28,90,2,85,271,356,61,228,289,645,19,134,Illinois,Aurora,197899
4595,2010-2011,2010-12-01,2011-03-06,96,14,109,315,424,64,231,295,719,21,147,Illinois,Aurora,197899
4596,2011-2012,2011-12-01,2012-03-05,96,0,31,175,206,33,36,69,275,10,66,Illinois,Aurora,197899
4597,2012-2013,2012-11-25,2013-03-21,117,2,64,274,338,32,56,88,426,12,69,Illinois,Aurora,197899
4598,2013-2014,2013-11-12,2014-04-15,155,5,197,572,769,110,429,539,1308,37,315,Illinois,Aurora,197899
4599,2014-2015,2014-11-13,2015-03-24,132,3,136,421,557,56,214,270,827,16,145,Illinois,Aurora,197899
4600,2015-2016,2015-11-21,2016-03-05,106,4,56,210,266,35,33,68,334,18,105,Illinois,Aurora,197899
4601,2016-2017,2016-12-01,2017-03-16,106,0,67,237,304,28,86,114,418,9,61,Illinois,Aurora,197899
4602,2017-2018,2017-12-01,2018-04-19,140,0,111,361,472,57,148,205,677,19,163,Illinois,Aurora,197899
4603,2019-2020,2019-10-30,2020-04-18,172,3,50,279,329,51,56,107,436,23,100,Illinois,Aurora,197899
4604,1950-1951,1950-11-10,1951-04-12,154,2,93,354,447,62,163,225,672,33,207,Illinois,Bloomington,76610
4605,1951-1952,1951-11-03,1952-03-06,125,13,51,262,313,44,114,158,471,15,90,Illinois,Bloomington,76610
4606,1952-1953,1952-11-27,1953-04-17,142,10,21,191,212,23,37,60,272,12,66,Illinois,Bloomington,76610
4607,1953-1954,1953-11-27,1954-03-14,108,0,29,205,234,22,36,58,292,9,39,Illinois,Bloomington,76610
4608,1954-1955,1954-11-01,1955-03-28,148,13,33,260,293,39,96,135,428,19,106,Illinois,Bloomington,76610
4609,1955-1956,1955-11-03,1956-03-16,135,8,36,287,323,44,25,69,392,22,120,Illinois,Bloomington,76610
4610,1956-1957,1956-11-21,1957-04-12,143,5,42,290,332,52,120,172,504,25,161,Illinois,Bloomington,76610
4611,1957-1958,1957-11-21,1958-03-11,111,1,55,238,293,26,53,79,372,16,65,Illinois,Bloomington,76610
4612,1959-1960,1959-11-12,1960-03-26,136,0,67,312,379,78,226,304,683,24,157,Illinois,Bloomington,76610
4613,1960-1961,1960-11-09,1961-04-17,160,0,56,265,321,36,89,125,446,17,101,Illinois,Bloomington,76610
4614,1961-1962,1961-11-19,1962-04-13,146,0,86,330,416,70,188,258,674,33,190,Illinois,Bloomington,76610
4615,1962-1963,1962-12-01,1963-03-06,96,0,120,358,478,46,128,174,652,28,221,Illinois,Bloomington,76610
4616,1963-1964,1963-11-30,1964-03-29,121,10,74,299,373,62,92,154,527,27,138,Illinois,Bloomington,76610
4617,1964-1965,1964-11-19,1965-03-27,129,6,82,320,402,56,118,174,576,23,144,Illinois,Bloomington,76610
4618,1965-1966,1965-11-29,1966-03-24,116,3,55,231,286,14,6,20,306,8,38,Illinois,Bloomington,76610
4619,1966-1967,1966-12-01,1967-04-24,145,4,48,263,311,31,95,126,437,16,79,Illinois,Bloomington,76610
4620,1967-1968,1967-10-27,1968-03-22,148,8,63,337,400,38,69,107,507,23,121,Illinois,Bloomington,76610
4621,1968-1969,1968-11-11,1969-03-31,141,0,61,324,385,27,64,91,476,15,70,Illinois,Bloomington,76610
4622,1969-1970,1969-11-14,1970-04-02,140,2,88,371,459,52,132,184,643,30,158,Illinois,Bloomington,76610
4623,1970-1971,1970-11-23,1971-03-20,118,1,68,289,357,17,8,25,382,6,37,Illinois,Bloomington,76610
4624,1971-1972,1971-11-09,1972-04-02,146,1,59,292,351,36,80,116,467,19,117,Illinois,Bloomington,76610
4625,1972-1973,1972-11-19,1973-04-10,143,2,56,241,297,27,45,72,369,18,74,Illinois,Bloomington,76610
4626,1973-1974,1973-12-01,1974-04-05,126,1,69,267,336,50,137,187,523,24,140,Illinois,Bloomington,76610
4627,1974-1975,1974-11-13,1975-04-03,142,0,42,258,300,48,54,102,402,24,119,Illinois,Bloomington,76610
4628,1975-1976,1975-11-21,1976-02-29,101,1,47,223,270,36,55,91,361,19,92,Illinois,Bloomington,76610
4629,1976-1977,1976-11-22,1977-04-06,136,1,127,435,562,45,198,243,805,25,193,Illinois,Bloomington,76610
4630,1977-1978,1977-11-25,1978-03-27,123,1,136,475,611,66,333,399,1010,34,223,Illinois,Bloomington,76610
4631,1978-1979,1978-11-21,1979-03-25,125,0,128,419,547,51,415,466,1013,21,170,Illinois,Bloomington,76610
4632,1979-1980,1979-11-26,1980-04-15,142,0,62,289,351,30,45,75,426,20,105,Illinois,Bloomington,76610
4633,1980-1981,1980-11-27,1981-03-19,113,0,55,280,335,36,109,145,480,13,79,Illinois,Bloomington,76610
4634,1981-1982,1981-11-21,1982-04-10,141,2,105,394,499,71,293,364,863,29,217,Illinois,Bloomington,76610
4635,1982-1983,1982-11-04,1983-03-25,142,10,29,195,224,23,46,69,293,13,57,Illinois,Bloomington,76610
4636,1983-1984,1983-11-13,1984-03-18,127,0,113,348,461,50,202,252,713,26,161,Illinois,Bloomington,76610
4637,1984-1985,1984-12-01,1985-02-28,90,2,67,282,349,25,130,155,504,17,97,Illinois,Bloomington,76610
4638,1985-1986,1985-12-01,1986-03-03,93,5,65,282,347,30,103,133,480,13,81,Illinois,Bloomington,76610
4639,1986-1987,1986-11-12,1987-02-28,109,2,29,197,226,27,94,121,347,8,52,Illinois,Bloomington,76610
4640,1987-1988,1987-12-01,1988-03-18,109,2,60,284,344,21,59,80,424,9,57,Illinois,Bloomington,76610
4641,1988-1989,1988-11-28,1989-04-08,132,15,60,299,359,29,96,125,484,13,79,Illinois,Bloomington,76610
4642,1989-1990,1989-10-20,1990-02-28,132,2,60,286,346,20,74,94,440,11,91,Illinois,Bloomington,76610
4643,1990-1991,1990-12-01,1991-03-14,104,2,71,291,362,22,52,74,436,14,115,Illinois,Bloomington,76610
4644,1991-1992,1991-11-02,1992-03-15,135,5,32,271,303,22,48,70,373,13,86,Illinois,Bloomington,76610
4645,1992-1993,1992-11-27,1993-03-19,113,11,56,347,403,38,113,151,554,16,103,Illinois,Bloomington,76610
4646,1993-1994,1993-11-27,1994-04-06,131,11,98,413,511,33,110,143,654,15,140,Illinois,Bloomington,76610
4647,1994-1995,1994-12-01,1995-03-09,99,14,61,277,338,12,14,26,364,9,69,Illinois,Bloomington,76610
4648,1996-1997,1996-11-11,1997-04-11,152,13,95,331,426,38,99,137,563,14,100,Illinois,Bloomington,76610
4649,1997-1998,1997-11-03,1998-03-21,139,15,38,182,220,30,76,106,326,19,66,Illinois,Bloomington,76610
4650,1998-1999,1998-11-08,1999-03-14,127,6,53,269,322,50,197,247,569,17,131,Illinois,Bloomington,76610
4651,2000-2001,2000-11-20,2001-03-25,126,1,86,377,463,40,230,270,733,16,123,Illinois,Bloomington,76610
4652,2001-2002,2001-12-01,2002-03-26,116,13,31,210,241,18,29,47,288,9,38,Illinois,Bloomington,76610
4653,2006-2007,2006-12-01,2007-03-08,98,15,70,265,335,37,146,183,518,8,79,Illinois,Bloomington,76610
4654,2007-2008,2007-12-01,2008-03-09,100,12,77,304,381,54,86,140,521,20,148,Illinois,Bloomington,76610
4655,2008-2009,2008-11-21,2009-04-06,137,0,99,419,518,40,119,159,677,22,156,Illinois,Bloomington,76610
4656,2009-2010,2009-12-01,2010-02-28,90,2,87,302,389,37,165,202,591,16,106,Illinois,Bloomington,76610
4657,2010-2011,2010-12-01,2011-03-06,96,4,87,366,453,63,203,266,719,19,163,Illinois,Bloomington,76610
4658,2011-2012,2011-12-01,2012-03-05,96,1,17,182,199,10,15,25,224,5,27,Illinois,Bloomington,76610
4659,2012-2013,2012-12-01,2013-03-27,117,4,43,269,312,31,61,92,404,10,62,Illinois,Bloomington,76610
4660,2013-2014,2013-11-12,2014-04-15,155,3,141,543,684,76,220,296,980,24,205,Illinois,Bloomington,76610
4661,2014-2015,2014-11-13,2015-03-07,115,1,95,385,480,38,101,139,619,15,113,Illinois,Bloomington,76610
4662,2015-2016,2015-11-22,2016-02-29,100,0,40,209,249,24,39,63,312,10,75,Illinois,Bloomington,76610
4663,2016-2017,2016-12-01,2017-03-16,106,0,50,222,272,20,14,34,306,11,68,Illinois,Bloomington,76610
4664,2017-2018,2017-11-19,2018-04-16,149,0,93,397,490,51,123,174,664,19,142,Illinois,Bloomington,76610
4665,2018-2019,2018-11-09,2019-04-15,158,2,66,391,457,53,131,184,641,25,155,Illinois,Bloomington,76610
4666,2019-2020,2019-10-31,2020-04-15,168,6,36,264,300,39,45,84,384,20,84,Illinois,Bloomington,76610
4667,1950-1951,1950-11-10,1951-04-12,154,3,84,337,421,67,182,249,670,37,209,Illinois,Champaign,81055
4668,1951-1952,1951-11-03,1952-03-05,124,1,50,229,279,44,103,147,426,17,103,Illinois,Champaign,81055
4669,1952-1953,1952-11-27,1953-04-17,142,0,22,159,181,23,24,47,228,17,75,Illinois,Champaign,81055
4670,1953-1954,1953-11-26,1954-03-14,109,0,25,185,210,11,4,15,225,8,27,Illinois,Champaign,81055
4671,1954-1955,1954-11-01,1955-03-26,146,0,40,221,261,28,34,62,323,19,91,Illinois,Champaign,81055
4672,1955-1956,1955-11-03,1956-04-07,157,0,40,280,320,49,62,111,431,24,109,Illinois,Champaign,81055
4673,1956-1957,1956-11-22,1957-04-08,138,0,52,228,280,25,20,45,325,16,76,Illinois,Champaign,81055
4674,1957-1958,1957-11-29,1958-03-20,112,0,63,238,301,21,10,31,332,18,58,Illinois,Champaign,81055
4675,1958-1959,1958-11-26,1959-03-16,111,0,84,320,404,36,64,100,504,19,107,Illinois,Champaign,81055
4676,1959-1960,1959-11-06,1960-03-26,142,0,77,311,388,71,194,265,653,38,194,Illinois,Champaign,81055
4677,1960-1961,1960-11-09,1961-04-17,160,0,69,284,353,44,145,189,542,22,124,Illinois,Champaign,81055
4678,1961-1962,1961-11-19,1962-04-12,145,0,72,296,368,74,119,193,561,38,192,Illinois,Champaign,81055
4679,1962-1963,1962-12-01,1963-03-05,95,0,121,366,487,49,145,194,681,28,213,Illinois,Champaign,81055
4680,1963-1964,1963-11-30,1964-04-08,131,0,69,299,368,69,128,197,565,30,147,Illinois,Champaign,81055
4681,1964-1965,1964-11-21,1965-03-26,126,6,77,305,382,46,96,142,524,25,154,Illinois,Champaign,81055
4682,1965-1966,1965-11-28,1966-04-05,129,0,69,253,322,24,18,42,364,14,68,Illinois,Champaign,81055
4683,1966-1967,1966-11-02,1967-04-23,173,0,58,276,334,32,19,51,385,23,96,Illinois,Champaign,81055
4684,1967-1968,1967-11-03,1968-03-23,142,1,69,309,378,55,126,181,559,30,156,Illinois,Champaign,81055
4685,1968-1969,1968-11-18,1969-03-30,133,0,64,265,329,30,86,116,445,14,73,Illinois,Champaign,81055
4686,1969-1970,1969-11-14,1970-04-02,140,1,92,325,417,43,149,192,609,26,142,Illinois,Champaign,81055
4687,1970-1971,1970-11-23,1971-04-04,133,0,66,280,346,19,8,27,373,12,60,Illinois,Champaign,81055
4688,1971-1972,1971-11-09,1972-04-01,145,2,59,259,318,27,60,87,405,14,65,Illinois,Champaign,81055
4689,1972-1973,1972-11-19,1973-04-09,142,0,53,212,265,19,8,27,292,16,58,Illinois,Champaign,81055
4690,1973-1974,1973-11-08,1974-03-25,138,2,60,242,302,56,143,199,501,21,122,Illinois,Champaign,81055
4691,1974-1975,1974-11-13,1975-04-02,141,2,39,213,252,56,63,119,371,29,130,Illinois,Champaign,81055
4692,1975-1976,1975-11-21,1976-03-17,118,5,54,217,271,39,57,96,367,18,82,Illinois,Champaign,81055
4693,1976-1977,1976-11-22,1977-04-06,136,0,134,404,538,51,227,278,816,27,205,Illinois,Champaign,81055
4694,1977-1978,1977-11-26,1978-03-27,122,3,142,415,557,98,415,513,1070,34,251,Illinois,Champaign,81055
4695,1978-1979,1978-11-26,1979-04-04,130,0,136,394,530,61,387,448,978,25,210,Illinois,Champaign,81055
4696,1979-1980,1979-11-28,1980-03-17,111,2,62,261,323,28,60,88,411,19,94,Illinois,Champaign,81055
4697,1980-1981,1980-11-27,1981-03-18,112,0,62,257,319,45,107,152,471,15,107,Illinois,Champaign,81055
4698,1981-1982,1981-11-21,1982-04-09,140,6,116,380,496,77,337,414,910,27,218,Illinois,Champaign,81055
4699,1982-1983,1982-11-04,1983-03-27,144,3,32,187,219,30,28,58,277,17,59,Illinois,Champaign,81055
4700,1983-1984,1983-11-13,1984-03-21,130,4,125,345,470,71,325,396,866,30,211,Illinois,Champaign,81055
4701,1984-1985,1984-11-18,1985-03-05,108,10,80,276,356,30,129,159,515,18,101,Illinois,Champaign,81055
4702,1985-1986,1985-11-20,1986-04-15,147,3,80,343,423,31,80,111,534,16,101,Illinois,Champaign,81055
4703,1991-1992,1991-11-02,1992-04-01,152,3,31,214,245,26,21,47,292,20,83,Illinois,Champaign,81055
4704,1992-1993,1992-11-05,1993-04-01,148,3,59,263,322,53,126,179,501,23,110,Illinois,Champaign,81055
4705,1993-1994,1993-10-30,1994-04-07,160,0,103,347,450,39,93,132,582,24,148,Illinois,Champaign,81055
4706,1994-1995,1994-12-01,1995-03-08,98,2,53,207,260,14,39,53,313,9,45,Illinois,Champaign,81055
4707,1995-1996,1995-11-04,1996-03-20,138,0,97,373,470,38,137,175,645,17,114,Illinois,Champaign,81055
4708,1996-1997,1996-11-02,1997-03-15,134,0,84,278,362,40,121,161,523,14,104,Illinois,Champaign,81055
4709,1997-1998,1997-11-03,1998-03-21,139,0,28,169,197,26,30,56,253,17,58,Illinois,Champaign,81055
4710,1998-1999,1998-12-01,1999-03-12,102,1,49,206,255,48,174,222,477,15,114,Illinois,Champaign,81055
4711,1999-2000,1999-12-01,2000-03-11,102,4,42,208,250,31,107,138,388,15,95,Illinois,Champaign,81055
4712,2000-2001,2000-11-17,2001-03-25,129,14,87,341,428,41,185,226,654,25,167,Illinois,Champaign,81055
4713,2001-2002,2001-12-01,2002-03-28,118,0,27,200,227,24,24,48,275,12,62,Illinois,Champaign,81055
4714,2002-2003,2002-11-24,2003-03-10,107,0,68,307,375,43,84,127,502,22,124,Illinois,Champaign,81055
4715,2003-2004,2003-11-24,2004-03-17,115,0,57,237,294,28,79,107,401,19,92,Illinois,Champaign,81055
4716,2004-2005,2004-11-25,2005-03-11,107,2,45,198,243,25,42,67,310,17,84,Illinois,Champaign,81055
4717,2005-2006,2005-11-17,2006-03-22,126,0,45,219,264,29,55,84,348,18,92,Illinois,Champaign,81055
4718,2006-2007,2006-12-01,2007-03-06,96,1,71,234,305,38,126,164,469,14,112,Illinois,Champaign,81055
4719,2007-2008,2007-12-01,2008-03-08,99,5,63,260,323,43,66,109,432,21,138,Illinois,Champaign,81055
4720,2008-2009,2008-11-21,2009-04-06,137,2,87,337,424,37,84,121,545,22,133,Illinois,Champaign,81055
4721,2009-2010,2009-12-01,2010-02-28,90,0,84,270,354,38,166,204,558,17,115,Illinois,Champaign,81055
4722,2010-2011,2010-12-01,2011-03-06,96,0,91,284,375,61,241,302,677,25,175,Illinois,Champaign,81055
4723,2011-2012,2011-12-01,2012-03-05,96,0,18,151,169,20,19,39,208,13,68,Illinois,Champaign,81055
4724,2012-2013,2012-11-24,2013-03-28,125,0,42,237,279,33,48,81,360,11,65,Illinois,Champaign,81055
4725,2013-2014,2013-11-12,2014-04-15,155,4,122,454,576,70,182,252,828,34,248,Illinois,Champaign,81055
4726,2014-2015,2014-11-13,2015-03-08,116,0,97,351,448,40,130,170,618,15,133,Illinois,Champaign,81055
4727,2015-2016,2015-11-21,2016-02-29,101,0,40,171,211,21,36,57,268,13,83,Illinois,Champaign,81055
4728,2016-2017,2016-12-01,2017-03-15,105,0,41,187,228,14,19,33,261,10,68,Illinois,Champaign,81055
4729,2017-2018,2017-12-01,2018-04-16,137,0,93,314,407,29,93,122,529,15,117,Illinois,Champaign,81055
4730,2018-2019,2018-11-09,2019-03-08,120,0,66,272,338,30,68,98,436,18,108,Illinois,Champaign,81055
4731,2019-2020,2019-11-01,2020-03-15,136,0,31,221,252,26,41,67,319,17,69,Illinois,Champaign,81055
4732,1950-1951,1950-11-10,1951-04-01,143,0,118,399,517,82,191,273,790,37,265,Illinois,Chicago,2695598
4733,1951-1952,1951-11-02,1952-04-04,155,0,64,310,374,97,169,266,640,32,205,Illinois,Chicago,2695598
4734,1952-1953,1952-10-20,1953-03-09,141,0,34,200,234,34,36,70,304,17,92,Illinois,Chicago,2695598
4735,1953-1954,1953-11-05,1954-04-03,150,0,43,219,262,62,65,127,389,25,109,Illinois,Chicago,2695598
4736,1954-1955,1954-10-29,1955-03-27,150,0,59,245,304,56,76,132,436,34,166,Illinois,Chicago,2695598
4737,1955-1956,1955-11-02,1956-03-18,138,0,59,282,341,45,42,87,428,24,115,Illinois,Chicago,2695598
4738,1956-1957,1956-11-21,1957-04-12,143,1,65,277,342,56,95,151,493,33,163,Illinois,Chicago,2695598
4739,1957-1958,1957-10-26,1958-03-20,146,0,83,267,350,34,103,137,487,21,84,Illinois,Chicago,2695598
4740,1958-1959,1958-11-26,1959-04-08,134,0,122,378,500,61,164,225,725,29,203,Illinois,Chicago,2695598
4741,1959-1960,1959-11-06,1960-03-26,142,1,80,297,377,84,187,271,648,43,210,Illinois,Chicago,2695598
4742,1960-1961,1960-11-09,1961-04-17,160,0,79,270,349,63,81,144,493,26,154,Illinois,Chicago,2695598
4743,1961-1962,1961-11-19,1962-04-13,146,0,105,348,453,101,259,360,813,53,288,Illinois,Chicago,2695598
4744,1962-1963,1962-10-25,1963-03-12,139,0,153,406,559,69,157,226,785,40,283,Illinois,Chicago,2695598
4745,1963-1964,1963-12-01,1964-04-01,123,0,86,319,405,55,54,109,514,24,124,Illinois,Chicago,2695598
4746,1964-1965,1964-11-19,1965-03-28,130,0,99,339,438,83,160,243,681,34,218,Illinois,Chicago,2695598
4747,1965-1966,1965-11-28,1966-05-11,165,0,87,278,365,42,97,139,504,28,135,Illinois,Chicago,2695598
4748,1966-1967,1966-11-02,1967-04-24,174,0,72,289,361,102,316,418,779,36,211,Illinois,Chicago,2695598
4749,1967-1968,1967-10-26,1968-03-23,150,0,68,293,361,46,61,107,468,30,139,Illinois,Chicago,2695598
4750,1968-1969,1968-11-18,1969-03-31,134,0,77,285,362,44,84,128,490,25,111,Illinois,Chicago,2695598
4751,1969-1970,1969-11-13,1970-04-03,142,0,106,338,444,118,218,336,780,49,328,Illinois,Chicago,2695598
4752,1970-1971,1970-11-14,1971-04-03,141,0,90,327,417,61,68,129,546,32,148,Illinois,Chicago,2695598
4753,1971-1972,1971-11-08,1972-04-08,153,0,75,303,378,69,92,161,539,36,176,Illinois,Chicago,2695598
4754,1972-1973,1972-10-18,1973-04-12,177,0,60,251,311,53,73,126,437,34,139,Illinois,Chicago,2695598
4755,1973-1974,1973-12-01,1974-04-05,126,0,82,261,343,89,131,220,563,41,242,Illinois,Chicago,2695598
4756,1974-1975,1974-11-13,1975-04-09,148,0,54,268,322,89,92,181,503,48,218,Illinois,Chicago,2695598
4757,1975-1976,1975-11-12,1976-05-02,173,0,60,272,332,71,168,239,571,38,161,Illinois,Chicago,2695598
4758,1976-1977,1976-10-27,1977-04-05,161,0,163,468,631,87,222,309,940,47,349,Illinois,Chicago,2695598
4759,1977-1978,1977-11-13,1978-04-20,159,0,159,458,617,125,411,536,1153,47,377,Illinois,Chicago,2695598
4760,1978-1979,1978-11-20,1979-03-26,127,0,163,441,604,129,650,779,1383,45,339,Illinois,Chicago,2695598
4761,1979-1980,1979-11-27,1980-04-15,141,2,84,329,413,58,106,164,577,34,186,Illinois,Chicago,2695598
4762,1980-1981,1980-11-18,1981-03-19,122,0,86,327,413,57,67,124,537,30,166,Illinois,Chicago,2695598
4763,1981-1982,1981-11-20,1982-04-10,142,0,145,479,624,95,197,292,916,42,358,Illinois,Chicago,2695598
4764,1982-1983,1982-11-04,1983-04-16,164,0,50,254,304,44,41,85,389,28,118,Illinois,Chicago,2695598
4765,1983-1984,1983-11-24,1984-04-03,132,0,152,426,578,72,175,247,825,37,250,Illinois,Chicago,2695598
4766,1984-1985,1984-12-01,1985-03-05,95,0,118,360,478,60,264,324,802,26,194,Illinois,Chicago,2695598
4767,1985-1986,1985-11-20,1986-04-15,147,0,115,423,538,53,66,119,657,34,196,Illinois,Chicago,2695598
4768,1986-1987,1986-11-11,1987-03-15,125,0,41,215,256,40,55,95,351,20,85,Illinois,Chicago,2695598
4769,1987-1988,1987-10-20,1988-03-30,163,0,91,347,438,73,144,217,655,32,172,Illinois,Chicago,2695598
4770,1988-1989,1988-11-06,1989-05-06,182,0,75,323,398,45,71,116,514,30,168,Illinois,Chicago,2695598
4771,1989-1990,1989-10-18,1990-04-11,176,0,78,312,390,58,97,155,545,33,172,Illinois,Chicago,2695598
4772,1990-1991,1990-12-01,1991-03-31,121,0,68,277,345,40,74,114,459,21,113,Illinois,Chicago,2695598
4773,1991-1992,1991-11-02,1992-04-02,153,0,39,272,311,47,69,116,427,25,116,Illinois,Chicago,2695598
4774,1992-1993,1992-10-20,1993-04-02,165,0,63,303,366,66,134,200,566,32,145,Illinois,Chicago,2695598
4775,1993-1994,1993-11-06,1994-03-06,121,0,121,352,473,67,199,266,739,30,243,Illinois,Chicago,2695598
4776,1994-1995,1994-12-01,1995-04-12,133,0,62,249,311,35,82,117,428,15,68,Illinois,Chicago,2695598
4777,1999-2000,1999-12-01,2000-04-08,130,0,52,236,288,44,112,156,444,20,119,Illinois,Chicago,2695598
4778,2000-2001,2000-11-16,2001-04-16,152,0,106,394,500,66,324,390,890,27,176,Illinois,Chicago,2695598
4779,2001-2002,2001-12-01,2002-04-04,125,18,39,206,245,51,78,129,374,22,114,Illinois,Chicago,2695598
4780,2002-2003,2002-11-17,2003-04-08,143,0,93,352,445,44,52,96,541,21,124,Illinois,Chicago,2695598
4781,2003-2004,2003-11-24,2004-03-18,116,0,78,276,354,42,120,162,516,25,140,Illinois,Chicago,2695598
4782,2004-2005,2004-11-24,2005-03-25,122,0,63,250,313,64,119,183,496,27,146,Illinois,Chicago,2695598
4783,2005-2006,2005-11-16,2006-03-24,129,0,52,244,296,48,92,140,436,28,121,Illinois,Chicago,2695598
4784,2006-2007,2006-10-12,2007-04-12,183,0,94,294,388,53,118,171,559,23,126,Illinois,Chicago,2695598
4785,2007-2008,2007-11-21,2008-03-28,129,3,87,325,412,88,185,273,685,44,256,Illinois,Chicago,2695598
4786,2008-2009,2008-11-16,2009-04-06,142,0,117,398,515,83,228,311,826,40,265,Illinois,Chicago,2695598
4787,2009-2010,2009-12-01,2010-03-20,110,0,84,249,333,77,199,276,609,30,166,Illinois,Chicago,2695598
4788,2010-2011,2010-11-26,2011-04-18,144,3,101,330,431,82,241,323,754,32,204,Illinois,Chicago,2695598
4789,2011-2012,2011-12-01,2012-03-04,95,0,22,144,166,34,34,68,234,18,91,Illinois,Chicago,2695598
4790,2012-2013,2012-11-24,2013-04-19,147,0,50,263,313,53,73,126,439,29,137,Illinois,Chicago,2695598
4791,2013-2014,2013-11-11,2014-04-15,156,0,158,498,656,122,327,449,1105,51,392,Illinois,Chicago,2695598
4792,2014-2015,2014-10-31,2015-03-27,148,0,127,397,524,80,257,337,861,35,269,Illinois,Chicago,2695598
4793,2015-2016,2015-11-20,2016-04-08,141,0,54,214,268,49,52,101,369,24,130,Illinois,Chicago,2695598
4794,2016-2017,2016-12-01,2017-03-16,106,0,60,218,278,39,74,113,391,15,101,Illinois,Chicago,2695598
4795,2017-2018,2017-11-10,2018-04-19,161,0,91,320,411,57,96,153,564,31,195,Illinois,Chicago,2695598
4796,2018-2019,2018-11-09,2019-04-27,170,0,90,328,418,76,125,201,619,37,234,Illinois,Chicago,2695598
4797,2019-2020,2019-10-30,2020-04-17,171,0,34,210,244,55,62,117,361,29,110,Illinois,Chicago,2695598
4798,1950-1951,1950-11-10,1951-03-14,125,2,78,310,388,45,123,168,556,18,129,Illinois,Effingham,12328
4799,1952-1953,1952-11-27,1953-03-07,101,1,19,137,156,22,12,34,190,11,57,Illinois,Effingham,12328
4800,1953-1954,1953-12-01,1954-03-05,95,9,17,144,161,1,0,1,162,1,4,Illinois,Effingham,12328
4801,1957-1958,1957-12-01,1958-03-10,100,0,44,216,260,18,25,43,303,8,46,Illinois,Effingham,12328
4802,1958-1959,1958-11-27,1959-03-10,104,0,49,280,329,10,19,29,358,4,29,Illinois,Effingham,12328
4803,1959-1960,1959-11-17,1960-03-25,130,2,40,241,281,48,89,137,418,19,98,Illinois,Effingham,12328
4804,1960-1961,1960-12-01,1961-04-15,136,0,37,212,249,35,71,106,355,16,92,Illinois,Effingham,12328
4805,1961-1962,1961-11-19,1962-03-16,118,0,41,230,271,47,77,124,395,23,120,Illinois,Effingham,12328
4806,1962-1963,1962-12-01,1963-03-01,91,0,70,286,356,25,27,52,408,20,111,Illinois,Effingham,12328
4807,1963-1964,1963-12-01,1964-03-27,118,0,50,268,318,46,102,148,466,15,81,Illinois,Effingham,12328
4808,1964-1965,1964-11-21,1965-03-27,127,3,46,269,315,51,92,143,458,14,115,Illinois,Effingham,12328
4809,1965-1966,1965-11-29,1966-03-06,98,0,38,201,239,13,32,45,284,5,32,Illinois,Effingham,12328
4810,1966-1967,1966-12-01,1967-03-08,98,3,30,205,235,14,8,22,257,7,34,Illinois,Effingham,12328
4811,1967-1968,1967-11-23,1968-03-22,121,2,49,266,315,36,126,162,477,12,79,Illinois,Effingham,12328
4812,1968-1969,1968-12-01,1969-03-11,101,2,26,203,229,6,9,15,244,3,12,Illinois,Effingham,12328
4813,1969-1970,1969-11-19,1970-03-18,120,1,65,288,353,58,197,255,608,17,120,Illinois,Effingham,12328
4814,1970-1971,1970-11-23,1971-02-28,98,1,31,225,256,13,27,40,296,6,38,Illinois,Effingham,12328
4815,1971-1972,1971-12-01,1972-02-29,91,4,27,185,212,12,14,26,238,5,48,Illinois,Effingham,12328
4816,1972-1973,1972-11-23,1973-04-10,139,2,28,190,218,15,14,29,247,5,28,Illinois,Effingham,12328
4817,1973-1974,1973-12-01,1974-03-25,115,0,43,208,251,56,145,201,452,12,120,Illinois,Effingham,12328
4818,1976-1977,1976-11-29,1977-03-22,114,0,123,420,543,45,211,256,799,18,142,Illinois,Effingham,12328
4819,1977-1978,1977-11-27,1978-03-26,120,0,123,447,570,65,362,427,997,27,194,Illinois,Effingham,12328
4820,1978-1979,1978-12-01,1979-03-26,116,0,115,392,507,50,293,343,850,23,204,Illinois,Effingham,12328
4821,1979-1980,1979-11-29,1980-04-15,139,0,56,298,354,41,122,163,517,14,102,Illinois,Effingham,12328
4822,1980-1981,1980-11-18,1981-02-28,103,0,59,285,344,34,53,87,431,12,84,Illinois,Effingham,12328
4823,1981-1982,1981-11-22,1982-04-09,139,6,93,358,451,51,182,233,684,18,135,Illinois,Effingham,12328
4824,1982-1983,1982-11-14,1983-03-24,131,6,25,165,190,15,7,22,212,12,42,Illinois,Effingham,12328
4825,1983-1984,1983-12-01,1984-03-14,105,3,105,309,414,45,139,184,598,26,163,Illinois,Effingham,12328
4826,1990-1991,1990-12-01,1991-03-04,94,3,43,180,223,23,100,123,346,6,52,Illinois,Effingham,12328
4827,1991-1992,1991-11-03,1992-03-31,150,12,22,191,213,24,30,54,267,6,43,Illinois,Effingham,12328
4828,1992-1993,1992-11-15,1993-03-18,124,7,47,232,279,56,70,126,405,13,100,Illinois,Effingham,12328
4829,1993-1994,1993-10-31,1994-04-07,159,5,68,283,351,18,47,65,416,11,56,Illinois,Effingham,12328
4830,1994-1995,1994-12-01,1995-03-09,99,2,43,199,242,19,42,61,303,7,43,Illinois,Effingham,12328
4831,1999-2000,1999-12-01,2000-03-13,104,0,30,199,229,22,51,73,302,7,48,Illinois,Effingham,12328
4832,2000-2001,2000-11-22,2001-02-28,99,1,63,291,354,27,140,167,521,12,89,Illinois,Effingham,12328
4833,2001-2002,2001-12-01,2002-03-26,116,0,18,179,197,15,21,36,233,7,34,Illinois,Effingham,12328
4834,2002-2003,2002-12-01,2003-03-11,101,0,50,276,326,43,58,101,427,21,117,Illinois,Effingham,12328
4835,2003-2004,2003-12-01,2004-02-29,91,1,41,196,237,15,27,42,279,11,74,Illinois,Effingham,12328
4836,2004-2005,2004-12-01,2005-03-02,92,0,34,178,212,22,43,65,277,11,54,Illinois,Effingham,12328
4837,2005-2006,2005-11-18,2006-03-23,126,6,27,203,230,25,34,59,289,8,45,Illinois,Effingham,12328
4838,2006-2007,2006-12-01,2007-03-04,94,0,47,214,261,15,30,45,306,7,47,Illinois,Effingham,12328
4839,2007-2008,2007-12-01,2008-03-09,100,0,47,241,288,30,39,69,357,15,82,Illinois,Effingham,12328
4840,2008-2009,2008-11-22,2009-03-04,103,0,61,291,352,24,40,64,416,10,66,Illinois,Effingham,12328
4841,2009-2010,2009-12-01,2010-02-28,90,0,49,249,298,25,53,78,376,11,65,Illinois,Effingham,12328
4842,2010-2011,2010-12-01,2011-02-28,90,0,58,249,307,31,104,135,442,14,89,Illinois,Effingham,12328
4843,2012-2013,2012-12-01,2013-03-27,117,6,24,213,237,23,39,62,299,8,33,Illinois,Effingham,12328
4844,2013-2014,2013-11-24,2014-03-25,122,2,85,419,504,53,136,189,693,19,137,Illinois,Effingham,12328
4845,2014-2015,2014-11-14,2015-03-09,116,2,59,312,371,35,102,137,508,11,85,Illinois,Effingham,12328
4846,2015-2016,2015-12-01,2016-02-29,91,0,27,135,162,12,19,31,193,5,29,Illinois,Effingham,12328
4847,2016-2017,2016-12-01,2017-03-15,105,1,30,164,194,5,4,9,203,4,18,Illinois,Effingham,12328
4848,2017-2018,2017-12-01,2018-04-09,130,0,56,258,314,12,9,21,335,8,39,Illinois,Effingham,12328
4849,2018-2019,2018-11-14,2019-03-06,113,0,37,223,260,18,24,42,302,8,52,Illinois,Effingham,12328
4850,2019-2020,2019-11-12,2020-02-29,110,0,20,169,189,11,21,32,221,6,25,Illinois,Effingham,12328
4851,1951-1952,1951-11-03,1952-03-08,127,14,55,308,363,45,77,122,485,16,126,Illinois,La Harpe,1235
4852,1953-1954,1953-12-01,1954-03-14,104,14,23,223,246,12,14,26,272,6,31,Illinois,La Harpe,1235
4853,1954-1955,1954-12-01,1955-03-26,116,7,39,269,308,37,98,135,443,14,87,Illinois,La Harpe,1235
4854,1955-1956,1955-11-03,1956-03-18,137,1,55,357,412,28,43,71,483,19,97,Illinois,La Harpe,1235
4855,1956-1957,1956-11-21,1957-04-10,141,4,56,299,355,46,118,164,519,18,138,Illinois,La Harpe,1235
4856,1957-1958,1957-11-30,1958-03-11,102,0,83,282,365,27,173,200,565,10,55,Illinois,La Harpe,1235
4857,1958-1959,1958-11-27,1959-03-15,109,7,90,368,458,36,155,191,649,10,87,Illinois,La Harpe,1235
4858,1959-1960,1959-11-06,1960-03-27,143,0,84,382,466,64,253,317,783,19,134,Illinois,La Harpe,1235
4859,1960-1961,1960-12-01,1961-04-17,138,5,54,318,372,28,77,105,477,10,69,Illinois,La Harpe,1235
4860,1961-1962,1961-12-01,1962-03-15,105,5,94,347,441,35,236,271,712,12,70,Illinois,La Harpe,1235
4861,1962-1963,1962-12-01,1963-03-01,91,8,113,376,489,27,101,128,617,12,111,Illinois,La Harpe,1235
4862,1963-1964,1963-12-01,1964-03-29,120,6,72,352,424,37,104,141,565,12,77,Illinois,La Harpe,1235
4863,1964-1965,1964-11-21,1965-03-28,128,5,89,408,497,61,142,203,700,14,139,Illinois,La Harpe,1235
4864,1965-1966,1965-11-29,1966-03-24,116,3,59,264,323,14,7,21,344,8,43,Illinois,La Harpe,1235
4865,1967-1968,1967-10-27,1968-03-21,147,3,65,367,432,26,69,95,527,11,76,Illinois,La Harpe,1235
4866,1968-1969,1968-11-11,1969-03-30,140,4,68,324,392,29,95,124,516,10,53,Illinois,La Harpe,1235
4867,1969-1970,1969-11-14,1970-04-03,141,2,81,384,465,56,174,230,695,15,102,Illinois,La Harpe,1235
4868,1970-1971,1970-11-23,1971-03-11,109,1,71,337,408,27,87,114,522,8,39,Illinois,La Harpe,1235
4869,1971-1972,1971-11-29,1972-03-29,122,0,68,317,385,43,109,152,537,13,101,Illinois,La Harpe,1235
4870,1972-1973,1972-10-18,1973-04-10,175,5,67,284,351,16,58,74,425,6,44,Illinois,La Harpe,1235
4871,1974-1975,1974-11-14,1975-04-03,141,2,43,367,410,72,128,200,610,16,126,Illinois,La Harpe,1235
4872,1975-1976,1975-11-25,1976-02-29,97,2,40,228,268,38,63,101,369,12,85,Illinois,La Harpe,1235
4873,1976-1977,1976-11-27,1977-03-22,116,3,122,429,551,41,202,243,794,16,137,Illinois,La Harpe,1235
4874,1977-1978,1977-11-25,1978-03-27,123,0,131,523,654,76,387,463,1117,21,199,Illinois,La Harpe,1235
4875,1978-1979,1978-11-20,1979-03-25,126,1,144,461,605,78,530,608,1213,20,203,Illinois,La Harpe,1235
4876,1979-1980,1979-11-28,1980-04-15,140,2,56,315,371,42,88,130,501,16,108,Illinois,La Harpe,1235
4877,1980-1981,1980-11-27,1981-02-28,94,0,44,258,302,22,45,67,369,11,68,Illinois,La Harpe,1235
4878,1981-1982,1981-11-20,1982-04-09,141,2,98,431,529,53,260,313,842,17,149,Illinois,La Harpe,1235
4879,1982-1983,1982-11-13,1983-03-26,134,3,25,211,236,27,64,91,327,11,59,Illinois,La Harpe,1235
4880,1983-1984,1983-11-29,1984-03-22,115,5,114,367,481,50,239,289,770,19,146,Illinois,La Harpe,1235
4881,1984-1985,1984-12-01,1985-02-28,90,6,85,336,421,30,277,307,728,9,75,Illinois,La Harpe,1235
4882,1986-1987,1986-11-11,1987-02-28,110,1,29,213,242,19,46,65,307,6,38,Illinois,La Harpe,1235
4883,1987-1988,1987-11-29,1988-03-30,123,4,72,362,434,33,102,135,569,9,74,Illinois,La Harpe,1235
4884,1988-1989,1988-11-22,1989-03-19,118,2,55,351,406,19,105,124,530,8,62,Illinois,La Harpe,1235
4885,1989-1990,1989-11-17,1990-03-24,128,1,68,433,501,26,110,136,637,9,86,Illinois,La Harpe,1235
4886,1990-1991,1990-12-01,1991-03-14,104,0,67,358,425,26,101,127,552,9,77,Illinois,La Harpe,1235
4887,1991-1992,1991-11-03,1992-03-14,133,5,34,228,262,24,39,63,325,10,59,Illinois,La Harpe,1235
4888,1992-1993,1992-11-27,1993-04-02,127,2,62,323,385,50,153,203,588,14,92,Illinois,La Harpe,1235
4889,1993-1994,1993-11-07,1994-03-03,117,6,95,361,456,38,149,187,643,14,117,Illinois,La Harpe,1235
4890,1994-1995,1994-11-30,1995-03-09,100,0,58,296,354,26,150,176,530,8,57,Illinois,La Harpe,1235
4891,1995-1996,1995-11-11,1996-03-27,138,4,100,436,536,31,106,137,673,13,94,Illinois,La Harpe,1235
4892,1996-1997,1996-11-11,1997-04-13,154,3,86,403,489,33,112,145,634,11,98,Illinois,La Harpe,1235
4893,1997-1998,1997-11-17,1998-03-14,118,4,32,201,233,49,114,163,396,12,76,Illinois,La Harpe,1235
4894,1998-1999,1998-11-08,1999-03-15,128,6,57,306,363,51,192,243,606,9,104,Illinois,La Harpe,1235
4895,1999-2000,1999-12-01,2000-04-08,130,3,41,277,318,20,79,99,417,8,51,Illinois,La Harpe,1235
4896,2000-2001,2000-11-21,2001-03-17,117,2,92,448,540,45,346,391,931,15,137,Illinois,La Harpe,1235
4897,2001-2002,2001-12-01,2002-03-26,116,2,28,280,308,29,58,87,395,8,52,Illinois,La Harpe,1235
4898,2002-2003,2002-11-26,2003-03-11,106,2,62,389,451,26,70,96,547,9,67,Illinois,La Harpe,1235
4899,2010-2011,2010-11-22,2011-05-15,175,18,92,343,435,34,165,199,634,17,63,Illinois,La Harpe,1235
4900,2012-2013,2012-12-01,2013-03-28,118,17,53,283,336,41,134,175,511,12,69,Illinois,La Harpe,1235
4901,2013-2014,2013-11-12,2014-03-17,126,0,147,514,661,66,274,340,1001,18,161,Illinois,La Harpe,1235
4902,2014-2015,2014-11-12,2015-03-07,116,14,103,377,480,41,131,172,652,10,91,Illinois,La Harpe,1235
4903,2015-2016,2015-11-21,2016-02-29,101,5,41,179,220,19,33,52,272,8,62,Illinois,La Harpe,1235
4904,2016-2017,2016-12-01,2017-03-15,105,4,43,212,255,16,20,36,291,5,40,Illinois,La Harpe,1235
4905,2017-2018,2017-12-01,2018-04-09,130,3,92,352,444,26,103,129,573,9,85,Illinois,La Harpe,1235
4906,2018-2019,2018-11-09,2019-03-08,120,3,90,355,445,42,153,195,640,13,84,Illinois,La Harpe,1235
4907,2019-2020,2019-10-30,2020-04-17,171,4,47,266,313,43,82,125,438,15,77,Illinois,La Harpe,1235
4908,1950-1951,1950-11-08,1951-04-01,145,0,149,464,613,60,161,221,834,32,222,Illinois,Moline,21302
4909,1951-1952,1951-11-02,1952-03-23,143,0,87,379,466,65,165,230,696,28,168,Illinois,Moline,21302
4910,1952-1953,1952-11-27,1953-04-19,144,0,52,277,329,41,81,122,451,17,115,Illinois,Moline,21302
4911,1953-1954,1953-11-26,1954-04-03,129,0,54,296,350,26,34,60,410,10,56,Illinois,Moline,21302
4912,1954-1955,1954-11-01,1955-03-26,146,0,66,337,403,72,145,217,620,35,225,Illinois,Moline,21302
4913,1955-1956,1955-11-16,1956-04-07,144,0,73,392,465,30,43,73,538,21,101,Illinois,Moline,21302
4914,1956-1957,1956-11-21,1957-04-12,143,0,80,357,437,54,92,146,583,25,170,Illinois,Moline,21302
4915,1957-1958,1957-11-19,1958-03-05,107,0,103,318,421,42,212,254,675,18,107,Illinois,Moline,21302
4916,1958-1959,1958-11-26,1959-04-20,146,0,120,431,551,64,169,233,784,30,190,Illinois,Moline,21302
4917,1959-1960,1959-11-06,1960-03-27,143,0,108,429,537,89,382,471,1008,41,266,Illinois,Moline,21302
4918,1960-1961,1960-11-29,1961-04-17,140,0,86,349,435,25,47,72,507,16,115,Illinois,Moline,21302
4919,1961-1962,1961-12-01,1962-04-13,134,0,127,418,545,77,355,432,977,42,246,Illinois,Moline,21302
4920,1962-1963,1962-10-24,1963-03-13,141,0,172,510,682,46,111,157,839,27,269,Illinois,Moline,21302
4921,1963-1964,1963-12-01,1964-03-29,120,0,108,378,486,50,109,159,645,25,116,Illinois,Moline,21302
4922,1964-1965,1964-11-19,1965-03-27,129,0,126,417,543,72,135,207,750,39,237,Illinois,Moline,21302
4923,1965-1966,1965-11-18,1966-04-05,139,0,111,368,479,29,66,95,574,22,145,Illinois,Moline,21302
4924,1966-1967,1966-12-01,1967-04-24,145,0,89,342,431,54,123,177,608,24,149,Illinois,Moline,21302
4925,1967-1968,1967-10-26,1968-03-22,149,0,93,394,487,42,76,118,605,27,171,Illinois,Moline,21302
4926,1968-1969,1968-11-08,1969-03-30,143,0,108,384,492,41,59,100,592,24,116,Illinois,Moline,21302
4927,1969-1970,1969-11-14,1970-04-02,140,0,126,455,581,84,154,238,819,38,301,Illinois,Moline,21302
4928,1970-1971,1970-11-22,1971-03-23,122,0,117,369,486,49,185,234,720,19,110,Illinois,Moline,21302
4929,1971-1972,1971-11-09,1972-04-07,151,0,101,384,485,79,163,242,727,33,216,Illinois,Moline,21302
4930,1972-1973,1972-10-18,1973-04-10,175,0,85,303,388,46,77,123,511,26,145,Illinois,Moline,21302
4931,1973-1974,1973-11-09,1974-04-04,147,0,110,352,462,53,124,177,639,27,169,Illinois,Moline,21302
4932,1974-1975,1974-11-13,1975-04-05,144,0,70,344,414,105,133,238,652,41,233,Illinois,Moline,21302
4933,1975-1976,1975-11-12,1976-03-13,123,0,63,297,360,40,41,81,441,22,97,Illinois,Moline,21302
4934,1976-1977,1976-11-04,1977-04-05,153,0,165,538,703,60,182,242,945,30,248,Illinois,Moline,21302
4935,1977-1978,1977-11-24,1978-03-27,124,0,187,535,722,65,319,384,1106,33,252,Illinois,Moline,21302
4936,1978-1979,1978-11-20,1979-04-02,134,0,198,552,750,98,601,699,1449,42,341,Illinois,Moline,21302
4937,1979-1980,1979-11-10,1980-04-15,158,0,90,387,477,63,87,150,627,37,199,Illinois,Moline,21302
4938,1980-1981,1980-10-27,1981-02-28,125,0,79,336,415,34,55,89,504,22,141,Illinois,Moline,21302
4939,1981-1982,1981-11-19,1982-04-11,144,0,153,488,641,71,193,264,905,38,303,Illinois,Moline,21302
4940,1982-1983,1982-11-05,1983-04-03,150,0,39,235,274,40,60,100,374,24,94,Illinois,Moline,21302
4941,1983-1984,1983-11-13,1984-04-03,143,0,144,401,545,74,249,323,868,36,249,Illinois,Moline,21302
4942,1984-1985,1984-12-01,1985-03-30,120,0,110,360,470,49,276,325,795,27,198,Illinois,Moline,21302
4943,1985-1986,1985-11-20,1986-04-15,147,0,120,424,544,50,148,198,742,31,202,Illinois,Moline,21302
4944,1986-1987,1986-11-10,1987-03-01,112,0,40,240,280,20,18,38,318,14,55,Illinois,Moline,21302
4945,1987-1988,1987-11-29,1988-03-29,122,0,98,332,430,56,140,196,626,24,149,Illinois,Moline,21302
4946,1988-1989,1988-11-05,1989-03-18,134,0,71,326,397,27,107,134,531,16,104,Illinois,Moline,21302
4947,1989-1990,1989-11-16,1990-02-28,105,0,82,321,403,45,113,158,561,20,141,Illinois,Moline,21302
4948,1990-1991,1990-12-01,1991-03-16,106,0,77,325,402,40,131,171,573,21,136,Illinois,Moline,21302
4949,1991-1992,1991-11-02,1992-03-15,135,0,40,251,291,33,38,71,362,21,94,Illinois,Moline,21302
4950,1992-1993,1992-11-05,1993-04-16,163,0,65,342,407,41,113,154,561,24,101,Illinois,Moline,21302
4951,1993-1994,1993-11-06,1994-04-30,176,0,130,425,555,68,190,258,813,32,249,Illinois,Moline,21302
4952,1994-1995,1994-11-29,1995-04-10,133,0,73,296,369,51,161,212,581,21,129,Illinois,Moline,21302
4953,1995-1996,1995-11-02,1996-03-26,146,4,124,453,577,47,94,141,718,27,165,Illinois,Moline,21302
4954,1996-1997,1996-11-10,1997-04-13,155,0,118,386,504,90,116,206,710,36,257,Illinois,Moline,21302
4955,2000-2001,2000-11-13,2001-03-25,133,20,125,445,570,78,339,417,987,39,252,Illinois,Moline,21302
4956,2001-2002,2001-12-01,2002-04-02,123,0,40,244,284,48,86,134,418,22,121,Illinois,Moline,21302
4957,2002-2003,2002-11-24,2003-04-07,135,0,74,377,451,34,54,88,539,20,112,Illinois,Moline,21302
4958,2003-2004,2003-11-24,2004-03-17,115,0,76,280,356,50,177,227,583,21,124,Illinois,Moline,21302
4959,2004-2005,2004-11-24,2005-03-23,120,10,56,255,311,28,71,99,410,19,77,Illinois,Moline,21302
4960,2005-2006,2005-11-17,2006-03-24,128,3,60,264,324,34,102,136,460,18,97,Illinois,Moline,21302
4961,2006-2007,2006-12-01,2007-04-12,133,4,89,304,393,53,201,254,647,19,126,Illinois,Moline,21302
4962,2007-2008,2007-12-01,2008-03-27,118,3,96,357,453,81,211,292,745,38,238,Illinois,Moline,21302
4963,2008-2009,2008-11-21,2009-04-05,136,1,111,421,532,67,166,233,765,29,218,Illinois,Moline,21302
4964,2009-2010,2009-12-01,2010-03-21,111,0,97,322,419,66,236,302,721,27,167,Illinois,Moline,21302
4965,2010-2011,2010-11-30,2011-02-28,91,0,106,321,427,67,233,300,727,28,182,Illinois,Moline,21302
4966,2011-2012,2011-11-09,2012-03-06,119,2,24,212,236,27,37,64,300,16,80,Illinois,Moline,21302
4967,2012-2013,2012-11-24,2013-03-25,122,1,60,310,370,52,122,174,544,21,112,Illinois,Moline,21302
4968,2013-2014,2013-10-22,2014-03-25,155,0,176,584,760,91,249,340,1100,38,318,Illinois,Moline,21302
4969,2014-2015,2014-11-11,2015-03-23,133,1,115,427,542,56,200,256,798,21,170,Illinois,Moline,21302
4970,2015-2016,2015-11-20,2016-03-25,127,2,43,219,262,35,51,86,348,15,91,Illinois,Moline,21302
4971,2016-2017,2016-12-01,2017-03-15,105,1,50,215,265,32,46,78,343,13,68,Illinois,Moline,21302
4972,2017-2018,2017-12-01,2018-04-16,137,0,101,367,468,61,118,179,647,26,215,Illinois,Moline,21302
4973,2018-2019,2018-10-15,2019-03-17,154,16,87,376,463,86,157,243,706,29,233,Illinois,Moline,21302
4974,1965-1966,1965-11-29,1966-03-06,98,4,37,175,212,20,39,59,271,7,47,Illinois,Nashville,601222
4975,1966-1967,1966-12-01,1967-03-09,99,4,20,155,175,6,1,7,182,6,21,Illinois,Nashville,601222
4976,1967-1968,1967-12-01,1968-03-15,106,1,41,215,256,17,39,56,312,10,67,Illinois,Nashville,601222
4977,1968-1969,1968-12-01,1969-03-11,101,0,23,166,189,20,26,46,235,4,28,Illinois,Nashville,601222
4978,1969-1970,1969-11-19,1970-03-29,131,0,58,258,316,44,205,249,565,19,111,Illinois,Nashville,601222
4979,1970-1971,1970-11-24,1971-04-08,136,0,32,211,243,32,36,68,311,10,57,Illinois,Nashville,601222
4980,1971-1972,1971-11-24,1972-02-29,98,0,24,151,175,11,16,27,202,7,42,Illinois,Nashville,601222
4981,1972-1973,1972-12-01,1973-02-28,90,0,26,157,183,7,3,10,193,6,28,Illinois,Nashville,601222
4982,1973-1974,1973-12-01,1974-03-25,115,0,38,168,206,37,70,107,313,9,76,Illinois,Nashville,601222
4983,1974-1975,1974-12-01,1975-03-14,104,0,11,120,131,24,20,44,175,9,37,Illinois,Nashville,601222
4984,1975-1976,1975-11-27,1976-03-16,111,0,24,147,171,23,43,66,237,7,47,Illinois,Nashville,601222
4985,1976-1977,1976-11-28,1977-03-01,94,2,82,296,378,39,226,265,643,12,105,Illinois,Nashville,601222
4986,1977-1978,1977-11-26,1978-03-26,121,1,86,320,406,46,271,317,723,18,111,Illinois,Nashville,601222
4987,1978-1979,1978-12-01,1979-03-25,115,3,77,286,363,43,221,264,627,18,149,Illinois,Nashville,601222
4988,1979-1980,1979-11-29,1980-04-15,139,0,35,191,226,24,81,105,331,13,77,Illinois,Nashville,601222
4989,1980-1981,1980-11-27,1981-02-28,94,0,24,172,196,20,24,44,240,6,41,Illinois,Nashville,601222
4990,1981-1982,1981-12-01,1982-04-08,129,2,54,249,303,59,205,264,567,13,113,Illinois,Nashville,601222
4991,1982-1983,1982-12-01,1983-04-18,139,12,14,100,114,11,8,19,133,8,26,Illinois,Nashville,601222
4992,1983-1984,1983-12-01,1984-03-21,112,3,76,242,318,41,121,162,480,17,110,Illinois,Nashville,601222
4993,1984-1985,1984-12-01,1985-02-28,90,1,52,206,258,21,117,138,396,12,72,Illinois,Nashville,601222
4994,1985-1986,1985-12-01,1986-02-28,90,12,35,188,223,13,20,33,256,8,56,Illinois,Nashville,601222
4995,1986-1987,1986-11-13,1987-02-28,108,1,19,137,156,14,27,41,197,8,36,Illinois,Nashville,601222
4996,1987-1988,1987-12-01,1988-03-18,109,3,33,195,228,14,13,27,255,7,45,Illinois,Nashville,601222
4997,1988-1989,1988-12-01,1989-03-10,100,0,22,182,204,17,41,58,262,7,47,Illinois,Nashville,601222
4998,1989-1990,1989-11-29,1990-03-25,117,1,47,231,278,23,66,89,367,8,61,Illinois,Nashville,601222
4999,1990-1991,1990-12-01,1991-03-14,104,0,28,212,240,20,82,102,342,8,64,Illinois,Nashville,601222
5000,1991-1992,1991-11-03,1992-03-14,133,0,11,130,141,10,24,34,175,5,20,Illinois,Nashville,601222
5001,1992-1993,1992-12-01,1993-03-14,104,0,23,158,181,29,62,91,272,6,52,Illinois,Nashville,601222
5002,1993-1994,1993-10-30,1994-03-09,131,0,41,208,249,20,35,55,304,13,59,Illinois,Nashville,601222
5003,1994-1995,1994-12-01,1995-03-08,98,3,25,161,186,5,5,10,196,5,25,Illinois,Nashville,601222
5004,1995-1996,1995-12-01,1996-03-21,112,0,47,217,264,24,62,86,350,11,69,Illinois,Nashville,601222
5005,1996-1997,1996-11-27,1997-03-15,109,4,43,186,229,21,81,102,331,10,61,Illinois,Nashville,601222
5006,1997-1998,1997-11-14,1998-03-12,119,2,14,99,113,21,28,49,162,8,36,Illinois,Nashville,601222
5007,1998-1999,1998-12-01,1999-03-14,104,1,30,139,169,19,63,82,251,9,63,Illinois,Nashville,601222
5008,1999-2000,1999-12-01,2000-03-13,104,0,9,121,130,11,12,23,153,4,21,Illinois,Nashville,601222
5009,2000-2001,2000-11-21,2001-02-28,100,2,50,225,275,27,151,178,453,11,72,Illinois,Nashville,601222
5010,2001-2002,2001-12-01,2002-03-26,116,1,17,136,153,13,20,33,186,8,41,Illinois,Nashville,601222
5011,2002-2003,2002-12-01,2003-03-01,91,1,38,193,231,46,87,133,364,15,95,Illinois,Nashville,601222
5012,2003-2004,2003-12-01,2004-02-29,91,2,26,137,163,10,6,16,179,8,45,Illinois,Nashville,601222
5013,2004-2005,2004-12-01,2005-03-01,91,4,23,124,147,16,29,45,192,9,42,Illinois,Nashville,601222
5014,2006-2007,2006-12-01,2007-02-28,90,8,24,141,165,8,18,26,191,5,25,Illinois,Nashville,601222
5015,2007-2008,2007-12-01,2008-03-09,100,6,34,186,220,19,12,31,251,8,36,Illinois,Nashville,601222
5016,2008-2009,2008-11-22,2009-03-13,112,2,46,238,284,12,37,49,333,2,23,Illinois,Nashville,601222
5017,2009-2010,2009-12-01,2010-02-28,90,2,53,212,265,16,45,61,326,6,38,Illinois,Nashville,601222
5018,2010-2011,2010-12-01,2011-03-27,117,3,54,211,265,24,59,83,348,6,38,Illinois,Nashville,601222
5019,2011-2012,2011-12-01,2012-02-29,91,0,9,101,110,5,3,8,118,4,14,Illinois,Nashville,601222
5020,2012-2013,2012-12-01,2013-03-25,115,0,16,170,186,30,44,74,260,8,40,Illinois,Nashville,601222
5021,2013-2014,2013-11-25,2014-03-04,100,0,75,314,389,42,120,162,551,11,91,Illinois,Nashville,601222
5022,2014-2015,2014-11-14,2015-03-07,114,0,45,252,297,26,40,66,363,9,70,Illinois,Nashville,601222
5023,2015-2016,2015-12-01,2016-02-29,91,3,24,118,142,9,9,18,160,6,33,Illinois,Nashville,601222
5024,2016-2017,2016-12-01,2017-03-13,103,2,23,142,165,4,4,8,173,2,9,Illinois,Nashville,601222
5025,2017-2018,2017-12-01,2018-02-28,90,14,52,195,247,6,4,10,257,5,23,Illinois,Nashville,601222
5026,2018-2019,2018-11-15,2019-03-06,112,5,32,177,209,27,31,58,267,8,67,Illinois,Nashville,601222
5027,1950-1951,1950-11-22,1951-03-25,124,0,71,294,365,59,164,223,588,25,170,Illinois,Pana,5847
5028,1951-1952,1951-11-06,1952-03-05,121,9,30,209,239,48,96,144,383,16,105,Illinois,Pana,5847
5029,1952-1953,1952-11-27,1953-03-07,101,2,20,155,175,32,38,70,245,12,65,Illinois,Pana,5847
5030,1953-1954,1953-11-29,1954-03-14,106,1,23,171,194,10,7,17,211,6,22,Illinois,Pana,5847
5031,1954-1955,1954-11-01,1955-03-26,146,4,33,200,233,27,25,52,285,15,73,Illinois,Pana,5847
5032,1955-1956,1955-11-18,1956-03-16,120,4,34,223,257,40,71,111,368,15,78,Illinois,Pana,5847
5033,1956-1957,1956-11-22,1957-04-12,142,0,36,189,225,18,34,52,277,13,68,Illinois,Pana,5847
5034,1957-1958,1957-12-01,1958-03-17,107,2,49,219,268,20,17,37,305,12,48,Illinois,Pana,5847
5035,1958-1959,1958-11-27,1959-03-12,106,1,65,267,332,24,49,73,405,12,72,Illinois,Pana,5847
5036,1959-1960,1959-11-17,1960-03-25,130,0,59,258,317,54,176,230,547,20,108,Illinois,Pana,5847
5037,1960-1961,1960-12-01,1961-02-28,90,0,54,215,269,30,107,137,406,12,80,Illinois,Pana,5847
5038,1961-1962,1961-11-19,1962-03-08,110,0,58,251,309,53,122,175,484,20,124,Illinois,Pana,5847
5039,1962-1963,1962-12-01,1963-03-09,99,0,93,312,405,22,67,89,494,15,99,Illinois,Pana,5847
5040,1963-1964,1963-12-01,1964-03-12,103,0,64,251,315,57,138,195,510,14,100,Illinois,Pana,5847
5041,1964-1965,1964-11-20,1965-03-25,126,0,63,279,342,46,97,143,485,19,138,Illinois,Pana,5847
5042,1965-1966,1965-11-29,1966-03-08,100,3,47,203,250,7,36,43,293,5,19,Illinois,Pana,5847
5043,1966-1967,1966-11-27,1967-03-09,103,3,33,206,239,17,17,34,273,10,38,Illinois,Pana,5847
5044,1967-1968,1967-11-23,1968-03-23,122,1,60,262,322,41,142,183,505,18,120,Illinois,Pana,5847
5045,1968-1969,1968-11-20,1969-03-31,132,0,47,240,287,28,73,101,388,12,61,Illinois,Pana,5847
5046,1969-1970,1969-11-14,1970-04-02,140,0,86,310,396,59,211,270,666,26,155,Illinois,Pana,5847
5047,1970-1971,1970-11-23,1971-03-07,105,2,55,227,282,10,25,35,317,6,42,Illinois,Pana,5847
5048,1971-1972,1971-11-23,1972-02-29,99,3,37,179,216,20,38,58,274,12,78,Illinois,Pana,5847
5049,1972-1973,1972-11-19,1973-04-10,143,0,41,204,245,38,42,80,325,21,91,Illinois,Pana,5847
5050,1973-1974,1973-11-09,1974-04-05,148,2,55,217,272,79,195,274,546,23,171,Illinois,Pana,5847
5051,1974-1975,1974-11-30,1975-03-27,118,1,25,171,196,34,45,79,275,17,83,Illinois,Pana,5847
5052,1975-1976,1975-11-27,1976-03-17,112,6,39,191,230,41,53,94,324,14,93,Illinois,Pana,5847
5053,1976-1977,1976-11-28,1977-04-06,130,0,112,358,470,49,245,294,764,22,164,Illinois,Pana,5847
5054,1977-1978,1977-11-25,1978-03-27,123,6,124,397,521,92,433,525,1046,34,249,Illinois,Pana,5847
5055,1978-1979,1978-12-01,1979-03-25,115,3,109,342,451,54,365,419,870,24,207,Illinois,Pana,5847
5056,1979-1980,1979-11-29,1980-04-15,139,0,54,243,297,52,129,181,478,20,119,Illinois,Pana,5847
5057,1980-1981,1980-11-27,1981-03-05,99,0,42,207,249,38,67,105,354,13,99,Illinois,Pana,5847
5058,1981-1982,1981-11-21,1982-04-09,140,5,80,317,397,65,350,415,812,19,174,Illinois,Pana,5847
5059,1982-1983,1982-11-13,1983-04-18,157,4,18,162,180,30,30,60,240,14,69,Illinois,Pana,5847
5060,1983-1984,1983-12-01,1984-03-15,106,9,84,292,376,67,310,377,753,27,203,Illinois,Pana,5847
5061,1984-1985,1984-11-18,1985-02-28,103,0,57,279,336,25,122,147,483,16,119,Illinois,Pana,5847
5062,1985-1986,1985-12-01,1986-03-07,97,1,49,307,356,22,49,71,427,15,96,Illinois,Pana,5847
5063,1986-1987,1986-11-13,1987-02-28,108,3,22,194,216,34,99,133,349,11,77,Illinois,Pana,5847
5064,1987-1988,1987-12-01,1988-03-18,109,8,44,223,267,34,80,114,381,14,75,Illinois,Pana,5847
5065,1988-1989,1988-11-07,1989-03-10,124,6,38,244,282,51,96,147,429,19,129,Illinois,Pana,5847
5066,1989-1990,1989-10-20,1990-03-25,157,4,55,243,298,31,70,101,399,13,89,Illinois,Pana,5847
5067,1990-1991,1990-12-01,1991-03-14,104,1,35,189,224,37,109,146,370,15,97,Illinois,Pana,5847
5068,1991-1992,1991-11-03,1992-04-28,178,4,16,179,195,22,45,67,262,14,58,Illinois,Pana,5847
5069,1992-1993,1992-11-06,1993-04-02,148,4,33,232,265,52,126,178,443,20,95,Illinois,Pana,5847
5070,1993-1994,1993-10-31,1994-04-06,158,8,51,253,304,47,66,113,417,15,107,Illinois,Pana,5847
5071,1999-2000,1999-12-01,2000-04-08,130,16,40,196,236,31,53,84,320,10,80,Illinois,Pana,5847
5072,2000-2001,2000-11-18,2001-03-06,109,8,80,328,408,24,120,144,552,8,74,Illinois,Pana,5847
5073,2005-2006,2005-11-18,2006-03-24,127,5,30,213,243,30,49,79,322,10,67,Illinois,Pana,5847
5074,2009-2010,2009-12-01,2010-02-28,90,6,60,240,300,25,74,99,399,9,57,Illinois,Pana,5847
5075,2010-2011,2010-12-01,2011-02-28,90,4,65,240,305,32,143,175,480,12,77,Illinois,Pana,5847
5076,2012-2013,2012-12-01,2013-03-28,118,8,27,216,243,33,42,75,318,10,53,Illinois,Pana,5847
5077,2013-2014,2013-11-12,2014-03-25,134,4,91,446,537,53,149,202,739,18,152,Illinois,Pana,5847
5078,2014-2015,2014-11-13,2015-03-09,117,5,62,332,394,28,86,114,508,13,103,Illinois,Pana,5847
5079,2015-2016,2015-12-01,2016-02-29,91,4,26,155,181,12,20,32,213,5,31,Illinois,Pana,5847
5080,2016-2017,2016-12-01,2017-03-15,105,0,31,175,206,6,7,13,219,5,24,Illinois,Pana,5847
5081,2017-2018,2017-12-01,2018-04-09,130,5,58,279,337,7,13,20,357,5,25,Illinois,Pana,5847
5082,2018-2019,2018-11-10,2019-03-07,118,3,44,256,300,20,39,59,359,7,37,Illinois,Pana,5847
5083,2019-2020,2019-11-12,2020-02-29,110,2,24,181,205,19,41,60,265,8,39,Illinois,Pana,5847
5084,1950-1951,1950-11-10,1951-04-12,154,0,114,410,524,58,109,167,691,32,177,Illinois,Peoria,23402
5085,1951-1952,1951-11-02,1952-03-25,145,0,59,337,396,51,114,165,561,26,143,Illinois,Peoria,23402
5086,1952-1953,1952-11-27,1953-04-19,144,0,34,212,246,21,26,47,293,15,66,Illinois,Peoria,23402
5087,1953-1954,1953-11-26,1954-03-14,109,0,42,230,272,21,29,50,322,10,53,Illinois,Peoria,23402
5088,1954-1955,1954-11-01,1955-03-27,147,0,60,278,338,53,114,167,505,30,170,Illinois,Peoria,23402
5089,1955-1956,1955-11-02,1956-03-15,135,0,61,308,369,31,20,51,420,22,102,Illinois,Peoria,23402
5090,1956-1957,1956-11-21,1957-04-11,142,0,73,285,358,57,91,148,506,30,161,Illinois,Peoria,23402
5091,1957-1958,1957-11-21,1958-03-10,110,0,83,282,365,33,122,155,520,16,74,Illinois,Peoria,23402
5092,1958-1959,1958-11-26,1959-03-11,106,0,103,366,469,36,129,165,634,16,119,Illinois,Peoria,23402
5093,1959-1960,1959-11-06,1960-03-27,143,0,105,375,480,65,191,256,736,35,196,Illinois,Peoria,23402
5094,1960-1961,1960-11-09,1961-04-17,160,0,83,346,429,24,70,94,523,15,93,Illinois,Peoria,23402
5095,1961-1962,1961-11-19,1962-04-01,134,0,121,394,515,55,182,237,752,33,178,Illinois,Peoria,23402
5096,1962-1963,1962-12-01,1963-03-02,92,0,153,418,571,27,78,105,676,19,165,Illinois,Peoria,23402
5097,1963-1964,1963-11-30,1964-03-29,121,0,96,350,446,42,89,131,577,23,107,Illinois,Peoria,23402
5098,1964-1965,1964-11-19,1965-03-28,130,0,103,387,490,45,114,159,649,23,152,Illinois,Peoria,23402
5099,1965-1966,1965-11-18,1966-05-08,172,0,83,317,400,17,11,28,428,13,55,Illinois,Peoria,23402
5100,1966-1967,1966-12-01,1967-04-23,144,0,81,299,380,35,100,135,515,19,110,Illinois,Peoria,23402
5101,1967-1968,1967-10-26,1968-03-22,149,0,85,353,438,35,80,115,553,27,124,Illinois,Peoria,23402
5102,1968-1969,1968-11-11,1969-03-30,140,0,81,338,419,30,62,92,511,21,96,Illinois,Peoria,23402
5103,1969-1970,1969-11-14,1970-04-02,140,0,117,402,519,61,175,236,755,36,236,Illinois,Peoria,23402
5104,1970-1971,1970-11-23,1971-03-19,117,0,90,318,408,27,5,32,440,15,83,Illinois,Peoria,23402
5105,1971-1972,1971-11-08,1972-04-02,147,0,84,335,419,48,72,120,539,28,148,Illinois,Peoria,23402
5106,1972-1973,1972-10-18,1973-04-10,175,0,83,283,366,38,56,94,460,30,135,Illinois,Peoria,23402
5107,1973-1974,1973-11-08,1974-04-05,149,0,96,314,410,51,122,173,583,26,159,Illinois,Peoria,23402
5108,1974-1975,1974-11-13,1975-04-03,142,0,57,290,347,64,101,165,512,33,153,Illinois,Peoria,23402
5109,1975-1976,1975-11-12,1976-03-10,120,0,69,283,352,39,50,89,441,19,92,Illinois,Peoria,23402
5110,1976-1977,1976-11-04,1977-04-06,154,0,147,514,661,47,157,204,865,29,209,Illinois,Peoria,23402
5111,1977-1978,1977-11-10,1978-03-27,138,0,172,524,696,74,280,354,1050,38,275,Illinois,Peoria,23402
5112,1978-1979,1978-11-20,1979-03-26,127,0,168,474,642,80,471,551,1193,33,280,Illinois,Peoria,23402
5113,1979-1980,1979-11-10,1980-04-15,158,0,92,356,448,45,90,135,583,26,145,Illinois,Peoria,23402
5114,1980-1981,1980-11-27,1981-02-28,94,0,78,275,353,38,72,110,463,21,136,Illinois,Peoria,23402
5115,1981-1982,1981-11-19,1982-04-11,144,0,114,405,519,71,272,343,862,35,244,Illinois,Peoria,23402
5116,1982-1983,1982-11-05,1983-04-03,150,0,34,204,238,33,49,82,320,21,81,Illinois,Peoria,23402
5117,1983-1984,1983-11-13,1984-03-18,127,0,136,360,496,56,181,237,733,31,217,Illinois,Peoria,23402
5118,1984-1985,1984-12-01,1985-03-05,95,0,98,311,409,30,146,176,585,22,147,Illinois,Peoria,23402
5119,1985-1986,1985-11-20,1986-04-15,147,0,101,385,486,40,90,130,616,25,165,Illinois,Peoria,23402
5120,1986-1987,1986-11-11,1987-02-28,110,0,40,215,255,28,76,104,359,12,61,Illinois,Peoria,23402
5121,1987-1988,1987-11-29,1988-03-30,123,0,76,302,378,40,73,113,491,20,94,Illinois,Peoria,23402
5122,1988-1989,1988-11-06,1989-04-08,154,0,70,307,377,35,105,140,517,17,97,Illinois,Peoria,23402
5123,1989-1990,1989-10-19,1990-02-28,133,0,78,291,369,34,106,140,509,15,117,Illinois,Peoria,23402
5124,1990-1991,1990-12-01,1991-03-15,105,0,66,267,333,35,89,124,457,16,113,Illinois,Peoria,23402
5125,1991-1992,1991-11-02,1992-03-15,135,0,37,227,264,31,39,70,334,19,99,Illinois,Peoria,23402
5126,1992-1993,1992-11-03,1993-04-16,165,0,56,294,350,52,113,165,515,30,126,Illinois,Peoria,23402
5127,1993-1994,1993-11-06,1994-04-05,151,0,108,339,447,44,120,164,611,25,171,Illinois,Peoria,23402
5128,1994-1995,1994-12-01,1995-03-08,98,0,53,241,294,16,27,43,337,13,58,Illinois,Peoria,23402
5129,1995-1996,1995-11-11,1996-04-15,157,0,103,393,496,26,28,54,550,20,117,Illinois,Peoria,23402
5130,1997-1998,1997-11-02,1998-03-20,139,0,39,188,227,41,109,150,377,19,82,Illinois,Peoria,23402
5131,1998-1999,1998-11-07,1999-03-12,126,1,58,231,289,48,148,196,485,17,122,Illinois,Peoria,23402
5132,1999-2000,1999-12-01,2000-02-29,91,0,43,201,244,25,71,96,340,14,73,Illinois,Peoria,23402
5133,2000-2001,2000-11-17,2001-03-25,129,0,97,377,474,50,231,281,755,25,186,Illinois,Peoria,23402
5134,2001-2002,2001-12-01,2002-03-26,116,0,30,192,222,19,18,37,259,11,46,Illinois,Peoria,23402
5135,2002-2003,2002-11-25,2003-04-06,133,0,68,326,394,28,48,76,470,18,95,Illinois,Peoria,23402
5136,2003-2004,2003-11-24,2004-03-17,115,0,65,246,311,35,54,89,400,18,101,Illinois,Peoria,23402
5137,2004-2005,2004-11-24,2005-03-22,119,0,46,225,271,27,26,53,324,16,73,Illinois,Peoria,23402
5138,2005-2006,2005-11-17,2006-03-22,126,0,48,218,266,28,90,118,384,12,72,Illinois,Peoria,23402
5139,2006-2007,2006-11-30,2007-03-06,97,0,78,259,337,35,122,157,494,8,74,Illinois,Peoria,23402
5140,2007-2008,2007-12-01,2008-03-08,99,0,70,278,348,51,91,142,490,22,148,Illinois,Peoria,23402
5141,2008-2009,2008-11-21,2009-04-06,137,0,100,354,454,49,138,187,641,24,161,Illinois,Peoria,23402
5142,2009-2010,2009-12-01,2010-03-20,110,0,86,290,376,59,201,260,636,26,144,Illinois,Peoria,23402
5143,2010-2011,2010-12-01,2011-02-28,90,0,91,275,366,76,228,304,670,30,205,Illinois,Peoria,23402
5144,2011-2012,2011-12-01,2012-03-05,96,0,16,160,176,22,21,43,219,13,59,Illinois,Peoria,23402
5145,2012-2013,2012-11-24,2013-03-28,125,0,44,254,298,41,70,111,409,21,93,Illinois,Peoria,23402
5146,2013-2014,2013-11-11,2014-04-14,155,0,138,471,609,90,235,325,934,43,288,Illinois,Peoria,23402
5147,2014-2015,2014-11-12,2015-03-07,116,0,82,328,410,44,139,183,593,20,139,Illinois,Peoria,23402
5148,2015-2016,2015-11-21,2016-03-03,104,0,34,176,210,25,37,62,272,12,81,Illinois,Peoria,23402
5149,2016-2017,2016-12-01,2017-03-15,105,0,48,187,235,21,17,38,273,10,64,Illinois,Peoria,23402
5150,2017-2018,2017-12-01,2018-04-16,137,0,94,321,415,51,124,175,590,25,191,Illinois,Peoria,23402
5151,2018-2019,2018-11-08,2019-04-15,159,0,73,316,389,56,149,205,594,27,160,Illinois,Peoria,23402
5152,2019-2020,2019-10-29,2020-04-17,172,0,36,230,266,53,86,139,405,28,107,Illinois,Peoria,23402
5153,1951-1952,1951-11-02,1952-04-10,161,0,101,412,513,76,190,266,779,30,209,Illinois,Rockford,152871
5154,1952-1953,1952-11-27,1953-03-24,118,0,55,286,341,32,105,137,478,16,93,Illinois,Rockford,152871
5155,1953-1954,1953-11-26,1954-04-03,129,0,58,330,388,35,56,91,479,17,84,Illinois,Rockford,152871
5156,1954-1955,1954-11-01,1955-03-27,147,0,80,386,466,47,118,165,631,23,145,Illinois,Rockford,152871
5157,1955-1956,1955-11-17,1956-03-17,122,0,77,382,459,34,37,71,530,22,128,Illinois,Rockford,152871
5158,1956-1957,1956-11-22,1957-03-26,125,0,90,370,460,31,121,152,612,11,74,Illinois,Rockford,152871
5159,1957-1958,1957-11-21,1958-03-06,106,0,103,353,456,29,224,253,709,13,77,Illinois,Rockford,152871
5160,1958-1959,1958-11-23,1959-04-08,137,0,152,497,649,85,327,412,1061,41,317,Illinois,Rockford,152871
5161,1959-1960,1959-10-26,1960-03-28,155,0,110,430,540,85,401,486,1026,39,246,Illinois,Rockford,152871
5162,1960-1961,1960-11-29,1961-04-17,140,0,96,361,457,36,90,126,583,15,120,Illinois,Rockford,152871
5163,1961-1962,1961-11-19,1962-04-13,146,0,149,451,600,84,401,485,1085,45,268,Illinois,Rockford,152871
5164,1962-1963,1962-10-25,1963-03-26,153,0,185,522,707,56,185,241,948,34,288,Illinois,Rockford,152871
5165,1963-1964,1963-12-01,1964-04-01,123,0,111,422,533,65,203,268,801,28,159,Illinois,Rockford,152871
5166,1964-1965,1964-11-19,1965-03-30,132,0,137,472,609,73,189,262,871,37,240,Illinois,Rockford,152871
5167,1965-1966,1965-11-18,1966-05-11,175,3,106,412,518,33,147,180,698,18,110,Illinois,Rockford,152871
5168,1966-1967,1966-12-01,1967-04-24,145,0,96,391,487,59,206,265,752,28,178,Illinois,Rockford,152871
5169,1967-1968,1967-10-26,1968-04-24,182,0,95,414,509,25,41,66,575,22,127,Illinois,Rockford,152871
5170,1968-1969,1968-11-19,1969-03-31,133,0,103,372,475,35,125,160,635,16,94,Illinois,Rockford,152871
5171,1969-1970,1969-11-14,1970-04-03,141,0,137,460,597,63,299,362,959,34,233,Illinois,Rockford,152871
5172,1970-1971,1970-11-23,1971-04-03,132,0,127,398,525,53,170,223,748,29,145,Illinois,Rockford,152871
5173,1971-1972,1971-11-08,1972-04-08,153,0,108,424,532,63,135,198,730,35,179,Illinois,Rockford,152871
5174,1972-1973,1972-10-18,1973-04-12,177,0,81,319,400,41,115,156,556,25,122,Illinois,Rockford,152871
5175,1973-1974,1973-12-01,1974-03-24,114,0,106,337,443,75,259,334,777,34,217,Illinois,Rockford,152871
5176,1974-1975,1974-11-13,1975-04-07,146,0,81,388,469,77,206,283,752,39,204,Illinois,Rockford,152871
5177,1975-1976,1975-11-12,1976-04-04,145,0,88,394,482,39,171,210,692,26,131,Illinois,Rockford,152871
5178,1976-1977,1976-11-11,1977-04-05,146,0,209,599,808,53,237,290,1098,34,296,Illinois,Rockford,152871
5179,1977-1978,1977-11-21,1978-03-27,127,0,214,594,808,75,504,579,1387,35,272,Illinois,Rockford,152871
5180,1978-1979,1978-11-20,1979-04-28,160,0,209,580,789,109,786,895,1684,46,334,Illinois,Rockford,152871
5181,1979-1980,1979-11-09,1980-04-15,159,0,120,462,582,53,125,178,760,34,189,Illinois,Rockford,152871
5182,1980-1981,1980-10-27,1981-03-11,136,0,100,376,476,35,68,103,579,23,134,Illinois,Rockford,152871
5183,1981-1982,1981-11-19,1982-04-10,143,0,167,533,700,66,287,353,1053,37,310,Illinois,Rockford,152871
5184,1982-1983,1982-11-04,1983-03-27,144,0,53,284,337,45,103,148,485,26,115,Illinois,Rockford,152871
5185,1983-1984,1983-11-24,1984-04-22,151,0,169,458,627,66,307,373,1000,35,227,Illinois,Rockford,152871
5186,1984-1985,1984-11-19,1985-04-08,141,0,130,447,577,62,317,379,956,35,232,Illinois,Rockford,152871
5187,1985-1986,1985-11-20,1986-04-15,147,0,140,456,596,63,253,316,912,36,211,Illinois,Rockford,152871
5188,1986-1987,1986-11-10,1987-03-15,126,0,50,296,346,36,64,100,446,25,106,Illinois,Rockford,152871
5189,1987-1988,1987-11-20,1988-04-27,160,0,120,403,523,69,237,306,829,29,176,Illinois,Rockford,152871
5190,1988-1989,1988-11-06,1989-04-18,164,0,93,387,480,58,200,258,738,32,188,Illinois,Rockford,152871
5191,1989-1990,1989-10-19,1990-05-10,204,0,104,415,519,64,123,187,706,39,237,Illinois,Rockford,152871
5192,1990-1991,1990-11-09,1991-03-31,143,0,89,375,464,57,190,247,711,26,159,Illinois,Rockford,152871
5193,1991-1992,1991-11-02,1992-04-01,152,1,43,312,355,54,79,133,488,25,137,Illinois,Rockford,152871
5194,1992-1993,1992-10-19,1993-04-16,180,0,79,376,455,79,191,270,725,41,196,Illinois,Rockford,152871
5195,1993-1994,1993-11-05,1994-04-30,177,0,158,471,629,86,285,371,1000,43,332,Illinois,Rockford,152871
5196,1994-1995,1994-11-29,1995-03-23,115,0,97,307,404,51,217,268,672,20,130,Illinois,Rockford,152871
5197,1995-1996,1995-11-03,1996-03-26,145,0,157,482,639,45,87,132,771,27,191,Illinois,Rockford,152871
5198,2000-2001,2000-11-13,2001-04-17,156,14,141,486,627,60,387,447,1074,28,205,Illinois,Rockford,152871
5199,2004-2005,2004-11-24,2005-03-25,122,5,81,311,392,53,145,198,590,27,133,Illinois,Rockford,152871
5200,2005-2006,2005-11-16,2006-03-24,129,0,69,299,368,44,103,147,515,27,134,Illinois,Rockford,152871
5201,2006-2007,2006-11-10,2007-04-12,154,3,104,349,453,44,192,236,689,28,177,Illinois,Rockford,152871
5202,2007-2008,2007-11-21,2008-03-27,128,3,111,391,502,111,339,450,952,48,330,Illinois,Rockford,152871
5203,2008-2009,2008-11-17,2009-04-05,140,0,139,452,591,84,289,373,964,37,259,Illinois,Rockford,152871
5204,2009-2010,2009-11-26,2010-03-20,115,0,103,334,437,76,267,343,780,32,191,Illinois,Rockford,152871
5205,2010-2011,2010-12-01,2011-03-05,95,0,110,333,443,80,309,389,832,37,245,Illinois,Rockford,152871
5206,2011-2012,2011-12-01,2012-03-04,95,0,32,202,234,38,67,105,339,17,89,Illinois,Rockford,152871
5207,2012-2013,2012-12-01,2013-03-25,115,3,73,309,382,63,144,207,589,30,170,Illinois,Rockford,152871
5208,2013-2014,2013-11-11,2014-04-14,155,0,204,617,821,91,457,548,1369,48,391,Illinois,Rockford,152871
5209,2014-2015,2014-10-31,2015-03-25,146,0,138,454,592,59,230,289,881,28,233,Illinois,Rockford,152871
5210,2015-2016,2015-11-20,2016-04-08,141,0,63,231,294,41,97,138,432,26,129,Illinois,Rockford,152871
5211,2016-2017,2016-12-01,2017-03-15,105,0,68,240,308,36,90,126,434,17,91,Illinois,Rockford,152871
5212,2017-2018,2017-11-10,2018-04-19,161,0,116,421,537,56,124,180,717,32,219,Illinois,Rockford,152871
5213,2018-2019,2018-11-09,2019-04-28,171,0,120,402,522,85,213,298,820,34,273,Illinois,Rockford,152871
5214,2019-2020,2019-10-29,2020-04-17,172,0,44,282,326,57,119,176,502,32,128,Illinois,Rockford,152871
5215,1958-1959,1958-11-28,1959-02-28,93,5,41,241,282,13,14,27,309,4,26,Illinois,Salem,137
5216,1959-1960,1959-11-17,1960-03-26,131,10,34,243,277,34,82,116,393,9,58,Illinois,Salem,137
5217,1960-1961,1960-12-01,1961-04-15,136,0,33,232,265,18,41,59,324,9,55,Illinois,Salem,137
5218,1962-1963,1962-12-01,1963-03-02,92,1,57,283,340,20,22,42,382,8,61,Illinois,Salem,137
5219,1963-1964,1963-12-01,1964-03-10,101,0,42,238,280,25,73,98,378,7,51,Illinois,Salem,137
5220,1964-1965,1964-11-21,1965-03-26,126,0,44,278,322,32,57,89,411,12,93,Illinois,Salem,137
5221,1965-1966,1965-11-29,1966-03-06,98,1,36,203,239,14,31,45,284,1,18,Illinois,Salem,137
5222,1967-1968,1967-12-01,1968-03-13,104,3,39,243,282,17,47,64,346,7,46,Illinois,Salem,137
5223,1968-1969,1968-12-01,1969-03-11,101,0,26,200,226,13,10,23,249,4,22,Illinois,Salem,137
5224,1969-1970,1969-12-01,1970-03-29,119,3,52,277,329,38,119,157,486,16,86,Illinois,Salem,137
5225,1970-1971,1970-11-23,1971-04-07,136,1,33,233,266,17,16,33,299,4,24,Illinois,Salem,137
5226,1971-1972,1971-11-23,1972-02-29,99,2,25,165,190,9,12,21,211,4,21,Illinois,Salem,137
5227,1972-1973,1972-12-01,1973-04-09,130,3,33,163,196,5,3,8,204,3,10,Illinois,Salem,137
5228,1974-1975,1974-12-01,1975-03-14,104,0,10,141,151,16,9,25,176,6,25,Illinois,Salem,137
5229,1975-1976,1975-11-26,1976-02-29,96,1,23,166,189,25,32,57,246,9,47,Illinois,Salem,137
5230,1976-1977,1976-11-24,1977-03-01,98,1,76,336,412,36,182,218,630,19,125,Illinois,Salem,137
5231,1977-1978,1977-11-26,1978-03-17,112,0,85,355,440,47,222,269,709,22,129,Illinois,Salem,137
5232,1978-1979,1978-12-01,1979-03-25,115,0,73,326,399,38,201,239,638,17,138,Illinois,Salem,137
5233,1979-1980,1979-11-29,1980-03-13,106,1,33,220,253,21,76,97,350,10,61,Illinois,Salem,137
5234,1980-1981,1980-12-01,1981-02-28,90,0,26,190,216,7,7,14,230,4,23,Illinois,Salem,137
5235,1983-1984,1983-12-01,1984-03-21,112,6,74,258,332,43,96,139,471,15,97,Illinois,Salem,137
5236,1984-1985,1984-11-18,1985-02-28,103,1,44,230,274,26,45,71,345,16,91,Illinois,Salem,137
5237,1985-1986,1985-12-01,1986-02-28,90,5,39,217,256,12,15,27,283,6,44,Illinois,Salem,137
5238,1986-1987,1986-11-13,1987-02-28,108,11,17,154,171,20,30,50,221,9,41,Illinois,Salem,137
5239,1987-1988,1987-12-01,1988-03-18,109,1,34,228,262,16,14,30,292,8,48,Illinois,Salem,137
5240,1989-1990,1989-12-01,1990-03-24,114,2,45,210,255,26,48,74,329,7,58,Illinois,Salem,137
5241,1990-1991,1990-12-01,1991-02-28,90,5,20,134,154,16,67,83,237,5,36,Illinois,Salem,137
5242,1991-1992,1991-11-03,1992-03-10,129,3,10,140,150,9,5,14,164,5,25,Illinois,Salem,137
5243,1992-1993,1992-11-14,1993-03-14,121,1,23,192,215,29,56,85,300,7,50,Illinois,Salem,137
5244,1996-1997,1996-12-01,1997-02-28,90,16,40,171,211,17,68,85,296,9,52,Illinois,Salem,137
5245,1997-1998,1997-11-14,1998-03-13,120,19,16,113,129,17,11,28,157,7,30,Illinois,Salem,137
5246,1998-1999,1998-12-01,1999-02-28,90,6,35,149,184,16,60,76,260,6,50,Illinois,Salem,137
5247,1999-2000,1999-12-01,2000-03-14,105,8,20,172,192,18,16,34,226,3,32,Illinois,Salem,137
5248,2000-2001,2000-11-22,2001-02-28,99,6,68,257,325,32,130,162,487,13,99,Illinois,Salem,137
5249,2001-2002,2001-12-01,2002-03-05,95,1,20,146,166,11,7,18,184,6,28,Illinois,Salem,137
5250,2002-2003,2002-12-01,2003-03-11,101,11,47,241,288,39,63,102,390,9,73,Illinois,Salem,137
5251,2003-2004,2003-11-29,2004-02-29,93,2,39,184,223,14,18,32,255,8,56,Illinois,Salem,137
5252,2004-2005,2004-12-01,2005-03-01,91,7,28,150,178,17,37,54,232,9,42,Illinois,Salem,137
5253,2005-2006,2005-12-01,2006-03-22,112,9,21,159,180,22,20,42,222,9,47,Illinois,Salem,137
5254,2006-2007,2006-12-01,2007-04-08,129,4,40,198,238,12,16,28,266,5,35,Illinois,Salem,137
5255,2007-2008,2007-12-01,2008-03-09,100,15,36,214,250,21,36,57,307,10,49,Illinois,Salem,137
5256,2008-2009,2008-12-01,2009-03-13,103,4,49,239,288,13,39,52,340,4,35,Illinois,Salem,137
5257,2009-2010,2009-12-01,2010-02-28,90,0,55,217,272,13,24,37,309,5,30,Illinois,Salem,137
5258,2013-2014,2013-11-25,2014-03-04,100,4,83,332,415,46,104,150,565,11,97,Illinois,Salem,137
5259,2014-2015,2014-11-14,2015-03-08,115,15,57,282,339,18,74,92,431,8,63,Illinois,Salem,137
5260,2015-2016,2015-12-01,2016-02-29,91,3,27,121,148,16,22,38,186,6,38,Illinois,Salem,137
5261,2016-2017,2016-12-01,2017-03-15,105,2,38,175,213,2,2,4,217,2,16,Illinois,Salem,137
5262,2017-2018,2017-12-01,2018-02-28,90,6,56,211,267,3,7,10,277,2,10,Illinois,Salem,137
5263,2018-2019,2018-11-14,2019-03-07,114,2,40,207,247,14,18,32,279,5,43,Illinois,Salem,137
5264,2019-2020,2019-11-12,2020-02-29,110,1,18,138,156,8,11,19,175,4,17,Illinois,Salem,137
5265,1950-1951,1950-11-10,1951-04-16,158,0,93,354,447,48,85,133,580,29,166,Illinois,Springfield,159498
5266,1951-1952,1951-11-02,1952-03-08,128,0,45,261,306,46,76,122,428,25,129,Illinois,Springfield,159498
5267,1952-1953,1952-11-27,1953-04-18,143,0,26,166,192,24,24,48,240,11,57,Illinois,Springfield,159498
5268,1953-1954,1953-11-25,1954-03-14,110,0,31,203,234,12,11,23,257,9,32,Illinois,Springfield,159498
5269,1954-1955,1954-11-01,1955-03-28,148,0,39,235,274,26,28,54,328,20,95,Illinois,Springfield,159498
5270,1955-1956,1955-11-18,1956-03-16,120,0,42,274,316,38,59,97,413,24,112,Illinois,Springfield,159498
5271,1956-1957,1956-11-22,1957-04-11,141,0,50,241,291,28,34,62,353,18,86,Illinois,Springfield,159498
5272,1957-1958,1957-11-29,1958-03-11,103,0,62,235,297,22,12,34,331,15,56,Illinois,Springfield,159498
5273,1958-1959,1958-11-26,1959-03-16,111,0,80,297,377,18,43,61,438,13,70,Illinois,Springfield,159498
5274,1959-1960,1959-11-06,1960-03-27,143,0,75,331,406,60,206,266,672,27,169,Illinois,Springfield,159498
5275,1960-1961,1960-11-09,1961-04-17,160,0,65,304,369,31,87,118,487,14,99,Illinois,Springfield,159498
5276,1961-1962,1961-11-18,1962-04-13,147,0,84,315,399,67,108,175,574,35,189,Illinois,Springfield,159498
5277,1962-1963,1962-12-01,1963-03-06,96,0,114,369,483,37,90,127,610,20,151,Illinois,Springfield,159498
5278,1963-1964,1963-12-01,1964-03-29,120,0,70,319,389,54,111,165,554,23,114,Illinois,Springfield,159498
5279,1964-1965,1964-11-19,1965-03-27,129,0,83,329,412,59,95,154,566,26,182,Illinois,Springfield,159498
5280,1965-1966,1965-11-29,1966-03-07,99,0,62,238,300,24,27,51,351,13,61,Illinois,Springfield,159498
5281,1966-1967,1966-11-27,1967-04-23,148,0,59,244,303,25,27,52,355,16,72,Illinois,Springfield,159498
5282,1967-1968,1967-10-27,1968-03-21,147,0,74,315,389,45,97,142,531,23,123,Illinois,Springfield,159498
5283,1968-1969,1968-11-09,1969-03-30,142,0,66,303,369,37,60,97,466,16,87,Illinois,Springfield,159498
5284,1969-1970,1969-11-14,1970-04-02,140,0,94,331,425,46,119,165,590,34,173,Illinois,Springfield,159498
5285,1970-1971,1970-11-23,1971-04-06,135,0,61,278,339,25,19,44,383,18,71,Illinois,Springfield,159498
5286,1971-1972,1971-11-08,1972-03-30,144,0,59,246,305,35,55,90,395,19,106,Illinois,Springfield,159498
5287,1972-1973,1972-11-14,1973-04-10,148,0,57,233,290,24,16,40,330,20,79,Illinois,Springfield,159498
5288,1973-1974,1973-11-08,1974-04-05,149,0,75,263,338,59,135,194,532,24,135,Illinois,Springfield,159498
5289,1974-1975,1974-11-13,1975-04-03,142,0,33,214,247,48,46,94,341,26,103,Illinois,Springfield,159498
5290,1975-1976,1975-11-13,1976-03-16,125,0,45,225,270,41,44,85,355,19,76,Illinois,Springfield,159498
5291,1976-1977,1976-11-28,1977-04-06,130,0,121,412,533,59,197,256,789,29,213,Illinois,Springfield,159498
5292,1977-1978,1977-11-26,1978-03-27,122,0,142,452,594,82,297,379,973,37,266,Illinois,Springfield,159498
5293,1978-1979,1978-12-01,1979-03-25,115,0,134,397,531,48,254,302,833,25,200,Illinois,Springfield,159498
5294,1979-1980,1979-11-27,1980-04-15,141,0,62,279,341,50,95,145,486,23,128,Illinois,Springfield,159498
5295,1980-1981,1980-11-27,1981-03-04,98,0,52,238,290,27,41,68,358,13,84,Illinois,Springfield,159498
5296,1981-1982,1981-11-19,1982-04-09,142,0,104,379,483,72,217,289,772,27,216,Illinois,Springfield,159498
5297,1982-1983,1982-11-13,1983-04-17,156,0,32,185,217,18,11,29,246,15,55,Illinois,Springfield,159498
5298,1983-1984,1983-11-30,1984-03-18,110,0,124,333,457,54,160,214,671,25,204,Illinois,Springfield,159498
5299,1984-1985,1984-11-17,1985-02-28,104,0,79,296,375,26,105,131,506,18,105,Illinois,Springfield,159498
5300,1985-1986,1985-11-20,1986-04-15,147,0,74,319,393,36,47,83,476,19,113,Illinois,Springfield,159498
5301,1986-1987,1986-11-11,1987-02-28,110,0,35,190,225,33,66,99,324,11,67,Illinois,Springfield,159498
5302,1987-1988,1987-11-29,1988-03-18,111,0,62,251,313,34,76,110,423,16,79,Illinois,Springfield,159498
5303,1988-1989,1988-11-21,1989-03-09,109,0,57,253,310,36,92,128,438,15,101,Illinois,Springfield,159498
5304,1989-1990,1989-10-19,1990-03-24,157,0,64,268,332,20,40,60,392,17,107,Illinois,Springfield,159498
5305,1990-1991,1990-12-01,1991-03-14,104,0,57,216,273,33,61,94,367,19,126,Illinois,Springfield,159498
5306,1991-1992,1991-11-02,1992-03-14,134,0,27,185,212,21,25,46,258,16,69,Illinois,Springfield,159498
5307,1992-1993,1992-11-07,1993-04-01,146,0,42,223,265,50,82,132,397,25,111,Illinois,Springfield,159498
5308,1993-1994,1993-10-30,1994-04-06,159,0,78,290,368,31,54,85,453,23,120,Illinois,Springfield,159498
5309,1994-1995,1994-12-01,1995-03-08,98,0,41,200,241,17,27,44,285,11,50,Illinois,Springfield,159498
5310,1995-1996,1995-11-11,1996-03-20,131,0,90,341,431,34,76,110,541,16,108,Illinois,Springfield,159498
5311,1996-1997,1996-11-12,1997-03-15,124,0,79,275,354,31,84,115,469,11,75,Illinois,Springfield,159498
5312,1997-1998,1997-11-13,1998-03-20,128,0,29,158,187,34,36,70,257,21,76,Illinois,Springfield,159498
5313,1998-1999,1998-12-01,1999-03-12,102,0,47,199,246,44,114,158,404,13,113,Illinois,Springfield,159498
5314,1999-2000,1999-12-01,2000-03-12,103,0,26,193,219,26,49,75,294,12,66,Illinois,Springfield,159498
5315,2000-2001,2000-11-17,2001-03-16,120,0,84,339,423,24,139,163,586,17,118,Illinois,Springfield,159498
5316,2001-2002,2001-12-01,2002-03-26,116,0,22,181,203,18,14,32,235,8,34,Illinois,Springfield,159498
5317,2002-2003,2002-12-01,2003-03-10,100,0,63,276,339,40,63,103,442,16,103,Illinois,Springfield,159498
5318,2003-2004,2003-12-01,2004-03-17,108,0,51,219,270,26,57,83,353,18,99,Illinois,Springfield,159498
5319,2004-2005,2004-11-24,2005-03-11,108,0,36,176,212,28,28,56,268,15,65,Illinois,Springfield,159498
5320,2005-2006,2005-11-17,2006-03-23,127,0,39,206,245,35,59,94,339,13,74,Illinois,Springfield,159498
5321,2006-2007,2006-11-30,2007-03-03,94,0,58,221,279,36,109,145,424,13,88,Illinois,Springfield,159498
5322,2007-2008,2007-11-22,2008-03-23,123,0,50,256,306,61,63,124,430,24,142,Illinois,Springfield,159498
5323,2008-2009,2008-11-21,2009-04-06,137,0,57,276,333,30,34,64,397,18,102,Illinois,Springfield,159498
5324,2009-2010,2009-12-01,2010-02-28,90,0,67,248,315,36,115,151,466,21,103,Illinois,Springfield,159498
5325,2010-2011,2010-12-01,2011-02-28,90,0,67,243,310,52,160,212,522,21,142,Illinois,Springfield,159498
5326,2011-2012,2011-12-01,2012-03-05,96,0,9,131,140,15,16,31,171,9,38,Illinois,Springfield,159498
5327,2012-2013,2012-12-01,2013-03-28,118,0,31,219,250,49,55,104,354,16,80,Illinois,Springfield,159498
5328,2013-2014,2013-11-11,2014-04-14,155,0,102,441,543,65,171,236,779,30,196,Illinois,Springfield,159498
5329,2014-2015,2014-11-12,2015-03-08,117,0,60,311,371,50,106,156,527,20,150,Illinois,Springfield,159498
5330,2015-2016,2015-11-21,2016-03-01,102,0,30,147,177,23,43,66,243,12,69,Illinois,Springfield,159498
5331,2016-2017,2016-12-01,2017-03-15,105,0,31,154,185,17,14,31,216,8,45,Illinois,Springfield,159498
5332,2017-2018,2017-12-01,2018-04-09,130,0,67,283,350,20,40,60,410,12,85,Illinois,Springfield,159498
5333,2018-2019,2018-11-08,2019-04-14,158,0,58,292,350,46,89,135,485,16,95,Illinois,Springfield,159498
5334,2019-2020,2019-10-31,2020-04-16,169,0,29,205,234,43,58,101,335,19,80,Illinois,Springfield,159498
5335,1950-1951,1950-11-04,1951-04-01,149,1,100,369,469,73,233,306,775,24,174,Indiana,Angola,8612
5336,1952-1953,1952-11-28,1953-03-25,118,5,57,237,294,44,67,111,405,14,101,Indiana,Angola,8612
5337,1953-1954,1953-11-30,1954-04-04,126,3,60,281,341,48,94,142,483,15,106,Indiana,Angola,8612
5338,1954-1955,1954-11-02,1955-03-29,148,6,73,330,403,41,107,148,551,16,109,Indiana,Angola,8612
5339,1955-1956,1955-11-18,1956-04-08,143,0,73,382,455,47,121,168,623,24,135,Indiana,Angola,8612
5340,1956-1957,1956-11-24,1957-04-13,141,4,76,330,406,62,164,226,632,23,147,Indiana,Angola,8612
5341,1957-1958,1957-11-10,1958-03-25,136,0,89,326,415,38,153,191,606,19,95,Indiana,Angola,8612
5342,1958-1959,1958-11-27,1959-03-18,112,15,113,414,527,29,242,271,798,13,103,Indiana,Angola,8612
5343,1959-1960,1959-11-07,1960-04-05,151,0,93,360,453,58,199,257,710,30,159,Indiana,Angola,8612
5344,1960-1961,1960-11-30,1961-04-18,140,8,95,362,457,55,182,237,694,17,122,Indiana,Angola,8612
5345,1961-1962,1961-11-20,1962-03-18,119,6,117,367,484,61,276,337,821,28,192,Indiana,Angola,8612
5346,1962-1963,1962-10-25,1963-05-01,189,0,162,491,653,100,542,642,1295,45,328,Indiana,Angola,8612
5347,1963-1964,1963-11-02,1964-04-01,152,1,87,370,457,70,172,242,699,42,202,Indiana,Angola,8612
5348,1964-1965,1964-11-19,1965-04-02,135,1,112,404,516,88,186,274,790,45,268,Indiana,Angola,8612
5349,1965-1966,1965-11-19,1966-05-12,175,0,81,342,423,50,88,138,561,36,182,Indiana,Angola,8612
5350,1966-1967,1966-11-02,1967-04-24,174,1,87,374,461,92,285,377,838,47,261,Indiana,Angola,8612
5351,1967-1968,1967-09-30,1968-03-24,177,1,104,394,498,42,100,142,640,18,116,Indiana,Angola,8612
5352,1977-1978,1977-11-26,1978-03-26,121,0,158,594,752,84,586,670,1422,26,244,Indiana,Angola,8612
5353,1978-1979,1978-11-22,1979-04-07,137,0,143,469,612,39,260,299,911,26,172,Indiana,Angola,8612
5354,1979-1980,1979-11-28,1980-03-14,108,2,82,376,458,30,110,140,598,21,135,Indiana,Angola,8612
5355,1980-1981,1980-10-28,1981-03-21,145,0,105,457,562,45,294,339,901,22,142,Indiana,Angola,8612
5356,1981-1982,1981-11-21,1982-04-12,143,6,123,519,642,105,531,636,1278,33,317,Indiana,Angola,8612
5357,1982-1983,1982-11-06,1983-04-19,165,2,53,291,344,28,60,88,432,12,66,Indiana,Angola,8612
5358,1983-1984,1983-11-11,1984-03-23,134,0,149,474,623,73,381,454,1077,25,195,Indiana,Angola,8612
5359,1984-1985,1984-11-11,1985-04-09,150,9,96,393,489,38,185,223,712,23,153,Indiana,Angola,8612
5360,1985-1986,1985-11-21,1986-03-21,121,0,121,397,518,48,238,286,804,24,178,Indiana,Angola,8612
5361,1986-1987,1986-11-13,1987-03-15,123,3,57,301,358,50,180,230,588,18,120,Indiana,Angola,8612
5362,1987-1988,1987-11-21,1988-03-21,122,0,101,341,442,44,145,189,631,19,124,Indiana,Angola,8612
5363,1989-1990,1989-10-19,1990-04-12,176,1,92,366,458,43,134,177,635,26,156,Indiana,Angola,8612
5364,1990-1991,1990-12-01,1991-03-10,100,1,63,266,329,36,67,103,432,21,128,Indiana,Angola,8612
5365,1991-1992,1991-11-03,1992-04-03,153,2,53,326,379,40,113,153,532,19,116,Indiana,Angola,8612
5366,1992-1993,1992-10-20,1993-03-23,155,2,77,343,420,70,217,287,707,33,175,Indiana,Angola,8612
5367,1993-1994,1993-11-29,1994-04-07,130,0,141,454,595,62,289,351,946,24,211,Indiana,Angola,8612
5368,1994-1995,1994-12-01,1995-04-05,126,7,79,300,379,26,133,159,538,11,79,Indiana,Angola,8612
5369,1995-1996,1995-11-04,1996-04-16,165,0,139,500,639,63,123,186,825,33,233,Indiana,Angola,8612
5370,1996-1997,1996-11-03,1997-04-09,158,2,105,371,476,59,138,197,673,29,198,Indiana,Angola,8612
5371,1997-1998,1997-11-14,1998-03-21,128,1,44,210,254,29,65,94,348,14,67,Indiana,Angola,8612
5372,1998-1999,1998-12-01,1999-03-17,107,1,70,299,369,72,224,296,665,21,197,Indiana,Angola,8612
5373,1999-2000,1999-12-01,2000-04-08,130,0,68,314,382,40,154,194,576,22,151,Indiana,Angola,8612
5374,2000-2001,2000-11-17,2001-03-27,131,0,111,411,522,69,440,509,1031,37,251,Indiana,Angola,8612
5375,2001-2002,2001-12-01,2002-03-29,119,0,45,237,282,34,65,99,381,17,98,Indiana,Angola,8612
5376,2002-2003,2002-11-22,2003-04-08,138,0,112,429,541,61,195,256,797,29,205,Indiana,Angola,8612
5377,2003-2004,2003-11-25,2004-03-22,119,0,95,345,440,48,267,315,755,25,149,Indiana,Angola,8612
5378,2004-2005,2004-11-25,2005-04-24,151,0,84,359,443,71,207,278,721,30,203,Indiana,Angola,8612
5379,2005-2006,2005-11-18,2006-03-18,121,0,67,271,338,43,145,188,526,19,109,Indiana,Angola,8612
5380,2006-2007,2006-11-03,2007-04-15,164,1,101,358,459,45,174,219,678,21,144,Indiana,Angola,8612
5381,2007-2008,2007-11-24,2008-03-29,127,1,92,361,453,96,221,317,770,30,235,Indiana,Angola,8612
5382,2008-2009,2008-11-11,2009-04-07,148,3,115,457,572,75,243,318,890,31,234,Indiana,Angola,8612
5383,2009-2010,2009-11-27,2010-03-08,102,6,83,293,376,60,244,304,680,29,177,Indiana,Angola,8612
5384,2010-2011,2010-11-27,2011-03-06,100,0,103,352,455,81,299,380,835,34,261,Indiana,Angola,8612
5385,2011-2012,2011-11-11,2012-03-06,117,4,27,195,222,33,34,67,289,17,70,Indiana,Angola,8612
5386,2012-2013,2012-11-25,2013-04-20,147,0,71,297,368,43,112,155,523,25,153,Indiana,Angola,8612
5387,2013-2014,2013-11-12,2014-04-15,155,0,172,569,741,110,592,702,1443,37,334,Indiana,Angola,8612
5388,2014-2015,2014-11-13,2015-03-28,136,1,143,485,628,50,293,343,971,19,186,Indiana,Angola,8612
5389,2015-2016,2015-11-22,2016-04-10,141,0,41,231,272,53,77,130,402,22,144,Indiana,Angola,8612
5390,2016-2017,2016-11-21,2017-03-18,118,0,68,253,321,43,95,138,459,26,161,Indiana,Angola,8612
5391,2017-2018,2017-11-11,2018-04-19,160,0,109,392,501,61,183,244,745,40,280,Indiana,Angola,8612
5392,2018-2019,2018-11-09,2019-04-15,158,7,111,369,480,57,106,163,643,34,204,Indiana,Angola,8612
5393,2019-2020,2019-11-12,2020-04-18,159,8,44,257,301,52,102,154,455,31,153,Indiana,Angola,8612
5394,1952-1953,1952-11-30,1953-04-19,141,3,12,149,161,27,22,49,210,7,44,Indiana,Columbus,787033
5395,1953-1954,1953-12-01,1954-03-15,105,2,23,176,199,6,18,24,223,2,14,Indiana,Columbus,787033
5396,1954-1955,1954-11-03,1955-03-27,145,18,31,218,249,6,7,13,262,5,19,Indiana,Columbus,787033
5397,1957-1958,1957-12-01,1958-03-14,104,16,41,236,277,14,1,15,292,6,23,Indiana,Columbus,787033
5398,1964-1965,1964-11-22,1965-03-27,126,7,39,306,345,48,46,94,439,13,118,Indiana,Columbus,787033
5399,1966-1967,1966-11-03,1967-03-18,136,0,32,266,298,25,18,43,341,8,53,Indiana,Columbus,787033
5400,1982-1983,1982-11-25,1983-02-28,96,11,15,134,149,1,0,1,150,1,6,Indiana,Columbus,787033
5401,1989-1990,1989-10-19,1990-03-25,158,5,56,259,315,23,79,102,417,8,57,Indiana,Columbus,787033
5402,1990-1991,1990-12-01,1991-02-28,90,2,28,163,191,14,15,29,220,5,34,Indiana,Columbus,787033
5403,1991-1992,1991-11-04,1992-04-02,151,15,18,205,223,13,13,26,249,8,40,Indiana,Columbus,787033
5404,1992-1993,1992-11-28,1993-03-15,108,14,32,208,240,24,44,68,308,6,40,Indiana,Columbus,787033
5405,1993-1994,1993-10-30,1994-03-10,132,0,68,258,326,26,56,82,408,10,75,Indiana,Columbus,787033
5406,1994-1995,1994-12-01,1995-03-09,99,3,32,185,217,20,42,62,279,10,62,Indiana,Columbus,787033
5407,1995-1996,1995-12-01,1996-03-24,115,0,78,300,378,62,137,199,577,15,128,Indiana,Columbus,787033
5408,1996-1997,1996-11-14,1997-02-28,107,4,51,199,250,19,55,74,324,7,38,Indiana,Columbus,787033
5409,1997-1998,1997-12-01,1998-03-13,103,2,11,114,125,14,27,41,166,6,31,Indiana,Columbus,787033
5410,1998-1999,1998-12-01,1999-03-11,101,5,32,180,212,27,75,102,314,9,72,Indiana,Columbus,787033
5411,1999-2000,1999-12-01,2000-03-12,103,15,29,182,211,18,43,61,272,10,53,Indiana,Columbus,787033
5412,2000-2001,2000-11-21,2001-02-28,100,12,47,238,285,17,80,97,382,8,52,Indiana,Columbus,787033
5413,2001-2002,2001-12-01,2002-03-05,95,1,15,134,149,8,7,15,164,4,14,Indiana,Columbus,787033
5414,2002-2003,2002-12-01,2003-03-11,101,10,45,250,295,54,82,136,431,20,118,Indiana,Columbus,787033
5415,2003-2004,2003-11-25,2004-03-16,113,3,43,207,250,22,76,98,348,10,58,Indiana,Columbus,787033
5416,2004-2005,2004-12-01,2005-03-11,101,1,32,185,217,37,65,102,319,9,72,Indiana,Columbus,787033
5417,2005-2006,2005-11-24,2006-03-22,119,4,23,173,196,25,37,62,258,9,47,Indiana,Columbus,787033
5418,2006-2007,2006-12-01,2007-02-28,90,3,43,192,235,23,68,91,326,12,73,Indiana,Columbus,787033
5419,2007-2008,2007-12-01,2008-03-11,102,1,35,201,236,30,29,59,295,18,97,Indiana,Columbus,787033
5420,2008-2009,2008-11-23,2009-03-04,102,5,54,266,320,25,45,70,390,14,84,Indiana,Columbus,787033
5421,2009-2010,2009-12-01,2010-02-28,90,4,48,221,269,37,101,138,407,19,105,Indiana,Columbus,787033
5422,2012-2013,2012-12-01,2013-03-26,116,0,18,176,194,29,70,99,293,13,58,Indiana,Columbus,787033
5423,2014-2015,2014-11-17,2015-03-07,111,1,46,267,313,24,84,108,421,12,90,Indiana,Columbus,787033
5424,2015-2016,2015-12-01,2016-02-29,91,2,20,131,151,13,14,27,178,8,47,Indiana,Columbus,787033
5425,2016-2017,2016-12-01,2017-03-14,104,0,20,134,154,7,5,12,166,5,25,Indiana,Columbus,787033
5426,2017-2018,2017-12-01,2018-04-09,130,6,42,228,270,26,30,56,326,16,73,Indiana,Columbus,787033
5427,2018-2019,2018-11-28,2019-03-08,101,0,28,169,197,21,27,48,245,9,57,Indiana,Columbus,787033
5428,2019-2020,2019-11-12,2020-02-29,110,0,9,130,139,11,6,17,156,9,28,Indiana,Columbus,787033
5429,1950-1951,1950-11-23,1951-03-19,117,0,52,234,286,39,48,87,373,20,130,Indiana,Evansville,117429
5430,1951-1952,1951-11-02,1952-03-04,124,0,14,148,162,20,0,20,182,13,47,Indiana,Evansville,117429
5431,1952-1953,1952-11-28,1953-04-18,142,0,6,90,96,19,8,27,123,9,34,Indiana,Evansville,117429
5432,1953-1954,1953-12-01,1954-03-03,93,0,15,122,137,10,10,20,157,5,24,Indiana,Evansville,117429
5433,1954-1955,1954-12-01,1955-03-26,116,0,22,143,165,16,11,27,192,10,28,Indiana,Evansville,117429
5434,1955-1956,1955-11-28,1956-02-29,94,0,16,152,168,11,28,39,207,6,29,Indiana,Evansville,117429
5435,1956-1957,1956-11-22,1957-02-28,99,0,18,111,129,8,1,9,138,7,24,Indiana,Evansville,117429
5436,1957-1958,1957-12-01,1958-03-17,107,0,33,182,215,18,2,20,235,11,38,Indiana,Evansville,117429
5437,1958-1959,1958-11-28,1959-02-28,93,0,36,206,242,15,22,37,279,6,43,Indiana,Evansville,117429
5438,1959-1960,1959-11-17,1960-03-20,125,0,32,202,234,45,100,145,379,15,85,Indiana,Evansville,117429
5439,1960-1961,1960-12-01,1961-04-15,136,0,28,190,218,32,43,75,293,15,89,Indiana,Evansville,117429
5440,1961-1962,1961-11-19,1962-04-01,134,0,34,184,218,22,11,33,251,16,64,Indiana,Evansville,117429
5441,1962-1963,1962-12-01,1963-02-28,90,0,59,282,341,11,29,40,381,8,58,Indiana,Evansville,117429
5442,1963-1964,1963-12-01,1964-02-29,91,0,30,247,277,25,38,63,340,11,70,Indiana,Evansville,117429
5443,1964-1965,1964-11-20,1965-03-26,127,0,44,252,296,27,49,76,372,14,91,Indiana,Evansville,117429
5444,1965-1966,1965-11-29,1966-03-06,98,0,33,203,236,23,50,73,309,9,62,Indiana,Evansville,117429
5445,1966-1967,1966-11-02,1967-03-09,128,0,20,199,219,24,16,40,259,12,57,Indiana,Evansville,117429
5446,1967-1968,1967-12-01,1968-03-24,115,0,37,218,255,25,57,82,337,12,60,Indiana,Evansville,117429
5447,1968-1969,1968-11-19,1969-03-11,113,0,24,154,178,16,15,31,209,8,31,Indiana,Evansville,117429
5448,1969-1970,1969-11-14,1970-03-29,136,0,59,255,314,58,78,136,450,21,127,Indiana,Evansville,117429
5449,1970-1971,1970-11-23,1971-04-07,136,0,36,213,249,35,35,70,319,13,64,Indiana,Evansville,117429
5450,1971-1972,1971-11-06,1972-03-25,141,0,24,172,196,15,6,21,217,11,45,Indiana,Evansville,117429
5451,1972-1973,1972-11-21,1973-04-10,141,0,27,158,185,12,9,21,206,10,33,Indiana,Evansville,117429
5452,1973-1974,1973-12-01,1974-03-24,114,0,30,124,154,23,22,45,199,9,46,Indiana,Evansville,117429
5453,1974-1975,1974-12-01,1975-03-29,119,0,10,104,114,28,15,43,157,13,47,Indiana,Evansville,117429
5454,1975-1976,1975-11-26,1976-03-16,112,0,25,153,178,14,5,19,197,12,43,Indiana,Evansville,117429
5455,1976-1977,1976-11-28,1977-02-28,93,0,78,309,387,43,185,228,615,22,142,Indiana,Evansville,117429
5456,1977-1978,1977-11-26,1978-03-26,121,0,83,338,421,68,240,308,729,36,206,Indiana,Evansville,117429
5457,1978-1979,1978-12-01,1979-03-25,115,0,67,260,327,38,123,161,488,20,129,Indiana,Evansville,117429
5458,1979-1980,1979-11-29,1980-03-13,106,0,37,194,231,29,69,98,329,13,74,Indiana,Evansville,117429
5459,1980-1981,1980-11-27,1981-02-28,94,0,27,168,195,8,9,17,212,7,26,Indiana,Evansville,117429
5460,1981-1982,1981-11-20,1982-04-08,140,0,44,225,269,30,52,82,351,21,124,Indiana,Evansville,117429
5461,1982-1983,1982-12-01,1983-04-18,139,0,5,83,88,12,1,13,101,12,21,Indiana,Evansville,117429
5462,1983-1984,1983-12-01,1984-03-21,112,0,62,227,289,39,45,84,373,24,108,Indiana,Evansville,117429
5463,1984-1985,1984-12-01,1985-02-28,90,0,53,209,262,38,104,142,404,14,100,Indiana,Evansville,117429
5464,1985-1986,1985-12-01,1986-02-28,90,0,38,197,235,17,22,39,274,10,67,Indiana,Evansville,117429
5465,1986-1987,1986-11-13,1987-03-31,139,0,16,141,157,17,7,24,181,13,49,Indiana,Evansville,117429
5466,1987-1988,1987-12-01,1988-03-18,109,0,31,180,211,13,9,22,233,9,35,Indiana,Evansville,117429
5467,1988-1989,1988-12-01,1989-03-07,97,0,14,134,148,9,6,15,163,7,27,Indiana,Evansville,117429
5468,1989-1990,1989-10-19,1990-03-25,158,0,42,194,236,22,31,53,289,14,74,Indiana,Evansville,117429
5469,1990-1991,1990-12-01,1991-03-14,104,0,19,126,145,22,14,36,181,15,70,Indiana,Evansville,117429
5470,1991-1992,1991-11-03,1992-03-14,133,0,8,120,128,7,5,12,140,5,19,Indiana,Evansville,117429
5471,1992-1993,1992-11-14,1993-03-14,121,0,17,152,169,31,42,73,242,9,43,Indiana,Evansville,117429
5472,1993-1994,1993-10-29,1994-03-11,134,0,36,190,226,37,48,85,311,18,82,Indiana,Evansville,117429
5473,1994-1995,1994-12-01,1995-03-02,92,0,16,114,130,7,4,11,141,7,20,Indiana,Evansville,117429
5474,1995-1996,1995-11-11,1996-03-22,133,20,48,237,285,43,67,110,395,17,102,Indiana,Evansville,117429
5475,1996-1997,1996-12-01,1997-02-28,90,1,36,144,180,11,13,24,204,8,30,Indiana,Evansville,117429
5476,1997-1998,1997-12-01,1998-03-12,102,2,11,97,108,31,37,68,176,12,50,Indiana,Evansville,117429
5477,1998-1999,1998-12-01,1999-03-14,104,0,23,135,158,12,2,14,172,6,31,Indiana,Evansville,117429
5478,1999-2000,1999-12-01,2000-02-29,91,0,12,125,137,8,3,11,148,5,22,Indiana,Evansville,117429
5479,2000-2001,2000-11-17,2001-04-17,152,0,39,233,272,25,56,81,353,12,64,Indiana,Evansville,117429
5480,2001-2002,2001-12-01,2002-03-04,94,0,9,116,125,8,8,16,141,5,21,Indiana,Evansville,117429
5481,2002-2003,2002-12-01,2003-02-28,90,1,29,164,193,34,22,56,249,19,82,Indiana,Evansville,117429
5482,2003-2004,2003-11-28,2004-02-29,94,5,21,142,163,12,4,16,179,8,37,Indiana,Evansville,117429
5483,2004-2005,2004-12-01,2005-03-01,91,5,22,128,150,31,37,68,218,3,45,Indiana,Evansville,117429
5484,2005-2006,2005-12-01,2006-02-28,90,0,11,112,123,9,7,16,139,5,21,Indiana,Evansville,117429
5485,2006-2007,2006-12-01,2007-02-28,90,0,22,142,164,5,0,5,169,3,16,Indiana,Evansville,117429
5486,2007-2008,2007-12-01,2008-03-08,99,0,20,138,158,18,4,22,180,11,44,Indiana,Evansville,117429
5487,2008-2009,2008-12-01,2009-02-28,90,5,29,168,197,11,11,22,219,6,27,Indiana,Evansville,117429
5488,2009-2010,2009-12-01,2010-02-28,90,0,35,185,220,22,33,55,275,8,57,Indiana,Evansville,117429
5489,2010-2011,2010-12-01,2011-02-28,90,0,35,172,207,22,13,35,242,11,53,Indiana,Evansville,117429
5490,2011-2012,2011-11-29,2012-02-29,93,0,4,89,93,3,0,3,96,3,7,Indiana,Evansville,117429
5491,2012-2013,2012-12-01,2013-02-28,90,0,9,111,120,18,26,44,164,6,28,Indiana,Evansville,117429
5492,2013-2014,2013-11-27,2014-03-25,119,0,40,243,283,21,31,52,335,11,50,Indiana,Evansville,117429
5493,2014-2015,2014-11-13,2015-03-07,115,0,33,199,232,28,46,74,306,9,60,Indiana,Evansville,117429
5494,2015-2016,2015-12-01,2016-02-29,91,0,11,90,101,21,25,46,147,9,44,Indiana,Evansville,117429
5495,2016-2017,2016-12-01,2017-03-13,103,0,13,101,114,3,0,3,117,3,9,Indiana,Evansville,117429
5496,2017-2018,2017-12-01,2018-04-07,128,1,42,185,227,17,19,36,263,7,32,Indiana,Evansville,117429
5497,2018-2019,2018-11-13,2019-03-06,114,0,20,137,157,16,9,25,182,12,46,Indiana,Evansville,117429
5498,2019-2020,2019-11-11,2020-02-29,111,0,9,104,113,2,1,3,116,1,4,Indiana,Evansville,117429
5499,1950-1951,1950-11-03,1951-03-31,149,0,99,364,463,76,161,237,700,41,242,Indiana,Fort Wayne,253691
5500,1951-1952,1951-11-03,1952-04-06,156,0,55,289,344,55,98,153,497,30,153,Indiana,Fort Wayne,253691
5501,1952-1953,1952-10-28,1953-04-20,175,0,41,223,264,40,39,79,343,25,115,Indiana,Fort Wayne,253691
5502,1953-1954,1953-11-26,1954-03-30,125,0,36,221,257,43,28,71,328,24,99,Indiana,Fort Wayne,253691
5503,1954-1955,1954-10-30,1955-03-29,151,0,50,281,331,51,51,102,433,34,152,Indiana,Fort Wayne,253691
5504,1955-1956,1955-11-17,1956-04-24,160,0,49,332,381,64,100,164,545,35,144,Indiana,Fort Wayne,253691
5505,1956-1957,1956-11-21,1957-04-12,143,0,60,275,335,66,124,190,525,41,175,Indiana,Fort Wayne,253691
5506,1957-1958,1957-10-27,1958-04-07,163,0,64,286,350,32,33,65,415,29,99,Indiana,Fort Wayne,253691
5507,1958-1959,1958-11-27,1959-03-27,121,0,102,382,484,49,104,153,637,33,214,Indiana,Fort Wayne,253691
5508,1959-1960,1959-11-06,1960-04-09,156,0,72,335,407,59,121,180,587,37,174,Indiana,Fort Wayne,253691
5509,1960-1961,1960-11-06,1961-04-17,163,0,82,317,399,52,65,117,516,30,169,Indiana,Fort Wayne,253691
5510,1961-1962,1961-11-19,1962-04-13,146,0,94,331,425,53,103,156,581,32,180,Indiana,Fort Wayne,253691
5511,1962-1963,1962-10-25,1963-03-21,148,0,136,453,589,53,137,190,779,39,265,Indiana,Fort Wayne,253691
5512,1963-1964,1963-11-02,1964-03-30,150,0,83,342,425,82,140,222,647,43,218,Indiana,Fort Wayne,253691
5513,1964-1965,1964-11-19,1965-04-01,134,0,95,362,457,62,124,186,643,33,198,Indiana,Fort Wayne,253691
5514,1965-1966,1965-11-18,1966-04-06,140,0,66,274,340,29,28,57,397,23,116,Indiana,Fort Wayne,253691
5515,1966-1967,1966-11-02,1967-04-24,174,0,79,323,402,76,115,191,593,44,225,Indiana,Fort Wayne,253691
5516,1967-1968,1967-11-05,1968-04-24,172,0,96,386,482,46,107,153,635,29,167,Indiana,Fort Wayne,253691
5517,1968-1969,1968-12-01,1969-04-19,140,0,75,307,382,29,35,64,446,25,103,Indiana,Fort Wayne,253691
5518,1969-1970,1969-11-14,1970-04-02,140,0,110,385,495,64,160,224,719,41,217,Indiana,Fort Wayne,253691
5519,1970-1971,1970-11-14,1971-04-02,140,0,80,319,399,48,47,95,494,31,152,Indiana,Fort Wayne,253691
5520,1971-1972,1971-11-09,1972-04-08,152,0,66,308,374,48,49,97,471,36,145,Indiana,Fort Wayne,253691
5521,1972-1973,1972-10-18,1973-04-12,177,0,50,247,297,54,40,94,391,27,102,Indiana,Fort Wayne,253691
5522,1973-1974,1973-12-01,1974-04-08,129,0,76,289,365,64,168,232,597,30,179,Indiana,Fort Wayne,253691
5523,1974-1975,1974-10-19,1975-04-03,167,0,48,258,306,69,71,140,446,43,173,Indiana,Fort Wayne,253691
5524,1975-1976,1975-11-24,1976-03-17,115,0,58,246,304,44,117,161,465,20,102,Indiana,Fort Wayne,253691
5525,1976-1977,1976-11-04,1977-04-06,154,0,156,482,638,70,219,289,927,43,285,Indiana,Fort Wayne,253691
5526,1977-1978,1977-11-11,1978-04-21,162,0,158,513,671,95,499,594,1265,46,329,Indiana,Fort Wayne,253691
5527,1978-1979,1978-11-26,1979-03-26,121,0,123,371,494,55,216,271,765,33,197,Indiana,Fort Wayne,253691
5528,1979-1980,1979-11-27,1980-04-15,141,0,94,311,405,46,92,138,543,27,149,Indiana,Fort Wayne,253691
5529,1980-1981,1980-10-27,1981-03-20,145,0,85,319,404,62,178,240,644,32,170,Indiana,Fort Wayne,253691
5530,1981-1982,1981-11-20,1982-04-11,143,0,133,414,547,117,415,532,1079,47,352,Indiana,Fort Wayne,253691
5531,1982-1983,1982-11-29,1983-04-18,141,0,35,162,197,29,32,61,258,20,73,Indiana,Fort Wayne,253691
5532,1983-1984,1983-11-11,1984-04-17,159,0,119,365,484,79,248,327,811,40,237,Indiana,Fort Wayne,253691
5533,1984-1985,1984-11-11,1985-04-08,149,0,91,302,393,54,213,267,660,31,193,Indiana,Fort Wayne,253691
5534,1985-1986,1985-11-27,1986-04-15,140,0,94,325,419,55,123,178,597,34,180,Indiana,Fort Wayne,253691
5535,1986-1987,1986-11-11,1987-03-30,140,0,43,239,282,44,78,122,404,23,108,Indiana,Fort Wayne,253691
5536,1987-1988,1987-11-20,1988-03-20,122,0,76,299,375,57,86,143,518,31,160,Indiana,Fort Wayne,253691
5537,1988-1989,1988-11-06,1989-03-31,146,0,59,283,342,38,67,105,447,23,123,Indiana,Fort Wayne,253691
5538,1989-1990,1989-10-19,1990-02-28,133,0,66,254,320,43,66,109,429,28,174,Indiana,Fort Wayne,253691
5539,1990-1991,1990-12-01,1991-03-14,104,0,46,212,258,49,75,124,382,26,131,Indiana,Fort Wayne,253691
5540,1991-1992,1991-11-03,1992-04-01,151,0,34,229,263,44,64,108,371,29,134,Indiana,Fort Wayne,253691
5541,1992-1993,1992-10-20,1993-04-17,180,0,55,272,327,75,146,221,548,45,185,Indiana,Fort Wayne,253691
5542,1993-1994,1993-10-30,1994-04-07,160,0,90,338,428,70,114,184,612,38,233,Indiana,Fort Wayne,253691
5543,1994-1995,1994-11-01,1995-04-02,153,0,56,256,312,25,56,81,393,18,83,Indiana,Fort Wayne,253691
5544,1995-1996,1995-11-08,1996-04-06,151,0,97,385,482,69,176,245,727,42,243,Indiana,Fort Wayne,253691
5545,1996-1997,1996-11-09,1997-04-11,154,0,89,306,395,68,129,197,592,36,202,Indiana,Fort Wayne,253691
5546,1997-1998,1997-11-03,1998-03-21,139,0,29,175,204,28,18,46,250,21,73,Indiana,Fort Wayne,253691
5547,1998-1999,1998-12-01,1999-03-16,106,1,55,251,306,51,157,208,514,25,175,Indiana,Fort Wayne,253691
5548,1999-2000,1999-11-03,2000-04-08,158,0,59,267,326,52,123,175,501,32,170,Indiana,Fort Wayne,253691
5549,2000-2001,2000-11-14,2001-04-17,155,0,83,358,441,57,196,253,694,41,237,Indiana,Fort Wayne,253691
5550,2001-2002,2001-12-01,2002-03-29,119,0,23,178,201,32,32,64,265,21,91,Indiana,Fort Wayne,253691
5551,2002-2003,2002-11-15,2003-03-10,116,0,100,352,452,73,139,212,664,41,235,Indiana,Fort Wayne,253691
5552,2003-2004,2003-11-28,2004-03-17,111,0,78,270,348,61,122,183,531,34,204,Indiana,Fort Wayne,253691
5553,2004-2005,2004-11-24,2005-04-24,152,0,72,293,365,77,140,217,582,40,208,Indiana,Fort Wayne,253691
5554,2005-2006,2005-11-16,2006-03-26,131,0,53,232,285,51,92,143,428,31,140,Indiana,Fort Wayne,253691
5555,2006-2007,2006-12-01,2007-04-15,136,0,83,284,367,45,101,146,513,26,150,Indiana,Fort Wayne,253691
5556,2007-2008,2007-12-01,2008-03-22,113,0,68,283,351,72,115,187,538,40,218,Indiana,Fort Wayne,253691
5557,2008-2009,2008-11-16,2009-04-06,142,0,89,365,454,52,101,153,607,34,213,Indiana,Fort Wayne,253691
5558,2009-2010,2009-12-01,2010-02-28,90,0,66,224,290,56,91,147,437,37,184,Indiana,Fort Wayne,253691
5559,2010-2011,2010-12-01,2011-03-24,114,0,90,320,410,73,191,264,674,39,239,Indiana,Fort Wayne,253691
5560,2011-2012,2011-11-29,2012-03-04,97,0,24,153,177,53,40,93,270,30,127,Indiana,Fort Wayne,253691
5561,2012-2013,2012-10-30,2013-03-26,148,0,51,254,305,72,83,155,460,40,187,Indiana,Fort Wayne,253691
5562,2013-2014,2013-11-11,2014-04-15,156,0,139,477,616,120,252,372,988,53,397,Indiana,Fort Wayne,253691
5563,2014-2015,2014-11-13,2015-03-24,132,0,111,382,493,72,165,237,730,35,247,Indiana,Fort Wayne,253691
5564,2015-2016,2015-11-21,2016-04-09,141,0,41,195,236,46,21,67,303,36,164,Indiana,Fort Wayne,253691
5565,2016-2017,2016-11-19,2017-04-06,139,0,45,197,242,36,59,95,337,22,103,Indiana,Fort Wayne,253691
5566,2017-2018,2017-11-10,2018-04-19,161,0,87,312,399,64,93,157,556,45,252,Indiana,Fort Wayne,253691
5567,2018-2019,2018-11-09,2019-04-14,157,0,61,241,302,47,51,98,400,32,169,Indiana,Fort Wayne,253691
5568,2019-2020,2019-10-31,2020-04-17,170,0,22,224,246,44,44,88,334,28,95,Indiana,Fort Wayne,253691
5569,1950-1951,1950-11-10,1951-04-16,158,0,80,341,421,55,112,167,588,32,194,Indiana,Indianapolis,820445
5570,1951-1952,1951-11-03,1952-04-06,156,0,41,236,277,27,44,71,348,17,76,Indiana,Indianapolis,820445
5571,1952-1953,1952-11-27,1953-04-18,143,0,24,175,199,37,29,66,265,21,101,Indiana,Indianapolis,820445
5572,1953-1954,1953-11-25,1954-03-14,110,0,27,186,213,28,26,54,267,20,66,Indiana,Indianapolis,820445
5573,1954-1955,1954-11-01,1955-03-28,148,0,45,247,292,41,35,76,368,31,130,Indiana,Indianapolis,820445
5574,1955-1956,1955-11-18,1956-04-07,142,0,39,265,304,45,85,130,434,24,114,Indiana,Indianapolis,820445
5575,1956-1957,1956-11-21,1957-04-12,143,0,37,206,243,31,28,59,302,23,93,Indiana,Indianapolis,820445
5576,1957-1958,1957-12-01,1958-03-20,110,0,54,236,290,21,7,28,318,18,65,Indiana,Indianapolis,820445
5577,1958-1959,1958-11-27,1959-03-17,111,0,79,318,397,34,53,87,484,16,88,Indiana,Indianapolis,820445
5578,1959-1960,1959-11-11,1960-03-25,136,0,65,297,362,38,104,142,504,22,104,Indiana,Indianapolis,820445
5579,1960-1961,1960-11-30,1961-04-17,139,0,74,285,359,42,94,136,495,19,122,Indiana,Indianapolis,820445
5580,1961-1962,1961-11-19,1962-03-16,118,0,69,262,331,42,73,115,446,22,125,Indiana,Indianapolis,820445
5581,1962-1963,1962-10-25,1963-03-06,133,0,112,392,504,46,106,152,656,27,189,Indiana,Indianapolis,820445
5582,1963-1964,1963-11-13,1964-04-08,148,0,69,317,386,58,111,169,555,30,136,Indiana,Indianapolis,820445
5583,1964-1965,1964-11-19,1965-03-26,128,0,71,290,361,58,82,140,501,23,142,Indiana,Indianapolis,820445
5584,1965-1966,1965-11-29,1966-03-24,116,0,58,228,286,19,39,58,344,9,48,Indiana,Indianapolis,820445
5585,1966-1967,1966-11-02,1967-03-20,139,0,45,239,284,38,29,67,351,18,91,Indiana,Indianapolis,820445
5586,1967-1968,1967-11-20,1968-03-24,126,0,54,291,345,52,88,140,485,19,111,Indiana,Indianapolis,820445
5587,1968-1969,1968-11-18,1969-03-30,133,0,48,259,307,34,31,65,372,16,75,Indiana,Indianapolis,820445
5588,1969-1970,1969-11-14,1970-04-02,140,0,84,342,426,67,176,243,669,37,211,Indiana,Indianapolis,820445
5589,1970-1971,1970-11-14,1971-03-23,130,0,69,283,352,30,16,46,398,22,111,Indiana,Indianapolis,820445
5590,1971-1972,1971-11-06,1972-04-07,154,0,46,276,322,36,44,80,402,24,111,Indiana,Indianapolis,820445
5591,1972-1973,1972-11-19,1973-04-12,145,0,36,204,240,20,4,24,264,18,54,Indiana,Indianapolis,820445
5592,1973-1974,1973-11-08,1974-04-08,152,0,44,230,274,69,131,200,474,23,146,Indiana,Indianapolis,820445
5593,1974-1975,1974-11-30,1975-04-03,125,0,23,185,208,56,49,105,313,35,129,Indiana,Indianapolis,820445
5594,1975-1976,1975-11-21,1976-03-16,117,0,44,219,263,33,33,66,329,18,77,Indiana,Indianapolis,820445
5595,1976-1977,1976-11-21,1977-04-05,136,0,130,422,552,53,200,253,805,35,239,Indiana,Indianapolis,820445
5596,1977-1978,1977-11-10,1978-03-16,127,0,118,394,512,96,358,454,966,45,303,Indiana,Indianapolis,820445
5597,1978-1979,1978-12-01,1979-04-09,130,0,97,331,428,60,233,293,721,27,197,Indiana,Indianapolis,820445
5598,1979-1980,1979-11-28,1980-04-15,140,0,55,278,333,40,90,130,463,24,127,Indiana,Indianapolis,820445
5599,1980-1981,1980-11-17,1981-03-19,123,0,60,276,336,33,38,71,407,22,116,Indiana,Indianapolis,820445
5600,1981-1982,1981-11-20,1982-04-09,141,0,79,351,430,88,205,293,723,36,285,Indiana,Indianapolis,820445
5601,1982-1983,1982-11-13,1983-03-22,130,0,19,150,169,16,7,23,192,15,47,Indiana,Indianapolis,820445
5602,1983-1984,1983-11-11,1984-03-22,133,0,96,325,421,66,103,169,590,35,200,Indiana,Indianapolis,820445
5603,1984-1985,1984-11-18,1985-04-08,142,0,72,280,352,47,149,196,548,27,152,Indiana,Indianapolis,820445
5604,1985-1986,1985-12-01,1986-03-20,110,0,64,272,336,37,43,80,416,25,144,Indiana,Indianapolis,820445
5605,1986-1987,1986-11-13,1987-03-30,138,0,32,185,217,29,31,60,277,13,60,Indiana,Indianapolis,820445
5606,1987-1988,1987-12-01,1988-03-18,109,0,55,236,291,24,23,47,338,19,83,Indiana,Indianapolis,820445
5607,1988-1989,1988-11-06,1989-05-06,182,0,34,230,264,29,31,60,324,20,77,Indiana,Indianapolis,820445
5608,1989-1990,1989-10-18,1990-03-24,158,0,54,263,317,42,46,88,405,22,129,Indiana,Indianapolis,820445
5609,1990-1991,1990-12-01,1991-03-14,104,0,34,187,221,27,30,57,278,15,84,Indiana,Indianapolis,820445
5610,1991-1992,1991-11-03,1992-04-02,152,0,21,188,209,29,26,55,264,20,81,Indiana,Indianapolis,820445
5611,1992-1993,1992-10-20,1993-03-14,146,0,38,208,246,50,58,108,354,27,104,Indiana,Indianapolis,820445
5612,1993-1994,1993-10-30,1994-04-07,160,0,69,293,362,52,64,116,478,34,202,Indiana,Indianapolis,820445
5613,1994-1995,1994-12-01,1995-03-08,98,0,46,186,232,27,61,88,320,14,73,Indiana,Indianapolis,820445
5614,1995-1996,1995-11-05,1996-03-23,140,6,86,336,422,85,158,243,665,34,232,Indiana,Indianapolis,820445
5615,1996-1997,1996-11-13,1997-03-15,123,0,57,217,274,51,99,150,424,24,133,Indiana,Indianapolis,820445
5616,1997-1998,1997-11-13,1998-03-12,120,0,19,130,149,22,18,40,189,17,60,Indiana,Indianapolis,820445
5617,1998-1999,1998-12-01,1999-03-12,102,0,43,184,227,46,108,154,381,23,157,Indiana,Indianapolis,820445
5618,1999-2000,1999-12-01,2000-03-13,104,0,38,181,219,43,92,135,354,21,111,Indiana,Indianapolis,820445
5619,2000-2001,2000-11-17,2001-04-16,151,0,62,295,357,33,131,164,521,20,124,Indiana,Indianapolis,820445
5620,2001-2002,2001-12-01,2002-03-26,116,0,18,157,175,19,10,29,204,12,57,Indiana,Indianapolis,820445
5621,2002-2003,2002-11-22,2003-03-10,109,0,61,280,341,81,150,231,572,41,207,Indiana,Indianapolis,820445
5622,2003-2004,2003-11-28,2004-03-17,111,0,42,197,239,35,71,106,345,20,90,Indiana,Indianapolis,820445
5623,2004-2005,2004-11-25,2005-03-12,108,0,43,190,233,47,78,125,358,24,126,Indiana,Indianapolis,820445
5624,2005-2006,2005-11-17,2006-03-24,128,0,32,194,226,42,62,104,330,18,85,Indiana,Indianapolis,820445
5625,2006-2007,2006-12-01,2007-04-07,128,0,58,226,284,39,116,155,439,18,106,Indiana,Indianapolis,820445
5626,2007-2008,2007-12-01,2008-03-08,99,0,40,201,241,42,42,84,325,29,138,Indiana,Indianapolis,820445
5627,2008-2009,2008-11-30,2009-03-03,94,0,56,244,300,47,71,118,418,25,144,Indiana,Indianapolis,820445
5628,2009-2010,2009-12-01,2010-02-28,90,0,54,217,271,53,123,176,447,25,136,Indiana,Indianapolis,820445
5629,2010-2011,2010-12-01,2011-03-30,120,0,65,244,309,60,180,240,549,32,160,Indiana,Indianapolis,820445
5630,2011-2012,2011-11-29,2012-03-05,98,0,13,111,124,22,11,33,157,18,71,Indiana,Indianapolis,820445
5631,2012-2013,2012-11-12,2013-03-27,136,0,38,214,252,54,85,139,391,25,112,Indiana,Indianapolis,820445
5632,2013-2014,2013-11-11,2014-04-15,156,0,98,397,495,86,240,326,821,36,238,Indiana,Indianapolis,820445
5633,2014-2015,2014-10-31,2015-03-09,130,0,77,320,397,43,100,143,540,22,144,Indiana,Indianapolis,820445
5634,2015-2016,2015-11-21,2016-03-03,104,0,33,149,182,21,25,46,228,14,73,Indiana,Indianapolis,820445
5635,2016-2017,2016-12-01,2017-03-14,104,0,36,150,186,17,12,29,215,10,48,Indiana,Indianapolis,820445
5636,2017-2018,2017-12-01,2018-04-16,137,0,72,269,341,42,63,105,446,23,133,Indiana,Indianapolis,820445
5637,2018-2019,2018-11-14,2019-03-30,137,0,49,217,266,31,35,66,332,18,81,Indiana,Indianapolis,820445
5638,2019-2020,2019-11-11,2020-03-14,125,0,20,155,175,25,35,60,235,14,54,Indiana,Indianapolis,820445
5639,1950-1951,1950-11-10,1951-04-16,158,8,102,430,532,147,384,531,1063,41,365,Indiana,La Porte,22053
5640,1951-1952,1951-11-02,1952-04-05,156,7,57,345,402,167,360,527,929,31,296,Indiana,La Porte,22053
5641,1952-1953,1952-11-28,1953-04-19,143,8,25,226,251,68,79,147,398,16,124,Indiana,La Porte,22053
5642,1953-1954,1953-11-25,1954-05-04,161,1,35,258,293,122,172,294,587,29,203,Indiana,La Porte,22053
5643,1954-1955,1954-10-29,1955-03-29,152,0,50,308,358,121,236,357,715,27,244,Indiana,La Porte,22053
5644,1955-1956,1955-11-03,1956-03-30,149,1,37,316,353,93,231,324,677,23,165,Indiana,La Porte,22053
5645,1956-1957,1956-11-22,1957-04-11,141,5,59,280,339,87,241,328,667,24,169,Indiana,La Porte,22053
5646,1957-1958,1957-11-09,1958-03-20,132,0,65,271,336,165,404,569,905,40,334,Indiana,La Porte,22053
5647,1958-1959,1958-11-27,1959-03-17,111,0,99,372,471,156,505,661,1132,38,361,Indiana,La Porte,22053
5648,1959-1960,1959-11-06,1960-03-27,143,0,69,329,398,168,345,513,911,48,333,Indiana,La Porte,22053
5649,1960-1961,1960-11-06,1961-04-17,163,0,70,332,402,150,282,432,834,40,310,Indiana,La Porte,22053
5650,1961-1962,1961-11-19,1962-04-15,148,0,94,376,470,121,398,519,989,46,326,Indiana,La Porte,22053
5651,1962-1963,1962-10-23,1963-03-21,150,0,135,471,606,177,684,861,1467,48,455,Indiana,La Porte,22053
5652,1963-1964,1963-11-13,1964-03-31,140,0,70,352,422,109,306,415,837,41,273,Indiana,La Porte,22053
5653,1964-1965,1964-11-19,1965-04-01,134,0,90,354,444,132,275,407,851,51,372,Indiana,La Porte,22053
5654,1965-1966,1965-11-18,1966-05-11,175,8,70,312,382,85,204,289,671,35,217,Indiana,La Porte,22053
5655,1968-1969,1968-11-12,1969-03-30,139,1,63,302,365,102,212,314,679,21,168,Indiana,La Porte,22053
5656,1975-1976,1975-11-14,1976-03-13,121,2,57,241,298,79,208,287,585,30,194,Indiana,La Porte,22053
5657,1977-1978,1977-11-12,1978-03-22,131,1,141,460,601,179,616,795,1396,48,473,Indiana,La Porte,22053
5658,1978-1979,1978-11-26,1979-03-25,120,1,132,419,551,113,543,656,1207,41,330,Indiana,La Porte,22053
5659,1979-1980,1979-11-28,1980-04-24,149,8,68,308,376,77,204,281,657,31,215,Indiana,La Porte,22053
5660,1980-1981,1980-10-27,1981-03-19,144,19,91,307,398,113,336,449,847,42,303,Indiana,La Porte,22053
5661,1981-1982,1981-11-20,1982-04-11,143,6,120,412,532,150,553,703,1235,43,362,Indiana,La Porte,22053
5662,1982-1983,1982-11-26,1983-04-18,144,14,39,187,226,45,114,159,385,21,92,Indiana,La Porte,22053
5663,1983-1984,1983-11-11,1984-04-17,159,16,139,382,521,109,360,469,990,48,339,Indiana,La Porte,22053
5664,1984-1985,1984-11-19,1985-04-09,142,2,96,310,406,101,293,394,800,33,277,Indiana,La Porte,22053
5665,1985-1986,1985-11-20,1986-04-15,147,4,103,341,444,124,224,348,792,46,323,Indiana,La Porte,22053
5666,1986-1987,1986-11-11,1987-04-03,144,0,47,239,286,55,124,179,465,25,146,Indiana,La Porte,22053
5667,1987-1988,1987-11-20,1988-03-20,122,9,90,294,384,89,99,188,572,35,235,Indiana,La Porte,22053
5668,1990-1991,1990-12-01,1991-03-13,103,15,65,225,290,85,114,199,489,33,238,Indiana,La Porte,22053
5669,1991-1992,1991-11-02,1992-04-02,153,4,46,237,283,91,117,208,491,38,226,Indiana,La Porte,22053
5670,1992-1993,1992-10-20,1993-04-02,165,2,70,267,337,103,155,258,595,50,256,Indiana,La Porte,22053
5671,1993-1994,1993-10-30,1994-04-06,159,2,129,371,500,88,238,326,826,52,393,Indiana,La Porte,22053
5672,1994-1995,1994-11-30,1995-04-10,132,0,69,233,302,55,110,165,467,29,193,Indiana,La Porte,22053
5673,1995-1996,1995-11-03,1996-04-16,166,0,111,379,490,78,91,169,659,45,276,Indiana,La Porte,22053
5674,1996-1997,1996-11-09,1997-05-01,174,0,93,312,405,94,114,208,613,45,264,Indiana,La Porte,22053
5675,1997-1998,1997-10-26,1998-03-20,146,0,33,179,212,98,118,216,428,33,172,Indiana,La Porte,22053
5676,1998-1999,1998-12-01,1999-03-14,104,0,67,234,301,81,190,271,572,28,234,Indiana,La Porte,22053
5677,1999-2000,1999-11-29,2000-04-08,132,0,55,220,275,85,159,244,519,34,227,Indiana,La Porte,22053
5678,2000-2001,2000-10-08,2001-04-17,192,0,98,353,451,135,352,487,938,59,398,Indiana,La Porte,22053
5679,2001-2002,2001-12-01,2002-04-04,125,3,20,138,158,83,94,177,335,36,165,Indiana,La Porte,22053
5680,2003-2004,2003-12-01,2004-03-21,112,0,81,256,337,76,183,259,596,31,191,Indiana,La Porte,22053
5681,2006-2007,2006-10-23,2007-04-11,171,8,87,282,369,98,185,283,652,40,298,Indiana,La Porte,22053
5682,2007-2008,2007-11-22,2008-03-27,127,0,84,302,386,137,206,343,729,48,343,Indiana,La Porte,22053
5683,2008-2009,2008-11-16,2009-04-06,142,3,100,375,475,136,228,364,839,55,384,Indiana,La Porte,22053
5684,2009-2010,2009-12-01,2010-03-03,93,2,73,236,309,103,205,308,617,43,263,Indiana,La Porte,22053
5685,2011-2012,2011-12-01,2012-03-05,96,1,31,153,184,69,73,142,326,21,134,Indiana,La Porte,22053
5686,2012-2013,2012-11-24,2013-03-21,118,0,60,229,289,84,110,194,483,35,228,Indiana,La Porte,22053
5687,2013-2014,2013-11-11,2014-04-15,156,0,166,506,672,173,350,523,1195,52,482,Indiana,La Porte,22053
5688,2014-2015,2014-11-13,2015-03-27,135,0,128,380,508,93,259,352,860,32,299,Indiana,La Porte,22053
5689,2015-2016,2015-11-21,2016-04-09,141,1,53,217,270,89,123,212,482,25,211,Indiana,La Porte,22053
5690,2016-2017,2016-12-01,2017-03-15,105,0,62,206,268,64,124,188,456,19,160,Indiana,La Porte,22053
5691,2017-2018,2017-11-10,2018-04-19,161,6,100,329,429,201,210,411,840,47,471,Indiana,La Porte,22053
5692,2018-2019,2018-11-09,2019-04-27,170,0,102,318,420,77,61,138,558,31,220,Indiana,La Porte,22053
5693,2019-2020,2019-11-11,2020-04-17,159,0,34,217,251,55,54,109,360,28,130,Indiana,La Porte,22053
5694,1954-1955,1954-12-01,1955-03-29,119,0,53,274,327,29,70,99,426,14,103,Indiana,Lafayette,67140
5695,1955-1956,1955-11-03,1956-04-07,157,0,45,356,401,50,98,148,549,21,102,Indiana,Lafayette,67140
5696,1956-1957,1956-11-22,1957-04-12,142,1,56,284,340,29,72,101,441,16,94,Indiana,Lafayette,67140
5697,1957-1958,1957-11-10,1958-03-20,131,0,65,283,348,15,10,25,373,10,43,Indiana,Lafayette,67140
5698,1958-1959,1958-11-27,1959-03-18,112,0,92,378,470,29,58,87,557,15,99,Indiana,Lafayette,67140
5699,1959-1960,1959-11-07,1960-03-27,142,1,73,362,435,40,167,207,642,19,123,Indiana,Lafayette,67140
5700,1960-1961,1960-11-30,1961-04-17,139,1,75,319,394,35,149,184,578,15,102,Indiana,Lafayette,67140
5701,1961-1962,1961-11-19,1962-03-15,117,3,85,321,406,37,77,114,520,15,100,Indiana,Lafayette,67140
5702,1962-1963,1962-12-01,1963-03-09,99,0,126,441,567,34,107,141,708,18,140,Indiana,Lafayette,67140
5703,1963-1964,1963-12-01,1964-03-30,121,1,79,380,459,55,164,219,678,22,122,Indiana,Lafayette,67140
5704,1964-1965,1964-11-20,1965-03-27,128,0,87,345,432,38,89,127,559,15,104,Indiana,Lafayette,67140
5705,1965-1966,1965-11-29,1966-03-25,117,1,66,289,355,15,22,37,392,8,45,Indiana,Lafayette,67140
5706,1966-1967,1966-11-03,1967-03-20,138,0,70,335,405,30,53,83,488,16,89,Indiana,Lafayette,67140
5707,1967-1968,1967-11-23,1968-03-24,123,0,73,356,429,35,130,165,594,19,124,Indiana,Lafayette,67140
5708,1968-1969,1968-11-20,1969-03-31,132,0,77,327,404,18,51,69,473,11,62,Indiana,Lafayette,67140
5709,1969-1970,1969-11-15,1970-04-03,140,0,100,408,508,34,137,171,679,19,127,Indiana,Lafayette,67140
5710,1970-1971,1970-11-24,1971-03-24,121,0,83,325,408,18,23,41,449,12,67,Indiana,Lafayette,67140
5711,1971-1972,1971-11-08,1972-04-08,153,1,71,331,402,21,43,64,466,12,78,Indiana,Lafayette,67140
5712,1972-1973,1972-11-22,1973-03-17,116,0,52,241,293,14,11,25,318,10,37,Indiana,Lafayette,67140
5713,1973-1974,1973-11-10,1974-03-25,136,0,71,293,364,53,149,202,566,18,145,Indiana,Lafayette,67140
5714,1974-1975,1974-11-14,1975-04-03,141,2,45,259,304,43,52,95,399,22,98,Indiana,Lafayette,67140
5715,1975-1976,1975-11-25,1976-03-17,114,0,59,253,312,38,61,99,411,14,78,Indiana,Lafayette,67140
5716,1976-1977,1976-11-23,1977-03-22,120,3,162,482,644,46,183,229,873,24,200,Indiana,Lafayette,67140
5717,1977-1978,1977-11-27,1978-03-26,120,0,162,532,694,70,432,502,1196,30,227,Indiana,Lafayette,67140
5718,1978-1979,1978-11-29,1979-04-09,132,1,139,441,580,37,210,247,827,23,199,Indiana,Lafayette,67140
5719,1979-1980,1979-11-11,1980-03-14,125,0,74,329,403,28,79,107,510,16,98,Indiana,Lafayette,67140
5720,1980-1981,1980-11-27,1981-03-20,114,0,75,325,400,27,84,111,511,11,77,Indiana,Lafayette,67140
5721,1981-1982,1981-11-22,1982-04-11,141,8,119,433,552,77,239,316,868,27,232,Indiana,Lafayette,67140
5722,1982-1983,1982-11-06,1983-03-25,140,6,40,207,247,15,16,31,278,11,48,Indiana,Lafayette,67140
5723,1983-1984,1983-12-01,1984-03-22,113,0,145,406,551,66,286,352,903,30,240,Indiana,Lafayette,67140
5724,1984-1985,1984-11-18,1985-02-28,103,1,89,312,401,23,126,149,550,16,112,Indiana,Lafayette,67140
5725,1985-1986,1985-11-21,1986-03-21,121,3,79,334,413,25,66,91,504,16,109,Indiana,Lafayette,67140
5726,1986-1987,1986-11-11,1987-02-28,110,0,39,222,261,36,91,127,388,13,83,Indiana,Lafayette,67140
5727,1987-1988,1987-11-21,1988-03-18,119,4,70,293,363,31,74,105,468,11,61,Indiana,Lafayette,67140
5728,1988-1989,1988-11-06,1989-04-09,155,11,57,294,351,21,51,72,423,11,55,Indiana,Lafayette,67140
5729,1989-1990,1989-10-19,1990-02-28,133,6,66,279,345,34,71,105,450,13,80,Indiana,Lafayette,67140
5730,1990-1991,1990-12-01,1991-03-14,104,17,58,250,308,28,57,85,393,13,87,Indiana,Lafayette,67140
5731,1991-1992,1991-11-03,1992-04-02,152,5,29,240,269,25,40,65,334,15,72,Indiana,Lafayette,67140
5732,1992-1993,1992-11-28,1993-03-18,111,0,58,282,340,31,108,139,479,12,66,Indiana,Lafayette,67140
5733,1997-1998,1997-12-01,1998-03-13,103,11,21,147,168,7,11,18,186,3,14,Indiana,Lafayette,67140
5734,1998-1999,1998-12-01,1999-03-16,106,6,54,240,294,42,160,202,496,9,94,Indiana,Lafayette,67140
5735,1999-2000,1999-12-01,2000-03-13,104,16,49,241,290,43,118,161,451,10,89,Indiana,Lafayette,67140
5736,2001-2002,2001-12-01,2002-03-29,119,11,28,187,215,16,31,47,262,6,34,Indiana,Lafayette,67140
5737,2002-2003,2002-11-27,2003-03-11,105,17,85,338,423,55,153,208,631,18,131,Indiana,Lafayette,67140
5738,2003-2004,2003-11-25,2004-03-16,113,19,63,257,320,27,58,85,405,14,80,Indiana,Lafayette,67140
5739,2004-2005,2004-11-25,2005-03-13,109,19,54,226,280,37,73,110,390,16,88,Indiana,Lafayette,67140
5740,2005-2006,2005-11-17,2006-03-22,126,7,40,238,278,20,61,81,359,9,42,Indiana,Lafayette,67140
5741,2006-2007,2006-12-01,2007-04-15,136,9,79,291,370,41,123,164,534,8,87,Indiana,Lafayette,67140
5742,2007-2008,2007-12-01,2008-03-09,100,13,69,263,332,50,102,152,484,15,128,Indiana,Lafayette,67140
5743,2008-2009,2008-11-22,2009-03-13,112,10,87,319,406,26,87,113,519,11,83,Indiana,Lafayette,67140
5744,2009-2010,2009-12-01,2010-03-06,96,1,73,297,370,45,195,240,610,19,118,Indiana,Lafayette,67140
5745,2012-2013,2012-11-05,2013-03-28,144,0,43,264,307,32,78,110,417,9,55,Indiana,Lafayette,67140
5746,2013-2014,2013-11-12,2014-03-29,138,11,123,464,587,88,231,319,906,27,223,Indiana,Lafayette,67140
5747,2014-2015,2014-11-13,2015-03-09,117,0,99,360,459,42,129,171,630,9,87,Indiana,Lafayette,67140
5748,2015-2016,2015-11-22,2016-03-04,104,0,48,188,236,23,38,61,297,6,51,Indiana,Lafayette,67140
5749,2016-2017,2016-12-01,2017-03-16,106,0,48,186,234,15,15,30,264,7,46,Indiana,Lafayette,67140
5750,2017-2018,2017-12-01,2018-04-09,130,0,92,327,419,39,114,153,572,14,105,Indiana,Lafayette,67140
5751,2018-2019,2018-11-14,2019-03-08,115,0,65,265,330,30,63,93,423,12,92,Indiana,Lafayette,67140
5752,2019-2020,2019-11-01,2020-03-23,144,0,29,210,239,27,46,73,312,13,53,Indiana,Lafayette,67140
5753,1950-1951,1950-11-23,1951-03-25,123,7,40,252,292,87,96,183,475,25,176,Indiana,Oolitic,1184
5754,1951-1952,1951-11-04,1952-03-02,120,17,18,176,194,28,13,41,235,11,57,Indiana,Oolitic,1184
5755,1952-1953,1952-11-28,1953-04-18,142,4,8,133,141,33,18,51,192,14,61,Indiana,Oolitic,1184
5756,1953-1954,1953-12-01,1954-03-04,94,0,12,144,156,18,23,41,197,4,30,Indiana,Oolitic,1184
5757,1954-1955,1954-11-01,1955-03-26,146,1,17,188,205,35,10,45,250,22,91,Indiana,Oolitic,1184
5758,1955-1956,1955-11-19,1956-03-16,119,2,15,202,217,37,47,84,301,14,71,Indiana,Oolitic,1184
5759,1956-1957,1956-11-23,1957-03-08,106,0,15,150,165,19,18,37,202,11,44,Indiana,Oolitic,1184
5760,1957-1958,1957-12-01,1958-03-20,110,2,33,214,247,25,11,36,283,12,46,Indiana,Oolitic,1184
5761,1958-1959,1958-11-28,1959-03-17,110,2,40,272,312,40,35,75,387,13,78,Indiana,Oolitic,1184
5762,1959-1960,1959-11-28,1960-03-17,111,0,28,201,229,43,95,138,367,12,74,Indiana,Oolitic,1184
5763,1960-1961,1960-11-10,1961-04-16,158,4,31,243,274,54,56,110,384,18,109,Indiana,Oolitic,1184
5764,1961-1962,1961-12-01,1962-04-01,122,2,33,215,248,47,34,81,329,17,101,Indiana,Oolitic,1184
5765,1962-1963,1962-12-01,1963-03-06,96,0,49,301,350,44,54,98,448,20,111,Indiana,Oolitic,1184
5766,1964-1965,1964-11-20,1965-03-27,128,3,43,319,362,53,80,133,495,17,144,Indiana,Oolitic,1184
5767,1965-1966,1965-11-30,1966-03-08,99,0,41,237,278,35,62,97,375,14,82,Indiana,Oolitic,1184
5768,1966-1967,1966-11-02,1967-03-18,137,0,34,298,332,30,23,53,385,12,75,Indiana,Oolitic,1184
5769,1967-1968,1967-12-01,1968-03-24,115,3,46,306,352,35,72,107,459,16,99,Indiana,Oolitic,1184
5770,1968-1969,1968-11-19,1969-03-26,128,0,37,281,318,13,11,24,342,10,37,Indiana,Oolitic,1184
5771,1969-1970,1969-11-15,1970-04-04,141,1,65,351,416,68,206,274,690,30,195,Indiana,Oolitic,1184
5772,1970-1971,1970-11-24,1971-03-20,117,0,54,286,340,25,42,67,407,12,77,Indiana,Oolitic,1184
5773,1971-1972,1971-11-07,1972-03-06,121,0,34,249,283,23,31,54,337,13,73,Indiana,Oolitic,1184
5774,1972-1973,1972-12-01,1973-04-11,132,0,32,201,233,9,12,21,254,6,24,Indiana,Oolitic,1184
5775,1973-1974,1973-12-01,1974-03-25,115,0,41,217,258,29,54,83,341,11,77,Indiana,Oolitic,1184
5776,1974-1975,1974-12-01,1975-03-26,116,0,18,185,203,18,18,36,239,9,46,Indiana,Oolitic,1184
5777,1975-1976,1975-11-25,1976-03-16,113,0,33,226,259,15,23,38,297,10,39,Indiana,Oolitic,1184
5778,1976-1977,1976-11-29,1977-03-01,93,2,104,400,504,39,220,259,763,17,128,Indiana,Oolitic,1184
5779,1977-1978,1977-11-27,1978-03-26,120,1,104,444,548,71,335,406,954,26,207,Indiana,Oolitic,1184
5780,1978-1979,1978-12-01,1979-03-26,116,0,81,373,454,56,174,230,684,18,168,Indiana,Oolitic,1184
5781,1979-1980,1979-11-29,1980-03-14,107,0,37,276,313,27,80,107,420,13,80,Indiana,Oolitic,1184
5782,1980-1981,1980-11-18,1981-03-20,123,0,51,325,376,13,15,28,404,9,49,Indiana,Oolitic,1184
5783,1981-1982,1981-11-21,1982-04-08,139,0,65,375,440,35,116,151,591,13,104,Indiana,Oolitic,1184
5784,1982-1983,1982-12-01,1983-03-22,112,1,14,170,184,8,3,11,195,7,23,Indiana,Oolitic,1184
5785,1983-1984,1983-12-01,1984-03-13,104,8,82,299,381,26,29,55,436,19,118,Indiana,Oolitic,1184
5786,1984-1985,1984-11-18,1985-02-28,103,0,65,294,359,30,128,158,517,17,119,Indiana,Oolitic,1184
5787,1985-1986,1985-12-01,1986-03-21,111,7,45,297,342,14,18,32,374,8,61,Indiana,Oolitic,1184
5788,1986-1987,1986-12-01,1987-03-31,121,1,21,196,217,14,8,22,239,8,36,Indiana,Oolitic,1184
5789,1987-1988,1987-11-21,1988-03-18,119,3,44,281,325,13,10,23,348,8,45,Indiana,Oolitic,1184
5790,1989-1990,1989-10-19,1990-03-26,159,2,46,296,342,26,63,89,431,10,73,Indiana,Oolitic,1184
5791,1990-1991,1990-12-01,1991-02-28,90,0,24,184,208,18,13,31,239,8,51,Indiana,Oolitic,1184
5792,1991-1992,1991-11-04,1992-04-02,151,2,16,233,249,11,3,14,263,8,40,Indiana,Oolitic,1184
5793,1992-1993,1992-11-15,1993-03-15,121,2,28,247,275,32,48,80,355,12,60,Indiana,Oolitic,1184
5794,1993-1994,1993-10-30,1994-03-10,132,20,71,301,372,27,43,70,442,12,65,Indiana,Oolitic,1184
5795,1996-1997,1996-12-01,1997-02-28,90,15,53,207,260,16,40,56,316,11,56,Indiana,Oolitic,1184
5796,1997-1998,1997-11-15,1998-03-13,119,15,12,150,162,26,26,52,214,15,62,Indiana,Oolitic,1184
5797,1998-1999,1998-12-01,1999-03-15,105,4,25,191,216,29,62,91,307,15,91,Indiana,Oolitic,1184
5798,1999-2000,1999-12-01,2000-03-12,103,13,23,193,216,18,21,39,255,11,50,Indiana,Oolitic,1184
5799,2000-2001,2000-11-18,2001-02-28,103,18,53,287,340,49,112,161,501,24,168,Indiana,Oolitic,1184
5800,2001-2002,2001-12-01,2002-03-05,95,3,16,169,185,15,11,26,211,8,49,Indiana,Oolitic,1184
5801,2002-2003,2002-12-01,2003-03-07,97,2,43,247,290,60,130,190,480,24,144,Indiana,Oolitic,1184
5802,2003-2004,2003-11-25,2004-02-29,97,0,32,210,242,24,59,83,325,10,62,Indiana,Oolitic,1184
5803,2004-2005,2004-12-01,2005-03-12,102,2,26,195,221,41,68,109,330,14,83,Indiana,Oolitic,1184
5804,2005-2006,2005-11-18,2006-03-22,125,3,19,212,231,28,32,60,291,10,56,Indiana,Oolitic,1184
5805,2006-2007,2006-12-01,2007-04-08,129,0,40,240,280,17,14,31,311,10,57,Indiana,Oolitic,1184
5806,2007-2008,2007-12-01,2008-03-10,101,0,37,227,264,30,32,62,326,12,74,Indiana,Oolitic,1184
5807,2008-2009,2008-12-01,2009-03-03,93,3,52,258,310,31,57,88,398,17,114,Indiana,Oolitic,1184
5808,2009-2010,2009-12-01,2010-02-28,90,1,43,237,280,42,94,136,416,16,102,Indiana,Oolitic,1184
5809,2010-2011,2010-12-01,2011-03-27,117,0,53,249,302,32,68,100,402,21,98,Indiana,Oolitic,1184
5810,2011-2012,2011-11-30,2012-03-05,97,0,12,146,158,11,3,14,172,8,36,Indiana,Oolitic,1184
5811,2012-2013,2012-11-25,2013-03-26,122,4,28,234,262,39,80,119,381,17,83,Indiana,Oolitic,1184
5812,2013-2014,2013-11-25,2014-03-26,122,6,79,383,462,39,95,134,596,21,141,Indiana,Oolitic,1184
5813,2014-2015,2014-11-14,2015-03-08,115,0,55,327,382,29,106,135,517,12,90,Indiana,Oolitic,1184
5814,2015-2016,2015-12-01,2016-02-29,91,0,26,162,188,18,25,43,231,10,70,Indiana,Oolitic,1184
5815,2016-2017,2016-12-01,2017-03-15,105,1,30,165,195,3,6,9,204,3,18,Indiana,Oolitic,1184
5816,2017-2018,2017-12-01,2018-04-09,130,0,59,288,347,32,44,76,423,19,113,Indiana,Oolitic,1184
5817,2018-2019,2018-11-15,2019-03-08,114,0,41,207,248,18,16,34,282,13,65,Indiana,Oolitic,1184
5818,2019-2020,2019-11-12,2020-02-29,110,1,13,155,168,15,7,22,190,9,29,Indiana,Oolitic,1184
5819,1950-1951,1950-11-11,1951-04-16,157,0,95,394,489,92,205,297,786,51,323,Indiana,South Bend,101168
5820,1951-1952,1951-11-02,1952-04-06,157,0,64,330,394,118,213,331,725,48,304,Indiana,South Bend,101168
5821,1952-1953,1952-10-28,1953-04-20,175,0,39,234,273,61,59,120,393,39,175,Indiana,South Bend,101168
5822,1953-1954,1953-11-25,1954-05-04,161,0,42,267,309,105,135,240,549,46,252,Indiana,South Bend,101168
5823,1954-1955,1954-10-29,1955-03-28,151,0,59,305,364,104,191,295,659,42,261,Indiana,South Bend,101168
5824,1955-1956,1955-11-03,1956-04-18,168,0,59,352,411,91,143,234,645,54,267,Indiana,South Bend,101168
5825,1956-1957,1956-11-21,1957-04-11,142,0,67,295,362,96,192,288,650,50,271,Indiana,South Bend,101168
5826,1957-1958,1957-11-09,1958-03-25,137,0,75,294,369,114,308,422,791,50,342,Indiana,South Bend,101168
5827,1958-1959,1958-11-27,1959-03-27,121,0,117,398,515,134,419,553,1068,56,448,Indiana,South Bend,101168
5828,1959-1960,1959-11-06,1960-04-09,156,0,82,347,429,145,287,432,861,68,402,Indiana,South Bend,101168
5829,1960-1961,1960-11-06,1961-04-18,164,0,88,328,416,111,196,307,723,46,310,Indiana,South Bend,101168
5830,1961-1962,1961-11-17,1962-04-15,150,0,100,362,462,96,269,365,827,56,364,Indiana,South Bend,101168
5831,1962-1963,1962-10-23,1963-04-30,190,0,158,463,621,144,546,690,1311,63,515,Indiana,South Bend,101168
5832,1963-1964,1963-11-02,1964-04-08,159,0,81,336,417,126,237,363,780,69,384,Indiana,South Bend,101168
5833,1964-1965,1964-11-19,1965-04-01,134,0,104,348,452,134,248,382,834,64,426,Indiana,South Bend,101168
5834,1965-1966,1965-10-23,1966-05-11,201,0,76,294,370,108,189,297,667,55,327,Indiana,South Bend,101168
5835,1966-1967,1966-11-01,1967-04-24,175,0,77,304,381,159,458,617,998,61,366,Indiana,South Bend,101168
5836,1967-1968,1967-10-26,1968-04-24,182,0,95,334,429,106,264,370,799,52,333,Indiana,South Bend,101168
5837,1968-1969,1968-11-08,1969-03-30,143,0,85,309,394,115,233,348,742,57,330,Indiana,South Bend,101168
5838,1969-1970,1969-11-13,1970-04-05,144,0,100,376,476,137,326,463,939,69,452,Indiana,South Bend,101168
5839,1970-1971,1970-11-23,1971-04-03,132,0,86,319,405,123,249,372,777,57,363,Indiana,South Bend,101168
5840,1971-1972,1971-11-07,1972-04-08,154,0,67,294,361,127,211,338,699,63,330,Indiana,South Bend,101168
5841,1972-1973,1972-10-18,1973-04-12,177,0,45,223,268,82,139,221,489,43,202,Indiana,South Bend,101168
5842,1973-1974,1973-11-09,1974-04-23,166,0,60,253,313,96,168,264,577,46,280,Indiana,South Bend,101168
5843,1974-1975,1974-10-19,1975-04-06,170,0,36,227,263,108,162,270,533,55,227,Indiana,South Bend,101168
5844,1975-1976,1975-11-13,1976-05-03,173,0,50,271,321,107,301,408,729,48,271,Indiana,South Bend,101168
5845,1976-1977,1976-10-19,1977-04-06,170,0,138,439,577,194,546,740,1317,80,614,Indiana,South Bend,101168
5846,1977-1978,1977-10-16,1978-03-21,157,0,139,445,584,240,769,1009,1593,62,577,Indiana,South Bend,101168
5847,1978-1979,1978-11-21,1979-04-07,138,0,120,373,493,149,533,682,1175,62,430,Indiana,South Bend,101168
5848,1979-1980,1979-11-08,1980-04-14,159,0,63,267,330,101,160,261,591,47,278,Indiana,South Bend,101168
5849,1980-1981,1980-10-25,1981-03-20,147,0,58,271,329,125,300,425,754,50,304,Indiana,South Bend,101168
5850,1981-1982,1981-10-23,1982-04-10,170,0,115,413,528,195,429,624,1152,66,508,Indiana,South Bend,101168
5851,1982-1983,1982-11-12,1983-04-17,157,0,31,179,210,57,80,137,347,36,133,Indiana,South Bend,101168
5852,1983-1984,1983-11-11,1984-04-03,145,0,134,360,494,120,325,445,939,56,404,Indiana,South Bend,101168
5853,1984-1985,1984-11-19,1985-04-09,142,0,83,302,385,132,275,407,792,53,369,Indiana,South Bend,101168
5854,1985-1986,1985-11-22,1986-04-15,145,0,96,340,436,129,228,357,793,56,377,Indiana,South Bend,101168
5855,1986-1987,1986-11-11,1987-04-03,144,0,45,254,299,82,133,215,514,34,195,Indiana,South Bend,101168
5856,1987-1988,1987-11-19,1988-03-20,123,0,84,312,396,95,140,235,631,49,315,Indiana,South Bend,101168
5857,1988-1989,1988-10-24,1989-04-18,177,0,62,294,356,72,77,149,505,42,213,Indiana,South Bend,101168
5858,1989-1990,1989-10-19,1990-04-12,176,0,73,310,383,113,182,295,678,46,291,Indiana,South Bend,101168
5859,1990-1991,1990-12-01,1991-03-28,118,0,56,221,277,90,124,214,491,37,235,Indiana,South Bend,101168
5860,1991-1992,1991-11-03,1992-04-02,152,0,39,234,273,99,132,231,504,45,246,Indiana,South Bend,101168
5861,1992-1993,1992-10-20,1993-04-17,180,0,61,271,332,125,169,294,626,56,281,Indiana,South Bend,101168
5862,1993-1994,1993-09-29,1994-04-06,190,0,124,388,512,89,202,291,803,51,381,Indiana,South Bend,101168
5863,1994-1995,1994-11-30,1995-04-10,132,0,66,252,318,77,132,209,527,35,228,Indiana,South Bend,101168
5864,1995-1996,1995-11-04,1996-04-26,175,0,105,401,506,92,130,222,728,55,337,Indiana,South Bend,101168
5865,1996-1997,1996-11-02,1997-04-17,167,0,93,337,430,116,138,254,684,47,323,Indiana,South Bend,101168
5866,1997-1998,1997-10-27,1998-03-21,146,1,36,194,230,83,119,202,432,31,166,Indiana,South Bend,101168
5867,1998-1999,1998-12-01,1999-03-16,106,0,65,262,327,105,212,317,644,30,282,Indiana,South Bend,101168
5868,1999-2000,1999-11-03,2000-04-08,158,0,49,239,288,86,149,235,523,36,232,Indiana,South Bend,101168
5869,2000-2001,2000-11-17,2001-04-17,152,0,94,366,460,107,304,411,871,44,309,Indiana,South Bend,101168
5870,2001-2002,2001-12-01,2002-04-04,125,0,36,193,229,96,90,186,415,37,214,Indiana,South Bend,101168
5871,2002-2003,2002-11-22,2003-04-07,137,0,95,341,436,89,100,189,625,44,282,Indiana,South Bend,101168
5872,2003-2004,2003-11-28,2004-03-16,110,0,73,257,330,79,122,201,531,40,241,Indiana,South Bend,101168
5873,2004-2005,2004-11-24,2005-04-24,152,0,66,289,355,112,157,269,624,43,283,Indiana,South Bend,101168
5874,2005-2006,2005-11-17,2006-03-16,120,0,55,221,276,60,100,160,436,33,183,Indiana,South Bend,101168
5875,2006-2007,2006-10-12,2007-04-11,182,0,87,296,383,98,147,245,628,47,314,Indiana,South Bend,101168
5876,2007-2008,2007-11-22,2008-03-28,128,0,82,307,389,110,171,281,670,52,330,Indiana,South Bend,101168
5877,2008-2009,2008-10-27,2009-04-06,162,0,106,407,513,116,256,372,885,56,386,Indiana,South Bend,101168
5878,2009-2010,2009-12-01,2010-03-02,92,0,69,233,302,88,216,304,606,38,227,Indiana,South Bend,101168
5879,2010-2011,2010-11-05,2011-03-23,139,0,93,317,410,151,319,470,880,52,364,Indiana,South Bend,101168
5880,2011-2012,2011-12-01,2012-03-05,96,0,27,154,181,71,64,135,316,23,131,Indiana,South Bend,101168
5881,2012-2013,2012-11-24,2013-03-26,123,0,52,227,279,87,147,234,513,36,218,Indiana,South Bend,101168
5882,2014-2015,2014-10-31,2015-03-27,148,0,109,379,488,124,349,473,961,47,398,Indiana,South Bend,101168
5883,2015-2016,2015-11-21,2016-04-10,142,0,54,242,296,104,144,248,544,38,266,Indiana,South Bend,101168
5884,2016-2017,2016-11-19,2017-04-06,139,1,61,231,292,66,99,165,457,35,213,Indiana,South Bend,101168
5885,2017-2018,2017-11-10,2018-04-19,161,0,102,361,463,133,241,374,837,52,419,Indiana,South Bend,101168
5886,2018-2019,2018-11-09,2019-04-27,170,0,93,331,424,69,113,182,606,40,233,Indiana,South Bend,101168
5887,2019-2020,2019-10-31,2020-04-17,170,0,28,222,250,70,79,149,399,35,148,Indiana,South Bend,101168
5888,1950-1951,1950-11-10,1951-04-04,146,3,158,508,666,86,448,534,1200,31,257,Iowa,Cedar Rapids,126326
5889,1951-1952,1951-11-02,1952-04-14,165,0,104,427,531,74,270,344,875,33,215,Iowa,Cedar Rapids,126326
5890,1952-1953,1952-11-25,1953-03-10,106,0,58,276,334,45,131,176,510,25,147,Iowa,Cedar Rapids,126326
5891,1953-1954,1953-11-23,1954-04-03,132,0,58,334,392,56,103,159,551,23,121,Iowa,Cedar Rapids,126326
5892,1954-1955,1954-11-01,1955-03-27,147,0,77,366,443,42,129,171,614,28,177,Iowa,Cedar Rapids,126326
5893,1955-1956,1955-11-07,1956-04-08,154,1,85,464,549,33,103,136,685,24,140,Iowa,Cedar Rapids,126326
5894,1957-1958,1957-11-18,1958-03-20,123,8,97,337,434,33,165,198,632,18,74,Iowa,Cedar Rapids,126326
5895,1958-1959,1958-11-26,1959-04-20,146,0,137,484,621,71,345,416,1037,26,185,Iowa,Cedar Rapids,126326
5896,1959-1960,1959-11-05,1960-03-28,145,0,113,448,561,91,436,527,1088,27,189,Iowa,Cedar Rapids,126326
5897,1960-1961,1960-11-29,1961-04-17,140,0,73,339,412,31,56,87,499,15,97,Iowa,Cedar Rapids,126326
5898,1961-1962,1961-12-01,1962-04-01,122,0,154,439,593,84,557,641,1234,34,242,Iowa,Cedar Rapids,126326
5899,1962-1963,1962-12-01,1963-03-13,103,2,166,442,608,53,214,267,875,27,242,Iowa,Cedar Rapids,126326
5900,1963-1964,1963-11-23,1964-03-30,129,0,95,390,485,46,137,183,668,25,118,Iowa,Cedar Rapids,126326
5901,1964-1965,1964-11-20,1965-03-29,130,0,142,476,618,65,168,233,851,27,211,Iowa,Cedar Rapids,126326
5902,1965-1966,1965-11-18,1966-05-11,175,0,107,398,505,26,115,141,646,19,110,Iowa,Cedar Rapids,126326
5903,1966-1967,1966-12-01,1967-04-23,144,0,81,355,436,45,164,209,645,19,124,Iowa,Cedar Rapids,126326
5904,1967-1968,1967-10-26,1968-03-22,149,0,87,381,468,21,72,93,561,16,99,Iowa,Cedar Rapids,126326
5905,1968-1969,1968-11-08,1969-03-31,144,0,112,423,535,45,261,306,841,24,131,Iowa,Cedar Rapids,126326
5906,1969-1970,1969-11-14,1970-04-02,140,1,128,478,606,73,362,435,1041,29,216,Iowa,Cedar Rapids,126326
5907,1970-1971,1970-11-23,1971-03-23,121,3,129,434,563,52,251,303,866,18,109,Iowa,Cedar Rapids,126326
5908,1971-1972,1971-11-08,1972-04-07,152,0,104,436,540,76,195,271,811,26,187,Iowa,Cedar Rapids,126326
5909,1972-1973,1972-10-18,1973-04-13,178,0,107,369,476,70,190,260,736,21,150,Iowa,Cedar Rapids,126326
5910,1973-1974,1973-12-01,1974-03-30,120,2,113,372,485,42,174,216,701,23,158,Iowa,Cedar Rapids,126326
5911,1974-1975,1974-11-13,1975-04-09,148,1,80,412,492,93,275,368,860,32,187,Iowa,Cedar Rapids,126326
5912,1975-1976,1975-11-21,1976-04-25,157,2,54,348,402,27,33,60,462,12,63,Iowa,Cedar Rapids,126326
5913,1976-1977,1976-10-19,1977-04-05,169,0,164,595,759,33,134,167,926,21,171,Iowa,Cedar Rapids,126326
5914,1977-1978,1977-11-10,1978-03-26,137,0,182,599,781,80,459,539,1320,36,288,Iowa,Cedar Rapids,126326
5915,1978-1979,1978-11-20,1979-04-04,136,0,212,568,780,90,632,722,1502,45,360,Iowa,Cedar Rapids,126326
5916,1979-1980,1979-11-09,1980-04-14,158,2,93,398,491,44,85,129,620,24,140,Iowa,Cedar Rapids,126326
5917,1980-1981,1980-10-27,1981-02-28,125,0,79,338,417,27,42,69,486,16,109,Iowa,Cedar Rapids,126326
5918,1981-1982,1981-11-19,1982-04-10,143,1,154,520,674,64,342,406,1080,34,286,Iowa,Cedar Rapids,126326
5919,1982-1983,1982-11-04,1983-04-09,157,3,44,289,333,40,91,131,464,18,87,Iowa,Cedar Rapids,126326
5920,1983-1984,1983-11-13,1984-04-22,162,3,155,461,616,70,343,413,1029,35,238,Iowa,Cedar Rapids,126326
5921,1984-1985,1984-11-30,1985-03-31,122,0,107,385,492,38,193,231,723,20,130,Iowa,Cedar Rapids,126326
5922,1985-1986,1985-11-20,1986-04-15,147,0,145,490,635,64,428,492,1127,31,218,Iowa,Cedar Rapids,126326
5923,1986-1987,1986-10-13,1987-03-30,169,2,43,293,336,29,35,64,400,13,63,Iowa,Cedar Rapids,126326
5924,1987-1988,1987-12-01,1988-03-15,106,1,106,359,465,41,155,196,661,17,126,Iowa,Cedar Rapids,126326
5925,1988-1989,1988-11-06,1989-03-18,133,1,72,368,440,26,42,68,508,18,126,Iowa,Cedar Rapids,126326
5926,1989-1990,1989-11-18,1990-02-28,103,0,79,316,395,31,79,110,505,17,111,Iowa,Cedar Rapids,126326
5927,1990-1991,1990-11-05,1991-03-16,132,0,98,371,469,57,174,231,700,25,159,Iowa,Cedar Rapids,126326
5928,1991-1992,1991-11-01,1992-04-13,165,2,50,304,354,53,89,142,496,27,133,Iowa,Cedar Rapids,126326
5929,1992-1993,1992-11-06,1993-04-16,162,0,99,382,481,69,204,273,754,38,181,Iowa,Cedar Rapids,126326
5930,1993-1994,1993-10-30,1994-04-30,183,4,161,460,621,55,271,326,947,31,249,Iowa,Cedar Rapids,126326
5931,1994-1995,1994-11-29,1995-04-10,133,0,95,319,414,42,157,199,613,17,105,Iowa,Cedar Rapids,126326
5932,1995-1996,1995-10-31,1996-04-29,182,0,135,493,628,56,161,217,845,28,195,Iowa,Cedar Rapids,126326
5933,1996-1997,1996-11-11,1997-05-01,172,1,127,424,551,87,192,279,830,39,266,Iowa,Cedar Rapids,126326
5934,1997-1998,1997-10-26,1998-03-15,141,0,59,252,311,64,154,218,529,33,149,Iowa,Cedar Rapids,126326
5935,1998-1999,1998-11-08,1999-03-13,126,2,82,286,368,42,193,235,603,22,164,Iowa,Cedar Rapids,126326
5936,1999-2000,1999-10-03,2000-04-08,189,4,57,299,356,43,137,180,536,24,134,Iowa,Cedar Rapids,126326
5937,2000-2001,2000-11-13,2001-03-25,133,4,143,464,607,63,463,526,1133,28,224,Iowa,Cedar Rapids,126326
5938,2001-2002,2001-12-01,2002-04-01,122,0,45,240,285,32,48,80,365,15,87,Iowa,Cedar Rapids,126326
5939,2002-2003,2002-11-24,2003-04-08,136,0,80,383,463,37,68,105,568,18,111,Iowa,Cedar Rapids,126326
5940,2003-2004,2003-11-24,2004-03-17,115,1,70,306,376,38,167,205,581,19,125,Iowa,Cedar Rapids,126326
5941,2004-2005,2004-11-29,2005-03-23,115,0,64,283,347,41,144,185,532,21,107,Iowa,Cedar Rapids,126326
5942,2005-2006,2005-11-15,2006-03-16,122,0,68,285,353,55,160,215,568,22,154,Iowa,Cedar Rapids,126326
5943,2006-2007,2006-10-12,2007-04-11,182,10,97,370,467,33,194,227,694,15,99,Iowa,Cedar Rapids,126326
5944,2007-2008,2007-11-21,2008-04-04,136,1,137,457,594,93,484,577,1171,40,274,Iowa,Cedar Rapids,126326
5945,2008-2009,2008-11-21,2009-03-29,129,0,134,473,607,68,251,319,926,27,203,Iowa,Cedar Rapids,126326
5946,2009-2010,2009-12-01,2010-03-20,110,0,129,381,510,62,451,513,1023,24,171,Iowa,Cedar Rapids,126326
5947,2010-2011,2010-12-01,2011-04-16,137,0,123,388,511,61,271,332,843,23,156,Iowa,Cedar Rapids,126326
5948,2011-2012,2011-11-09,2012-03-05,118,1,31,223,254,37,94,131,385,20,103,Iowa,Cedar Rapids,126326
5949,2012-2013,2012-11-24,2013-03-25,122,2,68,342,410,42,196,238,648,14,82,Iowa,Cedar Rapids,126326
5950,2013-2014,2013-11-11,2014-03-25,135,0,190,585,775,67,481,548,1323,35,302,Iowa,Cedar Rapids,126326
5951,2014-2015,2014-11-12,2015-03-09,118,0,127,424,551,38,214,252,803,17,137,Iowa,Cedar Rapids,126326
5952,2015-2016,2015-11-20,2016-03-03,105,0,68,232,300,29,123,152,452,18,97,Iowa,Cedar Rapids,126326
5953,2016-2017,2016-12-01,2017-03-15,105,0,65,254,319,25,70,95,414,12,68,Iowa,Cedar Rapids,126326
5954,2017-2018,2017-11-10,2018-04-19,161,9,117,435,552,67,148,215,767,32,246,Iowa,Cedar Rapids,126326
5955,2019-2020,2019-10-29,2020-04-17,172,0,65,321,386,60,158,218,604,31,165,Iowa,Cedar Rapids,126326
5956,1952-1953,1952-11-26,1953-03-07,102,19,45,280,325,41,106,147,472,12,90,Iowa,Clarinda,5572
5957,1953-1954,1953-12-01,1954-03-30,120,1,38,313,351,9,11,20,371,5,27,Iowa,Clarinda,5572
5958,1954-1955,1954-12-01,1955-03-27,117,1,55,343,398,43,158,201,599,14,118,Iowa,Clarinda,5572
5959,1955-1956,1955-11-16,1956-03-12,118,3,72,398,470,28,78,106,576,13,93,Iowa,Clarinda,5572
5960,1956-1957,1956-11-16,1957-04-12,148,0,67,375,442,55,114,169,611,16,131,Iowa,Clarinda,5572
5961,1957-1958,1957-10-26,1958-03-11,137,7,68,336,404,45,148,193,597,19,98,Iowa,Clarinda,5572
5962,1958-1959,1958-11-27,1959-03-18,112,0,86,383,469,40,121,161,630,16,119,Iowa,Clarinda,5572
5963,1959-1960,1959-11-05,1960-04-30,178,0,97,478,575,82,394,476,1051,26,196,Iowa,Clarinda,5572
5964,1960-1961,1960-11-30,1961-04-01,123,0,42,359,401,32,46,78,479,14,80,Iowa,Clarinda,5572
5965,1961-1962,1961-11-16,1962-04-01,137,0,133,481,614,77,438,515,1129,18,163,Iowa,Clarinda,5572
5966,1962-1963,1962-11-19,1963-03-11,113,0,122,431,553,34,110,144,697,14,131,Iowa,Clarinda,5572
5967,1963-1964,1963-12-01,1964-03-27,118,2,77,354,431,39,89,128,559,13,114,Iowa,Clarinda,5572
5968,1964-1965,1964-11-21,1965-03-26,126,0,91,449,540,50,93,143,683,16,152,Iowa,Clarinda,5572
5969,1965-1966,1965-11-28,1966-03-06,99,0,67,293,360,5,3,8,368,3,19,Iowa,Clarinda,5572
5970,1966-1967,1966-11-02,1967-04-24,174,0,58,392,450,24,72,96,546,7,60,Iowa,Clarinda,5572
5971,1967-1968,1967-12-01,1968-03-22,113,0,69,312,381,20,96,116,497,5,60,Iowa,Clarinda,5572
5972,1970-1971,1970-11-23,1971-03-25,123,0,95,386,481,56,317,373,854,10,92,Iowa,Clarinda,5572
5973,1971-1972,1971-11-23,1972-03-31,130,3,67,349,416,23,45,68,484,9,69,Iowa,Clarinda,5572
5974,1972-1973,1972-11-14,1973-04-10,148,0,88,350,438,51,156,207,645,12,113,Iowa,Clarinda,5572
5975,1973-1974,1973-12-01,1974-03-23,113,0,79,319,398,53,200,253,651,12,142,Iowa,Clarinda,5572
5976,1974-1975,1974-11-29,1975-04-03,126,0,56,363,419,68,156,224,643,13,128,Iowa,Clarinda,5572
5977,1975-1976,1975-11-25,1976-03-05,102,1,40,269,309,35,53,88,397,8,66,Iowa,Clarinda,5572
5978,1976-1977,1976-11-12,1977-02-28,109,0,103,446,549,22,96,118,667,8,77,Iowa,Clarinda,5572
5979,1977-1978,1977-11-21,1978-03-18,118,3,150,510,660,38,259,297,957,12,127,Iowa,Clarinda,5572
5980,1978-1979,1978-11-19,1979-04-02,135,1,176,523,699,52,331,383,1082,14,159,Iowa,Clarinda,5572
5981,1979-1980,1979-11-28,1980-03-14,108,0,69,344,413,43,110,153,566,12,103,Iowa,Clarinda,5572
5982,1980-1981,1980-10-28,1981-03-05,129,4,49,323,372,21,57,78,450,5,54,Iowa,Clarinda,5572
5983,1982-1983,1982-11-04,1983-03-28,145,4,39,252,291,21,54,75,366,5,40,Iowa,Clarinda,5572
5984,1983-1984,1983-11-24,1984-03-21,119,8,125,399,524,67,244,311,835,18,184,Iowa,Clarinda,5572
5985,1984-1985,1984-12-01,1985-04-01,122,13,64,336,400,38,81,119,519,8,85,Iowa,Clarinda,5572
5986,1985-1986,1985-11-20,1986-04-15,147,5,90,366,456,34,131,165,621,10,91,Iowa,Clarinda,5572
5987,1986-1987,1986-11-11,1987-03-30,140,10,25,283,308,18,20,38,346,6,41,Iowa,Clarinda,5572
5988,1987-1988,1987-11-27,1988-02-29,95,3,66,307,373,30,67,97,470,6,73,Iowa,Clarinda,5572
5989,1989-1990,1989-11-17,1990-03-24,128,1,96,377,473,37,121,158,631,17,135,Iowa,Clarinda,5572
5990,1990-1991,1990-11-28,1991-03-14,107,3,109,364,473,35,207,242,715,14,141,Iowa,Clarinda,5572
5991,1992-1993,1992-11-06,1993-04-02,148,8,109,391,500,51,269,320,820,20,150,Iowa,Clarinda,5572
5992,1993-1994,1993-10-31,1994-04-30,182,16,114,446,560,30,82,112,672,17,143,Iowa,Clarinda,5572
5993,1994-1995,1994-11-28,1995-03-10,103,2,80,321,401,31,129,160,561,14,99,Iowa,Clarinda,5572
5994,1995-1996,1995-11-02,1996-03-31,151,9,140,471,611,50,228,278,889,26,184,Iowa,Clarinda,5572
5995,1997-1998,1997-10-26,1998-03-21,147,9,67,329,396,54,152,206,602,16,100,Iowa,Clarinda,5572
5996,1998-1999,1998-11-07,1999-03-11,125,6,70,317,387,30,75,105,492,10,75,Iowa,Clarinda,5572
5997,1999-2000,1999-12-01,2000-03-19,110,0,36,322,358,17,24,41,399,8,46,Iowa,Clarinda,5572
5998,2000-2001,2000-11-09,2001-03-17,129,6,143,547,690,58,254,312,1002,21,217,Iowa,Clarinda,5572
5999,2001-2002,2001-11-28,2002-03-27,120,0,47,354,401,23,47,70,471,7,55,Iowa,Clarinda,5572
6000,2002-2003,2002-10-17,2003-03-11,146,2,80,475,555,37,77,114,669,14,107,Iowa,Clarinda,5572
6001,2003-2004,2003-11-06,2004-03-17,133,0,95,376,471,43,176,219,690,14,109,Iowa,Clarinda,5572
6002,2004-2005,2004-11-29,2005-03-01,93,3,64,295,359,20,88,108,467,6,61,Iowa,Clarinda,5572
6003,2005-2006,2005-11-16,2006-03-22,127,0,60,335,395,25,44,69,464,9,72,Iowa,Clarinda,5572
6004,2006-2007,2006-11-30,2007-03-08,99,0,97,373,470,45,167,212,682,11,107,Iowa,Clarinda,5572
6005,2007-2008,2007-11-22,2008-03-11,111,3,120,486,606,60,229,289,895,21,189,Iowa,Clarinda,5572
6006,2008-2009,2008-11-22,2009-03-12,111,0,101,441,542,31,67,98,640,14,114,Iowa,Clarinda,5572
6007,2009-2010,2009-12-01,2010-03-21,111,0,152,469,621,83,377,460,1081,25,230,Iowa,Clarinda,5572
6008,2010-2011,2010-11-26,2011-03-29,124,0,101,424,525,43,154,197,722,16,127,Iowa,Clarinda,5572
6009,2011-2012,2011-11-09,2012-02-29,113,0,32,279,311,16,20,36,347,8,33,Iowa,Clarinda,5572
6010,2012-2013,2012-12-01,2013-03-26,116,0,59,329,388,31,47,78,466,7,61,Iowa,Clarinda,5572
6011,2013-2014,2013-11-23,2014-03-06,104,3,141,506,647,37,114,151,798,10,97,Iowa,Clarinda,5572
6012,2014-2015,2014-11-12,2015-03-06,115,0,90,417,507,28,50,78,585,10,86,Iowa,Clarinda,5572
6013,2015-2016,2015-11-28,2016-03-02,96,0,47,225,272,17,34,51,323,8,52,Iowa,Clarinda,5572
6014,2016-2017,2016-12-01,2017-03-14,104,0,54,271,325,4,5,9,334,3,19,Iowa,Clarinda,5572
6015,2017-2018,2017-12-01,2018-04-16,137,0,106,420,526,24,74,98,624,11,98,Iowa,Clarinda,5572
6016,2018-2019,2018-11-09,2019-03-10,122,0,126,460,586,75,296,371,957,20,174,Iowa,Clarinda,5572
6017,2019-2020,2019-10-31,2020-04-17,170,0,45,339,384,31,28,59,443,12,69,Iowa,Clarinda,5572
6018,1950-1951,1950-11-10,1951-03-24,135,4,126,459,585,62,267,329,914,31,201,Iowa,Clinton,26885
6019,1951-1952,1951-11-02,1952-03-23,143,2,85,349,434,86,235,321,755,23,197,Iowa,Clinton,26885
6020,1952-1953,1952-11-26,1953-04-19,145,3,48,268,316,48,98,146,462,20,131,Iowa,Clinton,26885
6021,1953-1954,1953-11-26,1954-04-03,129,0,46,279,325,45,78,123,448,11,71,Iowa,Clinton,26885
6022,1954-1955,1954-11-01,1955-03-26,146,0,60,304,364,54,123,177,541,23,154,Iowa,Clinton,26885
6023,1955-1956,1955-11-16,1956-03-15,121,0,62,353,415,26,43,69,484,22,110,Iowa,Clinton,26885
6024,1956-1957,1956-11-22,1957-03-25,124,0,75,314,389,43,107,150,539,20,143,Iowa,Clinton,26885
6025,1957-1958,1957-11-30,1958-03-05,96,0,86,300,386,40,245,285,671,15,87,Iowa,Clinton,26885
6026,1958-1959,1958-11-26,1959-03-17,112,0,129,473,602,66,230,296,898,15,140,Iowa,Clinton,26885
6027,1959-1960,1959-11-06,1960-03-27,143,0,97,441,538,90,382,472,1010,25,181,Iowa,Clinton,26885
6028,1960-1961,1960-11-29,1961-04-17,140,2,76,330,406,29,73,102,508,10,64,Iowa,Clinton,26885
6029,1961-1962,1961-11-19,1962-03-21,123,0,157,447,604,58,418,476,1080,19,146,Iowa,Clinton,26885
6030,1962-1963,1962-12-01,1963-03-13,103,0,161,470,631,42,151,193,824,17,159,Iowa,Clinton,26885
6031,1963-1964,1963-12-01,1964-03-29,120,2,105,417,522,49,129,178,700,15,94,Iowa,Clinton,26885
6032,1964-1965,1964-11-20,1965-03-27,128,1,122,438,560,76,168,244,804,20,182,Iowa,Clinton,26885
6033,1965-1966,1965-11-28,1966-03-24,117,0,106,350,456,31,157,188,644,11,89,Iowa,Clinton,26885
6034,1966-1967,1966-12-01,1967-04-23,144,1,76,345,421,56,172,228,649,17,126,Iowa,Clinton,26885
6035,1967-1968,1967-10-27,1968-03-22,148,1,80,374,454,29,55,84,538,14,96,Iowa,Clinton,26885
6036,1968-1969,1968-12-01,1969-03-31,121,1,91,368,459,18,71,89,548,7,48,Iowa,Clinton,26885
6037,1969-1970,1969-11-14,1970-04-02,140,1,154,527,681,56,189,245,926,24,184,Iowa,Clinton,26885
6038,1970-1971,1970-11-23,1971-03-23,121,1,111,379,490,38,197,235,725,12,84,Iowa,Clinton,26885
6039,1971-1972,1971-11-24,1972-04-07,136,2,85,375,460,53,161,214,674,16,103,Iowa,Clinton,26885
6040,1972-1973,1972-10-18,1973-04-09,174,8,74,305,379,23,87,110,489,8,42,Iowa,Clinton,26885
6041,1973-1974,1973-12-01,1974-03-24,114,1,98,317,415,48,165,213,628,16,125,Iowa,Clinton,26885
6042,1974-1975,1974-11-13,1975-04-05,144,3,64,345,409,68,171,239,648,20,112,Iowa,Clinton,26885
6043,1975-1976,1975-11-25,1976-02-29,97,0,50,278,328,24,63,87,415,12,61,Iowa,Clinton,26885
6044,1976-1977,1976-11-11,1977-03-22,132,2,166,533,699,40,211,251,950,20,165,Iowa,Clinton,26885
6045,1977-1978,1977-11-25,1978-03-26,122,0,166,532,698,67,354,421,1119,24,193,Iowa,Clinton,26885
6046,1978-1979,1978-11-20,1979-03-25,126,2,188,511,699,109,860,969,1668,30,256,Iowa,Clinton,26885
6047,1979-1980,1979-11-29,1980-04-15,139,0,78,345,423,40,123,163,586,16,95,Iowa,Clinton,26885
6048,1980-1981,1980-10-28,1981-02-28,124,0,65,319,384,23,63,86,470,13,83,Iowa,Clinton,26885
6049,1981-1982,1981-11-20,1982-04-09,141,2,127,473,600,55,261,316,916,27,197,Iowa,Clinton,26885
6050,1982-1983,1982-11-05,1983-03-26,142,0,36,256,292,26,52,78,370,15,63,Iowa,Clinton,26885
6051,1983-1984,1983-11-29,1984-03-21,114,0,136,399,535,53,262,315,850,24,171,Iowa,Clinton,26885
6052,1984-1985,1984-12-01,1985-03-05,95,0,103,378,481,47,289,336,817,21,149,Iowa,Clinton,26885
6053,1985-1986,1985-11-21,1986-03-07,107,0,125,400,525,47,202,249,774,24,146,Iowa,Clinton,26885
6054,1986-1987,1986-11-11,1987-02-28,110,0,41,228,269,23,21,44,313,15,63,Iowa,Clinton,26885
6055,1987-1988,1987-12-01,1988-03-15,106,0,105,328,433,49,204,253,686,20,154,Iowa,Clinton,26885
6056,1989-1990,1989-11-18,1990-02-28,103,0,80,312,392,42,116,158,550,22,167,Iowa,Clinton,26885
6057,1990-1991,1990-11-09,1991-03-17,129,0,81,332,413,55,171,226,639,19,134,Iowa,Clinton,26885
6058,1991-1992,1991-11-02,1992-04-01,152,3,45,275,320,34,62,96,416,16,84,Iowa,Clinton,26885
6059,1992-1993,1992-11-13,1993-04-01,140,0,79,321,400,50,116,166,566,28,137,Iowa,Clinton,26885
6060,1993-1994,1993-11-06,1994-03-04,119,0,154,395,549,72,315,387,936,30,273,Iowa,Clinton,26885
6061,1994-1995,1994-12-01,1995-03-08,98,0,80,269,349,43,239,282,631,14,92,Iowa,Clinton,26885
6062,1995-1996,1995-11-09,1996-03-26,139,2,121,432,553,44,138,182,735,23,148,Iowa,Clinton,26885
6063,1996-1997,1996-11-12,1997-04-12,152,0,116,384,500,62,158,220,720,28,196,Iowa,Clinton,26885
6064,1997-1998,1997-10-26,1998-03-16,142,0,49,226,275,54,120,174,449,23,104,Iowa,Clinton,26885
6065,1998-1999,1998-11-08,1999-03-15,128,2,79,287,366,58,211,269,635,23,179,Iowa,Clinton,26885
6066,1999-2000,1999-12-01,2000-04-08,130,0,66,283,349,58,191,249,598,22,155,Iowa,Clinton,26885
6067,2000-2001,2000-11-13,2001-03-25,133,2,130,447,577,59,375,434,1011,31,222,Iowa,Clinton,26885
6068,2001-2002,2001-12-01,2002-04-01,122,2,42,241,283,35,75,110,393,15,87,Iowa,Clinton,26885
6069,2002-2003,2002-11-24,2003-04-07,135,0,75,387,462,37,64,101,563,21,119,Iowa,Clinton,26885
6070,2003-2004,2003-11-24,2004-03-17,115,0,73,294,367,40,138,178,545,20,116,Iowa,Clinton,26885
6071,2004-2005,2004-11-30,2005-03-23,114,2,57,265,322,31,85,116,438,17,84,Iowa,Clinton,26885
6072,2005-2006,2005-11-16,2006-03-17,122,0,69,280,349,30,108,138,487,17,100,Iowa,Clinton,26885
6073,2006-2007,2006-12-01,2007-04-12,133,0,103,319,422,43,185,228,650,15,108,Iowa,Clinton,26885
6074,2007-2008,2007-12-01,2008-03-24,115,3,112,387,499,85,328,413,912,34,247,Iowa,Clinton,26885
6075,2008-2009,2008-11-21,2009-03-29,129,0,124,452,576,53,251,304,880,29,220,Iowa,Clinton,26885
6076,2009-2010,2009-12-01,2010-03-20,110,1,114,343,457,52,294,346,803,24,135,Iowa,Clinton,26885
6077,2011-2012,2011-11-09,2012-03-03,116,0,28,200,228,32,68,100,328,14,79,Iowa,Clinton,26885
6078,2012-2013,2012-11-27,2013-03-25,119,0,57,300,357,41,134,175,532,20,95,Iowa,Clinton,26885
6079,2013-2014,2013-11-11,2014-03-25,135,0,184,559,743,75,454,529,1272,37,306,Iowa,Clinton,26885
6080,2014-2015,2014-11-12,2015-03-23,132,0,117,413,530,53,277,330,860,21,164,Iowa,Clinton,26885
6081,2015-2016,2015-11-21,2016-03-24,125,0,53,216,269,30,56,86,355,16,82,Iowa,Clinton,26885
6082,2016-2017,2016-12-01,2017-03-15,105,0,64,230,294,31,64,95,389,13,93,Iowa,Clinton,26885
6083,2017-2018,2017-11-10,2018-04-19,161,0,119,423,542,54,134,188,730,27,203,Iowa,Clinton,26885
6084,2018-2019,2018-11-08,2019-03-17,130,0,124,393,517,69,298,367,884,28,215,Iowa,Clinton,26885
6085,2019-2020,2019-10-29,2020-04-17,172,0,42,256,298,46,86,132,430,24,97,Iowa,Clinton,26885
6086,1952-1953,1952-11-25,1953-04-15,142,2,84,355,439,36,257,293,732,13,97,Iowa,Denison,8298
6087,1953-1954,1953-12-01,1954-03-31,121,2,66,391,457,20,15,35,492,6,44,Iowa,Denison,8298
6088,1954-1955,1954-11-30,1955-03-28,119,3,87,412,499,23,163,186,685,7,61,Iowa,Denison,8298
6089,1955-1956,1955-11-07,1956-03-15,130,4,132,506,638,12,74,86,724,6,51,Iowa,Denison,8298
6090,1956-1957,1956-11-20,1957-04-05,137,11,98,412,510,22,96,118,628,5,47,Iowa,Denison,8298
6091,1957-1958,1957-10-26,1958-03-17,143,4,104,393,497,40,169,209,706,8,66,Iowa,Denison,8298
6092,1958-1959,1958-11-26,1959-04-20,146,6,123,527,650,30,106,136,786,7,61,Iowa,Denison,8298
6093,1959-1960,1959-11-05,1960-03-29,146,5,168,521,689,74,509,583,1272,15,150,Iowa,Denison,8298
6094,1960-1961,1960-11-29,1961-03-15,107,0,77,357,434,38,77,115,549,9,87,Iowa,Denison,8298
6095,1961-1962,1961-11-05,1962-03-23,139,3,181,528,709,72,486,558,1267,14,154,Iowa,Denison,8298
6096,1962-1963,1962-11-18,1963-03-09,112,0,147,452,599,36,168,204,803,11,124,Iowa,Denison,8298
6097,1964-1965,1964-11-19,1965-04-26,159,1,152,566,718,64,248,312,1030,32,283,Iowa,Denison,8298
6098,1965-1966,1965-11-27,1966-04-05,130,1,109,385,494,23,98,121,615,15,95,Iowa,Denison,8298
6099,1966-1967,1966-11-02,1967-03-17,136,0,85,454,539,23,96,119,658,17,130,Iowa,Denison,8298
6100,1967-1968,1967-11-04,1968-03-22,140,1,85,430,515,18,41,59,574,14,114,Iowa,Denison,8298
6101,1968-1969,1968-11-08,1969-03-30,143,3,164,502,666,67,517,584,1250,30,221,Iowa,Denison,8298
6102,1969-1970,1969-11-14,1970-03-31,138,0,144,498,642,63,379,442,1084,23,208,Iowa,Denison,8298
6103,1970-1971,1970-10-10,1971-04-02,175,0,146,483,629,52,275,327,956,19,143,Iowa,Denison,8298
6104,1971-1972,1971-11-23,1972-04-04,134,0,129,454,583,53,206,259,842,20,179,Iowa,Denison,8298
6105,1972-1973,1972-11-14,1973-04-16,154,1,135,392,527,68,279,347,874,27,232,Iowa,Denison,8298
6106,1973-1974,1973-12-01,1974-04-14,135,0,124,390,514,46,262,308,822,21,183,Iowa,Denison,8298
6107,1974-1975,1974-11-13,1975-04-03,142,0,109,469,578,87,526,613,1191,31,237,Iowa,Denison,8298
6108,1975-1976,1975-11-12,1976-03-30,140,0,78,382,460,36,73,109,569,16,124,Iowa,Denison,8298
6109,1976-1977,1976-10-19,1977-03-21,154,0,132,546,678,40,77,117,795,21,153,Iowa,Denison,8298
6110,1977-1978,1977-11-10,1978-03-17,128,1,247,584,831,54,216,270,1101,21,210,Iowa,Denison,8298
6111,1978-1979,1978-11-17,1979-04-04,139,0,267,628,895,95,657,752,1647,29,296,Iowa,Denison,8298
6112,1979-1980,1979-10-23,1980-03-27,157,3,103,409,512,38,72,110,622,19,151,Iowa,Denison,8298
6113,1980-1981,1980-10-28,1981-02-28,124,2,87,344,431,24,49,73,504,9,92,Iowa,Denison,8298
6114,1983-1984,1983-11-10,1984-04-22,165,3,193,490,683,79,446,525,1208,24,214,Iowa,Denison,8298
6115,1984-1985,1984-11-09,1985-04-03,146,4,105,414,519,47,84,131,650,18,149,Iowa,Denison,8298
6116,1985-1986,1985-11-09,1986-03-17,129,3,135,450,585,49,278,327,912,19,170,Iowa,Denison,8298
6117,1986-1987,1986-11-09,1987-04-04,147,2,38,290,328,49,84,133,461,15,113,Iowa,Denison,8298
6118,1987-1988,1987-11-17,1988-03-17,122,6,89,374,463,46,151,197,660,20,156,Iowa,Denison,8298
6119,1988-1989,1988-11-16,1989-03-18,123,8,101,395,496,35,59,94,590,19,161,Iowa,Denison,8298
6120,1989-1990,1989-11-16,1990-03-23,128,1,91,383,474,39,82,121,595,17,140,Iowa,Denison,8298
6121,1990-1991,1990-10-18,1991-03-28,162,0,135,445,580,58,314,372,952,20,178,Iowa,Denison,8298
6122,1991-1992,1991-10-30,1992-04-22,176,7,64,328,392,43,112,155,547,18,115,Iowa,Denison,8298
6123,1992-1993,1992-11-03,1993-04-01,150,3,159,443,602,61,281,342,944,25,179,Iowa,Denison,8298
6124,1993-1994,1993-10-30,1994-05-01,184,4,182,525,707,47,205,252,959,23,215,Iowa,Denison,8298
6125,1994-1995,1994-11-28,1995-04-04,128,3,119,357,476,41,154,195,671,10,101,Iowa,Denison,8298
6126,1995-1996,1995-10-31,1996-04-16,169,5,170,520,690,47,141,188,878,18,177,Iowa,Denison,8298
6127,1996-1997,1996-10-31,1997-04-14,166,15,202,546,748,62,188,250,998,19,187,Iowa,Denison,8298
6128,1997-1998,1997-10-26,1998-03-25,151,2,100,350,450,62,201,263,713,30,163,Iowa,Denison,8298
6129,1998-1999,1998-11-07,1999-03-18,132,2,103,330,433,63,264,327,760,18,157,Iowa,Denison,8298
6130,1999-2000,1999-12-01,2000-04-08,130,4,63,314,377,32,97,129,506,17,114,Iowa,Denison,8298
6131,2000-2001,2000-11-07,2001-03-26,140,2,206,578,784,68,576,644,1428,27,260,Iowa,Denison,8298
6132,2001-2002,2001-11-29,2002-03-22,114,2,84,321,405,26,115,141,546,7,61,Iowa,Denison,8298
6133,2002-2003,2002-10-24,2003-04-09,168,5,117,483,600,52,123,175,775,15,129,Iowa,Denison,8298
6134,2003-2004,2003-11-23,2004-03-20,119,1,132,390,522,83,325,408,930,20,202,Iowa,Denison,8298
6135,2004-2005,2004-11-29,2005-03-13,105,2,92,333,425,23,95,118,543,8,68,Iowa,Denison,8298
6136,2005-2006,2005-11-16,2006-03-23,128,6,87,343,430,36,70,106,536,16,120,Iowa,Denison,8298
6137,2006-2007,2006-11-11,2007-04-12,153,5,127,427,554,63,210,273,827,14,134,Iowa,Denison,8298
6138,2007-2008,2007-11-22,2008-04-12,143,0,132,480,612,48,204,252,864,25,180,Iowa,Denison,8298
6139,2008-2009,2008-11-08,2009-04-08,152,1,114,467,581,57,187,244,825,21,166,Iowa,Denison,8298
6140,2009-2010,2009-12-01,2010-03-21,111,0,158,428,586,75,663,738,1324,21,187,Iowa,Denison,8298
6141,2010-2011,2010-11-12,2011-03-29,138,0,191,534,725,64,294,358,1083,22,214,Iowa,Denison,8298
6142,2011-2012,2011-11-20,2012-03-04,106,0,72,316,388,33,98,131,519,10,85,Iowa,Denison,8298
6143,2012-2013,2012-11-12,2013-05-02,172,0,126,496,622,59,198,257,879,15,122,Iowa,Denison,8298
6144,2013-2014,2013-11-12,2014-04-14,154,0,219,664,883,45,79,124,1007,21,202,Iowa,Denison,8298
6145,2014-2015,2014-11-11,2015-04-10,151,1,132,462,594,37,110,147,741,14,112,Iowa,Denison,8298
6146,2015-2016,2015-11-21,2016-03-04,105,0,115,297,412,53,222,275,687,18,143,Iowa,Denison,8298
6147,2016-2017,2016-12-01,2017-03-22,112,0,101,334,435,36,63,99,534,13,88,Iowa,Denison,8298
6148,2017-2018,2017-10-28,2018-04-19,174,0,176,526,702,52,125,177,879,24,200,Iowa,Denison,8298
6149,2018-2019,2018-10-15,2019-04-02,170,0,181,542,723,62,266,328,1051,19,178,Iowa,Denison,8298
6150,2019-2020,2019-10-29,2020-04-17,172,0,74,425,499,40,102,142,641,24,134,Iowa,Denison,8298
6151,1950-1951,1950-11-09,1951-03-31,143,0,150,492,642,44,151,195,837,22,168,Iowa,Des Moines,203433
6152,1951-1952,1951-11-01,1952-04-13,165,0,122,421,543,51,175,226,769,26,174,Iowa,Des Moines,203433
6153,1952-1953,1952-11-24,1953-03-24,121,0,73,288,361,46,152,198,559,22,122,Iowa,Des Moines,203433
6154,1953-1954,1953-11-27,1954-04-03,128,0,65,343,408,20,35,55,463,10,58,Iowa,Des Moines,203433
6155,1954-1955,1954-10-30,1955-03-27,149,0,82,365,447,45,156,201,648,26,178,Iowa,Des Moines,203433
6156,1955-1956,1955-10-30,1956-04-16,170,0,122,471,593,33,86,119,712,22,129,Iowa,Des Moines,203433
6157,1956-1957,1956-11-20,1957-04-10,142,0,92,369,461,60,112,172,633,31,214,Iowa,Des Moines,203433
6158,1957-1958,1957-11-17,1958-03-17,121,0,104,350,454,50,189,239,693,24,130,Iowa,Des Moines,203433
6159,1958-1959,1958-11-26,1959-04-21,147,0,132,439,571,60,161,221,792,28,194,Iowa,Des Moines,203433
6160,1959-1960,1959-11-05,1960-04-30,178,0,147,472,619,89,472,561,1180,39,266,Iowa,Des Moines,203433
6161,1960-1961,1960-11-30,1961-04-17,139,0,81,340,421,51,67,118,539,31,165,Iowa,Des Moines,203433
6162,1961-1962,1961-11-05,1962-04-12,159,0,202,525,727,103,547,650,1377,44,361,Iowa,Des Moines,203433
6163,1962-1963,1962-10-24,1963-03-13,141,0,183,488,671,56,186,242,913,32,298,Iowa,Des Moines,203433
6164,1963-1964,1963-12-01,1964-03-30,121,0,127,412,539,43,105,148,687,21,134,Iowa,Des Moines,203433
6165,1964-1965,1964-11-20,1965-03-27,128,0,167,520,687,61,154,215,902,36,282,Iowa,Des Moines,203433
6166,1965-1966,1965-11-27,1966-03-24,118,0,116,352,468,15,59,74,542,12,75,Iowa,Des Moines,203433
6167,1966-1967,1966-11-02,1967-04-23,173,0,86,421,507,27,71,98,605,18,120,Iowa,Des Moines,203433
6168,1967-1968,1967-10-26,1968-04-04,162,0,93,374,467,31,44,75,542,19,117,Iowa,Des Moines,203433
6169,1968-1969,1968-11-09,1969-03-30,142,0,147,451,598,60,225,285,883,31,184,Iowa,Des Moines,203433
6170,1969-1970,1969-11-14,1970-04-02,140,0,141,447,588,44,181,225,813,25,185,Iowa,Des Moines,203433
6171,1970-1971,1970-11-03,1971-04-01,150,0,127,385,512,61,208,269,781,25,136,Iowa,Des Moines,203433
6172,1971-1972,1971-11-08,1972-04-03,148,0,125,416,541,47,155,202,743,25,169,Iowa,Des Moines,203433
6173,1972-1973,1972-11-13,1973-04-16,155,0,137,362,499,80,205,285,784,29,210,Iowa,Des Moines,203433
6174,1973-1974,1973-12-01,1974-04-14,135,0,127,346,473,45,145,190,663,25,185,Iowa,Des Moines,203433
6175,1974-1975,1974-11-13,1975-04-05,144,0,97,372,469,87,212,299,768,36,205,Iowa,Des Moines,203433
6176,1975-1976,1975-11-12,1976-03-06,116,0,60,303,363,36,43,79,442,16,86,Iowa,Des Moines,203433
6177,1976-1977,1976-11-11,1977-04-05,146,0,136,493,629,37,66,103,732,28,189,Iowa,Des Moines,203433
6178,1977-1978,1977-11-09,1978-04-20,163,0,211,546,757,83,383,466,1223,37,273,Iowa,Des Moines,203433
6179,1978-1979,1978-11-16,1979-04-04,140,0,217,534,751,84,455,539,1290,42,332,Iowa,Des Moines,203433
6180,1979-1980,1979-11-12,1980-04-11,152,0,93,355,448,43,66,109,557,26,159,Iowa,Des Moines,203433
6181,1980-1981,1980-10-27,1981-02-28,125,0,73,316,389,32,48,80,469,13,114,Iowa,Des Moines,203433
6182,1981-1982,1981-10-24,1982-04-10,169,0,173,478,651,92,350,442,1093,37,308,Iowa,Des Moines,203433
6183,1982-1983,1982-10-19,1983-04-18,182,0,47,267,314,80,114,194,508,33,168,Iowa,Des Moines,203433
6184,1983-1984,1983-11-12,1984-04-29,170,0,165,429,594,84,321,405,999,38,301,Iowa,Des Moines,203433
6185,1984-1985,1984-11-10,1985-04-02,144,0,104,417,521,46,128,174,695,24,169,Iowa,Des Moines,203433
6186,1985-1986,1985-11-10,1986-04-15,157,0,141,468,609,49,275,324,933,24,197,Iowa,Des Moines,203433
6187,1986-1987,1986-11-10,1987-03-31,142,0,40,285,325,32,31,63,388,18,80,Iowa,Des Moines,203433
6188,1987-1988,1987-11-24,1988-03-17,115,0,106,350,456,38,88,126,582,22,147,Iowa,Des Moines,203433
6189,1988-1989,1988-11-05,1989-04-09,156,0,81,392,473,35,113,148,621,23,164,Iowa,Des Moines,203433
6190,1989-1990,1989-11-02,1990-03-23,142,0,85,355,440,49,103,152,592,28,194,Iowa,Des Moines,203433
6191,1990-1991,1990-11-06,1991-03-13,128,0,99,357,456,37,163,200,656,17,142,Iowa,Des Moines,203433
6192,1991-1992,1991-11-01,1992-04-21,173,0,43,280,323,39,53,92,415,23,104,Iowa,Des Moines,203433
6193,1992-1993,1992-11-03,1993-04-16,165,0,105,370,475,71,245,316,791,36,193,Iowa,Des Moines,203433
6194,1993-1994,1993-10-30,1994-04-30,183,0,137,461,598,46,163,209,807,25,206,Iowa,Des Moines,203433
6195,1994-1995,1994-11-28,1995-04-10,134,0,81,310,391,43,171,214,605,17,103,Iowa,Des Moines,203433
6196,1995-1996,1995-10-30,1996-04-14,168,0,143,480,623,66,213,279,902,22,196,Iowa,Des Moines,203433
6197,1996-1997,1996-11-10,1997-04-13,155,0,140,424,564,51,146,197,761,24,184,Iowa,Des Moines,203433
6198,1997-1998,1997-10-26,1998-03-21,147,0,70,264,334,70,172,242,576,29,149,Iowa,Des Moines,203433
6199,1998-1999,1998-11-07,1999-04-16,161,0,84,284,368,67,185,252,620,23,179,Iowa,Des Moines,203433
6200,1999-2000,1999-12-01,2000-04-08,130,0,46,249,295,36,73,109,404,16,103,Iowa,Des Moines,203433
6201,2000-2001,2000-11-08,2001-03-25,138,0,161,486,647,79,408,487,1134,27,246,Iowa,Des Moines,203433
6202,2001-2002,2001-11-28,2002-03-25,118,0,46,256,302,24,57,81,383,14,71,Iowa,Des Moines,203433
6203,2002-2003,2002-10-23,2003-04-09,169,0,95,426,521,50,122,172,693,19,134,Iowa,Des Moines,203433
6204,2003-2004,2003-11-24,2004-03-18,116,0,93,307,400,66,192,258,658,20,171,Iowa,Des Moines,203433
6205,2004-2005,2004-11-29,2005-03-25,117,0,66,274,340,32,120,152,492,15,82,Iowa,Des Moines,203433
6206,2005-2006,2005-11-15,2006-03-22,128,0,59,271,330,40,69,109,439,22,138,Iowa,Des Moines,203433
6207,2006-2007,2006-11-10,2007-04-12,154,0,102,346,448,57,223,280,728,24,166,Iowa,Des Moines,203433
6208,2007-2008,2007-11-21,2008-04-12,144,0,118,421,539,90,325,415,954,40,281,Iowa,Des Moines,203433
6209,2008-2009,2008-11-07,2009-04-06,151,0,100,406,506,67,213,280,786,34,250,Iowa,Des Moines,203433
6210,2009-2010,2009-10-10,2010-03-21,163,0,128,385,513,100,606,706,1219,36,275,Iowa,Des Moines,203433
6211,2010-2011,2010-11-25,2011-03-29,125,0,101,363,464,61,249,310,774,31,209,Iowa,Des Moines,203433
6212,2011-2012,2011-11-09,2012-03-04,117,0,30,205,235,36,68,104,339,21,100,Iowa,Des Moines,203433
6213,2012-2013,2012-12-01,2013-05-04,155,0,60,298,358,79,225,304,662,27,151,Iowa,Des Moines,203433
6214,2013-2014,2013-11-11,2014-04-14,155,0,154,514,668,72,191,263,931,33,238,Iowa,Des Moines,203433
6215,2014-2015,2014-11-11,2015-03-05,115,0,100,361,461,46,109,155,616,18,141,Iowa,Des Moines,203433
6216,2015-2016,2015-11-20,2016-03-19,121,0,53,210,263,47,88,135,398,22,131,Iowa,Des Moines,203433
6217,2016-2017,2016-12-01,2017-03-21,111,0,52,226,278,23,25,48,326,14,66,Iowa,Des Moines,203433
6218,2017-2018,2017-12-01,2018-04-18,139,0,111,355,466,54,99,153,619,36,260,Iowa,Des Moines,203433
6219,2018-2019,2018-10-12,2019-04-02,173,0,123,427,550,76,247,323,873,35,259,Iowa,Des Moines,203433
6220,2019-2020,2019-10-28,2020-04-17,173,0,63,311,374,58,151,209,583,34,161,Iowa,Des Moines,203433
6221,1950-1951,1950-11-10,1951-04-01,143,0,173,537,710,85,422,507,1217,35,279,Iowa,Dubuque,57637
6222,1951-1952,1951-11-02,1952-04-14,165,0,132,495,627,86,278,364,991,34,249,Iowa,Dubuque,57637
6223,1952-1953,1952-11-24,1953-04-19,147,0,86,352,438,45,148,193,631,27,144,Iowa,Dubuque,57637
6224,1953-1954,1953-11-26,1954-04-03,129,0,84,374,458,46,101,147,605,16,104,Iowa,Dubuque,57637
6225,1954-1955,1954-11-01,1955-03-28,148,0,115,420,535,56,155,211,746,37,249,Iowa,Dubuque,57637
6226,1955-1956,1955-10-30,1956-04-07,161,0,121,510,631,41,177,218,849,26,170,Iowa,Dubuque,57637
6227,1956-1957,1956-11-16,1957-04-03,139,0,124,437,561,52,167,219,780,28,175,Iowa,Dubuque,57637
6228,1957-1958,1957-11-18,1958-03-14,117,0,131,378,509,42,238,280,789,20,107,Iowa,Dubuque,57637
6229,1958-1959,1958-11-23,1959-04-20,149,0,192,568,760,100,500,600,1360,40,325,Iowa,Dubuque,57637
6230,1959-1960,1959-11-05,1960-05-08,186,0,148,514,662,105,625,730,1392,43,297,Iowa,Dubuque,57637
6231,1960-1961,1960-11-08,1961-04-17,161,0,113,418,531,56,151,207,738,22,146,Iowa,Dubuque,57637
6232,1961-1962,1961-11-06,1962-04-13,159,0,192,528,720,104,671,775,1495,38,301,Iowa,Dubuque,57637
6233,1962-1963,1962-10-24,1963-03-18,146,0,209,552,761,56,251,307,1068,33,303,Iowa,Dubuque,57637
6234,1963-1964,1963-11-30,1964-04-01,124,0,131,440,571,47,192,239,810,23,123,Iowa,Dubuque,57637
6235,1964-1965,1964-11-19,1965-04-02,135,0,182,552,734,73,258,331,1065,33,277,Iowa,Dubuque,57637
6236,1965-1966,1965-11-18,1966-05-11,175,0,140,449,589,36,161,197,786,18,115,Iowa,Dubuque,57637
6237,1966-1967,1966-12-01,1967-04-23,144,0,122,424,546,59,205,264,810,24,175,Iowa,Dubuque,57637
6238,1967-1968,1967-10-26,1968-04-24,182,0,123,439,562,30,70,100,662,22,158,Iowa,Dubuque,57637
6239,1968-1969,1968-11-16,1969-03-31,136,0,153,457,610,49,283,332,942,27,164,Iowa,Dubuque,57637
6240,1969-1970,1969-11-13,1970-04-02,141,0,184,561,745,68,448,516,1261,34,260,Iowa,Dubuque,57637
6241,1970-1971,1970-10-31,1971-04-03,155,0,185,499,684,71,481,552,1236,32,199,Iowa,Dubuque,57637
6242,1971-1972,1971-11-07,1972-04-14,160,0,158,492,650,87,242,329,979,37,239,Iowa,Dubuque,57637
6243,1972-1973,1972-10-18,1973-04-16,181,0,141,393,534,78,191,269,803,31,209,Iowa,Dubuque,57637
6244,1973-1974,1973-11-09,1974-04-14,157,0,160,430,590,53,197,250,840,33,231,Iowa,Dubuque,57637
6245,1974-1975,1974-11-14,1975-04-11,149,0,129,450,579,107,362,469,1048,43,265,Iowa,Dubuque,57637
6246,1975-1976,1975-11-24,1976-03-16,114,0,99,368,467,41,68,109,576,15,89,Iowa,Dubuque,57637
6247,1976-1977,1976-10-19,1977-04-05,169,0,235,643,878,59,183,242,1120,39,346,Iowa,Dubuque,57637
6248,1977-1978,1977-11-10,1978-03-27,138,0,266,638,904,106,554,660,1564,40,362,Iowa,Dubuque,57637
6249,1978-1979,1978-11-17,1979-04-05,140,0,265,624,889,98,693,791,1680,40,334,Iowa,Dubuque,57637
6250,1979-1980,1979-11-09,1980-04-15,159,0,122,436,558,60,118,178,736,36,233,Iowa,Dubuque,57637
6251,1980-1981,1980-10-27,1981-03-11,136,0,104,376,480,41,64,105,585,26,172,Iowa,Dubuque,57637
6252,1982-1983,1982-11-04,1983-04-10,158,0,74,325,399,80,170,250,649,28,166,Iowa,Dubuque,57637
6253,1983-1984,1983-11-12,1984-04-23,164,0,207,497,704,75,324,399,1103,41,267,Iowa,Dubuque,57637
6254,1984-1985,1984-11-19,1985-04-07,140,0,142,434,576,67,296,363,939,33,221,Iowa,Dubuque,57637
6255,1985-1986,1985-11-09,1986-04-15,158,0,197,560,757,93,549,642,1399,37,286,Iowa,Dubuque,57637
6256,1986-1987,1986-11-10,1987-03-31,142,0,70,320,390,54,68,122,512,25,106,Iowa,Dubuque,57637
6257,1987-1988,1987-11-17,1988-04-26,162,0,146,436,582,65,238,303,885,30,197,Iowa,Dubuque,57637
6258,1988-1989,1988-11-05,1989-04-09,156,0,115,426,541,42,105,147,688,25,169,Iowa,Dubuque,57637
6259,1989-1990,1989-11-03,1990-04-02,151,0,112,415,527,49,97,146,673,30,189,Iowa,Dubuque,57637
6260,1990-1991,1990-11-05,1991-04-23,170,0,123,425,548,78,332,410,958,33,222,Iowa,Dubuque,57637
6261,1991-1992,1991-11-01,1992-04-21,173,0,80,349,429,61,119,180,609,32,167,Iowa,Dubuque,57637
6262,1992-1993,1992-10-19,1993-04-20,184,0,128,423,551,99,255,354,905,43,229,Iowa,Dubuque,57637
6263,1993-1994,1993-11-05,1994-05-01,178,0,190,486,676,77,336,413,1089,33,294,Iowa,Dubuque,57637
6264,1994-1995,1994-11-28,1995-04-12,136,0,116,351,467,54,230,284,751,16,123,Iowa,Dubuque,57637
6265,1995-1996,1995-10-30,1996-04-29,183,19,180,547,727,54,166,220,947,23,150,Iowa,Dubuque,57637
6266,1996-1997,1996-10-31,1997-04-12,164,0,165,468,633,81,28,109,742,32,244,Iowa,Dubuque,57637
6267,1997-1998,1997-10-26,1998-03-15,141,15,79,270,349,61,0,61,410,31,147,Iowa,Dubuque,57637
6268,2004-2005,2004-11-24,2005-03-25,122,4,96,326,422,47,155,202,624,27,135,Iowa,Dubuque,57637
6269,2005-2006,2005-11-15,2006-03-24,130,1,98,354,452,50,200,250,702,23,141,Iowa,Dubuque,57637
6270,2006-2007,2006-11-10,2007-04-13,155,1,130,399,529,59,223,282,811,24,179,Iowa,Dubuque,57637
6271,2007-2008,2007-11-21,2008-04-08,140,0,174,502,676,115,495,610,1286,43,364,Iowa,Dubuque,57637
6272,2008-2009,2008-10-26,2009-04-05,162,0,169,542,711,78,269,347,1058,34,289,Iowa,Dubuque,57637
6273,2009-2010,2009-12-01,2010-03-20,110,0,140,393,533,69,380,449,982,33,228,Iowa,Dubuque,57637
6274,2010-2011,2010-11-23,2011-04-18,147,0,166,466,632,93,408,501,1133,36,275,Iowa,Dubuque,57637
6275,2011-2012,2011-11-09,2012-03-06,119,0,54,273,327,50,109,159,486,20,118,Iowa,Dubuque,57637
6276,2012-2013,2012-11-06,2013-03-26,141,0,111,414,525,78,270,348,873,31,188,Iowa,Dubuque,57637
6277,2013-2014,2013-11-11,2014-04-14,155,0,255,695,950,94,442,536,1486,46,430,Iowa,Dubuque,57637
6278,2014-2015,2014-11-11,2015-03-25,135,1,172,501,673,56,234,290,963,27,209,Iowa,Dubuque,57637
6279,2015-2016,2015-11-20,2016-04-08,141,6,79,288,367,59,195,254,621,30,168,Iowa,Dubuque,57637
6280,2016-2017,2016-12-01,2017-04-28,149,0,96,305,401,41,136,177,578,17,106,Iowa,Dubuque,57637
6281,2017-2018,2017-11-10,2018-04-19,161,0,145,483,628,59,151,210,838,34,259,Iowa,Dubuque,57637
6282,2018-2019,2018-11-08,2019-04-28,172,0,155,480,635,81,275,356,991,32,274,Iowa,Dubuque,57637
6283,2019-2020,2019-10-28,2020-04-17,173,0,78,369,447,58,211,269,716,36,171,Iowa,Dubuque,57637
6284,1951-1952,1951-11-03,1952-03-24,143,15,76,422,498,79,243,322,820,25,186,Iowa,Iowa City,67862
6285,1952-1953,1952-11-27,1953-03-09,103,0,46,275,321,47,68,115,436,20,123,Iowa,Iowa City,67862
6286,1953-1954,1953-11-26,1954-03-30,125,0,38,310,348,38,57,95,443,8,60,Iowa,Iowa City,67862
6287,1954-1955,1954-11-01,1955-03-26,146,2,61,343,404,52,132,184,588,30,185,Iowa,Iowa City,67862
6288,1955-1956,1955-11-16,1956-03-18,124,0,73,436,509,26,44,70,579,19,108,Iowa,Iowa City,67862
6289,1956-1957,1956-11-22,1957-04-03,133,0,67,352,419,30,81,111,530,15,119,Iowa,Iowa City,67862
6290,1957-1958,1957-11-19,1958-03-08,110,0,85,335,420,27,159,186,606,13,62,Iowa,Iowa City,67862
6291,1958-1959,1958-11-27,1959-04-20,145,0,109,464,573,70,202,272,845,23,176,Iowa,Iowa City,67862
6292,1959-1960,1959-11-06,1960-03-28,144,0,105,445,550,75,413,488,1038,29,176,Iowa,Iowa City,67862
6293,1960-1961,1960-11-29,1961-04-17,140,0,58,366,424,24,50,74,498,9,60,Iowa,Iowa City,67862
6294,1961-1962,1961-12-01,1962-03-19,109,0,133,452,585,69,436,505,1090,29,201,Iowa,Iowa City,67862
6295,1962-1963,1962-12-01,1963-03-13,103,0,159,464,623,35,129,164,787,21,202,Iowa,Iowa City,67862
6296,1963-1964,1963-12-01,1964-03-29,120,0,88,440,528,39,96,135,663,18,103,Iowa,Iowa City,67862
6297,1964-1965,1964-11-20,1965-03-26,127,0,117,467,584,45,97,142,726,25,181,Iowa,Iowa City,67862
6298,1965-1966,1965-11-28,1966-03-24,117,1,90,347,437,14,71,85,522,6,28,Iowa,Iowa City,67862
6299,1966-1967,1966-12-01,1967-04-23,144,0,59,352,411,25,75,100,511,13,63,Iowa,Iowa City,67862
6300,1967-1968,1967-10-27,1968-02-29,126,0,74,325,399,19,25,44,443,9,65,Iowa,Iowa City,67862
6301,1968-1969,1968-11-10,1969-03-30,141,16,85,380,465,38,106,144,609,18,90,Iowa,Iowa City,67862
6302,1969-1970,1969-11-14,1970-04-02,140,4,110,443,553,71,276,347,900,25,169,Iowa,Iowa City,67862
6303,1970-1971,1970-11-23,1971-03-23,121,1,107,368,475,32,182,214,689,14,64,Iowa,Iowa City,67862
6304,1971-1972,1971-11-22,1972-04-03,134,3,89,353,442,47,175,222,664,16,100,Iowa,Iowa City,67862
6305,1972-1973,1972-10-18,1973-04-11,176,0,82,313,395,62,121,183,578,20,113,Iowa,Iowa City,67862
6306,1973-1974,1973-12-01,1974-03-30,120,0,104,328,432,34,166,200,632,17,121,Iowa,Iowa City,67862
6307,1974-1975,1974-11-13,1975-04-03,142,2,57,318,375,79,184,263,638,23,123,Iowa,Iowa City,67862
6308,1975-1976,1975-11-21,1976-02-29,101,0,41,263,304,18,34,52,356,8,38,Iowa,Iowa City,67862
6309,1976-1977,1976-11-13,1977-04-06,145,1,142,493,635,41,136,177,812,20,143,Iowa,Iowa City,67862
6310,1977-1978,1977-11-25,1978-03-27,123,0,159,497,656,55,403,458,1114,25,177,Iowa,Iowa City,67862
6311,1978-1979,1978-11-21,1979-04-02,133,1,182,496,678,73,610,683,1361,23,205,Iowa,Iowa City,67862
6312,1979-1980,1979-11-29,1980-04-15,139,0,70,322,392,46,105,151,543,17,104,Iowa,Iowa City,67862
6313,1980-1981,1980-10-27,1981-02-28,125,0,58,288,346,23,42,65,411,11,68,Iowa,Iowa City,67862
6314,1981-1982,1981-11-20,1982-04-09,141,1,125,442,567,60,355,415,982,25,187,Iowa,Iowa City,67862
6315,1982-1983,1982-11-05,1983-04-09,156,7,41,227,268,34,76,110,378,13,56,Iowa,Iowa City,67862
6316,1983-1984,1983-11-13,1984-03-21,130,1,131,397,528,59,279,338,866,24,178,Iowa,Iowa City,67862
6317,1984-1985,1984-12-01,1985-03-05,95,13,92,331,423,31,246,277,700,15,103,Iowa,Iowa City,67862
6318,1985-1986,1985-11-20,1986-04-15,147,2,125,417,542,44,284,328,870,21,135,Iowa,Iowa City,67862
6319,1986-1987,1986-11-11,1987-03-30,140,6,32,237,269,15,13,28,297,9,38,Iowa,Iowa City,67862
6320,1987-1988,1987-12-01,1988-03-15,106,0,87,314,401,35,113,148,549,15,103,Iowa,Iowa City,67862
6321,1989-1990,1989-11-18,1990-02-28,103,0,69,291,360,37,99,136,496,16,122,Iowa,Iowa City,67862
6322,1990-1991,1990-12-01,1991-03-13,103,0,84,300,384,35,161,196,580,9,71,Iowa,Iowa City,67862
6323,1991-1992,1991-11-02,1992-03-13,133,11,38,233,271,25,64,89,360,11,61,Iowa,Iowa City,67862
6324,1992-1993,1992-11-14,1993-04-16,154,10,76,312,388,47,157,204,592,23,108,Iowa,Iowa City,67862
6325,1993-1994,1993-11-26,1994-03-03,98,2,131,348,479,49,193,242,721,19,161,Iowa,Iowa City,67862
6326,1994-1995,1994-12-01,1995-03-09,99,2,71,260,331,22,154,176,507,7,40,Iowa,Iowa City,67862
6327,1995-1996,1995-11-08,1996-03-26,140,6,116,400,516,35,154,189,705,9,72,Iowa,Iowa City,67862
6328,1996-1997,1996-11-11,1997-04-13,154,9,105,349,454,52,148,200,654,20,157,Iowa,Iowa City,67862
6329,1997-1998,1997-10-26,1998-03-12,138,10,40,200,240,35,126,161,401,16,73,Iowa,Iowa City,67862
6330,1998-1999,1998-12-01,1999-03-14,104,2,65,233,298,53,200,253,551,18,149,Iowa,Iowa City,67862
6331,1999-2000,1999-12-01,2000-04-08,130,7,44,234,278,46,176,222,500,14,113,Iowa,Iowa City,67862
6332,2000-2001,2000-11-17,2001-03-25,129,9,130,411,541,60,431,491,1032,20,195,Iowa,Iowa City,67862
6333,2001-2002,2001-12-01,2002-04-02,123,4,34,210,244,25,64,89,333,6,40,Iowa,Iowa City,67862
6334,2002-2003,2002-11-27,2003-03-13,107,5,66,378,444,27,64,91,535,7,61,Iowa,Iowa City,67862
6335,2003-2004,2003-11-24,2004-03-18,116,2,56,285,341,53,148,201,542,15,110,Iowa,Iowa City,67862
6336,2004-2005,2004-11-29,2005-03-10,102,13,52,221,273,22,72,94,367,7,44,Iowa,Iowa City,67862
6337,2005-2006,2005-11-17,2006-03-21,125,2,55,280,335,31,131,162,497,10,73,Iowa,Iowa City,67862
6338,2006-2007,2006-12-01,2007-03-03,93,11,68,279,347,23,114,137,484,8,53,Iowa,Iowa City,67862
6339,2007-2008,2007-12-01,2008-03-11,102,4,83,367,450,88,397,485,935,23,162,Iowa,Iowa City,67862
6340,2008-2009,2008-11-21,2009-03-29,129,2,79,405,484,52,196,248,732,21,158,Iowa,Iowa City,67862
6341,2009-2010,2009-12-01,2010-03-20,110,1,89,354,443,51,262,313,756,17,116,Iowa,Iowa City,67862
6342,2010-2011,2010-12-01,2011-02-28,90,2,83,305,388,53,235,288,676,12,96,Iowa,Iowa City,67862
6343,2012-2013,2012-11-24,2013-03-25,122,1,46,310,356,28,63,91,447,10,47,Iowa,Iowa City,67862
6344,2014-2015,2014-11-13,2015-03-07,115,0,132,465,597,40,140,180,777,13,115,Iowa,Iowa City,67862
6345,2015-2016,2015-11-21,2016-03-03,104,4,63,245,308,19,53,72,380,7,50,Iowa,Iowa City,67862
6346,2016-2017,2016-12-01,2017-03-16,106,0,66,278,344,19,28,47,391,9,50,Iowa,Iowa City,67862
6347,2017-2018,2017-12-01,2018-04-09,130,2,119,435,554,44,128,172,726,16,153,Iowa,Iowa City,67862
6348,2018-2019,2018-11-09,2019-03-17,129,2,123,469,592,60,200,260,852,17,154,Iowa,Iowa City,67862
6349,2019-2020,2019-10-29,2020-04-17,172,5,55,322,377,33,88,121,498,13,70,Iowa,Iowa City,67862
6350,1950-1951,1950-11-09,1951-04-11,154,7,246,727,973,79,574,653,1626,37,364,Iowa,Mason City,28079
6351,1951-1952,1951-11-01,1952-04-13,165,0,193,588,781,73,320,393,1174,35,258,Iowa,Mason City,28079
6352,1952-1953,1952-11-24,1953-03-24,121,0,141,432,573,46,457,503,1076,24,158,Iowa,Mason City,28079
6353,1953-1954,1953-11-22,1954-04-03,133,0,118,471,589,33,52,85,674,19,130,Iowa,Mason City,28079
6354,1954-1955,1954-10-30,1955-03-28,150,0,150,495,645,38,164,202,847,28,201,Iowa,Mason City,28079
6355,1955-1956,1955-11-03,1956-04-29,179,1,220,706,926,54,351,405,1331,27,208,Iowa,Mason City,28079
6356,1956-1957,1956-11-15,1957-04-11,148,2,151,524,675,47,151,198,873,20,180,Iowa,Mason City,28079
6357,1957-1958,1957-10-25,1958-03-20,147,0,150,456,606,35,241,276,882,15,86,Iowa,Mason City,28079
6358,1958-1959,1958-11-24,1959-03-27,124,0,225,624,849,57,328,385,1234,20,185,Iowa,Mason City,28079
6359,1959-1960,1959-11-04,1960-03-27,145,0,174,560,734,51,235,286,1020,26,185,Iowa,Mason City,28079
6360,1960-1961,1960-11-09,1961-04-17,160,0,158,569,727,67,321,388,1115,23,202,Iowa,Mason City,28079
6361,1961-1962,1961-11-05,1962-04-13,160,0,249,627,876,88,698,786,1662,31,292,Iowa,Mason City,28079
6362,1962-1963,1962-11-18,1963-03-16,119,0,217,538,755,56,214,270,1025,21,209,Iowa,Mason City,28079
6363,1963-1964,1963-11-23,1964-04-01,131,1,165,544,709,48,160,208,917,22,164,Iowa,Mason City,28079
6364,1964-1965,1964-11-19,1965-04-06,139,7,241,639,880,73,371,444,1324,23,241,Iowa,Mason City,28079
6365,1965-1966,1965-11-18,1966-04-11,145,0,188,504,692,41,184,225,917,15,122,Iowa,Mason City,28079
6366,1966-1967,1966-11-01,1967-03-18,138,0,138,510,648,39,210,249,897,13,130,Iowa,Mason City,28079
6367,1967-1968,1967-11-04,1968-03-22,140,0,136,507,643,16,40,56,699,6,53,Iowa,Mason City,28079
6368,1968-1969,1968-11-08,1969-03-31,144,0,237,633,870,71,690,761,1631,25,219,Iowa,Mason City,28079
6369,1969-1970,1969-11-13,1970-04-01,140,0,224,644,868,65,566,631,1499,16,147,Iowa,Mason City,28079
6370,1970-1971,1970-11-02,1971-04-02,152,1,250,620,870,97,759,856,1726,16,170,Iowa,Mason City,28079
6371,1971-1972,1971-11-06,1972-04-07,154,3,219,626,845,43,274,317,1162,18,151,Iowa,Mason City,28079
6372,1972-1973,1972-10-18,1973-04-14,179,0,177,491,668,79,305,384,1052,16,165,Iowa,Mason City,28079
6373,1973-1974,1973-11-08,1974-04-04,148,0,200,510,710,57,294,351,1061,18,170,Iowa,Mason City,28079
6374,1974-1975,1974-11-05,1975-04-10,157,0,168,539,707,71,467,538,1245,27,172,Iowa,Mason City,28079
6375,1975-1976,1975-11-13,1976-03-30,139,0,109,424,533,22,44,66,599,8,58,Iowa,Mason City,28079
6376,1976-1977,1976-10-19,1977-03-03,136,0,238,686,924,37,128,165,1089,16,154,Iowa,Mason City,28079
6377,1977-1978,1977-11-21,1978-03-20,120,3,284,653,937,51,474,525,1462,18,174,Iowa,Mason City,28079
6378,1978-1979,1978-11-14,1979-04-06,144,0,350,772,1122,90,903,993,2115,29,326,Iowa,Mason City,28079
6379,1979-1980,1979-10-22,1980-04-09,171,0,160,526,686,51,134,185,871,17,147,Iowa,Mason City,28079
6380,1980-1981,1980-11-14,1981-03-06,113,0,136,421,557,25,51,76,633,8,90,Iowa,Mason City,28079
6381,1981-1982,1981-10-23,1982-04-11,171,1,248,640,888,83,562,645,1533,24,239,Iowa,Mason City,28079
6382,1982-1983,1982-11-04,1983-04-18,166,0,101,399,500,70,230,300,800,20,140,Iowa,Mason City,28079
6383,1983-1984,1983-11-10,1984-04-30,173,3,284,631,915,73,529,602,1517,25,236,Iowa,Mason City,28079
6384,1984-1985,1984-11-19,1985-04-04,137,1,185,527,712,58,142,200,912,21,167,Iowa,Mason City,28079
6385,1985-1986,1985-11-08,1986-03-20,133,0,247,604,851,66,418,484,1335,18,169,Iowa,Mason City,28079
6386,1986-1987,1986-11-09,1987-04-01,144,0,84,398,482,36,69,105,587,15,92,Iowa,Mason City,28079
6387,1987-1988,1987-11-20,1988-04-27,160,0,198,548,746,60,279,339,1085,22,204,Iowa,Mason City,28079
6388,1988-1989,1988-11-12,1989-04-09,149,0,148,509,657,56,107,163,820,27,187,Iowa,Mason City,28079
6389,1989-1990,1989-10-30,1990-03-23,145,0,132,510,642,44,105,149,791,21,171,Iowa,Mason City,28079
6390,1990-1991,1990-10-17,1991-03-29,164,3,159,526,685,60,365,425,1110,24,197,Iowa,Mason City,28079
6391,1991-1992,1991-10-18,1992-04-21,187,0,100,414,514,77,219,296,810,44,243,Iowa,Mason City,28079
6392,1992-1993,1992-11-02,1993-04-20,170,0,181,561,742,98,465,563,1305,52,306,Iowa,Mason City,28079
6393,1993-1994,1993-10-30,1994-04-05,158,0,233,636,869,68,302,370,1239,36,343,Iowa,Mason City,28079
6394,1994-1995,1994-11-21,1995-04-09,140,0,135,452,587,54,226,280,867,28,187,Iowa,Mason City,28079
6395,1995-1996,1995-10-31,1996-04-15,168,0,194,632,826,72,166,238,1064,34,238,Iowa,Mason City,28079
6396,1996-1997,1996-10-31,1997-04-12,164,3,204,571,775,97,373,470,1245,52,415,Iowa,Mason City,28079
6397,1997-1998,1997-11-02,1998-04-16,166,0,109,386,495,82,238,320,815,47,249,Iowa,Mason City,28079
6398,1998-1999,1998-11-07,1999-04-23,168,0,117,425,542,82,300,382,924,35,293,Iowa,Mason City,28079
6399,1999-2000,1999-10-01,2000-04-08,191,3,83,429,512,68,178,246,758,31,227,Iowa,Mason City,28079
6400,2002-2003,2002-10-23,2003-04-10,170,0,132,566,698,51,78,129,827,23,157,Iowa,Mason City,28079
6401,2003-2004,2003-11-05,2004-03-16,133,2,140,458,598,49,232,281,879,20,135,Iowa,Mason City,28079
6402,2004-2005,2004-11-27,2005-03-24,118,0,118,407,525,46,170,216,741,18,119,Iowa,Mason City,28079
6403,2005-2006,2005-11-15,2006-03-17,123,8,105,387,492,47,191,238,730,24,152,Iowa,Mason City,28079
6404,2006-2007,2006-10-11,2007-04-12,184,0,167,523,690,79,373,452,1142,25,210,Iowa,Mason City,28079
6405,2007-2008,2007-11-21,2008-04-01,133,0,212,577,789,56,499,555,1344,31,261,Iowa,Mason City,28079
6406,2008-2009,2008-11-07,2009-04-01,146,0,199,618,817,66,503,569,1386,31,292,Iowa,Mason City,28079
6407,2009-2010,2009-10-13,2010-03-14,153,0,221,540,761,62,692,754,1515,28,240,Iowa,Mason City,28079
6408,2010-2011,2010-11-18,2011-04-20,154,0,201,551,752,78,469,547,1299,28,240,Iowa,Mason City,28079
6409,2011-2012,2011-11-20,2012-03-05,107,6,61,319,380,30,147,177,557,14,96,Iowa,Mason City,28079
6410,2012-2013,2012-11-12,2013-05-04,174,0,130,540,670,84,304,388,1058,29,210,Iowa,Mason City,28079
6411,2013-2014,2013-11-11,2014-04-14,155,0,287,732,1019,91,563,654,1673,40,400,Iowa,Mason City,28079
6412,2014-2015,2014-11-11,2015-04-09,150,0,190,548,738,57,336,393,1131,22,176,Iowa,Mason City,28079
6413,2015-2016,2015-11-20,2016-03-25,127,0,116,350,466,78,357,435,901,22,170,Iowa,Mason City,28079
6414,2016-2017,2016-12-01,2017-03-18,108,0,119,363,482,69,387,456,938,19,172,Iowa,Mason City,28079
6415,2017-2018,2017-10-27,2018-04-21,177,0,183,607,790,95,252,347,1137,31,260,Iowa,Mason City,28079
6416,2018-2019,2018-10-14,2019-04-27,196,0,216,595,811,85,390,475,1286,38,340,Iowa,Mason City,28079
6417,2019-2020,2019-10-30,2020-04-14,168,0,122,465,587,58,295,353,940,32,199,Iowa,Mason City,28079
6418,1950-1951,1950-11-09,1951-04-12,155,0,137,568,705,42,133,175,880,24,181,Iowa,Sioux City,82684
6419,1951-1952,1951-10-22,1952-04-12,174,0,136,530,666,62,209,271,937,31,222,Iowa,Sioux City,82684
6420,1952-1953,1952-11-24,1953-04-15,143,0,93,431,524,58,342,400,924,27,189,Iowa,Sioux City,82684
6421,1953-1954,1953-11-20,1954-04-01,133,0,75,384,459,43,68,111,570,20,120,Iowa,Sioux City,82684
6422,1954-1955,1954-11-26,1955-03-28,123,0,93,412,505,41,179,220,725,22,162,Iowa,Sioux City,82684
6423,1955-1956,1955-11-15,1956-04-29,167,0,159,556,715,43,157,200,915,32,244,Iowa,Sioux City,82684
6424,1956-1957,1956-11-15,1957-04-08,145,0,97,443,540,58,139,197,737,26,195,Iowa,Sioux City,82684
6425,1957-1958,1957-11-04,1958-04-06,154,0,93,391,484,47,160,207,691,29,135,Iowa,Sioux City,82684
6426,1958-1959,1958-11-17,1959-04-20,155,0,134,530,664,51,122,173,837,24,178,Iowa,Sioux City,82684
6427,1959-1960,1959-10-08,1960-04-02,178,0,179,577,756,102,576,678,1434,41,325,Iowa,Sioux City,82684
6428,1960-1961,1960-11-09,1961-04-17,160,0,91,441,532,55,138,193,725,30,169,Iowa,Sioux City,82684
6429,1961-1962,1961-09-30,1962-04-12,195,0,206,593,799,106,514,620,1419,44,382,Iowa,Sioux City,82684
6430,1962-1963,1962-10-24,1963-03-25,153,0,148,489,637,53,168,221,858,34,286,Iowa,Sioux City,82684
6431,1963-1964,1963-12-01,1964-03-29,120,0,106,440,546,39,85,124,670,27,157,Iowa,Sioux City,82684
6432,1964-1965,1964-11-19,1965-04-25,158,0,166,597,763,73,248,321,1084,35,298,Iowa,Sioux City,82684
6433,1965-1966,1965-11-26,1966-03-28,123,0,127,407,534,33,114,147,681,17,132,Iowa,Sioux City,82684
6434,1966-1967,1966-10-14,1967-03-17,155,0,95,487,582,37,146,183,765,24,175,Iowa,Sioux City,82684
6435,1967-1968,1967-10-26,1968-04-23,181,0,107,461,568,16,19,35,603,13,96,Iowa,Sioux City,82684
6436,1968-1969,1968-11-09,1969-03-30,142,0,174,528,702,74,599,673,1375,35,266,Iowa,Sioux City,82684
6437,1969-1970,1969-11-13,1970-03-27,135,0,144,507,651,66,275,341,992,32,267,Iowa,Sioux City,82684
6438,1970-1971,1970-10-09,1971-04-01,175,0,147,479,626,40,172,212,838,22,159,Iowa,Sioux City,82684
6439,1971-1972,1971-11-06,1972-04-08,155,0,134,493,627,51,168,219,846,33,231,Iowa,Sioux City,82684
6440,1972-1973,1972-10-18,1973-04-09,174,0,128,399,527,46,177,223,750,25,186,Iowa,Sioux City,82684
6441,1973-1974,1973-11-04,1974-04-04,152,0,121,415,536,39,159,198,734,25,217,Iowa,Sioux City,82684
6442,1974-1975,1974-11-13,1975-04-04,143,0,127,484,611,63,368,431,1042,32,192,Iowa,Sioux City,82684
6443,1975-1976,1975-11-20,1976-03-15,117,0,92,374,466,35,65,100,566,21,141,Iowa,Sioux City,82684
6444,1976-1977,1976-10-18,1977-04-04,169,0,157,604,761,35,58,93,854,20,138,Iowa,Sioux City,82684
6445,1977-1978,1977-11-09,1978-03-16,128,0,240,586,826,51,253,304,1130,33,250,Iowa,Sioux City,82684
6446,1978-1979,1978-11-11,1979-04-02,143,0,278,701,979,64,634,698,1677,38,295,Iowa,Sioux City,82684
6447,1979-1980,1979-10-22,1980-04-03,165,0,101,428,529,37,55,92,621,25,146,Iowa,Sioux City,82684
6448,1980-1981,1980-10-27,1981-03-09,134,0,80,401,481,26,51,77,558,12,93,Iowa,Sioux City,82684
6449,1981-1982,1981-10-24,1982-04-08,167,0,199,574,773,87,373,460,1233,37,374,Iowa,Sioux City,82684
6450,1982-1983,1982-10-19,1983-04-17,181,0,88,362,450,95,253,348,798,36,189,Iowa,Sioux City,82684
6451,1983-1984,1983-11-09,1984-04-30,174,0,197,472,669,87,401,488,1157,32,263,Iowa,Sioux City,82684
6452,1984-1985,1984-11-09,1985-04-02,145,0,107,414,521,39,33,72,593,20,127,Iowa,Sioux City,82684
6453,1985-1986,1985-11-08,1986-04-15,159,0,152,470,622,46,99,145,767,29,200,Iowa,Sioux City,82684
6454,1986-1987,1986-11-09,1987-04-01,144,0,40,334,374,34,47,81,455,18,94,Iowa,Sioux City,82684
6455,1987-1988,1987-11-27,1988-04-26,152,0,117,435,552,41,96,137,689,20,140,Iowa,Sioux City,82684
6456,1988-1989,1988-11-15,1989-04-09,146,0,104,430,534,43,63,106,640,27,179,Iowa,Sioux City,82684
6457,1989-1990,1989-11-16,1990-04-13,149,0,100,451,551,34,52,86,637,20,140,Iowa,Sioux City,82684
6458,1990-1991,1990-10-17,1991-03-29,164,0,110,448,558,55,124,179,737,29,213,Iowa,Sioux City,82684
6459,1991-1992,1991-10-29,1992-04-22,177,0,53,326,379,50,90,140,519,25,138,Iowa,Sioux City,82684
6460,1992-1993,1992-11-01,1993-04-13,164,0,137,473,610,72,268,340,950,42,279,Iowa,Sioux City,82684
6461,1993-1994,1993-10-30,1994-04-28,181,0,159,539,698,73,294,367,1065,39,307,Iowa,Sioux City,82684
6462,1994-1995,1994-11-27,1995-04-12,137,0,106,373,479,64,294,358,837,28,195,Iowa,Sioux City,82684
6463,1995-1996,1995-10-30,1996-04-15,169,0,146,556,702,35,87,122,824,24,197,Iowa,Sioux City,82684
6464,1996-1997,1996-11-01,1997-04-14,165,0,196,543,739,60,242,302,1041,23,199,Iowa,Sioux City,82684
6465,1997-1998,1997-10-25,1998-04-01,159,0,77,357,434,42,70,112,546,26,110,Iowa,Sioux City,82684
6466,1998-1999,1998-11-07,1999-04-17,162,0,82,380,462,59,175,234,696,20,159,Iowa,Sioux City,82684
6467,1999-2000,1999-11-23,2000-04-07,137,0,50,339,389,26,40,66,455,15,78,Iowa,Sioux City,82684
6468,2000-2001,2000-11-06,2001-04-23,169,0,190,602,792,72,511,583,1375,30,230,Iowa,Sioux City,82684
6469,2001-2002,2001-11-28,2002-03-21,114,0,72,344,416,39,88,127,543,12,93,Iowa,Sioux City,82684
6470,2002-2003,2002-10-16,2003-04-10,177,0,88,508,596,46,64,110,706,22,125,Iowa,Sioux City,82684
6471,2003-2004,2003-11-05,2004-03-19,136,0,116,406,522,83,304,387,909,21,198,Iowa,Sioux City,82684
6472,2004-2005,2004-11-28,2005-03-25,118,0,70,341,411,23,83,106,517,10,64,Iowa,Sioux City,82684
6473,2005-2006,2005-11-15,2006-03-26,132,0,74,378,452,51,131,182,634,21,164,Iowa,Sioux City,82684
6474,2006-2007,2006-10-18,2007-04-11,176,0,118,485,603,79,240,319,922,29,247,Iowa,Sioux City,82684
6475,2007-2008,2007-11-22,2008-04-25,156,0,143,542,685,67,329,396,1081,33,252,Iowa,Sioux City,82684
6476,2008-2009,2008-11-07,2009-04-05,150,0,116,523,639,59,197,256,895,31,223,Iowa,Sioux City,82684
6477,2009-2010,2009-10-10,2010-03-19,161,0,165,484,649,87,619,706,1355,34,295,Iowa,Sioux City,82684
6478,2010-2011,2010-11-22,2011-03-29,128,0,145,504,649,65,304,369,1018,30,232,Iowa,Sioux City,82684
6479,2011-2012,2011-11-20,2012-02-29,102,0,46,325,371,28,62,90,461,11,74,Iowa,Sioux City,82684
6480,2012-2013,2012-10-25,2013-05-01,189,0,88,480,568,70,152,222,790,26,155,Iowa,Sioux City,82684
6481,2013-2014,2013-11-05,2014-04-14,161,0,157,626,783,44,68,112,895,28,188,Iowa,Sioux City,82684
6482,2014-2015,2014-11-10,2015-03-04,115,0,101,418,519,35,118,153,672,18,130,Iowa,Sioux City,82684
6483,2015-2016,2015-11-20,2016-03-28,130,0,62,289,351,89,321,410,761,28,172,Iowa,Sioux City,82684
6484,2016-2017,2016-11-18,2017-03-21,124,0,61,295,356,45,85,130,486,18,119,Iowa,Sioux City,82684
6485,2017-2018,2017-12-01,2018-04-18,139,0,134,473,607,70,308,378,985,26,217,Iowa,Sioux City,82684
6486,2018-2019,2018-10-14,2019-04-02,171,0,149,517,666,46,209,255,921,26,193,Iowa,Sioux City,82684
6487,2019-2020,2019-11-06,2020-04-13,160,0,67,386,453,57,151,208,661,27,156,Iowa,Sioux City,82684
6488,1955-1956,1955-11-03,1956-04-07,157,0,150,584,734,28,95,123,857,22,141,Iowa,Waterloo,68406
6489,1956-1957,1956-11-16,1957-03-20,125,0,119,454,573,38,139,177,750,18,128,Iowa,Waterloo,68406
6490,1957-1958,1957-11-17,1958-03-16,120,0,125,409,534,35,148,183,717,15,80,Iowa,Waterloo,68406
6491,1958-1959,1958-11-23,1959-04-20,149,1,163,563,726,65,222,287,1013,28,218,Iowa,Waterloo,68406
6492,1959-1960,1959-11-05,1960-04-17,165,0,138,556,694,65,347,412,1106,34,240,Iowa,Waterloo,68406
6493,1960-1961,1960-11-09,1961-04-17,160,0,116,465,581,42,93,135,716,23,144,Iowa,Waterloo,68406
6494,1961-1962,1961-11-13,1962-04-02,141,0,209,582,791,89,542,631,1422,39,322,Iowa,Waterloo,68406
6495,1962-1963,1962-10-24,1963-03-14,142,0,204,584,788,47,144,191,979,29,249,Iowa,Waterloo,68406
6496,1963-1964,1963-11-22,1964-04-01,132,0,146,534,680,35,112,147,827,19,122,Iowa,Waterloo,68406
6497,1964-1965,1964-11-19,1965-03-31,133,0,209,607,816,54,167,221,1037,27,223,Iowa,Waterloo,68406
6498,1965-1966,1965-11-27,1966-05-11,166,0,139,482,621,26,108,134,755,18,118,Iowa,Waterloo,68406
6499,1966-1967,1966-11-02,1967-04-26,176,0,117,518,635,34,109,143,778,22,170,Iowa,Waterloo,68406
6500,1967-1968,1967-11-04,1968-03-22,140,0,126,479,605,28,35,63,668,21,139,Iowa,Waterloo,68406
6501,1968-1969,1968-11-10,1969-03-31,142,0,180,528,708,44,246,290,998,26,156,Iowa,Waterloo,68406
6502,1969-1970,1969-11-13,1970-03-28,136,0,221,644,865,61,396,457,1322,34,307,Iowa,Waterloo,68406
6503,1970-1971,1970-11-13,1971-03-25,133,0,223,572,795,70,498,568,1363,25,187,Iowa,Waterloo,68406
6504,1971-1972,1971-11-06,1972-04-08,155,0,201,603,804,69,221,290,1094,32,279,Iowa,Waterloo,68406
6505,1972-1973,1972-10-18,1973-04-16,181,0,157,463,620,69,228,297,917,28,208,Iowa,Waterloo,68406
6506,1973-1974,1973-11-08,1974-04-14,158,0,158,458,616,43,138,181,797,26,171,Iowa,Waterloo,68406
6507,1974-1975,1974-11-13,1975-04-10,149,0,136,490,626,76,262,338,964,43,230,Iowa,Waterloo,68406
6508,1975-1976,1975-11-13,1976-03-16,125,0,100,417,517,23,43,66,583,12,65,Iowa,Waterloo,68406
6509,1976-1977,1976-10-19,1977-04-04,168,0,233,749,982,34,141,175,1157,27,250,Iowa,Waterloo,68406
6510,1977-1978,1977-11-09,1978-04-20,163,0,307,745,1052,69,514,583,1635,38,345,Iowa,Waterloo,68406
6511,1978-1979,1978-11-16,1979-04-02,138,0,267,638,905,71,589,660,1565,41,329,Iowa,Waterloo,68406
6512,1979-1980,1979-11-09,1980-04-09,153,0,133,466,599,46,149,195,794,27,187,Iowa,Waterloo,68406
6513,1980-1981,1980-12-01,1981-02-28,90,0,117,364,481,35,67,102,583,15,141,Iowa,Waterloo,68406
6514,1981-1982,1981-11-19,1982-04-11,144,0,231,605,836,61,428,489,1325,34,319,Iowa,Waterloo,68406
6515,1982-1983,1982-10-20,1983-04-14,177,0,67,340,407,61,134,195,602,32,154,Iowa,Waterloo,68406
6516,1983-1984,1983-11-12,1984-04-22,163,0,215,540,755,72,364,436,1191,37,259,Iowa,Waterloo,68406
6517,1984-1985,1984-11-30,1985-04-07,129,0,145,457,602,48,194,242,844,30,204,Iowa,Waterloo,68406
6518,1985-1986,1985-11-09,1986-04-15,158,0,194,605,799,64,615,679,1478,27,204,Iowa,Waterloo,68406
6519,1986-1987,1986-11-10,1987-03-30,141,0,67,369,436,44,165,209,645,20,95,Iowa,Waterloo,68406
6520,1987-1988,1987-11-17,1988-03-15,120,0,150,438,588,40,188,228,816,21,150,Iowa,Waterloo,68406
6521,1988-1989,1988-11-12,1989-03-18,127,0,124,442,566,28,85,113,679,22,155,Iowa,Waterloo,68406
6522,1989-1990,1989-10-31,1990-03-23,144,0,106,446,552,30,64,94,646,22,147,Iowa,Waterloo,68406
6523,1990-1991,1990-11-06,1991-04-23,169,0,131,496,627,52,317,369,996,24,182,Iowa,Waterloo,68406
6524,1991-1992,1991-10-18,1992-04-12,178,0,66,376,442,67,127,194,636,39,184,Iowa,Waterloo,68406
6525,1992-1993,1992-11-05,1993-04-20,167,0,123,471,594,91,311,402,996,41,214,Iowa,Waterloo,68406
6526,1993-1994,1993-11-05,1994-04-05,152,0,195,567,762,62,322,384,1146,33,295,Iowa,Waterloo,68406
6527,1994-1995,1994-11-28,1995-04-10,134,0,115,385,500,49,174,223,723,19,144,Iowa,Waterloo,68406
6528,1995-1996,1995-11-02,1996-04-15,166,0,161,581,742,58,190,248,990,21,153,Iowa,Waterloo,68406
6529,1996-1997,1996-11-10,1997-04-30,172,0,182,525,707,69,222,291,998,31,268,Iowa,Waterloo,68406
6530,1997-1998,1997-10-26,1998-03-21,147,1,84,319,403,63,181,244,647,28,147,Iowa,Waterloo,68406
6531,1998-1999,1998-11-07,1999-03-13,127,0,97,355,452,57,237,294,746,28,233,Iowa,Waterloo,68406
6532,1999-2000,1999-12-01,2000-04-08,130,0,70,352,422,58,184,242,664,24,173,Iowa,Waterloo,68406
6533,2000-2001,2000-11-08,2001-03-26,139,0,210,591,801,69,593,662,1463,28,236,Iowa,Waterloo,68406
6534,2001-2002,2001-12-01,2002-04-03,124,0,54,314,368,32,59,91,459,19,107,Iowa,Waterloo,68406
6535,2002-2003,2002-10-24,2003-04-09,168,0,97,519,616,45,84,129,745,24,152,Iowa,Waterloo,68406
6536,2003-2004,2003-11-05,2004-03-17,134,0,107,409,516,42,165,207,723,19,133,Iowa,Waterloo,68406
6537,2004-2005,2004-12-01,2005-03-14,104,0,91,338,429,28,148,176,605,12,90,Iowa,Waterloo,68406
6538,2005-2006,2005-11-15,2006-03-06,112,0,96,373,469,49,167,216,685,20,154,Iowa,Waterloo,68406
6539,2006-2007,2006-11-10,2007-04-12,154,0,136,437,573,42,215,257,830,19,138,Iowa,Waterloo,68406
6540,2007-2008,2007-11-21,2008-03-28,129,0,180,534,714,81,491,572,1286,39,316,Iowa,Waterloo,68406
6541,2008-2009,2008-11-07,2009-04-05,150,0,161,568,729,74,322,396,1125,29,274,Iowa,Waterloo,68406
6542,2009-2010,2009-12-01,2010-03-20,110,0,175,466,641,76,601,677,1318,28,235,Iowa,Waterloo,68406
6543,2010-2011,2010-11-23,2011-04-19,148,0,160,496,656,78,321,399,1055,30,250,Iowa,Waterloo,68406
6544,2011-2012,2011-11-09,2012-03-05,118,0,42,296,338,39,93,132,470,14,94,Iowa,Waterloo,68406
6545,2012-2013,2012-11-12,2013-05-03,173,0,105,469,574,74,221,295,869,26,164,Iowa,Waterloo,68406
6546,2013-2014,2013-10-22,2014-04-14,175,0,246,743,989,85,319,404,1393,42,402,Iowa,Waterloo,68406
6547,2014-2015,2014-11-11,2015-03-24,134,0,163,504,667,45,174,219,886,20,158,Iowa,Waterloo,68406
6548,2015-2016,2015-11-20,2016-03-05,107,0,91,297,388,65,239,304,692,22,174,Iowa,Waterloo,68406
6549,2016-2017,2016-12-01,2017-03-17,107,0,88,302,390,38,105,143,533,14,100,Iowa,Waterloo,68406
6550,2017-2018,2017-11-10,2018-04-19,161,0,147,534,681,73,160,233,914,32,277,Iowa,Waterloo,68406
6551,2018-2019,2018-10-14,2019-04-27,196,0,158,534,692,89,342,431,1123,40,344,Iowa,Waterloo,68406
6552,2019-2020,2019-10-28,2020-04-12,168,0,79,373,452,50,246,296,748,31,164,Iowa,Waterloo,68406
6553,1957-1958,1957-10-25,1958-04-01,159,4,43,390,433,77,218,295,728,30,196,Kansas,Colby,5387
6554,1958-1959,1958-11-17,1959-04-12,147,1,64,390,454,71,101,172,626,32,236,Kansas,Colby,5387
6555,1959-1960,1959-10-01,1960-03-19,171,8,100,492,592,61,214,275,867,26,218,Kansas,Colby,5387
6556,1960-1961,1960-11-09,1961-04-11,154,8,33,374,407,41,58,99,506,17,101,Kansas,Colby,5387
6557,1961-1962,1961-11-03,1962-03-11,129,1,95,447,542,38,72,110,652,22,198,Kansas,Colby,5387
6558,1962-1963,1962-11-16,1963-03-16,121,0,75,382,457,45,53,98,555,17,156,Kansas,Colby,5387
6559,1963-1964,1963-11-17,1964-04-05,141,0,52,428,480,47,54,101,581,21,138,Kansas,Colby,5387
6560,1964-1965,1964-11-19,1965-03-26,128,2,51,473,524,23,23,46,570,12,88,Kansas,Colby,5387
6561,1965-1966,1965-12-01,1966-05-12,163,0,77,401,478,34,100,134,612,18,150,Kansas,Colby,5387
6562,1966-1967,1966-10-15,1967-05-04,202,3,39,423,462,28,57,85,547,16,94,Kansas,Colby,5387
6563,1967-1968,1967-11-02,1968-02-29,120,1,31,405,436,17,19,36,472,11,64,Kansas,Colby,5387
6564,1968-1969,1968-11-15,1969-03-29,135,0,67,439,506,47,185,232,738,25,166,Kansas,Colby,5387
6565,1969-1970,1969-10-12,1970-05-01,202,3,42,441,483,51,58,109,592,26,138,Kansas,Colby,5387
6566,1970-1971,1970-10-08,1971-03-25,169,0,51,446,497,30,49,79,576,12,69,Kansas,Colby,5387
6567,1971-1972,1971-10-30,1972-02-29,123,0,44,364,408,15,24,39,447,9,67,Kansas,Colby,5387
6568,1972-1973,1972-10-31,1973-04-10,162,0,105,405,510,54,136,190,700,21,156,Kansas,Colby,5387
6569,1973-1974,1973-11-05,1974-04-14,161,4,73,405,478,45,140,185,663,17,135,Kansas,Colby,5387
6570,1974-1975,1974-11-29,1975-04-18,141,1,44,441,485,25,44,69,554,16,94,Kansas,Colby,5387
6571,1975-1976,1975-11-19,1976-03-30,133,3,63,354,417,37,88,125,542,15,100,Kansas,Colby,5387
6572,1976-1977,1976-10-07,1977-04-05,181,0,47,507,554,35,51,86,640,11,89,Kansas,Colby,5387
6573,1977-1978,1977-11-09,1978-03-14,126,1,130,494,624,32,102,134,758,17,145,Kansas,Colby,5387
6574,1978-1979,1978-11-12,1979-05-10,180,1,115,486,601,60,113,173,774,30,189,Kansas,Colby,5387
6575,1979-1980,1979-10-22,1980-04-05,167,0,72,415,487,86,187,273,760,29,197,Kansas,Colby,5387
6576,1980-1981,1980-10-27,1981-03-11,136,3,42,372,414,36,88,124,538,14,91,Kansas,Colby,5387
6577,1981-1982,1981-11-19,1982-04-06,139,1,67,406,473,26,61,87,560,17,134,Kansas,Colby,5387
6578,1982-1983,1982-11-23,1983-04-14,143,3,45,284,329,59,170,229,558,17,119,Kansas,Colby,5387
6579,1983-1984,1983-11-09,1984-04-30,174,12,116,479,595,99,258,357,952,27,239,Kansas,Colby,5387
6580,1984-1985,1984-09-28,1985-03-31,185,11,68,430,498,43,133,176,674,17,132,Kansas,Colby,5387
6581,1985-1986,1985-09-29,1986-04-28,212,14,68,418,486,32,38,70,556,19,132,Kansas,Colby,5387
6582,1986-1987,1986-10-12,1987-04-14,185,1,32,376,408,51,57,108,516,21,119,Kansas,Colby,5387
6583,1988-1989,1988-11-16,1989-04-10,146,6,62,477,539,28,18,46,585,15,101,Kansas,Colby,5387
6584,1989-1990,1989-12-01,1990-05-04,155,3,49,396,445,44,85,129,574,17,128,Kansas,Colby,5387
6585,1990-1991,1990-10-21,1991-03-27,158,6,72,413,485,31,33,64,549,19,117,Kansas,Colby,5387
6586,1991-1992,1991-10-31,1992-03-19,141,1,22,281,303,41,50,91,394,13,89,Kansas,Colby,5387
6587,1992-1993,1992-10-29,1993-04-20,174,2,95,552,647,91,375,466,1113,30,234,Kansas,Colby,5387
6588,1993-1994,1993-10-29,1994-04-30,184,7,49,500,549,53,106,159,708,18,123,Kansas,Colby,5387
6589,1994-1995,1994-11-04,1995-04-27,175,5,43,341,384,49,78,127,511,23,140,Kansas,Colby,5387
6590,1995-1996,1995-09-21,1996-04-14,207,11,62,508,570,34,44,78,648,13,98,Kansas,Colby,5387
6591,1996-1997,1996-11-17,1997-04-12,147,3,62,440,502,39,68,107,609,12,109,Kansas,Colby,5387
6592,1997-1998,1997-10-25,1998-03-19,146,6,39,312,351,56,80,136,487,14,95,Kansas,Colby,5387
6593,1998-1999,1998-11-03,1999-03-17,135,5,35,304,339,40,56,96,435,9,77,Kansas,Colby,5387
6594,1999-2000,1999-11-23,2000-03-03,102,4,6,282,288,14,13,27,315,6,36,Kansas,Colby,5387
6595,2000-2001,2000-11-11,2001-03-12,122,7,49,432,481,53,196,249,730,12,114,Kansas,Colby,5387
6596,2001-2002,2001-11-27,2002-03-26,120,7,25,392,417,24,32,56,473,7,54,Kansas,Colby,5387
6597,2002-2003,2002-10-24,2003-04-07,166,10,37,380,417,15,15,30,447,7,42,Kansas,Colby,5387
6598,2003-2004,2003-11-06,2004-04-12,159,19,31,373,404,27,40,67,471,12,72,Kansas,Colby,5387
6599,2004-2005,2004-11-14,2005-04-29,167,20,35,306,341,22,37,59,400,12,75,Kansas,Colby,5387
6600,2005-2006,2005-11-28,2006-03-26,119,14,35,304,339,33,51,84,423,7,60,Kansas,Colby,5387
6601,2006-2007,2006-11-30,2007-04-14,136,16,63,392,455,65,321,386,841,18,162,Kansas,Colby,5387
6602,2013-2014,2013-10-18,2014-04-14,179,0,80,490,570,40,72,112,682,22,162,Kansas,Colby,5387
6603,2014-2015,2014-11-12,2015-04-03,143,0,54,398,452,34,66,100,552,19,136,Kansas,Colby,5387
6604,2015-2016,2015-11-18,2016-04-30,165,1,18,304,322,46,86,132,454,13,81,Kansas,Colby,5387
6605,2016-2017,2016-11-18,2017-05-02,166,2,34,371,405,34,34,68,473,7,68,Kansas,Colby,5387
6606,2017-2018,2017-11-01,2018-04-14,165,0,58,453,511,31,36,67,578,14,97,Kansas,Colby,5387
6607,2018-2019,2018-10-14,2019-05-22,221,2,66,441,507,57,70,127,634,24,160,Kansas,Colby,5387
6608,2019-2020,2019-10-29,2020-04-03,158,2,20,364,384,27,28,55,439,13,79,Kansas,Colby,5387
6609,1951-1952,1951-11-02,1952-04-09,160,0,51,289,340,32,36,68,408,17,90,Kansas,Concordia,5395
6610,1952-1953,1952-11-25,1953-03-08,104,0,38,213,251,33,118,151,402,14,74,Kansas,Concordia,5395
6611,1953-1954,1953-11-06,1954-03-29,144,1,35,228,263,13,11,24,287,8,33,Kansas,Concordia,5395
6612,1954-1955,1954-12-01,1955-03-27,117,8,38,253,291,29,89,118,409,14,85,Kansas,Concordia,5395
6613,1955-1956,1955-11-15,1956-04-23,161,1,72,332,404,43,108,151,555,25,158,Kansas,Concordia,5395
6614,1956-1957,1956-11-15,1957-04-11,148,16,53,252,305,37,44,81,386,21,110,Kansas,Concordia,5395
6615,1957-1958,1957-10-24,1958-03-19,147,18,49,261,310,70,143,213,523,32,180,Kansas,Concordia,5395
6616,1958-1959,1958-11-17,1959-03-26,130,0,73,301,374,52,98,150,524,24,178,Kansas,Concordia,5395
6617,1959-1960,1959-11-05,1960-04-09,157,0,102,356,458,92,325,417,875,35,239,Kansas,Concordia,5395
6618,1960-1961,1960-11-30,1961-05-01,153,0,29,217,246,36,27,63,309,23,89,Kansas,Concordia,5395
6619,1961-1962,1961-11-15,1962-03-13,119,20,102,321,423,35,125,160,583,23,150,Kansas,Concordia,5395
6620,1962-1963,1962-11-16,1963-03-06,111,0,75,321,396,29,61,90,486,18,136,Kansas,Concordia,5395
6621,1963-1964,1963-12-01,1964-03-25,116,0,57,304,361,20,17,37,398,14,83,Kansas,Concordia,5395
6622,1964-1965,1964-11-18,1965-03-25,128,0,62,368,430,42,77,119,549,15,107,Kansas,Concordia,5395
6623,1965-1966,1965-12-01,1966-03-24,114,0,50,276,326,14,11,25,351,10,58,Kansas,Concordia,5395
6624,1966-1967,1966-11-09,1967-04-23,166,0,49,325,374,35,97,132,506,15,109,Kansas,Concordia,5395
6625,1967-1968,1967-11-02,1968-04-23,174,0,54,313,367,27,50,77,444,16,89,Kansas,Concordia,5395
6626,1968-1969,1968-11-30,1969-03-29,120,0,71,331,402,54,154,208,610,25,146,Kansas,Concordia,5395
6627,1969-1970,1969-12-01,1970-04-12,133,0,58,312,370,25,20,45,415,13,66,Kansas,Concordia,5395
6628,1970-1971,1970-10-09,1971-03-26,169,0,73,362,435,65,176,241,676,21,128,Kansas,Concordia,5395
6629,1971-1972,1971-11-22,1972-02-29,100,0,49,252,301,22,28,50,351,9,51,Kansas,Concordia,5395
6630,1972-1973,1972-11-13,1973-04-08,147,0,83,280,363,40,98,138,501,22,111,Kansas,Concordia,5395
6631,1973-1974,1973-11-20,1974-04-04,136,0,78,276,354,39,141,180,534,26,172,Kansas,Concordia,5395
6632,1974-1975,1974-11-29,1975-04-02,125,0,47,285,332,54,109,163,495,20,125,Kansas,Concordia,5395
6633,1975-1976,1975-11-19,1976-03-30,133,0,43,272,315,31,30,61,376,15,86,Kansas,Concordia,5395
6634,1976-1977,1976-10-26,1977-04-03,160,0,54,372,426,22,76,98,524,14,83,Kansas,Concordia,5395
6635,1977-1978,1977-11-09,1978-03-11,123,0,122,439,561,37,169,206,767,19,148,Kansas,Concordia,5395
6636,1978-1979,1978-11-14,1979-04-03,141,0,135,461,596,42,275,317,913,19,144,Kansas,Concordia,5395
6637,1979-1980,1979-10-22,1980-03-29,160,0,61,326,387,43,108,151,538,19,121,Kansas,Concordia,5395
6638,1980-1981,1980-12-01,1981-02-28,90,0,29,209,238,9,22,31,269,4,29,Kansas,Concordia,5395
6639,1981-1982,1981-11-19,1982-04-08,141,0,87,343,430,34,64,98,528,20,129,Kansas,Concordia,5395
6640,1982-1983,1982-11-23,1983-04-14,143,0,44,230,274,50,117,167,441,19,95,Kansas,Concordia,5395
6641,1983-1984,1983-11-23,1984-03-21,120,0,126,331,457,51,235,286,743,17,165,Kansas,Concordia,5395
6642,1984-1985,1984-11-10,1985-03-31,142,0,79,327,406,37,182,219,625,13,101,Kansas,Concordia,5395
6643,1985-1986,1985-11-10,1986-03-07,118,0,70,286,356,23,55,78,434,13,94,Kansas,Concordia,5395
6644,1986-1987,1986-11-11,1987-04-01,142,0,18,199,217,38,46,84,301,14,74,Kansas,Concordia,5395
6645,1987-1988,1987-11-27,1988-03-18,113,0,62,279,341,37,115,152,493,16,111,Kansas,Concordia,5395
6646,1988-1989,1988-11-15,1989-03-20,126,0,49,261,310,12,14,26,336,8,40,Kansas,Concordia,5395
6647,1989-1990,1989-11-16,1990-03-25,130,0,56,274,330,26,53,79,409,14,101,Kansas,Concordia,5395
6648,1990-1991,1990-11-03,1991-03-15,133,0,60,279,339,26,59,85,424,15,118,Kansas,Concordia,5395
6649,1991-1992,1991-10-30,1992-04-21,175,0,17,173,190,28,49,77,267,13,54,Kansas,Concordia,5395
6650,1993-1994,1993-10-30,1994-05-01,184,0,59,324,383,22,44,66,449,12,83,Kansas,Concordia,5395
6651,2000-2001,2000-11-12,2001-03-07,116,6,83,347,430,58,210,268,698,16,156,Kansas,Concordia,5395
6652,2004-2005,2004-11-28,2005-02-28,93,0,49,200,249,26,63,89,338,8,60,Kansas,Concordia,5395
6653,2005-2006,2005-11-15,2006-03-24,130,0,39,233,272,22,35,57,329,7,51,Kansas,Concordia,5395
6654,2006-2007,2006-11-29,2007-04-05,128,0,52,239,291,25,68,93,384,8,58,Kansas,Concordia,5395
6655,2007-2008,2007-11-23,2008-02-29,99,0,51,277,328,36,153,189,517,19,109,Kansas,Concordia,5395
6656,2008-2009,2008-12-01,2009-04-02,123,0,49,305,354,19,26,45,399,10,63,Kansas,Concordia,5395
6657,2009-2010,2009-11-16,2010-03-21,126,0,91,308,399,53,239,292,691,20,138,Kansas,Concordia,5395
6658,2010-2011,2010-11-23,2011-03-14,112,0,66,309,375,29,69,98,473,8,85,Kansas,Concordia,5395
6659,2011-2012,2011-12-01,2012-02-29,91,0,16,172,188,13,9,22,210,8,31,Kansas,Concordia,5395
6660,2012-2013,2012-12-01,2013-04-23,144,0,37,276,313,43,93,136,449,14,76,Kansas,Concordia,5395
6661,2013-2014,2013-11-22,2014-03-24,123,0,95,373,468,34,91,125,593,17,119,Kansas,Concordia,5395
6662,2014-2015,2014-11-10,2015-02-28,111,0,51,287,338,21,18,39,377,13,79,Kansas,Concordia,5395
6663,2015-2016,2015-11-26,2016-02-29,96,0,23,158,181,17,43,60,241,5,25,Kansas,Concordia,5395
6664,2016-2017,2016-12-01,2017-03-11,101,0,31,199,230,7,6,13,243,6,41,Kansas,Concordia,5395
6665,2017-2018,2017-12-01,2018-04-15,136,0,62,320,382,23,29,52,434,16,106,Kansas,Concordia,5395
6666,2018-2019,2018-10-14,2019-03-30,168,0,74,331,405,67,162,229,634,18,129,Kansas,Concordia,5395
6667,2019-2020,2019-10-30,2020-04-16,170,1,15,200,215,16,14,30,245,9,38,Kansas,Concordia,5395
6668,1950-1951,1950-11-09,1951-04-10,153,0,43,321,364,21,15,36,400,12,86,Kansas,Dodge City,27340
6669,1951-1952,1951-10-31,1952-03-22,144,0,28,263,291,31,32,63,354,11,70,Kansas,Dodge City,27340
6670,1952-1953,1952-11-09,1953-04-11,154,0,25,223,248,24,104,128,376,15,56,Kansas,Dodge City,27340
6671,1953-1954,1953-11-06,1954-03-02,117,0,18,187,205,16,13,29,234,9,40,Kansas,Dodge City,27340
6672,1954-1955,1954-12-01,1955-03-26,116,0,24,239,263,14,17,31,294,12,71,Kansas,Dodge City,27340
6673,1955-1956,1955-11-15,1956-04-10,148,0,39,308,347,32,69,101,448,15,85,Kansas,Dodge City,27340
6674,1956-1957,1956-11-20,1957-04-12,144,0,46,261,307,40,40,80,387,15,93,Kansas,Dodge City,27340
6675,1957-1958,1957-11-16,1958-03-29,134,0,35,238,273,36,51,87,360,23,97,Kansas,Dodge City,27340
6676,1958-1959,1958-11-17,1959-04-10,145,0,46,303,349,39,58,97,446,18,120,Kansas,Dodge City,27340
6677,1959-1960,1959-11-04,1960-03-18,136,0,76,333,409,47,152,199,608,19,151,Kansas,Dodge City,27340
6678,1960-1961,1960-10-30,1961-04-08,161,0,23,236,259,20,24,44,303,16,60,Kansas,Dodge City,27340
6679,1961-1962,1961-11-15,1962-03-11,117,0,63,288,351,15,38,53,404,10,65,Kansas,Dodge City,27340
6680,1962-1963,1962-11-15,1963-02-28,106,0,49,267,316,14,5,19,335,11,66,Kansas,Dodge City,27340
6681,1963-1964,1963-12-01,1964-03-25,116,0,33,278,311,24,37,61,372,15,89,Kansas,Dodge City,27340
6682,1964-1965,1964-11-18,1965-03-25,128,0,30,317,347,30,65,95,442,16,94,Kansas,Dodge City,27340
6683,1965-1966,1965-12-01,1966-03-22,112,0,54,246,300,24,77,101,401,14,107,Kansas,Dodge City,27340
6684,1966-1967,1966-12-01,1967-03-07,97,0,32,243,275,24,47,71,346,13,80,Kansas,Dodge City,27340
6685,1967-1968,1967-11-02,1968-03-11,131,0,34,250,284,20,15,35,319,18,93,Kansas,Dodge City,27340
6686,1968-1969,1968-12-01,1969-03-24,114,0,49,257,306,43,126,169,475,16,101,Kansas,Dodge City,27340
6687,1969-1970,1969-11-17,1970-04-03,138,0,25,265,290,46,42,88,378,18,106,Kansas,Dodge City,27340
6688,1970-1971,1970-10-08,1971-03-05,149,0,48,272,320,39,108,147,467,12,90,Kansas,Dodge City,27340
6689,1971-1972,1971-11-22,1972-03-29,129,0,32,242,274,21,20,41,315,14,91,Kansas,Dodge City,27340
6690,1972-1973,1972-10-31,1973-04-26,178,0,77,297,374,42,67,109,483,27,158,Kansas,Dodge City,27340
6691,1973-1974,1973-11-20,1974-04-03,135,0,58,246,304,29,91,120,424,17,127,Kansas,Dodge City,27340
6692,1974-1975,1974-11-29,1975-03-15,107,0,29,244,273,22,27,49,322,13,64,Kansas,Dodge City,27340
6693,1975-1976,1975-11-19,1976-03-31,134,0,30,241,271,17,15,32,303,8,41,Kansas,Dodge City,27340
6694,1976-1977,1976-10-26,1977-04-04,161,0,39,305,344,23,34,57,401,13,77,Kansas,Dodge City,27340
6695,1977-1978,1977-11-08,1978-05-03,177,0,78,364,442,42,101,143,585,22,149,Kansas,Dodge City,27340
6696,1978-1979,1978-11-11,1979-05-04,175,0,106,383,489,42,93,135,624,24,179,Kansas,Dodge City,27340
6697,1979-1980,1979-11-10,1980-04-02,145,0,57,299,356,52,70,122,478,20,130,Kansas,Dodge City,27340
6698,1980-1981,1980-10-28,1981-03-09,133,0,18,217,235,19,14,33,268,9,55,Kansas,Dodge City,27340
6699,1981-1982,1981-12-01,1982-03-27,117,0,57,264,321,27,70,97,418,11,96,Kansas,Dodge City,27340
6700,1982-1983,1982-11-27,1983-04-13,138,0,26,171,197,46,80,126,323,17,84,Kansas,Dodge City,27340
6701,1983-1984,1983-11-09,1984-04-29,173,0,96,326,422,42,85,127,549,22,161,Kansas,Dodge City,27340
6702,1984-1985,1984-11-26,1985-04-01,127,0,39,247,286,34,49,83,369,17,95,Kansas,Dodge City,27340
6703,1985-1986,1985-11-10,1986-02-28,111,0,46,223,269,21,36,57,326,11,75,Kansas,Dodge City,27340
6704,1986-1987,1986-11-12,1987-03-31,140,0,19,189,208,42,66,108,316,12,78,Kansas,Dodge City,27340
6705,1987-1988,1987-11-26,1988-03-29,125,0,43,283,326,38,76,114,440,15,94,Kansas,Dodge City,27340
6706,1988-1989,1988-11-15,1989-04-10,147,0,32,306,338,16,5,21,359,8,40,Kansas,Dodge City,27340
6707,1989-1990,1989-12-01,1990-04-05,126,0,37,242,279,41,68,109,388,18,110,Kansas,Dodge City,27340
6708,1990-1991,1990-11-03,1991-03-16,134,0,46,273,319,22,18,40,359,16,122,Kansas,Dodge City,27340
6709,1991-1992,1991-10-30,1992-03-22,145,0,12,164,176,11,19,30,206,6,36,Kansas,Dodge City,27340
6710,1992-1993,1992-11-11,1993-03-18,128,0,66,307,373,92,282,374,747,27,184,Kansas,Dodge City,27340
6711,1993-1994,1993-10-29,1994-04-06,160,0,28,328,356,13,7,20,376,9,52,Kansas,Dodge City,27340
6712,1994-1995,1994-12-01,1995-03-29,119,0,30,189,219,37,54,91,310,16,118,Kansas,Dodge City,27340
6713,1995-1996,1995-09-21,1996-03-25,187,0,45,352,397,24,16,40,437,14,100,Kansas,Dodge City,27340
6714,1996-1997,1996-10-21,1997-04-11,173,0,43,287,330,25,20,45,375,14,78,Kansas,Dodge City,27340
6715,1997-1998,1997-10-25,1998-04-03,161,0,27,228,255,63,84,147,402,23,119,Kansas,Dodge City,27340
6716,1998-1999,1998-12-01,1999-03-19,109,0,27,198,225,45,46,91,316,14,90,Kansas,Dodge City,27340
6717,1999-2000,1999-12-01,2000-03-18,109,0,11,186,197,16,21,37,234,7,32,Kansas,Dodge City,27340
6718,2000-2001,2000-11-12,2001-03-26,135,0,41,306,347,50,76,126,473,17,118,Kansas,Dodge City,27340
6719,2001-2002,2001-11-27,2002-03-25,119,0,19,281,300,20,30,50,350,9,49,Kansas,Dodge City,27340
6720,2002-2003,2002-10-24,2003-03-05,133,0,37,253,290,32,62,94,384,13,74,Kansas,Dodge City,27340
6721,2003-2004,2003-11-05,2004-04-12,160,0,24,263,287,21,26,47,334,10,52,Kansas,Dodge City,27340
6722,2004-2005,2004-11-13,2005-02-28,108,0,29,174,203,29,28,57,260,13,75,Kansas,Dodge City,27340
6723,2005-2006,2005-11-27,2006-03-24,118,0,23,205,228,22,27,49,277,10,61,Kansas,Dodge City,27340
6724,2006-2007,2006-11-29,2007-04-14,137,0,32,224,256,32,29,61,317,14,90,Kansas,Dodge City,27340
6725,2007-2008,2007-11-23,2008-03-07,106,0,20,251,271,30,53,83,354,10,67,Kansas,Dodge City,27340
6726,2008-2009,2008-12-01,2009-04-05,126,0,25,265,290,31,23,54,344,13,91,Kansas,Dodge City,27340
6727,2009-2010,2009-11-15,2010-03-20,126,0,45,277,322,34,63,97,419,19,99,Kansas,Dodge City,27340
6728,2010-2011,2010-12-01,2011-04-15,136,0,28,280,308,22,35,57,365,12,85,Kansas,Dodge City,27340
6729,2011-2012,2011-11-02,2012-02-29,120,0,11,195,206,11,30,41,247,5,20,Kansas,Dodge City,27340
6730,2012-2013,2012-12-01,2013-05-02,153,0,20,281,301,41,83,124,425,14,84,Kansas,Dodge City,27340
6731,2013-2014,2013-10-18,2014-04-14,179,0,75,356,431,46,80,126,557,23,171,Kansas,Dodge City,27340
6732,2014-2015,2014-11-11,2015-03-04,114,0,38,260,298,32,39,71,369,16,98,Kansas,Dodge City,27340
6733,2015-2016,2015-11-18,2016-03-18,122,0,15,178,193,19,29,48,241,10,39,Kansas,Dodge City,27340
6734,2016-2017,2016-12-01,2017-04-30,151,0,23,226,249,12,10,22,271,6,39,Kansas,Dodge City,27340
6735,2017-2018,2017-12-01,2018-04-07,128,0,31,295,326,9,4,13,339,6,34,Kansas,Dodge City,27340
6736,2018-2019,2018-10-14,2019-03-30,168,0,38,298,336,37,43,80,416,20,113,Kansas,Dodge City,27340
6737,2019-2020,2019-10-30,2020-02-29,123,0,9,198,207,24,17,41,248,13,55,Kansas,Dodge City,27340
6738,1950-1951,1950-11-09,1951-04-21,164,0,53,483,536,30,19,49,585,20,144,Kansas,Goodland,4489
6739,1951-1952,1951-10-31,1952-04-09,162,0,44,471,515,41,35,76,591,24,147,Kansas,Goodland,4489
6740,1952-1953,1952-10-14,1953-04-18,187,0,39,443,482,45,92,137,619,19,131,Kansas,Goodland,4489
6741,1953-1954,1953-11-04,1954-05-02,180,0,34,363,397,62,103,165,562,22,138,Kansas,Goodland,4489
6742,1954-1955,1954-10-28,1955-03-27,151,0,46,431,477,37,99,136,613,18,140,Kansas,Goodland,4489
6743,1955-1956,1955-10-23,1956-04-09,170,0,59,466,525,41,89,130,655,21,151,Kansas,Goodland,4489
6744,1956-1957,1956-10-25,1957-04-12,170,0,51,438,489,67,69,136,625,35,223,Kansas,Goodland,4489
6745,1957-1958,1957-10-24,1958-04-29,188,0,40,446,486,68,165,233,719,32,179,Kansas,Goodland,4489
6746,1958-1959,1958-11-17,1959-04-12,147,0,46,397,443,65,76,141,584,31,213,Kansas,Goodland,4489
6747,1959-1960,1959-09-29,1960-03-18,172,0,94,478,572,78,219,297,869,33,254,Kansas,Goodland,4489
6748,1960-1961,1960-10-30,1961-04-25,178,0,25,372,397,54,65,119,516,26,128,Kansas,Goodland,4489
6749,1961-1962,1961-11-02,1962-03-29,148,0,87,478,565,45,82,127,692,20,185,Kansas,Goodland,4489
6750,1962-1963,1962-11-15,1963-03-16,122,0,65,360,425,51,61,112,537,20,172,Kansas,Goodland,4489
6751,1963-1964,1963-11-16,1964-04-12,149,0,44,443,487,54,66,120,607,26,157,Kansas,Goodland,4489
6752,1964-1965,1964-11-18,1965-03-26,129,0,48,464,512,39,40,79,591,22,166,Kansas,Goodland,4489
6753,1965-1966,1965-12-01,1966-05-12,163,0,59,375,434,45,125,170,604,25,180,Kansas,Goodland,4489
6754,1966-1967,1966-10-14,1967-05-04,203,0,30,408,438,40,31,71,509,19,117,Kansas,Goodland,4489
6755,1967-1968,1967-11-02,1968-05-16,197,0,29,397,426,31,33,64,490,22,112,Kansas,Goodland,4489
6756,1968-1969,1968-11-14,1969-03-16,123,0,55,365,420,55,150,205,625,22,157,Kansas,Goodland,4489
6757,1969-1970,1969-10-11,1970-05-01,203,0,25,372,397,64,48,112,509,30,142,Kansas,Goodland,4489
6758,1970-1971,1970-10-07,1971-03-18,163,0,40,355,395,54,67,121,516,27,151,Kansas,Goodland,4489
6759,1971-1972,1971-10-29,1972-03-28,152,0,34,340,374,27,18,45,419,18,121,Kansas,Goodland,4489
6760,1972-1973,1972-10-28,1973-05-01,186,0,99,416,515,109,177,286,801,49,332,Kansas,Goodland,4489
6761,1973-1974,1973-10-10,1974-04-13,186,0,68,369,437,66,121,187,624,30,227,Kansas,Goodland,4489
6762,1974-1975,1974-11-03,1975-04-18,167,0,31,432,463,50,53,103,566,20,129,Kansas,Goodland,4489
6763,1975-1976,1975-11-18,1976-03-29,133,0,33,297,330,50,101,151,481,20,123,Kansas,Goodland,4489
6764,1976-1977,1976-10-06,1977-04-20,197,0,34,436,470,53,77,130,600,20,132,Kansas,Goodland,4489
6765,1977-1978,1977-11-01,1978-05-06,187,0,101,497,598,47,126,173,771,28,217,Kansas,Goodland,4489
6766,1978-1979,1978-10-22,1979-04-03,164,0,94,447,541,86,113,199,740,31,218,Kansas,Goodland,4489
6767,1979-1980,1979-10-21,1980-04-08,171,0,59,346,405,137,243,380,785,33,239,Kansas,Goodland,4489
6768,1980-1981,1980-10-27,1981-04-03,159,0,33,333,366,57,126,183,549,14,110,Kansas,Goodland,4489
6769,1981-1982,1981-11-19,1982-05-05,168,0,58,383,441,32,74,106,547,17,128,Kansas,Goodland,4489
6770,1982-1983,1982-10-19,1983-04-13,177,0,34,299,333,76,184,260,593,30,143,Kansas,Goodland,4489
6771,1983-1984,1983-11-08,1984-04-30,175,0,123,422,545,136,277,413,958,34,311,Kansas,Goodland,4489
6772,1984-1985,1984-09-27,1985-05-13,229,0,54,363,417,56,115,171,588,24,145,Kansas,Goodland,4489
6773,1985-1986,1985-09-28,1986-04-27,212,0,63,343,406,47,57,104,510,22,147,Kansas,Goodland,4489
6774,1986-1987,1986-10-11,1987-04-13,185,0,27,305,332,74,85,159,491,29,147,Kansas,Goodland,4489
6775,1987-1988,1987-11-15,1988-05-02,170,0,66,385,451,88,132,220,671,22,185,Kansas,Goodland,4489
6776,1988-1989,1988-11-15,1989-04-30,167,0,62,397,459,40,29,69,528,20,130,Kansas,Goodland,4489
6777,1989-1990,1989-10-16,1990-05-04,201,0,49,378,427,58,90,148,575,21,148,Kansas,Goodland,4489
6778,1990-1991,1990-10-08,1991-05-04,209,0,69,370,439,58,49,107,546,25,169,Kansas,Goodland,4489
6779,1991-1992,1991-10-29,1992-03-18,142,0,25,238,263,37,69,106,369,17,76,Kansas,Goodland,4489
6780,1992-1993,1992-10-29,1993-04-07,161,0,92,451,543,66,216,282,825,27,188,Kansas,Goodland,4489
6781,1993-1994,1993-10-29,1994-04-30,184,0,56,439,495,60,106,166,661,19,135,Kansas,Goodland,4489
6782,1994-1995,1994-11-04,1995-04-27,175,0,42,336,378,70,100,170,548,28,185,Kansas,Goodland,4489
6783,1995-1996,1995-09-20,1996-04-28,222,0,58,473,531,50,54,104,635,21,163,Kansas,Goodland,4489
6784,1996-1997,1996-11-14,1997-04-13,151,0,62,414,476,35,60,95,571,14,127,Kansas,Goodland,4489
6785,1997-1998,1997-10-25,1998-03-11,138,0,40,272,312,57,81,138,450,20,109,Kansas,Goodland,4489
6786,1998-1999,1998-11-02,1999-04-23,173,0,34,332,366,44,49,93,459,16,104,Kansas,Goodland,4489
6787,1999-2000,1999-11-22,2000-04-15,146,0,7,286,293,32,13,45,338,20,83,Kansas,Goodland,4489
6788,2000-2001,2000-09-24,2001-03-26,184,0,53,398,451,51,107,158,609,23,159,Kansas,Goodland,4489
6789,2001-2002,2001-10-15,2002-03-26,163,0,26,371,397,27,35,62,459,11,75,Kansas,Goodland,4489
6790,2002-2003,2002-10-22,2003-04-07,168,0,38,348,386,33,32,65,451,16,93,Kansas,Goodland,4489
6791,2003-2004,2003-11-05,2004-04-12,160,0,24,351,375,34,33,67,442,19,103,Kansas,Goodland,4489
6792,2004-2005,2004-11-01,2005-04-29,180,0,33,293,326,26,18,44,370,17,85,Kansas,Goodland,4489
6793,2005-2006,2005-11-27,2006-04-07,132,0,32,285,317,39,56,95,412,16,119,Kansas,Goodland,4489
6794,2006-2007,2006-11-29,2007-04-14,137,0,73,360,433,70,386,456,889,20,184,Kansas,Goodland,4489
6795,2007-2008,2007-11-21,2008-05-03,165,0,39,393,432,54,98,152,584,23,136,Kansas,Goodland,4489
6796,2008-2009,2008-10-23,2009-04-06,166,0,30,391,421,33,27,60,481,22,109,Kansas,Goodland,4489
6797,2009-2010,2009-10-10,2010-04-07,180,0,52,392,444,56,73,129,573,28,154,Kansas,Goodland,4489
6798,2010-2011,2010-11-29,2011-04-15,138,0,46,368,414,40,58,98,512,17,127,Kansas,Goodland,4489
6799,2011-2012,2011-10-26,2012-02-29,127,0,15,301,316,29,52,81,397,13,72,Kansas,Goodland,4489
6800,2012-2013,2012-10-05,2013-05-02,210,0,36,470,506,86,124,210,716,27,188,Kansas,Goodland,4489
6801,2013-2014,2013-10-18,2014-04-13,178,0,79,432,511,45,70,115,626,23,186,Kansas,Goodland,4489
6802,2014-2015,2014-11-11,2015-04-03,144,0,57,342,399,40,64,104,503,22,156,Kansas,Goodland,4489
6803,2015-2016,2015-11-11,2016-04-29,171,0,20,292,312,42,60,102,414,13,76,Kansas,Goodland,4489
6804,2016-2017,2016-11-17,2017-04-30,165,0,37,354,391,20,13,33,424,11,70,Kansas,Goodland,4489
6805,2017-2018,2017-10-31,2018-04-24,176,0,43,412,455,41,56,97,552,18,122,Kansas,Goodland,4489
6806,2018-2019,2018-10-09,2019-04-11,185,0,52,409,461,46,63,109,570,24,151,Kansas,Goodland,4489
6807,2019-2020,2019-10-28,2020-03-14,139,0,21,312,333,33,30,63,396,14,97,Kansas,Goodland,4489
6808,1951-1952,1951-11-01,1952-04-10,162,8,38,414,452,29,46,75,527,16,90,Kansas,Hays,20510
6809,1952-1953,1952-11-24,1953-04-12,140,9,33,314,347,47,133,180,527,16,99,Kansas,Hays,20510
6810,1953-1954,1953-11-06,1954-03-30,145,7,35,326,361,39,53,92,453,11,69,Kansas,Hays,20510
6811,1954-1955,1954-12-01,1955-03-27,117,0,38,354,392,18,59,77,469,6,44,Kansas,Hays,20510
6812,1955-1956,1955-11-16,1956-04-10,147,4,65,434,499,46,155,201,700,13,115,Kansas,Hays,20510
6813,1956-1957,1956-11-21,1957-04-12,143,0,58,383,441,32,51,83,524,17,99,Kansas,Hays,20510
6814,1957-1958,1957-10-26,1958-03-30,156,0,44,381,425,70,207,277,702,18,137,Kansas,Hays,20510
6815,1958-1959,1958-11-17,1959-04-12,147,0,66,393,459,37,71,108,567,16,128,Kansas,Hays,20510
6816,1959-1960,1959-11-06,1960-03-25,141,0,92,444,536,61,281,342,878,17,163,Kansas,Hays,20510
6817,1960-1961,1960-11-09,1961-04-10,153,0,35,348,383,31,63,94,477,10,61,Kansas,Hays,20510
6818,1961-1962,1961-11-16,1962-03-12,117,16,85,372,457,38,103,141,598,14,140,Kansas,Hays,20510
6819,1962-1963,1962-11-16,1963-03-06,111,0,65,358,423,19,26,45,468,10,87,Kansas,Hays,20510
6820,1963-1964,1963-12-01,1964-03-26,117,0,46,363,409,15,40,55,464,4,34,Kansas,Hays,20510
6821,1964-1965,1964-11-19,1965-03-26,128,0,58,427,485,28,70,98,583,8,67,Kansas,Hays,20510
6822,1965-1966,1965-12-01,1966-03-23,113,0,61,330,391,21,89,110,501,10,77,Kansas,Hays,20510
6823,1966-1967,1966-12-01,1967-03-18,108,0,40,328,368,25,88,113,481,10,73,Kansas,Hays,20510
6824,1967-1968,1967-11-03,1968-02-29,119,0,41,327,368,12,29,41,409,7,40,Kansas,Hays,20510
6825,1969-1970,1969-12-01,1970-04-03,124,0,38,333,371,29,38,67,438,11,67,Kansas,Hays,20510
6826,1970-1971,1970-11-23,1971-03-26,124,0,54,367,421,41,127,168,589,10,87,Kansas,Hays,20510
6827,1971-1972,1971-11-28,1972-04-03,128,0,44,316,360,10,15,25,385,5,36,Kansas,Hays,20510
6828,1972-1973,1972-11-10,1973-04-10,152,0,76,350,426,32,67,99,525,14,107,Kansas,Hays,20510
6829,1973-1974,1973-11-21,1974-04-04,135,0,68,315,383,46,189,235,618,14,112,Kansas,Hays,20510
6830,1974-1975,1974-11-29,1975-04-03,126,0,36,347,383,34,77,111,494,11,78,Kansas,Hays,20510
6831,1975-1976,1975-11-20,1976-03-16,118,0,40,314,354,23,40,63,417,6,44,Kansas,Hays,20510
6832,1976-1977,1976-10-27,1977-04-04,160,0,48,435,483,25,69,94,577,11,80,Kansas,Hays,20510
6833,1977-1978,1977-11-22,1978-03-24,123,0,84,443,527,36,131,167,694,9,81,Kansas,Hays,20510
6834,1978-1979,1978-11-12,1979-04-04,144,0,116,469,585,52,271,323,908,16,149,Kansas,Hays,20510
6835,1979-1980,1979-11-29,1980-04-03,127,0,49,315,364,53,140,193,557,12,96,Kansas,Hays,20510
6836,1981-1982,1981-11-20,1982-03-06,107,3,64,341,405,24,70,94,499,11,98,Kansas,Hays,20510
6837,1982-1983,1982-11-23,1983-04-05,134,8,28,248,276,33,84,117,393,14,75,Kansas,Hays,20510
6838,1984-1985,1984-11-27,1985-04-01,126,6,60,345,405,47,181,228,633,14,124,Kansas,Hays,20510
6839,1986-1987,1986-11-13,1987-04-01,140,4,22,255,277,37,41,78,355,11,70,Kansas,Hays,20510
6840,1990-1991,1990-11-28,1991-03-16,109,0,62,332,394,13,13,26,420,9,62,Kansas,Hays,20510
6841,1991-1992,1991-10-31,1992-03-19,141,1,15,206,221,14,30,44,265,5,28,Kansas,Hays,20510
6842,1992-1993,1992-11-12,1993-04-04,144,3,82,393,475,70,420,490,965,25,167,Kansas,Hays,20510
6843,1993-1994,1993-11-24,1994-04-30,158,0,47,340,387,25,46,71,458,12,75,Kansas,Hays,20510
6844,1994-1995,1994-11-23,1995-03-09,107,0,36,259,295,26,72,98,393,12,81,Kansas,Hays,20510
6845,1995-1996,1995-11-11,1996-03-26,137,10,59,427,486,21,45,66,552,10,82,Kansas,Hays,20510
6846,1996-1997,1996-11-22,1997-04-13,143,7,60,367,427,24,40,64,491,9,66,Kansas,Hays,20510
6847,1997-1998,1997-10-26,1998-03-19,145,10,32,281,313,31,86,117,430,11,48,Kansas,Hays,20510
6848,1998-1999,1998-11-10,1999-03-16,127,9,33,252,285,30,25,55,340,14,76,Kansas,Hays,20510
6849,1999-2000,1999-12-01,2000-03-04,95,4,12,217,229,18,23,41,270,8,46,Kansas,Hays,20510
6850,2000-2001,2000-11-13,2001-03-12,120,15,51,363,414,35,82,117,531,11,90,Kansas,Hays,20510
6851,2001-2002,2001-11-28,2002-03-26,119,4,26,327,353,15,43,58,411,4,41,Kansas,Hays,20510
6852,2002-2003,2002-10-24,2003-03-10,138,3,48,336,384,14,17,31,415,8,54,Kansas,Hays,20510
6853,2003-2004,2003-11-06,2004-04-13,160,0,48,350,398,23,92,115,513,12,73,Kansas,Hays,20510
6854,2004-2005,2004-11-29,2005-02-28,92,4,42,225,267,18,33,51,318,10,74,Kansas,Hays,20510
6855,2005-2006,2005-11-28,2006-03-24,117,3,37,259,296,21,41,62,358,9,63,Kansas,Hays,20510
6856,2006-2007,2006-11-30,2007-04-06,128,2,39,261,300,23,45,68,368,8,55,Kansas,Hays,20510
6857,2007-2008,2007-11-24,2008-03-08,106,5,33,316,349,47,177,224,573,11,82,Kansas,Hays,20510
6858,2008-2009,2008-11-28,2009-04-05,129,8,40,331,371,10,9,19,390,7,46,Kansas,Hays,20510
6859,2009-2010,2009-10-11,2010-03-20,161,0,63,327,390,30,66,96,486,15,94,Kansas,Hays,20510
6860,2012-2013,2012-12-01,2013-04-23,144,0,33,313,346,52,117,169,515,12,92,Kansas,Hays,20510
6861,2013-2014,2013-10-19,2014-03-08,141,2,84,409,493,31,55,86,579,17,135,Kansas,Hays,20510
6862,2014-2015,2014-11-12,2015-03-01,110,0,49,320,369,18,17,35,404,12,85,Kansas,Hays,20510
6863,2015-2016,2015-11-27,2016-03-24,119,0,20,218,238,24,41,65,303,7,39,Kansas,Hays,20510
6864,2016-2017,2016-12-01,2017-04-30,151,0,31,277,308,7,3,10,318,5,42,Kansas,Hays,20510
6865,2017-2018,2017-11-01,2018-04-15,166,0,54,411,465,19,11,30,495,15,84,Kansas,Hays,20510
6866,2018-2019,2018-10-15,2019-03-30,167,0,71,391,462,47,109,156,618,14,100,Kansas,Hays,20510
6867,2019-2020,2019-10-29,2020-02-29,124,0,18,281,299,20,16,36,335,13,61,Kansas,Hays,20510
6868,1950-1951,1950-12-01,1951-03-13,103,0,25,191,216,15,22,37,253,5,46,Kansas,Independence,9483
6869,1951-1952,1951-11-02,1952-03-04,124,0,13,156,169,23,31,54,223,6,48,Kansas,Independence,9483
6870,1952-1953,1952-11-28,1953-04-18,142,0,4,127,131,6,3,9,140,4,12,Kansas,Independence,9483
6871,1953-1954,1953-12-01,1954-03-02,92,6,10,151,161,9,6,15,176,3,23,Kansas,Independence,9483
6872,1954-1955,1954-12-01,1955-03-26,116,0,4,167,171,16,14,30,201,3,21,Kansas,Independence,9483
6873,1955-1956,1955-11-28,1956-03-15,109,1,15,209,224,26,47,73,297,10,46,Kansas,Independence,9483
6874,1956-1957,1956-12-01,1957-04-12,133,3,20,147,167,10,5,15,182,3,17,Kansas,Independence,9483
6875,1957-1958,1957-12-01,1958-03-17,107,1,18,172,190,30,22,52,242,7,45,Kansas,Independence,9483
6876,1958-1959,1958-11-27,1959-03-05,99,0,32,203,235,24,45,69,304,8,59,Kansas,Independence,9483
6877,1959-1960,1959-11-17,1960-03-15,120,0,29,198,227,29,68,97,324,11,62,Kansas,Independence,9483
6878,1960-1961,1960-12-01,1961-02-28,90,0,12,167,179,7,4,11,190,2,9,Kansas,Independence,9483
6879,1961-1962,1961-12-01,1962-03-01,91,0,36,190,226,16,28,44,270,5,33,Kansas,Independence,9483
6880,1962-1963,1962-12-01,1963-02-28,90,1,34,229,263,9,7,16,279,4,39,Kansas,Independence,9483
6881,1963-1964,1963-12-01,1964-03-25,116,0,27,223,250,16,10,26,276,5,41,Kansas,Independence,9483
6882,1964-1965,1964-11-21,1965-03-25,125,0,23,246,269,5,3,8,277,2,16,Kansas,Independence,9483
6883,1965-1966,1965-12-01,1966-02-28,90,0,21,155,176,8,6,14,190,6,25,Kansas,Independence,9483
6884,1966-1967,1966-12-01,1967-03-08,98,0,18,197,215,16,40,56,271,5,33,Kansas,Independence,9483
6885,1967-1968,1967-12-01,1968-03-20,111,1,17,162,179,6,3,9,188,2,12,Kansas,Independence,9483
6886,1968-1969,1968-12-01,1969-03-11,101,0,20,172,192,9,11,20,212,3,15,Kansas,Independence,9483
6887,1969-1970,1969-12-01,1970-03-19,109,0,27,185,212,29,30,59,271,3,45,Kansas,Independence,9483
6888,1970-1971,1970-11-23,1971-02-28,98,0,20,168,188,14,17,31,219,3,25,Kansas,Independence,9483
6889,1971-1972,1971-11-22,1972-02-29,100,0,16,144,160,19,17,36,196,5,35,Kansas,Independence,9483
6890,1972-1973,1972-11-16,1973-02-28,105,3,40,183,223,20,56,76,299,9,43,Kansas,Independence,9483
6891,1974-1975,1974-11-29,1975-03-28,120,2,11,154,165,30,29,59,224,9,43,Kansas,Independence,9483
6892,1976-1977,1976-11-28,1977-02-28,93,0,31,236,267,12,33,45,312,4,34,Kansas,Independence,9483
6893,1977-1978,1977-12-01,1978-03-04,94,0,54,268,322,33,125,158,480,11,84,Kansas,Independence,9483
6894,1978-1979,1978-12-01,1979-04-03,124,9,63,334,397,29,158,187,584,12,96,Kansas,Independence,9483
6895,1979-1980,1979-12-01,1980-03-02,93,0,21,202,223,24,51,75,298,3,34,Kansas,Independence,9483
6896,1980-1981,1980-12-01,1981-02-28,90,0,8,168,176,3,8,11,187,2,13,Kansas,Independence,9483
6897,1982-1983,1982-12-01,1983-03-20,110,8,10,135,145,4,25,29,174,2,7,Kansas,Independence,9483
6898,1983-1984,1983-12-01,1984-03-31,122,3,65,294,359,27,106,133,492,9,94,Kansas,Independence,9483
6899,1984-1985,1984-11-18,1985-02-28,103,4,29,242,271,26,59,85,356,9,53,Kansas,Independence,9483
6900,1985-1986,1985-11-27,1986-02-28,94,11,23,190,213,15,15,30,243,7,37,Kansas,Independence,9483
6901,1987-1988,1987-12-01,1988-03-17,108,3,27,191,218,46,88,134,352,11,76,Kansas,Independence,9483
6902,1988-1989,1988-12-01,1989-03-05,95,1,21,149,170,14,14,28,198,7,41,Kansas,Independence,9483
6903,1989-1990,1989-12-01,1990-03-24,114,1,27,170,197,20,27,47,244,10,49,Kansas,Independence,9483
6904,1990-1991,1990-12-01,1991-02-28,90,2,23,148,171,9,5,14,185,9,47,Kansas,Independence,9483
6905,1991-1992,1991-11-02,1992-03-19,139,7,3,95,98,1,0,1,99,1,1,Kansas,Independence,9483
6906,1992-1993,1992-11-22,1993-02-28,99,4,18,134,152,29,59,88,240,7,45,Kansas,Independence,9483
6907,1993-1994,1993-11-25,1994-03-09,105,5,21,167,188,13,8,21,209,6,34,Kansas,Independence,9483
6908,1994-1995,1994-12-01,1995-03-07,97,1,10,106,116,10,9,19,135,6,31,Kansas,Independence,9483
6909,1995-1996,1995-12-01,1996-03-09,100,6,39,219,258,13,13,26,284,8,38,Kansas,Independence,9483
6910,1996-1997,1996-11-25,1997-02-28,96,4,28,182,210,17,40,57,267,7,41,Kansas,Independence,9483
6911,1997-1998,1997-11-12,1998-03-20,129,1,8,132,140,12,4,16,156,6,22,Kansas,Independence,9483
6912,1998-1999,1998-12-01,1999-03-15,105,6,23,122,145,10,12,22,167,2,12,Kansas,Independence,9483
6913,1999-2000,1999-12-01,2000-03-12,103,1,5,121,126,18,20,38,164,4,28,Kansas,Independence,9483
6914,2000-2001,2000-11-09,2001-03-01,113,6,36,271,307,31,101,132,439,9,66,Kansas,Independence,9483
6915,2001-2002,2001-11-29,2002-03-04,96,8,10,156,166,9,14,23,189,2,17,Kansas,Independence,9483
6916,2002-2003,2002-12-01,2003-03-06,96,19,23,192,215,19,66,85,300,7,50,Kansas,Independence,9483
6917,2003-2004,2003-12-01,2004-02-29,91,4,15,158,173,20,20,40,213,4,32,Kansas,Independence,9483
6918,2004-2005,2004-12-01,2005-02-28,90,7,14,128,142,0,1,1,143,0,0,Kansas,Independence,9483
6919,2005-2006,2005-12-01,2006-02-28,90,9,14,147,161,9,8,17,178,3,15,Kansas,Independence,9483
6920,2006-2007,2006-12-01,2007-02-28,90,13,28,178,206,31,83,114,320,6,56,Kansas,Independence,9483
6921,2009-2010,2009-12-01,2010-03-22,112,13,35,222,257,29,45,74,331,6,53,Kansas,Independence,9483
6922,2014-2015,2014-11-13,2015-03-05,113,0,21,192,213,13,8,21,234,5,28,Kansas,Independence,9483
6923,2015-2016,2015-12-01,2016-02-29,91,0,9,108,117,2,0,2,119,2,6,Kansas,Independence,9483
6924,2016-2017,2016-12-01,2017-02-28,90,0,16,137,153,1,0,1,154,1,12,Kansas,Independence,9483
6925,2017-2018,2017-12-01,2018-02-28,90,0,24,191,215,5,3,8,223,3,18,Kansas,Independence,9483
6926,2018-2019,2018-11-12,2019-03-05,114,0,25,189,214,12,11,23,237,5,22,Kansas,Independence,9483
6927,2019-2020,2019-11-13,2020-02-29,109,0,7,126,133,6,1,7,140,3,15,Kansas,Independence,9483
6928,1950-1951,1950-11-23,1951-04-12,141,2,46,348,394,19,19,38,432,10,71,Kansas,Manhattan,52281
6929,1951-1952,1951-11-02,1952-03-26,146,4,30,325,355,24,44,68,423,13,84,Kansas,Manhattan,52281
6930,1952-1953,1952-11-26,1953-03-06,101,1,25,278,303,38,107,145,448,12,77,Kansas,Manhattan,52281
6931,1953-1954,1953-11-07,1954-03-29,143,0,24,258,282,13,18,31,313,4,25,Kansas,Manhattan,52281
6932,1954-1955,1954-12-01,1955-03-26,116,1,16,255,271,34,83,117,388,11,73,Kansas,Manhattan,52281
6933,1955-1956,1955-11-16,1956-04-09,146,3,48,344,392,37,69,106,498,20,124,Kansas,Manhattan,52281
6934,1956-1957,1956-11-21,1957-04-12,143,0,32,249,281,28,25,53,334,15,88,Kansas,Manhattan,52281
6935,1957-1958,1957-10-26,1958-03-19,145,0,33,261,294,28,44,72,366,16,88,Kansas,Manhattan,52281
6936,1958-1959,1958-11-27,1959-04-12,137,0,53,296,349,38,88,126,475,15,117,Kansas,Manhattan,52281
6937,1959-1960,1959-11-05,1960-03-26,143,3,57,387,444,73,250,323,767,22,164,Kansas,Manhattan,52281
6938,1960-1961,1960-12-01,1961-04-09,130,0,23,235,258,20,39,59,317,10,57,Kansas,Manhattan,52281
6939,1961-1962,1961-11-18,1962-03-13,116,1,69,312,381,36,108,144,525,18,141,Kansas,Manhattan,52281
6940,1962-1963,1962-12-01,1963-03-05,95,0,61,277,338,15,25,40,378,11,111,Kansas,Manhattan,52281
6941,1963-1964,1963-12-01,1964-03-26,117,0,39,265,304,17,35,52,356,12,62,Kansas,Manhattan,52281
6942,1964-1965,1964-11-19,1965-03-25,127,0,35,325,360,38,72,110,470,12,82,Kansas,Manhattan,52281
6943,1965-1966,1965-12-01,1966-02-28,90,5,35,199,234,10,10,20,254,5,26,Kansas,Manhattan,52281
6944,1966-1967,1966-12-01,1967-02-28,90,0,32,223,255,27,79,106,361,9,69,Kansas,Manhattan,52281
6945,1967-1968,1967-12-01,1968-02-29,91,3,31,205,236,34,53,87,323,11,85,Kansas,Manhattan,52281
6946,1969-1970,1969-12-01,1970-04-02,123,0,46,279,325,32,51,83,408,13,80,Kansas,Manhattan,52281
6947,1970-1971,1970-11-23,1971-03-26,124,0,48,278,326,44,134,178,504,7,68,Kansas,Manhattan,52281
6948,1971-1972,1971-11-23,1972-03-31,130,0,34,231,265,14,16,30,295,9,59,Kansas,Manhattan,52281
6949,1972-1973,1972-11-16,1973-02-28,105,0,70,239,309,31,94,125,434,11,82,Kansas,Manhattan,52281
6950,1973-1974,1973-12-01,1974-04-04,125,0,62,234,296,37,91,128,424,17,141,Kansas,Manhattan,52281
6951,1974-1975,1974-11-29,1975-04-03,126,0,25,245,270,50,108,158,428,13,91,Kansas,Manhattan,52281
6952,1975-1976,1975-11-20,1976-03-16,118,0,25,211,236,31,32,63,299,14,80,Kansas,Manhattan,52281
6953,1976-1977,1976-11-27,1977-04-04,129,0,43,316,359,18,73,91,450,10,62,Kansas,Manhattan,52281
6954,1977-1978,1977-11-26,1978-03-11,106,1,88,365,453,41,147,188,641,13,107,Kansas,Manhattan,52281
6955,1978-1979,1978-11-15,1979-03-23,129,1,115,388,503,57,326,383,886,18,176,Kansas,Manhattan,52281
6956,1979-1980,1979-11-29,1980-03-24,117,0,40,257,297,32,69,101,398,14,90,Kansas,Manhattan,52281
6957,1980-1981,1980-12-01,1981-02-28,90,0,23,188,211,14,24,38,249,6,49,Kansas,Manhattan,52281
6958,1981-1982,1981-12-01,1982-04-08,129,2,65,303,368,25,51,76,444,9,95,Kansas,Manhattan,52281
6959,1982-1983,1982-11-23,1983-04-14,143,3,19,196,215,41,86,127,342,16,74,Kansas,Manhattan,52281
6960,1983-1984,1983-11-23,1984-03-24,123,12,95,330,425,43,144,187,612,19,157,Kansas,Manhattan,52281
6961,1984-1985,1984-11-10,1985-03-31,142,0,49,286,335,30,185,215,550,12,93,Kansas,Manhattan,52281
6962,1985-1986,1985-11-23,1986-02-28,98,4,36,264,300,15,48,63,363,8,64,Kansas,Manhattan,52281
6963,1986-1987,1986-11-13,1987-03-30,138,10,13,194,207,16,38,54,261,7,39,Kansas,Manhattan,52281
6964,1987-1988,1987-11-28,1988-03-18,112,0,35,274,309,28,56,84,393,13,73,Kansas,Manhattan,52281
6965,1988-1989,1988-12-01,1989-03-05,95,2,36,215,251,13,14,27,278,7,49,Kansas,Manhattan,52281
6966,1989-1990,1989-12-01,1990-03-25,115,7,40,229,269,26,52,78,347,9,63,Kansas,Manhattan,52281
6967,1990-1991,1990-12-01,1991-03-14,104,6,41,250,291,14,43,57,348,7,64,Kansas,Manhattan,52281
6968,1991-1992,1991-10-31,1992-03-10,132,4,9,175,184,12,16,28,212,6,29,Kansas,Manhattan,52281
6969,1992-1993,1992-11-25,1993-03-19,115,20,42,286,328,44,112,156,484,13,91,Kansas,Manhattan,52281
6970,1993-1994,1993-11-24,1994-02-28,97,4,33,268,301,14,14,28,329,5,36,Kansas,Manhattan,52281
6971,1994-1995,1994-12-01,1995-03-09,99,12,23,229,252,25,51,76,328,6,58,Kansas,Manhattan,52281
6972,1996-1997,1996-11-24,1997-02-28,97,15,41,262,303,15,42,57,360,4,28,Kansas,Manhattan,52281
6973,1998-1999,1998-12-01,1999-03-08,98,7,29,189,218,8,9,17,235,6,34,Kansas,Manhattan,52281
6974,1999-2000,1999-12-01,2000-02-29,91,8,8,173,181,15,18,33,214,5,29,Kansas,Manhattan,52281
6975,2000-2001,2000-12-01,2001-03-03,93,10,36,302,338,43,157,200,538,13,102,Kansas,Manhattan,52281
6976,2002-2003,2002-12-01,2003-03-05,95,1,21,245,266,11,18,29,295,4,35,Kansas,Manhattan,52281
6977,2003-2004,2003-12-01,2004-02-29,91,5,40,227,267,36,121,157,424,13,97,Kansas,Manhattan,52281
6978,2004-2005,2004-11-24,2005-02-28,97,13,22,192,214,15,29,44,258,7,41,Kansas,Manhattan,52281
6979,2005-2006,2005-11-28,2006-03-22,115,9,20,186,206,30,34,64,270,9,66,Kansas,Manhattan,52281
6980,2006-2007,2006-11-30,2007-03-01,92,8,30,206,236,30,45,75,311,9,73,Kansas,Manhattan,52281
6981,2007-2008,2007-11-24,2008-03-08,106,3,30,303,333,51,110,161,494,19,113,Kansas,Manhattan,52281
6982,2008-2009,2008-12-01,2009-03-29,119,1,40,302,342,23,37,60,402,10,77,Kansas,Manhattan,52281
6983,2009-2010,2009-12-01,2010-03-21,111,0,67,346,413,45,145,190,603,17,137,Kansas,Manhattan,52281
6984,2010-2011,2010-12-01,2011-03-28,118,0,54,307,361,39,115,154,515,11,102,Kansas,Manhattan,52281
6985,2011-2012,2011-11-09,2012-02-29,113,2,12,186,198,8,5,13,211,5,19,Kansas,Manhattan,52281
6986,2012-2013,2012-12-01,2013-04-23,144,0,29,258,287,37,64,101,388,11,63,Kansas,Manhattan,52281
6987,2013-2014,2013-11-23,2014-04-14,143,0,100,378,478,58,181,239,717,17,155,Kansas,Manhattan,52281
6988,2014-2015,2014-11-12,2015-03-01,110,0,51,285,336,20,35,55,391,9,69,Kansas,Manhattan,52281
6989,2015-2016,2015-11-28,2016-03-24,118,0,23,169,192,13,19,32,224,7,32,Kansas,Manhattan,52281
6990,2016-2017,2016-12-01,2017-03-15,105,2,33,209,242,6,8,14,256,4,37,Kansas,Manhattan,52281
6991,2017-2018,2017-12-01,2018-04-07,128,1,64,298,362,10,19,29,391,7,50,Kansas,Manhattan,52281
6992,2018-2019,2018-11-09,2019-03-06,118,0,65,301,366,37,79,116,482,10,77,Kansas,Manhattan,52281
6993,2019-2020,2019-10-31,2020-04-17,170,3,23,256,279,16,12,28,307,7,36,Kansas,Manhattan,52281
6994,1951-1952,1951-11-02,1952-04-10,161,5,34,363,397,57,128,185,582,14,108,Kansas,Smith Center,1665
6995,1952-1953,1952-11-24,1953-03-05,102,2,39,265,304,57,162,219,523,14,115,Kansas,Smith Center,1665
6996,1954-1955,1954-12-01,1955-03-26,116,1,22,368,390,29,64,93,483,7,63,Kansas,Smith Center,1665
6997,1955-1956,1955-11-16,1956-03-12,118,1,59,388,447,29,104,133,580,8,77,Kansas,Smith Center,1665
6998,1956-1957,1956-12-01,1957-04-08,129,0,39,353,392,18,15,33,425,7,46,Kansas,Smith Center,1665
6999,1957-1958,1957-10-25,1958-03-28,155,0,37,399,436,69,183,252,688,15,114,Kansas,Smith Center,1665
7000,1958-1959,1958-11-18,1959-03-15,118,5,53,388,441,39,66,105,546,13,124,Kansas,Smith Center,1665
7001,1960-1961,1960-12-01,1961-04-10,131,0,22,330,352,27,33,60,412,14,77,Kansas,Smith Center,1665
7002,1962-1963,1962-11-18,1963-03-13,116,3,63,320,383,11,9,20,403,7,62,Kansas,Smith Center,1665
7003,1963-1964,1963-12-01,1964-03-25,116,0,47,311,358,10,16,26,384,5,36,Kansas,Smith Center,1665
7004,1964-1965,1964-11-21,1965-03-26,126,0,38,380,418,29,103,132,550,10,90,Kansas,Smith Center,1665
7005,1965-1966,1965-12-01,1966-04-20,141,0,44,294,338,14,40,54,392,8,54,Kansas,Smith Center,1665
7006,1966-1967,1966-12-01,1967-02-28,90,3,38,257,295,18,74,92,387,4,44,Kansas,Smith Center,1665
7007,1967-1968,1967-11-04,1968-02-29,118,1,32,303,335,18,63,81,416,10,85,Kansas,Smith Center,1665
7008,1968-1969,1968-12-01,1969-03-30,120,0,65,334,399,53,206,259,658,17,122,Kansas,Smith Center,1665
7009,1969-1970,1969-12-01,1970-04-13,134,0,41,329,370,35,83,118,488,18,116,Kansas,Smith Center,1665
7010,1970-1971,1970-11-23,1971-03-25,123,0,49,341,390,45,164,209,599,13,102,Kansas,Smith Center,1665
7011,1971-1972,1971-11-28,1972-04-03,128,0,29,285,314,17,17,34,348,12,73,Kansas,Smith Center,1665
7012,1972-1973,1972-11-13,1973-04-10,149,0,73,295,368,34,93,127,495,22,138,Kansas,Smith Center,1665
7013,1973-1974,1973-11-21,1974-04-04,135,0,64,293,357,34,153,187,544,18,131,Kansas,Smith Center,1665
7014,1974-1975,1974-11-29,1975-04-02,125,0,33,302,335,34,90,124,459,16,100,Kansas,Smith Center,1665
7015,1975-1976,1975-11-20,1976-03-16,118,0,36,289,325,37,76,113,438,13,88,Kansas,Smith Center,1665
7016,1976-1977,1976-11-27,1977-04-04,129,0,39,342,381,19,70,89,470,10,72,Kansas,Smith Center,1665
7017,1977-1978,1977-11-21,1978-03-08,108,0,93,411,504,24,126,150,654,12,107,Kansas,Smith Center,1665
7018,1978-1979,1978-11-16,1979-04-02,138,0,103,436,539,34,133,167,706,21,137,Kansas,Smith Center,1665
7019,1979-1980,1979-11-28,1980-04-03,128,0,50,298,348,45,142,187,535,16,119,Kansas,Smith Center,1665
7020,1980-1981,1980-10-28,1981-03-07,131,0,20,267,287,11,17,28,315,9,49,Kansas,Smith Center,1665
7021,1981-1982,1981-12-01,1982-03-06,96,0,67,333,400,23,72,95,495,14,130,Kansas,Smith Center,1665
7022,1982-1983,1982-11-23,1983-04-13,142,1,24,236,260,19,59,78,338,12,55,Kansas,Smith Center,1665
7023,1983-1984,1983-11-27,1984-03-22,117,0,101,363,464,41,270,311,775,15,131,Kansas,Smith Center,1665
7024,1984-1985,1984-11-10,1985-03-31,142,0,60,357,417,30,229,259,676,11,83,Kansas,Smith Center,1665
7025,1985-1986,1985-09-29,1986-02-28,153,2,56,304,360,15,24,39,399,8,62,Kansas,Smith Center,1665
7026,1986-1987,1986-11-12,1987-03-31,140,0,13,229,242,27,33,60,302,8,48,Kansas,Smith Center,1665
7027,1987-1988,1987-11-27,1988-03-17,112,1,59,295,354,32,101,133,487,12,87,Kansas,Smith Center,1665
7028,1988-1989,1988-11-16,1989-03-21,126,1,44,314,358,15,15,30,388,11,53,Kansas,Smith Center,1665
7029,1989-1990,1989-12-01,1990-04-13,134,0,50,280,330,15,55,70,400,9,76,Kansas,Smith Center,1665
7030,1990-1991,1990-12-01,1991-03-16,106,0,59,296,355,17,35,52,407,11,88,Kansas,Smith Center,1665
7031,1991-1992,1991-10-30,1992-03-19,142,0,20,182,202,22,50,72,274,9,52,Kansas,Smith Center,1665
7032,1992-1993,1992-11-06,1993-03-18,133,2,84,351,435,50,293,343,778,20,133,Kansas,Smith Center,1665
7033,1993-1994,1993-11-15,1994-04-30,167,0,53,333,386,28,66,94,480,12,92,Kansas,Smith Center,1665
7034,1994-1995,1994-12-01,1995-03-09,99,0,43,222,265,15,34,49,314,8,63,Kansas,Smith Center,1665
7035,1995-1996,1995-11-11,1996-04-15,157,1,60,378,438,23,26,49,487,11,81,Kansas,Smith Center,1665
7036,1996-1997,1996-11-14,1997-04-13,151,0,62,331,393,30,54,84,477,12,73,Kansas,Smith Center,1665
7037,1997-1998,1997-10-26,1998-03-16,142,0,31,235,266,37,94,131,397,13,68,Kansas,Smith Center,1665
7038,1998-1999,1998-11-10,1999-03-13,124,1,33,206,239,15,13,28,267,13,66,Kansas,Smith Center,1665
7039,1999-2000,1999-11-23,2000-03-03,102,1,11,176,187,11,27,38,225,5,25,Kansas,Smith Center,1665
7040,2000-2001,2000-11-07,2001-03-12,126,1,56,336,392,44,154,198,590,19,131,Kansas,Smith Center,1665
7041,2001-2002,2001-11-27,2002-03-26,120,0,26,278,304,23,58,81,385,10,69,Kansas,Smith Center,1665
7042,2002-2003,2002-10-24,2003-03-09,137,0,34,278,312,17,17,34,346,12,80,Kansas,Smith Center,1665
7043,2003-2004,2003-11-23,2004-04-12,142,0,55,291,346,32,146,178,524,13,98,Kansas,Smith Center,1665
7044,2004-2005,2004-11-28,2005-02-28,93,0,51,225,276,17,70,87,363,8,62,Kansas,Smith Center,1665
7045,2005-2006,2005-11-28,2006-03-24,117,0,47,279,326,22,47,69,395,9,54,Kansas,Smith Center,1665
7046,2006-2007,2006-11-30,2007-04-06,128,0,57,311,368,29,46,75,443,11,86,Kansas,Smith Center,1665
7047,2007-2008,2007-11-24,2008-03-08,106,8,57,343,400,40,119,159,559,16,102,Kansas,Smith Center,1665
7048,2008-2009,2008-12-01,2009-03-12,102,0,53,334,387,14,24,38,425,8,67,Kansas,Smith Center,1665
7049,2009-2010,2009-12-01,2010-03-20,110,0,77,325,402,30,149,179,581,14,97,Kansas,Smith Center,1665
7050,2010-2011,2010-11-21,2011-03-14,114,0,70,376,446,36,103,139,585,11,105,Kansas,Smith Center,1665
7051,2011-2012,2011-11-17,2012-02-29,105,1,19,266,285,14,38,52,337,8,38,Kansas,Smith Center,1665
7052,2012-2013,2012-12-01,2013-04-23,144,0,44,347,391,55,172,227,618,16,102,Kansas,Smith Center,1665
7053,2013-2014,2013-11-22,2014-04-14,144,0,88,448,536,43,81,124,660,16,127,Kansas,Smith Center,1665
7054,2014-2015,2014-11-11,2015-03-05,115,0,55,369,424,19,16,35,459,13,78,Kansas,Smith Center,1665
7055,2015-2016,2015-11-27,2016-03-24,119,0,26,227,253,25,64,89,342,11,45,Kansas,Smith Center,1665
7056,2016-2017,2016-12-01,2017-03-12,102,0,39,257,296,10,5,15,311,8,52,Kansas,Smith Center,1665
7057,2017-2018,2017-11-01,2018-04-15,166,0,71,414,485,23,33,56,541,14,98,Kansas,Smith Center,1665
7058,2018-2019,2018-10-15,2019-04-11,179,0,79,396,475,57,137,194,669,17,118,Kansas,Smith Center,1665
7059,2019-2020,2019-10-29,2020-03-14,138,0,22,299,321,18,10,28,349,12,54,Kansas,Smith Center,1665
7060,1950-1951,1950-11-03,1951-03-20,138,0,51,326,377,15,11,26,403,10,68,Kansas,Topeka,127473
7061,1951-1952,1951-11-02,1952-03-26,146,0,35,270,305,30,42,72,377,15,75,Kansas,Topeka,127473
7062,1952-1953,1952-11-24,1953-03-09,106,0,20,192,212,30,80,110,322,11,53,Kansas,Topeka,127473
7063,1953-1954,1953-11-06,1954-03-29,144,0,26,233,259,13,18,31,290,6,32,Kansas,Topeka,127473
7064,1954-1955,1954-12-01,1955-03-27,117,0,24,241,265,37,87,124,389,18,92,Kansas,Topeka,127473
7065,1955-1956,1955-11-15,1956-04-09,147,0,49,327,376,39,85,124,500,24,137,Kansas,Topeka,127473
7066,1956-1957,1956-11-20,1957-04-12,144,0,41,262,303,27,36,63,366,16,87,Kansas,Topeka,127473
7067,1957-1958,1957-12-01,1958-03-19,109,0,41,237,278,35,54,89,367,16,82,Kansas,Topeka,127473
7068,1958-1959,1958-11-26,1959-04-12,138,0,65,290,355,44,90,134,489,18,129,Kansas,Topeka,127473
7069,1959-1960,1959-11-05,1960-03-25,142,0,75,357,432,68,208,276,708,23,154,Kansas,Topeka,127473
7070,1960-1961,1960-12-01,1961-04-09,130,0,23,250,273,30,23,53,326,15,69,Kansas,Topeka,127473
7071,1961-1962,1961-11-18,1962-03-10,113,0,82,332,414,49,186,235,649,18,128,Kansas,Topeka,127473
7072,1962-1963,1962-12-01,1963-03-05,95,0,70,298,368,19,56,75,443,11,87,Kansas,Topeka,127473
7073,1963-1964,1963-12-01,1964-03-26,117,0,46,293,339,18,27,45,384,12,60,Kansas,Topeka,127473
7074,1964-1965,1964-11-18,1965-03-25,128,0,54,318,372,33,50,83,455,16,84,Kansas,Topeka,127473
7075,1965-1966,1965-12-01,1966-03-04,94,0,37,224,261,10,7,17,278,8,35,Kansas,Topeka,127473
7076,1966-1967,1966-12-01,1967-03-18,108,0,32,254,286,26,57,83,369,12,66,Kansas,Topeka,127473
7077,1967-1968,1967-12-01,1968-02-29,91,0,51,223,274,33,64,97,371,14,86,Kansas,Topeka,127473
7078,1968-1969,1968-12-01,1969-03-11,101,0,43,237,280,21,45,66,346,13,81,Kansas,Topeka,127473
7079,1969-1970,1969-11-13,1970-04-02,141,0,55,306,361,37,35,72,433,16,92,Kansas,Topeka,127473
7080,1970-1971,1970-10-09,1971-03-26,169,0,64,296,360,55,82,137,497,15,81,Kansas,Topeka,127473
7081,1971-1972,1971-11-22,1972-03-31,131,0,46,248,294,27,25,52,346,16,90,Kansas,Topeka,127473
7082,1972-1973,1972-11-13,1973-04-08,147,0,71,251,322,42,79,121,443,20,117,Kansas,Topeka,127473
7083,1973-1974,1973-12-01,1974-04-04,125,0,66,260,326,46,101,147,473,19,142,Kansas,Topeka,127473
7084,1974-1975,1974-11-29,1975-04-04,127,0,30,248,278,39,67,106,384,16,81,Kansas,Topeka,127473
7085,1975-1976,1975-11-20,1976-03-16,118,0,42,244,286,35,32,67,353,17,94,Kansas,Topeka,127473
7086,1976-1977,1976-11-26,1977-04-04,130,0,66,373,439,25,126,151,590,14,95,Kansas,Topeka,127473
7087,1977-1978,1977-11-26,1978-03-25,120,0,102,409,511,42,126,168,679,23,155,Kansas,Topeka,127473
7088,1978-1979,1978-11-19,1979-04-04,137,0,129,452,581,63,276,339,920,25,224,Kansas,Topeka,127473
7089,1979-1980,1979-11-28,1980-03-24,118,0,50,286,336,29,78,107,443,15,92,Kansas,Topeka,127473
7090,1980-1981,1980-12-01,1981-02-28,90,0,33,204,237,13,20,33,270,8,42,Kansas,Topeka,127473
7091,1981-1982,1981-12-01,1982-04-08,129,0,78,316,394,24,53,77,471,16,116,Kansas,Topeka,127473
7092,1982-1983,1982-11-23,1983-04-09,138,0,15,165,180,43,92,135,315,18,77,Kansas,Topeka,127473
7093,1983-1984,1983-11-09,1984-03-20,133,0,104,321,425,47,119,166,591,23,186,Kansas,Topeka,127473
7094,1984-1985,1984-12-01,1985-03-31,121,0,56,297,353,53,202,255,608,15,111,Kansas,Topeka,127473
7095,1985-1986,1985-11-20,1986-02-28,101,0,54,244,298,16,32,48,346,10,64,Kansas,Topeka,127473
7096,1986-1987,1986-11-10,1987-03-29,140,0,22,190,212,32,54,86,298,14,71,Kansas,Topeka,127473
7097,1987-1988,1987-11-27,1988-03-18,113,0,38,246,284,37,35,72,356,18,99,Kansas,Topeka,127473
7098,1988-1989,1988-11-19,1989-03-20,122,0,37,263,300,18,19,37,337,10,66,Kansas,Topeka,127473
7099,1989-1990,1989-11-16,1990-03-26,131,0,55,303,358,27,49,76,434,8,60,Kansas,Topeka,127473
7100,1990-1991,1990-12-01,1991-02-28,90,0,41,222,263,21,38,59,322,11,86,Kansas,Topeka,127473
7101,1991-1992,1991-11-01,1992-03-19,140,0,9,156,165,13,8,21,186,7,22,Kansas,Topeka,127473
7102,1992-1993,1992-11-05,1993-03-19,135,0,47,254,301,65,127,192,493,18,121,Kansas,Topeka,127473
7103,1993-1994,1993-11-24,1994-04-06,134,0,45,270,315,22,6,28,343,12,65,Kansas,Topeka,127473
7104,1994-1995,1994-12-01,1995-03-09,99,1,26,199,225,13,30,43,268,6,39,Kansas,Topeka,127473
7105,1995-1996,1995-11-02,1996-03-25,145,2,69,332,401,20,42,62,463,11,59,Kansas,Topeka,127473
7106,1996-1997,1996-10-22,1997-04-11,172,0,58,284,342,35,20,55,397,17,86,Kansas,Topeka,127473
7107,1997-1998,1997-12-01,1998-03-13,103,0,22,162,184,21,40,61,245,10,53,Kansas,Topeka,127473
7108,1998-1999,1998-12-01,1999-03-13,103,0,37,174,211,14,11,25,236,9,56,Kansas,Topeka,127473
7109,1999-2000,1999-12-01,2000-02-29,91,0,12,154,166,21,22,43,209,10,46,Kansas,Topeka,127473
7110,2000-2001,2000-11-08,2001-03-16,129,0,55,326,381,29,83,112,493,14,99,Kansas,Topeka,127473
7111,2001-2002,2001-11-28,2002-03-04,97,0,17,175,192,15,19,34,226,8,41,Kansas,Topeka,127473
7112,2002-2003,2002-12-01,2003-03-09,99,0,32,239,271,21,22,43,314,11,67,Kansas,Topeka,127473
7113,2003-2004,2003-12-01,2004-02-29,91,0,45,205,250,28,88,116,366,10,69,Kansas,Topeka,127473
7114,2004-2005,2004-11-23,2005-02-28,98,0,31,179,210,17,12,29,239,11,39,Kansas,Topeka,127473
7115,2005-2006,2005-11-28,2006-03-21,114,0,30,190,220,21,22,43,263,9,57,Kansas,Topeka,127473
7116,2006-2007,2006-11-29,2007-02-28,92,0,41,200,241,17,20,37,278,13,67,Kansas,Topeka,127473
7117,2007-2008,2007-11-22,2008-03-07,107,0,37,272,309,48,95,143,452,18,108,Kansas,Topeka,127473
7118,2008-2009,2008-11-29,2009-03-28,120,0,37,255,292,19,13,32,324,14,67,Kansas,Topeka,127473
7119,2009-2010,2009-12-01,2010-03-21,111,0,61,253,314,61,141,202,516,24,167,Kansas,Topeka,127473
7120,2010-2011,2010-12-01,2011-03-28,118,0,45,283,328,56,121,177,505,12,106,Kansas,Topeka,127473
7121,2011-2012,2011-12-01,2012-03-08,99,0,7,145,152,6,3,9,161,4,11,Kansas,Topeka,127473
7122,2012-2013,2012-12-01,2013-04-23,144,0,19,215,234,42,59,101,335,14,67,Kansas,Topeka,127473
7123,2013-2014,2013-11-22,2014-04-14,144,0,77,357,434,43,79,122,556,20,143,Kansas,Topeka,127473
7124,2014-2015,2014-11-12,2015-03-04,113,0,40,270,310,19,14,33,343,15,79,Kansas,Topeka,127473
7125,2015-2016,2015-11-27,2016-03-27,122,0,15,153,168,11,8,19,187,9,36,Kansas,Topeka,127473
7126,2016-2017,2016-12-01,2017-03-14,104,0,24,184,208,9,13,22,230,6,37,Kansas,Topeka,127473
7127,2017-2018,2017-10-31,2018-04-01,153,1,46,264,310,15,12,27,337,10,49,Kansas,Topeka,127473
7128,2018-2019,2018-10-14,2019-03-06,144,0,47,276,323,39,78,117,440,16,91,Kansas,Topeka,127473
7129,2019-2020,2019-10-30,2020-02-29,123,0,14,187,201,20,21,41,242,11,45,Kansas,Topeka,127473
7130,1951-1952,1951-10-31,1952-03-22,144,0,26,195,221,31,25,56,277,13,74,Kansas,Wichita,382368
7131,1952-1953,1952-11-25,1953-03-04,100,0,20,144,164,16,35,51,215,7,37,Kansas,Wichita,382368
7132,1953-1954,1953-11-06,1954-03-03,118,0,22,163,185,7,7,14,199,5,31,Kansas,Wichita,382368
7133,1954-1955,1954-12-01,1955-03-26,116,0,13,191,204,14,15,29,233,9,43,Kansas,Wichita,382368
7134,1955-1956,1955-11-15,1956-04-09,147,0,37,264,301,24,32,56,357,16,80,Kansas,Wichita,382368
7135,1956-1957,1956-12-01,1957-04-12,133,0,34,188,222,18,9,27,249,17,83,Kansas,Wichita,382368
7136,1957-1958,1957-10-26,1958-03-19,145,0,34,203,237,35,30,65,302,15,80,Kansas,Wichita,382368
7137,1958-1959,1958-11-26,1959-04-12,138,0,48,236,284,30,61,91,375,13,101,Kansas,Wichita,382368
7138,1959-1960,1959-11-05,1960-03-18,135,0,61,265,326,44,125,169,495,17,106,Kansas,Wichita,382368
7139,1960-1961,1960-10-30,1961-03-20,142,0,19,199,218,33,28,61,279,13,65,Kansas,Wichita,382368
7140,1961-1962,1961-11-18,1962-02-28,103,0,54,223,277,35,93,128,405,9,70,Kansas,Wichita,382368
7141,1962-1963,1962-12-01,1963-02-28,90,0,49,235,284,12,24,36,320,6,55,Kansas,Wichita,382368
7142,1963-1964,1963-12-01,1964-03-25,116,0,34,235,269,9,13,22,291,5,48,Kansas,Wichita,382368
7143,1964-1965,1964-11-19,1965-03-24,126,0,27,253,280,18,21,39,319,7,37,Kansas,Wichita,382368
7144,1965-1966,1965-12-01,1966-02-28,90,0,30,174,204,12,19,31,235,11,48,Kansas,Wichita,382368
7145,1966-1967,1966-12-01,1967-03-18,108,0,28,218,246,15,39,54,300,10,55,Kansas,Wichita,382368
7146,1967-1968,1967-11-02,1968-02-29,120,0,28,190,218,23,24,47,265,13,65,Kansas,Wichita,382368
7147,1968-1969,1968-11-30,1969-03-13,104,0,28,219,247,25,48,73,320,10,53,Kansas,Wichita,382368
7148,1969-1970,1969-12-01,1970-04-04,125,0,32,225,257,31,36,67,324,11,68,Kansas,Wichita,382368
7149,1970-1971,1970-11-23,1971-03-02,100,0,34,232,266,21,46,67,333,4,33,Kansas,Wichita,382368
7150,1971-1972,1971-11-22,1972-03-29,129,0,32,231,263,19,13,32,295,13,82,Kansas,Wichita,382368
7151,1972-1973,1972-11-15,1973-04-08,145,0,60,235,295,44,67,111,406,17,100,Kansas,Wichita,382368
7152,1973-1974,1973-12-01,1974-04-03,124,0,52,231,283,24,70,94,377,14,104,Kansas,Wichita,382368
7153,1974-1975,1974-11-04,1975-04-02,150,0,21,217,238,48,79,127,365,15,77,Kansas,Wichita,382368
7154,1975-1976,1975-11-24,1976-02-29,98,1,25,190,215,12,11,23,238,6,42,Kansas,Wichita,382368
7155,1976-1977,1976-11-27,1977-02-28,94,0,34,255,289,10,10,20,309,9,57,Kansas,Wichita,382368
7156,1977-1978,1977-12-01,1978-03-24,114,0,79,304,383,29,104,133,516,19,124,Kansas,Wichita,382368
7157,1978-1979,1978-11-20,1979-04-04,136,0,104,346,450,40,171,211,661,21,159,Kansas,Wichita,382368
7158,1979-1980,1979-12-01,1980-03-24,115,0,44,216,260,19,55,74,334,5,32,Kansas,Wichita,382368
7159,1980-1981,1980-12-01,1981-03-08,98,0,13,173,186,6,6,12,198,5,20,Kansas,Wichita,382368
7160,1981-1982,1981-12-01,1982-03-05,95,0,62,256,318,18,61,79,397,7,73,Kansas,Wichita,382368
7161,1982-1983,1982-11-27,1983-04-04,129,0,23,160,183,35,89,124,307,15,72,Kansas,Wichita,382368
7162,1983-1984,1983-11-23,1984-03-31,130,0,97,313,410,41,65,106,516,17,165,Kansas,Wichita,382368
7163,1984-1985,1984-11-18,1985-03-31,134,0,37,227,264,31,40,71,335,13,75,Kansas,Wichita,382368
7164,1985-1986,1985-11-24,1986-02-28,97,0,36,192,228,17,26,43,271,9,55,Kansas,Wichita,382368
7165,1986-1987,1986-11-12,1987-03-29,138,0,18,177,195,36,69,105,300,12,65,Kansas,Wichita,382368
7166,1987-1988,1987-11-27,1988-03-18,113,0,39,238,277,53,116,169,446,15,104,Kansas,Wichita,382368
7167,1988-1989,1988-11-19,1989-03-05,107,0,28,195,223,7,3,10,233,4,22,Kansas,Wichita,382368
7168,1989-1990,1989-12-01,1990-04-05,126,0,42,211,253,21,20,41,294,12,68,Kansas,Wichita,382368
7169,1990-1991,1990-12-01,1991-02-28,90,0,33,192,225,14,14,28,253,11,86,Kansas,Wichita,382368
7170,1991-1992,1991-10-31,1992-02-29,122,0,6,103,109,3,10,13,122,2,5,Kansas,Wichita,382368
7171,1992-1993,1992-11-25,1993-03-12,108,0,35,190,225,30,99,129,354,9,50,Kansas,Wichita,382368
7172,1993-1994,1993-11-24,1994-02-28,97,0,20,199,219,4,2,6,225,3,21,Kansas,Wichita,382368
7173,1994-1995,1994-12-01,1995-03-08,98,0,24,151,175,16,25,41,216,10,65,Kansas,Wichita,382368
7174,1995-1996,1995-11-02,1996-03-25,145,0,49,294,343,20,19,39,382,15,87,Kansas,Wichita,382368
7175,1996-1997,1996-10-22,1997-04-09,170,0,35,223,258,28,15,43,301,14,66,Kansas,Wichita,382368
7176,1997-1998,1997-10-26,1998-03-21,147,0,16,163,179,33,18,51,230,15,58,Kansas,Wichita,382368
7177,1998-1999,1998-12-01,1999-03-14,104,0,26,146,172,13,13,26,198,5,28,Kansas,Wichita,382368
7178,1999-2000,1999-12-01,2000-03-16,107,0,10,138,148,31,46,77,225,8,51,Kansas,Wichita,382368
7179,2000-2001,2000-12-01,2001-02-28,90,0,45,226,271,16,25,41,312,12,69,Kansas,Wichita,382368
7180,2001-2002,2001-11-28,2002-03-03,96,0,13,176,189,10,10,20,209,7,32,Kansas,Wichita,382368
7181,2002-2003,2002-12-01,2003-03-05,95,0,29,181,210,36,58,94,304,10,65,Kansas,Wichita,382368
7182,2003-2004,2003-12-01,2004-02-29,91,0,23,162,185,22,50,72,257,8,47,Kansas,Wichita,382368
7183,2004-2005,2004-11-24,2005-03-09,106,0,19,155,174,11,6,17,191,8,25,Kansas,Wichita,382368
7184,2005-2006,2005-12-01,2006-03-23,113,0,21,163,184,16,19,35,219,7,36,Kansas,Wichita,382368
7185,2006-2007,2006-11-30,2007-04-14,136,0,27,194,221,26,45,71,292,10,57,Kansas,Wichita,382368
7186,2007-2008,2007-11-23,2008-03-07,106,0,20,222,242,35,56,91,333,15,82,Kansas,Wichita,382368
7187,2008-2009,2008-12-01,2009-04-09,130,0,26,209,235,21,13,34,269,10,64,Kansas,Wichita,382368
7188,2009-2010,2009-12-01,2010-03-21,111,0,39,209,248,25,39,64,312,16,82,Kansas,Wichita,382368
7189,2010-2011,2010-12-01,2011-02-28,90,0,34,229,263,24,49,73,336,6,64,Kansas,Wichita,382368
7190,2011-2012,2011-11-08,2012-03-08,122,0,5,148,153,8,2,10,163,7,21,Kansas,Wichita,382368
7191,2012-2013,2012-12-01,2013-04-23,144,0,11,193,204,44,68,112,316,12,66,Kansas,Wichita,382368
7192,2013-2014,2013-11-22,2014-04-14,144,0,58,303,361,36,72,108,469,14,108,Kansas,Wichita,382368
7193,2014-2015,2014-11-12,2015-03-04,113,0,27,220,247,27,35,62,309,15,81,Kansas,Wichita,382368
7194,2015-2016,2015-11-27,2016-03-27,122,0,12,130,142,8,4,12,154,5,19,Kansas,Wichita,382368
7195,2016-2017,2016-12-01,2017-02-28,90,0,15,146,161,3,6,9,170,1,9,Kansas,Wichita,382368
7196,2017-2018,2017-12-01,2018-04-07,128,0,24,207,231,4,1,5,236,4,18,Kansas,Wichita,382368
7197,2018-2019,2018-10-14,2019-03-05,143,0,26,214,240,16,15,31,271,9,38,Kansas,Wichita,382368
7198,2019-2020,2019-10-30,2020-02-29,123,0,8,158,166,15,8,23,189,10,35,Kansas,Wichita,382368
7199,1950-1951,1950-11-23,1951-04-02,131,0,34,208,242,32,49,81,323,14,83,Kentucky,Bowling Green,58067
7200,1951-1952,1951-11-02,1952-02-29,120,0,5,124,129,3,0,3,132,3,6,Kentucky,Bowling Green,58067
7201,1952-1953,1952-11-29,1953-02-28,92,0,4,68,72,3,2,5,77,2,6,Kentucky,Bowling Green,58067
7202,1953-1954,1953-12-01,1954-02-28,90,1,11,123,134,6,10,16,150,2,8,Kentucky,Bowling Green,58067
7203,1954-1955,1954-11-02,1955-03-26,145,0,13,143,156,8,7,15,171,4,22,Kentucky,Bowling Green,58067
7204,1955-1956,1955-11-28,1956-02-29,94,0,6,120,126,1,0,1,127,1,2,Kentucky,Bowling Green,58067
7205,1956-1957,1956-11-27,1957-03-08,102,0,8,89,97,1,0,1,98,1,2,Kentucky,Bowling Green,58067
7206,1957-1958,1957-12-01,1958-03-18,108,2,24,192,216,10,16,26,242,5,22,Kentucky,Bowling Green,58067
7207,1958-1959,1958-12-01,1959-02-28,90,0,20,181,201,1,0,1,202,1,3,Kentucky,Bowling Green,58067
7208,1959-1960,1959-11-28,1960-03-19,113,0,17,175,192,70,84,154,346,12,95,Kentucky,Bowling Green,58067
7209,1960-1961,1960-12-01,1961-02-28,90,2,17,165,182,22,17,39,221,11,67,Kentucky,Bowling Green,58067
7210,1961-1962,1961-12-01,1962-03-06,96,4,17,126,143,14,10,24,167,7,31,Kentucky,Bowling Green,58067
7211,1962-1963,1962-12-01,1963-02-28,90,0,35,245,280,23,41,64,344,7,58,Kentucky,Bowling Green,58067
7212,1963-1964,1963-12-01,1964-02-29,91,0,21,197,218,38,57,95,313,10,74,Kentucky,Bowling Green,58067
7213,1964-1965,1964-11-21,1965-03-20,120,3,17,192,209,25,38,63,272,10,65,Kentucky,Bowling Green,58067
7214,1965-1966,1965-12-01,1966-02-28,90,0,22,141,163,12,26,38,201,3,25,Kentucky,Bowling Green,58067
7215,1966-1967,1966-11-02,1967-03-07,126,0,11,164,175,34,31,65,240,8,47,Kentucky,Bowling Green,58067
7216,1967-1968,1967-12-01,1968-03-25,116,0,22,211,233,44,61,105,338,10,64,Kentucky,Bowling Green,58067
7217,1968-1969,1968-11-19,1969-03-26,128,0,12,157,169,18,15,33,202,7,25,Kentucky,Bowling Green,58067
7218,1969-1970,1969-12-01,1970-03-13,103,0,27,195,222,29,44,73,295,15,66,Kentucky,Bowling Green,58067
7219,1970-1971,1970-11-23,1971-03-03,101,0,23,159,182,22,25,47,229,8,43,Kentucky,Bowling Green,58067
7220,1971-1972,1971-12-01,1972-03-03,94,0,12,119,131,5,3,8,139,2,7,Kentucky,Bowling Green,58067
7221,1972-1973,1972-11-30,1973-02-28,91,0,13,121,134,6,6,12,146,4,16,Kentucky,Bowling Green,58067
7222,1973-1974,1973-12-01,1974-02-28,90,0,11,97,108,2,1,3,111,1,5,Kentucky,Bowling Green,58067
7223,1974-1975,1974-12-01,1975-03-10,100,0,5,112,117,11,5,16,133,6,23,Kentucky,Bowling Green,58067
7224,1975-1976,1975-12-01,1976-02-29,91,0,11,132,143,5,3,8,151,2,13,Kentucky,Bowling Green,58067
7225,1976-1977,1976-11-28,1977-02-28,93,0,47,260,307,30,78,108,415,10,71,Kentucky,Bowling Green,58067
7226,1977-1978,1977-11-26,1978-03-04,99,0,52,268,320,59,179,238,558,16,116,Kentucky,Bowling Green,58067
7227,1978-1979,1978-12-01,1979-02-28,90,0,32,202,234,40,59,99,333,10,81,Kentucky,Bowling Green,58067
7228,1979-1980,1979-11-29,1980-03-04,97,0,20,145,165,19,26,45,210,5,37,Kentucky,Bowling Green,58067
7229,1980-1981,1980-12-01,1981-02-28,90,0,24,165,189,13,17,30,219,3,20,Kentucky,Bowling Green,58067
7230,1981-1982,1981-12-01,1982-02-28,90,0,28,167,195,10,26,36,231,4,26,Kentucky,Bowling Green,58067
7231,1982-1983,1982-12-01,1983-04-18,139,0,8,103,111,9,2,11,122,5,17,Kentucky,Bowling Green,58067
7232,1983-1984,1983-12-01,1984-02-29,91,0,50,191,241,21,33,54,295,7,50,Kentucky,Bowling Green,58067
7233,1984-1985,1984-12-01,1985-02-28,90,0,33,176,209,28,62,90,299,11,71,Kentucky,Bowling Green,58067
7234,1985-1986,1985-12-01,1986-02-28,90,0,25,167,192,20,30,50,242,5,43,Kentucky,Bowling Green,58067
7235,1986-1987,1986-12-01,1987-03-31,121,0,9,103,112,20,9,29,141,8,37,Kentucky,Bowling Green,58067
7236,1987-1988,1987-12-01,1988-03-14,105,0,25,161,186,11,19,30,216,4,29,Kentucky,Bowling Green,58067
7237,1988-1989,1988-12-01,1989-03-07,97,0,11,110,121,7,2,9,130,5,17,Kentucky,Bowling Green,58067
7238,1989-1990,1989-12-01,1990-03-19,109,0,30,138,168,14,21,35,203,6,32,Kentucky,Bowling Green,58067
7239,1990-1991,1990-12-01,1991-03-29,119,0,11,119,130,9,2,11,141,6,34,Kentucky,Bowling Green,58067
7240,1991-1992,1991-12-01,1992-03-14,105,0,4,94,98,2,0,2,100,2,7,Kentucky,Bowling Green,58067
7241,1992-1993,1992-12-01,1993-03-14,104,0,9,119,128,17,8,25,153,7,34,Kentucky,Bowling Green,58067
7242,1993-1994,1993-10-31,1994-03-09,130,1,26,181,207,20,27,47,254,8,40,Kentucky,Bowling Green,58067
7243,1994-1995,1994-12-01,1995-03-08,98,1,10,116,126,5,2,7,133,4,12,Kentucky,Bowling Green,58067
7244,1996-1997,1996-12-01,1997-02-28,90,0,19,119,138,7,5,12,150,5,17,Kentucky,Bowling Green,58067
7245,1997-1998,1997-12-01,1998-03-11,101,11,6,75,81,14,2,16,97,8,24,Kentucky,Bowling Green,58067
7246,1999-2000,1999-12-01,2000-02-29,91,6,7,105,112,2,0,2,114,1,5,Kentucky,Bowling Green,58067
7247,2000-2001,2000-12-01,2001-02-28,90,6,21,165,186,9,4,13,199,8,30,Kentucky,Bowling Green,58067
7248,2001-2002,2001-12-01,2002-03-04,94,0,7,129,136,8,4,12,148,4,12,Kentucky,Bowling Green,58067
7249,2002-2003,2002-12-01,2003-02-28,90,2,18,128,146,19,17,36,182,13,47,Kentucky,Bowling Green,58067
7250,2003-2004,2003-12-01,2004-02-29,91,1,11,133,144,6,4,10,154,4,11,Kentucky,Bowling Green,58067
7251,2004-2005,2004-12-01,2005-03-11,101,4,10,105,115,3,1,4,119,2,8,Kentucky,Bowling Green,58067
7252,2005-2006,2005-12-01,2006-02-28,90,1,5,95,100,13,12,25,125,9,31,Kentucky,Bowling Green,58067
7253,2006-2007,2006-12-01,2007-02-28,90,2,11,125,136,6,4,10,146,3,16,Kentucky,Bowling Green,58067
7254,2007-2008,2007-12-01,2008-03-09,100,10,11,116,127,8,4,12,139,3,17,Kentucky,Bowling Green,58067
7255,2008-2009,2008-12-01,2009-03-13,103,6,13,135,148,6,3,9,157,3,10,Kentucky,Bowling Green,58067
7256,2009-2010,2009-12-01,2010-02-28,90,0,20,147,167,23,27,50,217,13,65,Kentucky,Bowling Green,58067
7257,2010-2011,2010-12-01,2011-02-28,90,1,24,146,170,32,40,72,242,15,71,Kentucky,Bowling Green,58067
7258,2011-2012,2011-12-01,2012-02-29,91,0,1,70,71,3,2,5,76,2,7,Kentucky,Bowling Green,58067
7259,2012-2013,2012-12-01,2013-03-26,116,0,2,96,98,9,1,10,108,8,16,Kentucky,Bowling Green,58067
7260,2013-2014,2013-11-25,2014-03-25,121,0,27,213,240,22,14,36,276,16,58,Kentucky,Bowling Green,58067
7261,2014-2015,2014-11-17,2015-03-07,111,1,22,174,196,34,63,97,293,10,72,Kentucky,Bowling Green,58067
7262,2015-2016,2015-12-01,2016-02-29,91,3,12,98,110,36,39,75,185,9,58,Kentucky,Bowling Green,58067
7263,2016-2017,2016-12-01,2017-02-28,90,2,8,71,79,1,1,2,81,1,4,Kentucky,Bowling Green,58067
7264,2017-2018,2017-12-01,2018-04-07,128,0,24,148,172,16,31,47,219,8,45,Kentucky,Bowling Green,58067
7265,2018-2019,2018-11-15,2019-03-04,110,11,8,86,94,11,5,16,110,8,28,Kentucky,Bowling Green,58067
7266,1950-1951,1950-11-24,1951-03-26,123,4,25,199,224,49,88,137,361,19,120,Kentucky,Cave Run Lake,0
7267,1951-1952,1951-11-03,1952-02-29,119,2,5,145,150,10,8,18,168,6,20,Kentucky,Cave Run Lake,0
7268,1952-1953,1952-11-30,1953-03-02,93,0,2,102,104,12,11,23,127,6,22,Kentucky,Cave Run Lake,0
7269,1953-1954,1953-12-01,1954-03-04,94,3,7,155,162,27,40,67,229,7,41,Kentucky,Cave Run Lake,0
7270,1954-1955,1954-11-02,1955-02-28,119,0,11,180,191,35,51,86,277,15,73,Kentucky,Cave Run Lake,0
7271,1955-1956,1955-11-19,1956-02-29,103,0,5,182,187,15,24,39,226,9,30,Kentucky,Cave Run Lake,0
7272,1956-1957,1956-11-23,1957-03-09,107,0,8,133,141,16,23,39,180,8,39,Kentucky,Cave Run Lake,0
7273,1957-1958,1957-12-01,1958-03-18,108,2,26,216,242,29,66,95,337,18,86,Kentucky,Cave Run Lake,0
7274,1958-1959,1958-11-29,1959-02-28,92,0,17,223,240,9,16,25,265,4,23,Kentucky,Cave Run Lake,0
7275,1959-1960,1959-11-28,1960-03-21,115,0,18,229,247,67,126,193,440,16,112,Kentucky,Cave Run Lake,0
7276,1960-1961,1960-12-01,1961-04-01,122,3,23,240,263,27,72,99,362,12,65,Kentucky,Cave Run Lake,0
7277,1961-1962,1961-11-19,1962-03-07,109,3,12,180,192,20,21,41,233,11,54,Kentucky,Cave Run Lake,0
7278,1962-1963,1962-12-01,1963-02-28,90,0,26,305,331,34,71,105,436,13,86,Kentucky,Cave Run Lake,0
7279,1963-1964,1963-11-29,1964-02-29,93,0,16,270,286,48,86,134,420,16,97,Kentucky,Cave Run Lake,0
7280,1964-1965,1964-11-30,1965-03-21,112,0,19,201,220,32,43,75,295,11,86,Kentucky,Cave Run Lake,0
7281,1965-1966,1965-12-01,1966-03-07,97,1,25,185,210,33,88,121,331,9,76,Kentucky,Cave Run Lake,0
7282,1966-1967,1966-11-02,1967-03-07,126,1,9,192,201,37,34,71,272,13,64,Kentucky,Cave Run Lake,0
7283,1967-1968,1967-12-01,1968-03-23,114,2,19,244,263,38,82,120,383,14,75,Kentucky,Cave Run Lake,0
7284,1968-1969,1968-12-01,1969-03-11,101,4,12,184,196,12,8,20,216,8,33,Kentucky,Cave Run Lake,0
7285,1969-1970,1969-11-14,1970-03-29,136,5,29,252,281,41,68,109,390,12,76,Kentucky,Cave Run Lake,0
7286,1970-1971,1970-11-24,1971-03-26,123,2,29,200,229,34,42,76,305,9,70,Kentucky,Cave Run Lake,0
7287,1971-1972,1971-12-01,1972-03-03,94,0,8,123,131,9,7,16,147,4,19,Kentucky,Cave Run Lake,0
7288,1972-1973,1972-12-01,1973-02-28,90,0,12,129,141,3,3,6,147,3,12,Kentucky,Cave Run Lake,0
7289,1974-1975,1974-12-01,1975-03-04,94,18,3,101,104,12,15,27,131,6,20,Kentucky,Cave Run Lake,0
7290,1975-1976,1975-12-01,1976-02-29,91,9,22,168,190,10,21,31,221,5,28,Kentucky,Cave Run Lake,0
7291,1989-1990,1989-12-01,1990-02-28,90,6,31,224,255,6,50,56,311,3,20,Kentucky,Cave Run Lake,0
7292,1990-1991,1990-12-01,1991-02-28,90,1,13,135,148,2,2,4,152,2,12,Kentucky,Cave Run Lake,0
7293,1991-1992,1991-11-26,1992-03-12,108,3,9,153,162,2,3,5,167,2,7,Kentucky,Cave Run Lake,0
7294,1995-1996,1995-12-01,1996-03-22,113,15,49,226,275,25,73,98,373,15,65,Kentucky,Cave Run Lake,0
7295,1996-1997,1996-12-01,1997-02-28,90,6,21,124,145,0,7,7,152,0,0,Kentucky,Cave Run Lake,0
7296,1997-1998,1997-11-16,1998-03-12,117,14,7,87,94,24,34,58,152,14,46,Kentucky,Cave Run Lake,0
7297,1998-1999,1998-12-01,1999-03-04,94,7,14,121,135,11,9,20,155,9,36,Kentucky,Cave Run Lake,0
7298,1999-2000,1999-12-01,2000-02-29,91,12,14,127,141,12,22,34,175,6,24,Kentucky,Cave Run Lake,0
7299,2000-2001,2000-11-22,2001-02-28,99,5,27,193,220,16,31,47,267,9,46,Kentucky,Cave Run Lake,0
7300,2001-2002,2001-12-01,2002-03-05,95,19,8,129,137,15,18,33,170,13,50,Kentucky,Cave Run Lake,0
7301,2002-2003,2002-11-28,2003-03-03,96,17,25,155,180,24,34,58,238,14,69,Kentucky,Cave Run Lake,0
7302,2003-2004,2003-11-29,2004-02-29,93,11,17,146,163,15,22,37,200,8,31,Kentucky,Cave Run Lake,0
7303,2004-2005,2004-12-01,2005-03-14,104,2,15,141,156,10,6,16,172,7,30,Kentucky,Cave Run Lake,0
7304,2005-2006,2005-12-01,2006-02-28,90,6,7,107,114,7,4,11,125,5,19,Kentucky,Cave Run Lake,0
7305,2006-2007,2006-12-01,2007-02-28,90,4,25,149,174,23,0,23,197,15,104,Kentucky,Cave Run Lake,0
7306,2007-2008,2007-12-01,2008-03-09,100,12,14,137,151,7,7,14,165,5,21,Kentucky,Cave Run Lake,0
7307,2008-2009,2008-11-21,2009-03-13,113,2,21,202,223,29,22,51,274,13,62,Kentucky,Cave Run Lake,0
7308,2009-2010,2009-12-01,2010-02-28,90,0,27,166,193,44,54,98,291,20,107,Kentucky,Cave Run Lake,0
7309,2010-2011,2010-12-01,2011-03-27,117,1,36,222,258,49,99,148,406,24,136,Kentucky,Cave Run Lake,0
7310,2011-2012,2011-12-01,2012-03-06,97,4,5,137,142,15,9,24,166,5,30,Kentucky,Cave Run Lake,0
7311,2012-2013,2012-10-30,2013-03-07,129,11,9,213,222,15,11,26,248,12,47,Kentucky,Cave Run Lake,0
7312,2013-2014,2013-11-12,2014-03-25,134,0,37,278,315,43,53,96,411,23,113,Kentucky,Cave Run Lake,0
7313,2014-2015,2014-11-14,2015-03-08,115,1,42,248,290,46,82,128,418,14,127,Kentucky,Cave Run Lake,0
7314,2015-2016,2015-12-01,2016-03-04,95,1,19,141,160,39,38,77,237,9,76,Kentucky,Cave Run Lake,0
7315,2016-2017,2016-12-01,2017-03-16,106,2,17,118,135,6,10,16,151,2,12,Kentucky,Cave Run Lake,0
7316,2017-2018,2017-12-01,2018-04-09,130,0,45,220,265,20,20,40,305,11,51,Kentucky,Cave Run Lake,0
7317,2018-2019,2018-11-16,2019-03-08,113,7,24,143,167,14,8,22,189,10,35,Kentucky,Cave Run Lake,0
7318,2019-2020,2019-11-12,2020-02-29,110,0,8,109,117,10,9,19,136,5,18,Kentucky,Cave Run Lake,0
7319,1981-1982,1981-11-21,1982-04-08,139,3,31,180,211,35,43,78,289,15,84,Kentucky,Jackson,65211
7320,1982-1983,1982-12-01,1983-04-18,139,0,11,104,115,25,19,44,159,16,55,Kentucky,Jackson,65211
7321,1983-1984,1983-12-01,1984-03-21,112,0,43,183,226,27,34,61,287,16,86,Kentucky,Jackson,65211
7322,1984-1985,1984-12-01,1985-02-28,90,0,43,170,213,55,154,209,422,23,148,Kentucky,Jackson,65211
7323,1985-1986,1985-12-01,1986-03-07,97,0,25,167,192,37,49,86,278,19,102,Kentucky,Jackson,65211
7324,1986-1987,1986-11-15,1987-04-07,144,0,16,121,137,51,50,101,238,20,95,Kentucky,Jackson,65211
7325,1987-1988,1987-12-01,1988-03-18,109,0,27,156,183,24,19,43,226,17,84,Kentucky,Jackson,65211
7326,1988-1989,1988-11-28,1989-05-07,161,0,11,117,128,20,5,25,153,14,42,Kentucky,Jackson,65211
7327,1989-1990,1989-10-20,1990-03-20,152,0,31,152,183,32,43,75,258,21,97,Kentucky,Jackson,65211
7328,1990-1991,1990-12-01,1991-03-30,120,0,10,97,107,18,10,28,135,13,56,Kentucky,Jackson,65211
7329,1991-1992,1991-12-01,1992-04-04,126,0,6,107,113,16,1,17,130,14,44,Kentucky,Jackson,65211
7330,1992-1993,1992-11-06,1993-04-02,148,0,12,141,153,57,40,97,250,22,94,Kentucky,Jackson,65211
7331,1993-1994,1993-10-31,1994-03-31,152,0,37,186,223,72,104,176,399,27,161,Kentucky,Jackson,65211
7332,1994-1995,1994-12-01,1995-03-10,100,3,18,128,146,33,37,70,216,20,89,Kentucky,Jackson,65211
7333,1995-1996,1995-11-11,1996-04-01,143,4,52,215,267,97,136,233,500,41,222,Kentucky,Jackson,65211
7334,1996-1997,1996-11-09,1997-02-28,112,1,22,128,150,17,7,24,174,12,50,Kentucky,Jackson,65211
7335,1997-1998,1997-11-12,1998-03-21,130,1,13,89,102,51,71,122,224,25,96,Kentucky,Jackson,65211
7336,1998-1999,1998-12-01,1999-03-13,103,2,14,109,123,29,21,50,173,18,71,Kentucky,Jackson,65211
7337,1999-2000,1999-12-01,2000-03-12,103,0,21,107,128,25,55,80,208,18,80,Kentucky,Jackson,65211
7338,2000-2001,2000-11-18,2001-04-17,151,0,30,184,214,37,38,75,289,27,121,Kentucky,Jackson,65211
7339,2001-2002,2001-12-01,2002-03-22,112,0,12,105,117,31,30,61,178,14,64,Kentucky,Jackson,65211
7340,2002-2003,2002-11-22,2003-03-03,102,0,32,148,180,41,42,83,263,26,112,Kentucky,Jackson,65211
7341,2003-2004,2003-11-28,2004-02-29,94,0,14,126,140,30,21,51,191,21,75,Kentucky,Jackson,65211
7342,2004-2005,2004-11-25,2005-04-24,151,0,12,116,128,26,11,37,165,20,73,Kentucky,Jackson,65211
7343,2005-2006,2005-12-01,2006-03-25,115,0,6,90,96,25,14,39,135,17,54,Kentucky,Jackson,65211
7344,2006-2007,2006-12-01,2007-04-07,128,0,21,144,165,21,11,32,197,16,74,Kentucky,Jackson,65211
7345,2007-2008,2007-12-01,2008-03-24,115,0,14,121,135,22,10,32,167,16,61,Kentucky,Jackson,65211
7346,2008-2009,2008-11-16,2009-04-07,143,0,31,176,207,54,44,98,305,32,136,Kentucky,Jackson,65211
7347,2009-2010,2009-12-01,2010-03-03,93,0,41,155,196,78,86,164,360,32,182,Kentucky,Jackson,65211
7348,2010-2011,2010-12-01,2011-03-28,118,0,41,162,203,65,75,140,343,37,175,Kentucky,Jackson,65211
7349,2011-2012,2011-12-01,2012-03-06,97,0,5,72,77,24,16,40,117,14,53,Kentucky,Jackson,65211
7350,2012-2013,2012-10-30,2013-03-26,148,0,14,133,147,35,16,51,198,22,76,Kentucky,Jackson,65211
7351,2013-2014,2013-10-24,2014-04-15,174,0,32,228,260,65,45,110,370,37,156,Kentucky,Jackson,65211
7352,2014-2015,2014-11-01,2015-03-07,127,0,26,195,221,46,76,122,343,21,123,Kentucky,Jackson,65211
7353,2015-2016,2015-12-01,2016-04-09,131,0,19,111,130,49,54,103,233,18,103,Kentucky,Jackson,65211
7354,2016-2017,2016-12-01,2017-03-15,105,0,13,87,100,12,4,16,116,9,40,Kentucky,Jackson,65211
7355,2017-2018,2017-12-01,2018-04-16,137,0,33,164,197,43,23,66,263,25,93,Kentucky,Jackson,65211
7356,2018-2019,2018-11-15,2019-03-08,114,0,15,111,126,20,7,27,153,16,57,Kentucky,Jackson,65211
7357,2019-2020,2019-11-12,2020-04-14,155,0,5,66,71,18,6,24,95,14,37,Kentucky,Jackson,65211
7358,1950-1951,1950-11-23,1951-04-02,131,0,48,237,285,64,103,167,452,31,178,Kentucky,Lexington,295803
7359,1951-1952,1951-11-02,1952-03-02,122,0,17,151,168,18,6,24,192,13,50,Kentucky,Lexington,295803
7360,1952-1953,1952-11-22,1953-04-20,150,0,10,104,114,19,10,29,143,13,47,Kentucky,Lexington,295803
7361,1953-1954,1953-11-25,1954-03-01,97,0,18,127,145,16,29,45,190,7,29,Kentucky,Lexington,295803
7362,1954-1955,1954-10-31,1955-03-27,148,0,22,171,193,31,39,70,263,18,84,Kentucky,Lexington,295803
7363,1955-1956,1955-11-18,1956-04-07,142,0,15,178,193,20,15,35,228,16,52,Kentucky,Lexington,295803
7364,1956-1957,1956-11-22,1957-03-09,108,0,18,134,152,13,6,19,171,9,41,Kentucky,Lexington,295803
7365,1957-1958,1957-11-30,1958-03-20,111,0,45,203,248,27,28,55,303,23,98,Kentucky,Lexington,295803
7366,1958-1959,1958-11-28,1959-04-13,137,0,32,236,268,14,18,32,300,10,35,Kentucky,Lexington,295803
7367,1959-1960,1959-11-27,1960-03-22,117,0,34,201,235,58,143,201,436,21,112,Kentucky,Lexington,295803
7368,1960-1961,1960-12-01,1961-04-01,122,0,42,193,235,28,59,87,322,17,99,Kentucky,Lexington,295803
7369,1961-1962,1961-11-19,1962-04-01,134,0,34,186,220,28,20,48,268,19,76,Kentucky,Lexington,295803
7370,1962-1963,1962-12-01,1963-02-28,90,0,55,250,305,33,46,79,384,22,119,Kentucky,Lexington,295803
7371,1963-1964,1963-11-29,1964-03-29,122,1,36,225,261,52,73,125,386,20,105,Kentucky,Lexington,295803
7372,1964-1965,1964-11-21,1965-03-20,120,0,38,221,259,26,38,64,323,16,93,Kentucky,Lexington,295803
7373,1965-1966,1965-11-29,1966-03-07,99,0,42,187,229,34,82,116,345,11,74,Kentucky,Lexington,295803
7374,1966-1967,1966-11-02,1967-03-08,127,0,26,174,200,42,32,74,274,18,84,Kentucky,Lexington,295803
7375,1967-1968,1967-12-01,1968-03-25,116,0,32,222,254,49,109,158,412,16,94,Kentucky,Lexington,295803
7376,1968-1969,1968-11-11,1969-03-26,136,0,23,185,208,26,10,36,244,21,70,Kentucky,Lexington,295803
7377,1969-1970,1969-11-14,1970-03-29,136,0,43,241,284,48,57,105,389,28,135,Kentucky,Lexington,295803
7378,1970-1971,1970-11-23,1971-03-26,124,0,39,211,250,33,35,68,318,17,78,Kentucky,Lexington,295803
7379,1971-1972,1971-11-23,1972-03-04,103,0,23,145,168,17,13,30,198,12,43,Kentucky,Lexington,295803
7380,1972-1973,1972-10-19,1973-04-11,175,0,17,137,154,20,0,20,174,20,44,Kentucky,Lexington,295803
7381,1973-1974,1973-12-01,1974-03-24,114,0,18,122,140,15,12,27,167,9,37,Kentucky,Lexington,295803
7382,1974-1975,1974-11-13,1975-03-10,118,0,6,123,129,30,13,43,172,20,68,Kentucky,Lexington,295803
7383,1975-1976,1975-12-01,1976-03-16,107,0,27,165,192,22,11,33,225,16,71,Kentucky,Lexington,295803
7384,1976-1977,1976-11-21,1977-04-06,137,0,70,301,371,46,110,156,527,30,135,Kentucky,Lexington,295803
7385,1977-1978,1977-11-26,1978-03-16,111,0,89,309,398,66,200,266,664,33,192,Kentucky,Lexington,295803
7386,1978-1979,1978-12-01,1979-03-27,117,0,59,233,292,38,79,117,409,21,128,Kentucky,Lexington,295803
7387,1979-1980,1979-11-29,1980-04-15,139,0,39,200,239,31,86,117,356,13,76,Kentucky,Lexington,295803
7388,1980-1981,1980-11-18,1981-03-19,122,0,37,219,256,9,6,15,271,8,36,Kentucky,Lexington,295803
7389,1981-1982,1981-11-20,1982-04-08,140,0,40,222,262,25,25,50,312,18,107,Kentucky,Lexington,295803
7390,1982-1983,1982-12-01,1983-03-21,111,0,13,99,112,14,14,28,140,9,30,Kentucky,Lexington,295803
7391,1983-1984,1983-12-01,1984-03-21,112,0,53,210,263,26,37,63,326,15,62,Kentucky,Lexington,295803
7392,1984-1985,1984-12-01,1985-04-08,129,0,49,207,256,43,76,119,375,22,126,Kentucky,Lexington,295803
7393,1985-1986,1985-12-01,1986-03-07,97,0,31,200,231,26,30,56,287,17,95,Kentucky,Lexington,295803
7394,1986-1987,1986-11-15,1987-04-05,142,0,16,132,148,29,14,43,191,18,77,Kentucky,Lexington,295803
7395,1987-1988,1987-11-10,1988-03-18,130,0,31,194,225,21,15,36,261,15,63,Kentucky,Lexington,295803
7396,1988-1989,1988-12-01,1989-03-07,97,0,15,135,150,6,3,9,159,5,20,Kentucky,Lexington,295803
7397,1989-1990,1989-11-16,1990-03-24,129,0,41,185,226,23,53,76,302,12,68,Kentucky,Lexington,295803
7398,1990-1991,1990-12-01,1991-03-30,120,0,13,117,130,10,5,15,145,7,25,Kentucky,Lexington,295803
7399,1991-1992,1991-11-04,1992-04-02,151,0,11,143,154,8,1,9,163,8,27,Kentucky,Lexington,295803
7400,1992-1993,1992-11-14,1993-03-16,123,0,18,148,166,37,37,74,240,16,65,Kentucky,Lexington,295803
7401,1993-1994,1993-11-06,1994-03-11,126,0,46,207,253,47,83,130,383,21,124,Kentucky,Lexington,295803
7402,1994-1995,1994-12-01,1995-03-10,100,0,25,149,174,19,12,31,205,14,60,Kentucky,Lexington,295803
7403,1995-1996,1995-11-13,1996-04-01,141,2,56,239,295,51,82,133,428,27,134,Kentucky,Lexington,295803
7404,1996-1997,1996-12-01,1997-02-28,90,0,32,130,162,7,5,12,174,5,20,Kentucky,Lexington,295803
7405,1997-1998,1997-12-01,1998-03-12,102,0,11,91,102,28,48,76,178,9,44,Kentucky,Lexington,295803
7406,1998-1999,1998-12-01,1999-03-13,103,0,19,133,152,10,4,14,166,10,36,Kentucky,Lexington,295803
7407,1999-2000,1999-12-01,2000-03-11,102,4,27,139,166,12,4,16,182,10,41,Kentucky,Lexington,295803
7408,2000-2001,2000-11-21,2001-04-17,148,3,39,222,261,17,25,42,303,11,57,Kentucky,Lexington,295803
7409,2001-2002,2001-12-01,2002-03-04,94,0,15,122,137,13,12,25,162,7,26,Kentucky,Lexington,295803
7410,2002-2003,2002-11-26,2003-02-28,95,0,38,173,211,32,30,62,273,19,90,Kentucky,Lexington,295803
7411,2003-2004,2003-12-01,2004-02-29,91,0,22,155,177,14,18,32,209,10,42,Kentucky,Lexington,295803
7412,2004-2005,2004-12-01,2005-03-14,104,0,21,141,162,13,5,18,180,11,39,Kentucky,Lexington,295803
7413,2005-2006,2005-11-25,2006-02-28,96,0,14,117,131,17,12,29,160,11,40,Kentucky,Lexington,295803
7414,2006-2007,2006-11-20,2007-04-06,138,0,26,169,195,15,9,24,219,12,64,Kentucky,Lexington,295803
7415,2007-2008,2007-12-01,2008-03-09,100,0,22,144,166,22,15,37,203,13,70,Kentucky,Lexington,295803
7416,2008-2009,2008-11-20,2009-03-12,113,0,33,196,229,23,28,51,280,16,64,Kentucky,Lexington,295803
7417,2009-2010,2009-12-01,2010-02-28,90,0,37,175,212,38,48,86,298,23,123,Kentucky,Lexington,295803
7418,2010-2011,2010-11-26,2011-03-26,121,0,44,188,232,42,76,118,350,23,101,Kentucky,Lexington,295803
7419,2011-2012,2011-12-01,2012-03-06,97,0,7,96,103,13,7,20,123,7,35,Kentucky,Lexington,295803
7420,2012-2013,2012-12-01,2013-03-26,116,0,16,139,155,23,15,38,193,16,52,Kentucky,Lexington,295803
7421,2013-2014,2013-11-12,2014-04-15,155,0,42,258,300,46,71,117,417,28,126,Kentucky,Lexington,295803
7422,2014-2015,2014-11-15,2015-03-09,115,0,37,239,276,59,92,151,427,14,110,Kentucky,Lexington,295803
7423,2015-2016,2015-12-01,2016-03-03,94,0,22,115,137,23,26,49,186,10,56,Kentucky,Lexington,295803
7424,2016-2017,2016-12-01,2017-02-28,90,0,12,90,102,7,5,12,114,5,17,Kentucky,Lexington,295803
7425,2017-2018,2017-12-01,2018-04-09,130,0,35,183,218,34,31,65,283,18,83,Kentucky,Lexington,295803
7426,2018-2019,2018-11-13,2019-03-08,116,0,16,121,137,18,10,28,165,12,49,Kentucky,Lexington,295803
7427,2019-2020,2019-11-11,2020-02-29,111,0,5,82,87,10,6,16,103,8,28,Kentucky,Lexington,295803
7428,1950-1951,1950-11-23,1951-03-25,123,0,40,209,249,49,61,110,359,22,131,Kentucky,Louisville,597337
7429,1951-1952,1951-11-02,1952-03-02,122,0,12,136,148,16,5,21,169,11,38,Kentucky,Louisville,597337
7430,1952-1953,1952-11-29,1953-04-18,141,0,4,82,86,18,9,27,113,6,26,Kentucky,Louisville,597337
7431,1953-1954,1953-12-01,1954-02-28,90,0,14,107,121,10,9,19,140,3,16,Kentucky,Louisville,597337
7432,1954-1955,1954-11-02,1955-03-26,145,0,20,133,153,14,14,28,181,10,38,Kentucky,Louisville,597337
7433,1955-1956,1955-11-18,1956-03-16,120,0,11,133,144,20,30,50,194,9,35,Kentucky,Louisville,597337
7434,1956-1957,1956-11-23,1957-04-06,135,0,10,109,119,13,3,16,135,11,37,Kentucky,Louisville,597337
7435,1957-1958,1957-12-01,1958-03-18,108,0,30,172,202,27,18,45,247,17,57,Kentucky,Louisville,597337
7436,1958-1959,1958-11-28,1959-02-28,93,0,26,187,213,13,15,28,241,6,36,Kentucky,Louisville,597337
7437,1959-1960,1959-11-27,1960-03-19,114,0,22,160,182,54,52,106,288,20,93,Kentucky,Louisville,597337
7438,1960-1961,1960-12-01,1961-04-16,137,0,35,202,237,40,49,89,326,17,99,Kentucky,Louisville,597337
7439,1961-1962,1961-11-19,1962-04-01,134,0,31,169,200,34,12,46,246,21,80,Kentucky,Louisville,597337
7440,1962-1963,1962-12-01,1963-03-06,96,0,50,263,313,25,32,57,370,19,103,Kentucky,Louisville,597337
7441,1963-1964,1963-12-01,1964-03-29,120,0,29,220,249,54,49,103,352,25,109,Kentucky,Louisville,597337
7442,1964-1965,1964-11-20,1965-03-20,121,0,28,203,231,34,43,77,308,17,90,Kentucky,Louisville,597337
7443,1965-1966,1965-11-29,1966-04-05,128,0,39,174,213,29,68,97,310,10,65,Kentucky,Louisville,597337
7444,1966-1967,1966-11-02,1967-03-09,128,0,23,179,202,52,31,83,285,17,86,Kentucky,Louisville,597337
7445,1967-1968,1967-12-01,1968-03-24,115,0,35,189,224,46,55,101,325,14,78,Kentucky,Louisville,597337
7446,1968-1969,1968-11-19,1969-03-26,128,0,15,158,173,23,11,34,207,15,45,Kentucky,Louisville,597337
7447,1969-1970,1969-11-19,1970-03-30,132,0,35,209,244,54,52,106,350,26,127,Kentucky,Louisville,597337
7448,1970-1971,1970-11-14,1971-04-06,144,0,34,184,218,34,37,71,289,17,63,Kentucky,Louisville,597337
7449,1971-1972,1971-11-06,1972-03-03,119,0,20,134,154,23,10,33,187,15,55,Kentucky,Louisville,597337
7450,1972-1973,1972-11-28,1973-04-10,134,0,17,119,136,19,2,21,157,16,41,Kentucky,Louisville,597337
7451,1973-1974,1973-12-01,1974-03-24,114,0,19,97,116,17,7,24,140,13,43,Kentucky,Louisville,597337
7452,1974-1975,1974-11-30,1975-03-27,118,0,7,94,101,28,9,37,138,15,47,Kentucky,Louisville,597337
7453,1975-1976,1975-11-13,1976-03-16,125,0,13,139,152,12,2,14,166,12,34,Kentucky,Louisville,597337
7454,1976-1977,1976-11-28,1977-04-06,130,0,61,272,333,44,101,145,478,28,147,Kentucky,Louisville,597337
7455,1977-1978,1977-11-26,1978-03-16,111,0,70,278,348,71,250,321,669,27,151,Kentucky,Louisville,597337
7456,1978-1979,1978-12-01,1979-03-25,115,0,43,213,256,32,56,88,344,18,96,Kentucky,Louisville,597337
7457,1979-1980,1979-11-29,1980-03-04,97,0,32,170,202,27,76,103,305,12,67,Kentucky,Louisville,597337
7458,1980-1981,1980-12-01,1981-03-19,109,0,24,175,199,5,11,16,215,3,14,Kentucky,Louisville,597337
7459,1981-1982,1981-11-20,1982-04-08,140,0,36,217,253,20,15,35,288,14,63,Kentucky,Louisville,597337
7460,1982-1983,1982-12-01,1983-03-10,100,0,5,91,96,10,4,14,110,8,18,Kentucky,Louisville,597337
7461,1983-1984,1983-12-01,1984-03-21,112,0,51,200,251,20,17,37,288,11,45,Kentucky,Louisville,597337
7462,1984-1985,1984-12-01,1985-02-28,90,0,42,169,211,32,67,99,310,17,87,Kentucky,Louisville,597337
7463,1985-1986,1985-12-01,1986-03-07,97,0,30,174,204,20,26,46,250,11,50,Kentucky,Louisville,597337
7464,1986-1987,1986-11-13,1987-04-01,140,0,11,115,126,30,19,49,175,10,53,Kentucky,Louisville,597337
7465,1987-1988,1987-12-01,1988-03-18,109,0,26,164,190,12,18,30,220,5,35,Kentucky,Louisville,597337
7466,1988-1989,1988-12-01,1989-03-07,97,0,13,111,124,5,0,5,129,5,15,Kentucky,Louisville,597337
7467,1989-1990,1989-10-19,1990-03-25,158,0,35,161,196,25,37,62,258,16,74,Kentucky,Louisville,597337
7468,1990-1991,1990-12-01,1991-03-29,119,0,13,108,121,13,4,17,138,10,32,Kentucky,Louisville,597337
7469,1991-1992,1991-11-04,1992-04-02,151,0,6,113,119,11,0,11,130,11,28,Kentucky,Louisville,597337
7470,1992-1993,1992-11-14,1993-03-14,121,0,13,125,138,32,36,68,206,14,50,Kentucky,Louisville,597337
7471,1993-1994,1993-10-30,1994-03-11,133,0,37,186,223,47,81,128,351,17,104,Kentucky,Louisville,597337
7472,1994-1995,1994-12-01,1995-03-08,98,0,15,110,125,8,6,14,139,5,17,Kentucky,Louisville,597337
7473,1995-1996,1995-11-13,1996-03-22,131,0,53,226,279,54,63,117,396,27,127,Kentucky,Louisville,597337
7474,1996-1997,1996-12-01,1997-02-28,90,0,28,135,163,10,7,17,180,8,40,Kentucky,Louisville,597337
7475,1997-1998,1997-11-15,1998-03-21,127,0,12,99,111,41,52,93,204,13,68,Kentucky,Louisville,597337
7476,1998-1999,1998-12-01,1999-03-14,104,0,18,126,144,17,7,24,168,13,63,Kentucky,Louisville,597337
7477,1999-2000,1999-12-01,2000-03-11,102,0,16,116,132,19,16,35,167,11,49,Kentucky,Louisville,597337
7478,2000-2001,2000-11-21,2001-04-01,132,0,36,207,243,31,54,85,328,20,106,Kentucky,Louisville,597337
7479,2001-2002,2001-12-01,2002-03-04,94,0,11,110,121,15,12,27,148,8,34,Kentucky,Louisville,597337
7480,2002-2003,2002-11-26,2003-02-28,95,0,34,161,195,42,38,80,275,27,118,Kentucky,Louisville,597337
7481,2003-2004,2003-11-28,2004-04-13,138,1,17,153,170,21,16,37,207,14,60,Kentucky,Louisville,597337
7482,2004-2005,2004-12-01,2005-03-13,103,0,21,139,160,25,36,61,221,13,58,Kentucky,Louisville,597337
7483,2005-2006,2005-12-01,2006-02-28,90,0,13,95,108,12,1,13,121,9,28,Kentucky,Louisville,597337
7484,2006-2007,2006-12-01,2007-02-28,90,0,18,121,139,7,2,9,148,6,24,Kentucky,Louisville,597337
7485,2007-2008,2007-12-01,2008-03-23,114,0,13,113,126,33,24,57,183,14,58,Kentucky,Louisville,597337
7486,2008-2009,2008-12-01,2009-03-02,92,0,24,152,176,22,27,49,225,13,58,Kentucky,Louisville,597337
7487,2009-2010,2009-12-01,2010-02-28,90,0,30,147,177,33,63,96,273,15,75,Kentucky,Louisville,597337
7488,2010-2011,2010-11-26,2011-03-26,121,0,29,140,169,31,20,51,220,20,80,Kentucky,Louisville,597337
7489,2011-2012,2011-12-01,2012-03-06,97,0,3,74,77,10,9,19,96,7,25,Kentucky,Louisville,597337
7490,2012-2013,2012-12-01,2013-03-26,116,0,8,102,110,18,8,26,136,13,34,Kentucky,Louisville,597337
7491,2013-2014,2013-11-12,2014-04-15,155,0,31,222,253,45,77,122,375,28,112,Kentucky,Louisville,597337
7492,2014-2015,2014-11-17,2015-03-08,112,0,28,178,206,40,59,99,305,10,69,Kentucky,Louisville,597337
7493,2015-2016,2015-12-01,2016-03-03,94,0,12,93,105,19,26,45,150,9,47,Kentucky,Louisville,597337
7494,2016-2017,2016-12-01,2017-02-28,90,0,10,73,83,5,2,7,90,3,12,Kentucky,Louisville,597337
7495,2017-2018,2017-12-01,2018-04-16,137,0,31,148,179,31,31,62,241,17,67,Kentucky,Louisville,597337
7496,2018-2019,2018-11-15,2019-03-08,114,0,12,94,106,22,12,34,140,14,52,Kentucky,Louisville,597337
7497,2019-2020,2019-11-11,2020-02-29,111,0,5,65,70,10,2,12,82,9,23,Kentucky,Louisville,597337
7498,1950-1951,1950-11-24,1951-04-02,130,9,21,173,194,25,8,33,227,4,36,Kentucky,Murray,17741
7499,1951-1952,1951-12-01,1952-02-29,91,0,2,68,70,0,0,0,70,0,0,Kentucky,Murray,17741
7500,1952-1953,1952-11-29,1953-02-28,92,0,3,63,66,0,0,0,66,0,0,Kentucky,Murray,17741
7501,1953-1954,1953-12-01,1954-02-28,90,0,4,93,97,3,5,8,105,1,5,Kentucky,Murray,17741
7502,1954-1955,1954-12-01,1955-02-28,90,12,2,101,103,4,3,7,110,1,5,Kentucky,Murray,17741
7503,1955-1956,1955-12-01,1956-02-29,91,0,3,105,108,2,0,2,110,2,4,Kentucky,Murray,17741
7504,1956-1957,1956-11-26,1957-02-28,95,0,5,82,87,1,0,1,88,1,2,Kentucky,Murray,17741
7505,1957-1958,1957-12-01,1958-03-17,107,1,14,159,173,12,17,29,202,6,27,Kentucky,Murray,17741
7506,1958-1959,1958-11-28,1959-02-28,93,2,18,164,182,5,3,8,190,4,19,Kentucky,Murray,17741
7507,1959-1960,1959-11-28,1960-03-15,109,1,14,142,156,40,66,106,262,12,60,Kentucky,Murray,17741
7508,1960-1961,1960-12-01,1961-02-28,90,5,12,162,174,7,13,20,194,3,14,Kentucky,Murray,17741
7509,1962-1963,1962-12-01,1963-02-28,90,0,42,237,279,14,20,34,313,8,62,Kentucky,Murray,17741
7510,1963-1964,1963-12-01,1964-02-29,91,0,19,179,198,11,25,36,234,2,18,Kentucky,Murray,17741
7511,1964-1965,1964-11-22,1965-03-20,119,3,18,174,192,28,26,54,246,10,62,Kentucky,Murray,17741
7512,1965-1966,1965-12-01,1966-02-28,90,0,22,135,157,11,26,37,194,6,35,Kentucky,Murray,17741
7513,1966-1967,1966-11-03,1967-03-07,125,0,14,159,173,11,7,18,191,5,29,Kentucky,Murray,17741
7514,1967-1968,1967-12-01,1968-03-25,116,0,27,188,215,42,74,116,331,9,69,Kentucky,Murray,17741
7515,1968-1969,1968-12-01,1969-03-11,101,0,13,130,143,11,8,19,162,4,20,Kentucky,Murray,17741
7516,1969-1970,1969-11-14,1970-03-17,124,0,34,194,228,30,28,58,286,18,89,Kentucky,Murray,17741
7517,1970-1971,1970-11-24,1971-03-03,100,0,16,129,145,22,20,42,187,8,42,Kentucky,Murray,17741
7518,1971-1972,1971-12-01,1972-02-29,91,0,9,91,100,2,0,2,102,2,7,Kentucky,Murray,17741
7519,1972-1973,1972-12-01,1973-02-28,90,0,13,98,111,5,5,10,121,4,16,Kentucky,Murray,17741
7520,1973-1974,1973-12-01,1974-02-28,90,0,13,81,94,5,4,9,103,3,13,Kentucky,Murray,17741
7521,1974-1975,1974-12-01,1975-03-14,104,1,2,94,96,12,3,15,111,5,19,Kentucky,Murray,17741
7522,1975-1976,1975-12-01,1976-02-29,91,0,8,100,108,4,4,8,116,1,8,Kentucky,Murray,17741
7523,1976-1977,1976-11-11,1977-02-28,110,4,33,222,255,30,61,91,346,10,68,Kentucky,Murray,17741
7524,1977-1978,1977-11-26,1978-03-05,100,7,45,228,273,58,195,253,526,12,86,Kentucky,Murray,17741
7525,1978-1979,1978-12-01,1979-03-25,115,4,29,205,234,42,78,120,354,14,91,Kentucky,Murray,17741
7526,1979-1980,1979-11-29,1980-03-12,105,0,13,155,168,18,22,40,208,8,37,Kentucky,Murray,17741
7527,1982-1983,1982-12-01,1983-02-28,90,2,1,80,81,3,3,6,87,1,5,Kentucky,Murray,17741
7528,1983-1984,1983-12-01,1984-02-29,91,2,38,164,202,13,18,31,233,7,44,Kentucky,Murray,17741
7529,1987-1988,1987-12-01,1988-02-29,91,0,19,119,138,13,27,40,178,3,25,Kentucky,Murray,17741
7530,1988-1989,1988-12-01,1989-03-07,97,1,12,103,115,13,9,22,137,2,15,Kentucky,Murray,17741
7531,1989-1990,1989-12-01,1990-03-19,109,5,25,111,136,7,4,11,147,4,19,Kentucky,Murray,17741
7532,1990-1991,1990-12-01,1991-03-29,119,6,8,95,103,4,6,10,113,2,10,Kentucky,Murray,17741
7533,1991-1992,1991-12-01,1992-02-29,91,0,2,65,67,0,0,0,67,0,0,Kentucky,Murray,17741
7534,1992-1993,1992-12-01,1993-02-28,90,6,6,85,91,8,17,25,116,2,12,Kentucky,Murray,17741
7535,1993-1994,1993-10-30,1994-03-09,131,1,22,141,163,18,36,54,217,7,35,Kentucky,Murray,17741
7536,1994-1995,1994-12-01,1995-02-28,90,2,12,86,98,2,1,3,101,1,5,Kentucky,Murray,17741
7537,1995-1996,1995-12-01,1996-03-20,111,11,29,160,189,19,22,41,230,4,32,Kentucky,Murray,17741
7538,1996-1997,1996-11-10,1997-02-28,111,8,23,114,137,12,15,27,164,8,32,Kentucky,Murray,17741
7539,1998-1999,1998-12-01,1999-02-28,90,6,10,73,83,0,0,0,83,0,0,Kentucky,Murray,17741
7540,1999-2000,1999-12-01,2000-02-29,91,12,5,74,79,9,11,20,99,3,14,Kentucky,Murray,17741
7541,2000-2001,2000-12-01,2001-02-28,90,3,22,132,154,12,7,19,173,9,36,Kentucky,Murray,17741
7542,2001-2002,2001-12-01,2002-02-28,90,4,4,71,75,5,1,6,81,3,8,Kentucky,Murray,17741
7543,2003-2004,2003-12-01,2004-04-13,135,7,5,95,100,3,0,3,103,3,5,Kentucky,Murray,17741
7544,2004-2005,2004-12-01,2005-02-28,90,1,8,85,93,10,35,45,138,2,18,Kentucky,Murray,17741
7545,2005-2006,2005-12-01,2006-02-28,90,1,4,86,90,14,11,25,115,8,38,Kentucky,Murray,17741
7546,2006-2007,2006-12-01,2007-02-28,90,0,11,98,109,8,0,8,117,4,18,Kentucky,Murray,17741
7547,2007-2008,2007-12-01,2008-03-08,99,8,7,97,104,8,3,11,115,2,11,Kentucky,Murray,17741
7548,2008-2009,2008-12-01,2009-03-12,102,4,14,121,135,4,1,5,140,3,12,Kentucky,Murray,17741
7549,2009-2010,2009-12-01,2010-02-28,90,12,20,140,160,17,21,38,198,6,33,Kentucky,Murray,17741
7550,2011-2012,2011-12-01,2012-02-29,91,1,1,65,66,3,1,4,70,2,6,Kentucky,Murray,17741
7551,2012-2013,2012-12-01,2013-03-25,115,0,7,93,100,9,5,14,114,5,16,Kentucky,Murray,17741
7552,2013-2014,2013-11-24,2014-03-07,104,0,38,199,237,8,15,23,260,4,25,Kentucky,Murray,17741
7553,2014-2015,2014-11-17,2015-03-07,111,0,27,163,190,28,58,86,276,7,54,Kentucky,Murray,17741
7554,2015-2016,2015-12-01,2016-02-29,91,0,12,86,98,22,24,46,144,6,38,Kentucky,Murray,17741
7555,2016-2017,2016-12-01,2017-03-11,101,0,12,72,84,3,0,3,87,2,7,Kentucky,Murray,17741
7556,2017-2018,2017-12-01,2018-04-07,128,0,30,147,177,23,43,66,243,7,43,Kentucky,Murray,17741
7557,2018-2019,2018-11-14,2019-03-06,113,0,14,107,121,5,5,10,131,3,13,Kentucky,Murray,17741
7558,2019-2020,2019-11-12,2020-02-29,110,0,9,83,92,4,3,7,99,2,9,Kentucky,Murray,17741
7559,1950-1951,1950-11-23,1951-03-19,117,0,39,198,237,21,41,62,299,10,68,Kentucky,Paducah,25024
7560,1951-1952,1951-12-01,1952-02-29,91,0,10,87,97,8,1,9,106,3,13,Kentucky,Paducah,25024
7561,1952-1953,1952-11-28,1953-02-28,93,1,5,68,73,0,0,0,73,0,0,Kentucky,Paducah,25024
7562,1953-1954,1953-12-01,1954-02-28,90,2,10,108,118,3,12,15,133,1,6,Kentucky,Paducah,25024
7563,1954-1955,1954-12-01,1955-03-26,116,0,13,126,139,5,1,6,145,3,10,Kentucky,Paducah,25024
7564,1955-1956,1955-11-28,1956-02-29,94,0,12,127,139,9,7,16,155,3,20,Kentucky,Paducah,25024
7565,1956-1957,1956-11-29,1957-02-28,92,0,12,85,97,0,0,0,97,0,0,Kentucky,Paducah,25024
7566,1957-1958,1957-12-01,1958-03-18,108,0,25,167,192,13,13,26,218,6,24,Kentucky,Paducah,25024
7567,1958-1959,1958-11-28,1959-02-28,93,0,26,185,211,9,8,17,228,2,17,Kentucky,Paducah,25024
7568,1959-1960,1959-11-17,1960-03-18,123,0,21,174,195,50,85,135,330,12,80,Kentucky,Paducah,25024
7569,1960-1961,1960-12-01,1961-02-28,90,1,24,172,196,16,28,44,240,7,35,Kentucky,Paducah,25024
7570,1961-1962,1961-12-01,1962-03-01,91,2,25,138,163,5,5,10,173,2,10,Kentucky,Paducah,25024
7571,1962-1963,1962-12-01,1963-02-28,90,0,42,236,278,7,12,19,297,4,26,Kentucky,Paducah,25024
7572,1963-1964,1963-12-01,1964-02-29,91,0,21,193,214,12,23,35,249,4,32,Kentucky,Paducah,25024
7573,1964-1965,1964-11-21,1965-03-19,119,0,25,179,204,28,37,65,269,9,65,Kentucky,Paducah,25024
7574,1965-1966,1965-12-01,1966-02-28,90,0,24,133,157,8,19,27,184,3,13,Kentucky,Paducah,25024
7575,1966-1967,1966-12-01,1967-03-09,99,1,10,160,170,25,26,51,221,3,32,Kentucky,Paducah,25024
7576,1967-1968,1967-12-01,1968-03-23,114,0,29,194,223,22,38,60,283,8,45,Kentucky,Paducah,25024
7577,1968-1969,1968-12-01,1969-02-28,90,0,8,109,117,15,11,26,143,5,22,Kentucky,Paducah,25024
7578,1969-1970,1969-11-14,1970-03-18,125,0,35,203,238,34,44,78,316,12,75,Kentucky,Paducah,25024
7579,1970-1971,1970-11-23,1971-04-06,135,0,22,175,197,20,22,42,239,8,39,Kentucky,Paducah,25024
7580,1971-1972,1971-11-23,1972-02-29,99,0,13,107,120,4,2,6,126,2,8,Kentucky,Paducah,25024
7581,1972-1973,1972-12-01,1973-02-28,90,0,15,116,131,5,2,7,138,3,13,Kentucky,Paducah,25024
7582,1973-1974,1973-12-01,1974-02-28,90,0,23,99,122,6,8,14,136,3,13,Kentucky,Paducah,25024
7583,1974-1975,1974-11-30,1975-03-15,106,0,8,108,116,16,8,24,140,6,23,Kentucky,Paducah,25024
7584,1975-1976,1975-12-01,1976-02-29,91,0,15,116,131,8,6,14,145,3,17,Kentucky,Paducah,25024
7585,1976-1977,1976-11-28,1977-02-28,93,0,45,257,302,20,72,92,394,7,63,Kentucky,Paducah,25024
7586,1977-1978,1977-11-26,1978-03-16,111,0,53,271,324,51,241,292,616,13,91,Kentucky,Paducah,25024
7587,1978-1979,1978-12-01,1979-03-25,115,0,36,218,254,40,87,127,381,15,90,Kentucky,Paducah,25024
7588,1979-1980,1979-11-29,1980-03-03,96,0,17,141,158,20,34,54,212,7,39,Kentucky,Paducah,25024
7589,1980-1981,1980-12-01,1981-02-28,90,0,20,164,184,10,10,20,204,3,16,Kentucky,Paducah,25024
7590,1981-1982,1981-12-01,1982-03-06,96,0,30,185,215,14,41,55,270,4,24,Kentucky,Paducah,25024
7591,1982-1983,1982-12-01,1983-04-18,139,0,4,99,103,5,0,5,108,5,10,Kentucky,Paducah,25024
7592,1983-1984,1983-12-01,1984-03-02,93,0,51,195,246,23,30,53,299,7,54,Kentucky,Paducah,25024
7593,1984-1985,1984-12-01,1985-02-28,90,0,40,200,240,39,119,158,398,14,93,Kentucky,Paducah,25024
7594,1985-1986,1985-12-01,1986-02-28,90,0,24,172,196,15,27,42,238,7,40,Kentucky,Paducah,25024
7595,1986-1987,1986-11-13,1987-03-31,139,0,9,130,139,13,5,18,157,11,42,Kentucky,Paducah,25024
7596,1987-1988,1987-12-01,1988-03-18,109,0,19,155,174,14,17,31,205,5,26,Kentucky,Paducah,25024
7597,1988-1989,1988-12-01,1989-03-08,98,0,14,128,142,9,9,18,160,5,28,Kentucky,Paducah,25024
7598,1989-1990,1989-12-01,1990-03-19,109,0,27,139,166,9,3,12,178,8,31,Kentucky,Paducah,25024
7599,1990-1991,1990-12-01,1991-02-28,90,0,12,110,122,7,7,14,136,5,27,Kentucky,Paducah,25024
7600,1991-1992,1991-12-01,1992-02-29,91,0,3,77,80,0,0,0,80,0,0,Kentucky,Paducah,25024
7601,1992-1993,1992-12-01,1993-03-13,103,0,7,108,115,28,29,57,172,7,40,Kentucky,Paducah,25024
7602,1993-1994,1993-10-29,1994-03-12,135,0,25,180,205,28,53,81,286,10,51,Kentucky,Paducah,25024
7603,1994-1995,1994-12-01,1995-03-02,92,0,11,105,116,5,2,7,123,4,17,Kentucky,Paducah,25024
7604,1995-1996,1995-12-01,1996-03-20,111,0,41,181,222,22,27,49,271,11,49,Kentucky,Paducah,25024
7605,1996-1997,1996-11-09,1997-02-28,112,0,30,131,161,18,27,45,206,9,37,Kentucky,Paducah,25024
7606,1997-1998,1997-11-12,1998-03-11,120,1,2,99,101,8,0,8,109,7,18,Kentucky,Paducah,25024
7607,1998-1999,1998-12-01,1999-02-28,90,0,19,99,118,8,3,11,129,8,30,Kentucky,Paducah,25024
7608,1999-2000,1999-12-01,2000-03-11,102,0,7,112,119,7,1,8,127,6,19,Kentucky,Paducah,25024
7609,2000-2001,2000-12-01,2001-02-28,90,0,31,172,203,15,19,34,237,11,59,Kentucky,Paducah,25024
7610,2001-2002,2001-12-01,2002-03-03,93,0,7,110,117,10,11,21,138,4,16,Kentucky,Paducah,25024
7611,2002-2003,2002-11-26,2003-02-28,95,2,26,159,185,38,46,84,269,17,87,Kentucky,Paducah,25024
7612,2003-2004,2003-12-01,2004-02-29,91,0,10,123,133,7,2,9,142,5,14,Kentucky,Paducah,25024
7613,2004-2005,2004-12-01,2005-02-28,90,0,13,112,125,19,39,58,183,2,31,Kentucky,Paducah,25024
7614,2005-2006,2005-12-01,2006-02-28,90,0,10,110,120,13,10,23,143,8,36,Kentucky,Paducah,25024
7615,2006-2007,2006-12-01,2007-02-28,90,0,15,117,132,5,0,5,137,4,19,Kentucky,Paducah,25024
7616,2007-2008,2007-12-01,2008-03-08,99,2,9,122,131,14,1,15,146,13,34,Kentucky,Paducah,25024
7617,2008-2009,2008-12-01,2009-02-28,90,0,19,137,156,7,6,13,169,6,23,Kentucky,Paducah,25024
7618,2009-2010,2009-12-01,2010-02-28,90,0,24,171,195,14,23,37,232,7,36,Kentucky,Paducah,25024
7619,2010-2011,2010-12-01,2011-02-28,90,0,23,161,184,28,31,59,243,11,58,Kentucky,Paducah,25024
7620,2011-2012,2011-11-29,2012-02-29,93,0,2,76,78,4,0,4,82,4,12,Kentucky,Paducah,25024
7621,2012-2013,2012-12-01,2013-03-26,116,0,3,114,117,12,14,26,143,7,22,Kentucky,Paducah,25024
7622,2013-2014,2013-12-01,2014-03-25,115,3,33,219,252,30,78,108,360,12,61,Kentucky,Paducah,25024
7623,2014-2015,2014-11-16,2015-03-08,113,0,25,188,213,42,89,131,344,10,78,Kentucky,Paducah,25024
7624,2015-2016,2015-12-01,2016-02-29,91,0,10,94,104,16,12,28,132,6,32,Kentucky,Paducah,25024
7625,2016-2017,2016-12-01,2017-03-13,103,0,9,89,98,3,0,3,101,3,9,Kentucky,Paducah,25024
7626,2017-2018,2017-12-01,2018-04-07,128,0,26,167,193,22,35,57,250,5,34,Kentucky,Paducah,25024
7627,2018-2019,2018-11-13,2019-03-04,112,2,8,101,109,12,6,18,127,10,35,Kentucky,Paducah,25024
7628,2019-2020,2019-11-11,2020-02-29,111,0,5,91,96,2,1,3,99,1,4,Kentucky,Paducah,25024
7629,1950-1951,1950-11-24,1951-02-28,97,0,5,59,64,7,21,28,92,3,13,Louisiana,Monroe,48815
7630,1951-1952,1951-12-01,1952-02-29,91,0,0,20,20,0,0,0,20,0,0,Louisiana,Monroe,48815
7631,1952-1953,1952-12-01,1953-02-28,90,0,0,22,22,0,0,0,22,0,0,Louisiana,Monroe,48815
7632,1953-1954,1953-12-01,1954-03-05,95,0,0,36,36,1,1,2,38,1,2,Louisiana,Monroe,48815
7633,1954-1955,1954-12-01,1955-02-28,90,1,0,37,37,0,0,0,37,0,0,Louisiana,Monroe,48815
7634,1955-1956,1955-12-01,1956-02-29,91,0,0,31,31,0,0,0,31,0,0,Louisiana,Monroe,48815
7635,1956-1957,1956-12-01,1957-02-28,90,0,0,17,17,0,0,0,17,0,0,Louisiana,Monroe,48815
7636,1957-1958,1957-12-01,1958-02-28,90,0,1,41,42,3,2,5,47,1,4,Louisiana,Monroe,48815
7637,1958-1959,1958-12-01,1959-02-28,90,0,0,53,53,0,0,0,53,0,0,Louisiana,Monroe,48815
7638,1959-1960,1959-12-01,1960-02-29,91,0,1,34,35,13,5,18,53,3,16,Louisiana,Monroe,48815
7639,1960-1961,1960-12-01,1961-02-28,90,0,4,46,50,0,0,0,50,0,0,Louisiana,Monroe,48815
7640,1961-1962,1961-12-01,1962-02-28,90,0,6,58,64,6,8,14,78,1,10,Louisiana,Monroe,48815
7641,1962-1963,1962-12-01,1963-02-28,90,0,5,108,113,5,2,7,120,2,7,Louisiana,Monroe,48815
7642,1963-1964,1963-12-01,1964-02-29,91,0,3,71,74,7,12,19,93,2,11,Louisiana,Monroe,48815
7643,1964-1965,1964-12-01,1965-02-28,90,0,1,44,45,0,0,0,45,0,0,Louisiana,Monroe,48815
7644,1965-1966,1965-12-01,1966-02-28,90,0,2,37,39,0,0,0,39,0,0,Louisiana,Monroe,48815
7645,1966-1967,1966-12-01,1967-02-28,90,0,1,41,42,0,0,0,42,0,0,Louisiana,Monroe,48815
7646,1967-1968,1967-12-01,1968-03-22,113,0,2,44,46,4,3,7,53,1,5,Louisiana,Monroe,48815
7647,1968-1969,1968-12-01,1969-02-28,90,0,0,38,38,0,0,0,38,0,0,Louisiana,Monroe,48815
7648,1969-1970,1969-12-01,1970-02-28,90,0,2,47,49,0,0,0,49,0,0,Louisiana,Monroe,48815
7649,1970-1971,1970-12-01,1971-02-28,90,0,2,44,46,6,4,10,56,2,10,Louisiana,Monroe,48815
7650,1971-1972,1971-12-01,1972-02-29,91,0,1,25,26,0,0,0,26,0,0,Louisiana,Monroe,48815
7651,1972-1973,1972-12-01,1973-02-28,90,0,4,48,52,0,0,0,52,0,0,Louisiana,Monroe,48815
7652,1973-1974,1973-12-01,1974-02-28,90,0,1,34,35,1,0,1,36,1,2,Louisiana,Monroe,48815
7653,1974-1975,1974-12-01,1975-02-28,90,0,0,29,29,1,0,1,30,1,2,Louisiana,Monroe,48815
7654,1975-1976,1975-12-01,1976-02-29,91,0,2,48,50,0,0,0,50,0,0,Louisiana,Monroe,48815
7655,1976-1977,1976-12-01,1977-02-28,90,0,3,70,73,6,1,7,80,2,10,Louisiana,Monroe,48815
7656,1977-1978,1977-12-01,1978-02-28,90,0,10,85,95,3,0,3,98,1,5,Louisiana,Monroe,48815
7657,1978-1979,1978-12-01,1979-02-28,90,0,4,62,66,0,0,0,66,0,0,Louisiana,Monroe,48815
7658,1979-1980,1979-12-01,1980-02-29,91,0,0,47,47,0,0,0,47,0,0,Louisiana,Monroe,48815
7659,1980-1981,1980-12-01,1981-02-28,90,0,1,45,46,0,0,0,46,0,0,Louisiana,Monroe,48815
7660,1981-1982,1981-12-01,1982-02-28,90,0,4,61,65,7,4,11,76,2,16,Louisiana,Monroe,48815
7661,1982-1983,1982-12-01,1983-02-28,90,0,0,27,27,0,0,0,27,0,0,Louisiana,Monroe,48815
7662,1983-1984,1983-12-01,1984-02-29,91,0,12,87,99,2,0,2,101,2,4,Louisiana,Monroe,48815
7663,1984-1985,1984-12-01,1985-02-28,90,3,7,69,76,9,7,16,92,3,20,Louisiana,Monroe,48815
7664,1985-1986,1985-12-01,1986-02-28,90,0,0,53,53,0,0,0,53,0,0,Louisiana,Monroe,48815
7665,1986-1987,1986-12-01,1987-02-28,90,0,0,24,24,0,0,0,24,0,0,Louisiana,Monroe,48815
7666,1987-1988,1987-12-01,1988-02-29,91,0,4,34,38,6,3,9,47,3,11,Louisiana,Monroe,48815
7667,1988-1989,1988-12-01,1989-02-28,90,2,3,28,31,0,0,0,31,0,0,Louisiana,Monroe,48815
7668,1989-1990,1989-12-01,1990-02-28,90,0,7,44,51,1,0,1,52,1,1,Louisiana,Monroe,48815
7669,1990-1991,1990-12-01,1991-02-28,90,0,1,27,28,0,0,0,28,0,0,Louisiana,Monroe,48815
7670,1991-1992,1991-12-01,1992-02-29,91,0,0,19,19,1,0,1,20,1,2,Louisiana,Monroe,48815
7671,1992-1993,1992-12-01,1993-03-12,102,2,0,13,13,2,1,3,16,1,2,Louisiana,Monroe,48815
7672,1993-1994,1993-12-01,1994-02-28,90,0,1,32,33,0,0,0,33,0,0,Louisiana,Monroe,48815
7673,1994-1995,1994-12-01,1995-02-28,90,0,0,23,23,0,0,0,23,0,0,Louisiana,Monroe,48815
7674,1995-1996,1995-12-01,1996-02-29,91,0,5,64,69,2,2,4,73,2,8,Louisiana,Monroe,48815
7675,1996-1997,1996-12-01,1997-02-28,90,0,3,28,31,1,0,1,32,1,1,Louisiana,Monroe,48815
7676,1997-1998,1997-12-01,1998-02-28,90,0,0,13,13,2,1,3,16,1,3,Louisiana,Monroe,48815
7677,2006-2007,2006-12-01,2007-02-28,90,14,0,38,38,1,0,1,39,1,2,Louisiana,Monroe,48815
7678,2007-2008,2007-12-01,2008-02-29,91,14,0,40,40,0,0,0,40,0,0,Louisiana,Monroe,48815
7679,2008-2009,2008-12-01,2009-02-28,90,10,0,31,31,0,0,0,31,0,0,Louisiana,Monroe,48815
7680,2009-2010,2009-12-01,2010-02-28,90,0,2,45,47,5,3,8,55,2,5,Louisiana,Monroe,48815
7681,2010-2011,2010-12-01,2011-02-28,90,0,0,45,45,0,0,0,45,0,0,Louisiana,Monroe,48815
7682,2011-2012,2011-12-01,2012-02-29,91,0,0,21,21,0,0,0,21,0,0,Louisiana,Monroe,48815
7683,2012-2013,2012-12-01,2013-02-28,90,0,0,22,22,1,0,1,23,1,2,Louisiana,Monroe,48815
7684,2013-2014,2013-12-01,2014-02-28,90,14,4,74,78,2,0,2,80,2,5,Louisiana,Monroe,48815
7685,2014-2015,2014-12-01,2015-03-05,95,18,0,41,41,5,0,5,46,2,7,Louisiana,Monroe,48815
7686,2015-2016,2015-12-01,2016-02-29,91,8,0,22,22,0,0,0,22,0,0,Louisiana,Monroe,48815
7687,2016-2017,2016-12-01,2017-02-28,90,7,0,22,22,0,0,0,22,0,0,Louisiana,Monroe,48815
7688,2017-2018,2017-12-01,2018-02-28,90,3,2,58,60,3,1,4,64,2,6,Louisiana,Monroe,48815
7689,2018-2019,2018-11-14,2019-02-28,107,6,0,21,21,1,0,1,22,1,2,Louisiana,Monroe,48815
7690,1951-1952,1951-12-01,1952-02-29,91,0,0,15,15,0,0,0,15,0,0,Louisiana,Natchitoches,18323
7691,1952-1953,1952-12-01,1953-02-28,90,0,0,30,30,0,0,0,30,0,0,Louisiana,Natchitoches,18323
7692,1953-1954,1953-12-01,1954-02-28,90,0,0,38,38,0,0,0,38,0,0,Louisiana,Natchitoches,18323
7693,1954-1955,1954-12-01,1955-02-28,90,0,0,34,34,0,0,0,34,0,0,Louisiana,Natchitoches,18323
7694,1955-1956,1955-12-01,1956-02-29,91,1,0,36,36,0,0,0,36,0,0,Louisiana,Natchitoches,18323
7695,1956-1957,1956-12-01,1957-02-28,90,1,0,17,17,0,0,0,17,0,0,Louisiana,Natchitoches,18323
7696,1957-1958,1957-12-01,1958-02-28,90,0,0,39,39,0,0,0,39,0,0,Louisiana,Natchitoches,18323
7697,1958-1959,1958-12-01,1959-02-28,90,0,0,43,43,0,0,0,43,0,0,Louisiana,Natchitoches,18323
7698,1959-1960,1959-12-01,1960-02-29,91,4,0,34,34,10,0,10,44,1,11,Louisiana,Natchitoches,18323
7699,1960-1961,1960-12-01,1961-02-28,90,4,1,45,46,0,0,0,46,0,0,Louisiana,Natchitoches,18323
7700,1961-1962,1961-12-01,1962-02-28,90,5,3,37,40,1,1,2,42,1,3,Louisiana,Natchitoches,18323
7701,1962-1963,1962-12-01,1963-02-28,90,8,0,59,59,0,0,0,59,0,0,Louisiana,Natchitoches,18323
7702,1963-1964,1963-12-01,1964-02-29,91,12,1,62,63,0,0,0,63,0,0,Louisiana,Natchitoches,18323
7703,1964-1965,1964-12-01,1965-02-28,90,0,0,28,28,0,0,0,28,0,0,Louisiana,Natchitoches,18323
7704,1965-1966,1965-12-01,1966-02-28,90,0,0,32,32,0,0,0,32,0,0,Louisiana,Natchitoches,18323
7705,1966-1967,1966-12-01,1967-02-28,90,0,0,40,40,0,0,0,40,0,0,Louisiana,Natchitoches,18323
7706,1967-1968,1967-12-01,1968-02-29,91,2,1,41,42,7,3,10,52,2,10,Louisiana,Natchitoches,18323
7707,1968-1969,1968-12-01,1969-02-28,90,1,0,24,24,0,0,0,24,0,0,Louisiana,Natchitoches,18323
7708,1969-1970,1969-12-01,1970-02-28,90,0,0,35,35,0,0,0,35,0,0,Louisiana,Natchitoches,18323
7709,1970-1971,1970-12-01,1971-02-28,90,0,0,28,28,2,0,2,30,1,4,Louisiana,Natchitoches,18323
7710,1971-1972,1971-12-01,1972-02-29,91,0,0,18,18,0,0,0,18,0,0,Louisiana,Natchitoches,18323
7711,1972-1973,1972-12-01,1973-02-28,90,3,0,36,36,6,0,6,42,2,9,Louisiana,Natchitoches,18323
7712,1973-1974,1973-12-01,1974-02-28,90,0,0,20,20,0,0,0,20,0,0,Louisiana,Natchitoches,18323
7713,1974-1975,1974-12-01,1975-02-28,90,2,0,24,24,0,0,0,24,0,0,Louisiana,Natchitoches,18323
7714,1975-1976,1975-12-01,1976-02-29,91,1,0,41,41,0,0,0,41,0,0,Louisiana,Natchitoches,18323
7715,1976-1977,1976-12-01,1977-02-28,90,2,1,67,68,9,5,14,82,1,10,Louisiana,Natchitoches,18323
7716,1977-1978,1977-12-01,1978-02-28,90,0,4,70,74,4,0,4,78,2,9,Louisiana,Natchitoches,18323
7717,1978-1979,1978-12-01,1979-02-28,90,1,1,61,62,0,0,0,62,0,0,Louisiana,Natchitoches,18323
7718,1979-1980,1979-12-01,1980-02-29,91,1,0,39,39,0,0,0,39,0,0,Louisiana,Natchitoches,18323
7719,1980-1981,1980-12-01,1981-02-28,90,2,0,55,55,0,0,0,55,0,0,Louisiana,Natchitoches,18323
7720,1981-1982,1981-12-01,1982-02-28,90,5,2,58,60,1,3,4,64,1,4,Louisiana,Natchitoches,18323
7721,1982-1983,1982-12-01,1983-02-28,90,2,0,21,21,0,0,0,21,0,0,Louisiana,Natchitoches,18323
7722,1983-1984,1983-12-01,1984-02-29,91,2,6,76,82,0,0,0,82,0,0,Louisiana,Natchitoches,18323
7723,1985-1986,1985-12-01,1986-02-28,90,1,1,45,46,0,0,0,46,0,0,Louisiana,Natchitoches,18323
7724,1986-1987,1986-12-01,1987-02-28,90,1,0,25,25,0,0,0,25,0,0,Louisiana,Natchitoches,18323
7725,1987-1988,1987-12-01,1988-02-29,91,6,4,43,47,0,0,0,47,0,0,Louisiana,Natchitoches,18323
7726,1988-1989,1988-12-01,1989-02-28,90,1,4,27,31,0,0,0,31,0,0,Louisiana,Natchitoches,18323
7727,1989-1990,1989-12-01,1990-02-28,90,0,7,46,53,0,0,0,53,0,0,Louisiana,Natchitoches,18323
7728,1990-1991,1990-12-01,1991-02-28,90,0,1,33,34,0,0,0,34,0,0,Louisiana,Natchitoches,18323
7729,1991-1992,1991-12-01,1992-02-29,91,0,0,24,24,0,0,0,24,0,0,Louisiana,Natchitoches,18323
7730,1992-1993,1992-12-01,1993-02-28,90,1,0,15,15,0,0,0,15,0,0,Louisiana,Natchitoches,18323
7731,1993-1994,1993-12-01,1994-02-28,90,1,0,41,41,0,0,0,41,0,0,Louisiana,Natchitoches,18323
7732,1994-1995,1994-12-01,1995-02-28,90,1,0,25,25,0,0,0,25,0,0,Louisiana,Natchitoches,18323
7733,1995-1996,1995-12-01,1996-02-29,91,0,4,60,64,0,0,0,64,0,0,Louisiana,Natchitoches,18323
7734,1996-1997,1996-12-01,1997-02-28,90,0,2,35,37,3,0,3,40,3,6,Louisiana,Natchitoches,18323
7735,1997-1998,1997-12-01,1998-02-28,90,0,0,16,16,0,0,0,16,0,0,Louisiana,Natchitoches,18323
7736,1998-1999,1998-12-01,1999-02-28,90,5,2,24,26,0,0,0,26,0,0,Louisiana,Natchitoches,18323
7737,1999-2000,1999-12-01,2000-02-29,91,6,0,28,28,0,0,0,28,0,0,Louisiana,Natchitoches,18323
7738,2000-2001,2000-12-01,2001-02-28,90,1,1,42,43,1,1,2,45,1,2,Louisiana,Natchitoches,18323
7739,2001-2002,2001-12-01,2002-02-28,90,0,0,40,40,0,0,0,40,0,0,Louisiana,Natchitoches,18323
7740,2002-2003,2002-12-01,2003-02-28,90,7,0,28,28,0,0,0,28,0,0,Louisiana,Natchitoches,18323
7741,2003-2004,2003-12-01,2004-02-29,91,4,0,22,22,0,0,0,22,0,0,Louisiana,Natchitoches,18323
7742,2004-2005,2004-12-01,2005-02-28,90,3,0,18,18,0,0,0,18,0,0,Louisiana,Natchitoches,18323
7743,2005-2006,2005-12-01,2006-02-28,90,1,0,16,16,0,0,0,16,0,0,Louisiana,Natchitoches,18323
7744,2006-2007,2006-12-01,2007-02-28,90,1,0,22,22,0,0,0,22,0,0,Louisiana,Natchitoches,18323
7745,2007-2008,2007-12-01,2008-02-29,91,0,0,21,21,0,0,0,21,0,0,Louisiana,Natchitoches,18323
7746,2008-2009,2008-12-01,2009-02-28,90,0,0,22,22,0,0,0,22,0,0,Louisiana,Natchitoches,18323
7747,2009-2010,2009-12-01,2010-02-28,90,0,1,33,34,0,0,0,34,0,0,Louisiana,Natchitoches,18323
7748,2010-2011,2010-12-01,2011-02-28,90,0,2,44,46,1,0,1,47,1,3,Louisiana,Natchitoches,18323
7749,2011-2012,2011-12-01,2012-02-29,91,0,0,17,17,0,0,0,17,0,0,Louisiana,Natchitoches,18323
7750,2012-2013,2012-12-01,2013-02-28,90,0,0,13,13,0,0,0,13,0,0,Louisiana,Natchitoches,18323
7751,2013-2014,2013-12-01,2014-02-28,90,0,1,50,51,4,4,8,59,2,8,Louisiana,Natchitoches,18323
7752,2014-2015,2014-12-01,2015-02-28,90,0,0,36,36,1,0,1,37,1,2,Louisiana,Natchitoches,18323
7753,2015-2016,2015-12-01,2016-02-29,91,0,0,18,18,0,0,0,18,0,0,Louisiana,Natchitoches,18323
7754,2016-2017,2016-12-01,2017-02-28,90,0,0,10,10,0,0,0,10,0,0,Louisiana,Natchitoches,18323
7755,2017-2018,2017-12-01,2018-02-28,90,1,1,34,35,3,3,6,41,3,9,Louisiana,Natchitoches,18323
7756,2018-2019,2018-12-01,2019-02-28,90,0,0,13,13,0,0,0,13,0,0,Louisiana,Natchitoches,18323
7757,2019-2020,2019-12-01,2020-02-29,91,0,0,15,15,0,0,0,15,0,0,Louisiana,Natchitoches,18323
7758,1950-1951,1950-12-01,1951-02-28,90,0,8,52,60,6,13,19,79,3,17,Louisiana,Shreveport,199311
7759,1951-1952,1951-12-01,1952-02-29,91,0,0,23,23,0,0,0,23,0,0,Louisiana,Shreveport,199311
7760,1952-1953,1952-12-01,1953-02-28,90,0,0,14,14,0,0,0,14,0,0,Louisiana,Shreveport,199311
7761,1953-1954,1953-12-01,1954-02-28,90,0,1,24,25,0,0,0,25,0,0,Louisiana,Shreveport,199311
7762,1954-1955,1954-12-01,1955-02-28,90,0,0,30,30,0,0,0,30,0,0,Louisiana,Shreveport,199311
7763,1955-1956,1955-12-01,1956-02-29,91,0,0,24,24,0,0,0,24,0,0,Louisiana,Shreveport,199311
7764,1956-1957,1956-12-01,1957-02-28,90,0,0,16,16,0,0,0,16,0,0,Louisiana,Shreveport,199311
7765,1957-1958,1957-12-01,1958-02-28,90,0,0,33,33,0,0,0,33,0,0,Louisiana,Shreveport,199311
7766,1958-1959,1958-12-01,1959-02-28,90,0,1,52,53,0,0,0,53,0,0,Louisiana,Shreveport,199311
7767,1959-1960,1959-12-01,1960-02-29,91,0,0,31,31,4,0,4,35,3,8,Louisiana,Shreveport,199311
7768,1960-1961,1960-12-01,1961-02-28,90,0,3,36,39,1,0,1,40,1,4,Louisiana,Shreveport,199311
7769,1961-1962,1961-12-01,1962-02-28,90,0,5,47,52,4,11,15,67,1,8,Louisiana,Shreveport,199311
7770,1962-1963,1962-12-01,1963-02-28,90,0,6,73,79,3,1,4,83,1,4,Louisiana,Shreveport,199311
7771,1963-1964,1963-12-01,1964-02-29,91,0,4,59,63,8,6,14,77,4,16,Louisiana,Shreveport,199311
7772,1964-1965,1964-12-01,1965-03-04,94,0,0,42,42,9,3,12,54,2,12,Louisiana,Shreveport,199311
7773,1965-1966,1965-12-01,1966-02-28,90,0,1,38,39,3,1,4,43,2,5,Louisiana,Shreveport,199311
7774,1966-1967,1966-12-01,1967-02-28,90,0,1,48,49,0,0,0,49,0,0,Louisiana,Shreveport,199311
7775,1967-1968,1967-12-01,1968-03-21,112,0,2,50,52,6,0,6,58,4,13,Louisiana,Shreveport,199311
7776,1968-1969,1968-12-01,1969-02-28,90,0,0,25,25,0,0,0,25,0,0,Louisiana,Shreveport,199311
7777,1969-1970,1969-12-01,1970-02-28,90,0,1,40,41,0,0,0,41,0,0,Louisiana,Shreveport,199311
7778,1970-1971,1970-12-01,1971-03-03,93,0,1,34,35,3,1,4,39,3,8,Louisiana,Shreveport,199311
7779,1971-1972,1971-12-01,1972-02-29,91,0,1,30,31,0,0,0,31,0,0,Louisiana,Shreveport,199311
7780,1972-1973,1972-12-01,1973-02-28,90,0,3,37,40,1,1,2,42,1,3,Louisiana,Shreveport,199311
7781,1973-1974,1973-12-01,1974-02-28,90,0,3,38,41,0,0,0,41,0,0,Louisiana,Shreveport,199311
7782,1974-1975,1974-12-01,1975-02-28,90,0,0,37,37,4,1,5,42,1,6,Louisiana,Shreveport,199311
7783,1975-1976,1975-12-01,1976-02-29,91,0,0,39,39,0,0,0,39,0,0,Louisiana,Shreveport,199311
7784,1976-1977,1976-12-01,1977-02-28,90,0,1,76,77,7,5,12,89,1,8,Louisiana,Shreveport,199311
7785,1977-1978,1977-12-01,1978-03-03,93,0,10,106,116,11,6,17,133,6,23,Louisiana,Shreveport,199311
7786,1978-1979,1978-12-01,1979-02-28,90,0,2,73,75,3,0,3,78,2,4,Louisiana,Shreveport,199311
7787,1979-1980,1979-12-01,1980-02-29,91,0,0,39,39,3,0,3,42,2,4,Louisiana,Shreveport,199311
7788,1980-1981,1980-11-26,1981-02-28,95,0,1,53,54,4,1,5,59,3,5,Louisiana,Shreveport,199311
7789,1981-1982,1981-12-01,1982-02-28,90,0,3,58,61,7,9,16,77,1,10,Louisiana,Shreveport,199311
7790,1982-1983,1982-12-01,1983-02-28,90,0,0,24,24,0,0,0,24,0,0,Louisiana,Shreveport,199311
7791,1983-1984,1983-12-01,1984-02-29,91,0,10,84,94,7,2,9,103,1,8,Louisiana,Shreveport,199311
7792,1984-1985,1984-12-01,1985-02-28,90,0,4,52,56,8,11,19,75,3,16,Louisiana,Shreveport,199311
7793,1985-1986,1985-12-01,1986-02-28,90,0,0,53,53,0,0,0,53,0,0,Louisiana,Shreveport,199311
7794,1986-1987,1986-12-01,1987-04-02,123,0,0,33,33,1,0,1,34,1,1,Louisiana,Shreveport,199311
7795,1987-1988,1987-12-01,1988-02-29,91,0,3,54,57,4,5,9,66,3,11,Louisiana,Shreveport,199311
7796,1988-1989,1988-12-01,1989-03-06,96,0,5,36,41,0,0,0,41,0,0,Louisiana,Shreveport,199311
7797,1989-1990,1989-12-01,1990-02-28,90,0,4,44,48,0,0,0,48,0,0,Louisiana,Shreveport,199311
7798,1990-1991,1990-12-01,1991-02-28,90,0,3,40,43,0,0,0,43,0,0,Louisiana,Shreveport,199311
7799,1991-1992,1991-12-01,1992-02-29,91,0,0,19,19,0,0,0,19,0,0,Louisiana,Shreveport,199311
7800,1992-1993,1992-12-01,1993-03-12,102,0,0,16,16,2,1,3,19,1,2,Louisiana,Shreveport,199311
7801,1993-1994,1993-12-01,1994-02-28,90,0,0,34,34,1,0,1,35,1,2,Louisiana,Shreveport,199311
7802,1994-1995,1994-12-01,1995-02-28,90,0,0,22,22,0,0,0,22,0,0,Louisiana,Shreveport,199311
7803,1995-1996,1995-12-01,1996-02-29,91,0,3,54,57,2,0,2,59,2,6,Louisiana,Shreveport,199311
7804,1996-1997,1996-12-01,1997-02-28,90,0,2,35,37,2,0,2,39,2,4,Louisiana,Shreveport,199311
7805,1997-1998,1997-12-01,1998-02-28,90,0,0,15,15,0,0,0,15,0,0,Louisiana,Shreveport,199311
7806,1998-1999,1998-12-01,1999-02-28,90,0,2,26,28,1,0,1,29,1,3,Louisiana,Shreveport,199311
7807,1999-2000,1999-12-01,2000-02-29,91,0,1,28,29,2,3,5,34,1,3,Louisiana,Shreveport,199311
7808,2000-2001,2000-12-01,2001-02-28,90,0,1,49,50,3,1,4,54,1,6,Louisiana,Shreveport,199311
7809,2001-2002,2001-12-01,2002-02-28,90,0,0,32,32,0,0,0,32,0,0,Louisiana,Shreveport,199311
7810,2002-2003,2002-12-01,2003-02-28,90,0,0,29,29,0,0,0,29,0,0,Louisiana,Shreveport,199311
7811,2003-2004,2003-12-01,2004-02-29,91,0,0,32,32,0,0,0,32,0,0,Louisiana,Shreveport,199311
7812,2004-2005,2004-12-01,2005-02-28,90,0,0,26,26,0,0,0,26,0,0,Louisiana,Shreveport,199311
7813,2005-2006,2005-12-01,2006-02-28,90,0,1,21,22,0,0,0,22,0,0,Louisiana,Shreveport,199311
7814,2006-2007,2006-12-01,2007-02-28,90,0,0,29,29,1,0,1,30,1,2,Louisiana,Shreveport,199311
7815,2007-2008,2007-12-01,2008-02-29,91,0,0,31,31,0,0,0,31,0,0,Louisiana,Shreveport,199311
7816,2008-2009,2008-12-01,2009-02-28,90,0,1,37,38,0,0,0,38,0,0,Louisiana,Shreveport,199311
7817,2009-2010,2009-12-01,2010-03-21,111,0,1,59,60,10,4,14,74,4,13,Louisiana,Shreveport,199311
7818,2010-2011,2010-12-01,2011-02-28,90,0,3,52,55,8,2,10,65,2,11,Louisiana,Shreveport,199311
7819,2011-2012,2011-12-01,2012-02-29,91,0,0,17,17,0,0,0,17,0,0,Louisiana,Shreveport,199311
7820,2012-2013,2012-12-01,2013-02-28,90,0,0,22,22,1,0,1,23,1,2,Louisiana,Shreveport,199311
7821,2013-2014,2013-12-01,2014-02-28,90,0,0,53,53,2,1,3,56,1,3,Louisiana,Shreveport,199311
7822,2014-2015,2014-12-01,2015-03-05,95,0,0,32,32,7,1,8,40,3,9,Louisiana,Shreveport,199311
7823,2015-2016,2015-12-01,2016-02-29,91,0,0,20,20,0,0,0,20,0,0,Louisiana,Shreveport,199311
7824,2016-2017,2016-12-01,2017-02-28,90,0,0,17,17,0,0,0,17,0,0,Louisiana,Shreveport,199311
7825,2017-2018,2017-12-01,2018-02-28,90,0,2,47,49,2,2,4,53,1,5,Louisiana,Shreveport,199311
7826,2018-2019,2018-12-01,2019-02-28,90,0,0,12,12,0,0,0,12,0,0,Louisiana,Shreveport,199311
7827,2019-2020,2019-12-01,2020-02-29,91,0,0,18,18,0,0,0,18,0,0,Louisiana,Shreveport,199311
7828,1953-1954,1953-12-01,1954-04-16,137,0,101,381,482,113,255,368,850,29,243,Maine,Bangor,33039
7829,1954-1955,1954-11-25,1955-03-29,125,2,116,397,513,148,571,719,1232,48,329,Maine,Bangor,33039
7830,1956-1957,1956-11-18,1957-04-09,143,4,122,469,591,127,312,439,1030,35,310,Maine,Bangor,33039
7831,1957-1958,1957-11-24,1958-04-28,156,5,75,350,425,162,434,596,1021,46,264,Maine,Bangor,33039
7832,1958-1959,1958-11-28,1959-03-27,120,2,153,526,679,139,464,603,1282,33,317,Maine,Bangor,33039
7833,1959-1960,1959-11-20,1960-04-12,145,0,81,364,445,143,506,649,1094,40,249,Maine,Bangor,33039
7834,1960-1961,1960-12-01,1961-05-03,154,3,130,493,623,108,489,597,1220,41,247,Maine,Bangor,33039
7835,1961-1962,1961-11-20,1962-04-26,158,1,128,483,611,169,451,620,1231,43,344,Maine,Bangor,33039
7836,1962-1963,1962-10-26,1963-05-11,198,1,132,576,708,253,1244,1497,2205,58,512,Maine,Bangor,33039
7837,1963-1964,1963-10-29,1964-04-23,178,1,129,508,637,126,341,467,1104,40,297,Maine,Bangor,33039
7838,1964-1965,1964-12-01,1965-04-23,144,0,170,535,705,110,385,495,1200,47,398,Maine,Bangor,33039
7839,1965-1966,1965-10-28,1966-05-10,195,0,104,478,582,141,443,584,1166,51,323,Maine,Bangor,33039
7840,1966-1967,1966-11-16,1967-05-08,174,0,119,524,643,112,563,675,1318,47,328,Maine,Bangor,33039
7841,1967-1968,1967-11-16,1968-03-22,128,0,162,526,688,98,424,522,1210,33,266,Maine,Bangor,33039
7842,1968-1969,1968-11-08,1969-04-20,164,0,112,463,575,168,1003,1171,1746,57,324,Maine,Bangor,33039
7843,1969-1970,1969-10-22,1970-04-09,170,0,152,531,683,107,196,303,986,33,221,Maine,Bangor,33039
7844,1970-1971,1970-10-17,1971-04-18,184,3,213,674,887,174,1050,1224,2111,57,498,Maine,Bangor,33039
7845,1972-1973,1972-11-14,1973-04-12,150,0,135,478,613,128,752,880,1493,43,325,Maine,Bangor,33039
7846,1973-1974,1973-11-06,1974-04-25,171,1,106,426,532,59,134,193,725,24,146,Maine,Bangor,33039
7847,1974-1975,1974-11-22,1975-04-10,140,0,100,472,572,100,517,617,1189,33,215,Maine,Bangor,33039
7848,1975-1976,1975-11-24,1976-04-12,141,0,138,525,663,113,342,455,1118,34,299,Maine,Bangor,33039
7849,1976-1977,1976-11-09,1977-04-10,153,0,131,521,652,122,772,894,1546,30,258,Maine,Bangor,33039
7850,1977-1978,1977-11-28,1978-04-12,136,0,177,497,674,117,615,732,1406,26,241,Maine,Bangor,33039
7851,1978-1979,1978-11-21,1979-04-10,141,0,144,418,562,72,236,308,870,27,171,Maine,Bangor,33039
7852,1979-1980,1979-10-09,1980-03-17,161,0,107,422,529,33,113,146,675,14,84,Maine,Bangor,33039
7853,1980-1981,1980-11-10,1981-03-19,130,0,141,490,631,71,296,367,998,27,229,Maine,Bangor,33039
7854,1981-1982,1981-11-25,1982-04-12,139,3,144,527,671,130,796,926,1597,43,334,Maine,Bangor,33039
7855,1982-1983,1982-11-28,1983-04-02,126,0,78,359,437,61,178,239,676,22,138,Maine,Bangor,33039
7856,1983-1984,1983-11-16,1984-04-10,147,0,126,438,564,104,267,371,935,31,249,Maine,Bangor,33039
7857,1984-1985,1984-11-19,1985-04-06,139,0,109,441,550,74,322,396,946,24,176,Maine,Bangor,33039
7858,1985-1986,1985-11-12,1986-03-28,137,3,109,475,584,91,469,560,1144,30,215,Maine,Bangor,33039
7859,1986-1987,1986-11-06,1987-04-29,175,3,96,461,557,125,767,892,1449,34,261,Maine,Bangor,33039
7860,1987-1988,1987-11-12,1988-04-17,158,0,102,486,588,110,447,557,1145,27,228,Maine,Bangor,33039
7861,1988-1989,1988-10-09,1989-04-23,197,6,105,500,605,84,200,284,889,27,172,Maine,Bangor,33039
7862,1989-1990,1989-11-21,1990-04-01,132,3,142,527,669,111,579,690,1359,28,255,Maine,Bangor,33039
7863,1990-1991,1990-11-19,1991-03-27,129,5,81,374,455,47,221,268,723,18,115,Maine,Bangor,33039
7864,1991-1992,1991-11-26,1992-04-17,144,0,135,521,656,74,258,332,988,27,213,Maine,Bangor,33039
7865,1992-1993,1992-11-19,1993-04-07,140,0,138,549,687,118,539,657,1344,33,326,Maine,Bangor,33039
7866,1993-1994,1993-11-25,1994-04-01,128,0,181,537,718,94,516,610,1328,27,275,Maine,Bangor,33039
7867,2002-2003,2002-11-02,2003-04-09,159,3,156,616,772,94,470,564,1336,30,225,Maine,Bangor,33039
7868,2003-2004,2003-12-01,2004-04-06,128,3,134,466,600,90,172,262,862,26,187,Maine,Bangor,33039
7869,2004-2005,2004-12-01,2005-04-12,133,0,117,512,629,113,450,563,1192,35,302,Maine,Bangor,33039
7870,2005-2006,2005-11-24,2006-04-06,134,0,84,398,482,56,119,175,657,25,162,Maine,Bangor,33039
7871,2006-2007,2006-12-01,2007-04-15,136,2,111,490,601,82,350,432,1033,22,151,Maine,Bangor,33039
7872,2007-2008,2007-11-24,2008-03-31,129,0,93,485,578,135,507,642,1220,38,297,Maine,Bangor,33039
7873,2008-2009,2008-11-20,2009-03-23,124,6,129,556,685,124,614,738,1423,30,283,Maine,Bangor,33039
7874,2009-2010,2009-12-01,2010-03-01,91,0,57,264,321,86,330,416,737,27,150,Maine,Bangor,33039
7875,2010-2011,2010-11-26,2011-04-06,132,3,96,466,562,154,701,855,1417,29,290,Maine,Bangor,33039
7876,2011-2012,2011-10-29,2012-03-29,153,0,59,350,409,71,170,241,650,25,151,Maine,Bangor,33039
7877,2012-2013,2012-11-07,2013-04-13,158,0,101,448,549,103,362,465,1014,29,217,Maine,Bangor,33039
7878,2013-2014,2013-11-24,2014-04-16,144,0,149,586,735,111,589,700,1435,37,306,Maine,Bangor,33039
7879,2014-2015,2014-11-02,2015-04-09,159,12,161,651,812,187,995,1182,1994,46,449,Maine,Bangor,33039
7880,2015-2016,2015-11-23,2016-04-04,134,0,65,352,417,63,226,289,706,20,152,Maine,Bangor,33039
7881,2016-2017,2016-11-27,2017-04-19,144,0,87,445,532,105,376,481,1013,30,247,Maine,Bangor,33039
7882,2017-2018,2017-12-01,2018-04-07,128,0,116,464,580,160,550,710,1290,36,316,Maine,Bangor,33039
7883,2018-2019,2018-11-09,2019-04-11,154,0,108,529,637,115,332,447,1084,43,278,Maine,Bangor,33039
7884,2019-2020,2019-11-08,2020-05-09,184,0,70,429,499,76,263,339,838,31,189,Maine,Bangor,33039
7885,1950-1951,1950-10-23,1951-04-26,186,0,187,597,784,114,762,876,1660,47,340,Maine,Caribou,8189
7886,1951-1952,1951-10-28,1952-04-20,176,0,223,697,920,189,1333,1522,2442,67,570,Maine,Caribou,8189
7887,1952-1953,1952-10-19,1953-04-21,185,3,197,594,791,157,595,752,1543,46,326,Maine,Caribou,8189
7888,1953-1954,1953-10-07,1954-04-16,192,0,206,633,839,153,754,907,1746,65,494,Maine,Caribou,8189
7889,1954-1955,1954-10-27,1955-04-20,176,0,231,656,887,251,1502,1753,2640,66,598,Maine,Caribou,8189
7890,1955-1956,1955-10-27,1956-04-25,182,0,226,683,909,133,809,942,1851,61,433,Maine,Caribou,8189
7891,1956-1957,1956-10-11,1957-05-03,205,1,257,777,1034,146,882,1028,2062,74,590,Maine,Caribou,8189
7892,1957-1958,1957-10-27,1958-04-20,176,3,155,518,673,179,938,1117,1790,56,417,Maine,Caribou,8189
7893,1958-1959,1958-10-12,1959-04-19,190,0,295,860,1155,171,1150,1321,2476,78,677,Maine,Caribou,8189
7894,1959-1960,1959-10-16,1960-04-25,193,0,192,645,837,195,974,1169,2006,81,516,Maine,Caribou,8189
7895,1960-1961,1960-11-07,1961-05-21,196,0,250,783,1033,209,1165,1374,2407,75,618,Maine,Caribou,8189
7896,1961-1962,1961-10-15,1962-04-24,192,0,213,668,881,106,359,465,1346,58,403,Maine,Caribou,8189
7897,1962-1963,1962-10-26,1963-04-25,182,0,246,785,1031,208,1291,1499,2530,66,610,Maine,Caribou,8189
7898,1963-1964,1963-10-29,1964-04-23,178,0,234,694,928,150,671,821,1749,50,389,Maine,Caribou,8189
7899,1964-1965,1964-10-13,1965-04-14,184,0,256,707,963,138,616,754,1717,56,466,Maine,Caribou,8189
7900,1965-1966,1965-10-27,1966-05-10,196,0,191,656,847,173,1130,1303,2150,82,526,Maine,Caribou,8189
7901,1966-1967,1966-10-20,1967-05-12,205,0,228,777,1005,161,1029,1190,2195,70,558,Maine,Caribou,8189
7902,1967-1968,1967-11-09,1968-04-05,149,0,263,717,980,156,844,1000,1980,54,488,Maine,Caribou,8189
7903,1968-1969,1968-11-08,1969-04-29,173,3,186,625,811,223,1480,1703,2514,76,560,Maine,Caribou,8189
7904,1969-1970,1969-10-20,1970-04-21,184,0,230,708,938,137,555,692,1630,63,462,Maine,Caribou,8189
7905,1970-1971,1970-10-17,1971-04-23,189,0,282,752,1034,190,1055,1245,2279,82,602,Maine,Caribou,8189
7906,1971-1972,1971-11-07,1972-04-27,173,0,311,897,1208,202,1133,1335,2543,77,757,Maine,Caribou,8189
7907,1972-1973,1972-10-24,1973-04-19,178,0,265,777,1042,215,1219,1434,2476,67,580,Maine,Caribou,8189
7908,1973-1974,1973-11-05,1974-05-25,202,1,245,752,997,168,569,737,1734,69,531,Maine,Caribou,8189
7909,1974-1975,1974-10-20,1975-04-29,192,0,228,762,990,184,951,1135,2125,75,574,Maine,Caribou,8189
7910,1975-1976,1975-11-15,1976-05-07,175,0,271,822,1093,192,996,1188,2281,67,654,Maine,Caribou,8189
7911,1976-1977,1976-10-22,1977-04-23,184,0,277,786,1063,208,1480,1688,2751,65,617,Maine,Caribou,8189
7912,1977-1978,1977-11-13,1978-05-01,170,0,266,687,953,168,1012,1180,2133,58,499,Maine,Caribou,8189
7913,1978-1979,1978-11-11,1979-04-19,160,0,250,627,877,179,1036,1215,2092,64,473,Maine,Caribou,8189
7914,1979-1980,1979-10-09,1980-04-22,197,0,204,639,843,110,676,786,1629,50,359,Maine,Caribou,8189
7915,1980-1981,1980-10-21,1981-05-17,209,0,237,683,920,186,812,998,1918,70,561,Maine,Caribou,8189
7916,1981-1982,1981-10-22,1982-05-01,192,0,252,721,973,221,1273,1494,2467,67,563,Maine,Caribou,8189
7917,1982-1983,1982-11-13,1983-04-12,151,0,182,570,752,124,457,581,1333,51,347,Maine,Caribou,8189
7918,1983-1984,1983-11-04,1984-05-04,183,0,250,699,949,196,1214,1410,2359,73,593,Maine,Caribou,8189
7919,1984-1985,1984-10-05,1985-05-14,222,0,233,725,958,138,892,1030,1988,57,441,Maine,Caribou,8189
7920,1985-1986,1985-11-10,1986-04-13,155,0,254,751,1005,152,829,981,1986,59,485,Maine,Caribou,8189
7921,1986-1987,1986-10-06,1987-04-30,207,0,232,722,954,129,1045,1174,2128,53,422,Maine,Caribou,8189
7922,1987-1988,1987-11-06,1988-04-25,172,0,210,679,889,148,948,1096,1985,58,420,Maine,Caribou,8189
7923,1988-1989,1988-10-05,1989-04-24,202,0,240,791,1031,130,870,1000,2031,67,472,Maine,Caribou,8189
7924,1989-1990,1989-10-04,1990-05-22,231,0,275,801,1076,181,1195,1376,2452,72,648,Maine,Caribou,8189
7925,1990-1991,1990-11-06,1991-04-19,165,0,195,658,853,141,1053,1194,2047,58,454,Maine,Caribou,8189
7926,1991-1992,1991-09-29,1992-04-14,199,0,274,772,1046,139,750,889,1935,58,499,Maine,Caribou,8189
7927,1992-1993,1992-10-19,1993-04-11,175,0,275,767,1042,125,760,885,1927,56,472,Maine,Caribou,8189
7928,1993-1994,1993-10-10,1994-04-25,198,0,311,817,1128,190,984,1174,2302,67,596,Maine,Caribou,8189
7929,1994-1995,1994-11-23,1995-05-07,166,0,217,645,862,193,986,1179,2041,56,485,Maine,Caribou,8189
7930,1995-1996,1995-11-02,1996-05-13,194,0,272,719,991,167,552,719,1710,67,489,Maine,Caribou,8189
7931,1996-1997,1996-10-30,1997-05-07,190,1,216,703,919,197,902,1099,2018,64,483,Maine,Caribou,8189
7932,1997-1998,1997-10-23,1998-04-25,185,3,187,634,821,186,1383,1569,2390,64,457,Maine,Caribou,8189
7933,1998-1999,1998-11-01,1999-04-24,175,3,177,603,780,194,688,882,1662,66,503,Maine,Caribou,8189
7934,1999-2000,1999-10-14,2000-04-27,197,3,188,623,811,165,783,948,1759,53,430,Maine,Caribou,8189
7935,2000-2001,2000-10-09,2001-04-21,195,0,237,693,930,193,962,1155,2085,63,496,Maine,Caribou,8189
7936,2001-2002,2001-11-11,2002-05-15,186,0,160,548,708,135,525,660,1368,63,441,Maine,Caribou,8189
7937,2002-2003,2002-10-19,2003-04-20,184,0,299,843,1142,170,1050,1220,2362,63,564,Maine,Caribou,8189
7938,2003-2004,2003-10-21,2004-04-26,189,0,240,673,913,152,488,640,1553,55,415,Maine,Caribou,8189
7939,2004-2005,2004-11-05,2005-04-29,176,3,244,701,945,186,770,956,1901,65,561,Maine,Caribou,8189
7940,2005-2006,2005-10-25,2006-04-06,164,0,184,544,728,146,712,858,1586,67,471,Maine,Caribou,8189
7941,2006-2007,2006-11-06,2007-05-17,193,0,210,651,861,156,567,723,1584,56,436,Maine,Caribou,8189
7942,2007-2008,2007-10-29,2008-04-19,174,0,237,759,996,284,1284,1568,2564,79,719,Maine,Caribou,8189
7943,2008-2009,2008-10-21,2009-04-13,175,6,246,759,1005,172,921,1093,2098,63,550,Maine,Caribou,8189
7944,2009-2010,2009-10-22,2010-04-10,171,0,135,435,570,109,448,557,1127,47,283,Maine,Caribou,8189
7945,2010-2011,2010-11-19,2011-04-22,155,0,188,573,761,153,604,757,1518,51,415,Maine,Caribou,8189
7946,2011-2012,2011-10-30,2012-04-27,181,0,156,568,724,153,629,782,1506,50,383,Maine,Caribou,8189
7947,2012-2013,2012-11-06,2013-04-14,160,0,186,572,758,161,534,695,1453,59,417,Maine,Caribou,8189
7948,2013-2014,2013-10-28,2014-04-25,180,0,280,780,1060,223,1074,1297,2357,79,710,Maine,Caribou,8189
7949,2014-2015,2014-11-01,2015-05-23,204,3,279,788,1067,212,1026,1238,2305,72,662,Maine,Caribou,8189
7950,2015-2016,2015-10-19,2016-05-16,211,0,144,549,693,145,649,794,1487,54,375,Maine,Caribou,8189
7951,2016-2017,2016-11-21,2017-04-23,154,0,191,596,787,192,1272,1464,2251,74,561,Maine,Caribou,8189
7952,2017-2018,2017-11-11,2018-04-25,166,0,205,647,852,202,1211,1413,2265,74,611,Maine,Caribou,8189
7953,2018-2019,2018-10-24,2019-04-25,184,0,244,755,999,240,1551,1791,2790,70,597,Maine,Caribou,8189
7954,2019-2020,2019-11-07,2020-05-12,188,0,159,646,805,223,1196,1419,2224,67,505,Maine,Caribou,8189
7955,1976-1977,1976-10-25,1977-04-30,188,2,183,678,861,178,1172,1350,2211,45,387,Maine,Dover,4213
7956,1977-1978,1977-11-13,1978-04-25,164,0,165,669,834,177,1170,1347,2181,49,417,Maine,Dover,4213
7957,1978-1979,1978-11-21,1979-04-17,148,0,184,575,759,185,1006,1191,1950,47,389,Maine,Dover,4213
7958,1979-1980,1979-10-10,1980-04-23,197,1,128,578,706,90,392,482,1188,32,203,Maine,Dover,4213
7959,1980-1981,1980-11-11,1981-04-25,166,4,181,635,816,112,546,658,1474,45,347,Maine,Dover,4213
7960,1981-1982,1981-10-24,1982-04-27,186,8,180,729,909,227,1732,1959,2868,56,475,Maine,Dover,4213
7961,1982-1983,1982-11-16,1983-04-14,150,3,103,503,606,122,463,585,1191,35,254,Maine,Dover,4213
7962,1983-1984,1983-11-15,1984-04-20,158,11,163,637,800,173,1030,1203,2003,45,401,Maine,Dover,4213
7963,1984-1985,1984-10-26,1985-04-15,172,9,142,645,787,162,978,1140,1927,39,342,Maine,Dover,4213
7964,1985-1986,1985-11-09,1986-05-06,179,5,170,689,859,141,902,1043,1902,42,375,Maine,Dover,4213
7965,1986-1987,1986-11-07,1987-05-01,176,15,166,649,815,114,1230,1344,2159,35,281,Maine,Dover,4213
7966,1987-1988,1987-11-07,1988-04-25,171,10,148,673,821,152,1165,1317,2138,37,365,Maine,Dover,4213
7967,1990-1991,1990-11-09,1991-04-18,161,11,145,555,700,131,870,1001,1701,31,275,Maine,Dover,4213
7968,1991-1992,1991-11-12,1992-04-18,159,6,192,665,857,107,771,878,1735,32,303,Maine,Dover,4213
7969,1992-1993,1992-11-08,1993-04-19,163,15,198,651,849,153,946,1099,1948,34,344,Maine,Dover,4213
7970,1993-1994,1993-11-01,1994-04-22,173,20,221,707,928,135,966,1101,2029,34,369,Maine,Dover,4213
7971,1994-1995,1994-11-24,1995-04-11,139,20,128,521,649,99,701,800,1449,29,235,Maine,Dover,4213
7972,1996-1997,1996-11-03,1997-05-08,187,2,145,628,773,151,945,1096,1869,36,322,Maine,Dover,4213
7973,1997-1998,1997-10-27,1998-04-07,163,17,94,499,593,122,1097,1219,1812,34,249,Maine,Dover,4213
7974,1998-1999,1998-11-20,1999-03-31,132,5,88,501,589,124,776,900,1489,30,307,Maine,Dover,4213
7975,2004-2005,2004-11-12,2005-04-13,153,10,184,595,779,121,783,904,1683,33,344,Maine,Dover,4213
7976,2008-2009,2008-11-20,2009-04-12,144,3,159,720,879,155,1093,1248,2127,32,373,Maine,Dover,4213
7977,2009-2010,2009-11-06,2010-03-28,143,10,92,391,483,64,603,667,1150,18,124,Maine,Dover,4213
7978,2010-2011,2010-10-31,2011-04-22,174,6,127,659,786,128,982,1110,1896,32,305,Maine,Dover,4213
7979,2011-2012,2011-11-23,2012-04-01,131,17,87,515,602,68,433,501,1103,17,151,Maine,Dover,4213
7980,2012-2013,2012-11-08,2013-04-14,158,15,111,507,618,75,605,680,1298,18,150,Maine,Dover,4213
7981,2013-2014,2013-11-14,2014-04-27,165,6,179,786,965,122,1307,1429,2394,33,338,Maine,Dover,4213
7982,2014-2015,2014-11-03,2015-04-20,169,1,186,790,976,115,1108,1223,2199,32,334,Maine,Dover,4213
7983,2015-2016,2015-11-23,2016-04-07,137,4,77,466,543,84,541,625,1168,24,213,Maine,Dover,4213
7984,2016-2017,2016-11-22,2017-04-16,146,0,107,573,680,145,1190,1335,2015,29,309,Maine,Dover,4213
7985,2017-2018,2017-11-11,2018-04-21,162,6,151,654,805,132,1082,1214,2019,26,286,Maine,Dover,4213
7986,2018-2019,2018-10-28,2019-04-21,176,9,137,780,917,125,1434,1559,2476,35,336,Maine,Dover,4213
7987,2019-2020,2019-11-09,2020-05-10,184,3,91,604,695,129,1013,1142,1837,36,286,Maine,Dover,4213
7988,1966-1967,1966-11-06,1967-05-08,184,8,115,702,817,115,797,912,1729,32,273,Maine,Farmington,7760
7989,1967-1968,1967-11-15,1968-03-28,135,7,143,693,836,113,876,989,1825,26,271,Maine,Farmington,7760
7990,1968-1969,1968-11-08,1969-04-20,164,0,130,706,836,241,1636,1877,2713,47,434,Maine,Farmington,7760
7991,1970-1971,1970-11-16,1971-04-17,153,0,187,794,981,225,1639,1864,2845,38,466,Maine,Farmington,7760
7992,1971-1972,1971-11-25,1972-04-21,149,0,150,732,882,180,1107,1287,2169,36,376,Maine,Farmington,7760
7993,1972-1973,1972-11-09,1973-04-11,154,11,134,635,769,142,1054,1196,1965,31,300,Maine,Farmington,7760
7994,1973-1974,1973-11-07,1974-04-25,170,0,120,650,770,90,200,290,1060,26,223,Maine,Farmington,7760
7995,1974-1975,1974-10-03,1975-04-22,202,0,106,740,846,154,1077,1231,2077,33,290,Maine,Farmington,7760
7996,1975-1976,1975-11-25,1976-04-13,141,1,179,775,954,159,1011,1170,2124,34,419,Maine,Farmington,7760
7997,1976-1977,1976-10-24,1977-04-11,170,1,160,702,862,154,1095,1249,2111,29,292,Maine,Farmington,7760
7998,1977-1978,1977-11-24,1978-04-22,150,0,160,695,855,179,1381,1560,2415,31,333,Maine,Farmington,7760
7999,1978-1979,1978-11-21,1979-04-16,147,0,181,678,859,159,1038,1197,2056,34,340,Maine,Farmington,7760
8000,1980-1981,1980-11-17,1981-03-28,132,0,162,692,854,63,333,396,1250,15,178,Maine,Farmington,7760
8001,1981-1982,1981-11-21,1982-04-18,149,1,186,748,934,159,1365,1524,2458,36,365,Maine,Farmington,7760
8002,1982-1983,1982-11-15,1983-04-11,148,14,95,528,623,78,261,339,962,21,156,Maine,Farmington,7760
8003,1983-1984,1983-11-15,1984-04-05,143,3,137,677,814,109,704,813,1627,19,207,Maine,Farmington,7760
8004,1984-1985,1984-11-20,1985-04-10,142,1,126,612,738,121,725,846,1584,30,280,Maine,Farmington,7760
8005,1985-1986,1985-11-13,1986-05-05,174,0,124,666,790,117,800,917,1707,25,243,Maine,Farmington,7760
8006,1986-1987,1986-11-06,1987-04-30,176,3,116,635,751,126,1216,1342,2093,24,234,Maine,Farmington,7760
8007,1987-1988,1987-11-07,1988-04-17,163,2,120,644,764,122,987,1109,1873,19,205,Maine,Farmington,7760
8008,1988-1989,1988-11-21,1989-04-17,148,4,143,691,834,102,694,796,1630,31,249,Maine,Farmington,7760
8009,1989-1990,1989-11-20,1990-04-06,138,3,165,691,856,140,1071,1211,2067,31,324,Maine,Farmington,7760
8010,1990-1991,1990-11-11,1991-03-28,138,0,104,536,640,100,592,692,1332,18,172,Maine,Farmington,7760
8011,1991-1992,1991-11-12,1992-04-17,158,3,144,620,764,107,575,682,1446,24,256,Maine,Farmington,7760
8012,1992-1993,1992-11-17,1993-04-11,146,5,154,663,817,177,798,975,1792,26,341,Maine,Farmington,7760
8013,1993-1994,1993-11-01,1994-04-08,159,12,193,753,946,144,782,926,1872,28,344,Maine,Farmington,7760
8014,1994-1995,1994-11-23,1995-04-06,135,6,116,558,674,116,511,627,1301,29,262,Maine,Farmington,7760
8015,1995-1996,1995-11-11,1996-04-15,157,1,174,675,849,195,956,1151,2000,43,416,Maine,Farmington,7760
8016,1996-1997,1996-11-14,1997-04-29,167,0,124,614,738,146,874,1020,1758,30,300,Maine,Farmington,7760
8017,1997-1998,1997-10-23,1998-03-30,159,0,85,509,594,113,666,779,1373,31,237,Maine,Farmington,7760
8018,1998-1999,1998-11-18,1999-03-28,131,2,82,491,573,115,640,755,1328,24,249,Maine,Farmington,7760
8019,1999-2000,1999-11-13,2000-04-22,162,3,104,475,579,93,537,630,1209,19,165,Maine,Farmington,7760
8020,2001-2002,2001-10-31,2002-05-13,195,2,50,439,489,122,600,722,1211,42,262,Maine,Farmington,7760
8021,2002-2003,2002-11-01,2003-04-06,157,9,163,657,820,101,648,749,1569,26,204,Maine,Farmington,7760
8022,2003-2004,2003-11-09,2004-04-13,157,1,151,567,718,122,898,1020,1738,23,225,Maine,Farmington,7760
8023,2004-2005,2004-11-21,2005-04-13,144,0,137,555,692,144,845,989,1681,41,383,Maine,Farmington,7760
8024,2005-2006,2005-10-25,2006-04-04,162,7,92,463,555,75,245,320,875,23,165,Maine,Farmington,7760
8025,2006-2007,2006-12-01,2007-04-17,138,8,101,503,604,140,637,777,1381,28,237,Maine,Farmington,7760
8026,2007-2008,2007-11-20,2008-04-16,149,0,107,555,662,196,1250,1446,2108,45,404,Maine,Farmington,7760
8027,2008-2009,2008-11-19,2009-04-01,134,8,133,605,738,150,990,1140,1878,32,320,Maine,Farmington,7760
8028,2009-2010,2009-11-05,2010-04-17,164,1,71,374,445,84,504,588,1033,27,153,Maine,Farmington,7760
8029,2012-2013,2012-11-08,2013-04-12,156,0,99,464,563,126,619,745,1308,37,264,Maine,Farmington,7760
8030,2013-2014,2013-11-10,2014-04-16,158,0,178,674,852,157,1085,1242,2094,45,392,Maine,Farmington,7760
8031,2014-2015,2014-11-13,2015-04-11,150,0,175,673,848,146,1186,1332,2180,42,364,Maine,Farmington,7760
8032,2015-2016,2015-11-23,2016-04-26,156,0,68,422,490,65,358,423,913,28,178,Maine,Farmington,7760
8033,2016-2017,2016-11-24,2017-04-13,141,0,114,504,618,175,1117,1292,1910,41,371,Maine,Farmington,7760
8034,2017-2018,2017-11-20,2018-04-17,149,0,140,532,672,138,814,952,1624,36,328,Maine,Farmington,7760
8035,2018-2019,2018-10-23,2019-04-18,178,0,135,641,776,163,1379,1542,2318,44,348,Maine,Farmington,7760
8036,2019-2020,2019-11-08,2020-05-09,184,0,80,501,581,121,676,797,1378,43,271,Maine,Farmington,7760
8037,1955-1956,1955-11-19,1956-03-31,134,10,164,758,922,75,773,848,1770,17,164,Maine,Fort Kent,4097
8038,1957-1958,1957-10-28,1958-04-13,168,2,128,577,705,167,1107,1274,1979,40,333,Maine,Fort Kent,4097
8039,1961-1962,1961-10-15,1962-04-18,186,6,197,744,941,75,584,659,1600,32,252,Maine,Fort Kent,4097
8040,1962-1963,1962-10-25,1963-04-22,180,0,216,909,1125,173,1451,1624,2749,47,459,Maine,Fort Kent,4097
8041,1963-1964,1963-10-29,1964-04-12,167,0,190,757,947,114,837,951,1898,36,250,Maine,Fort Kent,4097
8042,1964-1965,1964-11-12,1965-04-13,153,0,227,747,974,98,654,752,1726,45,397,Maine,Fort Kent,4097
8043,1965-1966,1965-11-02,1966-05-07,187,0,165,713,878,162,1269,1431,2309,48,385,Maine,Fort Kent,4097
8044,1966-1967,1966-11-14,1967-05-08,176,6,200,861,1061,136,970,1106,2167,44,421,Maine,Fort Kent,4097
8045,1967-1968,1967-11-14,1968-03-31,139,4,243,776,1019,96,985,1081,2100,35,326,Maine,Fort Kent,4097
8046,1973-1974,1973-11-05,1974-05-08,185,1,259,898,1157,148,1127,1275,2432,34,318,Maine,Fort Kent,4097
8047,1974-1975,1974-10-21,1975-04-29,191,10,229,935,1164,197,1334,1531,2695,39,418,Maine,Fort Kent,4097
8048,1976-1977,1976-10-26,1977-04-26,183,4,278,955,1233,226,1634,1860,3093,43,535,Maine,Fort Kent,4097
8049,1977-1978,1977-11-14,1978-05-01,169,2,248,865,1113,163,1020,1183,2296,38,371,Maine,Fort Kent,4097
8050,1978-1979,1978-11-11,1979-04-14,155,1,256,791,1047,161,1081,1242,2289,37,386,Maine,Fort Kent,4097
8051,1979-1980,1979-11-16,1980-04-09,146,1,207,788,995,98,761,859,1854,25,263,Maine,Fort Kent,4097
8052,1980-1981,1980-10-21,1981-04-16,178,0,252,855,1107,108,674,782,1889,26,292,Maine,Fort Kent,4097
8053,1981-1982,1981-10-22,1982-05-01,192,12,248,860,1108,191,1160,1351,2459,43,434,Maine,Fort Kent,4097
8054,1983-1984,1983-11-14,1984-04-24,163,5,243,870,1113,180,1435,1615,2728,32,407,Maine,Fort Kent,4097
8055,1984-1985,1984-11-14,1985-04-18,156,7,266,854,1120,102,815,917,2037,26,298,Maine,Fort Kent,4097
8056,1985-1986,1985-11-10,1986-04-12,154,10,245,783,1028,136,690,826,1854,36,339,Maine,Fort Kent,4097
8057,1988-1989,1988-11-14,1989-04-24,162,15,248,933,1181,131,1027,1158,2339,44,428,Maine,Fort Kent,4097
8058,1989-1990,1989-11-05,1990-04-15,162,15,303,884,1187,149,1123,1272,2459,41,456,Maine,Fort Kent,4097
8059,1990-1991,1990-11-06,1991-04-22,168,10,194,815,1009,124,1278,1402,2411,30,297,Maine,Fort Kent,4097
8060,1991-1992,1991-11-08,1992-04-15,160,7,270,896,1166,98,735,833,1999,31,305,Maine,Fort Kent,4097
8061,1992-1993,1992-11-02,1993-04-10,160,7,258,964,1222,103,782,885,2107,30,314,Maine,Fort Kent,4097
8062,1997-1998,1997-10-24,1998-04-13,172,15,201,725,926,165,1156,1321,2247,42,369,Maine,Fort Kent,4097
8063,1998-1999,1998-11-13,1999-04-15,154,8,185,700,885,149,993,1142,2027,39,393,Maine,Fort Kent,4097
8064,2005-2006,2005-10-26,2006-04-11,168,17,216,670,886,149,1009,1158,2044,47,440,Maine,Fort Kent,4097
8065,2006-2007,2006-11-06,2007-05-17,193,5,207,757,964,155,863,1018,1982,39,353,Maine,Fort Kent,4097
8066,2007-2008,2007-10-30,2008-04-22,176,1,261,897,1158,240,1440,1680,2838,62,671,Maine,Fort Kent,4097
8067,2008-2009,2008-10-22,2009-04-13,174,7,264,941,1205,156,1131,1287,2492,35,413,Maine,Fort Kent,4097
8068,2009-2010,2009-10-23,2010-04-27,187,16,143,512,655,110,823,933,1588,32,225,Maine,Fort Kent,4097
8069,2010-2011,2010-11-20,2011-04-22,154,16,217,700,917,163,779,942,1859,41,431,Maine,Fort Kent,4097
8070,2012-2013,2012-11-07,2013-04-16,161,4,218,716,934,169,773,942,1876,49,476,Maine,Fort Kent,4097
8071,2013-2014,2013-10-29,2014-04-17,171,4,337,968,1305,180,1113,1293,2598,52,545,Maine,Fort Kent,4097
8072,2014-2015,2014-11-03,2015-04-21,170,6,313,942,1255,122,793,915,2170,33,338,Maine,Fort Kent,4097
8073,2015-2016,2015-11-18,2016-04-17,152,0,183,657,840,120,812,932,1772,32,320,Maine,Fort Kent,4097
8074,2016-2017,2016-11-22,2017-04-23,153,2,237,724,961,162,1093,1255,2216,38,395,Maine,Fort Kent,4097
8075,2017-2018,2017-11-08,2018-04-24,168,6,258,805,1063,183,1168,1351,2414,39,407,Maine,Fort Kent,4097
8076,2018-2019,2018-10-28,2019-04-15,170,4,285,879,1164,229,1229,1458,2622,46,556,Maine,Fort Kent,4097
8077,2019-2020,2019-11-10,2020-05-13,186,4,207,818,1025,187,1123,1310,2335,43,433,Maine,Fort Kent,4097
8078,1973-1974,1973-11-06,1974-04-27,173,5,237,735,972,128,624,752,1724,41,369,Maine,Jackman,862
8079,1974-1975,1974-11-15,1975-04-28,165,1,198,758,956,195,1332,1527,2483,45,423,Maine,Jackman,862
8080,1975-1976,1975-10-18,1976-05-04,200,2,236,841,1077,214,859,1073,2150,52,588,Maine,Jackman,862
8081,1976-1977,1976-10-25,1977-04-25,183,1,268,770,1038,175,944,1119,2157,57,512,Maine,Jackman,862
8082,1977-1978,1977-11-14,1978-05-04,172,13,239,807,1046,176,1352,1528,2574,39,443,Maine,Jackman,862
8083,1978-1979,1978-11-21,1979-04-13,144,5,259,705,964,173,978,1151,2115,40,415,Maine,Jackman,862
8084,1979-1980,1979-10-10,1980-04-06,180,7,195,699,894,95,297,392,1286,33,280,Maine,Jackman,862
8085,1980-1981,1980-10-22,1981-04-22,183,8,224,803,1027,109,583,692,1719,37,331,Maine,Jackman,862
8086,1981-1982,1981-10-24,1982-04-18,177,3,246,837,1083,212,1533,1745,2828,53,510,Maine,Jackman,862
8087,1982-1983,1982-11-15,1983-04-13,150,7,150,604,754,103,355,458,1212,29,209,Maine,Jackman,862
8088,1983-1984,1983-11-13,1984-05-05,175,5,222,787,1009,157,801,958,1967,41,437,Maine,Jackman,862
8089,1984-1985,1984-10-26,1985-04-18,175,9,197,819,1016,141,550,691,1707,43,417,Maine,Jackman,862
8090,1985-1986,1985-11-09,1986-05-05,178,8,197,813,1010,184,803,987,1997,51,508,Maine,Jackman,862
8091,1988-1989,1988-11-21,1989-04-15,146,12,169,872,1041,125,975,1100,2141,30,312,Maine,Jackman,862
8092,1990-1991,1990-11-07,1991-04-21,166,4,142,766,908,155,1040,1195,2103,35,367,Maine,Jackman,862
8093,1992-1993,1992-10-26,1993-04-24,181,10,221,858,1079,178,1035,1213,2292,35,427,Maine,Jackman,862
8094,1994-1995,1994-11-23,1995-05-08,167,9,181,679,860,121,719,840,1700,33,312,Maine,Jackman,862
8095,1995-1996,1995-11-10,1996-04-18,161,3,249,781,1030,232,1118,1350,2380,47,482,Maine,Jackman,862
8096,1996-1997,1996-11-04,1997-05-08,186,2,205,741,946,174,1125,1299,2245,43,405,Maine,Jackman,862
8097,1997-1998,1997-10-27,1998-04-21,177,2,144,668,812,168,1133,1301,2113,47,376,Maine,Jackman,862
8098,1998-1999,1998-11-09,1999-04-06,149,1,140,586,726,122,726,848,1574,31,296,Maine,Jackman,862
8099,1999-2000,1999-10-05,2000-04-27,206,6,183,678,861,156,917,1073,1934,33,313,Maine,Jackman,862
8100,2000-2001,2000-10-10,2001-04-22,195,4,218,793,1011,237,1593,1830,2841,46,481,Maine,Jackman,862
8101,2001-2002,2001-11-01,2002-04-30,181,6,114,546,660,153,788,941,1601,42,349,Maine,Jackman,862
8102,2002-2003,2002-11-02,2003-04-25,175,5,269,807,1076,117,910,1027,2103,33,272,Maine,Jackman,862
8103,2003-2004,2003-10-21,2004-05-05,198,11,230,733,963,144,897,1041,2004,38,323,Maine,Jackman,862
8104,2004-2005,2004-11-05,2005-04-08,155,6,202,721,923,159,940,1099,2022,37,401,Maine,Jackman,862
8105,2005-2006,2005-10-26,2006-04-09,166,6,180,590,770,145,705,850,1620,46,389,Maine,Jackman,862
8106,2006-2007,2006-11-06,2007-04-28,174,2,203,668,871,179,924,1103,1974,28,306,Maine,Jackman,862
8107,2007-2008,2007-11-09,2008-04-30,174,6,191,705,896,245,1470,1715,2611,55,539,Maine,Jackman,862
8108,2008-2009,2008-10-30,2009-04-18,171,4,244,798,1042,171,1237,1408,2450,28,370,Maine,Jackman,862
8109,2009-2010,2009-10-22,2010-04-18,179,3,153,499,652,145,800,945,1597,32,276,Maine,Jackman,862
8110,2010-2011,2010-10-31,2011-04-28,180,0,208,689,897,183,1140,1323,2220,37,401,Maine,Jackman,862
8111,2011-2012,2011-10-30,2012-03-31,154,0,129,554,683,118,573,691,1374,37,281,Maine,Jackman,862
8112,2012-2013,2012-10-14,2013-04-19,188,0,186,648,834,167,1047,1214,2048,40,381,Maine,Jackman,862
8113,2013-2014,2013-11-10,2014-04-29,171,0,281,850,1131,158,1245,1403,2534,42,397,Maine,Jackman,862
8114,2014-2015,2014-11-07,2015-04-25,170,1,269,864,1133,163,906,1069,2202,56,492,Maine,Jackman,862
8115,2015-2016,2015-10-17,2016-04-10,177,2,136,605,741,103,297,400,1141,40,315,Maine,Jackman,862
8116,2016-2017,2016-10-28,2017-04-22,177,0,193,685,878,162,653,815,1693,53,462,Maine,Jackman,862
8117,2017-2018,2017-11-08,2018-04-22,166,0,257,885,1142,142,753,895,2037,46,474,Maine,Jackman,862
8118,2018-2019,2018-10-24,2019-05-14,203,0,232,912,1144,199,1205,1404,2548,64,587,Maine,Jackman,862
8119,2019-2020,2019-11-09,2020-05-09,183,0,172,782,954,146,839,985,1939,45,403,Maine,Jackman,862
8120,1950-1951,1950-11-21,1951-03-23,123,0,51,307,358,66,119,185,543,25,161,Maine,Portland,583776
8121,1951-1952,1951-11-01,1952-03-24,145,0,57,423,480,140,392,532,1012,28,260,Maine,Portland,583776
8122,1952-1953,1952-11-09,1953-04-14,157,0,38,316,354,48,65,113,467,25,121,Maine,Portland,583776
8123,1953-1954,1953-11-07,1954-04-16,161,0,67,390,457,72,136,208,665,28,192,Maine,Portland,583776
8124,1954-1955,1954-11-25,1955-03-28,124,0,64,355,419,80,139,219,638,33,209,Maine,Portland,583776
8125,1955-1956,1955-11-11,1956-04-24,166,0,69,500,569,159,609,768,1337,47,314,Maine,Portland,583776
8126,1956-1957,1956-11-18,1957-04-10,144,0,82,448,530,127,306,433,963,32,276,Maine,Portland,583776
8127,1957-1958,1957-11-26,1958-04-28,154,0,42,335,377,129,358,487,864,36,217,Maine,Portland,583776
8128,1958-1959,1958-11-28,1959-03-21,114,0,105,479,584,87,255,342,926,28,235,Maine,Portland,583776
8129,1959-1960,1959-10-19,1960-04-01,166,3,44,373,417,135,438,573,990,37,231,Maine,Portland,583776
8130,1960-1961,1960-12-01,1961-04-15,136,0,91,507,598,109,385,494,1092,28,231,Maine,Portland,583776
8131,1961-1962,1961-10-15,1962-04-25,193,0,87,481,568,129,475,604,1172,41,285,Maine,Portland,583776
8132,1962-1963,1962-10-26,1963-04-24,181,0,80,513,593,116,633,749,1342,40,260,Maine,Portland,583776
8133,1963-1964,1963-10-30,1964-04-04,158,0,80,483,563,116,369,485,1048,40,305,Maine,Portland,583776
8134,1964-1965,1964-12-01,1965-04-18,139,0,85,417,502,81,248,329,831,33,231,Maine,Portland,583776
8135,1965-1966,1965-11-01,1966-05-10,191,0,59,426,485,116,563,679,1164,38,202,Maine,Portland,583776
8136,1966-1967,1966-12-01,1967-05-07,158,0,75,473,548,147,687,834,1382,40,297,Maine,Portland,583776
8137,1967-1968,1967-11-15,1968-03-17,124,0,93,464,557,86,392,478,1035,28,205,Maine,Portland,583776
8138,1968-1969,1968-11-08,1969-03-30,143,0,61,374,435,155,529,684,1119,35,226,Maine,Portland,583776
8139,1969-1970,1969-10-22,1970-04-02,163,0,74,406,480,97,337,434,914,33,194,Maine,Portland,583776
8140,1970-1971,1970-12-01,1971-04-16,137,0,141,500,641,190,971,1161,1802,39,369,Maine,Portland,583776
8141,1971-1972,1971-11-22,1972-04-14,145,0,85,443,528,127,289,416,944,39,288,Maine,Portland,583776
8142,1972-1973,1972-11-05,1973-04-10,157,0,85,365,450,102,539,641,1091,36,226,Maine,Portland,583776
8143,1973-1974,1973-12-01,1974-04-12,133,0,65,320,385,59,162,221,606,25,140,Maine,Portland,583776
8144,1974-1975,1974-11-21,1975-04-05,136,0,36,363,399,72,242,314,713,31,152,Maine,Portland,583776
8145,1975-1976,1975-11-24,1976-04-12,141,0,103,446,549,98,359,457,1006,31,264,Maine,Portland,583776
8146,1976-1977,1976-11-10,1977-04-08,150,0,115,507,622,128,717,845,1467,33,277,Maine,Portland,583776
8147,1977-1978,1977-11-27,1978-04-01,126,0,87,441,528,102,506,608,1136,29,241,Maine,Portland,583776
8148,1978-1979,1978-11-21,1979-04-10,141,0,113,417,530,128,516,644,1174,31,252,Maine,Portland,583776
8149,1979-1980,1979-10-10,1980-03-18,161,0,67,405,472,41,122,163,635,13,85,Maine,Portland,583776
8150,1980-1981,1980-11-17,1981-03-21,125,0,96,437,533,61,244,305,838,25,170,Maine,Portland,583776
8151,1981-1982,1981-12-01,1982-04-15,136,0,89,425,514,122,770,892,1406,42,284,Maine,Portland,583776
8152,1982-1983,1982-11-26,1983-03-28,123,0,51,287,338,69,224,293,631,23,137,Maine,Portland,583776
8153,1983-1984,1983-12-01,1984-04-01,123,0,87,358,445,99,284,383,828,25,209,Maine,Portland,583776
8154,1984-1985,1984-12-01,1985-04-05,126,0,74,369,443,76,290,366,809,33,235,Maine,Portland,583776
8155,1985-1986,1985-11-16,1986-03-21,126,0,66,375,441,75,361,436,877,32,193,Maine,Portland,583776
8156,1986-1987,1986-11-05,1987-04-29,176,0,52,411,463,107,752,859,1322,32,195,Maine,Portland,583776
8157,1987-1988,1987-11-06,1988-04-16,163,0,57,386,443,87,260,347,790,26,162,Maine,Portland,583776
8158,1988-1989,1988-12-01,1989-04-10,131,0,68,363,431,50,74,124,555,28,134,Maine,Portland,583776
8159,1989-1990,1989-11-20,1990-03-31,132,0,88,427,515,97,352,449,964,26,205,Maine,Portland,583776
8160,1990-1991,1990-11-12,1991-03-26,135,0,42,276,318,48,90,138,456,20,104,Maine,Portland,583776
8161,1991-1992,1991-12-01,1992-04-18,140,0,65,376,441,86,178,264,705,33,212,Maine,Portland,583776
8162,1992-1993,1992-11-17,1993-04-27,162,0,85,433,518,162,441,603,1121,38,314,Maine,Portland,583776
8163,1993-1994,1993-10-30,1994-03-27,149,0,124,442,566,114,487,601,1167,38,308,Maine,Portland,583776
8164,1994-1995,1994-11-23,1995-04-05,134,0,64,325,389,53,213,266,655,19,133,Maine,Portland,583776
8165,1995-1996,1995-11-25,1996-04-14,142,0,96,421,517,174,491,665,1182,44,354,Maine,Portland,583776
8166,1997-1998,1997-11-14,1998-03-25,132,5,35,283,318,79,188,267,585,19,126,Maine,Portland,583776
8167,1998-1999,1998-12-01,1999-03-20,110,0,46,296,342,70,173,243,585,22,159,Maine,Portland,583776
8168,2000-2001,2000-11-24,2001-04-08,136,6,73,409,482,135,655,790,1272,33,239,Maine,Portland,583776
8169,2001-2002,2001-12-01,2002-04-25,146,0,10,235,245,46,95,141,386,19,86,Maine,Portland,583776
8170,2002-2003,2002-11-16,2003-04-06,142,0,106,454,560,97,423,520,1080,31,213,Maine,Portland,583776
8171,2003-2004,2003-12-01,2004-04-05,127,0,88,370,458,69,128,197,655,19,124,Maine,Portland,583776
8172,2004-2005,2004-12-01,2005-03-29,119,0,81,370,451,143,543,686,1137,31,298,Maine,Portland,583776
8173,2005-2006,2005-11-23,2006-04-05,134,0,47,291,338,70,148,218,556,25,145,Maine,Portland,583776
8174,2006-2007,2006-12-01,2007-04-15,136,0,80,344,424,81,226,307,731,22,144,Maine,Portland,583776
8175,2007-2008,2007-11-24,2008-03-30,128,4,48,332,380,145,508,653,1033,34,245,Maine,Portland,583776
8176,2008-2009,2008-11-20,2009-03-23,124,0,79,408,487,110,423,533,1020,28,223,Maine,Portland,583776
8177,2009-2010,2009-12-01,2010-03-26,116,0,39,239,278,52,153,205,483,19,96,Maine,Portland,583776
8178,2010-2011,2010-11-26,2011-04-04,130,0,59,364,423,113,564,677,1100,29,208,Maine,Portland,583776
8179,2011-2012,2011-10-29,2012-03-28,152,0,30,250,280,66,131,197,477,24,127,Maine,Portland,583776
8180,2012-2013,2012-11-07,2013-04-12,157,0,48,298,346,138,374,512,858,29,215,Maine,Portland,583776
8181,2013-2014,2013-11-24,2014-04-16,144,0,103,446,549,122,501,623,1172,33,266,Maine,Portland,583776
8182,2014-2015,2014-11-02,2015-04-10,160,0,89,446,535,134,656,790,1325,45,303,Maine,Portland,583776
8183,2015-2016,2015-11-30,2016-04-27,150,0,36,253,289,76,191,267,556,24,148,Maine,Portland,583776
8184,2016-2017,2016-11-20,2017-04-06,138,0,51,302,353,137,317,454,807,31,230,Maine,Portland,583776
8185,2017-2018,2017-11-13,2018-04-15,154,0,81,367,448,133,412,545,993,37,254,Maine,Portland,583776
8186,2018-2019,2018-11-15,2019-04-12,149,0,63,367,430,96,320,416,846,35,178,Maine,Portland,583776
8187,2019-2020,2019-11-12,2020-04-10,151,0,28,257,285,86,305,391,676,26,140,Maine,Portland,583776
8188,1950-1951,1950-11-25,1951-02-28,96,0,20,138,158,10,7,17,175,6,26,Maryland,Baltimore,620961
8189,1951-1952,1951-12-01,1952-03-03,94,0,6,104,110,21,15,36,146,5,29,Maryland,Baltimore,620961
8190,1952-1953,1952-11-29,1953-03-09,101,0,0,84,84,17,11,28,112,7,27,Maryland,Baltimore,620961
8191,1953-1954,1953-11-06,1954-03-11,126,0,14,144,158,29,39,68,226,8,49,Maryland,Baltimore,620961
8192,1954-1955,1954-12-01,1955-03-18,108,0,16,159,175,18,8,26,201,11,33,Maryland,Baltimore,620961
8193,1955-1956,1955-11-19,1956-03-28,131,0,15,177,192,27,35,62,254,12,46,Maryland,Baltimore,620961
8194,1956-1957,1956-12-01,1957-04-13,134,3,12,117,129,27,19,46,175,17,57,Maryland,Baltimore,620961
8195,1957-1958,1957-12-01,1958-03-23,113,0,24,158,182,58,95,153,335,15,79,Maryland,Baltimore,620961
8196,1958-1959,1958-11-30,1959-04-12,134,0,23,217,240,7,3,10,250,6,20,Maryland,Baltimore,620961
8197,1959-1960,1959-11-18,1960-03-22,126,0,14,159,173,51,66,117,290,15,87,Maryland,Baltimore,620961
8198,1960-1961,1960-11-07,1961-02-28,114,0,38,229,267,67,176,243,510,16,120,Maryland,Baltimore,620961
8199,1961-1962,1961-11-19,1962-03-09,111,0,19,191,210,53,31,84,294,21,100,Maryland,Baltimore,620961
8200,1962-1963,1962-11-05,1963-03-11,127,0,38,249,287,29,61,90,377,14,64,Maryland,Baltimore,620961
8201,1963-1964,1963-12-01,1964-04-01,123,0,22,198,220,73,67,140,360,18,109,Maryland,Baltimore,620961
8202,1964-1965,1964-12-01,1965-03-21,111,0,19,187,206,27,36,63,269,8,57,Maryland,Baltimore,620961
8203,1965-1966,1965-12-01,1966-02-28,90,0,24,168,192,49,87,136,328,11,89,Maryland,Baltimore,620961
8204,1966-1967,1966-12-01,1967-03-21,111,0,18,169,187,65,79,144,331,17,109,Maryland,Baltimore,620961
8205,1967-1968,1967-11-30,1968-03-23,115,0,24,187,211,34,29,63,274,12,53,Maryland,Baltimore,620961
8206,1968-1969,1968-11-10,1969-03-07,118,0,10,139,149,25,9,34,183,10,34,Maryland,Baltimore,620961
8207,1969-1970,1969-12-01,1970-03-18,108,0,26,170,196,31,40,71,267,14,64,Maryland,Baltimore,620961
8208,1970-1971,1970-12-01,1971-03-04,94,0,23,127,150,18,16,34,184,9,32,Maryland,Baltimore,620961
8209,1971-1972,1971-11-24,1972-04-08,137,0,7,124,131,23,14,37,168,12,37,Maryland,Baltimore,620961
8210,1972-1973,1972-12-01,1973-02-28,90,0,9,121,130,2,1,3,133,1,2,Maryland,Baltimore,620961
8211,1973-1974,1973-12-01,1974-02-28,90,0,11,105,116,26,27,53,169,7,40,Maryland,Baltimore,620961
8212,1974-1975,1974-12-01,1975-03-10,100,0,3,92,95,17,8,25,120,7,26,Maryland,Baltimore,620961
8213,1975-1976,1975-12-01,1976-03-11,102,0,14,127,141,18,8,26,167,8,32,Maryland,Baltimore,620961
8214,1976-1977,1976-11-12,1977-02-28,109,0,37,236,273,17,27,44,317,12,48,Maryland,Baltimore,620961
8215,1977-1978,1977-11-27,1978-03-16,110,0,26,202,228,50,75,125,353,20,92,Maryland,Baltimore,620961
8216,1978-1979,1978-11-26,1979-02-28,95,0,33,168,201,62,98,160,361,16,120,Maryland,Baltimore,620961
8217,1979-1980,1979-10-10,1980-03-14,157,0,18,154,172,23,24,47,219,13,59,Maryland,Baltimore,620961
8218,1980-1981,1980-12-01,1981-03-05,95,0,30,190,220,10,4,14,234,8,29,Maryland,Baltimore,620961
8219,1981-1982,1981-12-01,1982-03-07,97,0,28,174,202,35,92,127,329,16,80,Maryland,Baltimore,620961
8220,1982-1983,1982-12-01,1983-02-28,90,0,8,112,120,44,76,120,240,6,57,Maryland,Baltimore,620961
8221,1983-1984,1983-12-01,1984-03-13,104,0,30,176,206,21,41,62,268,8,43,Maryland,Baltimore,620961
8222,1984-1985,1984-12-01,1985-04-09,130,0,15,139,154,17,14,31,185,12,44,Maryland,Baltimore,620961
8223,1985-1986,1985-12-01,1986-03-08,98,0,19,175,194,25,25,50,244,14,64,Maryland,Baltimore,620961
8224,1986-1987,1986-12-01,1987-02-28,90,0,12,123,135,52,88,140,275,9,75,Maryland,Baltimore,620961
8225,1987-1988,1987-11-11,1988-02-29,111,0,20,159,179,30,49,79,258,10,54,Maryland,Baltimore,620961
8226,1988-1989,1988-12-01,1989-03-08,98,0,15,120,135,14,7,21,156,10,34,Maryland,Baltimore,620961
8227,1989-1990,1989-11-22,1990-04-06,136,0,22,173,195,27,63,90,285,13,53,Maryland,Baltimore,620961
8228,1990-1991,1990-12-01,1991-03-13,103,0,5,103,108,14,8,22,130,5,20,Maryland,Baltimore,620961
8229,1991-1992,1991-12-01,1992-02-29,91,0,10,122,132,7,4,11,143,4,18,Maryland,Baltimore,620961
8230,1992-1993,1992-12-01,1993-03-19,109,0,12,144,156,35,33,68,224,12,57,Maryland,Baltimore,620961
8231,1993-1994,1993-12-01,1994-03-18,108,0,33,188,221,28,39,67,288,14,69,Maryland,Baltimore,620961
8232,1994-1995,1994-11-23,1995-03-08,106,0,8,102,110,14,22,36,146,5,18,Maryland,Baltimore,620961
8233,1995-1996,1995-11-11,1996-03-09,120,0,26,172,198,89,137,226,424,18,134,Maryland,Baltimore,620961
8234,1996-1997,1996-11-14,1997-03-31,138,0,10,156,166,22,11,33,199,10,35,Maryland,Baltimore,620961
8235,1997-1998,1997-12-01,1998-03-21,111,0,0,91,91,6,0,6,97,5,11,Maryland,Baltimore,620961
8236,1998-1999,1998-12-01,1999-03-15,105,0,14,137,151,21,28,49,200,6,35,Maryland,Baltimore,620961
8237,1999-2000,1999-12-01,2000-04-09,131,0,19,149,168,34,73,107,275,7,51,Maryland,Baltimore,620961
8238,2000-2001,2000-12-01,2001-02-28,90,0,10,146,156,11,15,26,182,5,24,Maryland,Baltimore,620961
8239,2001-2002,2001-12-01,2002-02-28,90,0,1,90,91,3,3,6,97,1,4,Maryland,Baltimore,620961
8240,2002-2003,2002-12-01,2003-03-30,120,0,20,198,218,76,129,205,423,19,122,Maryland,Baltimore,620961
8241,2003-2004,2003-12-01,2004-03-16,107,2,22,166,188,26,64,90,278,12,58,Maryland,Baltimore,620961
8242,2004-2005,2004-12-01,2005-03-03,93,0,17,130,147,27,31,58,205,11,51,Maryland,Baltimore,620961
8243,2005-2006,2005-11-23,2006-02-28,98,0,3,115,118,27,24,51,169,8,38,Maryland,Baltimore,620961
8244,2006-2007,2006-12-01,2007-04-07,128,0,15,156,171,16,13,29,200,8,34,Maryland,Baltimore,620961
8245,2007-2008,2007-12-01,2008-02-29,91,0,7,108,115,12,10,22,137,5,23,Maryland,Baltimore,620961
8246,2008-2009,2008-12-01,2009-03-05,95,0,17,158,175,15,14,29,204,8,33,Maryland,Baltimore,620961
8247,2009-2010,2009-12-01,2010-02-28,90,0,15,145,160,113,200,313,473,17,151,Maryland,Baltimore,620961
8248,2010-2011,2010-12-01,2011-02-28,90,0,11,147,158,21,38,59,217,8,39,Maryland,Baltimore,620961
8249,2011-2012,2011-12-01,2012-02-29,91,0,5,80,85,3,4,7,92,3,8,Maryland,Baltimore,620961
8250,2012-2013,2012-12-01,2013-03-26,116,0,8,99,107,13,8,21,128,7,32,Maryland,Baltimore,620961
8251,2013-2014,2013-11-24,2014-03-25,122,0,34,224,258,53,64,117,375,18,110,Maryland,Baltimore,620961
8252,2014-2015,2014-11-26,2015-03-20,115,0,28,200,228,42,38,80,308,14,85,Maryland,Baltimore,620961
8253,2015-2016,2015-12-01,2016-03-04,95,0,13,122,135,49,74,123,258,8,69,Maryland,Baltimore,620961
8254,2016-2017,2016-12-01,2017-03-19,109,0,6,101,107,7,7,14,121,6,18,Maryland,Baltimore,620961
8255,2017-2018,2017-12-01,2018-03-22,112,0,24,168,192,22,15,37,229,11,47,Maryland,Baltimore,620961
8256,2018-2019,2018-11-15,2019-03-08,114,0,9,130,139,27,23,50,189,12,48,Maryland,Baltimore,620961
8257,2019-2020,2019-12-01,2020-02-29,91,0,0,68,68,4,1,5,73,3,6,Maryland,Baltimore,620961
8258,1951-1952,1951-12-01,1952-02-29,91,11,8,144,152,0,0,0,152,0,0,Maryland,Beltsville,0
8259,1952-1953,1952-11-30,1953-03-08,99,1,3,131,134,12,4,16,150,5,22,Maryland,Beltsville,0
8260,1954-1955,1954-12-01,1955-02-28,90,15,15,210,225,15,1,16,241,5,36,Maryland,Beltsville,0
8261,1955-1956,1955-11-19,1956-03-20,123,2,9,251,260,24,28,52,312,7,37,Maryland,Beltsville,0
8262,1956-1957,1956-12-01,1957-02-28,90,0,13,145,158,18,31,49,207,8,37,Maryland,Beltsville,0
8263,1958-1959,1958-12-01,1959-02-28,90,1,24,239,263,6,7,13,276,3,19,Maryland,Beltsville,0
8264,1961-1962,1961-11-20,1962-03-10,111,3,20,227,247,35,36,71,318,10,60,Maryland,Beltsville,0
8265,1962-1963,1962-12-01,1963-03-12,102,3,36,283,319,25,79,104,423,7,46,Maryland,Beltsville,0
8266,1963-1964,1963-12-01,1964-04-01,123,14,20,245,265,38,63,101,366,8,62,Maryland,Beltsville,0
8267,1964-1965,1964-12-01,1965-03-21,111,2,24,227,251,27,30,57,308,7,63,Maryland,Beltsville,0
8268,1965-1966,1965-12-01,1966-02-28,90,6,20,179,199,43,95,138,337,5,61,Maryland,Beltsville,0
8269,1966-1967,1966-12-01,1967-03-22,112,6,16,207,223,48,57,105,328,11,86,Maryland,Beltsville,0
8270,1967-1968,1967-12-01,1968-03-12,103,16,28,202,230,34,30,64,294,9,53,Maryland,Beltsville,0
8271,1969-1970,1969-11-23,1970-02-28,98,4,27,226,253,17,42,59,312,5,37,Maryland,Beltsville,0
8272,1970-1971,1970-12-01,1971-03-05,95,1,27,171,198,20,24,44,242,4,30,Maryland,Beltsville,0
8273,1972-1973,1972-12-01,1973-02-28,90,0,11,142,153,0,0,0,153,0,0,Maryland,Beltsville,0
8274,1974-1975,1974-12-01,1975-02-28,90,5,5,121,126,10,7,17,143,3,16,Maryland,Beltsville,0
8275,1978-1979,1978-12-01,1979-02-28,90,18,27,218,245,29,79,108,353,7,62,Maryland,Beltsville,0
8276,1981-1982,1981-12-01,1982-02-28,90,17,27,196,223,24,100,124,347,10,60,Maryland,Beltsville,0
8277,1984-1985,1984-12-01,1985-02-28,90,12,20,153,173,12,22,34,207,5,27,Maryland,Beltsville,0
8278,1985-1986,1985-12-01,1986-03-01,91,17,19,160,179,25,31,56,235,8,47,Maryland,Beltsville,0
8279,1988-1989,1988-12-01,1989-03-07,97,14,11,123,134,5,3,8,142,4,11,Maryland,Beltsville,0
8280,1989-1990,1989-11-23,1990-02-28,98,19,21,174,195,18,91,109,304,5,29,Maryland,Beltsville,0
8281,1990-1991,1990-12-01,1991-02-28,90,3,3,122,125,9,6,15,140,3,15,Maryland,Beltsville,0
8282,1991-1992,1991-12-01,1992-03-12,103,2,7,133,140,9,9,18,158,3,16,Maryland,Beltsville,0
8283,1992-1993,1992-12-01,1993-03-20,110,19,9,144,153,23,31,54,207,5,34,Maryland,Beltsville,0
8284,1995-1996,1995-11-12,1996-03-10,120,12,25,196,221,78,144,222,443,16,123,Maryland,Beltsville,0
8285,1996-1997,1996-11-14,1997-03-19,126,3,11,130,141,19,20,39,180,9,31,Maryland,Beltsville,0
8286,1997-1998,1997-12-01,1998-03-12,102,1,1,73,74,3,2,5,79,3,5,Maryland,Beltsville,0
8287,1998-1999,1998-12-01,1999-03-15,105,2,10,135,145,25,21,46,191,8,43,Maryland,Beltsville,0
8288,1999-2000,1999-12-01,2000-04-09,131,1,16,143,159,33,99,132,291,11,58,Maryland,Beltsville,0
8289,2000-2001,2000-12-01,2001-02-28,90,2,12,159,171,16,17,33,204,4,28,Maryland,Beltsville,0
8290,2001-2002,2001-12-01,2002-03-05,95,0,4,103,107,5,3,8,115,2,9,Maryland,Beltsville,0
8291,2002-2003,2002-12-01,2003-03-05,95,0,24,190,214,65,176,241,455,14,107,Maryland,Beltsville,0
8292,2003-2004,2003-12-01,2004-02-29,91,1,25,156,181,21,58,79,260,6,36,Maryland,Beltsville,0
8293,2004-2005,2004-12-01,2005-03-03,93,0,23,136,159,21,32,53,212,5,39,Maryland,Beltsville,0
8294,2005-2006,2005-11-24,2006-02-28,97,0,3,121,124,21,29,50,174,4,27,Maryland,Beltsville,0
8295,2006-2007,2006-12-01,2007-04-07,128,0,16,157,173,23,42,65,238,7,42,Maryland,Beltsville,0
8296,2007-2008,2007-12-01,2008-02-29,91,3,7,103,110,8,14,22,132,3,17,Maryland,Beltsville,0
8297,2008-2009,2008-12-01,2009-03-05,95,0,15,160,175,15,15,30,205,5,25,Maryland,Beltsville,0
8298,2009-2010,2009-12-01,2010-02-28,90,2,14,146,160,89,209,298,458,12,122,Maryland,Beltsville,0
8299,2010-2011,2010-12-01,2011-02-28,90,0,12,148,160,19,28,47,207,9,39,Maryland,Beltsville,0
8300,2011-2012,2011-12-01,2012-02-29,91,0,5,85,90,4,4,8,98,3,7,Maryland,Beltsville,0
8301,2012-2013,2012-12-01,2013-03-25,115,0,8,109,117,12,7,19,136,7,29,Maryland,Beltsville,0
8302,2013-2014,2013-11-25,2014-03-31,127,0,34,218,252,54,75,129,381,15,94,Maryland,Beltsville,0
8303,2014-2015,2014-11-19,2015-03-21,123,0,29,221,250,46,89,135,385,17,88,Maryland,Beltsville,0
8304,2015-2016,2015-12-01,2016-03-04,95,0,14,125,139,35,68,103,242,7,57,Maryland,Beltsville,0
8305,2016-2017,2016-12-01,2017-03-17,107,0,9,100,109,9,11,20,129,7,24,Maryland,Beltsville,0
8306,2017-2018,2017-12-01,2018-03-23,113,0,25,162,187,18,10,28,215,9,37,Maryland,Beltsville,0
8307,2018-2019,2018-11-15,2019-03-09,115,0,10,131,141,30,37,67,208,12,53,Maryland,Beltsville,0
8308,2019-2020,2019-12-01,2020-02-29,91,0,1,82,83,3,1,4,87,1,4,Maryland,Beltsville,0
8309,1956-1957,1956-12-01,1957-03-07,97,1,7,140,147,34,31,65,212,13,65,Maryland,Emmitsburg,2814
8310,1958-1959,1958-12-01,1959-04-12,133,4,19,263,282,28,18,46,328,11,50,Maryland,Emmitsburg,2814
8311,1959-1960,1959-12-01,1960-03-22,113,6,8,192,200,52,67,119,319,12,80,Maryland,Emmitsburg,2814
8312,1960-1961,1960-12-01,1961-04-13,134,2,45,323,368,103,355,458,826,20,182,Maryland,Emmitsburg,2814
8313,1961-1962,1961-11-20,1962-03-12,113,7,13,229,242,68,119,187,429,21,115,Maryland,Emmitsburg,2814
8314,1962-1963,1962-12-01,1963-03-11,101,5,35,307,342,51,142,193,535,13,88,Maryland,Emmitsburg,2814
8315,1963-1964,1963-12-01,1964-04-01,123,2,19,255,274,94,182,276,550,18,133,Maryland,Emmitsburg,2814
8316,1964-1965,1964-12-01,1965-03-25,115,3,20,221,241,45,81,126,367,11,72,Maryland,Emmitsburg,2814
8317,1965-1966,1965-12-01,1966-04-13,134,0,19,242,261,65,127,192,453,11,108,Maryland,Emmitsburg,2814
8318,1966-1967,1966-11-30,1967-03-21,112,0,17,220,237,70,135,205,442,15,116,Maryland,Emmitsburg,2814
8319,1968-1969,1968-11-10,1969-03-07,118,4,13,225,238,41,37,78,316,9,51,Maryland,Emmitsburg,2814
8320,1969-1970,1969-12-01,1970-03-29,119,1,31,293,324,68,242,310,634,18,127,Maryland,Emmitsburg,2814
8321,1970-1971,1970-12-01,1971-04-07,128,0,25,249,274,53,171,224,498,11,78,Maryland,Emmitsburg,2814
8322,1971-1972,1971-11-24,1972-04-08,137,0,10,219,229,55,92,147,376,13,79,Maryland,Emmitsburg,2814
8323,1972-1973,1972-10-19,1973-02-28,133,0,11,191,202,10,5,15,217,5,18,Maryland,Emmitsburg,2814
8324,1973-1974,1973-12-01,1974-02-28,90,0,15,141,156,26,64,90,246,7,39,Maryland,Emmitsburg,2814
8325,1974-1975,1974-12-01,1975-03-15,105,0,3,153,156,40,62,102,258,13,63,Maryland,Emmitsburg,2814
8326,1975-1976,1975-12-01,1976-03-12,103,0,20,178,198,30,34,64,262,11,52,Maryland,Emmitsburg,2814
8327,1976-1977,1976-11-12,1977-02-28,109,0,42,306,348,37,122,159,507,13,77,Maryland,Emmitsburg,2814
8328,1977-1978,1977-11-28,1978-03-16,109,0,45,331,376,81,285,366,742,19,128,Maryland,Emmitsburg,2814
8329,1978-1979,1978-11-27,1979-02-28,94,0,32,232,264,74,114,188,452,14,129,Maryland,Emmitsburg,2814
8330,1979-1980,1979-12-01,1980-03-15,106,1,16,228,244,37,31,68,312,14,84,Maryland,Emmitsburg,2814
8331,1980-1981,1980-12-01,1981-03-07,97,0,27,228,255,26,29,55,310,10,53,Maryland,Emmitsburg,2814
8332,1981-1982,1981-11-24,1982-04-09,137,10,27,312,339,66,160,226,565,21,121,Maryland,Emmitsburg,2814
8333,1982-1983,1982-12-01,1983-04-20,141,2,6,166,172,55,71,126,298,10,76,Maryland,Emmitsburg,2814
8334,1984-1985,1984-11-19,1985-04-09,142,2,21,235,256,39,60,99,355,13,73,Maryland,Emmitsburg,2814
8335,1985-1986,1985-12-01,1986-03-08,98,7,23,213,236,41,52,93,329,14,81,Maryland,Emmitsburg,2814
8336,1986-1987,1986-12-01,1987-04-06,127,5,14,214,228,77,127,204,432,15,109,Maryland,Emmitsburg,2814
8337,1987-1988,1987-11-11,1988-02-29,111,0,24,205,229,23,51,74,303,6,37,Maryland,Emmitsburg,2814
8338,1988-1989,1988-12-01,1989-03-13,103,4,16,165,181,27,51,78,259,8,51,Maryland,Emmitsburg,2814
8339,1989-1990,1989-11-23,1990-04-07,136,1,27,217,244,37,42,79,323,15,68,Maryland,Emmitsburg,2814
8340,1990-1991,1990-12-01,1991-03-30,120,3,6,153,159,37,43,80,239,7,50,Maryland,Emmitsburg,2814
8341,1991-1992,1991-12-01,1992-03-22,113,4,5,164,169,20,15,35,204,7,36,Maryland,Emmitsburg,2814
8342,1993-1994,1993-12-01,1994-03-18,108,12,62,294,356,73,233,306,662,20,137,Maryland,Emmitsburg,2814
8343,1994-1995,1994-11-24,1995-03-10,107,1,15,162,177,19,45,64,241,5,30,Maryland,Emmitsburg,2814
8344,1995-1996,1995-11-12,1996-03-09,119,10,43,246,289,123,222,345,634,20,172,Maryland,Emmitsburg,2814
8345,1996-1997,1996-11-14,1997-03-19,126,16,12,173,185,39,39,78,263,10,49,Maryland,Emmitsburg,2814
8346,1997-1998,1997-12-01,1998-03-22,112,7,2,107,109,20,7,27,136,8,28,Maryland,Emmitsburg,2814
8347,1998-1999,1998-12-01,1999-03-16,106,8,14,171,185,44,38,82,267,13,77,Maryland,Emmitsburg,2814
8348,1999-2000,1999-12-01,2000-04-09,131,15,16,161,177,51,129,180,357,9,83,Maryland,Emmitsburg,2814
8349,2000-2001,2000-12-01,2001-03-05,95,10,17,203,220,41,79,120,340,8,68,Maryland,Emmitsburg,2814
8350,2001-2002,2001-12-01,2002-03-11,101,9,1,143,144,17,12,29,173,5,29,Maryland,Emmitsburg,2814
8351,2002-2003,2002-11-27,2003-04-07,132,10,28,254,282,81,199,280,562,15,120,Maryland,Emmitsburg,2814
8352,2003-2004,2003-12-01,2004-03-17,108,14,28,224,252,57,147,204,456,11,97,Maryland,Emmitsburg,2814
8353,2008-2009,2008-12-01,2009-03-04,94,8,27,186,213,11,1,12,225,4,24,Maryland,Emmitsburg,2814
8354,2011-2012,2011-10-30,2012-02-29,123,3,8,129,137,11,0,11,148,4,18,Maryland,Emmitsburg,2814
8355,2012-2013,2012-12-01,2013-03-26,116,0,14,149,163,33,0,33,196,11,56,Maryland,Emmitsburg,2814
8356,2013-2014,2013-11-25,2014-03-26,122,9,43,296,339,82,59,141,480,18,137,Maryland,Emmitsburg,2814
8357,2014-2015,2014-11-20,2015-03-21,122,6,36,290,326,62,56,118,444,16,123,Maryland,Emmitsburg,2814
8358,2015-2016,2015-12-01,2016-03-06,97,16,13,159,172,44,64,108,280,4,52,Maryland,Emmitsburg,2814
8359,2016-2017,2016-12-01,2017-03-19,109,1,9,142,151,22,20,42,193,9,40,Maryland,Emmitsburg,2814
8360,2017-2018,2017-12-01,2018-03-22,112,5,32,199,231,33,9,42,273,11,67,Maryland,Emmitsburg,2814
8361,2018-2019,2018-11-16,2019-03-09,114,0,16,185,201,47,28,75,276,14,81,Maryland,Emmitsburg,2814
8362,2019-2020,2019-12-01,2020-02-29,91,3,2,112,114,6,0,6,120,3,11,Maryland,Emmitsburg,2814
8363,1950-1951,1950-12-01,1951-02-28,90,0,7,100,107,5,5,10,117,2,7,Maryland,Royal Oak,0
8364,1951-1952,1951-12-01,1952-03-03,94,3,4,83,87,6,0,6,93,3,9,Maryland,Royal Oak,0
8365,1952-1953,1952-11-30,1953-03-08,99,0,0,56,56,14,1,15,71,7,23,Maryland,Royal Oak,0
8366,1953-1954,1953-11-06,1954-02-28,115,0,5,76,81,29,31,60,141,8,44,Maryland,Royal Oak,0
8367,1954-1955,1954-12-01,1955-02-28,90,0,9,112,121,12,6,18,139,7,25,Maryland,Royal Oak,0
8368,1955-1956,1955-11-19,1956-03-19,122,0,3,120,123,7,1,8,131,5,13,Maryland,Royal Oak,0
8369,1956-1957,1956-12-01,1957-04-13,134,0,4,86,90,20,14,34,124,7,31,Maryland,Royal Oak,0
8370,1957-1958,1957-12-01,1958-03-20,110,0,10,127,137,34,53,87,224,10,47,Maryland,Royal Oak,0
8371,1958-1959,1958-12-01,1959-02-28,90,0,12,151,163,9,15,24,187,4,19,Maryland,Royal Oak,0
8372,1959-1960,1959-12-01,1960-03-17,108,0,6,110,116,38,66,104,220,10,56,Maryland,Royal Oak,0
8373,1960-1961,1960-12-01,1961-02-28,90,1,21,161,182,34,93,127,309,9,65,Maryland,Royal Oak,0
8374,1961-1962,1961-11-20,1962-03-07,108,0,8,126,134,25,16,41,175,12,47,Maryland,Royal Oak,0
8375,1962-1963,1962-12-01,1963-03-11,101,0,18,169,187,17,23,40,227,10,36,Maryland,Royal Oak,0
8376,1963-1964,1963-12-01,1964-04-01,123,0,13,136,149,40,49,89,238,12,64,Maryland,Royal Oak,0
8377,1964-1965,1964-11-30,1965-03-20,111,0,11,127,138,23,21,44,182,9,46,Maryland,Royal Oak,0
8378,1965-1966,1965-12-01,1966-02-28,90,0,11,117,128,46,103,149,277,7,72,Maryland,Royal Oak,0
8379,1966-1967,1966-12-01,1967-03-21,111,0,7,127,134,55,75,130,264,9,74,Maryland,Royal Oak,0
8380,1967-1968,1967-11-30,1968-03-13,105,0,14,158,172,35,26,61,233,9,53,Maryland,Royal Oak,0
8381,1968-1969,1968-12-01,1969-03-09,99,0,7,122,129,24,8,32,161,6,30,Maryland,Royal Oak,0
8382,1969-1970,1969-12-01,1970-02-28,90,1,13,142,155,18,36,54,209,7,34,Maryland,Royal Oak,0
8383,1970-1971,1970-12-01,1971-03-26,116,0,14,128,142,19,15,34,176,10,36,Maryland,Royal Oak,0
8384,1971-1972,1971-12-01,1972-04-08,130,0,5,105,110,21,12,33,143,6,27,Maryland,Royal Oak,0
8385,1972-1973,1972-12-01,1973-02-28,90,0,8,88,96,2,0,2,98,2,11,Maryland,Royal Oak,0
8386,1973-1974,1973-12-01,1974-03-12,102,0,4,73,77,19,20,39,116,9,35,Maryland,Royal Oak,0
8387,1974-1975,1974-12-01,1975-03-10,100,0,0,69,69,11,5,16,85,5,17,Maryland,Royal Oak,0
8388,1975-1976,1975-12-01,1976-03-10,101,0,10,100,110,6,3,9,119,4,14,Maryland,Royal Oak,0
8389,1976-1977,1976-11-12,1977-02-28,109,0,23,194,217,23,54,77,294,9,39,Maryland,Royal Oak,0
8390,1977-1978,1977-12-01,1978-03-10,100,0,21,177,198,42,90,132,330,12,65,Maryland,Royal Oak,0
8391,1978-1979,1978-11-27,1979-02-28,94,0,26,150,176,54,103,157,333,12,100,Maryland,Royal Oak,0
8392,1979-1980,1979-12-01,1980-03-03,94,0,12,106,118,25,22,47,165,10,58,Maryland,Royal Oak,0
8393,1980-1981,1980-12-01,1981-03-21,111,0,17,162,179,8,4,12,191,5,15,Maryland,Royal Oak,0
8394,1981-1982,1981-12-01,1982-02-28,90,3,17,132,149,30,75,105,254,12,61,Maryland,Royal Oak,0
8395,1982-1983,1982-12-01,1983-02-28,90,1,4,70,74,26,33,59,133,5,37,Maryland,Royal Oak,0
8396,1983-1984,1983-12-01,1984-03-10,101,0,21,131,152,10,25,35,187,4,21,Maryland,Royal Oak,0
8397,1984-1985,1984-12-01,1985-04-09,130,0,8,115,123,23,35,58,181,7,38,Maryland,Royal Oak,0
8398,1985-1986,1985-12-01,1986-03-08,98,2,14,116,130,25,13,38,168,14,62,Maryland,Royal Oak,0
8399,1986-1987,1986-12-01,1987-03-10,100,0,5,95,100,40,78,118,218,7,55,Maryland,Royal Oak,0
8400,1987-1988,1987-11-11,1988-03-21,132,0,11,124,135,18,40,58,193,6,28,Maryland,Royal Oak,0
8401,1988-1989,1988-12-01,1989-03-08,98,0,6,85,91,19,6,25,116,7,30,Maryland,Royal Oak,0
8402,1989-1990,1989-11-23,1990-02-28,98,0,14,118,132,31,75,106,238,10,50,Maryland,Royal Oak,0
8403,1990-1991,1990-12-01,1991-02-28,90,2,2,64,66,8,5,13,79,3,11,Maryland,Royal Oak,0
8404,1991-1992,1991-12-01,1992-02-29,91,0,1,73,74,5,1,6,80,2,8,Maryland,Royal Oak,0
8405,1992-1993,1992-12-01,1993-03-15,105,1,6,77,83,13,7,20,103,4,19,Maryland,Royal Oak,0
8406,1993-1994,1993-12-01,1994-03-02,92,2,25,133,158,20,35,55,213,9,50,Maryland,Royal Oak,0
8407,1994-1995,1994-12-01,1995-02-28,90,2,4,76,80,8,1,9,89,3,13,Maryland,Royal Oak,0
8408,1995-1996,1995-12-01,1996-03-09,100,3,17,130,147,62,116,178,325,10,85,Maryland,Royal Oak,0
8409,1996-1997,1996-12-01,1997-04-01,122,1,6,69,75,16,8,24,99,7,21,Maryland,Royal Oak,0
8410,1997-1998,1997-12-01,1998-03-22,112,0,0,50,50,1,0,1,51,1,1,Maryland,Royal Oak,0
8411,1998-1999,1998-12-01,1999-03-10,100,4,5,80,85,14,8,22,107,6,25,Maryland,Royal Oak,0
8412,1999-2000,1999-12-01,2000-02-29,91,0,10,99,109,29,80,109,218,6,41,Maryland,Royal Oak,0
8413,2000-2001,2000-12-01,2001-03-26,116,3,4,126,130,16,5,21,151,8,29,Maryland,Royal Oak,0
8414,2001-2002,2001-12-01,2002-02-28,90,5,0,55,55,7,2,9,64,3,11,Maryland,Royal Oak,0
8415,2002-2003,2002-12-01,2003-03-02,92,1,9,119,128,70,125,195,323,15,99,Maryland,Royal Oak,0
8416,2003-2004,2003-12-01,2004-02-29,91,3,10,110,120,12,19,31,151,5,20,Maryland,Royal Oak,0
8417,2004-2005,2004-12-01,2005-03-08,98,0,8,103,111,29,45,74,185,8,49,Maryland,Royal Oak,0
8418,2005-2006,2005-12-01,2006-02-28,90,1,1,63,64,16,19,35,99,3,19,Maryland,Royal Oak,0
8419,2006-2007,2006-12-01,2007-04-07,128,2,4,102,106,6,2,8,114,3,9,Maryland,Royal Oak,0
8420,2007-2008,2007-12-01,2008-02-29,91,2,1,68,69,10,3,13,82,6,18,Maryland,Royal Oak,0
8421,2008-2009,2008-12-01,2009-03-05,95,1,11,111,122,20,23,43,165,5,28,Maryland,Royal Oak,0
8422,2009-2010,2009-12-01,2010-02-28,90,0,6,101,107,78,204,282,389,8,91,Maryland,Royal Oak,0
8423,2012-2013,2012-12-01,2013-03-25,115,0,4,82,86,9,2,11,97,5,19,Maryland,Royal Oak,0
8424,2013-2014,2013-12-01,2014-03-26,116,0,14,171,185,47,47,94,279,17,86,Maryland,Royal Oak,0
8425,2014-2015,2014-12-01,2015-03-20,110,0,18,166,184,31,55,86,270,9,51,Maryland,Royal Oak,0
8426,2015-2016,2015-12-01,2016-03-04,95,0,10,78,88,37,37,74,162,9,54,Maryland,Royal Oak,0
8427,2016-2017,2016-12-01,2017-02-28,90,0,5,47,52,12,14,26,78,2,16,Maryland,Royal Oak,0
8428,2017-2018,2017-12-01,2018-03-22,112,0,19,126,145,23,22,45,190,8,38,Maryland,Royal Oak,0
8429,2018-2019,2018-12-01,2019-03-01,91,0,6,76,82,15,12,27,109,7,28,Maryland,Royal Oak,0
8430,2019-2020,2019-12-01,2020-02-29,91,0,0,51,51,1,0,1,52,1,1,Maryland,Royal Oak,0
8431,1951-1952,1951-11-03,1952-03-19,138,2,34,299,333,87,316,403,736,27,156,Massachusetts,Amherst,37819
8432,1954-1955,1954-12-01,1955-03-28,118,5,50,252,302,23,32,55,357,11,56,Massachusetts,Amherst,37819
8433,1955-1956,1955-11-11,1956-04-23,165,3,62,344,406,111,254,365,771,28,195,Massachusetts,Amherst,37819
8434,1956-1957,1956-11-18,1957-04-09,143,5,49,326,375,79,176,255,630,28,173,Massachusetts,Amherst,37819
8435,1957-1958,1957-12-01,1958-03-22,112,3,57,270,327,65,291,356,683,19,144,Massachusetts,Amherst,37819
8436,1959-1960,1959-11-18,1960-03-25,129,9,43,265,308,41,182,223,531,23,114,Massachusetts,Amherst,37819
8437,1960-1961,1960-12-01,1961-03-25,115,0,92,511,603,90,665,755,1358,18,177,Massachusetts,Amherst,37819
8438,1964-1965,1964-12-01,1965-04-18,139,7,73,422,495,62,138,200,695,30,200,Massachusetts,Amherst,37819
8439,1965-1966,1965-12-01,1966-03-29,119,12,40,325,365,62,165,227,592,16,95,Massachusetts,Amherst,37819
8440,1966-1967,1966-12-01,1967-04-24,145,0,38,401,439,93,403,496,935,27,182,Massachusetts,Amherst,37819
8441,1967-1968,1967-11-22,1968-03-16,116,0,59,410,469,49,342,391,860,15,113,Massachusetts,Amherst,37819
8442,1968-1969,1968-11-10,1969-03-22,133,0,45,385,430,74,584,658,1088,21,117,Massachusetts,Amherst,37819
8443,1969-1970,1969-12-01,1970-04-02,123,0,63,452,515,81,350,431,946,32,189,Massachusetts,Amherst,37819
8444,1970-1971,1970-12-01,1971-04-07,128,0,67,456,523,101,611,712,1235,27,187,Massachusetts,Amherst,37819
8445,1971-1972,1971-11-24,1972-04-08,137,0,33,369,402,114,218,332,734,24,182,Massachusetts,Amherst,37819
8446,1972-1973,1972-11-15,1973-03-01,107,0,34,291,325,56,261,317,642,21,105,Massachusetts,Amherst,37819
8447,1973-1974,1973-12-01,1974-04-10,131,0,37,343,380,51,207,258,638,16,119,Massachusetts,Amherst,37819
8448,1974-1975,1974-12-01,1975-03-15,105,15,14,299,313,60,202,262,575,19,116,Massachusetts,Amherst,37819
8449,1975-1976,1975-12-01,1976-03-19,110,0,56,355,411,81,314,395,806,26,196,Massachusetts,Amherst,37819
8450,1976-1977,1976-11-10,1977-03-23,134,0,65,439,504,63,395,458,962,26,162,Massachusetts,Amherst,37819
8451,1977-1978,1977-11-28,1978-03-26,119,1,57,398,455,86,470,556,1011,26,182,Massachusetts,Amherst,37819
8452,1980-1981,1980-11-18,1981-02-28,103,7,48,391,439,34,128,162,601,10,63,Massachusetts,Amherst,37819
8453,1982-1983,1982-12-01,1983-03-24,114,2,25,271,296,51,162,213,509,9,82,Massachusetts,Amherst,37819
8454,1983-1984,1983-12-01,1984-03-30,121,17,68,385,453,66,270,336,789,14,110,Massachusetts,Amherst,37819
8455,1984-1985,1984-12-01,1985-03-08,98,4,34,294,328,33,117,150,478,7,60,Massachusetts,Amherst,37819
8456,1985-1986,1985-11-17,1986-03-10,114,4,33,346,379,54,273,327,706,14,81,Massachusetts,Amherst,37819
8457,1986-1987,1986-11-11,1987-03-14,124,2,15,376,391,62,414,476,867,16,106,Massachusetts,Amherst,37819
8458,1987-1988,1987-11-11,1988-03-07,118,4,30,349,379,66,241,307,686,11,90,Massachusetts,Amherst,37819
8459,1988-1989,1988-12-01,1989-04-05,126,9,29,340,369,21,30,51,420,7,45,Massachusetts,Amherst,37819
8460,1989-1990,1989-11-23,1990-03-06,104,3,49,316,365,49,169,218,583,12,86,Massachusetts,Amherst,37819
8461,1990-1991,1990-12-01,1991-03-15,105,5,18,219,237,11,71,82,319,2,17,Massachusetts,Amherst,37819
8462,1991-1992,1991-11-12,1992-04-17,158,10,38,378,416,35,57,92,508,16,88,Massachusetts,Amherst,37819
8463,1992-1993,1992-11-18,1993-04-27,161,9,45,398,443,76,260,336,779,23,138,Massachusetts,Amherst,37819
8464,1993-1994,1993-11-26,1994-03-28,123,19,101,504,605,76,455,531,1136,27,223,Massachusetts,Amherst,37819
8465,1994-1995,1994-11-28,1995-04-06,130,12,28,297,325,23,70,93,418,6,49,Massachusetts,Amherst,37819
8466,1995-1996,1995-11-13,1996-04-11,151,10,81,454,535,121,397,518,1053,37,289,Massachusetts,Amherst,37819
8467,1996-1997,1996-11-25,1997-04-03,130,9,35,274,309,68,162,230,539,24,137,Massachusetts,Amherst,37819
8468,1997-1998,1997-11-15,1998-03-22,128,3,14,259,273,27,116,143,416,11,51,Massachusetts,Amherst,37819
8469,1998-1999,1998-12-01,1999-03-16,106,8,30,278,308,41,129,170,478,12,87,Massachusetts,Amherst,37819
8470,1999-2000,1999-11-30,2000-03-18,110,3,47,329,376,41,174,215,591,15,100,Massachusetts,Amherst,37819
8471,2000-2001,2000-10-30,2001-03-27,149,15,41,433,474,108,503,611,1085,25,187,Massachusetts,Amherst,37819
8472,2001-2002,2001-12-01,2002-03-23,113,2,7,238,245,36,49,85,330,12,63,Massachusetts,Amherst,37819
8473,2002-2003,2002-10-23,2003-04-08,168,11,59,508,567,98,481,579,1146,32,204,Massachusetts,Amherst,37819
8474,2003-2004,2003-10-23,2004-03-23,153,6,68,383,451,63,198,261,712,20,132,Massachusetts,Amherst,37819
8475,2004-2005,2004-11-13,2005-03-25,133,9,48,390,438,95,226,321,759,25,197,Massachusetts,Amherst,37819
8476,2005-2006,2005-11-24,2006-03-04,101,6,25,286,311,53,174,227,538,20,128,Massachusetts,Amherst,37819
8477,2006-2007,2006-12-01,2007-04-05,126,5,54,315,369,41,142,183,552,15,89,Massachusetts,Amherst,37819
8478,2007-2008,2007-11-21,2008-03-28,129,8,38,339,377,89,280,369,746,21,158,Massachusetts,Amherst,37819
8479,2008-2009,2008-11-20,2009-03-06,107,16,61,397,458,53,292,345,803,12,115,Massachusetts,Amherst,37819
8480,2009-2010,2009-12-01,2010-02-28,90,8,48,258,306,31,69,100,406,16,72,Massachusetts,Amherst,37819
8481,2012-2013,2012-12-01,2013-03-23,113,1,39,270,309,64,173,237,546,21,129,Massachusetts,Amherst,37819
8482,2013-2014,2013-11-25,2014-04-16,143,0,86,473,559,68,291,359,918,24,185,Massachusetts,Amherst,37819
8483,2014-2015,2014-11-27,2015-04-09,134,3,85,501,586,90,399,489,1075,27,239,Massachusetts,Amherst,37819
8484,2015-2016,2015-12-01,2016-04-05,127,1,28,229,257,27,53,80,337,16,74,Massachusetts,Amherst,37819
8485,2016-2017,2016-12-01,2017-04-02,123,0,34,321,355,75,171,246,601,21,154,Massachusetts,Amherst,37819
8486,2017-2018,2017-12-01,2018-04-16,137,0,66,366,432,55,146,201,633,19,109,Massachusetts,Amherst,37819
8487,2018-2019,2018-11-16,2019-03-15,120,0,51,342,393,54,160,214,607,17,118,Massachusetts,Amherst,37819
8488,2019-2020,2019-11-14,2020-03-24,132,3,22,275,297,39,75,114,411,13,74,Massachusetts,Amherst,37819
8489,1950-1951,1950-11-22,1951-03-23,122,0,63,329,392,41,122,163,555,15,100,Massachusetts,Birch Hill Dam,0
8490,1951-1952,1951-11-04,1952-04-05,154,1,54,410,464,105,682,787,1251,20,165,Massachusetts,Birch Hill Dam,0
8491,1952-1953,1952-11-09,1953-04-20,163,0,36,317,353,60,207,267,620,19,106,Massachusetts,Birch Hill Dam,0
8492,1953-1954,1953-11-07,1954-04-04,149,0,49,360,409,54,171,225,634,22,138,Massachusetts,Birch Hill Dam,0
8493,1954-1955,1954-11-25,1955-04-04,131,0,58,356,414,54,158,212,626,22,108,Massachusetts,Birch Hill Dam,0
8494,1955-1956,1955-11-19,1956-04-26,160,1,64,497,561,153,683,836,1397,37,246,Massachusetts,Birch Hill Dam,0
8495,1956-1957,1956-11-18,1957-04-09,143,3,60,437,497,101,485,586,1083,30,197,Massachusetts,Birch Hill Dam,0
8496,1957-1958,1957-11-27,1958-04-11,136,0,55,362,417,127,702,829,1246,25,188,Massachusetts,Birch Hill Dam,0
8497,1958-1959,1958-11-28,1959-03-29,122,1,86,506,592,92,415,507,1099,22,173,Massachusetts,Birch Hill Dam,0
8498,1959-1960,1959-11-03,1960-04-04,154,2,54,398,452,96,633,729,1181,26,170,Massachusetts,Birch Hill Dam,0
8499,1960-1961,1960-10-25,1961-04-19,177,1,86,599,685,153,886,1039,1724,27,255,Massachusetts,Birch Hill Dam,0
8500,1961-1962,1961-11-20,1962-04-13,145,2,72,442,514,97,647,744,1258,21,168,Massachusetts,Birch Hill Dam,0
8501,1962-1963,1962-10-26,1963-03-30,156,0,86,552,638,116,802,918,1556,26,204,Massachusetts,Birch Hill Dam,0
8502,1963-1964,1963-11-03,1964-04-20,170,0,73,488,561,111,552,663,1224,26,208,Massachusetts,Birch Hill Dam,0
8503,1964-1965,1964-10-21,1965-04-19,181,0,75,500,575,72,272,344,919,25,163,Massachusetts,Birch Hill Dam,0
8504,1965-1966,1965-12-01,1966-03-28,118,0,49,372,421,96,520,616,1037,24,167,Massachusetts,Birch Hill Dam,0
8505,1966-1967,1966-11-06,1967-05-06,182,0,65,474,539,147,557,704,1243,33,251,Massachusetts,Birch Hill Dam,0
8506,1967-1968,1967-11-09,1968-03-22,135,0,84,490,574,86,613,699,1273,20,160,Massachusetts,Birch Hill Dam,0
8507,1968-1969,1968-11-10,1969-04-06,148,1,76,449,525,140,923,1063,1588,26,211,Massachusetts,Birch Hill Dam,0
8508,1969-1970,1969-11-21,1970-04-05,136,0,97,508,605,102,743,845,1450,27,198,Massachusetts,Birch Hill Dam,0
8509,1970-1971,1970-11-25,1971-04-09,136,1,104,610,714,133,864,997,1711,32,302,Massachusetts,Birch Hill Dam,0
8510,1971-1972,1971-11-11,1972-04-09,151,2,78,550,628,151,402,553,1181,27,272,Massachusetts,Birch Hill Dam,0
8511,1972-1973,1972-11-05,1973-04-05,152,0,62,438,500,78,393,471,971,21,154,Massachusetts,Birch Hill Dam,0
8512,1973-1974,1973-12-01,1974-04-11,132,2,60,441,501,46,202,248,749,11,101,Massachusetts,Birch Hill Dam,0
8513,1974-1975,1974-11-23,1975-04-10,139,0,50,490,540,85,433,518,1058,26,214,Massachusetts,Birch Hill Dam,0
8514,1975-1976,1975-11-25,1976-03-20,117,2,88,484,572,104,391,495,1067,28,262,Massachusetts,Birch Hill Dam,0
8515,1976-1977,1976-11-10,1977-05-10,182,0,122,635,757,119,692,811,1568,25,260,Massachusetts,Birch Hill Dam,0
8516,1977-1978,1977-11-28,1978-03-27,120,0,104,557,661,105,543,648,1309,19,209,Massachusetts,Birch Hill Dam,0
8517,1978-1979,1978-11-22,1979-04-11,141,0,115,473,588,66,403,469,1057,22,148,Massachusetts,Birch Hill Dam,0
8518,1979-1980,1979-10-11,1980-03-23,165,0,67,446,513,30,124,154,667,8,58,Massachusetts,Birch Hill Dam,0
8519,1980-1981,1980-11-18,1981-03-25,128,0,100,551,651,48,188,236,887,18,127,Massachusetts,Birch Hill Dam,0
8520,1981-1982,1981-12-01,1982-04-14,135,1,110,555,665,110,898,1008,1673,26,220,Massachusetts,Birch Hill Dam,0
8521,1982-1983,1982-11-28,1983-04-19,143,13,51,373,424,53,207,260,684,16,111,Massachusetts,Birch Hill Dam,0
8522,1983-1984,1983-11-26,1984-04-02,129,10,84,472,556,98,350,448,1004,20,176,Massachusetts,Birch Hill Dam,0
8523,1984-1985,1984-12-01,1985-04-09,130,6,67,430,497,61,304,365,862,18,155,Massachusetts,Birch Hill Dam,0
8524,1985-1986,1985-11-17,1986-05-04,169,13,76,498,574,58,362,420,994,21,154,Massachusetts,Birch Hill Dam,0
8525,1986-1987,1986-11-12,1987-04-30,170,4,51,534,585,108,681,789,1374,19,175,Massachusetts,Birch Hill Dam,0
8526,1987-1988,1987-11-11,1988-04-16,158,15,73,525,598,90,332,422,1020,21,195,Massachusetts,Birch Hill Dam,0
8527,1988-1989,1988-12-01,1989-03-25,115,10,66,458,524,34,63,97,621,12,89,Massachusetts,Birch Hill Dam,0
8528,1989-1990,1989-11-20,1990-03-10,111,1,91,487,578,70,292,362,940,19,160,Massachusetts,Birch Hill Dam,0
8529,2004-2005,2004-11-27,2005-03-30,124,2,84,543,627,111,448,559,1186,22,253,Massachusetts,Birch Hill Dam,0
8530,2005-2006,2005-11-24,2006-03-21,118,4,67,438,505,67,214,281,786,13,132,Massachusetts,Birch Hill Dam,0
8531,2006-2007,2006-12-01,2007-04-13,134,17,74,386,460,52,186,238,698,12,103,Massachusetts,Birch Hill Dam,0
8532,2007-2008,2007-11-21,2008-03-31,132,7,63,457,520,123,454,577,1097,25,219,Massachusetts,Birch Hill Dam,0
8533,2009-2010,2009-12-01,2010-03-05,95,8,51,330,381,89,312,401,782,15,122,Massachusetts,Birch Hill Dam,0
8534,2012-2013,2012-11-08,2013-03-28,141,0,51,354,405,88,312,400,805,31,199,Massachusetts,Birch Hill Dam,0
8535,2013-2014,2013-11-12,2014-04-16,156,0,113,553,666,90,448,538,1204,37,269,Massachusetts,Birch Hill Dam,0
8536,2014-2015,2014-11-14,2015-04-10,148,4,114,589,703,102,525,627,1330,34,325,Massachusetts,Birch Hill Dam,0
8537,2015-2016,2015-12-01,2016-04-06,128,0,41,273,314,34,92,126,440,13,82,Massachusetts,Birch Hill Dam,0
8538,2016-2017,2016-11-21,2017-04-03,134,15,53,356,409,93,246,339,748,19,158,Massachusetts,Birch Hill Dam,0
8539,2017-2018,2017-12-01,2018-04-16,137,14,89,398,487,92,299,391,878,26,172,Massachusetts,Birch Hill Dam,0
8540,1959-1960,1959-11-19,1960-03-28,131,1,32,329,361,71,267,338,699,23,143,Massachusetts,Buffumville Lake,0
8541,1960-1961,1960-10-25,1961-04-14,172,2,74,566,640,112,502,614,1254,22,215,Massachusetts,Buffumville Lake,0
8542,1961-1962,1961-11-21,1962-03-25,125,6,61,397,458,93,492,585,1043,18,165,Massachusetts,Buffumville Lake,0
8543,1962-1963,1962-11-14,1963-03-27,134,1,80,497,577,72,430,502,1079,21,156,Massachusetts,Buffumville Lake,0
8544,1963-1964,1963-12-01,1964-03-20,111,1,56,400,456,79,317,396,852,21,171,Massachusetts,Buffumville Lake,0
8545,1964-1965,1964-12-01,1965-04-19,140,0,68,412,480,76,219,295,775,24,181,Massachusetts,Buffumville Lake,0
8546,1965-1966,1965-12-01,1966-03-29,119,0,47,338,385,87,369,456,841,21,153,Massachusetts,Buffumville Lake,0
8547,1966-1967,1966-12-01,1967-04-08,129,0,67,409,476,114,375,489,965,24,231,Massachusetts,Buffumville Lake,0
8548,1967-1968,1967-11-08,1968-03-21,135,0,83,465,548,79,533,612,1160,20,149,Massachusetts,Buffumville Lake,0
8549,1968-1969,1968-11-11,1969-04-01,142,1,56,400,456,82,454,536,992,17,116,Massachusetts,Buffumville Lake,0
8550,1969-1970,1969-12-01,1970-04-07,128,0,82,478,560,101,450,551,1111,29,229,Massachusetts,Buffumville Lake,0
8551,1970-1971,1970-12-01,1971-04-10,131,0,88,450,538,103,680,783,1321,31,239,Massachusetts,Buffumville Lake,0
8552,1971-1972,1971-11-25,1972-04-12,140,3,63,398,461,130,292,422,883,30,245,Massachusetts,Buffumville Lake,0
8553,1972-1973,1972-10-19,1973-03-23,156,3,53,338,391,45,100,145,536,19,102,Massachusetts,Buffumville Lake,0
8554,1979-1980,1979-10-11,1980-03-22,164,1,46,380,426,29,57,86,512,8,50,Massachusetts,Buffumville Lake,0
8555,1980-1981,1980-11-18,1981-03-07,110,0,86,445,531,29,126,155,686,10,82,Massachusetts,Buffumville Lake,0
8556,1981-1982,1981-12-01,1982-04-13,134,9,80,492,572,100,355,455,1027,24,212,Massachusetts,Buffumville Lake,0
8557,1982-1983,1982-11-28,1983-04-19,143,8,46,329,375,90,262,352,727,13,154,Massachusetts,Buffumville Lake,0
8558,1983-1984,1983-12-01,1984-04-04,126,4,67,427,494,89,218,307,801,18,163,Massachusetts,Buffumville Lake,0
8559,1984-1985,1984-12-01,1985-04-08,129,3,55,422,477,44,183,227,704,16,126,Massachusetts,Buffumville Lake,0
8560,1985-1986,1985-11-17,1986-03-10,114,3,60,418,478,38,115,153,631,19,126,Massachusetts,Buffumville Lake,0
8561,1986-1987,1986-11-12,1987-04-30,170,6,36,415,451,127,589,716,1167,24,203,Massachusetts,Buffumville Lake,0
8562,1987-1988,1987-11-11,1988-03-22,133,6,58,394,452,75,208,283,735,20,146,Massachusetts,Buffumville Lake,0
8563,1988-1989,1988-12-01,1989-03-25,115,13,51,324,375,20,26,46,421,9,58,Massachusetts,Buffumville Lake,0
8564,1989-1990,1989-11-22,1990-04-07,137,11,71,386,457,61,127,188,645,21,148,Massachusetts,Buffumville Lake,0
8565,2012-2013,2012-11-08,2013-03-22,135,4,47,300,347,119,225,344,691,22,183,Massachusetts,Buffumville Lake,0
8566,2013-2014,2013-11-26,2014-04-16,142,15,92,460,552,90,326,416,968,24,216,Massachusetts,Buffumville Lake,0
8567,2014-2015,2014-11-14,2015-04-03,141,5,98,513,611,134,606,740,1351,24,259,Massachusetts,Buffumville Lake,0
8568,2015-2016,2015-12-01,2016-04-05,127,0,34,247,281,56,101,157,438,13,99,Massachusetts,Buffumville Lake,0
8569,2016-2017,2016-11-21,2017-04-02,133,2,39,302,341,91,170,261,602,21,160,Massachusetts,Buffumville Lake,0
8570,2017-2018,2017-12-01,2018-04-07,128,0,71,336,407,106,220,326,733,28,196,Massachusetts,Buffumville Lake,0
8571,2018-2019,2018-11-15,2019-03-23,129,0,50,340,390,68,156,224,614,16,121,Massachusetts,Buffumville Lake,0
8572,2019-2020,2019-11-09,2020-04-18,162,0,22,278,300,42,85,127,427,9,62,Massachusetts,Buffumville Lake,0
8573,1972-1973,1972-11-23,1973-03-23,121,0,25,119,144,29,33,62,206,12,57,Massachusetts,Chatham,6125
8574,1973-1974,1973-12-01,1974-03-29,119,0,17,123,140,38,44,82,222,15,66,Massachusetts,Chatham,6125
8575,1974-1975,1974-11-26,1975-03-30,125,0,10,118,128,44,33,77,205,15,67,Massachusetts,Chatham,6125
8576,1975-1976,1975-12-01,1976-03-18,109,3,23,155,178,57,70,127,305,16,104,Massachusetts,Chatham,6125
8577,1976-1977,1976-11-30,1977-03-19,110,3,49,218,267,34,48,82,349,13,65,Massachusetts,Chatham,6125
8578,1977-1978,1977-12-01,1978-03-19,109,0,38,177,215,55,85,140,355,14,86,Massachusetts,Chatham,6125
8579,1978-1979,1978-11-26,1979-03-16,111,0,52,175,227,20,39,59,286,10,54,Massachusetts,Chatham,6125
8580,1979-1980,1979-12-01,1980-03-03,94,0,28,135,163,16,11,27,190,6,32,Massachusetts,Chatham,6125
8581,1980-1981,1980-12-01,1981-02-28,90,0,41,193,234,44,112,156,390,11,92,Massachusetts,Chatham,6125
8582,1981-1982,1981-12-01,1982-04-08,129,3,41,193,234,53,97,150,384,18,102,Massachusetts,Chatham,6125
8583,1982-1983,1982-12-01,1983-04-02,123,4,14,93,107,65,66,131,238,15,101,Massachusetts,Chatham,6125
8584,1983-1984,1983-12-01,1984-03-30,121,0,27,151,178,36,50,86,264,8,55,Massachusetts,Chatham,6125
8585,1984-1985,1984-12-01,1985-03-06,96,12,16,124,140,36,77,113,253,11,69,Massachusetts,Chatham,6125
8586,1985-1986,1985-12-01,1986-03-21,111,2,16,154,170,26,37,63,233,9,45,Massachusetts,Chatham,6125
8587,1987-1988,1987-12-01,1988-03-21,112,0,22,142,164,28,33,61,225,7,55,Massachusetts,Chatham,6125
8588,1988-1989,1988-12-01,1989-03-12,102,1,21,133,154,33,36,69,223,15,76,Massachusetts,Chatham,6125
8589,1989-1990,1989-11-23,1990-04-07,136,3,36,170,206,54,73,127,333,14,93,Massachusetts,Chatham,6125
8590,1990-1991,1990-12-01,1991-03-11,101,2,10,93,103,23,10,33,136,12,57,Massachusetts,Chatham,6125
8591,1992-1993,1992-12-01,1993-03-21,111,0,22,146,168,64,102,166,334,13,97,Massachusetts,Chatham,6125
8592,1993-1994,1993-12-01,1994-03-20,110,5,39,185,224,95,117,212,436,28,162,Massachusetts,Chatham,6125
8593,1997-1998,1997-12-01,1998-03-13,103,16,5,74,79,0,0,0,79,0,0,Massachusetts,Chatham,6125
8594,1998-1999,1998-12-01,1999-02-28,90,16,10,89,99,48,44,92,191,10,69,Massachusetts,Chatham,6125
8595,1999-2000,1999-12-01,2000-03-18,109,13,23,135,158,27,37,64,222,8,59,Massachusetts,Chatham,6125
8596,2001-2002,2001-12-01,2002-03-22,112,4,3,75,78,6,6,12,90,1,7,Massachusetts,Chatham,6125
8597,2002-2003,2002-11-29,2003-04-08,131,16,32,192,224,76,148,224,448,12,106,Massachusetts,Chatham,6125
8598,2003-2004,2003-12-01,2004-03-20,111,11,47,176,223,32,46,78,301,9,55,Massachusetts,Chatham,6125
8599,2005-2006,2005-12-01,2006-03-09,99,5,16,105,121,21,48,69,190,9,39,Massachusetts,Chatham,6125
8600,2006-2007,2006-12-01,2007-03-10,100,1,36,146,182,14,11,25,207,8,36,Massachusetts,Chatham,6125
8601,2007-2008,2007-12-01,2008-02-29,91,1,13,100,113,26,26,52,165,10,47,Massachusetts,Chatham,6125
8602,2008-2009,2008-11-23,2009-03-24,122,3,35,169,204,27,47,74,278,12,58,Massachusetts,Chatham,6125
8603,2009-2010,2009-12-01,2010-03-05,95,0,29,137,166,25,96,121,287,10,46,Massachusetts,Chatham,6125
8604,2010-2011,2010-12-01,2011-03-24,114,0,27,159,186,32,46,78,264,11,46,Massachusetts,Chatham,6125
8605,2011-2012,2011-12-01,2012-02-29,91,0,6,76,82,17,11,28,110,5,25,Massachusetts,Chatham,6125
8606,2012-2013,2012-12-01,2013-03-23,113,1,22,114,136,42,60,102,238,15,80,Massachusetts,Chatham,6125
8607,2013-2014,2013-11-13,2014-03-27,135,1,42,205,247,55,94,149,396,23,122,Massachusetts,Chatham,6125
8608,2014-2015,2014-12-01,2015-03-21,111,6,29,181,210,62,271,333,543,19,122,Massachusetts,Chatham,6125
8609,2015-2016,2015-12-01,2016-03-21,112,0,11,91,102,30,64,94,196,9,63,Massachusetts,Chatham,6125
8610,2016-2017,2016-12-01,2017-03-16,106,0,13,111,124,42,58,100,224,12,71,Massachusetts,Chatham,6125
8611,2018-2019,2018-12-01,2019-03-08,98,2,22,144,166,7,11,18,184,4,24,Massachusetts,Chatham,6125
8612,2019-2020,2019-11-13,2020-03-07,116,3,9,93,102,8,7,15,117,6,15,Massachusetts,Chatham,6125
8613,1982-1983,1982-12-01,1983-02-28,90,2,17,135,152,29,57,86,238,4,42,Massachusetts,Edgartown,4067
8614,1983-1984,1983-12-01,1984-03-13,104,3,27,180,207,28,54,82,289,7,54,Massachusetts,Edgartown,4067
8615,1984-1985,1984-12-01,1985-02-28,90,1,28,157,185,31,75,106,291,8,56,Massachusetts,Edgartown,4067
8616,1985-1986,1985-11-26,1986-03-22,117,7,25,202,227,26,56,82,309,8,50,Massachusetts,Edgartown,4067
8617,1986-1987,1986-12-01,1987-03-14,104,4,17,178,195,59,198,257,452,10,80,Massachusetts,Edgartown,4067
8618,1987-1988,1987-12-01,1988-03-22,113,0,24,201,225,20,46,66,291,6,40,Massachusetts,Edgartown,4067
8619,1988-1989,1988-12-01,1989-03-13,103,1,20,171,191,25,37,62,253,11,61,Massachusetts,Edgartown,4067
8620,1989-1990,1989-11-23,1990-04-07,136,2,33,217,250,40,78,118,368,13,75,Massachusetts,Edgartown,4067
8621,1990-1991,1990-12-01,1991-02-28,90,2,7,128,135,6,2,8,143,5,26,Massachusetts,Edgartown,4067
8622,1991-1992,1991-12-01,1992-04-17,139,0,22,210,232,27,27,54,286,11,58,Massachusetts,Edgartown,4067
8623,1992-1993,1992-12-01,1993-03-20,110,1,15,176,191,22,16,38,229,11,49,Massachusetts,Edgartown,4067
8624,1993-1994,1993-11-26,1994-03-19,114,6,36,225,261,78,143,221,482,21,144,Massachusetts,Edgartown,4067
8625,1994-1995,1994-12-01,1995-02-28,90,1,10,127,137,3,0,3,140,1,6,Massachusetts,Edgartown,4067
8626,1995-1996,1995-12-01,1996-04-08,130,16,24,231,255,77,171,248,503,21,136,Massachusetts,Edgartown,4067
8627,1996-1997,1996-11-16,1997-04-02,138,11,8,167,175,22,18,40,215,10,45,Massachusetts,Edgartown,4067
8628,1997-1998,1997-12-01,1998-03-13,103,14,3,100,103,1,0,1,104,1,2,Massachusetts,Edgartown,4067
8629,1999-2000,1999-12-01,2000-03-18,109,16,26,147,173,14,16,30,203,6,32,Massachusetts,Edgartown,4067
8630,2000-2001,2000-11-25,2001-03-27,123,6,11,189,200,21,18,39,239,9,41,Massachusetts,Edgartown,4067
8631,2001-2002,2001-12-01,2002-03-18,108,10,0,87,87,14,5,19,106,5,20,Massachusetts,Edgartown,4067
8632,2002-2003,2002-12-01,2003-04-08,129,16,32,207,239,81,174,255,494,19,129,Massachusetts,Edgartown,4067
8633,2003-2004,2003-12-01,2004-03-20,111,9,39,186,225,42,61,103,328,13,71,Massachusetts,Edgartown,4067
8634,2004-2005,2004-12-01,2005-03-24,114,10,21,167,188,96,201,297,485,18,142,Massachusetts,Edgartown,4067
8635,2005-2006,2005-12-01,2006-03-08,98,10,10,122,132,26,45,71,203,6,37,Massachusetts,Edgartown,4067
8636,2006-2007,2006-12-01,2007-03-16,106,9,25,154,179,13,12,25,204,4,19,Massachusetts,Edgartown,4067
8637,2007-2008,2007-12-01,2008-02-29,91,4,11,127,138,17,18,35,173,5,26,Massachusetts,Edgartown,4067
8638,2008-2009,2008-11-23,2009-03-04,102,20,22,165,187,36,34,70,257,14,70,Massachusetts,Edgartown,4067
8639,2009-2010,2009-12-01,2010-03-05,95,2,20,138,158,35,100,135,293,10,53,Massachusetts,Edgartown,4067
8640,2011-2012,2011-12-01,2012-02-29,91,0,2,73,75,14,12,26,101,4,19,Massachusetts,Edgartown,4067
8641,2012-2013,2012-12-01,2013-03-23,113,0,16,117,133,49,65,114,247,13,77,Massachusetts,Edgartown,4067
8642,2013-2014,2013-11-25,2014-03-27,123,0,32,217,249,62,119,181,430,15,105,Massachusetts,Edgartown,4067
8643,2014-2015,2014-12-01,2015-03-29,119,1,30,217,247,80,304,384,631,21,147,Massachusetts,Edgartown,4067
8644,2015-2016,2015-12-01,2016-03-21,112,0,12,95,107,44,64,108,215,11,69,Massachusetts,Edgartown,4067
8645,2016-2017,2016-12-01,2017-03-16,106,0,12,108,120,50,56,106,226,11,74,Massachusetts,Edgartown,4067
8646,2017-2018,2017-12-01,2018-04-03,124,0,30,144,174,28,33,61,235,12,61,Massachusetts,Edgartown,4067
8647,2018-2019,2018-11-23,2019-03-08,106,0,18,147,165,3,1,4,169,2,8,Massachusetts,Edgartown,4067
8648,2019-2020,2019-12-01,2020-03-07,98,0,6,98,104,20,18,38,142,5,26,Massachusetts,Edgartown,4067
8649,1950-1951,1950-11-21,1951-03-22,122,0,32,209,241,50,83,133,374,24,130,Massachusetts,Haverhill,60879
8650,1951-1952,1951-11-20,1952-03-20,122,2,33,260,293,89,276,365,658,29,166,Massachusetts,Haverhill,60879
8651,1952-1953,1952-11-09,1953-04-14,157,0,15,192,207,62,109,171,378,19,93,Massachusetts,Haverhill,60879
8652,1953-1954,1953-12-01,1954-04-01,122,0,32,227,259,39,67,106,365,17,102,Massachusetts,Haverhill,60879
8653,1954-1955,1954-12-01,1955-03-26,116,0,29,232,261,56,81,137,398,17,101,Massachusetts,Haverhill,60879
8654,1955-1956,1955-11-11,1956-04-23,165,0,40,318,358,137,290,427,785,37,212,Massachusetts,Haverhill,60879
8655,1956-1957,1956-11-18,1957-04-09,143,0,41,296,337,102,250,352,689,28,183,Massachusetts,Haverhill,60879
8656,1957-1958,1957-12-01,1958-04-11,132,0,28,210,238,91,277,368,606,24,146,Massachusetts,Haverhill,60879
8657,1958-1959,1958-11-30,1959-03-28,119,0,56,346,402,81,113,194,596,27,159,Massachusetts,Haverhill,60879
8658,1959-1960,1959-11-29,1960-03-20,113,0,19,206,225,85,269,354,579,24,135,Massachusetts,Haverhill,60879
8659,1960-1961,1960-12-01,1961-04-14,135,0,53,354,407,115,491,606,1013,26,187,Massachusetts,Haverhill,60879
8660,1961-1962,1961-11-20,1962-04-16,148,0,46,309,355,94,371,465,820,26,171,Massachusetts,Haverhill,60879
8661,1962-1963,1962-10-26,1963-03-21,147,0,44,323,367,66,271,337,704,24,130,Massachusetts,Haverhill,60879
8662,1963-1964,1963-11-15,1964-03-19,126,0,41,286,327,106,346,452,779,29,194,Massachusetts,Haverhill,60879
8663,1964-1965,1964-12-01,1965-03-31,121,0,51,282,333,79,201,280,613,30,173,Massachusetts,Haverhill,60879
8664,1965-1966,1965-12-01,1966-03-13,103,0,21,224,245,99,300,399,644,25,152,Massachusetts,Haverhill,60879
8665,1966-1967,1966-12-01,1967-04-24,145,0,33,291,324,121,350,471,795,32,194,Massachusetts,Haverhill,60879
8666,1967-1968,1967-11-15,1968-03-16,123,0,58,347,405,96,467,563,968,19,159,Massachusetts,Haverhill,60879
8667,1968-1969,1968-11-12,1969-03-30,139,1,41,280,321,130,651,781,1102,28,191,Massachusetts,Haverhill,60879
8668,1969-1970,1969-10-22,1970-04-02,163,0,44,330,374,95,288,383,757,31,169,Massachusetts,Haverhill,60879
8669,1970-1971,1970-12-01,1971-04-16,137,0,68,341,409,118,628,746,1155,36,221,Massachusetts,Haverhill,60879
8670,1971-1972,1971-11-11,1972-04-20,162,1,38,316,354,140,304,444,798,31,216,Massachusetts,Haverhill,60879
8671,1972-1973,1972-11-14,1973-04-05,143,0,43,257,300,63,210,273,573,25,120,Massachusetts,Haverhill,60879
8672,1973-1974,1973-12-01,1974-04-10,131,0,37,239,276,54,145,199,475,19,108,Massachusetts,Haverhill,60879
8673,1974-1975,1974-11-22,1975-04-08,138,0,18,241,259,79,178,257,516,22,126,Massachusetts,Haverhill,60879
8674,1975-1976,1975-11-24,1976-03-20,118,0,53,288,341,95,306,401,742,29,200,Massachusetts,Haverhill,60879
8675,1976-1977,1976-11-10,1977-05-10,182,0,55,361,416,108,561,669,1085,23,159,Massachusetts,Haverhill,60879
8676,1977-1978,1977-11-28,1978-03-26,119,0,52,334,386,128,593,721,1107,27,224,Massachusetts,Haverhill,60879
8677,1978-1979,1978-11-21,1979-04-09,140,0,59,282,341,57,136,193,534,25,120,Massachusetts,Haverhill,60879
8678,1983-1984,1983-12-01,1984-03-30,121,17,58,335,393,53,160,213,606,15,109,Massachusetts,Haverhill,60879
8679,1984-1985,1984-12-01,1985-04-01,122,18,50,323,373,51,81,132,505,21,143,Massachusetts,Haverhill,60879
8680,1985-1986,1985-11-16,1986-03-21,126,11,43,357,400,45,85,130,530,16,91,Massachusetts,Haverhill,60879
8681,1988-1989,1988-12-01,1989-04-08,129,7,37,299,336,29,16,45,381,13,72,Massachusetts,Haverhill,60879
8682,1990-1991,1990-11-12,1991-03-24,133,8,28,252,280,35,67,102,382,12,63,Massachusetts,Haverhill,60879
8683,1994-1995,1994-11-23,1995-04-05,134,5,31,262,293,35,80,115,408,10,71,Massachusetts,Haverhill,60879
8684,1997-1998,1997-11-14,1998-03-22,129,12,14,219,233,52,119,171,404,16,81,Massachusetts,Haverhill,60879
8685,1998-1999,1998-12-01,1999-03-15,105,15,27,230,257,55,93,148,405,19,121,Massachusetts,Haverhill,60879
8686,2001-2002,2001-12-01,2002-04-25,146,15,3,197,200,55,73,128,328,17,82,Massachusetts,Haverhill,60879
8687,2002-2003,2002-11-16,2003-04-09,145,13,59,392,451,124,543,667,1118,32,235,Massachusetts,Haverhill,60879
8688,2003-2004,2003-12-01,2004-03-22,113,20,58,299,357,71,159,230,587,16,105,Massachusetts,Haverhill,60879
8689,2012-2013,2012-11-08,2013-03-23,136,5,37,254,291,94,202,296,587,21,155,Massachusetts,Haverhill,60879
8690,2013-2014,2013-11-25,2014-04-16,143,15,77,409,486,118,394,512,998,24,216,Massachusetts,Haverhill,60879
8691,2014-2015,2014-11-27,2015-04-09,134,8,78,426,504,169,499,668,1172,32,321,Massachusetts,Haverhill,60879
8692,2015-2016,2015-12-01,2016-04-05,127,8,29,214,243,46,72,118,361,10,80,Massachusetts,Haverhill,60879
8693,2016-2017,2016-12-01,2017-04-03,124,20,35,263,298,92,180,272,570,20,159,Massachusetts,Haverhill,60879
8694,2017-2018,2017-12-01,2018-04-07,128,20,57,297,354,112,220,332,686,17,149,Massachusetts,Haverhill,60879
8695,2018-2019,2018-11-16,2019-03-15,120,2,43,312,355,67,143,210,565,15,129,Massachusetts,Haverhill,60879
8696,2019-2020,2019-11-14,2020-04-18,157,4,23,264,287,52,111,163,450,12,80,Massachusetts,Haverhill,60879
8697,1960-1961,1960-10-25,1961-04-13,171,0,53,361,414,103,396,499,913,27,169,Massachusetts,Hingham,22157
8698,1961-1962,1961-11-21,1962-04-16,147,2,40,287,327,71,267,338,665,20,132,Massachusetts,Hingham,22157
8699,1962-1963,1962-10-26,1963-03-23,149,0,47,320,367,57,119,176,543,22,108,Massachusetts,Hingham,22157
8700,1963-1964,1963-12-01,1964-03-19,110,0,40,277,317,104,382,486,803,24,173,Massachusetts,Hingham,22157
8701,1964-1965,1964-12-01,1965-04-19,140,0,41,291,332,88,252,340,672,34,194,Massachusetts,Hingham,22157
8702,1965-1966,1965-12-01,1966-03-14,104,0,21,217,238,78,231,309,547,28,152,Massachusetts,Hingham,22157
8703,1966-1967,1966-12-01,1967-04-24,145,0,31,272,303,90,265,355,658,32,167,Massachusetts,Hingham,22157
8704,1967-1968,1967-11-15,1968-03-14,121,0,52,318,370,82,231,313,683,26,170,Massachusetts,Hingham,22157
8705,1968-1969,1968-12-01,1969-03-30,120,1,37,243,280,86,290,376,656,21,127,Massachusetts,Hingham,22157
8706,1969-1970,1969-12-01,1970-04-02,123,0,45,303,348,97,239,336,684,31,190,Massachusetts,Hingham,22157
8707,1970-1971,1970-12-01,1971-04-16,137,0,53,293,346,90,361,451,797,34,161,Massachusetts,Hingham,22157
8708,1971-1972,1971-11-11,1972-04-20,162,0,35,274,309,81,141,222,531,31,151,Massachusetts,Hingham,22157
8709,1972-1973,1972-11-15,1973-03-22,128,0,32,203,235,32,41,73,308,20,76,Massachusetts,Hingham,22157
8710,1973-1974,1973-12-01,1974-04-10,131,1,26,219,245,53,183,236,481,16,97,Massachusetts,Hingham,22157
8711,1974-1975,1974-11-22,1975-04-08,138,0,15,224,239,64,142,206,445,27,122,Massachusetts,Hingham,22157
8712,1975-1976,1975-12-01,1976-03-19,110,0,42,247,289,82,219,301,590,25,161,Massachusetts,Hingham,22157
8713,1976-1977,1976-11-10,1977-03-23,134,0,50,345,395,92,461,553,948,27,171,Massachusetts,Hingham,22157
8714,1977-1978,1977-11-28,1978-03-26,119,2,52,301,353,130,525,655,1008,29,211,Massachusetts,Hingham,22157
8715,1978-1979,1978-11-21,1979-04-09,140,0,59,270,329,50,110,160,489,21,107,Massachusetts,Hingham,22157
8716,1979-1980,1979-12-01,1980-03-14,105,1,30,231,261,29,30,59,320,15,71,Massachusetts,Hingham,22157
8717,1980-1981,1980-11-18,1981-03-21,124,0,54,314,368,44,177,221,589,19,112,Massachusetts,Hingham,22157
8718,1981-1982,1981-12-01,1982-04-11,132,0,46,282,328,84,219,303,631,30,171,Massachusetts,Hingham,22157
8719,1982-1983,1982-12-01,1983-03-12,102,0,24,171,195,60,162,222,417,17,96,Massachusetts,Hingham,22157
8720,1983-1984,1983-12-01,1984-04-01,123,1,46,251,297,65,143,208,505,23,138,Massachusetts,Hingham,22157
8721,1984-1985,1984-11-13,1985-04-08,147,0,32,254,286,66,181,247,533,30,148,Massachusetts,Hingham,22157
8722,1985-1986,1985-11-16,1986-03-21,126,0,25,233,258,41,65,106,364,23,84,Massachusetts,Hingham,22157
8723,1986-1987,1986-11-11,1987-04-29,170,1,16,253,269,78,299,377,646,33,130,Massachusetts,Hingham,22157
8724,1987-1988,1987-11-11,1988-03-21,132,0,27,247,274,87,253,340,614,22,126,Massachusetts,Hingham,22157
8725,1988-1989,1988-12-01,1989-04-08,129,0,30,236,266,39,76,115,381,18,86,Massachusetts,Hingham,22157
8726,1989-1990,1989-11-20,1990-04-07,139,0,51,269,320,77,142,219,539,27,156,Massachusetts,Hingham,22157
8727,1990-1991,1990-12-01,1991-03-30,120,1,15,181,196,34,46,80,276,19,78,Massachusetts,Hingham,22157
8728,1991-1992,1991-12-01,1992-04-17,139,0,27,241,268,46,36,82,350,28,115,Massachusetts,Hingham,22157
8729,1992-1993,1992-12-01,1993-04-27,148,0,36,258,294,88,208,296,590,30,176,Massachusetts,Hingham,22157
8730,1993-1994,1993-12-01,1994-03-21,111,0,60,284,344,137,496,633,977,37,260,Massachusetts,Hingham,22157
8731,1994-1995,1994-11-28,1995-03-12,105,0,24,176,200,29,45,74,274,15,63,Massachusetts,Hingham,22157
8732,1995-1996,1995-11-14,1996-04-10,149,0,49,287,336,163,411,574,910,43,274,Massachusetts,Hingham,22157
8733,1996-1997,1996-11-15,1997-04-06,143,2,25,190,215,71,70,141,356,24,116,Massachusetts,Hingham,22157
8734,1997-1998,1997-11-14,1998-03-23,130,0,7,153,160,37,62,99,259,24,66,Massachusetts,Hingham,22157
8735,1998-1999,1998-12-01,1999-03-16,106,0,21,181,202,73,88,161,363,21,130,Massachusetts,Hingham,22157
8736,1999-2000,1999-11-30,2000-03-18,110,0,31,193,224,40,142,182,406,17,92,Massachusetts,Hingham,22157
8737,2000-2001,2000-11-24,2001-04-02,130,0,23,242,265,78,203,281,546,36,142,Massachusetts,Hingham,22157
8738,2001-2002,2001-12-01,2002-04-06,127,0,1,138,139,32,22,54,193,19,56,Massachusetts,Hingham,22157
8739,2002-2003,2002-11-27,2003-04-08,133,0,55,300,355,113,290,403,758,34,193,Massachusetts,Hingham,22157
8740,2003-2004,2003-12-01,2004-03-20,111,0,49,241,290,63,108,171,461,22,114,Massachusetts,Hingham,22157
8741,2004-2005,2004-11-12,2005-03-24,133,0,32,261,293,132,412,544,837,37,233,Massachusetts,Hingham,22157
8742,2005-2006,2005-10-29,2006-04-05,159,1,18,205,223,55,87,142,365,22,97,Massachusetts,Hingham,22157
8743,2006-2007,2006-12-01,2007-04-04,125,0,29,211,240,34,32,66,306,17,63,Massachusetts,Hingham,22157
8744,2007-2008,2007-11-20,2008-03-15,117,0,21,193,214,67,159,226,440,24,115,Massachusetts,Hingham,22157
8745,2008-2009,2008-11-22,2009-03-09,108,0,35,242,277,102,328,430,707,22,156,Massachusetts,Hingham,22157
8746,2009-2010,2009-12-01,2010-03-05,95,0,24,177,201,65,160,225,426,23,105,Massachusetts,Hingham,22157
8747,2010-2011,2010-12-01,2011-04-01,122,0,26,254,280,100,469,569,849,30,170,Massachusetts,Hingham,22157
8748,2011-2012,2011-12-01,2012-03-10,101,5,9,131,140,19,13,32,172,14,40,Massachusetts,Hingham,22157
8749,2012-2013,2012-12-01,2013-03-23,113,0,19,168,187,97,188,285,472,27,150,Massachusetts,Hingham,22157
8750,2013-2014,2013-11-25,2014-04-16,143,5,42,299,341,97,245,342,683,32,190,Massachusetts,Hingham,22157
8751,2014-2015,2014-11-28,2015-04-04,128,1,53,316,369,163,655,818,1187,44,318,Massachusetts,Hingham,22157
8752,2015-2016,2015-12-01,2016-04-06,128,0,18,152,170,55,102,157,327,20,96,Massachusetts,Hingham,22157
8753,2016-2017,2016-12-01,2017-04-01,122,0,17,180,197,72,128,200,397,22,126,Massachusetts,Hingham,22157
8754,2017-2018,2017-12-01,2018-04-06,127,0,46,215,261,88,160,248,509,25,140,Massachusetts,Hingham,22157
8755,2018-2019,2018-11-16,2019-03-23,128,0,21,228,249,66,118,184,433,18,102,Massachusetts,Hingham,22157
8756,2019-2020,2019-11-12,2020-04-18,159,2,10,159,169,28,33,61,230,16,53,Massachusetts,Hingham,22157
8757,1950-1951,1950-11-21,1951-03-22,122,0,36,206,242,66,69,135,377,27,143,Massachusetts,Milton,27003
8758,1951-1952,1951-11-02,1952-03-25,145,1,38,255,293,94,265,359,652,35,171,Massachusetts,Milton,27003
8759,1952-1953,1952-11-09,1953-04-14,157,1,24,203,227,84,116,200,427,24,131,Massachusetts,Milton,27003
8760,1953-1954,1953-12-01,1954-04-01,122,4,46,224,270,51,98,149,419,21,129,Massachusetts,Milton,27003
8761,1954-1955,1954-11-26,1955-04-04,130,1,51,256,307,65,98,163,470,27,141,Massachusetts,Milton,27003
8762,1955-1956,1955-11-19,1956-04-23,157,4,59,333,392,153,297,450,842,36,239,Massachusetts,Milton,27003
8763,1956-1957,1956-11-18,1957-04-13,147,5,57,249,306,114,244,358,664,35,211,Massachusetts,Milton,27003
8764,1957-1958,1957-10-27,1958-04-12,168,7,44,251,295,127,301,428,723,30,197,Massachusetts,Milton,27003
8765,1958-1959,1958-11-30,1959-03-29,120,0,77,350,427,64,117,181,608,23,138,Massachusetts,Milton,27003
8766,1959-1960,1959-11-17,1960-03-27,132,3,38,261,299,87,252,339,638,34,183,Massachusetts,Milton,27003
8767,1960-1961,1960-10-24,1961-04-19,178,1,84,335,419,124,485,609,1028,23,188,Massachusetts,Milton,27003
8768,1961-1962,1961-11-20,1962-04-16,148,1,62,297,359,87,325,412,771,25,154,Massachusetts,Milton,27003
8769,1962-1963,1962-10-26,1963-03-24,150,0,68,339,407,71,229,300,707,29,154,Massachusetts,Milton,27003
8770,1963-1964,1963-10-30,1964-03-22,145,0,60,279,339,120,371,491,830,32,224,Massachusetts,Milton,27003
8771,1964-1965,1964-11-22,1965-04-19,149,0,70,315,385,92,239,331,716,33,226,Massachusetts,Milton,27003
8772,1965-1966,1965-12-01,1966-03-16,106,0,52,232,284,104,316,420,704,29,193,Massachusetts,Milton,27003
8773,1966-1967,1966-12-01,1967-04-24,145,0,60,285,345,152,342,494,839,35,248,Massachusetts,Milton,27003
8774,1967-1968,1967-11-07,1968-03-16,131,0,76,330,406,95,334,429,835,24,184,Massachusetts,Milton,27003
8775,1968-1969,1968-11-10,1969-04-01,143,0,67,287,354,123,530,653,1007,30,188,Massachusetts,Milton,27003
8776,1969-1970,1969-11-22,1970-04-02,132,0,86,333,419,85,342,427,846,26,180,Massachusetts,Milton,27003
8777,1970-1971,1970-11-25,1971-04-17,144,0,94,331,425,86,358,444,869,30,177,Massachusetts,Milton,27003
8778,1971-1972,1971-11-21,1972-04-21,153,0,61,307,368,113,194,307,675,33,218,Massachusetts,Milton,27003
8779,1972-1973,1972-10-19,1973-03-23,156,0,47,244,291,39,64,103,394,20,90,Massachusetts,Milton,27003
8780,1973-1974,1973-12-01,1974-04-11,132,0,53,250,303,50,176,226,529,17,113,Massachusetts,Milton,27003
8781,1974-1975,1974-11-21,1975-04-26,157,0,34,247,281,70,182,252,533,28,122,Massachusetts,Milton,27003
8782,1975-1976,1975-11-24,1976-03-20,118,0,61,280,341,88,203,291,632,29,196,Massachusetts,Milton,27003
8783,1976-1977,1976-11-09,1977-05-11,184,0,96,360,456,118,472,590,1046,29,217,Massachusetts,Milton,27003
8784,1977-1978,1977-11-27,1978-04-07,132,0,79,337,416,131,553,684,1100,25,211,Massachusetts,Milton,27003
8785,1978-1979,1978-11-21,1979-04-09,140,0,90,311,401,56,103,159,560,27,142,Massachusetts,Milton,27003
8786,1979-1980,1979-10-10,1980-03-26,169,0,54,286,340,39,40,79,419,17,94,Massachusetts,Milton,27003
8787,1980-1981,1980-11-17,1981-03-21,125,0,77,350,427,66,207,273,700,23,154,Massachusetts,Milton,27003
8788,1981-1982,1981-12-01,1982-04-12,133,0,75,329,404,109,328,437,841,34,229,Massachusetts,Milton,27003
8789,1982-1983,1982-12-01,1983-03-12,102,0,43,193,236,81,249,330,566,21,153,Massachusetts,Milton,27003
8790,1983-1984,1983-12-01,1984-04-05,127,0,67,281,348,89,178,267,615,29,186,Massachusetts,Milton,27003
8791,1984-1985,1984-11-13,1985-04-08,147,0,58,285,343,70,194,264,607,24,170,Massachusetts,Milton,27003
8792,1985-1986,1985-11-16,1986-03-21,126,0,56,278,334,43,82,125,459,29,132,Massachusetts,Milton,27003
8793,1986-1987,1986-11-11,1987-04-30,171,0,38,287,325,126,405,531,856,36,200,Massachusetts,Milton,27003
8794,1987-1988,1987-11-10,1988-03-21,133,0,51,266,317,99,259,358,675,22,148,Massachusetts,Milton,27003
8795,1988-1989,1988-12-01,1989-04-08,129,0,48,261,309,51,87,138,447,21,128,Massachusetts,Milton,27003
8796,1989-1990,1989-11-20,1990-04-07,139,0,73,321,394,88,179,267,661,28,186,Massachusetts,Milton,27003
8797,1990-1991,1990-11-08,1991-03-30,143,12,32,229,261,46,70,116,377,26,127,Massachusetts,Milton,27003
8798,1991-1992,1991-11-11,1992-04-17,159,0,47,288,335,50,55,105,440,30,139,Massachusetts,Milton,27003
8799,1992-1993,1992-11-15,1993-04-27,164,0,59,305,364,127,297,424,788,41,256,Massachusetts,Milton,27003
8800,1993-1994,1993-11-24,1994-03-30,127,0,91,335,426,147,479,626,1052,38,316,Massachusetts,Milton,27003
8801,1994-1995,1994-11-23,1995-04-05,134,0,45,234,279,34,56,90,369,19,81,Massachusetts,Milton,27003
8802,1995-1996,1995-11-13,1996-04-13,153,0,79,321,400,201,489,690,1090,42,353,Massachusetts,Milton,27003
8803,1996-1997,1996-11-15,1997-04-09,146,0,38,244,282,109,110,219,501,32,195,Massachusetts,Milton,27003
8804,1997-1998,1997-11-14,1998-04-10,148,0,24,178,202,66,182,248,450,27,115,Massachusetts,Milton,27003
8805,1998-1999,1998-12-01,1999-03-18,108,1,30,214,244,85,113,198,442,23,163,Massachusetts,Milton,27003
8806,1999-2000,1999-12-01,2000-04-27,149,0,55,245,300,48,183,231,531,17,106,Massachusetts,Milton,27003
8807,2000-2001,2000-10-30,2001-04-19,172,0,56,317,373,135,421,556,929,39,241,Massachusetts,Milton,27003
8808,2001-2002,2001-12-01,2002-04-26,147,0,14,167,181,59,73,132,313,19,91,Massachusetts,Milton,27003
8809,2002-2003,2002-10-23,2003-04-10,170,0,93,389,482,168,545,713,1195,45,308,Massachusetts,Milton,27003
8810,2003-2004,2003-10-23,2004-04-05,166,1,80,334,414,91,169,260,674,30,197,Massachusetts,Milton,27003
8811,2004-2005,2004-11-13,2005-04-13,152,4,57,283,340,173,489,662,1002,39,301,Massachusetts,Milton,27003
8812,2005-2006,2005-10-30,2006-04-06,159,2,37,247,284,78,146,224,508,27,147,Massachusetts,Milton,27003
8813,2006-2007,2006-12-01,2007-04-05,126,1,50,261,311,43,59,102,413,19,92,Massachusetts,Milton,27003
8814,2007-2008,2007-11-20,2008-03-29,131,2,39,249,288,99,206,305,593,37,184,Massachusetts,Milton,27003
8815,2008-2009,2008-11-20,2009-04-11,143,4,59,310,369,110,326,436,805,25,194,Massachusetts,Milton,27003
8816,2011-2012,2011-10-28,2012-03-07,132,0,14,176,190,38,45,83,273,18,83,Massachusetts,Milton,27003
8817,2012-2013,2012-11-08,2013-03-26,139,0,39,216,255,140,252,392,647,31,217,Massachusetts,Milton,27003
8818,2013-2014,2013-11-13,2014-04-16,155,0,78,359,437,123,332,455,892,35,261,Massachusetts,Milton,27003
8819,2014-2015,2014-11-03,2015-04-03,152,0,86,395,481,209,727,936,1417,46,420,Massachusetts,Milton,27003
8820,2015-2016,2015-12-01,2016-04-07,129,0,28,185,213,81,127,208,421,17,130,Massachusetts,Milton,27003
8821,2016-2017,2016-12-01,2017-04-03,124,0,34,225,259,89,153,242,501,23,164,Massachusetts,Milton,27003
8822,2017-2018,2017-12-01,2018-04-07,128,0,68,261,329,125,270,395,724,28,207,Massachusetts,Milton,27003
8823,2018-2019,2018-11-16,2019-03-23,128,0,46,292,338,68,133,201,539,16,116,Massachusetts,Milton,27003
8824,2019-2020,2019-11-13,2020-04-19,159,3,21,211,232,49,59,108,340,21,88,Massachusetts,Milton,27003
8825,1951-1952,1951-11-01,1952-04-12,164,0,106,483,589,157,735,892,1481,58,378,Michigan,Alpena,10483
8826,1952-1953,1952-10-19,1953-04-17,181,0,56,364,420,86,250,336,756,52,264,Michigan,Alpena,10483
8827,1953-1954,1953-10-28,1954-05-05,190,13,74,405,479,106,359,465,944,42,272,Michigan,Alpena,10483
8828,1955-1956,1955-11-03,1956-04-29,179,12,86,508,594,110,343,453,1047,29,218,Michigan,Alpena,10483
8829,1957-1958,1957-11-11,1958-03-20,130,19,92,363,455,46,335,381,836,25,118,Michigan,Alpena,10483
8830,1958-1959,1958-11-26,1959-04-10,136,12,176,539,715,100,490,590,1305,43,317,Michigan,Alpena,10483
8831,1959-1960,1959-10-27,1960-04-09,166,0,118,585,703,125,735,860,1563,66,427,Michigan,Alpena,10483
8832,1960-1961,1960-10-23,1961-05-02,192,0,133,597,730,94,344,438,1168,52,357,Michigan,Alpena,10483
8833,1961-1962,1961-11-07,1962-04-15,160,0,158,580,738,133,756,889,1627,62,455,Michigan,Alpena,10483
8834,1962-1963,1962-10-24,1963-05-01,190,0,205,729,934,130,740,870,1804,60,514,Michigan,Alpena,10483
8835,1963-1964,1963-11-01,1964-04-09,161,0,101,534,635,102,316,418,1053,57,392,Michigan,Alpena,10483
8836,1964-1965,1964-10-09,1965-04-17,191,0,146,610,756,149,448,597,1353,69,542,Michigan,Alpena,10483
8837,1965-1966,1965-10-28,1966-05-28,213,0,106,485,591,92,235,327,918,62,345,Michigan,Alpena,10483
8838,1966-1967,1966-11-02,1967-04-07,157,0,117,600,717,179,763,942,1659,59,531,Michigan,Alpena,10483
8839,1967-1968,1967-10-27,1968-04-25,182,0,139,540,679,94,260,354,1033,61,414,Michigan,Alpena,10483
8840,1968-1969,1968-10-29,1969-04-01,155,0,115,502,617,136,633,769,1386,66,466,Michigan,Alpena,10483
8841,1969-1970,1969-10-21,1970-05-05,197,0,145,639,784,148,586,734,1518,72,548,Michigan,Alpena,10483
8842,1970-1971,1970-11-21,1971-04-26,157,0,139,582,721,241,954,1195,1916,87,681,Michigan,Alpena,10483
8843,1971-1972,1971-11-07,1972-04-22,168,0,129,579,708,136,580,716,1424,68,450,Michigan,Alpena,10483
8844,1972-1973,1972-10-17,1973-04-14,180,0,106,468,574,131,388,519,1093,58,389,Michigan,Alpena,10483
8845,1973-1974,1973-11-09,1974-05-06,179,0,145,524,669,112,364,476,1145,56,365,Michigan,Alpena,10483
8846,1974-1975,1974-10-19,1975-04-09,173,0,83,465,548,102,505,607,1155,63,327,Michigan,Alpena,10483
8847,1975-1976,1975-11-13,1976-05-03,173,0,125,524,649,156,709,865,1514,74,533,Michigan,Alpena,10483
8848,1976-1977,1976-10-19,1977-04-08,172,0,195,592,787,104,601,705,1492,64,459,Michigan,Alpena,10483
8849,1977-1978,1977-11-11,1978-04-13,154,0,163,590,753,176,892,1068,1821,73,569,Michigan,Alpena,10483
8850,1978-1979,1978-11-20,1979-05-06,168,0,190,564,754,140,791,931,1685,66,463,Michigan,Alpena,10483
8851,1979-1980,1979-10-12,1980-04-15,187,0,133,487,620,115,295,410,1030,60,378,Michigan,Alpena,10483
8852,1980-1981,1980-10-04,1981-03-26,174,0,138,520,658,120,497,617,1275,58,456,Michigan,Alpena,10483
8853,1981-1982,1981-10-18,1982-04-17,182,0,166,580,746,135,733,868,1614,70,521,Michigan,Alpena,10483
8854,1982-1983,1982-10-16,1983-04-18,185,0,79,361,440,112,346,458,898,53,299,Michigan,Alpena,10483
8855,1983-1984,1983-11-10,1984-05-01,174,0,153,527,680,117,540,657,1337,67,446,Michigan,Alpena,10483
8856,1984-1985,1984-11-02,1985-04-07,157,0,129,468,597,183,736,919,1516,76,555,Michigan,Alpena,10483
8857,1985-1986,1985-11-09,1986-04-22,165,0,144,505,649,151,815,966,1615,75,536,Michigan,Alpena,10483
8858,1986-1987,1986-10-30,1987-04-05,158,0,59,414,473,96,368,464,937,54,291,Michigan,Alpena,10483
8859,1987-1988,1987-10-22,1988-04-27,189,0,124,514,638,148,445,593,1231,78,509,Michigan,Alpena,10483
8860,1988-1989,1988-10-11,1989-05-07,209,0,121,517,638,148,428,576,1214,82,511,Michigan,Alpena,10483
8861,1989-1990,1989-10-03,1990-05-10,220,0,127,566,693,183,818,1001,1694,81,556,Michigan,Alpena,10483
8862,1990-1991,1990-10-28,1991-04-10,165,0,92,408,500,114,375,489,989,60,359,Michigan,Alpena,10483
8863,1991-1992,1991-11-03,1992-04-17,167,0,99,465,564,129,549,678,1242,60,407,Michigan,Alpena,10483
8864,1992-1993,1992-10-17,1993-04-21,187,0,106,510,616,122,435,557,1173,65,380,Michigan,Alpena,10483
8865,1993-1994,1993-10-03,1994-05-01,211,0,192,645,837,141,545,686,1523,67,548,Michigan,Alpena,10483
8866,1994-1995,1994-11-22,1995-04-26,156,0,92,415,507,96,274,370,877,54,354,Michigan,Alpena,10483
8867,1995-1996,1995-10-31,1996-05-01,184,9,180,627,807,173,724,897,1704,86,586,Michigan,Alpena,10483
8868,1998-1999,1998-11-20,1999-03-24,125,5,107,389,496,106,515,621,1117,31,282,Michigan,Alpena,10483
8869,1999-2000,1999-11-03,2000-04-12,162,0,90,418,508,81,248,329,837,38,258,Michigan,Alpena,10483
8870,2000-2001,2000-10-08,2001-04-17,192,3,139,487,626,161,688,849,1475,57,464,Michigan,Alpena,10483
8871,2001-2002,2001-10-07,2002-05-03,209,3,63,385,448,128,412,540,988,42,290,Michigan,Alpena,10483
8872,2002-2003,2002-11-01,2003-04-12,163,3,177,573,750,124,379,503,1253,50,427,Michigan,Alpena,10483
8873,2003-2004,2003-11-08,2004-05-03,178,3,117,484,601,142,579,721,1322,53,398,Michigan,Alpena,10483
8874,2004-2005,2004-11-24,2005-04-25,153,0,141,503,644,155,730,885,1529,66,513,Michigan,Alpena,10483
8875,2005-2006,2005-11-16,2006-04-05,141,2,84,393,477,138,718,856,1333,64,381,Michigan,Alpena,10483
8876,2006-2007,2006-11-10,2007-04-16,158,0,119,413,532,119,483,602,1134,53,396,Michigan,Alpena,10483
8877,2007-2008,2007-11-08,2008-04-12,157,0,116,486,602,112,737,849,1451,58,366,Michigan,Alpena,10483
8878,2008-2009,2008-11-09,2009-04-06,149,0,158,560,718,187,915,1102,1820,72,570,Michigan,Alpena,10483
8879,2009-2010,2009-11-30,2010-05-08,160,0,95,370,465,77,477,554,1019,43,268,Michigan,Alpena,10483
8880,2010-2011,2010-11-05,2011-04-23,170,9,150,515,665,140,583,723,1388,67,477,Michigan,Alpena,10483
8881,2011-2012,2011-11-10,2012-03-30,142,3,54,293,347,79,315,394,741,35,195,Michigan,Alpena,10483
8882,2012-2013,2012-11-24,2013-04-20,148,1,101,380,481,80,381,461,942,52,294,Michigan,Alpena,10483
8883,2013-2014,2013-11-12,2014-04-16,156,0,245,715,960,114,771,885,1845,73,629,Michigan,Alpena,10483
8884,2014-2015,2014-11-10,2015-04-06,148,0,177,603,780,77,382,459,1239,34,283,Michigan,Alpena,10483
8885,2015-2016,2015-11-21,2016-04-13,145,0,76,353,429,144,427,571,1000,60,420,Michigan,Alpena,10483
8886,2016-2017,2016-11-19,2017-03-31,133,0,81,323,404,110,291,401,805,61,332,Michigan,Alpena,10483
8887,2017-2018,2017-11-10,2018-04-24,166,0,135,527,662,122,369,491,1153,49,380,Michigan,Alpena,10483
8888,2018-2019,2018-10-17,2019-04-15,181,0,136,537,673,156,699,855,1528,74,526,Michigan,Alpena,10483
8889,2019-2020,2019-10-31,2020-04-21,174,0,69,378,447,104,416,520,967,52,280,Michigan,Alpena,10483
8890,1951-1952,1951-11-03,1952-04-13,163,0,65,298,363,83,180,263,626,38,203,Michigan,Ann Arbor,113934
8891,1952-1953,1952-11-28,1953-04-21,145,0,30,190,220,33,35,68,288,25,91,Michigan,Ann Arbor,113934
8892,1953-1954,1953-11-07,1954-04-03,148,11,49,262,311,49,87,136,447,27,135,Michigan,Ann Arbor,113934
8893,1955-1956,1955-11-19,1956-03-27,130,9,41,303,344,51,151,202,546,23,114,Michigan,Ann Arbor,113934
8894,1956-1957,1956-11-23,1957-03-03,101,4,57,237,294,35,117,152,446,9,63,Michigan,Ann Arbor,113934
8895,1957-1958,1957-11-09,1958-02-28,112,1,58,243,301,25,46,71,372,16,71,Michigan,Ann Arbor,113934
8896,1958-1959,1958-11-27,1959-03-28,122,0,93,382,475,54,298,352,827,28,187,Michigan,Ann Arbor,113934
8897,1959-1960,1959-11-18,1960-03-25,129,0,63,286,349,45,167,212,561,20,113,Michigan,Ann Arbor,113934
8898,1960-1961,1960-11-30,1961-04-09,131,8,79,308,387,29,113,142,529,13,92,Michigan,Ann Arbor,113934
8899,1961-1962,1961-11-28,1962-03-15,108,1,85,300,385,44,159,203,588,19,115,Michigan,Ann Arbor,113934
8900,1962-1963,1962-12-01,1963-03-21,111,3,117,365,482,50,342,392,874,27,171,Michigan,Ann Arbor,113934
8901,1963-1964,1963-12-01,1964-04-03,125,0,58,285,343,50,117,167,510,19,106,Michigan,Ann Arbor,113934
8902,1964-1965,1964-11-21,1965-04-02,133,2,98,332,430,40,101,141,571,16,101,Michigan,Ann Arbor,113934
8903,1965-1966,1965-11-28,1966-04-07,131,0,75,251,326,11,24,35,361,8,33,Michigan,Ann Arbor,113934
8904,1966-1967,1966-11-02,1967-03-25,144,1,73,300,373,104,452,556,929,27,168,Michigan,Ann Arbor,113934
8905,1967-1968,1967-11-06,1968-03-25,141,3,74,302,376,33,78,111,487,11,74,Michigan,Ann Arbor,113934
8906,1968-1969,1968-11-20,1969-03-30,131,0,63,250,313,21,29,50,363,14,54,Michigan,Ann Arbor,113934
8907,1969-1970,1969-11-15,1970-04-02,139,0,73,342,415,73,153,226,641,44,246,Michigan,Ann Arbor,113934
8908,1970-1971,1970-11-15,1971-04-03,140,5,83,304,387,70,127,197,584,47,225,Michigan,Ann Arbor,113934
8909,1971-1972,1971-11-09,1972-04-07,151,2,69,309,378,45,47,92,470,34,153,Michigan,Ann Arbor,113934
8910,1972-1973,1972-11-14,1973-04-10,148,1,52,227,279,79,144,223,502,33,162,Michigan,Ann Arbor,113934
8911,1973-1974,1973-12-01,1974-04-05,126,1,70,266,336,71,203,274,610,33,200,Michigan,Ann Arbor,113934
8912,1974-1975,1974-11-14,1975-04-19,157,1,48,285,333,103,286,389,722,50,214,Michigan,Ann Arbor,113934
8913,1975-1976,1975-11-25,1976-04-26,154,0,72,326,398,84,327,411,809,46,226,Michigan,Ann Arbor,113934
8914,1976-1977,1976-11-07,1977-04-07,152,0,145,459,604,87,317,404,1008,55,367,Michigan,Ann Arbor,113934
8915,1977-1978,1977-11-11,1978-04-21,162,0,135,454,589,117,609,726,1315,62,398,Michigan,Ann Arbor,113934
8916,1978-1979,1978-11-21,1979-04-09,140,0,137,392,529,90,284,374,903,63,366,Michigan,Ann Arbor,113934
8917,1979-1980,1979-11-08,1980-04-15,160,12,82,329,411,61,90,151,562,44,215,Michigan,Ann Arbor,113934
8918,1980-1981,1980-10-28,1981-03-20,144,3,91,350,441,77,274,351,792,49,270,Michigan,Ann Arbor,113934
8919,1981-1982,1981-10-19,1982-04-11,175,1,121,421,542,128,473,601,1143,69,448,Michigan,Ann Arbor,113934
8920,1982-1983,1982-11-05,1983-04-18,165,2,43,233,276,58,41,99,375,32,129,Michigan,Ann Arbor,113934
8921,1983-1984,1983-11-16,1984-04-17,154,1,125,390,515,89,323,412,927,56,340,Michigan,Ann Arbor,113934
8922,1984-1985,1984-11-11,1985-04-17,158,0,76,328,404,88,258,346,750,51,296,Michigan,Ann Arbor,113934
8923,1985-1986,1985-11-16,1986-04-22,158,7,89,350,439,92,291,383,822,59,338,Michigan,Ann Arbor,113934
8924,1986-1987,1986-11-11,1987-04-05,146,0,38,260,298,84,162,246,544,43,191,Michigan,Ann Arbor,113934
8925,1987-1988,1987-10-21,1988-04-16,179,1,82,328,410,98,216,314,724,53,301,Michigan,Ann Arbor,113934
8926,1988-1989,1988-10-26,1989-04-10,167,0,58,304,362,73,56,129,491,49,221,Michigan,Ann Arbor,113934
8927,1989-1990,1989-10-19,1990-04-12,176,0,75,320,395,97,205,302,697,57,283,Michigan,Ann Arbor,113934
8928,1990-1991,1990-11-06,1991-04-01,147,0,48,255,303,73,117,190,493,39,203,Michigan,Ann Arbor,113934
8929,1991-1992,1991-11-03,1992-04-14,164,2,50,282,332,97,153,250,582,52,268,Michigan,Ann Arbor,113934
8930,1992-1993,1992-10-19,1993-04-21,185,1,55,289,344,124,230,354,698,65,296,Michigan,Ann Arbor,113934
8931,1993-1994,1993-10-31,1994-04-06,158,0,109,397,506,103,235,338,844,60,399,Michigan,Ann Arbor,113934
8932,1994-1995,1994-11-23,1995-04-10,139,0,60,274,334,86,198,284,618,42,223,Michigan,Ann Arbor,113934
8933,1995-1996,1995-11-04,1996-04-16,165,0,116,423,539,94,126,220,759,63,354,Michigan,Ann Arbor,113934
8934,1996-1997,1996-11-11,1997-04-13,154,1,75,304,379,114,163,277,656,68,348,Michigan,Ann Arbor,113934
8935,1997-1998,1997-10-27,1998-03-23,148,0,28,185,213,76,96,172,385,43,157,Michigan,Ann Arbor,113934
8936,1998-1999,1998-11-21,1999-03-21,121,0,66,261,327,100,237,337,664,35,274,Michigan,Ann Arbor,113934
8937,1999-2000,1999-12-01,2000-04-11,133,0,61,248,309,70,197,267,576,42,229,Michigan,Ann Arbor,113934
8938,2000-2001,2000-11-14,2001-04-17,155,1,81,333,414,126,398,524,938,67,353,Michigan,Ann Arbor,113934
8939,2001-2002,2001-10-26,2002-04-21,178,0,27,209,236,91,114,205,441,51,217,Michigan,Ann Arbor,113934
8940,2002-2003,2002-11-15,2003-04-08,145,1,92,371,463,105,189,294,757,53,310,Michigan,Ann Arbor,113934
8941,2003-2004,2003-11-13,2004-04-13,153,0,74,293,367,85,259,344,711,54,247,Michigan,Ann Arbor,113934
8942,2004-2005,2004-11-24,2005-05-03,161,0,71,301,372,124,277,401,773,54,292,Michigan,Ann Arbor,113934
8943,2005-2006,2005-11-17,2006-03-25,129,0,45,221,266,88,151,239,505,46,197,Michigan,Ann Arbor,113934
8944,2006-2007,2006-10-12,2007-04-15,186,0,74,278,352,83,164,247,599,58,301,Michigan,Ann Arbor,113934
8945,2007-2008,2007-11-18,2008-04-13,148,0,68,285,353,139,208,347,700,64,338,Michigan,Ann Arbor,113934
8946,2008-2009,2008-11-09,2009-04-07,150,0,100,369,469,130,298,428,897,69,411,Michigan,Ann Arbor,113934
8947,2009-2010,2009-11-27,2010-03-07,101,0,55,218,273,91,222,313,586,45,214,Michigan,Ann Arbor,113934
8948,2010-2011,2010-12-01,2011-04-18,139,0,87,311,398,108,358,466,864,56,306,Michigan,Ann Arbor,113934
8949,2011-2012,2011-11-10,2012-04-11,154,0,18,169,187,66,47,113,300,43,156,Michigan,Ann Arbor,113934
8950,2012-2013,2012-10-30,2013-04-25,178,2,54,270,324,109,182,291,615,57,290,Michigan,Ann Arbor,113934
8951,2013-2014,2013-10-24,2014-04-15,174,0,136,463,599,152,549,701,1300,72,476,Michigan,Ann Arbor,113934
8952,2014-2015,2014-11-01,2015-04-23,174,0,114,396,510,98,351,449,959,58,351,Michigan,Ann Arbor,113934
8953,2015-2016,2015-11-21,2016-05-15,177,0,44,207,251,92,110,202,453,51,244,Michigan,Ann Arbor,113934
8954,2016-2017,2016-11-19,2017-04-07,140,0,52,209,261,83,125,208,469,47,220,Michigan,Ann Arbor,113934
8955,2017-2018,2017-10-30,2018-04-19,172,0,91,395,486,133,260,393,879,62,398,Michigan,Ann Arbor,113934
8956,2018-2019,2018-10-20,2019-04-28,191,0,71,359,430,101,110,211,641,60,287,Michigan,Ann Arbor,113934
8957,2019-2020,2019-11-01,2020-05-12,194,0,27,271,298,106,146,252,550,51,209,Michigan,Ann Arbor,113934
8958,1951-1952,1951-11-02,1952-04-14,165,2,105,465,570,119,595,714,1284,53,321,Michigan,Cheboygan,4867
8959,1952-1953,1952-10-28,1953-04-19,174,9,63,321,384,116,410,526,910,47,251,Michigan,Cheboygan,4867
8960,1953-1954,1953-10-28,1954-05-07,192,2,85,393,478,94,424,518,996,50,286,Michigan,Cheboygan,4867
8961,1954-1955,1954-10-30,1955-03-30,152,0,96,391,487,116,552,668,1155,57,293,Michigan,Cheboygan,4867
8962,1955-1956,1955-10-25,1956-04-30,189,1,112,498,610,137,709,846,1456,56,319,Michigan,Cheboygan,4867
8963,1956-1957,1956-09-20,1957-04-13,206,5,113,463,576,110,369,479,1055,56,306,Michigan,Cheboygan,4867
8964,1957-1958,1957-11-09,1958-04-08,151,0,102,391,493,87,417,504,997,41,225,Michigan,Cheboygan,4867
8965,1958-1959,1958-11-27,1959-04-11,136,7,161,574,735,163,1094,1257,1992,58,487,Michigan,Cheboygan,4867
8966,1959-1960,1959-10-25,1960-04-18,177,0,108,479,587,128,706,834,1421,54,328,Michigan,Cheboygan,4867
8967,1960-1961,1960-10-24,1961-04-03,162,0,118,446,564,78,455,533,1097,42,294,Michigan,Cheboygan,4867
8968,1961-1962,1961-11-07,1962-04-13,158,1,130,483,613,161,883,1044,1657,69,466,Michigan,Cheboygan,4867
8969,1962-1963,1962-10-25,1963-05-10,198,3,187,569,756,148,939,1087,1843,54,464,Michigan,Cheboygan,4867
8970,1963-1964,1963-11-30,1964-04-15,138,1,83,401,484,99,473,572,1056,35,221,Michigan,Cheboygan,4867
8971,1964-1965,1964-10-07,1965-04-17,193,0,130,510,640,167,794,961,1601,66,471,Michigan,Cheboygan,4867
8972,1965-1966,1965-11-14,1966-04-26,164,0,103,365,468,72,252,324,792,32,173,Michigan,Cheboygan,4867
8973,1966-1967,1966-11-03,1967-03-31,149,6,126,464,590,140,876,1016,1606,49,384,Michigan,Cheboygan,4867
8974,1967-1968,1967-11-14,1968-04-11,150,4,130,502,632,87,532,619,1251,28,244,Michigan,Cheboygan,4867
8975,1968-1969,1968-11-18,1969-04-01,135,9,93,432,525,100,663,763,1288,32,243,Michigan,Cheboygan,4867
8976,1969-1970,1969-11-15,1970-03-29,135,1,125,509,634,51,469,520,1154,22,151,Michigan,Cheboygan,4867
8977,1970-1971,1970-11-22,1971-04-24,154,6,130,529,659,163,1091,1254,1913,49,358,Michigan,Cheboygan,4867
8978,1972-1973,1972-11-22,1973-04-11,141,6,83,354,437,63,269,332,769,33,208,Michigan,Cheboygan,4867
8979,1973-1974,1973-11-03,1974-04-08,157,14,145,435,580,78,456,534,1114,32,214,Michigan,Cheboygan,4867
8980,1974-1975,1974-11-15,1975-04-19,156,9,81,441,522,106,560,666,1188,26,204,Michigan,Cheboygan,4867
8981,1976-1977,1976-11-08,1977-04-11,155,7,203,611,814,96,595,691,1505,48,453,Michigan,Cheboygan,4867
8982,1977-1978,1977-11-13,1978-03-31,139,4,164,591,755,91,847,938,1693,37,300,Michigan,Cheboygan,4867
8983,1978-1979,1978-11-20,1979-04-09,141,15,197,596,793,135,935,1070,1863,53,506,Michigan,Cheboygan,4867
8984,1979-1980,1979-11-29,1980-04-16,140,3,122,491,613,103,279,382,995,38,283,Michigan,Cheboygan,4867
8985,1980-1981,1980-11-11,1981-04-06,147,2,139,512,651,96,471,567,1218,35,314,Michigan,Cheboygan,4867
8986,1982-1983,1982-11-13,1983-04-15,154,8,77,363,440,64,215,279,719,22,140,Michigan,Cheboygan,4867
8987,1984-1985,1984-11-11,1985-04-08,149,11,144,469,613,200,749,949,1562,53,495,Michigan,Cheboygan,4867
8988,1985-1986,1985-11-08,1986-03-27,140,5,150,545,695,171,839,1010,1705,52,441,Michigan,Cheboygan,4867
8989,1986-1987,1986-11-09,1987-04-02,145,5,73,391,464,115,269,384,848,43,279,Michigan,Cheboygan,4867
8990,1987-1988,1987-11-19,1988-04-14,148,5,130,483,613,129,452,581,1194,45,361,Michigan,Cheboygan,4867
8991,1988-1989,1988-11-17,1989-04-11,146,12,139,520,659,167,549,716,1375,50,450,Michigan,Cheboygan,4867
8992,1989-1990,1989-10-03,1990-04-17,197,8,126,565,691,172,691,863,1554,54,421,Michigan,Cheboygan,4867
8993,1992-1993,1992-11-06,1993-04-22,168,7,108,491,599,117,413,530,1129,50,337,Michigan,Cheboygan,4867
8994,1994-1995,1994-11-23,1995-04-06,135,5,101,402,503,113,387,500,1003,39,337,Michigan,Cheboygan,4867
8995,1995-1996,1995-11-04,1996-04-24,173,10,185,707,892,197,765,962,1854,63,537,Michigan,Cheboygan,4867
8996,1996-1997,1996-11-02,1997-04-17,167,16,135,531,666,246,925,1171,1837,72,589,Michigan,Cheboygan,4867
8997,1997-1998,1997-11-12,1998-03-28,137,9,62,287,349,104,374,478,827,32,217,Michigan,Cheboygan,4867
8998,1998-1999,1998-11-16,1999-03-24,129,6,87,431,518,140,556,696,1214,39,359,Michigan,Cheboygan,4867
8999,1999-2000,1999-11-29,2000-04-17,141,4,76,418,494,99,334,433,927,33,275,Michigan,Cheboygan,4867
9000,2000-2001,2000-11-19,2001-04-17,150,6,118,424,542,146,693,839,1381,60,394,Michigan,Cheboygan,4867
9001,2001-2002,2001-10-07,2002-04-28,204,7,66,352,418,160,511,671,1089,46,350,Michigan,Cheboygan,4867
9002,2002-2003,2002-11-16,2003-04-12,148,4,181,543,724,123,471,594,1318,45,399,Michigan,Cheboygan,4867
9003,2003-2004,2003-11-08,2004-03-31,145,6,116,391,507,152,667,819,1326,40,315,Michigan,Cheboygan,4867
9004,2005-2006,2005-11-18,2006-04-05,139,5,80,361,441,130,446,576,1017,42,275,Michigan,Cheboygan,4867
9005,2006-2007,2006-10-12,2007-04-15,186,3,113,414,527,117,389,506,1033,38,281,Michigan,Cheboygan,4867
9006,2007-2008,2007-11-24,2008-04-14,143,8,117,453,570,133,586,719,1289,45,316,Michigan,Cheboygan,4867
9007,2008-2009,2008-11-19,2009-03-31,133,3,152,522,674,146,567,713,1387,46,368,Michigan,Cheboygan,4867
9008,2009-2010,2009-12-01,2010-03-27,117,0,86,352,438,66,311,377,815,26,179,Michigan,Cheboygan,4867
9009,2010-2011,2010-11-24,2011-04-21,149,0,134,474,608,108,413,521,1129,36,283,Michigan,Cheboygan,4867
9010,2011-2012,2011-12-01,2012-04-20,142,0,46,271,317,77,185,262,579,20,146,Michigan,Cheboygan,4867
9011,2012-2013,2012-11-13,2013-04-14,153,0,97,399,496,119,506,625,1121,45,326,Michigan,Cheboygan,4867
9012,2013-2014,2013-11-11,2014-04-16,157,0,233,724,957,198,933,1131,2088,52,547,Michigan,Cheboygan,4867
9013,2014-2015,2014-11-10,2015-04-07,149,0,177,626,803,121,469,590,1393,44,361,Michigan,Cheboygan,4867
9014,2015-2016,2015-11-20,2016-04-14,147,0,75,322,397,134,481,615,1012,36,271,Michigan,Cheboygan,4867
9015,2016-2017,2016-11-20,2017-03-23,124,4,85,306,391,120,331,451,842,40,277,Michigan,Cheboygan,4867
9016,2017-2018,2017-11-09,2018-04-22,165,1,151,523,674,122,393,515,1189,40,314,Michigan,Cheboygan,4867
9017,2018-2019,2018-11-10,2019-04-12,154,0,150,522,672,128,636,764,1436,44,352,Michigan,Cheboygan,4867
9018,2019-2020,2019-11-07,2020-04-22,168,0,67,359,426,101,414,515,941,37,220,Michigan,Cheboygan,4867
9019,1950-1951,1950-11-10,1951-04-01,143,0,91,282,373,72,146,218,591,40,208,Michigan,Detroit,713777
9020,1951-1952,1951-11-02,1952-03-27,147,0,64,276,340,95,170,265,605,47,232,Michigan,Detroit,713777
9021,1952-1953,1952-11-27,1953-04-20,145,0,36,172,208,37,19,56,264,30,111,Michigan,Detroit,713777
9022,1953-1954,1953-11-07,1954-05-04,179,0,47,231,278,62,106,168,446,35,138,Michigan,Detroit,713777
9023,1954-1955,1954-11-02,1955-03-28,147,0,57,235,292,51,59,110,402,35,140,Michigan,Detroit,713777
9024,1955-1956,1955-11-08,1956-04-17,162,0,62,278,340,76,122,198,538,42,170,Michigan,Detroit,713777
9025,1956-1957,1956-11-21,1957-04-13,144,0,69,263,332,79,169,248,580,47,189,Michigan,Detroit,713777
9026,1957-1958,1957-11-21,1958-04-07,138,0,65,244,309,41,45,86,395,35,136,Michigan,Detroit,713777
9027,1958-1959,1958-11-24,1959-03-27,124,0,102,354,456,62,193,255,711,38,226,Michigan,Detroit,713777
9028,1959-1960,1959-11-12,1960-03-27,137,0,65,259,324,81,207,288,612,51,223,Michigan,Detroit,713777
9029,1960-1961,1960-11-29,1961-04-17,140,0,87,274,361,37,59,96,457,29,158,Michigan,Detroit,713777
9030,1961-1962,1961-12-01,1962-04-14,135,0,93,288,381,53,117,170,551,34,190,Michigan,Detroit,713777
9031,1962-1963,1962-11-17,1963-03-21,125,0,151,370,521,54,187,241,762,41,265,Michigan,Detroit,713777
9032,1963-1964,1963-12-01,1964-04-08,130,0,65,249,314,59,119,178,492,39,173,Michigan,Detroit,713777
9033,1964-1965,1964-11-19,1965-04-17,150,0,84,292,376,77,170,247,623,40,199,Michigan,Detroit,713777
9034,1965-1966,1965-11-28,1966-04-11,135,0,75,240,315,39,67,106,421,36,143,Michigan,Detroit,713777
9035,1966-1967,1966-11-02,1967-04-24,174,0,62,300,362,80,255,335,697,42,175,Michigan,Detroit,713777
9036,1967-1968,1967-11-04,1968-04-24,173,0,81,358,439,55,118,173,612,33,187,Michigan,Detroit,713777
9037,1968-1969,1968-12-01,1969-04-18,139,0,64,314,378,34,63,97,475,25,102,Michigan,Detroit,713777
9038,1969-1970,1969-11-19,1970-04-03,136,0,95,403,498,74,208,282,780,44,261,Michigan,Detroit,713777
9039,1970-1971,1970-11-14,1971-04-24,162,0,87,340,427,66,72,138,565,43,207,Michigan,Detroit,713777
9040,1971-1972,1971-11-09,1972-04-07,151,0,74,325,399,52,47,99,498,38,172,Michigan,Detroit,713777
9041,1972-1973,1972-11-14,1973-04-09,147,0,53,234,287,71,78,149,436,35,150,Michigan,Detroit,713777
9042,1973-1974,1973-11-09,1974-04-07,150,0,77,286,363,80,170,250,613,39,237,Michigan,Detroit,713777
9043,1974-1975,1974-11-13,1975-04-05,144,0,48,260,308,102,222,324,632,47,202,Michigan,Detroit,713777
9044,1975-1976,1975-11-21,1976-04-25,157,0,65,330,395,92,247,339,734,45,222,Michigan,Detroit,713777
9045,1976-1977,1976-11-04,1977-04-07,155,0,133,455,588,78,206,284,872,49,313,Michigan,Detroit,713777
9046,1977-1978,1977-11-11,1978-04-21,162,0,118,452,570,95,381,476,1046,41,271,Michigan,Detroit,713777
9047,1978-1979,1978-11-21,1979-04-09,140,0,124,391,515,65,200,265,780,43,247,Michigan,Detroit,713777
9048,1979-1980,1979-11-08,1980-04-24,169,0,74,343,417,55,34,89,506,38,173,Michigan,Detroit,713777
9049,1980-1981,1980-10-27,1981-03-19,144,0,85,371,456,66,171,237,693,35,186,Michigan,Detroit,713777
9050,1981-1982,1981-10-23,1982-04-11,171,0,123,428,551,115,365,480,1031,47,338,Michigan,Detroit,713777
9051,1982-1983,1982-11-26,1983-04-17,143,0,32,206,238,33,33,66,304,18,73,Michigan,Detroit,713777
9052,1983-1984,1983-11-11,1984-04-17,159,0,129,390,519,85,180,265,784,40,228,Michigan,Detroit,713777
9053,1984-1985,1984-11-11,1985-04-08,149,0,76,336,412,83,222,305,717,39,247,Michigan,Detroit,713777
9054,1985-1986,1985-11-15,1986-04-22,159,0,98,344,442,89,203,292,734,52,282,Michigan,Detroit,713777
9055,1986-1987,1986-11-11,1987-04-02,143,0,36,238,274,72,97,169,443,30,141,Michigan,Detroit,713777
9056,1987-1988,1987-11-19,1988-04-15,149,0,71,298,369,81,118,199,568,44,228,Michigan,Detroit,713777
9057,1988-1989,1988-11-06,1989-04-09,155,0,58,276,334,45,34,79,413,31,142,Michigan,Detroit,713777
9058,1989-1990,1989-10-19,1990-04-11,175,0,74,300,374,66,110,176,550,39,201,Michigan,Detroit,713777
9059,1990-1991,1990-12-01,1991-03-11,101,0,45,211,256,54,79,133,389,30,155,Michigan,Detroit,713777
9060,1991-1992,1991-11-03,1992-04-01,151,0,46,246,292,77,120,197,489,43,204,Michigan,Detroit,713777
9061,1992-1993,1992-10-20,1993-04-17,180,0,50,253,303,82,169,251,554,36,166,Michigan,Detroit,713777
9062,1993-1994,1993-10-30,1994-04-07,160,0,106,351,457,81,163,244,701,43,263,Michigan,Detroit,713777
9063,1994-1995,1994-12-01,1995-04-09,130,0,52,231,283,54,114,168,451,25,132,Michigan,Detroit,713777
9064,1995-1996,1995-11-08,1996-04-09,154,13,107,381,488,50,64,114,602,33,164,Michigan,Detroit,713777
9065,1996-1997,1996-11-11,1997-04-17,158,3,68,286,354,77,78,155,509,47,256,Michigan,Detroit,713777
9066,1997-1998,1997-10-27,1998-03-22,147,0,22,157,179,43,69,112,291,26,80,Michigan,Detroit,713777
9067,1998-1999,1998-12-01,1999-03-15,105,0,60,235,295,70,215,285,580,23,167,Michigan,Detroit,713777
9068,1999-2000,1999-12-01,2000-04-11,133,0,58,233,291,40,117,157,448,24,132,Michigan,Detroit,713777
9069,2000-2001,2000-11-14,2001-04-17,155,0,74,311,385,76,255,331,716,51,258,Michigan,Detroit,713777
9070,2001-2002,2001-12-01,2002-03-27,117,0,27,159,186,53,63,116,302,30,127,Michigan,Detroit,713777
9071,2002-2003,2002-11-22,2003-04-09,139,0,94,351,445,98,195,293,738,50,307,Michigan,Detroit,713777
9072,2003-2004,2003-11-28,2004-03-18,112,0,70,249,319,45,132,177,496,30,121,Michigan,Detroit,713777
9073,2004-2005,2004-11-25,2005-05-03,160,0,70,280,350,97,209,306,656,37,194,Michigan,Detroit,713777
9074,2005-2006,2005-11-17,2006-03-25,129,0,41,210,251,61,101,162,413,36,153,Michigan,Detroit,713777
9075,2006-2007,2006-10-12,2007-04-14,185,0,76,260,336,59,78,137,473,41,212,Michigan,Detroit,713777
9076,2007-2008,2007-11-25,2008-03-28,125,0,59,264,323,111,176,287,610,50,254,Michigan,Detroit,713777
9077,2008-2009,2008-11-16,2009-04-07,143,0,91,346,437,104,263,367,804,46,278,Michigan,Detroit,713777
9078,2009-2010,2009-12-01,2010-03-04,94,0,54,196,250,71,145,216,466,34,164,Michigan,Detroit,713777
9079,2010-2011,2010-12-01,2011-04-18,139,0,93,305,398,108,358,466,864,45,265,Michigan,Detroit,713777
9080,2011-2012,2011-11-30,2012-03-09,101,0,20,137,157,42,43,85,242,27,103,Michigan,Detroit,713777
9081,2012-2013,2012-11-23,2013-04-20,149,0,48,229,277,75,143,218,495,39,209,Michigan,Detroit,713777
9082,2013-2014,2013-11-11,2014-04-16,157,0,149,448,597,144,536,680,1277,56,433,Michigan,Detroit,713777
9083,2014-2015,2014-11-13,2015-03-23,131,0,117,375,492,72,361,433,925,36,270,Michigan,Detroit,713777
9084,2015-2016,2015-11-21,2016-04-10,142,0,37,187,224,59,87,146,370,33,151,Michigan,Detroit,713777
9085,2016-2017,2016-11-19,2017-04-06,139,0,45,182,227,67,126,193,420,35,156,Michigan,Detroit,713777
9086,2017-2018,2017-11-10,2018-04-17,159,0,89,309,398,94,232,326,724,40,262,Michigan,Detroit,713777
9087,2018-2019,2018-11-09,2019-04-01,144,0,63,275,338,59,72,131,469,39,180,Michigan,Detroit,713777
9088,2019-2020,2019-11-07,2020-05-10,186,0,21,194,215,69,107,176,391,35,136,Michigan,Detroit,713777
9089,1950-1951,1950-11-04,1951-04-03,151,0,106,374,480,69,164,233,713,48,258,Michigan,Flint,102434
9090,1951-1952,1951-11-03,1952-04-07,157,0,89,371,460,110,218,328,788,45,286,Michigan,Flint,102434
9091,1952-1953,1952-10-28,1953-04-20,175,0,44,272,316,45,40,85,401,35,160,Michigan,Flint,102434
9092,1953-1954,1953-11-26,1954-04-03,129,0,64,319,383,81,158,239,622,38,189,Michigan,Flint,102434
9093,1954-1955,1954-11-29,1955-03-27,119,0,81,318,399,56,69,125,524,29,139,Michigan,Flint,102434
9094,1955-1956,1955-11-07,1956-04-17,163,0,87,411,498,68,149,217,715,46,214,Michigan,Flint,102434
9095,1956-1957,1956-11-16,1957-04-13,149,0,84,368,452,61,133,194,646,46,214,Michigan,Flint,102434
9096,1957-1958,1957-11-09,1958-03-21,133,0,94,355,449,53,137,190,639,43,210,Michigan,Flint,102434
9097,1958-1959,1958-11-24,1959-04-08,136,0,142,526,668,96,351,447,1115,45,333,Michigan,Flint,102434
9098,1959-1960,1959-11-12,1960-04-09,150,0,93,402,495,108,240,348,843,69,359,Michigan,Flint,102434
9099,1960-1961,1960-11-09,1961-05-26,199,0,102,407,509,64,78,142,651,46,275,Michigan,Flint,102434
9100,1961-1962,1961-12-01,1962-04-15,136,0,123,407,530,67,219,286,816,40,244,Michigan,Flint,102434
9101,1962-1963,1962-10-23,1963-04-30,190,0,176,531,707,67,254,321,1028,44,290,Michigan,Flint,102434
9102,1963-1964,1963-12-01,1964-04-08,130,0,73,356,429,61,144,205,634,43,224,Michigan,Flint,102434
9103,1964-1965,1964-11-19,1965-04-17,150,0,99,392,491,111,220,331,822,53,340,Michigan,Flint,102434
9104,1965-1966,1965-11-13,1966-04-07,146,0,86,309,395,66,141,207,602,47,230,Michigan,Flint,102434
9105,1966-1967,1966-11-02,1967-03-23,142,0,97,412,509,119,422,541,1050,52,313,Michigan,Flint,102434
9106,1967-1968,1967-10-27,1968-04-25,182,0,89,384,473,71,115,186,659,40,236,Michigan,Flint,102434
9107,1968-1969,1968-11-12,1969-03-30,139,0,83,338,421,47,106,153,574,30,156,Michigan,Flint,102434
9108,1969-1970,1969-11-15,1970-04-05,142,0,117,437,554,94,218,312,866,56,345,Michigan,Flint,102434
9109,1970-1971,1970-11-14,1971-04-24,162,0,113,355,468,92,202,294,762,53,281,Michigan,Flint,102434
9110,1971-1972,1971-11-09,1972-04-07,151,0,88,344,432,86,145,231,663,52,251,Michigan,Flint,102434
9111,1972-1973,1972-11-13,1973-05-04,173,0,59,262,321,95,242,337,658,45,188,Michigan,Flint,102434
9112,1973-1974,1973-12-01,1974-04-05,126,0,90,313,403,74,205,279,682,38,259,Michigan,Flint,102434
9113,1974-1975,1974-11-13,1975-04-11,150,0,53,297,350,124,251,375,725,50,249,Michigan,Flint,102434
9114,1975-1976,1975-11-24,1976-04-26,155,0,70,331,401,119,342,461,862,55,284,Michigan,Flint,102434
9115,1976-1977,1976-11-20,1977-04-07,139,0,186,474,660,86,268,354,1014,62,472,Michigan,Flint,102434
9116,1977-1978,1977-11-11,1978-04-21,162,0,148,495,643,85,429,514,1157,53,356,Michigan,Flint,102434
9117,1978-1979,1978-11-20,1979-04-09,141,0,164,426,590,88,300,388,978,47,302,Michigan,Flint,102434
9118,1979-1980,1979-11-08,1980-04-25,170,0,96,360,456,70,84,154,610,46,226,Michigan,Flint,102434
9119,1980-1981,1980-11-27,1981-03-26,120,0,95,344,439,71,218,289,728,49,255,Michigan,Flint,102434
9120,1981-1982,1981-11-20,1982-04-10,142,0,141,415,556,97,320,417,973,52,352,Michigan,Flint,102434
9121,1982-1983,1982-11-05,1983-04-19,166,0,32,218,250,55,67,122,372,28,104,Michigan,Flint,102434
9122,1983-1984,1983-11-11,1984-04-22,164,0,151,442,593,71,243,314,907,43,259,Michigan,Flint,102434
9123,1984-1985,1984-11-11,1985-04-17,158,0,83,333,416,78,225,303,719,40,215,Michigan,Flint,102434
9124,1985-1986,1985-11-09,1986-04-22,165,0,121,408,529,83,313,396,925,48,282,Michigan,Flint,102434
9125,1986-1987,1986-11-11,1987-04-05,146,0,47,294,341,65,117,182,523,40,169,Michigan,Flint,102434
9126,1987-1988,1987-10-22,1988-04-16,178,0,93,368,461,69,148,217,678,46,271,Michigan,Flint,102434
9127,1988-1989,1988-11-06,1989-04-10,156,0,74,337,411,57,82,139,550,43,214,Michigan,Flint,102434
9128,1989-1990,1989-10-19,1990-04-11,175,0,91,372,463,81,200,281,744,44,226,Michigan,Flint,102434
9129,1990-1991,1990-12-01,1991-03-29,119,0,68,278,346,58,154,212,558,33,193,Michigan,Flint,102434
9130,1991-1992,1991-11-03,1992-04-04,154,0,63,320,383,90,145,235,618,41,240,Michigan,Flint,102434
9131,1992-1993,1992-10-20,1993-04-17,180,0,70,331,401,88,203,291,692,49,240,Michigan,Flint,102434
9132,1993-1994,1993-10-30,1994-05-01,184,0,146,483,629,79,222,301,930,49,335,Michigan,Flint,102434
9133,1994-1995,1994-11-23,1995-04-09,138,0,83,335,418,75,233,308,726,44,241,Michigan,Flint,102434
9134,1995-1996,1995-11-09,1996-03-26,139,0,129,455,584,71,165,236,820,43,259,Michigan,Flint,102434
9135,1996-1997,1996-11-02,1997-04-13,163,0,99,363,462,69,139,208,670,41,225,Michigan,Flint,102434
9136,1997-1998,1997-10-26,1998-03-17,143,0,37,219,256,47,78,125,381,32,113,Michigan,Flint,102434
9137,1998-1999,1998-11-20,1999-03-17,118,0,81,323,404,77,187,264,668,36,249,Michigan,Flint,102434
9138,1999-2000,1999-12-01,2000-04-11,133,0,69,335,404,54,144,198,602,37,222,Michigan,Flint,102434
9139,2000-2001,2000-11-14,2001-04-17,155,0,95,392,487,93,387,480,967,55,307,Michigan,Flint,102434
9140,2001-2002,2001-12-01,2002-04-22,143,0,40,223,263,75,131,206,469,47,191,Michigan,Flint,102434
9141,2002-2003,2002-11-15,2003-04-09,146,0,112,426,538,83,176,259,797,51,298,Michigan,Flint,102434
9142,2003-2004,2003-11-28,2004-04-27,152,0,82,335,417,77,273,350,767,39,200,Michigan,Flint,102434
9143,2004-2005,2004-11-24,2005-04-25,153,0,99,376,475,106,241,347,822,45,271,Michigan,Flint,102434
9144,2005-2006,2005-11-16,2006-04-05,141,0,65,280,345,96,157,253,598,56,267,Michigan,Flint,102434
9145,2006-2007,2006-10-12,2007-04-11,182,0,94,330,424,79,181,260,684,60,315,Michigan,Flint,102434
9146,2007-2008,2007-11-22,2008-04-13,144,1,71,332,403,128,234,362,765,61,316,Michigan,Flint,102434
9147,2008-2009,2008-11-10,2009-04-08,150,0,125,428,553,116,320,436,989,63,372,Michigan,Flint,102434
9148,2009-2010,2009-12-01,2010-03-21,111,0,73,299,372,70,242,312,684,40,220,Michigan,Flint,102434
9149,2010-2011,2010-11-25,2011-04-18,145,0,109,385,494,114,389,503,997,54,303,Michigan,Flint,102434
9150,2011-2012,2011-11-29,2012-03-30,123,0,27,183,210,57,83,140,350,38,156,Michigan,Flint,102434
9151,2012-2013,2012-10-30,2013-04-19,172,0,59,331,390,76,148,224,614,47,234,Michigan,Flint,102434
9152,2013-2014,2013-11-11,2014-04-15,156,0,165,539,704,131,504,635,1339,65,510,Michigan,Flint,102434
9153,2014-2015,2014-10-31,2015-04-22,174,0,114,456,570,78,327,405,975,46,306,Michigan,Flint,102434
9154,2015-2016,2015-11-21,2016-04-10,142,0,42,213,255,110,183,293,548,44,230,Michigan,Flint,102434
9155,2016-2017,2016-12-01,2017-04-07,128,0,65,228,293,72,115,187,480,41,202,Michigan,Flint,102434
9156,2017-2018,2017-10-31,2018-04-18,170,0,117,421,538,127,310,437,975,49,343,Michigan,Flint,102434
9157,2018-2019,2018-11-09,2019-04-15,158,0,100,360,460,92,170,262,722,55,298,Michigan,Flint,102434
9158,2019-2020,2019-10-31,2020-04-22,175,0,32,238,270,87,163,250,520,43,195,Michigan,Flint,102434
9159,1951-1952,1951-10-24,1952-04-14,174,16,96,556,652,198,859,1057,1709,72,514,Michigan,Gaylord,3645
9160,1952-1953,1952-10-16,1953-04-27,194,13,75,413,488,207,657,864,1352,55,393,Michigan,Gaylord,3645
9161,1954-1955,1954-10-31,1955-04-01,153,5,129,508,637,158,734,892,1529,53,385,Michigan,Gaylord,3645
9162,1955-1956,1955-10-25,1956-05-17,206,9,128,594,722,178,806,984,1706,53,407,Michigan,Gaylord,3645
9163,1956-1957,1956-09-20,1957-04-13,206,8,136,553,689,127,498,625,1314,49,358,Michigan,Gaylord,3645
9164,1957-1958,1957-11-09,1958-04-06,149,6,124,498,622,139,613,752,1374,53,374,Michigan,Gaylord,3645
9165,1958-1959,1958-11-06,1959-04-24,170,3,209,646,855,206,1124,1330,2185,80,714,Michigan,Gaylord,3645
9166,1959-1960,1959-11-02,1960-05-01,182,0,121,560,681,223,1084,1307,1988,86,595,Michigan,Gaylord,3645
9167,1960-1961,1960-10-24,1961-05-02,191,7,144,543,687,187,792,979,1666,62,533,Michigan,Gaylord,3645
9168,1961-1962,1961-11-08,1962-04-19,163,4,165,551,716,271,1152,1423,2139,73,645,Michigan,Gaylord,3645
9169,1962-1963,1962-10-23,1963-04-30,190,0,214,654,868,210,1097,1307,2175,59,589,Michigan,Gaylord,3645
9170,1963-1964,1963-11-01,1964-04-15,167,0,112,503,615,200,936,1136,1751,57,466,Michigan,Gaylord,3645
9171,1964-1965,1964-10-06,1965-04-17,194,1,156,564,720,265,1093,1358,2078,79,695,Michigan,Gaylord,3645
9172,1965-1966,1965-09-26,1966-04-26,213,0,124,442,566,184,478,662,1228,65,465,Michigan,Gaylord,3645
9173,1966-1967,1966-11-01,1967-04-07,158,2,134,487,621,228,991,1219,1840,67,571,Michigan,Gaylord,3645
9174,1967-1968,1967-10-26,1968-03-23,150,0,153,510,663,177,762,939,1602,61,525,Michigan,Gaylord,3645
9175,1968-1969,1968-10-29,1969-04-04,158,0,131,493,624,235,1041,1276,1900,61,527,Michigan,Gaylord,3645
9176,1969-1970,1969-10-22,1970-04-11,172,0,169,585,754,206,1059,1265,2019,74,603,Michigan,Gaylord,3645
9177,1970-1971,1970-10-16,1971-05-12,209,0,164,563,727,297,1433,1730,2457,78,689,Michigan,Gaylord,3645
9178,1971-1972,1971-11-04,1972-04-24,173,1,137,547,684,245,1088,1333,2017,76,639,Michigan,Gaylord,3645
9179,1972-1973,1972-10-15,1973-05-04,202,0,108,424,532,196,598,794,1326,61,445,Michigan,Gaylord,3645
9180,1973-1974,1973-11-05,1974-05-06,183,6,147,467,614,195,749,944,1558,57,451,Michigan,Gaylord,3645
9181,1974-1975,1974-11-12,1975-04-20,160,1,101,431,532,240,1079,1319,1851,76,534,Michigan,Gaylord,3645
9182,1975-1976,1975-11-13,1976-05-03,173,1,123,472,595,244,965,1209,1804,73,583,Michigan,Gaylord,3645
9183,1976-1977,1976-10-19,1977-04-08,172,0,215,633,848,269,1255,1524,2372,90,809,Michigan,Gaylord,3645
9184,1977-1978,1977-11-11,1978-04-14,155,2,147,657,804,227,1179,1406,2210,65,564,Michigan,Gaylord,3645
9185,1978-1979,1978-11-19,1979-05-06,169,3,165,627,792,221,1160,1381,2173,78,644,Michigan,Gaylord,3645
9186,1979-1980,1979-10-11,1980-04-16,189,8,110,587,697,192,711,903,1600,60,465,Michigan,Gaylord,3645
9187,1980-1981,1980-10-26,1981-03-26,152,0,114,541,655,202,826,1028,1683,64,585,Michigan,Gaylord,3645
9188,1981-1982,1981-10-19,1982-04-20,184,8,134,669,803,173,1097,1270,2073,69,555,Michigan,Gaylord,3645
9189,1982-1983,1982-10-16,1983-04-16,183,4,64,443,507,145,482,627,1134,45,295,Michigan,Gaylord,3645
9190,1983-1984,1983-11-11,1984-05-13,185,6,160,642,802,204,953,1157,1959,65,558,Michigan,Gaylord,3645
9191,1985-1986,1985-11-09,1986-04-21,164,6,197,540,737,228,1152,1380,2117,63,590,Michigan,Gaylord,3645
9192,1986-1987,1986-11-09,1987-04-03,146,0,96,412,508,154,652,806,1314,42,328,Michigan,Gaylord,3645
9193,1988-1989,1988-10-12,1989-04-13,184,5,143,525,668,231,861,1092,1760,69,576,Michigan,Gaylord,3645
9194,1989-1990,1989-10-10,1990-05-11,214,5,145,543,688,261,993,1254,1942,65,584,Michigan,Gaylord,3645
9195,1990-1991,1990-10-19,1991-04-10,174,10,127,467,594,205,724,929,1523,59,501,Michigan,Gaylord,3645
9196,1991-1992,1991-10-16,1992-04-11,179,1,135,501,636,205,780,985,1621,58,500,Michigan,Gaylord,3645
9197,1992-1993,1992-10-17,1993-04-21,187,3,149,550,699,224,897,1121,1820,63,507,Michigan,Gaylord,3645
9198,1993-1994,1993-10-03,1994-05-01,211,9,235,663,898,200,766,966,1864,66,624,Michigan,Gaylord,3645
9199,1994-1995,1994-11-22,1995-04-26,156,0,119,414,533,170,548,718,1251,49,438,Michigan,Gaylord,3645
9200,1995-1996,1995-10-31,1996-05-01,184,9,196,654,850,284,1258,1542,2392,69,622,Michigan,Gaylord,3645
9201,1996-1997,1996-10-31,1997-05-13,195,14,167,528,695,294,1103,1397,2092,80,659,Michigan,Gaylord,3645
9202,1997-1998,1997-10-22,1998-03-26,156,2,96,372,468,153,609,762,1230,42,312,Michigan,Gaylord,3645
9203,1998-1999,1998-11-16,1999-03-24,129,2,126,401,527,175,733,908,1435,48,439,Michigan,Gaylord,3645
9204,1999-2000,1999-11-29,2000-04-09,133,3,106,368,474,153,547,700,1174,45,367,Michigan,Gaylord,3645
9205,2000-2001,2000-10-07,2001-04-18,194,5,156,472,628,249,973,1222,1850,73,600,Michigan,Gaylord,3645
9206,2002-2003,2002-10-18,2003-04-09,174,9,177,571,748,229,705,934,1682,56,556,Michigan,Gaylord,3645
9207,2003-2004,2003-10-01,2004-03-28,180,16,131,427,558,247,868,1115,1673,54,487,Michigan,Gaylord,3645
9208,2004-2005,2004-10-17,2005-04-25,191,7,150,516,666,203,779,982,1648,54,471,Michigan,Gaylord,3645
9209,2005-2006,2005-11-10,2006-04-05,147,17,113,380,493,230,878,1108,1601,48,427,Michigan,Gaylord,3645
9210,2006-2007,2006-10-12,2007-04-13,184,5,129,446,575,238,675,913,1488,57,516,Michigan,Gaylord,3645
9211,2007-2008,2007-11-05,2008-04-13,161,6,165,514,679,202,815,1017,1696,76,610,Michigan,Gaylord,3645
9212,2008-2009,2008-10-28,2009-04-22,177,0,203,598,801,239,908,1147,1948,97,792,Michigan,Gaylord,3645
9213,2009-2010,2009-10-13,2010-05-08,208,1,136,440,576,123,596,719,1295,60,411,Michigan,Gaylord,3645
9214,2010-2011,2010-11-06,2011-04-22,168,0,197,540,737,192,591,783,1520,83,659,Michigan,Gaylord,3645
9215,2011-2012,2011-11-11,2012-04-21,163,0,94,350,444,154,543,697,1141,58,381,Michigan,Gaylord,3645
9216,2012-2013,2012-10-07,2013-05-13,219,0,155,487,642,225,816,1041,1683,90,624,Michigan,Gaylord,3645
9217,2013-2014,2013-10-22,2014-05-16,207,0,310,759,1069,251,1131,1382,2451,98,931,Michigan,Gaylord,3645
9218,2014-2015,2014-11-01,2015-04-23,174,0,259,775,1034,205,773,978,2012,81,705,Michigan,Gaylord,3645
9219,2015-2016,2015-10-17,2016-04-15,182,0,123,459,582,172,643,815,1397,71,535,Michigan,Gaylord,3645
9220,2016-2017,2016-10-27,2017-04-12,168,3,140,428,568,193,676,869,1437,70,554,Michigan,Gaylord,3645
9221,2017-2018,2017-10-31,2018-04-29,181,0,220,638,858,201,761,962,1820,81,719,Michigan,Gaylord,3645
9222,2018-2019,2018-10-18,2019-04-15,180,0,230,645,875,184,869,1053,1928,82,660,Michigan,Gaylord,3645
9223,2019-2020,2019-10-31,2020-05-10,193,0,138,502,640,176,792,968,1608,77,506,Michigan,Gaylord,3645
9224,1950-1951,1950-11-10,1951-04-16,158,0,103,354,457,129,281,410,867,71,402,Michigan,Grand Rapids,10869
9225,1951-1952,1951-11-01,1952-04-06,158,0,84,355,439,194,280,474,913,61,417,Michigan,Grand Rapids,10869
9226,1952-1953,1952-11-26,1953-04-20,146,0,48,241,289,66,48,114,403,45,183,Michigan,Grand Rapids,10869
9227,1953-1954,1953-11-25,1954-05-05,162,0,44,284,328,117,185,302,630,56,283,Michigan,Grand Rapids,10869
9228,1954-1955,1954-10-29,1955-03-28,151,0,62,311,373,105,193,298,671,51,278,Michigan,Grand Rapids,10869
9229,1955-1956,1955-11-02,1956-04-17,168,0,73,364,437,130,146,276,713,68,332,Michigan,Grand Rapids,10869
9230,1956-1957,1956-11-07,1957-04-13,158,0,70,327,397,104,138,242,639,69,341,Michigan,Grand Rapids,10869
9231,1957-1958,1957-11-08,1958-03-20,133,0,79,320,399,110,369,479,878,55,297,Michigan,Grand Rapids,10869
9232,1958-1959,1958-11-24,1959-04-10,138,0,127,439,566,153,599,752,1318,71,495,Michigan,Grand Rapids,10869
9233,1959-1960,1959-11-06,1960-04-09,156,0,76,345,421,139,392,531,952,68,349,Michigan,Grand Rapids,10869
9234,1960-1961,1960-11-09,1961-04-28,171,0,83,342,425,114,241,355,780,53,351,Michigan,Grand Rapids,10869
9235,1961-1962,1961-11-17,1962-04-14,149,0,113,368,481,136,407,543,1024,66,436,Michigan,Grand Rapids,10869
9236,1962-1963,1962-10-24,1963-04-30,189,0,145,461,606,136,522,658,1264,64,479,Michigan,Grand Rapids,10869
9237,1963-1964,1963-11-02,1964-04-03,154,0,78,342,420,113,253,366,786,54,330,Michigan,Grand Rapids,10869
9238,1964-1965,1964-11-19,1965-04-17,150,0,110,409,519,150,317,467,986,67,463,Michigan,Grand Rapids,10869
9239,1965-1966,1965-11-28,1966-04-07,131,0,80,317,397,106,234,340,737,50,291,Michigan,Grand Rapids,10869
9240,1966-1967,1966-11-02,1967-03-23,142,0,63,328,391,138,460,598,989,60,325,Michigan,Grand Rapids,10869
9241,1967-1968,1967-10-26,1968-04-25,183,0,95,383,478,94,169,263,741,51,306,Michigan,Grand Rapids,10869
9242,1968-1969,1968-11-08,1969-03-31,144,0,109,387,496,110,248,358,854,52,330,Michigan,Grand Rapids,10869
9243,1969-1970,1969-11-13,1970-04-06,145,0,116,460,576,130,312,442,1018,64,439,Michigan,Grand Rapids,10869
9244,1970-1971,1970-11-22,1971-04-23,153,0,120,399,519,153,490,643,1162,66,442,Michigan,Grand Rapids,10869
9245,1971-1972,1971-11-03,1972-04-07,157,0,98,385,483,125,208,333,816,71,385,Michigan,Grand Rapids,10869
9246,1972-1973,1972-10-18,1973-05-03,198,0,73,303,376,106,289,395,771,51,266,Michigan,Grand Rapids,10869
9247,1973-1974,1973-11-09,1974-04-23,166,0,94,344,438,98,264,362,800,56,310,Michigan,Grand Rapids,10869
9248,1974-1975,1974-10-19,1975-04-09,173,0,85,356,441,113,225,338,779,60,290,Michigan,Grand Rapids,10869
9249,1975-1976,1975-11-24,1976-05-03,162,0,71,368,439,105,397,502,941,54,318,Michigan,Grand Rapids,10869
9250,1976-1977,1976-10-19,1977-04-07,171,0,148,510,658,121,357,478,1136,78,517,Michigan,Grand Rapids,10869
9251,1977-1978,1977-11-10,1978-03-26,137,0,126,486,612,127,567,694,1306,61,411,Michigan,Grand Rapids,10869
9252,1978-1979,1978-11-20,1979-04-06,138,0,138,414,552,143,661,804,1356,62,445,Michigan,Grand Rapids,10869
9253,1979-1980,1979-11-08,1980-04-24,169,0,65,315,380,77,149,226,606,50,258,Michigan,Grand Rapids,10869
9254,1980-1981,1980-10-25,1981-03-20,147,0,83,350,433,83,264,347,780,45,268,Michigan,Grand Rapids,10869
9255,1981-1982,1981-11-20,1982-04-12,144,0,111,388,499,116,322,438,937,59,413,Michigan,Grand Rapids,10869
9256,1982-1983,1982-11-04,1983-04-16,164,0,37,237,274,57,55,112,386,30,116,Michigan,Grand Rapids,10869
9257,1983-1984,1983-11-11,1984-04-22,164,0,121,401,522,114,350,464,986,63,425,Michigan,Grand Rapids,10869
9258,1984-1985,1984-12-01,1985-04-09,130,0,100,332,432,109,393,502,934,56,365,Michigan,Grand Rapids,10869
9259,1985-1986,1985-11-09,1986-04-15,158,0,112,372,484,116,385,501,985,63,412,Michigan,Grand Rapids,10869
9260,1986-1987,1986-11-12,1987-04-02,142,0,50,275,325,70,129,199,524,37,184,Michigan,Grand Rapids,10869
9261,1987-1988,1987-10-21,1988-04-15,178,0,95,369,464,102,222,324,788,60,352,Michigan,Grand Rapids,10869
9262,1988-1989,1988-10-25,1989-04-12,170,0,92,351,443,96,170,266,709,52,304,Michigan,Grand Rapids,10869
9263,1989-1990,1989-10-19,1990-05-10,204,0,87,367,454,138,228,366,820,62,377,Michigan,Grand Rapids,10869
9264,1990-1991,1990-11-05,1991-03-31,147,0,68,279,347,92,137,229,576,45,287,Michigan,Grand Rapids,10869
9265,1991-1992,1991-10-18,1992-04-13,179,0,55,285,340,127,138,265,605,54,293,Michigan,Grand Rapids,10869
9266,1992-1993,1992-10-18,1993-04-17,182,0,69,314,383,104,192,296,679,56,273,Michigan,Grand Rapids,10869
9267,1993-1994,1993-11-06,1994-05-01,177,0,141,442,583,118,342,460,1043,55,462,Michigan,Grand Rapids,10869
9268,1994-1995,1994-11-28,1995-04-09,133,0,70,268,338,86,208,294,632,44,248,Michigan,Grand Rapids,10869
9269,1995-1996,1995-11-03,1996-04-09,159,0,135,444,579,122,216,338,917,61,379,Michigan,Grand Rapids,10869
9270,1996-1997,1996-11-09,1997-04-13,156,0,101,330,431,140,225,365,796,63,398,Michigan,Grand Rapids,10869
9271,1997-1998,1997-10-26,1998-03-19,145,0,47,202,249,94,178,272,521,47,211,Michigan,Grand Rapids,10869
9272,1998-1999,1998-11-11,1999-03-15,125,0,79,273,352,109,218,327,679,36,293,Michigan,Grand Rapids,10869
9273,1999-2000,1999-11-03,2000-04-11,161,0,59,281,340,79,152,231,571,36,210,Michigan,Grand Rapids,10869
9274,2000-2001,2000-10-07,2001-04-17,193,0,97,356,453,154,331,485,938,69,400,Michigan,Grand Rapids,10869
9275,2001-2002,2001-10-25,2002-04-22,180,0,42,234,276,147,179,326,602,43,275,Michigan,Grand Rapids,10869
9276,2002-2003,2002-11-05,2003-04-08,155,0,124,404,528,138,219,357,885,58,398,Michigan,Grand Rapids,10869
9277,2003-2004,2003-11-24,2004-04-27,156,0,81,297,378,108,311,419,797,44,269,Michigan,Grand Rapids,10869
9278,2004-2005,2004-11-24,2005-04-24,152,0,92,322,414,128,239,367,781,55,332,Michigan,Grand Rapids,10869
9279,2005-2006,2005-11-16,2006-03-25,130,0,59,239,298,105,144,249,547,56,274,Michigan,Grand Rapids,10869
9280,2006-2007,2006-10-12,2007-04-13,184,0,91,295,386,124,325,449,835,51,336,Michigan,Grand Rapids,10869
9281,2007-2008,2007-11-21,2008-03-28,129,0,76,299,375,160,343,503,878,64,356,Michigan,Grand Rapids,10869
9282,2008-2009,2008-11-09,2009-03-29,141,0,106,355,461,151,325,476,937,59,396,Michigan,Grand Rapids,10869
9283,2009-2010,2009-11-27,2010-03-21,115,0,63,218,281,106,328,434,715,42,208,Michigan,Grand Rapids,10869
9284,2010-2011,2010-11-05,2011-04-18,165,0,88,312,400,116,362,478,878,53,292,Michigan,Grand Rapids,10869
9285,2011-2012,2011-11-10,2012-03-09,121,0,24,157,181,77,92,169,350,32,146,Michigan,Grand Rapids,10869
9286,2012-2013,2012-11-12,2013-04-25,165,0,60,277,337,109,190,299,636,57,285,Michigan,Grand Rapids,10869
9287,2013-2014,2013-11-11,2014-04-15,156,0,164,461,625,170,689,859,1484,75,568,Michigan,Grand Rapids,10869
9288,2014-2015,2014-11-12,2015-04-22,162,0,130,407,537,121,334,455,992,48,346,Michigan,Grand Rapids,10869
9289,2015-2016,2015-11-21,2016-04-10,142,0,49,210,259,90,133,223,482,38,220,Michigan,Grand Rapids,10869
9290,2016-2017,2016-11-19,2017-04-06,139,0,61,215,276,88,139,227,503,40,227,Michigan,Grand Rapids,10869
9291,2017-2018,2017-10-31,2018-04-18,170,0,100,345,445,115,223,338,783,54,367,Michigan,Grand Rapids,10869
9292,2018-2019,2018-11-09,2019-04-15,158,0,94,315,409,124,230,354,763,57,345,Michigan,Grand Rapids,10869
9293,2019-2020,2019-10-30,2020-04-16,170,0,35,225,260,86,129,215,475,43,187,Michigan,Grand Rapids,10869
9294,1968-1969,1968-10-03,1969-05-17,227,1,199,764,963,419,1467,1886,2849,100,993,Michigan,Herman,0
9295,1969-1970,1969-10-13,1970-05-05,205,0,236,893,1129,315,1259,1574,2703,115,1115,Michigan,Herman,0
9296,1970-1971,1970-09-28,1971-05-12,227,0,241,843,1084,382,1510,1892,2976,107,1071,Michigan,Herman,0
9297,1971-1972,1971-11-03,1972-05-07,187,0,252,902,1154,390,1577,1967,3121,109,1165,Michigan,Herman,0
9298,1972-1973,1972-10-15,1973-05-13,211,0,186,698,884,270,1110,1380,2264,96,801,Michigan,Herman,0
9299,1973-1974,1973-10-16,1974-05-06,203,0,226,834,1060,276,1167,1443,2503,99,919,Michigan,Herman,0
9300,1974-1975,1974-09-21,1975-04-29,221,1,177,724,901,406,1425,1831,2732,101,961,Michigan,Herman,0
9301,1975-1976,1975-09-13,1976-05-03,234,1,200,762,962,419,1357,1776,2738,96,1069,Michigan,Herman,0
9302,1976-1977,1976-10-13,1977-04-24,194,2,308,896,1204,358,1386,1744,2948,117,1275,Michigan,Herman,0
9303,1977-1978,1977-10-12,1978-04-30,201,3,239,798,1037,339,1390,1729,2766,104,1040,Michigan,Herman,0
9304,1978-1979,1978-10-15,1979-05-05,203,2,318,902,1220,413,1689,2102,3322,102,1225,Michigan,Herman,0
9305,1979-1980,1979-10-09,1980-04-25,200,0,218,783,1001,347,1364,1711,2712,108,981,Michigan,Herman,0
9306,1980-1981,1980-10-11,1981-05-09,211,0,229,716,945,354,1188,1542,2487,98,1001,Michigan,Herman,0
9307,1981-1982,1981-10-01,1982-05-01,213,0,267,858,1125,393,1502,1895,3020,112,1148,Michigan,Herman,0
9308,1982-1983,1982-10-17,1983-04-29,195,2,166,580,746,405,1283,1688,2434,93,865,Michigan,Herman,0
9309,1983-1984,1983-10-14,1984-05-09,209,9,255,807,1062,364,1324,1688,2750,90,969,Michigan,Herman,0
9310,1984-1985,1984-09-26,1985-04-19,206,11,249,715,964,399,1245,1644,2608,87,1023,Michigan,Herman,0
9311,1985-1986,1985-10-01,1986-05-01,213,3,275,718,993,433,1513,1946,2939,109,1205,Michigan,Herman,0
9312,1986-1987,1986-10-14,1987-04-07,176,6,157,489,646,233,918,1151,1797,68,616,Michigan,Herman,0
9313,1987-1988,1987-10-02,1988-04-23,205,4,218,665,883,423,1500,1923,2806,97,1009,Michigan,Herman,0
9314,1988-1989,1988-10-12,1989-05-06,207,0,229,739,968,321,1390,1711,2679,100,885,Michigan,Herman,0
9315,1989-1990,1989-09-23,1990-05-11,231,8,204,700,904,310,1072,1382,2286,87,834,Michigan,Herman,0
9316,1990-1991,1990-10-07,1991-05-07,213,0,199,663,862,209,867,1076,1938,66,607,Michigan,Herman,0
9317,1991-1992,1991-10-06,1992-04-25,203,0,182,643,825,249,1320,1569,2394,65,641,Michigan,Herman,0
9318,1992-1993,1992-10-14,1993-04-23,192,5,207,675,882,264,1256,1520,2402,77,687,Michigan,Herman,0
9319,1993-1994,1993-10-21,1994-04-29,191,16,271,774,1045,218,1091,1309,2354,59,572,Michigan,Herman,0
9320,1996-1997,1996-10-10,1997-05-17,220,8,291,772,1063,558,1654,2212,3275,96,1161,Michigan,Herman,0
9321,1997-1998,1997-10-21,1998-04-17,179,9,172,491,663,240,969,1209,1872,54,525,Michigan,Herman,0
9322,1999-2000,1999-10-22,2000-04-20,182,9,145,568,713,208,921,1129,1842,71,569,Michigan,Herman,0
9323,2002-2003,2002-10-13,2003-04-22,192,19,272,787,1059,276,1143,1419,2478,86,895,Michigan,Herman,0
9324,2003-2004,2003-09-30,2004-05-02,216,10,213,673,886,296,1209,1505,2391,107,897,Michigan,Herman,0
9325,2006-2007,2006-10-12,2007-05-20,221,1,274,777,1051,322,1097,1419,2470,85,936,Michigan,Herman,0
9326,2007-2008,2007-10-24,2008-04-27,187,0,279,801,1080,269,1354,1623,2703,96,912,Michigan,Herman,0
9327,2008-2009,2008-10-27,2009-05-10,196,0,274,828,1102,294,1326,1620,2722,94,992,Michigan,Herman,0
9328,2009-2010,2009-10-10,2010-05-09,212,9,148,548,696,264,1158,1422,2118,84,650,Michigan,Herman,0
9329,2010-2011,2010-10-28,2011-05-03,188,1,268,717,985,294,1450,1744,2729,104,981,Michigan,Herman,0
9330,2011-2012,2011-10-19,2012-04-26,191,3,151,530,681,284,1167,1451,2132,80,688,Michigan,Herman,0
9331,2013-2014,2013-10-21,2014-05-16,208,1,464,1036,1500,392,2074,2466,3966,119,1345,Michigan,Herman,0
9332,2014-2015,2014-10-31,2015-05-19,201,1,367,913,1280,326,1770,2096,3376,107,1140,Michigan,Herman,0
9333,2016-2017,2016-11-19,2017-05-02,165,9,229,565,794,248,920,1168,1962,76,751,Michigan,Herman,0
9334,2017-2018,2017-10-25,2018-05-01,189,15,311,746,1057,290,1445,1735,2792,80,834,Michigan,Herman,0
9335,2018-2019,2018-10-05,2019-05-02,210,1,313,721,1034,368,1653,2021,3055,93,943,Michigan,Herman,0
9336,2019-2020,2019-10-13,2020-05-09,210,8,224,607,831,321,1507,1828,2659,83,762,Michigan,Herman,0
9337,1950-1951,1950-11-11,1951-04-18,159,0,132,477,609,101,882,983,1592,45,301,Michigan,Houghton Lake,0
9338,1953-1954,1953-11-26,1954-05-05,161,5,79,404,483,70,344,414,897,43,243,Michigan,Houghton Lake,0
9339,1954-1955,1954-10-29,1955-03-31,154,13,95,469,564,74,597,671,1235,37,224,Michigan,Houghton Lake,0
9340,1955-1956,1955-10-24,1956-04-07,167,5,94,556,650,105,758,863,1513,49,318,Michigan,Houghton Lake,0
9341,1956-1957,1956-11-08,1957-04-07,151,10,102,470,572,91,301,392,964,46,301,Michigan,Houghton Lake,0
9342,1957-1958,1957-11-09,1958-03-19,131,1,96,388,484,73,429,502,986,41,258,Michigan,Houghton Lake,0
9343,1958-1959,1958-11-26,1959-04-09,135,4,175,585,760,105,866,971,1731,40,322,Michigan,Houghton Lake,0
9344,1959-1960,1959-11-02,1960-04-09,160,1,97,522,619,126,731,857,1476,55,347,Michigan,Houghton Lake,0
9345,1960-1961,1960-11-06,1961-04-17,163,0,123,451,574,68,282,350,924,35,237,Michigan,Houghton Lake,0
9346,1961-1962,1961-11-08,1962-03-28,141,1,140,479,619,96,752,848,1467,40,278,Michigan,Houghton Lake,0
9347,1962-1963,1962-10-23,1963-04-30,190,1,189,595,784,115,740,855,1639,42,344,Michigan,Houghton Lake,0
9348,1963-1964,1963-11-02,1964-04-08,159,2,92,436,528,65,283,348,876,32,195,Michigan,Houghton Lake,0
9349,1964-1965,1964-10-05,1965-04-20,198,0,163,609,772,144,450,594,1366,78,546,Michigan,Houghton Lake,0
9350,1965-1966,1965-10-28,1966-05-07,192,0,120,486,606,110,234,344,950,71,431,Michigan,Houghton Lake,0
9351,1966-1967,1966-11-02,1967-04-07,157,0,133,560,693,130,508,638,1331,66,473,Michigan,Houghton Lake,0
9352,1967-1968,1967-09-29,1968-04-25,210,0,154,551,705,89,231,320,1025,54,358,Michigan,Houghton Lake,0
9353,1968-1969,1968-10-25,1969-05-11,199,0,132,572,704,148,579,727,1431,73,500,Michigan,Houghton Lake,0
9354,1969-1970,1969-10-21,1970-04-09,171,0,158,651,809,169,709,878,1687,84,637,Michigan,Houghton Lake,0
9355,1970-1971,1970-11-14,1971-04-24,162,0,163,579,742,190,646,836,1578,83,598,Michigan,Houghton Lake,0
9356,1971-1972,1971-11-04,1972-04-11,160,0,151,591,742,150,534,684,1426,79,529,Michigan,Houghton Lake,0
9357,1972-1973,1972-10-17,1973-05-16,212,0,118,452,570,121,364,485,1055,65,405,Michigan,Houghton Lake,0
9358,1973-1974,1973-11-06,1974-05-06,182,0,150,531,681,109,353,462,1143,66,421,Michigan,Houghton Lake,0
9359,1974-1975,1974-11-12,1975-04-05,145,0,110,454,564,112,395,507,1071,71,385,Michigan,Houghton Lake,0
9360,1975-1976,1975-11-13,1976-05-03,173,0,127,492,619,148,500,648,1267,81,526,Michigan,Houghton Lake,0
9361,1976-1977,1976-10-16,1977-04-07,174,0,218,641,859,122,567,689,1548,85,627,Michigan,Houghton Lake,0
9362,1977-1978,1977-11-10,1978-04-20,162,0,165,658,823,149,840,989,1812,71,532,Michigan,Houghton Lake,0
9363,1978-1979,1978-11-19,1979-05-05,168,0,202,605,807,144,786,930,1737,73,555,Michigan,Houghton Lake,0
9364,1979-1980,1979-10-10,1980-04-24,198,0,122,536,658,107,319,426,1084,75,418,Michigan,Houghton Lake,0
9365,1980-1981,1980-10-03,1981-04-05,185,0,130,523,653,125,457,582,1235,71,503,Michigan,Houghton Lake,0
9366,1981-1982,1981-10-18,1982-04-17,182,0,165,578,743,156,705,861,1604,73,563,Michigan,Houghton Lake,0
9367,1982-1983,1982-10-21,1983-05-07,199,0,80,370,450,84,254,338,788,49,218,Michigan,Houghton Lake,0
9368,1983-1984,1983-11-11,1984-05-01,173,0,168,540,708,104,403,507,1215,68,435,Michigan,Houghton Lake,0
9369,1984-1985,1984-11-02,1985-04-17,167,0,133,500,633,125,498,623,1256,65,458,Michigan,Houghton Lake,0
9370,1985-1986,1985-11-09,1986-04-21,164,0,167,512,679,122,687,809,1488,70,523,Michigan,Houghton Lake,0
9371,1986-1987,1986-11-11,1987-04-03,144,0,76,409,485,68,319,387,872,48,247,Michigan,Houghton Lake,0
9372,1987-1988,1987-10-22,1988-04-27,189,0,125,493,618,121,376,497,1115,76,437,Michigan,Houghton Lake,0
9373,1988-1989,1988-11-06,1989-04-12,158,1,131,490,621,112,322,434,1055,72,447,Michigan,Houghton Lake,0
9374,1989-1990,1989-10-19,1990-05-11,205,0,129,547,676,107,429,536,1212,70,397,Michigan,Houghton Lake,0
9375,1990-1991,1990-11-05,1991-04-10,157,0,103,417,520,102,277,379,899,57,346,Michigan,Houghton Lake,0
9376,1991-1992,1991-11-02,1992-04-12,163,0,102,422,524,109,298,407,931,60,367,Michigan,Houghton Lake,0
9377,1992-1993,1992-10-16,1993-04-17,184,1,116,485,601,105,380,485,1086,64,336,Michigan,Houghton Lake,0
9378,1993-1994,1993-10-30,1994-05-01,184,0,185,604,789,110,391,501,1290,62,445,Michigan,Houghton Lake,0
9379,1994-1995,1994-11-22,1995-04-07,137,0,94,377,471,77,292,369,840,51,292,Michigan,Houghton Lake,0
9380,1995-1996,1995-11-04,1996-05-12,191,2,166,642,808,185,650,835,1643,81,575,Michigan,Houghton Lake,0
9381,1999-2000,1999-11-29,2000-04-08,132,0,100,380,480,64,261,325,805,34,243,Michigan,Houghton Lake,0
9382,2000-2001,2000-11-15,2001-04-17,154,0,132,483,615,90,623,713,1328,42,311,Michigan,Houghton Lake,0
9383,2001-2002,2001-10-07,2002-04-22,198,2,76,367,443,83,196,279,722,34,211,Michigan,Houghton Lake,0
9384,2002-2003,2002-11-06,2003-04-10,156,1,175,560,735,68,312,380,1115,37,310,Michigan,Houghton Lake,0
9385,2003-2004,2003-10-02,2004-03-23,174,1,130,474,604,131,559,690,1294,59,417,Michigan,Houghton Lake,0
9386,2004-2005,2004-11-24,2005-04-24,152,0,145,484,629,110,602,712,1341,49,347,Michigan,Houghton Lake,0
9387,2005-2006,2005-11-16,2006-04-04,140,0,97,365,462,100,567,667,1129,43,244,Michigan,Houghton Lake,0
9388,2006-2007,2006-10-12,2007-04-13,184,0,123,426,549,113,459,572,1121,49,349,Michigan,Houghton Lake,0
9389,2007-2008,2007-11-08,2008-04-04,149,3,133,491,624,112,772,884,1508,47,316,Michigan,Houghton Lake,0
9390,2008-2009,2008-11-10,2009-04-07,149,3,175,558,733,148,877,1025,1758,54,430,Michigan,Houghton Lake,0
9391,2009-2010,2009-11-30,2010-03-11,102,0,98,330,428,50,476,526,954,34,198,Michigan,Houghton Lake,0
9392,2010-2011,2010-11-18,2011-04-21,155,3,148,522,670,135,757,892,1562,55,402,Michigan,Houghton Lake,0
9393,2011-2012,2011-11-17,2012-03-31,136,0,58,279,337,108,497,605,942,34,222,Michigan,Houghton Lake,0
9394,2012-2013,2012-11-02,2013-05-12,192,0,106,424,530,99,518,617,1147,55,325,Michigan,Houghton Lake,0
9395,2013-2014,2013-11-12,2014-04-15,155,0,246,693,939,99,914,1013,1952,53,472,Michigan,Houghton Lake,0
9396,2014-2015,2014-11-12,2015-04-05,145,0,191,606,797,71,504,575,1372,41,321,Michigan,Houghton Lake,0
9397,2015-2016,2015-11-21,2016-04-13,145,0,86,333,419,87,483,570,989,38,233,Michigan,Houghton Lake,0
9398,2016-2017,2016-10-26,2017-03-30,156,0,97,344,441,110,447,557,998,46,288,Michigan,Houghton Lake,0
9399,2017-2018,2017-11-09,2018-04-20,163,0,155,496,651,86,330,416,1067,47,319,Michigan,Houghton Lake,0
9400,2018-2019,2018-11-09,2019-04-15,158,0,163,525,688,127,544,671,1359,60,393,Michigan,Houghton Lake,0
9401,2019-2020,2019-10-31,2020-05-10,193,0,83,397,480,82,429,511,991,33,210,Michigan,Houghton Lake,0
9402,1951-1952,1951-11-01,1952-04-14,166,4,158,670,828,93,666,759,1587,40,291,Michigan,Iron Mountain,7624
9403,1952-1953,1952-11-23,1953-04-26,155,0,108,481,589,81,545,626,1215,41,241,Michigan,Iron Mountain,7624
9404,1953-1954,1953-11-23,1954-05-04,163,0,131,533,664,83,349,432,1096,42,286,Michigan,Iron Mountain,7624
9405,1954-1955,1954-10-30,1955-04-05,158,0,157,591,748,93,680,773,1521,38,244,Michigan,Iron Mountain,7624
9406,1955-1956,1955-11-07,1956-04-29,175,0,161,694,855,89,872,961,1816,46,306,Michigan,Iron Mountain,7624
9407,1958-1959,1958-11-25,1959-03-28,124,0,238,741,979,76,648,724,1703,33,289,Michigan,Iron Mountain,7624
9408,1959-1960,1959-10-24,1960-05-06,196,0,145,678,823,115,900,1015,1838,53,346,Michigan,Iron Mountain,7624
9409,1960-1961,1960-11-10,1961-03-29,140,1,148,553,701,68,249,317,1018,21,178,Michigan,Iron Mountain,7624
9410,1961-1962,1961-11-08,1962-04-03,147,0,197,663,860,137,984,1121,1981,39,362,Michigan,Iron Mountain,7624
9411,1962-1963,1962-11-04,1963-03-23,140,0,233,696,929,66,435,501,1430,30,272,Michigan,Iron Mountain,7624
9412,1963-1964,1963-11-24,1964-03-31,129,0,120,564,684,45,355,400,1084,23,144,Michigan,Iron Mountain,7624
9413,1964-1965,1964-11-19,1965-04-26,159,1,190,731,921,114,735,849,1770,38,315,Michigan,Iron Mountain,7624
9414,1965-1966,1965-09-26,1966-04-26,213,1,129,578,707,90,507,597,1304,35,210,Michigan,Iron Mountain,7624
9415,1966-1967,1966-11-02,1967-05-11,191,1,158,659,817,123,670,793,1610,39,343,Michigan,Iron Mountain,7624
9416,1967-1968,1967-11-05,1968-04-25,173,0,157,618,775,56,385,441,1216,26,189,Michigan,Iron Mountain,7624
9417,1968-1969,1968-11-17,1969-04-02,137,1,129,583,712,117,862,979,1691,32,269,Michigan,Iron Mountain,7624
9418,1969-1970,1969-10-21,1970-03-29,160,0,165,683,848,87,678,765,1613,36,286,Michigan,Iron Mountain,7624
9419,1970-1971,1970-11-14,1971-04-08,146,1,183,677,860,151,1149,1300,2160,43,386,Michigan,Iron Mountain,7624
9420,1971-1972,1971-11-07,1972-04-23,169,1,188,755,943,163,1101,1264,2207,38,359,Michigan,Iron Mountain,7624
9421,1972-1973,1972-11-14,1973-04-10,148,2,139,527,666,74,516,590,1256,34,237,Michigan,Iron Mountain,7624
9422,1973-1974,1973-11-05,1974-04-04,151,6,173,619,792,85,641,726,1518,30,217,Michigan,Iron Mountain,7624
9423,1974-1975,1974-11-14,1975-04-13,151,3,113,598,711,111,735,846,1557,31,239,Michigan,Iron Mountain,7624
9424,1975-1976,1975-11-20,1976-04-01,134,0,150,577,727,122,621,743,1470,38,316,Michigan,Iron Mountain,7624
9425,1976-1977,1976-10-19,1977-04-09,173,0,226,773,999,123,660,783,1782,39,363,Michigan,Iron Mountain,7624
9426,1977-1978,1977-11-11,1978-04-20,161,1,176,704,880,95,700,795,1675,33,267,Michigan,Iron Mountain,7624
9427,1978-1979,1978-11-12,1979-05-06,176,4,247,794,1041,137,1052,1189,2230,37,355,Michigan,Iron Mountain,7624
9428,1979-1980,1979-10-23,1980-04-10,171,2,137,614,751,68,342,410,1161,25,156,Michigan,Iron Mountain,7624
9429,1980-1981,1980-11-08,1981-05-01,175,0,148,568,716,61,364,425,1141,27,222,Michigan,Iron Mountain,7624
9430,1981-1982,1981-11-19,1982-04-20,153,5,178,682,860,89,805,894,1754,33,276,Michigan,Iron Mountain,7624
9431,1982-1983,1982-11-05,1983-04-16,163,3,100,440,540,68,367,435,975,28,141,Michigan,Iron Mountain,7624
9432,1983-1984,1983-11-10,1984-03-25,137,15,183,683,866,73,674,747,1613,42,319,Michigan,Iron Mountain,7624
9433,1984-1985,1984-11-03,1985-04-17,166,2,175,682,857,110,547,657,1514,46,389,Michigan,Iron Mountain,7624
9434,1985-1986,1985-11-09,1986-03-29,141,4,204,748,952,111,949,1060,2012,52,438,Michigan,Iron Mountain,7624
9435,1987-1988,1987-11-18,1988-04-27,162,6,157,683,840,86,598,684,1524,39,322,Michigan,Iron Mountain,7624
9436,1988-1989,1988-11-06,1989-04-12,158,13,165,742,907,98,660,758,1665,44,364,Michigan,Iron Mountain,7624
9437,1989-1990,1989-10-20,1990-05-11,204,7,152,739,891,91,478,569,1460,44,331,Michigan,Iron Mountain,7624
9438,1990-1991,1990-11-09,1991-04-13,156,3,147,682,829,62,361,423,1252,21,209,Michigan,Iron Mountain,7624
9439,1991-1992,1991-11-02,1992-04-15,166,0,116,620,736,99,786,885,1621,37,284,Michigan,Iron Mountain,7624
9440,1992-1993,1992-10-16,1993-04-18,185,8,132,686,818,121,745,866,1684,48,330,Michigan,Iron Mountain,7624
9441,1994-1995,1994-11-23,1995-04-07,136,7,128,508,636,57,339,396,1032,24,164,Michigan,Iron Mountain,7624
9442,1995-1996,1995-10-21,1996-05-06,199,9,233,913,1146,165,1128,1293,2439,56,458,Michigan,Iron Mountain,7624
9443,1996-1997,1996-11-01,1997-05-17,198,10,178,667,845,133,1041,1174,2019,54,417,Michigan,Iron Mountain,7624
9444,1997-1998,1997-10-23,1998-04-17,177,4,95,434,529,97,581,678,1207,32,235,Michigan,Iron Mountain,7624
9445,1998-1999,1998-11-13,1999-03-26,134,5,144,522,666,75,706,781,1447,31,274,Michigan,Iron Mountain,7624
9446,1999-2000,1999-12-01,2000-04-18,140,16,121,569,690,89,564,653,1343,37,270,Michigan,Iron Mountain,7624
9447,2000-2001,2000-11-14,2001-04-17,155,5,171,614,785,84,810,894,1679,47,336,Michigan,Iron Mountain,7624
9448,2001-2002,2001-10-26,2002-04-29,186,6,82,451,533,98,338,436,969,40,231,Michigan,Iron Mountain,7624
9449,2002-2003,2002-10-22,2003-04-18,179,8,204,717,921,80,354,434,1355,29,242,Michigan,Iron Mountain,7624
9450,2003-2004,2003-10-28,2004-04-02,158,12,148,598,746,121,780,901,1647,39,309,Michigan,Iron Mountain,7624
9451,2004-2005,2004-11-27,2005-03-29,123,9,152,576,728,72,597,669,1397,33,274,Michigan,Iron Mountain,7624
9452,2005-2006,2005-11-16,2006-03-29,134,5,111,505,616,91,729,820,1436,40,251,Michigan,Iron Mountain,7624
9453,2006-2007,2006-10-14,2007-04-12,181,4,150,550,700,64,273,337,1037,22,166,Michigan,Iron Mountain,7624
9454,2007-2008,2007-11-08,2008-04-15,160,7,169,707,876,109,869,978,1854,39,291,Michigan,Iron Mountain,7624
9455,2008-2009,2008-10-27,2009-04-21,177,2,205,754,959,93,629,722,1681,48,406,Michigan,Iron Mountain,7624
9456,2009-2010,2009-10-13,2010-05-08,208,3,117,529,646,59,558,617,1263,30,196,Michigan,Iron Mountain,7624
9457,2010-2011,2010-11-15,2011-04-18,155,5,172,566,738,66,462,528,1266,33,227,Michigan,Iron Mountain,7624
9458,2011-2012,2011-11-10,2012-03-13,125,0,85,388,473,68,434,502,975,25,168,Michigan,Iron Mountain,7624
9459,2012-2013,2012-11-13,2013-04-25,164,0,148,605,753,94,746,840,1593,34,246,Michigan,Iron Mountain,7624
9460,2013-2014,2013-11-12,2014-04-19,159,0,316,909,1225,107,1023,1130,2355,41,387,Michigan,Iron Mountain,7624
9461,2014-2015,2014-11-06,2015-04-23,169,4,232,750,982,91,864,955,1937,31,249,Michigan,Iron Mountain,7624
9462,2015-2016,2015-11-13,2016-04-14,154,0,112,439,551,71,413,484,1035,33,206,Michigan,Iron Mountain,7624
9463,2017-2018,2017-11-04,2018-04-20,168,0,199,695,894,94,666,760,1654,34,286,Michigan,Iron Mountain,7624
9464,2018-2019,2018-11-09,2019-04-15,158,6,213,683,896,112,865,977,1873,36,341,Michigan,Iron Mountain,7624
9465,2019-2020,2019-10-29,2020-04-17,172,0,110,541,651,110,958,1068,1719,34,262,Michigan,Iron Mountain,7624
9466,1950-1951,1950-10-22,1951-04-22,183,13,253,704,957,215,1201,1416,2373,69,607,Michigan,Ironwood,5387
9467,1951-1952,1951-10-28,1952-05-11,197,9,189,659,848,173,997,1170,2018,52,414,Michigan,Ironwood,5387
9468,1952-1953,1952-10-06,1953-05-12,219,0,133,522,655,183,840,1023,1678,59,443,Michigan,Ironwood,5387
9469,1954-1955,1954-10-29,1955-04-09,163,10,195,591,786,173,1171,1344,2130,69,550,Michigan,Ironwood,5387
9470,1955-1956,1955-11-03,1956-05-02,182,1,187,714,901,167,1235,1402,2303,61,495,Michigan,Ironwood,5387
9471,1956-1957,1956-11-07,1957-04-15,160,3,214,721,935,219,1242,1461,2396,70,637,Michigan,Ironwood,5387
9472,1957-1958,1957-10-25,1958-04-05,163,0,192,602,794,194,1260,1454,2248,54,527,Michigan,Ironwood,5387
9473,1958-1959,1958-11-05,1959-04-11,158,1,285,775,1060,126,1061,1187,2247,57,568,Michigan,Ironwood,5387
9474,1959-1960,1959-10-26,1960-05-09,197,0,191,740,931,226,1122,1348,2279,72,639,Michigan,Ironwood,5387
9475,1960-1961,1960-11-05,1961-05-10,187,0,180,640,820,190,907,1097,1917,63,537,Michigan,Ironwood,5387
9476,1961-1962,1961-10-19,1962-04-14,178,0,256,691,947,159,983,1142,2089,69,596,Michigan,Ironwood,5387
9477,1962-1963,1962-10-23,1963-05-22,212,0,289,793,1082,186,952,1138,2220,68,661,Michigan,Ironwood,5387
9478,1963-1964,1963-11-01,1964-04-15,167,1,173,678,851,276,1234,1510,2361,72,736,Michigan,Ironwood,5387
9479,1964-1965,1964-10-05,1965-05-28,236,3,270,893,1163,249,1274,1523,2686,86,857,Michigan,Ironwood,5387
9480,1965-1966,1965-09-25,1966-05-02,220,1,206,698,904,250,1162,1412,2316,76,648,Michigan,Ironwood,5387
9481,1966-1967,1966-10-15,1967-05-11,209,0,215,745,960,347,1125,1472,2432,93,900,Michigan,Ironwood,5387
9482,1967-1968,1967-10-09,1968-04-26,201,2,214,689,903,214,798,1012,1915,68,625,Michigan,Ironwood,5387
9483,1968-1969,1968-10-28,1969-04-28,183,0,194,700,894,287,1317,1604,2498,69,677,Michigan,Ironwood,5387
9484,1969-1970,1969-10-13,1970-05-02,202,4,220,772,992,218,1056,1274,2266,84,733,Michigan,Ironwood,5387
9485,1970-1971,1970-10-10,1971-05-20,223,0,243,786,1029,359,1468,1827,2856,87,910,Michigan,Ironwood,5387
9486,1971-1972,1971-11-02,1972-04-28,179,0,241,853,1094,275,1201,1476,2570,80,759,Michigan,Ironwood,5387
9487,1972-1973,1972-10-17,1973-05-04,200,0,178,617,795,196,922,1118,1913,75,587,Michigan,Ironwood,5387
9488,1973-1974,1973-11-04,1974-04-23,171,4,242,795,1037,148,943,1091,2128,47,432,Michigan,Ironwood,5387
9489,1974-1975,1974-10-01,1975-04-20,202,0,184,735,919,271,1242,1513,2432,65,641,Michigan,Ironwood,5387
9490,1975-1976,1975-11-10,1976-05-04,177,2,217,705,922,343,1367,1710,2632,70,789,Michigan,Ironwood,5387
9491,1976-1977,1976-10-09,1977-04-09,183,3,314,895,1209,282,1179,1461,2670,89,1048,Michigan,Ironwood,5387
9492,1977-1978,1977-10-08,1978-04-20,195,0,248,835,1083,243,1149,1392,2475,79,819,Michigan,Ironwood,5387
9493,1978-1979,1978-11-11,1979-05-05,176,0,324,932,1256,212,1205,1417,2673,71,753,Michigan,Ironwood,5387
9494,1979-1980,1979-10-09,1980-04-24,199,1,212,851,1063,213,1195,1408,2471,80,693,Michigan,Ironwood,5387
9495,1980-1981,1980-10-12,1981-04-24,195,1,210,867,1077,222,998,1220,2297,69,796,Michigan,Ironwood,5387
9496,1981-1982,1981-10-18,1982-04-20,185,3,272,868,1140,264,1250,1514,2654,81,860,Michigan,Ironwood,5387
9497,1982-1983,1982-10-20,1983-04-29,192,3,142,652,794,283,1092,1375,2169,86,706,Michigan,Ironwood,5387
9498,1983-1984,1983-10-14,1984-05-09,209,3,262,887,1149,243,1030,1273,2422,76,757,Michigan,Ironwood,5387
9499,1984-1985,1984-10-30,1985-04-10,163,6,235,733,968,245,761,1006,1974,63,703,Michigan,Ironwood,5387
9500,1985-1986,1985-11-09,1986-04-21,164,13,263,714,977,247,1252,1499,2476,75,799,Michigan,Ironwood,5387
9501,1986-1987,1986-10-14,1987-04-05,174,8,143,545,688,163,701,864,1552,56,464,Michigan,Ironwood,5387
9502,1987-1988,1987-10-02,1988-04-23,205,8,241,705,946,239,1014,1253,2199,69,665,Michigan,Ironwood,5387
9503,1989-1990,1989-09-23,1990-05-10,230,14,243,805,1048,333,1025,1358,2406,82,915,Michigan,Ironwood,5387
9504,1990-1991,1990-10-18,1991-05-01,196,8,245,728,973,181,604,785,1758,66,639,Michigan,Ironwood,5387
9505,1991-1992,1991-10-06,1992-04-14,192,6,213,680,893,271,1201,1472,2365,81,797,Michigan,Ironwood,5387
9506,1992-1993,1992-10-14,1993-04-14,183,7,231,731,962,235,924,1159,2121,87,723,Michigan,Ironwood,5387
9507,1993-1994,1993-10-27,1994-04-29,185,15,348,873,1221,228,795,1023,2244,91,889,Michigan,Ironwood,5387
9508,1994-1995,1994-10-25,1995-04-26,184,16,203,648,851,225,614,839,1690,79,723,Michigan,Ironwood,5387
9509,1997-1998,1997-10-14,1998-04-02,171,19,152,502,654,203,796,999,1653,70,555,Michigan,Ironwood,5387
9510,2000-2001,2000-10-06,2001-04-24,201,15,255,734,989,432,1483,1915,2904,107,1173,Michigan,Ironwood,5387
9511,2002-2003,2002-10-19,2003-04-22,186,20,281,787,1068,295,818,1113,2181,88,887,Michigan,Ironwood,5387
9512,2004-2005,2004-10-16,2005-05-03,200,9,215,667,882,253,907,1160,2042,78,750,Michigan,Ironwood,5387
9513,2006-2007,2006-10-12,2007-04-14,185,20,223,656,879,285,834,1119,1998,62,675,Michigan,Ironwood,5387
9514,2008-2009,2008-10-28,2009-04-23,178,4,297,817,1114,273,883,1156,2270,79,873,Michigan,Ironwood,5387
9515,2009-2010,2009-10-13,2010-05-08,208,11,190,613,803,239,744,983,1786,56,604,Michigan,Ironwood,5387
9516,2017-2018,2017-10-28,2018-04-23,178,9,297,798,1095,245,1183,1428,2523,68,738,Michigan,Ironwood,5387
9517,2018-2019,2018-10-13,2019-05-09,209,5,298,776,1074,265,1033,1298,2372,78,814,Michigan,Ironwood,5387
9518,2019-2020,2019-10-31,2020-04-18,171,0,194,645,839,241,1180,1421,2260,65,597,Michigan,Ironwood,5387
9519,1950-1951,1950-11-04,1951-04-16,164,0,114,368,482,79,182,261,743,52,312,Michigan,Lansing,48579
9520,1951-1952,1951-11-02,1952-04-12,163,0,91,361,452,135,245,380,832,57,340,Michigan,Lansing,48579
9521,1952-1953,1952-10-19,1953-04-19,183,0,49,258,307,46,36,82,389,37,137,Michigan,Lansing,48579
9522,1953-1954,1953-11-25,1954-05-04,161,0,61,291,352,84,184,268,620,46,220,Michigan,Lansing,48579
9523,1955-1956,1955-11-03,1956-04-17,167,0,75,347,422,88,154,242,664,51,233,Michigan,Lansing,48579
9524,1958-1959,1958-11-24,1959-04-10,138,0,119,428,547,84,342,426,973,56,335,Michigan,Lansing,48579
9525,1959-1960,1959-11-06,1960-04-09,156,0,77,412,489,89,331,420,909,61,305,Michigan,Lansing,48579
9526,1960-1961,1960-11-06,1961-04-18,164,0,93,400,493,57,114,171,664,38,223,Michigan,Lansing,48579
9527,1961-1962,1961-12-01,1962-04-19,140,0,125,410,535,79,334,413,948,45,301,Michigan,Lansing,48579
9528,1962-1963,1962-10-25,1963-04-30,188,0,167,518,685,74,389,463,1148,50,334,Michigan,Lansing,48579
9529,1963-1964,1963-12-01,1964-04-08,130,0,75,357,432,59,138,197,629,37,187,Michigan,Lansing,48579
9530,1964-1965,1964-11-19,1965-04-17,150,0,113,427,540,100,213,313,853,50,326,Michigan,Lansing,48579
9531,1965-1966,1965-11-28,1966-04-07,131,0,98,354,452,61,167,228,680,37,228,Michigan,Lansing,48579
9532,1966-1967,1966-11-02,1967-03-24,143,0,97,416,513,125,506,631,1144,49,320,Michigan,Lansing,48579
9533,1967-1968,1967-10-27,1968-04-25,182,0,94,418,512,75,122,197,709,40,232,Michigan,Lansing,48579
9534,1968-1969,1968-11-09,1969-03-30,142,0,80,402,482,61,140,201,683,43,240,Michigan,Lansing,48579
9535,1969-1970,1969-11-14,1970-04-07,145,0,106,458,564,111,232,343,907,54,362,Michigan,Lansing,48579
9536,1970-1971,1970-11-22,1971-04-03,133,0,109,372,481,104,303,407,888,54,311,Michigan,Lansing,48579
9537,1971-1972,1971-11-03,1972-04-07,157,0,90,411,501,105,191,296,797,64,338,Michigan,Lansing,48579
9538,1972-1973,1972-11-13,1973-04-11,150,0,83,327,410,108,298,406,816,43,237,Michigan,Lansing,48579
9539,1973-1974,1973-12-01,1974-04-07,128,0,92,350,442,99,281,380,822,47,310,Michigan,Lansing,48579
9540,1974-1975,1974-10-19,1975-04-12,176,0,53,341,394,105,236,341,735,50,235,Michigan,Lansing,48579
9541,1975-1976,1975-11-24,1976-04-26,155,0,76,372,448,111,365,476,924,54,324,Michigan,Lansing,48579
9542,1976-1977,1976-10-21,1977-04-25,187,0,167,529,696,104,385,489,1185,66,477,Michigan,Lansing,48579
9543,1977-1978,1977-11-11,1978-03-30,140,0,159,544,703,115,577,692,1395,57,394,Michigan,Lansing,48579
9544,1978-1979,1978-11-20,1979-04-06,138,0,153,432,585,101,428,529,1114,58,390,Michigan,Lansing,48579
9545,1979-1980,1979-11-08,1980-04-25,170,0,95,406,501,63,80,143,644,46,259,Michigan,Lansing,48579
9546,1980-1981,1980-11-27,1981-03-20,114,0,99,369,468,67,204,271,739,39,266,Michigan,Lansing,48579
9547,1981-1982,1981-10-21,1982-04-11,173,0,129,474,603,99,363,462,1065,51,374,Michigan,Lansing,48579
9548,1982-1983,1982-11-05,1983-04-18,165,0,49,267,316,59,72,131,447,33,146,Michigan,Lansing,48579
9549,1983-1984,1983-10-14,1984-04-17,187,0,147,470,617,86,277,363,980,55,360,Michigan,Lansing,48579
9550,1984-1985,1984-11-11,1985-04-08,149,0,106,382,488,92,313,405,893,49,317,Michigan,Lansing,48579
9551,1985-1986,1985-11-09,1986-03-20,132,0,118,388,506,106,321,427,933,58,388,Michigan,Lansing,48579
9552,1986-1987,1986-11-12,1987-04-02,142,0,45,300,345,61,109,170,515,35,155,Michigan,Lansing,48579
9553,1987-1988,1987-10-21,1988-04-15,178,0,92,399,491,74,170,244,735,44,270,Michigan,Lansing,48579
9554,1988-1989,1988-11-06,1989-04-10,156,0,75,347,422,69,84,153,575,43,250,Michigan,Lansing,48579
9555,1989-1990,1989-10-19,1990-04-11,175,0,96,396,492,86,203,289,781,41,248,Michigan,Lansing,48579
9556,1990-1991,1990-11-11,1991-04-01,142,0,71,317,388,61,139,200,588,38,226,Michigan,Lansing,48579
9557,1991-1992,1991-10-19,1992-04-14,179,0,61,360,421,88,138,226,647,46,248,Michigan,Lansing,48579
9558,1992-1993,1992-10-20,1993-04-17,180,0,69,350,419,114,209,323,742,61,311,Michigan,Lansing,48579
9559,1993-1994,1993-11-06,1994-05-01,177,0,139,491,630,87,218,305,935,51,385,Michigan,Lansing,48579
9560,1994-1995,1994-11-01,1995-04-09,160,0,74,349,423,81,251,332,755,42,234,Michigan,Lansing,48579
9561,1995-1996,1995-11-03,1996-04-06,156,0,128,491,619,69,137,206,825,46,268,Michigan,Lansing,48579
9562,1998-1999,1998-12-01,1999-03-17,107,0,83,334,417,85,244,329,746,35,296,Michigan,Lansing,48579
9563,2004-2005,2004-11-24,2005-04-24,152,0,85,327,412,110,275,385,797,48,272,Michigan,Lansing,48579
9564,2005-2006,2005-11-16,2006-04-08,144,0,62,255,317,77,159,236,553,47,211,Michigan,Lansing,48579
9565,2006-2007,2006-10-12,2007-04-11,182,0,97,319,416,60,184,244,660,44,248,Michigan,Lansing,48579
9566,2007-2008,2007-11-21,2008-03-28,129,0,90,335,425,105,245,350,775,43,258,Michigan,Lansing,48579
9567,2008-2009,2008-11-09,2009-04-07,150,0,117,395,512,111,312,423,935,57,359,Michigan,Lansing,48579
9568,2009-2010,2009-12-01,2010-03-21,111,0,77,261,338,64,287,351,689,33,177,Michigan,Lansing,48579
9569,2010-2011,2010-11-26,2011-04-18,144,0,110,370,480,82,349,431,911,37,227,Michigan,Lansing,48579
9570,2011-2012,2011-11-10,2012-03-05,117,0,36,182,218,61,86,147,365,29,133,Michigan,Lansing,48579
9571,2012-2013,2012-10-30,2013-04-19,172,0,67,312,379,55,117,172,551,41,194,Michigan,Lansing,48579
9572,2013-2014,2013-11-11,2014-04-15,156,0,184,516,700,106,600,706,1406,52,425,Michigan,Lansing,48579
9573,2014-2015,2014-11-15,2015-03-27,133,0,140,423,563,58,325,383,946,34,248,Michigan,Lansing,48579
9574,2015-2016,2015-11-21,2016-04-10,142,0,53,231,284,80,132,212,496,33,191,Michigan,Lansing,48579
9575,2016-2017,2016-11-20,2017-04-06,138,0,61,223,284,53,97,150,434,31,153,Michigan,Lansing,48579
9576,2017-2018,2017-11-09,2018-04-17,160,0,103,371,474,80,187,267,741,38,235,Michigan,Lansing,48579
9577,2019-2020,2019-10-31,2020-04-17,170,0,42,256,298,73,137,210,508,38,185,Michigan,Lansing,48579
9578,1950-1951,1950-11-09,1951-04-21,164,0,188,479,667,198,1131,1329,1996,69,492,Michigan,Marquette,21355
9579,1951-1952,1951-10-19,1952-04-14,179,0,165,487,652,139,829,968,1620,66,413,Michigan,Marquette,21355
9580,1952-1953,1952-10-19,1953-04-28,192,0,112,350,462,188,778,966,1428,83,448,Michigan,Marquette,21355
9581,1953-1954,1953-11-04,1954-05-09,187,0,132,389,521,140,819,959,1480,75,445,Michigan,Marquette,21355
9582,1954-1955,1954-10-17,1955-04-05,171,0,139,392,531,132,711,843,1374,83,459,Michigan,Marquette,21355
9583,1955-1956,1955-10-24,1956-04-28,188,0,147,454,601,136,990,1126,1727,72,422,Michigan,Marquette,21355
9584,1956-1957,1956-09-19,1957-05-15,239,0,178,521,699,169,938,1107,1806,84,556,Michigan,Marquette,21355
9585,1957-1958,1957-10-24,1958-04-25,184,0,142,381,523,184,771,955,1478,92,551,Michigan,Marquette,21355
9586,1958-1959,1958-09-30,1959-04-28,211,0,232,565,797,158,900,1058,1855,78,598,Michigan,Marquette,21355
9587,1959-1960,1959-10-13,1960-05-10,211,0,149,465,614,274,1079,1353,1967,108,662,Michigan,Marquette,21355
9588,1960-1961,1960-10-19,1961-05-02,196,0,166,440,606,173,722,895,1501,73,485,Michigan,Marquette,21355
9589,1961-1962,1961-11-06,1962-05-08,184,0,201,505,706,174,1128,1302,2008,76,564,Michigan,Marquette,21355
9590,1962-1963,1962-10-23,1963-05-22,212,0,243,603,846,135,820,955,1801,72,553,Michigan,Marquette,21355
9591,1963-1964,1963-11-01,1964-04-14,166,0,132,427,559,149,948,1097,1656,77,487,Michigan,Marquette,21355
9592,1964-1965,1964-10-05,1965-04-23,201,0,208,549,757,164,1164,1328,2085,82,586,Michigan,Marquette,21355
9593,1965-1966,1965-10-28,1966-05-08,193,0,148,410,558,158,714,872,1430,82,458,Michigan,Marquette,21355
9594,1966-1967,1966-10-29,1967-05-11,195,0,169,494,663,203,1120,1323,1986,94,626,Michigan,Marquette,21355
9595,1967-1968,1967-10-27,1968-04-26,183,0,174,480,654,136,638,774,1428,63,445,Michigan,Marquette,21355
9596,1968-1969,1968-10-28,1969-05-11,196,0,141,393,534,180,1110,1290,1824,84,490,Michigan,Marquette,21355
9597,1969-1970,1969-10-21,1970-05-05,197,0,181,500,681,160,1067,1227,1908,80,534,Michigan,Marquette,21355
9598,1970-1971,1970-10-16,1971-05-12,209,0,189,465,654,218,1187,1405,2059,93,643,Michigan,Marquette,21355
9599,1971-1972,1971-11-04,1972-05-05,184,0,200,562,762,196,1269,1465,2227,81,572,Michigan,Marquette,21355
9600,1972-1973,1972-10-17,1973-05-16,212,0,145,406,551,127,843,970,1521,66,390,Michigan,Marquette,21355
9601,1973-1974,1973-11-05,1974-05-06,183,0,196,471,667,143,965,1108,1775,78,491,Michigan,Marquette,21355
9602,1974-1975,1974-09-21,1975-04-20,212,0,125,372,497,192,812,1004,1501,86,478,Michigan,Marquette,21355
9603,1975-1976,1975-10-01,1976-05-05,218,1,166,433,599,222,818,1040,1639,90,625,Michigan,Marquette,21355
9604,1976-1977,1976-10-16,1977-04-27,194,0,241,556,797,201,959,1160,1957,90,633,Michigan,Marquette,21355
9605,1977-1978,1977-11-10,1978-04-20,162,0,178,457,635,177,976,1153,1788,73,518,Michigan,Marquette,21355
9606,1978-1979,1978-10-23,1979-04-23,183,0,294,719,1013,224,1476,1700,2713,82,763,Michigan,Marquette,21355
9607,1979-1980,1979-10-09,1980-05-08,213,0,204,678,882,218,1006,1224,2106,94,733,Michigan,Marquette,21355
9608,1980-1981,1980-09-26,1981-04-25,212,0,214,661,875,252,885,1137,2012,101,829,Michigan,Marquette,21355
9609,1981-1982,1981-10-01,1982-04-25,207,5,239,778,1017,327,1392,1719,2736,98,922,Michigan,Marquette,21355
9610,1982-1983,1982-10-15,1983-04-24,192,0,163,538,701,285,921,1206,1907,83,655,Michigan,Marquette,21355
9611,1983-1984,1983-10-14,1984-05-01,201,6,241,756,997,290,1262,1552,2549,73,748,Michigan,Marquette,21355
9612,1984-1985,1984-11-02,1985-04-19,169,0,219,686,905,322,1011,1333,2238,85,840,Michigan,Marquette,21355
9613,1985-1986,1985-11-03,1986-05-01,180,0,242,717,959,298,1332,1630,2589,90,895,Michigan,Marquette,21355
9614,1986-1987,1986-10-14,1987-05-22,221,0,127,582,709,162,682,844,1553,68,518,Michigan,Marquette,21355
9615,1987-1988,1987-10-02,1988-04-23,205,0,212,697,909,300,1137,1437,2346,92,776,Michigan,Marquette,21355
9616,1988-1989,1988-10-04,1989-05-06,215,0,221,757,978,328,1096,1424,2402,108,906,Michigan,Marquette,21355
9617,1989-1990,1989-09-22,1990-05-13,234,0,196,703,899,341,1132,1473,2372,100,862,Michigan,Marquette,21355
9618,1990-1991,1990-10-18,1991-05-03,198,3,195,642,837,200,551,751,1588,83,674,Michigan,Marquette,21355
9619,1991-1992,1991-10-05,1992-04-24,203,0,174,658,832,293,1390,1683,2515,85,774,Michigan,Marquette,21355
9620,1992-1993,1992-10-15,1993-04-23,191,0,184,655,839,252,1030,1282,2121,95,710,Michigan,Marquette,21355
9621,1993-1994,1993-09-29,1994-05-01,215,0,294,777,1071,223,1067,1290,2361,91,810,Michigan,Marquette,21355
9622,1994-1995,1994-11-19,1995-04-25,158,3,174,507,681,241,611,852,1533,76,634,Michigan,Marquette,21355
9623,1995-1996,1995-10-20,1996-05-11,205,3,284,845,1129,333,1571,1904,3033,107,938,Michigan,Marquette,21355
9624,1996-1997,1996-10-09,1997-05-19,223,0,219,705,924,392,1761,2153,3077,106,973,Michigan,Marquette,21355
9625,1997-1998,1997-10-20,1998-04-18,181,0,147,476,623,258,1162,1420,2043,74,586,Michigan,Marquette,21355
9626,1998-1999,1998-10-21,1999-04-17,179,0,182,538,720,228,1013,1241,1961,71,603,Michigan,Marquette,21355
9627,1999-2000,1999-10-17,2000-04-20,187,0,157,574,731,225,828,1053,1784,82,677,Michigan,Marquette,21355
9628,2000-2001,2000-10-06,2001-04-24,201,0,235,629,864,374,1391,1765,2629,104,987,Michigan,Marquette,21355
9629,2001-2002,2001-10-06,2002-05-24,231,0,146,550,696,449,1183,1632,2328,102,904,Michigan,Marquette,21355
9630,2002-2003,2002-10-13,2003-04-22,192,0,273,787,1060,261,1026,1287,2347,91,836,Michigan,Marquette,21355
9631,2003-2004,2003-09-30,2004-04-29,213,1,196,621,817,313,1208,1521,2338,111,879,Michigan,Marquette,21355
9632,2004-2005,2004-10-04,2005-05-02,211,0,205,660,865,314,1196,1510,2375,98,901,Michigan,Marquette,21355
9633,2005-2006,2005-10-07,2006-05-11,217,0,164,544,708,281,1171,1452,2160,93,698,Michigan,Marquette,21355
9634,2006-2007,2006-10-11,2007-04-21,193,0,209,585,794,330,805,1135,1929,83,817,Michigan,Marquette,21355
9635,2007-2008,2007-10-24,2008-04-21,181,3,227,688,915,292,1257,1549,2464,88,761,Michigan,Marquette,21355
9636,2008-2009,2008-10-27,2009-05-09,195,0,264,723,987,344,1254,1598,2585,96,959,Michigan,Marquette,21355
9637,2009-2010,2009-10-12,2010-05-09,210,0,163,517,680,233,1078,1311,1991,72,582,Michigan,Marquette,21355
9638,2010-2011,2010-11-04,2011-04-28,176,3,226,604,830,224,1019,1243,2073,92,766,Michigan,Marquette,21355
9639,2011-2012,2011-11-09,2012-04-26,170,0,117,430,547,222,873,1095,1642,73,533,Michigan,Marquette,21355
9640,2012-2013,2012-10-06,2013-05-12,219,0,207,619,826,311,1376,1687,2513,114,864,Michigan,Marquette,21355
9641,2013-2014,2013-10-21,2014-05-16,208,0,376,909,1285,291,1372,1663,2948,117,1160,Michigan,Marquette,21355
9642,2014-2015,2014-10-30,2015-05-19,202,0,310,793,1103,263,1366,1629,2732,100,966,Michigan,Marquette,21355
9643,2015-2016,2015-10-17,2016-05-14,211,0,166,500,666,234,862,1096,1762,94,687,Michigan,Marquette,21355
9644,2016-2017,2016-11-19,2017-05-02,165,0,183,511,694,230,762,992,1686,76,631,Michigan,Marquette,21355
9645,2017-2018,2017-10-24,2018-04-30,189,0,266,751,1017,252,1176,1428,2445,96,842,Michigan,Marquette,21355
9646,2018-2019,2018-10-05,2019-05-19,227,1,278,775,1053,338,1479,1817,2870,106,1021,Michigan,Marquette,21355
9647,2019-2020,2019-10-12,2020-05-10,212,0,176,612,788,308,1631,1939,2727,103,757,Michigan,Marquette,21355
9648,1950-1951,1950-11-10,1951-04-16,158,0,104,340,444,124,359,483,927,60,377,Michigan,Muskegon,38401
9649,1951-1952,1951-11-01,1952-04-12,164,0,85,330,415,149,264,413,828,63,380,Michigan,Muskegon,38401
9650,1952-1953,1952-10-17,1953-04-20,186,0,41,247,288,76,72,148,436,42,183,Michigan,Muskegon,38401
9651,1953-1954,1953-11-25,1954-05-05,162,0,45,252,297,128,170,298,595,56,285,Michigan,Muskegon,38401
9652,1954-1955,1954-11-01,1955-03-28,148,0,63,282,345,121,196,317,662,52,282,Michigan,Muskegon,38401
9653,1955-1956,1955-11-03,1956-04-17,167,0,70,339,409,144,199,343,752,71,359,Michigan,Muskegon,38401
9654,1956-1957,1956-11-22,1957-04-06,136,0,68,280,348,97,145,242,590,56,301,Michigan,Muskegon,38401
9655,1957-1958,1957-11-08,1958-03-16,129,0,81,275,356,124,445,569,925,54,340,Michigan,Muskegon,38401
9656,1958-1959,1958-11-21,1959-04-09,140,0,128,410,538,185,685,870,1408,73,534,Michigan,Muskegon,38401
9657,1959-1960,1959-11-06,1960-04-09,156,0,78,322,400,161,443,604,1004,72,383,Michigan,Muskegon,38401
9658,1960-1961,1960-11-09,1961-04-28,171,0,82,312,394,121,210,331,725,50,319,Michigan,Muskegon,38401
9659,1961-1962,1961-11-08,1962-04-15,159,0,117,338,455,211,500,711,1166,66,489,Michigan,Muskegon,38401
9660,1962-1963,1962-10-23,1963-04-30,190,0,152,421,573,229,754,983,1556,77,618,Michigan,Muskegon,38401
9661,1963-1964,1963-11-30,1964-04-08,131,0,65,282,347,187,383,570,917,58,402,Michigan,Muskegon,38401
9662,1964-1965,1964-11-19,1965-04-17,150,0,104,324,428,228,389,617,1045,66,503,Michigan,Muskegon,38401
9663,1965-1966,1965-11-13,1966-04-07,146,0,87,312,399,168,264,432,831,62,434,Michigan,Muskegon,38401
9664,1966-1967,1966-11-01,1967-04-22,173,0,78,316,394,188,429,617,1011,72,432,Michigan,Muskegon,38401
9665,1967-1968,1967-10-27,1968-04-24,181,0,91,302,393,118,249,367,760,57,346,Michigan,Muskegon,38401
9666,1968-1969,1968-11-16,1969-03-31,136,0,86,308,394,164,340,504,898,63,391,Michigan,Muskegon,38401
9667,1969-1970,1969-11-13,1970-04-03,142,0,116,374,490,201,484,685,1175,75,515,Michigan,Muskegon,38401
9668,1970-1971,1970-11-22,1971-04-23,153,0,111,367,478,186,470,656,1134,77,490,Michigan,Muskegon,38401
9669,1971-1972,1971-11-03,1972-04-07,157,0,93,352,445,168,283,451,896,76,450,Michigan,Muskegon,38401
9670,1972-1973,1972-10-18,1973-04-12,177,0,67,266,333,112,226,338,671,52,274,Michigan,Muskegon,38401
9671,1973-1974,1973-11-09,1974-03-31,143,0,108,316,424,149,323,472,896,53,378,Michigan,Muskegon,38401
9672,1974-1975,1974-10-19,1975-04-06,170,0,53,269,322,137,280,417,739,67,310,Michigan,Muskegon,38401
9673,1975-1976,1975-11-24,1976-04-25,154,0,56,259,315,130,422,552,867,65,333,Michigan,Muskegon,38401
9674,1976-1977,1976-11-03,1977-04-07,156,0,166,423,589,196,720,916,1505,80,618,Michigan,Muskegon,38401
9675,1977-1978,1977-11-11,1978-03-31,141,0,142,436,578,229,753,982,1560,66,544,Michigan,Muskegon,38401
9676,1978-1979,1978-11-20,1979-04-28,160,0,178,416,594,183,706,889,1483,75,584,Michigan,Muskegon,38401
9677,1979-1980,1979-11-09,1980-04-24,168,0,95,320,415,109,184,293,708,54,312,Michigan,Muskegon,38401
9678,1980-1981,1980-10-25,1981-03-19,146,0,94,314,408,149,419,568,976,55,403,Michigan,Muskegon,38401
9679,1981-1982,1981-10-19,1982-04-12,176,0,125,408,533,252,617,869,1402,66,568,Michigan,Muskegon,38401
9680,1982-1983,1982-11-04,1983-03-28,145,0,49,209,258,57,85,142,400,33,129,Michigan,Muskegon,38401
9681,1983-1984,1983-11-11,1984-04-22,164,0,131,369,500,146,525,671,1171,71,481,Michigan,Muskegon,38401
9682,1984-1985,1984-12-01,1985-04-09,130,0,97,296,393,171,511,682,1075,55,409,Michigan,Muskegon,38401
9683,1985-1986,1985-11-08,1986-03-20,133,0,95,305,400,157,458,615,1015,62,403,Michigan,Muskegon,38401
9684,1986-1987,1986-11-11,1987-04-04,145,0,35,252,287,92,147,239,526,39,225,Michigan,Muskegon,38401
9685,1987-1988,1987-11-20,1988-03-30,132,0,77,297,374,132,258,390,764,55,358,Michigan,Muskegon,38401
9686,1988-1989,1988-10-25,1989-04-09,167,0,65,307,372,125,204,329,701,51,312,Michigan,Muskegon,38401
9687,1989-1990,1989-10-19,1990-04-12,176,0,79,298,377,192,293,485,862,64,424,Michigan,Muskegon,38401
9688,1990-1991,1990-11-05,1991-04-10,157,0,52,256,308,104,144,248,556,51,289,Michigan,Muskegon,38401
9689,1991-1992,1991-11-02,1992-04-14,165,0,43,259,302,121,192,313,615,49,262,Michigan,Muskegon,38401
9690,1992-1993,1992-10-18,1993-04-17,182,0,61,299,360,145,280,425,785,65,332,Michigan,Muskegon,38401
9691,1993-1994,1993-10-29,1994-03-29,152,0,130,395,525,178,501,679,1204,51,488,Michigan,Muskegon,38401
9692,1994-1995,1994-11-28,1995-04-09,133,0,64,243,307,130,268,398,705,48,292,Michigan,Muskegon,38401
9693,1995-1996,1995-11-04,1996-04-09,158,0,135,426,561,172,337,509,1070,74,519,Michigan,Muskegon,38401
9694,2000-2001,2000-11-16,2001-03-28,133,0,74,289,363,132,342,474,837,44,286,Michigan,Muskegon,38401
9695,2001-2002,2001-12-01,2002-04-04,125,1,36,183,219,78,137,215,434,34,173,Michigan,Muskegon,38401
9696,2002-2003,2002-11-21,2003-04-07,138,0,88,317,405,87,361,448,853,46,280,Michigan,Muskegon,38401
9697,2003-2004,2003-11-24,2004-03-21,119,0,75,248,323,96,391,487,810,42,258,Michigan,Muskegon,38401
9698,2004-2005,2004-11-24,2005-04-24,152,0,79,308,387,132,364,496,883,52,348,Michigan,Muskegon,38401
9699,2005-2006,2005-11-16,2006-03-24,129,0,54,203,257,112,190,302,559,47,251,Michigan,Muskegon,38401
9700,2006-2007,2006-10-23,2007-04-13,173,0,82,248,330,124,405,529,859,51,311,Michigan,Muskegon,38401
9701,2007-2008,2007-11-23,2008-03-28,127,0,80,287,367,152,453,605,972,59,376,Michigan,Muskegon,38401
9702,2008-2009,2008-11-17,2009-03-29,133,0,99,333,432,197,389,586,1018,53,426,Michigan,Muskegon,38401
9703,2009-2010,2009-12-01,2010-03-20,110,0,59,212,271,102,386,488,759,39,215,Michigan,Muskegon,38401
9704,2010-2011,2010-12-01,2011-04-18,139,0,78,279,357,151,493,644,1001,55,341,Michigan,Muskegon,38401
9705,2011-2012,2011-11-10,2012-03-09,121,0,21,132,153,79,102,181,334,29,143,Michigan,Muskegon,38401
9706,2012-2013,2012-11-12,2013-03-22,131,0,56,236,292,142,278,420,712,52,302,Michigan,Muskegon,38401
9707,2013-2014,2013-11-11,2014-04-15,156,0,149,423,572,192,824,1016,1588,72,557,Michigan,Muskegon,38401
9708,2014-2015,2014-11-13,2015-03-28,136,0,112,349,461,133,510,643,1104,45,349,Michigan,Muskegon,38401
9709,2015-2016,2015-11-21,2016-04-08,140,0,43,187,230,90,235,325,555,34,204,Michigan,Muskegon,38401
9710,2016-2017,2016-11-19,2017-03-17,119,0,49,169,218,72,141,213,431,32,177,Michigan,Muskegon,38401
9711,2017-2018,2017-11-10,2018-04-19,161,0,85,299,384,139,331,470,854,48,356,Michigan,Muskegon,38401
9712,2018-2019,2018-11-09,2019-04-15,158,0,79,290,369,110,256,366,735,51,296,Michigan,Muskegon,38401
9713,2019-2020,2019-11-06,2020-03-23,139,0,26,188,214,83,171,254,468,39,171,Michigan,Muskegon,38401
9714,1952-1953,1952-10-20,1953-03-17,149,4,28,212,240,32,23,55,295,17,86,Michigan,Port Huron,30184
9715,1955-1956,1955-11-19,1956-03-25,128,1,65,269,334,43,120,163,497,19,95,Michigan,Port Huron,30184
9716,1956-1957,1956-11-11,1957-03-27,137,0,62,271,333,44,114,158,491,21,96,Michigan,Port Huron,30184
9717,1957-1958,1957-10-26,1958-03-09,135,0,61,244,305,32,30,62,367,16,80,Michigan,Port Huron,30184
9718,1958-1959,1958-11-27,1959-03-29,123,3,98,376,474,59,177,236,710,24,162,Michigan,Port Huron,30184
9719,1959-1960,1959-11-13,1960-03-27,136,6,72,287,359,75,241,316,675,26,148,Michigan,Port Huron,30184
9720,1960-1961,1960-11-07,1961-04-17,162,2,82,311,393,75,254,329,722,15,149,Michigan,Port Huron,30184
9721,1961-1962,1961-12-01,1962-03-06,96,0,93,288,381,37,109,146,527,15,95,Michigan,Port Huron,30184
9722,1962-1963,1962-12-01,1963-03-21,111,0,130,367,497,49,269,318,815,21,143,Michigan,Port Huron,30184
9723,1963-1964,1963-12-01,1964-04-04,126,0,61,283,344,47,121,168,512,20,134,Michigan,Port Huron,30184
9724,1964-1965,1964-11-20,1965-04-17,149,0,87,336,423,125,227,352,775,33,244,Michigan,Port Huron,30184
9725,1965-1966,1965-10-28,1966-03-27,151,1,76,257,333,46,156,202,535,16,98,Michigan,Port Huron,30184
9726,1966-1967,1966-11-29,1967-03-23,115,0,66,302,368,86,335,421,789,28,170,Michigan,Port Huron,30184
9727,1967-1968,1967-11-16,1968-03-26,132,0,82,331,413,67,166,233,646,18,146,Michigan,Port Huron,30184
9728,1968-1969,1968-11-17,1969-03-30,134,0,76,289,365,50,100,150,515,19,114,Michigan,Port Huron,30184
9729,1969-1970,1969-10-23,1970-04-03,163,2,102,385,487,64,209,273,760,28,175,Michigan,Port Huron,30184
9730,1970-1971,1970-11-23,1971-04-03,132,1,95,311,406,65,173,238,644,25,139,Michigan,Port Huron,30184
9731,1971-1972,1971-11-09,1972-04-08,152,1,83,349,432,67,131,198,630,28,169,Michigan,Port Huron,30184
9732,1972-1973,1972-10-19,1973-03-23,156,2,49,243,292,68,151,219,511,24,130,Michigan,Port Huron,30184
9733,1973-1974,1973-12-01,1974-04-08,129,1,88,287,375,68,212,280,655,29,218,Michigan,Port Huron,30184
9734,1977-1978,1977-11-11,1978-03-25,135,17,119,386,505,77,389,466,971,25,179,Michigan,Port Huron,30184
9735,1978-1979,1978-11-26,1979-04-09,135,7,124,378,502,48,230,278,780,20,157,Michigan,Port Huron,30184
9736,1979-1980,1979-11-29,1980-03-21,114,11,77,289,366,33,61,94,460,19,112,Michigan,Port Huron,30184
9737,1980-1981,1980-11-11,1981-03-19,129,12,95,346,441,45,179,224,665,21,150,Michigan,Port Huron,30184
9738,1981-1982,1981-11-21,1982-04-08,139,17,116,397,513,88,389,477,990,26,210,Michigan,Port Huron,30184
9739,1982-1983,1982-11-26,1983-04-18,144,14,42,200,242,21,29,50,292,14,53,Michigan,Port Huron,30184
9740,1983-1984,1983-11-30,1984-03-23,115,13,116,329,445,56,248,304,749,27,150,Michigan,Port Huron,30184
9741,1984-1985,1984-11-12,1985-04-08,148,7,73,317,390,76,218,294,684,28,198,Michigan,Port Huron,30184
9742,1985-1986,1985-11-22,1986-04-22,152,10,96,353,449,65,222,287,736,27,176,Michigan,Port Huron,30184
9743,1986-1987,1986-11-13,1987-04-03,142,6,43,279,322,34,114,148,470,16,70,Michigan,Port Huron,30184
9744,1987-1988,1987-11-21,1988-03-21,122,5,62,345,407,41,103,144,551,17,108,Michigan,Port Huron,30184
9745,1988-1989,1988-12-01,1989-03-22,112,4,65,332,397,36,52,88,485,20,131,Michigan,Port Huron,30184
9746,1989-1990,1989-11-18,1990-04-03,137,1,78,391,469,56,168,224,693,28,191,Michigan,Port Huron,30184
9747,1990-1991,1990-12-01,1991-03-16,106,1,66,307,373,55,154,209,582,22,173,Michigan,Port Huron,30184
9748,1991-1992,1991-11-03,1992-04-02,152,1,57,324,381,70,145,215,596,24,178,Michigan,Port Huron,30184
9749,1992-1993,1992-11-14,1993-04-01,139,20,62,277,339,39,135,174,513,16,91,Michigan,Port Huron,30184
9750,1993-1994,1993-11-07,1994-03-29,143,18,131,384,515,28,131,159,674,15,123,Michigan,Port Huron,30184
9751,1994-1995,1994-12-01,1995-04-05,126,14,57,258,315,25,85,110,425,13,68,Michigan,Port Huron,30184
9752,1997-1998,1997-11-15,1998-03-23,129,1,20,162,182,38,98,136,318,13,63,Michigan,Port Huron,30184
9753,1999-2000,1999-11-30,2000-03-11,103,10,48,193,241,48,126,174,415,15,102,Michigan,Port Huron,30184
9754,2000-2001,2000-11-22,2001-03-26,125,14,83,302,385,80,362,442,827,29,197,Michigan,Port Huron,30184
9755,2001-2002,2001-12-01,2002-04-06,127,4,35,185,220,37,65,102,322,21,95,Michigan,Port Huron,30184
9756,2002-2003,2002-11-24,2003-04-07,135,5,110,366,476,102,203,305,781,36,245,Michigan,Port Huron,30184
9757,2003-2004,2003-12-01,2004-04-03,125,3,82,282,364,68,243,311,675,33,195,Michigan,Port Huron,30184
9758,2004-2005,2004-11-24,2005-04-24,152,19,91,324,415,108,243,351,766,46,298,Michigan,Port Huron,30184
9759,2005-2006,2005-11-17,2006-04-04,139,14,52,231,283,47,109,156,439,24,111,Michigan,Port Huron,30184
9760,2007-2008,2007-12-01,2008-03-27,118,3,62,262,324,106,233,339,663,28,194,Michigan,Port Huron,30184
9761,2008-2009,2008-11-18,2009-03-12,115,1,98,315,413,88,247,335,748,29,227,Michigan,Port Huron,30184
9762,2009-2010,2009-12-01,2010-03-26,116,0,57,201,258,40,136,176,434,16,92,Michigan,Port Huron,30184
9763,2010-2011,2010-12-01,2011-04-18,139,1,100,309,409,94,399,493,902,30,204,Michigan,Port Huron,30184
9764,2011-2012,2011-12-01,2012-03-05,96,0,23,139,162,19,28,47,209,10,58,Michigan,Port Huron,30184
9765,2012-2013,2012-12-01,2013-03-20,110,0,56,206,262,36,113,149,411,17,109,Michigan,Port Huron,30184
9766,2013-2014,2013-11-12,2014-04-15,155,1,163,460,623,87,368,455,1078,36,307,Michigan,Port Huron,30184
9767,2017-2018,2017-11-10,2018-03-17,128,7,98,265,363,68,194,262,625,27,183,Michigan,Port Huron,30184
9768,2018-2019,2018-11-12,2019-03-31,140,4,73,255,328,36,79,115,443,18,103,Michigan,Port Huron,30184
9769,2019-2020,2019-11-11,2020-03-21,132,0,27,149,176,32,55,87,263,11,54,Michigan,Port Huron,30184
9770,1950-1951,1950-11-11,1951-04-18,159,0,115,400,515,72,197,269,784,43,259,Michigan,Saginaw,51508
9771,1951-1952,1951-11-02,1952-04-06,157,3,93,408,501,126,264,390,891,45,300,Michigan,Saginaw,51508
9772,1952-1953,1952-11-27,1953-03-17,111,0,56,233,289,36,55,91,380,24,103,Michigan,Saginaw,51508
9773,1953-1954,1953-11-26,1954-04-03,129,0,70,319,389,79,168,247,636,36,192,Michigan,Saginaw,51508
9774,1954-1955,1954-11-27,1955-03-28,122,3,86,349,435,75,224,299,734,36,194,Michigan,Saginaw,51508
9775,1955-1956,1955-11-02,1956-04-08,159,0,96,391,487,71,161,232,719,44,209,Michigan,Saginaw,51508
9776,1956-1957,1956-11-10,1957-03-27,138,0,97,357,454,63,124,187,641,40,224,Michigan,Saginaw,51508
9777,1957-1958,1957-11-22,1958-03-10,109,0,99,312,411,44,251,295,706,22,135,Michigan,Saginaw,51508
9778,1958-1959,1958-11-24,1959-04-02,130,0,157,485,642,73,414,487,1129,34,243,Michigan,Saginaw,51508
9779,1959-1960,1959-11-12,1960-03-29,139,0,96,355,451,81,368,449,900,39,215,Michigan,Saginaw,51508
9780,1960-1961,1960-11-09,1961-04-16,159,0,119,376,495,51,113,164,659,23,153,Michigan,Saginaw,51508
9781,1961-1962,1961-11-22,1962-04-13,143,0,154,423,577,73,399,472,1049,40,250,Michigan,Saginaw,51508
9782,1962-1963,1962-11-19,1963-04-30,163,0,209,505,714,64,393,457,1171,32,235,Michigan,Saginaw,51508
9783,1963-1964,1963-12-01,1964-04-08,130,0,93,336,429,43,101,144,573,32,164,Michigan,Saginaw,51508
9784,1964-1965,1964-11-19,1965-04-18,151,0,125,402,527,97,246,343,870,37,254,Michigan,Saginaw,51508
9785,1965-1966,1965-11-17,1966-04-07,142,0,91,309,400,60,186,246,646,29,166,Michigan,Saginaw,51508
9786,1966-1967,1966-11-02,1967-04-07,157,0,111,362,473,126,461,587,1060,38,253,Michigan,Saginaw,51508
9787,1967-1968,1967-10-27,1968-04-25,182,3,114,365,479,72,121,193,672,23,176,Michigan,Saginaw,51508
9788,1968-1969,1968-11-19,1969-03-30,132,3,81,299,380,64,193,257,637,31,160,Michigan,Saginaw,51508
9789,1969-1970,1969-11-15,1970-04-06,143,0,143,454,597,73,197,270,867,37,258,Michigan,Saginaw,51508
9790,1970-1971,1970-11-23,1971-04-24,153,0,112,350,462,88,306,394,856,36,196,Michigan,Saginaw,51508
9791,1971-1972,1971-11-09,1972-04-07,151,0,119,359,478,90,227,317,795,35,217,Michigan,Saginaw,51508
9792,1972-1973,1972-11-15,1973-04-11,148,0,106,297,403,92,184,276,679,27,172,Michigan,Saginaw,51508
9793,1973-1974,1973-12-01,1974-04-08,129,3,110,323,433,66,159,225,658,34,208,Michigan,Saginaw,51508
9794,1974-1975,1974-11-14,1975-04-10,148,0,60,281,341,68,116,184,525,26,118,Michigan,Saginaw,51508
9795,1975-1976,1975-11-25,1976-03-18,115,0,101,310,411,86,378,464,875,34,225,Michigan,Saginaw,51508
9796,1976-1977,1976-11-22,1977-03-22,121,0,165,418,583,35,202,237,820,24,148,Michigan,Saginaw,51508
9797,1977-1978,1977-11-13,1978-03-26,134,0,184,505,689,81,459,540,1229,31,256,Michigan,Saginaw,51508
9798,1978-1979,1978-11-20,1979-04-08,140,3,182,452,634,87,436,523,1157,36,247,Michigan,Saginaw,51508
9799,1979-1980,1979-11-09,1980-04-24,168,0,97,346,443,43,37,80,523,21,102,Michigan,Saginaw,51508
9800,1980-1981,1980-11-27,1981-03-19,113,0,122,365,487,62,308,370,857,19,143,Michigan,Saginaw,51508
9801,1981-1982,1981-11-20,1982-04-11,143,0,154,426,580,70,273,343,923,28,226,Michigan,Saginaw,51508
9802,1982-1983,1982-11-14,1983-04-17,155,0,61,256,317,35,65,100,417,13,68,Michigan,Saginaw,51508
9803,1983-1984,1983-11-11,1984-03-22,133,3,144,399,543,41,198,239,782,20,111,Michigan,Saginaw,51508
9804,1984-1985,1984-11-11,1985-04-17,158,0,110,356,466,98,405,503,969,30,251,Michigan,Saginaw,51508
9805,1985-1986,1985-11-09,1986-03-20,132,3,130,365,495,76,223,299,794,30,185,Michigan,Saginaw,51508
9806,1986-1987,1986-11-13,1987-03-14,122,0,58,262,320,39,110,149,469,15,78,Michigan,Saginaw,51508
9807,1987-1988,1987-11-20,1988-03-21,123,0,99,334,433,58,121,179,612,26,157,Michigan,Saginaw,51508
9808,1988-1989,1988-12-01,1989-03-25,115,6,97,327,424,68,97,165,589,19,153,Michigan,Saginaw,51508
9809,1989-1990,1989-10-19,1990-04-06,170,9,104,373,477,69,160,229,706,27,180,Michigan,Saginaw,51508
9810,1990-1991,1990-12-01,1991-03-29,119,0,85,274,359,52,126,178,537,20,126,Michigan,Saginaw,51508
9811,1991-1992,1991-11-02,1992-04-02,153,3,75,323,398,73,110,183,581,29,186,Michigan,Saginaw,51508
9812,1992-1993,1992-10-20,1993-04-11,174,0,84,332,416,72,161,233,649,34,172,Michigan,Saginaw,51508
9813,1993-1994,1993-11-06,1994-05-01,177,6,168,468,636,48,189,237,873,31,221,Michigan,Saginaw,51508
9814,1994-1995,1994-12-01,1995-04-08,129,0,84,292,376,42,155,197,573,23,116,Michigan,Saginaw,51508
9815,1995-1996,1995-11-09,1996-04-09,153,0,132,466,598,99,308,407,1005,48,298,Michigan,Saginaw,51508
9816,1996-1997,1996-11-02,1997-04-13,163,0,87,342,429,116,274,390,819,62,310,Michigan,Saginaw,51508
9817,1997-1998,1997-10-27,1998-03-21,146,0,32,224,256,60,151,211,467,32,128,Michigan,Saginaw,51508
9818,1998-1999,1998-12-01,1999-03-16,106,0,84,289,373,81,229,310,683,36,251,Michigan,Saginaw,51508
9819,1999-2000,1999-12-01,2000-04-11,133,0,74,316,390,72,247,319,709,37,217,Michigan,Saginaw,51508
9820,2000-2001,2000-11-14,2001-04-17,155,4,102,368,470,102,428,530,1000,54,338,Michigan,Saginaw,51508
9821,2002-2003,2002-11-21,2003-04-09,140,13,131,437,568,73,91,164,732,49,308,Michigan,Saginaw,51508
9822,2011-2012,2011-11-29,2012-03-30,123,3,31,183,214,72,93,165,379,34,159,Michigan,Saginaw,51508
9823,2012-2013,2012-10-30,2013-04-24,177,6,66,300,366,72,174,246,612,39,194,Michigan,Saginaw,51508
9824,2013-2014,2013-11-23,2014-04-16,145,5,191,521,712,97,686,783,1495,52,395,Michigan,Saginaw,51508
9825,2014-2015,2014-11-15,2015-04-22,159,1,134,426,560,61,359,420,980,36,247,Michigan,Saginaw,51508
9826,2015-2016,2015-11-21,2016-04-10,142,3,50,213,263,79,155,234,497,31,177,Michigan,Saginaw,51508
9827,2016-2017,2016-10-26,2017-03-22,148,3,69,244,313,55,103,158,471,27,147,Michigan,Saginaw,51508
9828,2017-2018,2017-11-10,2018-04-17,159,9,110,377,487,64,199,263,750,35,219,Michigan,Saginaw,51508
9829,2018-2019,2018-11-09,2019-04-15,158,7,103,344,447,76,137,213,660,40,223,Michigan,Saginaw,51508
9830,2019-2020,2019-11-06,2020-04-21,168,4,39,247,286,56,123,179,465,27,125,Michigan,Saginaw,51508
9831,1950-1951,1950-10-22,1951-04-21,182,0,201,568,769,171,998,1169,1938,82,558,Michigan,Sault Ste Marie,0
9832,1951-1952,1951-10-28,1952-04-14,170,0,189,596,785,159,636,795,1580,77,557,Michigan,Sault Ste Marie,0
9833,1952-1953,1952-10-16,1953-04-27,194,0,138,446,584,169,690,859,1443,83,473,Michigan,Sault Ste Marie,0
9834,1953-1954,1953-11-03,1954-05-07,186,0,169,549,718,109,613,722,1440,72,480,Michigan,Sault Ste Marie,0
9835,1954-1955,1954-11-21,1955-04-07,138,0,184,532,716,120,636,756,1472,66,467,Michigan,Sault Ste Marie,0
9836,1955-1956,1955-10-24,1956-04-29,189,0,193,633,826,165,1135,1300,2126,83,532,Michigan,Sault Ste Marie,0
9837,1956-1957,1956-09-20,1957-04-16,209,1,207,680,887,153,912,1065,1952,82,612,Michigan,Sault Ste Marie,0
9838,1957-1958,1957-10-25,1958-04-08,166,0,178,494,672,119,788,907,1579,68,404,Michigan,Sault Ste Marie,0
9839,1958-1959,1958-11-06,1959-04-13,159,0,268,721,989,150,1213,1363,2352,71,619,Michigan,Sault Ste Marie,0
9840,1959-1960,1959-10-18,1960-04-27,193,0,197,580,777,141,806,947,1724,83,512,Michigan,Sault Ste Marie,0
9841,1960-1961,1960-10-20,1961-05-02,195,0,201,593,794,120,709,829,1623,82,556,Michigan,Sault Ste Marie,0
9842,1961-1962,1961-09-28,1962-05-08,223,0,233,638,871,173,1001,1174,2045,83,645,Michigan,Sault Ste Marie,0
9843,1962-1963,1962-10-23,1963-05-22,212,0,282,740,1022,141,859,1000,2022,73,696,Michigan,Sault Ste Marie,0
9844,1963-1964,1963-11-01,1964-04-16,168,0,169,565,734,204,993,1197,1931,85,618,Michigan,Sault Ste Marie,0
9845,1964-1965,1964-09-27,1965-04-23,209,0,234,684,918,237,998,1235,2153,93,731,Michigan,Sault Ste Marie,0
9846,1965-1966,1965-09-25,1966-05-28,246,0,172,528,700,179,469,648,1348,102,604,Michigan,Sault Ste Marie,0
9847,1966-1967,1966-10-11,1967-05-11,213,0,223,695,918,164,857,1021,1939,90,662,Michigan,Sault Ste Marie,0
9848,1967-1968,1967-10-26,1968-04-26,184,0,213,641,854,181,859,1040,1894,87,682,Michigan,Sault Ste Marie,0
9849,1968-1969,1968-10-25,1969-04-04,162,0,179,580,759,165,752,917,1676,79,583,Michigan,Sault Ste Marie,0
9850,1969-1970,1969-10-21,1970-05-05,197,0,242,731,973,167,976,1143,2116,82,609,Michigan,Sault Ste Marie,0
9851,1970-1971,1970-10-15,1971-05-12,210,0,256,706,962,210,1113,1323,2285,88,785,Michigan,Sault Ste Marie,0
9852,1971-1972,1971-11-03,1972-04-26,176,0,229,677,906,250,1251,1501,2407,101,844,Michigan,Sault Ste Marie,0
9853,1972-1973,1972-10-14,1973-05-17,216,0,163,506,669,146,707,853,1522,77,467,Michigan,Sault Ste Marie,0
9854,1973-1974,1973-10-16,1974-05-05,202,0,234,651,885,168,951,1119,2004,83,574,Michigan,Sault Ste Marie,0
9855,1974-1975,1974-10-01,1975-04-19,201,0,165,607,772,185,1096,1281,2053,79,586,Michigan,Sault Ste Marie,0
9856,1975-1976,1975-11-12,1976-05-05,176,0,204,648,852,205,936,1141,1993,96,801,Michigan,Sault Ste Marie,0
9857,1976-1977,1976-10-16,1977-04-12,179,3,288,752,1040,258,1271,1529,2569,115,965,Michigan,Sault Ste Marie,0
9858,1977-1978,1977-11-10,1978-04-18,160,3,230,680,910,186,1112,1298,2208,85,662,Michigan,Sault Ste Marie,0
9859,1978-1979,1978-11-12,1979-05-05,175,3,289,711,1000,228,1207,1435,2435,86,830,Michigan,Sault Ste Marie,0
9860,1979-1980,1979-10-10,1980-04-23,197,0,192,612,804,167,723,890,1694,80,566,Michigan,Sault Ste Marie,0
9861,1980-1981,1980-10-12,1981-04-23,194,0,232,737,969,208,947,1155,2124,80,750,Michigan,Sault Ste Marie,0
9862,1981-1982,1981-10-01,1982-04-26,208,0,249,801,1050,242,1153,1395,2445,91,784,Michigan,Sault Ste Marie,0
9863,1982-1983,1982-11-05,1983-04-17,164,0,146,515,661,136,510,646,1307,67,437,Michigan,Sault Ste Marie,0
9864,1983-1984,1983-11-10,1984-05-01,174,0,252,681,933,159,913,1072,2005,77,701,Michigan,Sault Ste Marie,0
9865,1984-1985,1984-09-26,1985-04-19,206,0,208,644,852,224,964,1188,2040,83,683,Michigan,Sault Ste Marie,0
9866,1985-1986,1985-10-16,1986-05-01,198,0,222,655,877,222,1188,1410,2287,87,753,Michigan,Sault Ste Marie,0
9867,1986-1987,1986-11-09,1987-04-03,146,0,112,443,555,145,797,942,1497,61,454,Michigan,Sault Ste Marie,0
9868,1987-1988,1987-10-10,1988-04-23,197,0,195,619,814,204,907,1111,1925,84,641,Michigan,Sault Ste Marie,0
9869,1988-1989,1988-10-25,1989-04-14,172,0,193,622,815,211,1012,1223,2038,104,744,Michigan,Sault Ste Marie,0
9870,1989-1990,1989-09-23,1990-05-11,231,0,194,664,858,232,1260,1492,2350,98,673,Michigan,Sault Ste Marie,0
9871,1990-1991,1990-10-18,1991-04-16,181,0,155,550,705,165,731,896,1601,81,578,Michigan,Sault Ste Marie,0
9872,1991-1992,1991-09-26,1992-05-01,219,0,180,609,789,175,1039,1214,2003,78,559,Michigan,Sault Ste Marie,0
9873,1992-1993,1992-10-13,1993-04-20,190,0,162,598,760,154,785,939,1699,72,478,Michigan,Sault Ste Marie,0
9874,1993-1994,1993-10-02,1994-04-17,198,0,290,771,1061,167,915,1082,2143,86,706,Michigan,Sault Ste Marie,0
9875,1994-1995,1994-11-22,1995-04-25,155,0,148,479,627,146,564,710,1337,65,494,Michigan,Sault Ste Marie,0
9876,1995-1996,1995-10-29,1996-05-01,186,0,271,773,1044,322,1513,1835,2879,99,905,Michigan,Sault Ste Marie,0
9877,1998-1999,1998-11-07,1999-04-07,152,2,155,457,612,136,860,996,1608,63,481,Michigan,Sault Ste Marie,0
9878,1999-2000,1999-11-16,2000-04-17,154,0,136,450,586,164,667,831,1417,71,526,Michigan,Sault Ste Marie,0
9879,2000-2001,2000-11-14,2001-04-25,163,0,200,559,759,166,1120,1286,2045,89,665,Michigan,Sault Ste Marie,0
9880,2001-2002,2001-10-26,2002-05-11,198,0,96,417,513,184,815,999,1512,82,504,Michigan,Sault Ste Marie,0
9881,2002-2003,2002-10-14,2003-04-15,184,0,205,620,825,178,1000,1178,2003,84,664,Michigan,Sault Ste Marie,0
9882,2003-2004,2003-10-02,2004-04-27,209,0,181,536,717,187,1058,1245,1962,87,626,Michigan,Sault Ste Marie,0
9883,2004-2005,2004-11-07,2005-05-01,176,18,192,573,765,125,864,989,1754,64,478,Michigan,Sault Ste Marie,0
9884,2005-2006,2005-11-06,2006-04-04,150,0,144,428,572,167,904,1071,1643,74,493,Michigan,Sault Ste Marie,0
9885,2006-2007,2006-10-13,2007-04-14,184,0,171,511,682,166,680,846,1528,76,632,Michigan,Sault Ste Marie,0
9886,2007-2008,2007-10-27,2008-04-15,172,2,167,534,701,210,1005,1215,1916,88,631,Michigan,Sault Ste Marie,0
9887,2008-2009,2008-10-28,2009-05-16,201,0,219,602,821,187,1130,1317,2138,84,683,Michigan,Sault Ste Marie,0
9888,2009-2010,2009-10-12,2010-05-08,209,0,124,415,539,124,626,750,1289,56,354,Michigan,Sault Ste Marie,0
9889,2010-2011,2010-10-21,2011-04-21,183,0,189,559,748,128,717,845,1593,68,441,Michigan,Sault Ste Marie,0
9890,2011-2012,2011-11-10,2012-04-17,160,0,80,341,421,127,512,639,1060,59,343,Michigan,Sault Ste Marie,0
9891,2012-2013,2012-10-10,2013-05-13,216,0,154,494,648,244,1130,1374,2022,98,669,Michigan,Sault Ste Marie,0
9892,2013-2014,2013-10-22,2014-04-26,187,2,323,785,1108,207,1249,1456,2564,109,947,Michigan,Sault Ste Marie,0
9893,2014-2015,2014-11-07,2015-04-23,168,2,244,704,948,234,1335,1569,2517,87,734,Michigan,Sault Ste Marie,0
9894,2015-2016,2015-10-16,2016-05-15,213,0,109,382,491,150,574,724,1215,82,479,Michigan,Sault Ste Marie,0
9895,2016-2017,2016-11-19,2017-04-27,160,0,115,370,485,194,891,1085,1570,79,533,Michigan,Sault Ste Marie,0
9896,2017-2018,2017-10-31,2018-04-26,178,0,189,579,768,185,1105,1290,2058,83,582,Michigan,Sault Ste Marie,0
9897,2018-2019,2018-10-12,2019-05-01,202,0,198,577,775,225,1351,1576,2351,100,709,Michigan,Sault Ste Marie,0
9898,2019-2020,2019-11-01,2020-05-09,191,0,105,436,541,213,1041,1254,1795,96,570,Michigan,Sault Ste Marie,0
9899,1950-1951,1950-11-09,1951-04-09,152,13,255,788,1043,101,826,927,1970,26,285,Minnesota,Austin,790390
9900,1951-1952,1951-11-01,1952-04-13,165,3,161,619,780,93,493,586,1366,34,272,Minnesota,Austin,790390
9901,1952-1953,1952-11-24,1953-04-15,143,1,122,499,621,52,476,528,1149,28,182,Minnesota,Austin,790390
9902,1953-1954,1953-11-22,1954-05-03,163,0,103,466,569,40,63,103,672,25,154,Minnesota,Austin,790390
9903,1954-1955,1954-11-01,1955-03-28,148,13,150,544,694,44,312,356,1050,26,189,Minnesota,Austin,790390
9904,1955-1956,1955-10-29,1956-04-29,184,15,205,802,1007,71,611,682,1689,28,238,Minnesota,Austin,790390
9905,1956-1957,1956-11-15,1957-04-05,142,5,126,529,655,40,111,151,806,23,154,Minnesota,Austin,790390
9906,1957-1958,1957-11-16,1958-03-20,125,1,139,456,595,37,211,248,843,18,108,Minnesota,Austin,790390
9907,1958-1959,1958-11-24,1959-03-27,124,7,208,669,877,76,464,540,1417,22,237,Minnesota,Austin,790390
9908,1959-1960,1959-11-05,1960-03-25,142,5,163,585,748,47,232,279,1027,21,163,Minnesota,Austin,790390
9909,1960-1961,1960-11-29,1961-04-17,140,0,128,521,649,63,243,306,955,21,175,Minnesota,Austin,790390
9910,1961-1962,1961-09-30,1962-04-17,200,6,223,677,900,112,721,833,1733,34,286,Minnesota,Austin,790390
9911,1962-1963,1962-11-17,1963-03-20,124,11,228,633,861,45,218,263,1124,21,218,Minnesota,Austin,790390
9912,1963-1964,1963-11-23,1964-03-31,130,0,143,525,668,47,140,187,855,25,172,Minnesota,Austin,790390
9913,1964-1965,1964-11-19,1965-04-05,138,7,239,703,942,84,441,525,1467,33,304,Minnesota,Austin,790390
9914,1965-1966,1965-11-18,1966-04-11,145,0,184,539,723,43,219,262,985,15,138,Minnesota,Austin,790390
9915,1966-1967,1966-11-02,1967-03-20,139,1,149,545,694,59,326,385,1079,19,177,Minnesota,Austin,790390
9916,1971-1972,1971-11-07,1972-04-08,154,1,238,666,904,64,405,469,1373,22,200,Minnesota,Austin,790390
9917,1973-1974,1973-11-05,1974-04-14,161,6,179,523,702,38,307,345,1047,16,114,Minnesota,Austin,790390
9918,1976-1977,1976-10-24,1977-04-04,163,19,223,709,932,29,189,218,1150,14,123,Minnesota,Austin,790390
9919,1977-1978,1977-11-21,1978-04-20,151,14,253,680,933,40,590,630,1563,17,149,Minnesota,Austin,790390
9920,1985-1986,1985-11-09,1986-03-20,132,5,222,584,806,64,840,904,1710,16,148,Minnesota,Austin,790390
9921,1986-1987,1986-11-09,1987-03-29,141,9,75,320,395,27,58,85,480,8,52,Minnesota,Austin,790390
9922,1987-1988,1987-12-01,1988-04-27,149,8,156,477,633,71,432,503,1136,18,144,Minnesota,Austin,790390
9923,1993-1994,1993-10-29,1994-04-05,159,9,277,686,963,78,563,641,1604,30,330,Minnesota,Austin,790390
9924,1999-2000,1999-10-01,2000-04-07,190,19,109,489,598,58,132,190,788,22,191,Minnesota,Austin,790390
9925,2000-2001,2000-11-08,2001-04-16,160,5,279,741,1020,98,834,932,1952,38,350,Minnesota,Austin,790390
9926,2001-2002,2001-10-24,2002-04-21,180,1,107,414,521,43,124,167,688,21,147,Minnesota,Austin,790390
9927,2002-2003,2002-10-24,2003-04-09,168,14,173,606,779,58,151,209,988,25,188,Minnesota,Austin,790390
9928,2006-2007,2006-10-12,2007-04-13,184,6,184,574,758,99,429,528,1286,23,243,Minnesota,Austin,790390
9929,2007-2008,2007-11-22,2008-03-24,124,16,229,596,825,43,423,466,1291,26,226,Minnesota,Austin,790390
9930,2008-2009,2008-11-07,2009-04-05,150,8,232,663,895,66,354,420,1315,27,265,Minnesota,Austin,790390
9931,2009-2010,2009-10-13,2010-03-14,153,3,213,567,780,59,550,609,1389,25,219,Minnesota,Austin,790390
9932,2010-2011,2010-11-13,2011-04-20,159,6,236,635,871,77,569,646,1517,29,243,Minnesota,Austin,790390
9933,2011-2012,2011-11-21,2012-03-06,107,2,83,341,424,28,102,130,554,16,116,Minnesota,Austin,790390
9934,2012-2013,2012-11-13,2013-05-05,174,5,174,552,726,72,316,388,1114,30,184,Minnesota,Austin,790390
9935,2013-2014,2013-11-11,2014-04-30,171,0,320,794,1114,88,553,641,1755,41,428,Minnesota,Austin,790390
9936,2014-2015,2014-11-11,2015-03-28,138,0,232,591,823,49,316,365,1188,23,180,Minnesota,Austin,790390
9937,2015-2016,2015-11-21,2016-03-26,127,0,131,376,507,52,319,371,878,17,109,Minnesota,Austin,790390
9938,2016-2017,2016-11-20,2017-03-19,120,0,132,393,525,69,266,335,860,14,128,Minnesota,Austin,790390
9939,2017-2018,2017-11-01,2018-04-21,172,4,235,618,853,78,316,394,1247,24,232,Minnesota,Austin,790390
9940,2018-2019,2018-11-08,2019-04-14,158,2,258,621,879,96,493,589,1468,27,292,Minnesota,Austin,790390
9941,2019-2020,2019-10-31,2020-04-17,170,10,142,502,644,54,427,481,1125,16,126,Minnesota,Austin,790390
9942,1950-1951,1950-11-09,1951-04-13,156,8,231,767,998,100,591,691,1689,23,306,Minnesota,Canby,1795
9943,1951-1952,1951-10-22,1952-04-06,168,3,207,672,879,98,533,631,1510,27,267,Minnesota,Canby,1795
9944,1952-1953,1952-11-24,1953-04-03,131,1,127,474,601,70,442,512,1113,19,197,Minnesota,Canby,1795
9945,1953-1954,1953-11-21,1954-05-03,164,2,141,509,650,60,359,419,1069,16,130,Minnesota,Canby,1795
9946,1954-1955,1954-11-29,1955-03-26,118,5,135,509,644,32,209,241,885,10,102,Minnesota,Canby,1795
9947,1955-1956,1955-11-07,1956-04-08,154,3,254,729,983,51,514,565,1548,18,192,Minnesota,Canby,1795
9948,1956-1957,1956-11-15,1957-04-11,148,3,156,572,728,54,158,212,940,12,141,Minnesota,Canby,1795
9949,1957-1958,1957-10-25,1958-04-06,164,1,132,493,625,35,165,200,825,12,80,Minnesota,Canby,1795
9950,1958-1959,1958-11-18,1959-04-12,146,0,191,649,840,39,137,176,1016,13,134,Minnesota,Canby,1795
9951,1959-1960,1959-10-12,1960-04-06,178,2,197,641,838,64,504,568,1406,13,132,Minnesota,Canby,1795
9952,1960-1961,1960-11-09,1961-04-17,160,0,125,539,664,30,112,142,806,10,80,Minnesota,Canby,1795
9953,1961-1962,1961-11-03,1962-04-12,161,0,224,691,915,88,505,593,1508,23,231,Minnesota,Canby,1795
9954,1962-1963,1962-11-17,1963-04-23,158,1,170,568,738,36,194,230,968,12,114,Minnesota,Canby,1795
9955,1963-1964,1963-11-24,1964-03-31,129,0,150,532,682,33,213,246,928,8,87,Minnesota,Canby,1795
9956,1964-1965,1964-11-19,1965-04-24,157,6,256,751,1007,89,589,678,1685,24,275,Minnesota,Canby,1795
9957,1965-1966,1965-11-13,1966-04-28,167,2,204,611,815,58,232,290,1105,15,157,Minnesota,Canby,1795
9958,1966-1967,1966-11-02,1967-04-17,167,6,162,628,790,58,371,429,1219,17,221,Minnesota,Canby,1795
9959,1967-1968,1967-11-04,1968-04-14,163,0,155,570,725,24,91,115,840,9,55,Minnesota,Canby,1795
9960,1969-1970,1969-10-13,1970-04-23,193,0,194,653,847,68,508,576,1423,18,153,Minnesota,Canby,1795
9961,1970-1971,1970-10-09,1971-03-23,166,4,205,608,813,50,289,339,1152,22,163,Minnesota,Canby,1795
9962,1971-1972,1971-10-29,1972-04-22,177,0,218,666,884,57,509,566,1450,30,216,Minnesota,Canby,1795
9963,1972-1973,1972-11-12,1973-02-28,109,0,166,462,628,26,262,288,916,11,108,Minnesota,Canby,1795
9964,1973-1974,1973-11-04,1974-03-26,143,0,198,568,766,40,321,361,1127,13,134,Minnesota,Canby,1795
9965,1974-1975,1974-11-13,1975-03-31,139,0,155,568,723,78,540,618,1341,23,221,Minnesota,Canby,1795
9966,1975-1976,1975-11-12,1976-03-21,131,1,153,535,688,79,685,764,1452,18,195,Minnesota,Canby,1795
9967,1976-1977,1976-10-18,1977-03-13,147,0,221,651,872,55,316,371,1243,18,176,Minnesota,Canby,1795
9968,1977-1978,1977-12-01,1978-04-20,141,0,275,652,927,57,653,710,1637,25,216,Minnesota,Canby,1795
9969,1978-1979,1978-11-12,1979-04-12,152,1,311,806,1117,100,871,971,2088,31,338,Minnesota,Canby,1795
9970,1979-1980,1979-10-22,1980-03-28,159,6,136,566,702,44,218,262,964,23,152,Minnesota,Canby,1795
9971,1980-1981,1980-11-14,1981-03-06,113,0,124,455,579,17,60,77,656,10,98,Minnesota,Canby,1795
9972,1981-1982,1981-11-19,1982-04-20,153,4,261,673,934,97,711,808,1742,29,310,Minnesota,Canby,1795
9973,1982-1983,1982-10-20,1983-04-16,179,4,122,491,613,89,425,514,1127,22,147,Minnesota,Canby,1795
9974,1983-1984,1983-11-09,1984-03-30,143,5,259,607,866,97,716,813,1679,26,236,Minnesota,Canby,1795
9975,1984-1985,1984-10-31,1985-03-31,152,7,208,587,795,56,246,302,1097,16,158,Minnesota,Canby,1795
9976,1985-1986,1985-11-09,1986-03-23,135,2,253,639,892,76,735,811,1703,24,247,Minnesota,Canby,1795
9977,1986-1987,1986-11-09,1987-03-30,142,0,72,414,486,24,60,84,570,9,51,Minnesota,Canby,1795
9978,1987-1988,1987-11-21,1988-04-27,159,5,188,581,769,62,530,592,1361,18,172,Minnesota,Canby,1795
9979,1988-1989,1988-11-12,1989-04-09,149,2,192,633,825,75,380,455,1280,22,229,Minnesota,Canby,1795
9980,1989-1990,1989-11-01,1990-03-24,144,0,147,547,694,45,128,173,867,15,120,Minnesota,Canby,1795
9981,1990-1991,1990-10-18,1991-03-30,164,1,169,545,714,48,251,299,1013,19,123,Minnesota,Canby,1795
9982,1991-1992,1991-10-30,1992-04-22,176,0,97,469,566,47,215,262,828,15,125,Minnesota,Canby,1795
9983,1992-1993,1992-10-16,1993-04-14,181,0,215,613,828,72,554,626,1454,26,186,Minnesota,Canby,1795
9984,1993-1994,1993-10-30,1994-05-01,184,4,277,662,939,92,630,722,1661,35,381,Minnesota,Canby,1795
9985,1994-1995,1994-11-28,1995-04-19,143,2,141,435,576,62,144,206,782,20,133,Minnesota,Canby,1795
9986,1995-1996,1995-10-24,1996-04-15,175,7,283,711,994,98,479,577,1571,27,303,Minnesota,Canby,1795
9987,1996-1997,1996-10-31,1997-04-12,164,2,286,702,988,105,980,1085,2073,32,343,Minnesota,Canby,1795
9988,1997-1998,1997-11-03,1998-04-05,154,1,126,423,549,67,286,353,902,27,168,Minnesota,Canby,1795
9989,1998-1999,1998-11-06,1999-04-06,152,2,132,460,592,62,298,360,952,22,216,Minnesota,Canby,1795
9990,1999-2000,1999-12-01,2000-04-17,139,2,88,429,517,38,174,212,729,19,137,Minnesota,Canby,1795
9991,2000-2001,2000-11-09,2001-04-06,149,3,240,690,930,90,931,1021,1951,30,259,Minnesota,Canby,1795
9992,2001-2002,2001-11-26,2002-04-28,154,4,119,443,562,79,385,464,1026,21,169,Minnesota,Canby,1795
9993,2002-2003,2002-10-16,2003-04-05,172,6,155,585,740,42,162,204,944,15,113,Minnesota,Canby,1795
9994,2003-2004,2003-11-04,2004-03-17,135,2,162,499,661,57,300,357,1018,20,198,Minnesota,Canby,1795
9995,2004-2005,2004-12-01,2005-03-21,111,3,125,444,569,23,77,100,669,16,127,Minnesota,Canby,1795
9996,2005-2006,2005-11-17,2006-03-22,126,4,139,414,553,43,208,251,804,16,121,Minnesota,Canby,1795
9997,2007-2008,2007-11-22,2008-04-28,159,0,220,649,869,72,328,400,1269,20,164,Minnesota,Canby,1795
9998,2010-2011,2010-11-21,2011-04-16,147,8,274,662,936,130,829,959,1895,34,376,Minnesota,Canby,1795
9999,2011-2012,2011-11-20,2012-03-08,110,1,75,341,416,30,84,114,530,11,84,Minnesota,Canby,1795
10000,2012-2013,2012-10-25,2013-04-27,185,3,206,682,888,120,757,877,1765,28,251,Minnesota,Canby,1795
10001,2013-2014,2013-11-05,2014-04-17,164,0,283,791,1074,81,325,406,1480,28,292,Minnesota,Canby,1795
10002,2014-2015,2014-11-10,2015-03-23,134,0,213,562,775,39,190,229,1004,16,135,Minnesota,Canby,1795
10003,2015-2016,2015-11-20,2016-03-24,126,5,139,375,514,58,309,367,881,18,149,Minnesota,Canby,1795
10004,2016-2017,2016-11-18,2017-05-01,165,2,156,465,621,64,257,321,942,11,138,Minnesota,Canby,1795
10005,2017-2018,2017-10-28,2018-04-23,178,4,203,637,840,119,344,463,1303,20,239,Minnesota,Canby,1795
10006,2018-2019,2018-11-07,2019-04-17,162,1,282,676,958,129,760,889,1847,31,408,Minnesota,Canby,1795
10007,2019-2020,2019-11-07,2020-04-04,150,0,158,479,637,72,585,657,1294,17,143,Minnesota,Canby,1795
10008,1950-1951,1950-10-22,1951-05-05,196,0,365,876,1241,161,1271,1432,2673,65,558,Minnesota,Duluth,86265
10009,1951-1952,1951-10-22,1952-04-15,177,0,286,814,1100,122,1044,1166,2266,62,522,Minnesota,Duluth,86265
10010,1952-1953,1952-10-15,1953-04-28,196,0,209,666,875,115,740,855,1730,58,459,Minnesota,Duluth,86265
10011,1953-1954,1953-11-04,1954-05-08,186,0,233,740,973,125,932,1057,2030,62,514,Minnesota,Duluth,86265
10012,1954-1955,1954-10-29,1955-04-07,161,0,253,719,972,137,871,1008,1980,62,504,Minnesota,Duluth,86265
10013,1955-1956,1955-10-28,1956-05-10,196,0,290,893,1183,160,1443,1603,2786,70,549,Minnesota,Duluth,86265
10014,1956-1957,1956-11-07,1957-04-16,161,0,301,834,1135,135,1005,1140,2275,69,614,Minnesota,Duluth,86265
10015,1957-1958,1957-10-24,1958-04-29,188,0,226,660,886,80,664,744,1630,45,297,Minnesota,Duluth,86265
10016,1958-1959,1958-10-10,1959-04-18,191,0,346,858,1204,76,647,723,1927,51,449,Minnesota,Duluth,86265
10017,1959-1960,1959-10-11,1960-04-29,202,0,242,795,1037,121,858,979,2016,68,530,Minnesota,Duluth,86265
10018,1960-1961,1960-11-02,1961-05-10,190,0,227,678,905,112,603,715,1620,55,368,Minnesota,Duluth,86265
10019,1961-1962,1961-11-03,1962-05-08,187,0,340,805,1145,107,922,1029,2174,60,537,Minnesota,Duluth,86265
10020,1962-1963,1962-10-24,1963-05-19,208,0,326,804,1130,94,545,639,1769,63,564,Minnesota,Duluth,86265
10021,1963-1964,1963-11-23,1964-04-14,144,0,224,663,887,91,673,764,1651,48,384,Minnesota,Duluth,86265
10022,1964-1965,1964-11-18,1965-05-28,192,0,344,946,1290,164,1285,1449,2739,58,572,Minnesota,Duluth,86265
10023,1965-1966,1965-11-09,1966-05-13,186,0,278,761,1039,140,1104,1244,2283,67,509,Minnesota,Duluth,86265
10024,1966-1967,1966-10-15,1967-05-10,208,0,281,860,1141,130,1034,1164,2305,63,517,Minnesota,Duluth,86265
10025,1967-1968,1967-10-09,1968-05-18,223,0,258,773,1031,71,365,436,1467,49,318,Minnesota,Duluth,86265
10026,1968-1969,1968-11-06,1969-04-29,175,0,274,736,1010,182,1325,1507,2517,65,588,Minnesota,Duluth,86265
10027,1969-1970,1969-10-12,1970-05-01,202,0,305,844,1149,150,1060,1210,2359,71,586,Minnesota,Duluth,86265
10028,1970-1971,1970-10-10,1971-05-19,222,0,318,836,1154,177,1109,1286,2440,68,619,Minnesota,Duluth,86265
10029,1971-1972,1971-10-28,1972-04-26,182,0,380,893,1273,166,1136,1302,2575,71,650,Minnesota,Duluth,86265
10030,1972-1973,1972-10-17,1973-05-02,198,0,288,706,994,82,656,738,1732,49,322,Minnesota,Duluth,86265
10031,1973-1974,1973-11-03,1974-05-14,193,0,325,792,1117,113,971,1084,2201,57,453,Minnesota,Duluth,86265
10032,1974-1975,1974-09-21,1975-04-28,220,0,268,740,1008,161,1208,1369,2377,72,562,Minnesota,Duluth,86265
10033,1975-1976,1975-10-25,1976-04-05,164,0,294,713,1007,144,1025,1169,2176,67,596,Minnesota,Duluth,86265
10034,1976-1977,1976-10-18,1977-04-06,171,0,358,823,1181,77,519,596,1777,53,498,Minnesota,Duluth,86265
10035,1977-1978,1977-10-10,1978-04-23,196,0,324,763,1087,116,668,784,1871,61,493,Minnesota,Duluth,86265
10036,1978-1979,1978-11-09,1979-05-06,179,0,398,887,1285,151,1135,1286,2571,83,696,Minnesota,Duluth,86265
10037,1979-1980,1979-10-22,1980-04-12,174,0,245,695,940,93,638,731,1671,56,357,Minnesota,Duluth,86265
10038,1980-1981,1980-10-22,1981-04-30,191,0,249,683,932,64,283,347,1279,42,328,Minnesota,Duluth,86265
10039,1981-1982,1981-10-21,1982-04-21,183,0,357,855,1212,155,1131,1286,2498,63,618,Minnesota,Duluth,86265
10040,1982-1983,1982-10-19,1983-04-22,186,0,207,600,807,139,887,1026,1833,58,333,Minnesota,Duluth,86265
10041,1983-1984,1983-11-08,1984-05-08,183,0,333,755,1088,163,1188,1351,2439,60,581,Minnesota,Duluth,86265
10042,1984-1985,1984-10-30,1985-04-08,161,0,282,710,992,109,484,593,1585,53,489,Minnesota,Duluth,86265
10043,1985-1986,1985-09-30,1986-04-03,186,0,337,808,1145,137,1020,1157,2302,60,576,Minnesota,Duluth,86265
10044,1986-1987,1986-10-12,1987-04-02,173,0,165,565,730,73,451,524,1254,45,269,Minnesota,Duluth,86265
10045,1987-1988,1987-10-20,1988-04-23,187,0,269,772,1041,89,694,783,1824,47,343,Minnesota,Duluth,86265
10046,1988-1989,1988-10-18,1989-05-06,201,0,298,845,1143,178,1128,1306,2449,70,586,Minnesota,Duluth,86265
10047,1989-1990,1989-10-31,1990-05-09,191,0,259,788,1047,99,516,615,1662,63,513,Minnesota,Duluth,86265
10048,1990-1991,1990-10-17,1991-05-06,202,0,253,723,976,103,611,714,1690,57,476,Minnesota,Duluth,86265
10049,1991-1992,1991-09-18,1992-04-24,220,0,210,664,874,156,1227,1383,2257,56,464,Minnesota,Duluth,86265
10050,1992-1993,1992-10-13,1993-04-29,199,0,230,688,918,156,1144,1300,2218,80,539,Minnesota,Duluth,86265
10051,1993-1994,1993-10-28,1994-04-30,185,0,354,839,1193,173,1177,1350,2543,70,663,Minnesota,Duluth,86265
10052,1994-1995,1994-10-24,1995-04-21,180,0,208,604,812,144,823,967,1779,62,427,Minnesota,Duluth,86265
10053,1995-1996,1995-09-21,1996-04-25,218,0,369,917,1286,208,1328,1536,2822,89,747,Minnesota,Duluth,86265
10054,1996-1997,1996-10-30,1997-05-14,197,0,324,795,1119,193,1295,1488,2607,85,802,Minnesota,Duluth,86265
10055,1997-1998,1997-10-13,1998-04-03,173,0,162,479,641,129,667,796,1437,67,421,Minnesota,Duluth,86265
10056,1998-1999,1998-11-05,1999-04-11,158,0,213,569,782,141,633,774,1556,60,483,Minnesota,Duluth,86265
10057,1999-2000,1999-11-23,2000-04-20,150,0,170,538,708,94,330,424,1132,52,383,Minnesota,Duluth,86265
10058,2000-2001,2000-11-07,2001-04-24,169,0,303,733,1036,151,1016,1167,2203,71,599,Minnesota,Duluth,86265
10059,2001-2002,2001-10-05,2002-05-07,215,0,170,575,745,141,390,531,1276,69,460,Minnesota,Duluth,86265
10060,2002-2003,2002-10-16,2003-04-17,184,0,297,748,1045,98,257,355,1400,53,399,Minnesota,Duluth,86265
10061,2003-2004,2003-10-27,2004-04-26,183,0,239,661,900,164,821,985,1885,60,506,Minnesota,Duluth,86265
10062,2004-2005,2004-11-25,2005-05-01,158,0,237,652,889,139,956,1095,1984,55,494,Minnesota,Duluth,86265
10063,2005-2006,2005-10-07,2006-03-31,176,0,178,517,695,138,816,954,1649,61,449,Minnesota,Duluth,86265
10064,2006-2007,2006-10-11,2007-05-20,222,0,238,636,874,120,464,584,1458,41,316,Minnesota,Duluth,86265
10065,2007-2008,2007-11-05,2008-05-11,189,0,306,727,1033,134,910,1044,2077,64,461,Minnesota,Duluth,86265
10066,2008-2009,2008-10-26,2009-04-07,164,0,328,780,1108,126,689,815,1923,61,590,Minnesota,Duluth,86265
10067,2009-2010,2009-10-10,2010-05-08,211,0,209,602,811,107,799,906,1717,39,347,Minnesota,Duluth,86265
10068,2010-2011,2010-10-26,2011-04-28,185,0,289,707,996,149,945,1094,2090,69,552,Minnesota,Duluth,86265
10069,2011-2012,2011-11-15,2012-04-16,154,0,123,419,542,82,266,348,890,41,248,Minnesota,Duluth,86265
10070,2012-2013,2012-09-21,2013-04-30,222,0,229,702,931,202,932,1134,2065,77,632,Minnesota,Duluth,86265
10071,2013-2014,2013-10-21,2014-04-30,192,0,416,960,1376,194,1252,1446,2822,66,670,Minnesota,Duluth,86265
10072,2014-2015,2014-10-30,2015-04-21,174,0,288,663,951,85,582,667,1618,50,331,Minnesota,Duluth,86265
10073,2015-2016,2015-11-12,2016-05-13,184,0,168,505,673,128,644,772,1445,64,408,Minnesota,Duluth,86265
10074,2016-2017,2016-11-18,2017-05-01,165,0,195,522,717,107,585,692,1409,54,380,Minnesota,Duluth,86265
10075,2017-2018,2017-10-27,2018-04-27,183,0,302,786,1088,142,829,971,2059,63,548,Minnesota,Duluth,86265
10076,2018-2019,2018-10-10,2019-05-20,223,0,273,720,993,164,903,1067,2060,69,564,Minnesota,Duluth,86265
10077,2019-2020,2019-10-11,2020-04-20,193,0,195,630,825,143,1159,1302,2127,61,399,Minnesota,Duluth,86265
10078,1957-1958,1957-11-08,1958-04-28,172,0,170,555,725,56,490,546,1271,35,181,Minnesota,Grand Marais,1351
10079,1958-1959,1958-11-18,1959-03-28,131,0,289,728,1017,56,625,681,1698,23,224,Minnesota,Grand Marais,1351
10080,1959-1960,1959-11-04,1960-04-26,175,0,171,618,789,63,562,625,1414,26,190,Minnesota,Grand Marais,1351
10081,1960-1961,1960-11-10,1961-04-12,154,1,200,574,774,63,490,553,1327,28,194,Minnesota,Grand Marais,1351
10082,1961-1962,1961-11-08,1962-05-08,182,4,233,665,898,71,782,853,1751,34,286,Minnesota,Grand Marais,1351
10083,1962-1963,1962-10-24,1963-05-22,211,0,284,776,1060,59,491,550,1610,35,337,Minnesota,Grand Marais,1351
10084,1963-1964,1963-11-23,1964-04-14,144,0,169,586,755,76,516,592,1347,33,234,Minnesota,Grand Marais,1351
10085,1964-1965,1964-11-18,1965-04-18,152,0,270,746,1016,95,964,1059,2075,44,358,Minnesota,Grand Marais,1351
10086,1965-1966,1965-11-09,1966-05-02,175,0,198,605,803,121,963,1084,1887,41,277,Minnesota,Grand Marais,1351
10087,1966-1967,1966-10-15,1967-05-02,200,0,238,743,981,95,910,1005,1986,40,332,Minnesota,Grand Marais,1351
10088,1967-1968,1967-10-28,1968-04-24,180,0,203,647,850,58,346,404,1254,26,196,Minnesota,Grand Marais,1351
10089,1968-1969,1968-11-12,1969-04-11,151,3,177,581,758,103,1118,1221,1979,34,277,Minnesota,Grand Marais,1351
10090,1969-1970,1969-10-13,1970-04-20,190,0,222,711,933,111,1077,1188,2121,39,290,Minnesota,Grand Marais,1351
10091,1970-1971,1970-11-13,1971-04-13,152,0,232,644,876,95,925,1020,1896,33,257,Minnesota,Grand Marais,1351
10092,1971-1972,1971-11-06,1972-04-22,169,5,263,768,1031,100,995,1095,2126,40,348,Minnesota,Grand Marais,1351
10093,1972-1973,1972-11-13,1973-04-05,144,0,168,500,668,41,606,647,1315,16,112,Minnesota,Grand Marais,1351
10094,1973-1974,1973-11-05,1974-04-17,164,2,200,583,783,87,784,871,1654,44,298,Minnesota,Grand Marais,1351
10095,1974-1975,1974-11-13,1975-04-17,156,3,132,521,653,66,890,956,1609,35,210,Minnesota,Grand Marais,1351
10096,1975-1976,1975-11-12,1976-04-10,151,1,163,545,708,123,1082,1205,1913,51,370,Minnesota,Grand Marais,1351
10097,1976-1977,1976-10-19,1977-03-25,158,2,248,657,905,41,522,563,1468,25,225,Minnesota,Grand Marais,1351
10098,1977-1978,1977-11-11,1978-04-12,153,1,204,582,786,72,605,677,1463,22,174,Minnesota,Grand Marais,1351
10099,1978-1979,1978-11-11,1979-05-06,177,1,313,749,1062,96,1147,1243,2305,36,285,Minnesota,Grand Marais,1351
10100,1979-1980,1979-10-23,1980-04-09,170,0,157,558,715,68,617,685,1400,28,192,Minnesota,Grand Marais,1351
10101,1980-1981,1980-11-08,1981-04-04,148,1,172,535,707,73,594,667,1374,22,178,Minnesota,Grand Marais,1351
10102,1981-1982,1981-10-22,1982-04-14,175,3,227,642,869,75,956,1031,1900,21,172,Minnesota,Grand Marais,1351
10103,1982-1983,1982-11-04,1983-04-18,166,6,111,439,550,55,576,631,1181,25,121,Minnesota,Grand Marais,1351
10104,1983-1984,1983-11-11,1984-04-30,172,2,215,607,822,49,725,774,1596,25,189,Minnesota,Grand Marais,1351
10105,1984-1985,1984-11-02,1985-04-13,163,2,198,580,778,58,432,490,1268,22,169,Minnesota,Grand Marais,1351
10106,1985-1986,1985-11-09,1986-04-08,151,8,218,598,816,70,1023,1093,1909,28,227,Minnesota,Grand Marais,1351
10107,1989-1990,1989-11-02,1990-04-06,156,12,170,608,778,75,821,896,1674,21,178,Minnesota,Grand Marais,1351
10108,1990-1991,1990-11-24,1991-04-07,135,5,167,534,701,97,946,1043,1744,22,214,Minnesota,Grand Marais,1351
10109,1991-1992,1991-11-01,1992-04-06,158,10,131,497,628,114,1056,1170,1798,22,230,Minnesota,Grand Marais,1351
10110,1992-1993,1992-10-20,1993-03-31,163,12,150,547,697,49,676,725,1422,18,160,Minnesota,Grand Marais,1351
10111,1998-1999,1998-12-01,1999-04-04,125,15,128,446,574,75,660,735,1309,18,161,Minnesota,Grand Marais,1351
10112,1999-2000,1999-11-23,2000-04-15,145,13,85,435,520,50,411,461,981,19,138,Minnesota,Grand Marais,1351
10113,2001-2002,2001-11-28,2002-03-28,121,16,80,415,495,21,100,121,616,9,64,Minnesota,Grand Marais,1351
10114,2002-2003,2002-11-12,2003-04-17,157,16,169,578,747,26,177,203,950,18,81,Minnesota,Grand Marais,1351
10115,2003-2004,2003-10-27,2004-04-03,160,9,110,510,620,62,635,697,1317,23,158,Minnesota,Grand Marais,1351
10116,2004-2005,2004-12-01,2005-04-04,125,8,128,518,646,91,885,976,1622,19,186,Minnesota,Grand Marais,1351
10117,2005-2006,2005-11-17,2006-04-03,138,19,72,391,463,61,421,482,945,22,129,Minnesota,Grand Marais,1351
10118,2007-2008,2007-11-08,2008-04-19,164,19,162,681,843,87,1078,1165,2008,15,139,Minnesota,Grand Marais,1351
10119,2008-2009,2008-11-16,2009-04-20,156,9,229,720,949,109,1082,1191,2140,28,275,Minnesota,Grand Marais,1351
10120,2009-2010,2009-11-30,2010-03-26,117,5,137,469,606,24,306,330,936,8,58,Minnesota,Grand Marais,1351
10121,2010-2011,2010-11-14,2011-04-18,156,4,175,667,842,77,805,882,1724,24,197,Minnesota,Grand Marais,1351
10122,2012-2013,2012-11-23,2013-04-28,157,7,196,712,908,107,471,578,1486,35,288,Minnesota,Grand Marais,1351
10123,2015-2016,2015-11-21,2016-04-13,145,0,148,487,635,62,327,389,1024,26,158,Minnesota,Grand Marais,1351
10124,2016-2017,2016-11-19,2017-04-27,160,6,166,503,669,81,531,612,1281,32,245,Minnesota,Grand Marais,1351
10125,2017-2018,2017-11-04,2018-04-18,166,3,244,716,960,85,731,816,1776,25,260,Minnesota,Grand Marais,1351
10126,2018-2019,2018-11-05,2019-04-17,164,12,256,667,923,99,884,983,1906,34,316,Minnesota,Grand Marais,1351
10127,2019-2020,2019-10-31,2020-04-09,162,1,137,558,695,103,814,917,1612,35,255,Minnesota,Grand Marais,1351
10128,1950-1951,1950-11-08,1951-04-15,159,0,317,947,1264,115,1083,1198,2462,37,367,Minnesota,Grand Rapids,10869
10129,1951-1952,1951-10-22,1952-04-11,173,1,243,852,1095,85,992,1077,2172,39,324,Minnesota,Grand Rapids,10869
10130,1952-1953,1952-10-16,1953-04-25,192,4,188,753,941,58,648,706,1647,21,193,Minnesota,Grand Rapids,10869
10131,1953-1954,1953-11-20,1954-05-05,167,3,215,790,1005,122,1013,1135,2140,36,350,Minnesota,Grand Rapids,10869
10132,1954-1955,1954-11-01,1955-04-08,159,0,215,788,1003,97,838,935,1938,28,243,Minnesota,Grand Rapids,10869
10133,1955-1956,1955-10-28,1956-04-19,175,3,261,968,1229,115,1280,1395,2624,38,295,Minnesota,Grand Rapids,10869
10134,1956-1957,1956-11-15,1957-04-17,154,0,252,881,1133,84,909,993,2126,30,285,Minnesota,Grand Rapids,10869
10135,1957-1958,1957-10-25,1958-04-29,187,0,176,690,866,39,422,461,1327,21,122,Minnesota,Grand Rapids,10869
10136,1958-1959,1958-10-01,1959-05-14,226,2,297,945,1242,43,673,716,1958,23,205,Minnesota,Grand Rapids,10869
10137,1959-1960,1959-10-11,1960-04-26,199,1,216,837,1053,52,561,613,1666,27,179,Minnesota,Grand Rapids,10869
10138,1960-1961,1960-10-19,1961-05-10,204,0,202,742,944,75,177,252,1196,26,163,Minnesota,Grand Rapids,10869
10139,1961-1962,1961-11-03,1962-04-28,177,0,275,827,1102,88,821,909,2011,48,396,Minnesota,Grand Rapids,10869
10140,1962-1963,1962-10-24,1963-05-19,208,0,288,836,1124,70,371,441,1565,34,296,Minnesota,Grand Rapids,10869
10141,1963-1964,1963-11-23,1964-04-14,144,3,204,738,942,58,542,600,1542,30,254,Minnesota,Grand Rapids,10869
10142,1964-1965,1964-11-18,1965-04-20,154,0,337,968,1305,97,1096,1193,2498,35,349,Minnesota,Grand Rapids,10869
10143,1965-1966,1965-11-09,1966-05-11,184,1,279,837,1116,134,980,1114,2230,42,336,Minnesota,Grand Rapids,10869
10144,1966-1967,1966-11-01,1967-05-11,192,0,268,903,1171,84,845,929,2100,41,312,Minnesota,Grand Rapids,10869
10145,1967-1968,1967-10-29,1968-05-18,203,0,244,804,1048,69,426,495,1543,33,235,Minnesota,Grand Rapids,10869
10146,1968-1969,1968-11-06,1969-06-02,209,0,276,779,1055,109,1133,1242,2297,45,385,Minnesota,Grand Rapids,10869
10147,1969-1970,1969-10-21,1970-05-15,207,0,272,880,1152,111,931,1042,2194,54,415,Minnesota,Grand Rapids,10869
10148,1970-1971,1970-10-10,1971-05-20,223,5,296,918,1214,149,1151,1300,2514,55,489,Minnesota,Grand Rapids,10869
10149,1971-1972,1971-10-29,1972-04-23,178,3,331,935,1266,115,1085,1200,2466,55,470,Minnesota,Grand Rapids,10869
10150,1972-1973,1972-10-18,1973-04-16,181,4,235,764,999,49,503,552,1551,31,224,Minnesota,Grand Rapids,10869
10151,1996-1997,1996-10-31,1997-05-14,196,13,303,881,1184,137,1153,1290,2474,61,655,Minnesota,Grand Rapids,10869
10152,1997-1998,1997-10-13,1998-04-02,172,0,123,517,640,62,526,588,1228,44,251,Minnesota,Grand Rapids,10869
10153,1998-1999,1998-11-05,1999-04-16,163,1,189,604,793,82,624,706,1499,45,360,Minnesota,Grand Rapids,10869
10154,1999-2000,1999-11-23,2000-04-13,143,0,141,571,712,45,279,324,1036,35,267,Minnesota,Grand Rapids,10869
10155,2000-2001,2000-11-07,2001-04-23,168,1,266,809,1075,116,1027,1143,2218,69,570,Minnesota,Grand Rapids,10869
10156,2001-2002,2001-10-24,2002-05-02,191,0,151,607,758,93,518,611,1369,61,408,Minnesota,Grand Rapids,10869
10157,2002-2003,2002-10-12,2003-04-17,188,0,254,794,1048,73,514,587,1635,53,364,Minnesota,Grand Rapids,10869
10158,2003-2004,2003-10-27,2004-03-29,155,0,211,684,895,120,859,979,1874,65,522,Minnesota,Grand Rapids,10869
10159,2004-2005,2004-11-08,2005-05-01,175,1,201,754,955,90,853,943,1898,52,436,Minnesota,Grand Rapids,10869
10160,2005-2006,2005-11-15,2006-03-28,134,0,147,514,661,85,726,811,1472,54,360,Minnesota,Grand Rapids,10869
10161,2006-2007,2006-10-11,2007-04-08,180,0,210,665,875,75,327,402,1277,42,287,Minnesota,Grand Rapids,10869
10162,2007-2008,2007-11-06,2008-04-26,173,3,265,824,1089,101,879,980,2069,48,413,Minnesota,Grand Rapids,10869
10163,2008-2009,2008-11-08,2009-04-24,168,0,293,862,1155,105,794,899,2054,59,561,Minnesota,Grand Rapids,10869
10164,2009-2010,2009-10-10,2010-05-07,210,0,197,677,874,53,555,608,1482,33,238,Minnesota,Grand Rapids,10869
10165,2010-2011,2010-11-13,2011-04-27,166,0,277,784,1061,118,917,1035,2096,55,527,Minnesota,Grand Rapids,10869
10166,2011-2012,2011-11-09,2012-04-21,165,0,134,505,639,76,307,383,1022,42,260,Minnesota,Grand Rapids,10869
10167,2012-2013,2012-10-10,2013-04-26,199,0,231,808,1039,143,937,1080,2119,64,531,Minnesota,Grand Rapids,10869
10168,2013-2014,2013-10-20,2014-04-25,188,0,428,1112,1540,136,1071,1207,2747,66,734,Minnesota,Grand Rapids,10869
10169,2014-2015,2014-11-08,2015-04-21,165,0,295,759,1054,62,479,541,1595,42,375,Minnesota,Grand Rapids,10869
10170,2015-2016,2015-11-19,2016-05-13,177,0,176,545,721,79,510,589,1310,41,282,Minnesota,Grand Rapids,10869
10171,2016-2017,2016-11-18,2017-05-01,165,0,202,620,822,102,609,711,1533,45,362,Minnesota,Grand Rapids,10869
10172,2017-2018,2017-10-26,2018-04-17,174,0,283,875,1158,102,829,931,2089,50,425,Minnesota,Grand Rapids,10869
10173,2018-2019,2018-10-05,2019-05-02,210,0,301,890,1191,135,962,1097,2288,71,607,Minnesota,Grand Rapids,10869
10174,2019-2020,2019-10-12,2020-04-20,192,0,205,744,949,96,896,992,1941,46,335,Minnesota,Grand Rapids,10869
10175,1950-1951,1950-10-02,1951-04-23,204,0,433,1079,1512,133,1178,1311,2823,71,661,Minnesota,International Falls,6424
10176,1951-1952,1951-09-26,1952-04-09,197,0,358,984,1342,99,758,857,2199,68,574,Minnesota,International Falls,6424
10177,1952-1953,1952-10-04,1953-05-12,221,0,271,912,1183,105,648,753,1936,75,634,Minnesota,International Falls,6424
10178,1953-1954,1953-11-04,1954-05-08,186,0,321,952,1273,144,1029,1173,2446,76,728,Minnesota,International Falls,6424
10179,1954-1955,1954-10-29,1955-04-06,160,0,316,964,1280,116,886,1002,2282,62,583,Minnesota,International Falls,6424
10180,1955-1956,1955-10-29,1956-05-02,187,0,355,1108,1463,143,1234,1377,2840,80,728,Minnesota,International Falls,6424
10181,1956-1957,1956-11-07,1957-04-15,160,0,369,1078,1447,94,746,840,2287,60,540,Minnesota,International Falls,6424
10182,1957-1958,1957-10-24,1958-05-02,191,0,248,798,1046,77,321,398,1444,61,435,Minnesota,International Falls,6424
10183,1958-1959,1958-10-01,1959-05-14,226,0,431,1198,1629,90,949,1039,2668,55,568,Minnesota,International Falls,6424
10184,1959-1960,1959-10-11,1960-04-29,202,0,306,960,1266,82,813,895,2161,53,403,Minnesota,International Falls,6424
10185,1960-1961,1960-10-18,1961-04-29,194,0,289,873,1162,90,693,783,1945,53,390,Minnesota,International Falls,6424
10186,1961-1962,1961-11-02,1962-05-08,188,0,378,994,1372,103,903,1006,2378,62,594,Minnesota,International Falls,6424
10187,1962-1963,1962-10-25,1963-04-20,178,0,393,995,1388,60,508,568,1956,48,539,Minnesota,International Falls,6424
10188,1963-1964,1963-11-11,1964-04-14,156,0,305,920,1225,74,771,845,2070,45,369,Minnesota,International Falls,6424
10189,1964-1965,1964-09-14,1965-05-28,257,0,442,1194,1636,88,1017,1105,2741,58,576,Minnesota,International Falls,6424
10190,1965-1966,1965-11-07,1966-05-02,177,0,378,1033,1411,148,1358,1506,2917,56,493,Minnesota,International Falls,6424
10191,1966-1967,1966-11-01,1967-05-03,184,0,403,1127,1530,88,885,973,2503,53,489,Minnesota,International Falls,6424
10192,1967-1968,1967-10-09,1968-05-17,222,0,343,994,1337,103,715,818,2155,55,451,Minnesota,International Falls,6424
10193,1968-1969,1968-10-23,1969-06-02,223,0,347,946,1293,99,1103,1202,2495,55,544,Minnesota,International Falls,6424
10194,1969-1970,1969-10-17,1970-05-25,221,0,373,1066,1439,113,1084,1197,2636,71,620,Minnesota,International Falls,6424
10195,1970-1971,1970-10-07,1971-05-01,207,0,411,1057,1468,87,935,1022,2490,51,490,Minnesota,International Falls,6424
10196,1971-1972,1971-10-29,1972-04-23,178,0,446,1091,1537,112,1158,1270,2807,63,518,Minnesota,International Falls,6424
10197,1972-1973,1972-10-14,1973-04-16,185,0,294,864,1158,56,509,565,1723,41,287,Minnesota,International Falls,6424
10198,1973-1974,1973-11-03,1974-05-14,193,0,375,1012,1387,96,934,1030,2417,56,490,Minnesota,International Falls,6424
10199,1974-1975,1974-09-21,1975-05-01,223,0,298,931,1229,142,1195,1337,2566,66,537,Minnesota,International Falls,6424
10200,1975-1976,1975-10-24,1976-05-02,192,0,348,986,1334,128,973,1101,2435,69,721,Minnesota,International Falls,6424
10201,1976-1977,1976-10-07,1977-04-08,184,0,449,1076,1525,109,550,659,2184,68,708,Minnesota,International Falls,6424
10202,1977-1978,1977-11-09,1978-04-16,159,0,462,1075,1537,109,1105,1214,2751,56,546,Minnesota,International Falls,6424
10203,1978-1979,1978-10-15,1979-05-05,203,0,530,1245,1775,120,1311,1431,3206,65,724,Minnesota,International Falls,6424
10204,1979-1980,1979-10-11,1980-04-14,187,0,332,963,1295,107,871,978,2273,64,572,Minnesota,International Falls,6424
10205,1980-1981,1980-10-22,1981-04-01,162,0,307,822,1129,75,729,804,1933,44,400,Minnesota,International Falls,6424
10206,1981-1982,1981-09-30,1982-04-21,204,0,437,1076,1513,137,1171,1308,2821,65,676,Minnesota,International Falls,6424
10207,1982-1983,1982-11-02,1983-05-04,184,0,237,701,938,82,420,502,1440,49,325,Minnesota,International Falls,6424
10208,1983-1984,1983-10-12,1984-05-08,210,0,409,968,1377,97,958,1055,2432,55,588,Minnesota,International Falls,6424
10209,1984-1985,1984-10-17,1985-04-13,179,0,396,1001,1397,107,799,906,2303,55,573,Minnesota,International Falls,6424
10210,1985-1986,1985-10-01,1986-05-01,213,0,402,977,1379,132,1125,1257,2636,63,682,Minnesota,International Falls,6424
10211,1986-1987,1986-10-13,1987-04-03,173,0,200,691,891,96,524,620,1511,58,464,Minnesota,International Falls,6424
10212,1987-1988,1987-10-09,1988-04-09,184,0,308,906,1214,78,536,614,1828,47,372,Minnesota,International Falls,6424
10213,1988-1989,1988-10-24,1989-05-06,195,0,374,1044,1418,163,1210,1373,2791,70,722,Minnesota,International Falls,6424
10214,1989-1990,1989-11-01,1990-04-30,181,0,334,961,1295,112,453,565,1860,72,695,Minnesota,International Falls,6424
10215,1990-1991,1990-10-17,1991-05-04,200,0,323,939,1262,141,842,983,2245,61,639,Minnesota,International Falls,6424
10216,1991-1992,1991-10-14,1992-05-23,223,0,263,824,1087,174,938,1112,2199,74,703,Minnesota,International Falls,6424
10217,1992-1993,1992-09-27,1993-04-29,215,0,331,908,1239,150,888,1038,2277,72,678,Minnesota,International Falls,6424
10218,1993-1994,1993-09-27,1994-04-29,215,0,404,1001,1405,129,549,678,2083,77,795,Minnesota,International Falls,6424
10219,1994-1995,1994-10-24,1995-04-17,176,0,261,775,1036,112,579,691,1727,61,554,Minnesota,International Falls,6424
10220,1995-1996,1995-10-20,1996-04-28,192,0,471,1214,1685,178,1274,1452,3137,76,779,Minnesota,International Falls,6424
10221,1996-1997,1996-10-02,1997-05-14,225,1,406,1067,1473,139,1130,1269,2742,85,792,Minnesota,International Falls,6424
10222,1997-1998,1997-10-14,1998-04-08,177,0,180,607,787,95,386,481,1268,65,469,Minnesota,International Falls,6424
10223,1998-1999,1998-11-03,1999-04-16,165,2,276,775,1051,104,447,551,1602,45,428,Minnesota,International Falls,6424
10224,1999-2000,1999-11-27,2000-04-14,140,0,194,672,866,48,263,311,1177,26,214,Minnesota,International Falls,6424
10225,2000-2001,2000-11-03,2001-04-23,172,0,341,903,1244,104,748,852,2096,49,409,Minnesota,International Falls,6424
10226,2003-2004,2003-09-29,2004-04-10,195,0,313,916,1229,117,768,885,2114,58,490,Minnesota,International Falls,6424
10227,2004-2005,2004-11-07,2005-05-01,176,0,308,909,1217,97,737,834,2051,52,511,Minnesota,International Falls,6424
10228,2005-2006,2005-10-18,2006-05-04,199,0,229,720,949,93,750,843,1792,61,480,Minnesota,International Falls,6424
10229,2006-2007,2006-10-11,2007-04-10,182,0,288,824,1112,74,377,451,1563,48,390,Minnesota,International Falls,6424
10230,2007-2008,2007-11-04,2008-05-04,183,0,345,995,1340,157,994,1151,2491,88,824,Minnesota,International Falls,6424
10231,2008-2009,2008-10-26,2009-05-16,203,0,394,1112,1506,199,1089,1288,2794,81,899,Minnesota,International Falls,6424
10232,2009-2010,2009-10-09,2010-03-25,168,0,256,814,1070,75,777,852,1922,36,269,Minnesota,International Falls,6424
10233,2010-2011,2010-10-28,2011-05-01,186,0,348,980,1328,132,1074,1206,2534,65,641,Minnesota,International Falls,6424
10234,2011-2012,2011-11-09,2012-04-22,166,0,155,592,747,117,547,664,1411,66,462,Minnesota,International Falls,6424
10235,2012-2013,2012-10-05,2013-04-30,208,0,309,1037,1346,157,1148,1305,2651,83,824,Minnesota,International Falls,6424
10236,2013-2014,2013-10-19,2014-04-25,189,0,496,1284,1780,167,1194,1361,3141,87,1004,Minnesota,International Falls,6424
10237,2014-2015,2014-10-30,2015-04-22,175,0,342,928,1270,114,708,822,2092,71,672,Minnesota,International Falls,6424
10238,2015-2016,2015-11-12,2016-04-10,151,0,217,637,854,83,593,676,1530,53,361,Minnesota,International Falls,6424
10239,2016-2017,2016-11-18,2017-04-28,162,3,255,700,955,106,732,838,1793,53,437,Minnesota,International Falls,6424
10240,2017-2018,2017-10-26,2018-04-20,177,0,352,1069,1421,99,875,974,2395,49,520,Minnesota,International Falls,6424
10241,2018-2019,2018-10-10,2019-05-02,205,1,356,1020,1376,115,936,1051,2427,57,536,Minnesota,International Falls,6424
10242,2019-2020,2019-10-12,2020-04-14,186,0,248,854,1102,106,1028,1134,2236,56,496,Minnesota,International Falls,6424
10243,1950-1951,1950-11-08,1951-04-15,159,0,280,705,985,129,802,931,1916,50,461,Minnesota,Minneapolis,382578
10244,1951-1952,1951-10-30,1952-04-09,163,0,213,604,817,121,542,663,1480,46,370,Minnesota,Minneapolis,382578
10245,1952-1953,1952-10-16,1953-04-25,192,0,158,517,675,68,509,577,1252,33,232,Minnesota,Minneapolis,382578
10246,1953-1954,1953-11-21,1954-05-03,164,0,142,481,623,53,81,134,757,36,237,Minnesota,Minneapolis,382578
10247,1954-1955,1954-10-31,1955-03-27,148,0,178,521,699,63,437,500,1199,42,287,Minnesota,Minneapolis,382578
10248,1955-1956,1955-10-29,1956-04-29,184,0,249,696,945,80,629,709,1654,53,361,Minnesota,Minneapolis,382578
10249,1956-1957,1956-11-15,1957-04-12,149,0,170,547,717,69,107,176,893,38,290,Minnesota,Minneapolis,382578
10250,1957-1958,1957-11-08,1958-04-06,150,0,151,427,578,40,91,131,709,26,144,Minnesota,Minneapolis,382578
10251,1958-1959,1958-11-05,1959-03-21,137,0,222,568,790,41,58,99,889,34,245,Minnesota,Minneapolis,382578
10252,1959-1960,1959-10-08,1960-03-26,171,0,177,556,733,60,169,229,962,40,254,Minnesota,Minneapolis,382578
10253,1960-1961,1960-11-09,1961-04-18,161,0,164,582,746,69,115,184,930,30,225,Minnesota,Minneapolis,382578
10254,1961-1962,1961-09-30,1962-04-15,198,0,265,725,990,126,677,803,1793,52,463,Minnesota,Minneapolis,382578
10255,1962-1963,1962-11-18,1963-04-23,157,0,252,661,913,59,244,303,1216,33,339,Minnesota,Minneapolis,382578
10256,1963-1964,1963-11-23,1964-04-14,144,0,180,546,726,50,193,243,969,29,187,Minnesota,Minneapolis,382578
10257,1964-1965,1964-11-19,1965-04-25,158,0,279,720,999,108,631,739,1738,43,376,Minnesota,Minneapolis,382578
10258,1965-1966,1965-11-11,1966-04-08,149,0,205,544,749,63,260,323,1072,31,264,Minnesota,Minneapolis,382578
10259,1966-1967,1966-10-15,1967-05-01,199,0,212,672,884,122,716,838,1722,50,422,Minnesota,Minneapolis,382578
10260,1967-1968,1967-10-27,1968-04-23,180,0,177,558,735,40,139,179,914,31,187,Minnesota,Minneapolis,382578
10261,1968-1969,1968-11-06,1969-04-28,174,0,220,594,814,110,783,893,1707,54,416,Minnesota,Minneapolis,382578
10262,1969-1970,1969-10-12,1970-04-20,191,0,229,650,879,106,765,871,1750,53,418,Minnesota,Minneapolis,382578
10263,1970-1971,1970-11-03,1971-05-19,198,0,230,615,845,89,532,621,1466,50,362,Minnesota,Minneapolis,382578
10264,1971-1972,1971-11-06,1972-04-21,168,0,268,680,948,101,695,796,1744,50,400,Minnesota,Minneapolis,382578
10265,1972-1973,1972-11-07,1973-04-16,161,0,189,496,685,60,374,434,1119,26,191,Minnesota,Minneapolis,382578
10266,1973-1974,1973-11-04,1974-04-07,155,0,210,580,790,80,473,553,1343,43,298,Minnesota,Minneapolis,382578
10267,1974-1975,1974-11-13,1975-04-13,152,0,183,560,743,101,690,791,1534,53,373,Minnesota,Minneapolis,382578
10268,1975-1976,1975-11-09,1976-05-02,176,0,155,503,658,83,418,501,1159,34,253,Minnesota,Minneapolis,382578
10269,1976-1977,1976-10-18,1977-04-05,170,0,253,693,946,74,315,389,1335,42,316,Minnesota,Minneapolis,382578
10270,1977-1978,1977-10-10,1978-04-20,193,0,288,697,985,84,517,601,1586,48,391,Minnesota,Minneapolis,382578
10271,1978-1979,1978-11-12,1979-04-06,146,0,303,717,1020,104,908,1012,2032,49,430,Minnesota,Minneapolis,382578
10272,1979-1980,1979-11-01,1980-04-12,164,0,169,544,713,84,251,335,1048,47,291,Minnesota,Minneapolis,382578
10273,1980-1981,1980-11-13,1981-04-05,144,0,147,459,606,39,82,121,727,28,194,Minnesota,Minneapolis,382578
10274,1981-1982,1981-10-24,1982-04-20,179,0,269,657,926,137,783,920,1846,47,422,Minnesota,Minneapolis,382578
10275,1982-1983,1982-10-19,1983-04-20,184,0,109,401,510,113,437,550,1060,41,225,Minnesota,Minneapolis,382578
10276,1983-1984,1983-11-09,1984-05-01,175,0,276,604,880,142,786,928,1808,47,398,Minnesota,Minneapolis,382578
10277,1984-1985,1984-10-29,1985-04-03,157,0,197,571,768,105,391,496,1264,39,356,Minnesota,Minneapolis,382578
10278,1985-1986,1985-09-24,1986-04-14,203,0,252,641,893,110,795,905,1798,44,364,Minnesota,Minneapolis,382578
10279,1986-1987,1986-11-08,1987-03-14,127,0,86,359,445,34,68,102,547,23,122,Minnesota,Minneapolis,382578
10280,1987-1988,1987-10-24,1988-04-23,183,0,185,527,712,66,320,386,1098,35,229,Minnesota,Minneapolis,382578
10281,1988-1989,1988-10-23,1989-05-05,195,0,193,621,814,106,374,480,1294,42,326,Minnesota,Minneapolis,382578
10282,1989-1990,1989-11-02,1990-04-16,166,0,145,531,676,57,112,169,845,34,255,Minnesota,Minneapolis,382578
10283,1990-1991,1990-11-03,1991-05-05,184,0,162,528,690,75,308,383,1073,48,310,Minnesota,Minneapolis,382578
10284,1991-1992,1991-10-30,1992-04-10,164,0,122,445,567,128,692,820,1387,41,329,Minnesota,Minneapolis,382578
10285,1992-1993,1992-10-15,1993-04-15,183,0,170,550,720,83,428,511,1231,50,255,Minnesota,Minneapolis,382578
10286,1993-1994,1993-11-04,1994-04-29,177,0,239,609,848,94,356,450,1298,47,387,Minnesota,Minneapolis,382578
10287,1994-1995,1994-11-27,1995-04-18,143,0,129,420,549,52,138,190,739,30,174,Minnesota,Minneapolis,382578
10288,1995-1996,1995-10-24,1996-04-26,186,0,234,665,899,89,464,553,1452,46,348,Minnesota,Minneapolis,382578
10289,1996-1997,1996-10-31,1997-04-10,162,18,248,651,899,114,745,859,1758,52,467,Minnesota,Minneapolis,382578
10290,1997-1998,1997-11-02,1998-03-23,142,0,104,372,476,77,241,318,794,44,268,Minnesota,Minneapolis,382578
10291,1998-1999,1998-11-06,1999-03-16,131,0,143,421,564,80,259,339,903,26,280,Minnesota,Minneapolis,382578
10292,1999-2000,1999-11-23,2000-04-12,142,0,105,371,476,53,250,303,779,23,147,Minnesota,Minneapolis,382578
10293,2000-2001,2000-11-07,2001-04-04,149,0,238,619,857,124,793,917,1774,53,426,Minnesota,Minneapolis,382578
10294,2001-2002,2001-10-24,2002-04-28,187,0,103,358,461,98,205,303,764,39,245,Minnesota,Minneapolis,382578
10295,2002-2003,2002-10-20,2003-04-05,168,0,173,515,688,58,154,212,900,35,242,Minnesota,Minneapolis,382578
10296,2003-2004,2003-11-03,2004-03-21,140,0,160,450,610,99,324,423,1033,38,321,Minnesota,Minneapolis,382578
10297,2004-2005,2004-11-27,2005-03-22,116,0,133,407,540,44,137,181,721,28,170,Minnesota,Minneapolis,382578
10298,2005-2006,2005-11-15,2006-03-26,132,0,115,376,491,70,239,309,800,31,186,Minnesota,Minneapolis,382578
10299,2006-2007,2006-11-02,2007-04-12,162,0,150,434,584,57,213,270,854,24,164,Minnesota,Minneapolis,382578
10300,2007-2008,2007-11-21,2008-04-26,158,0,219,573,792,74,428,502,1294,41,275,Minnesota,Minneapolis,382578
10301,2008-2009,2008-11-07,2009-04-05,150,0,222,605,827,72,320,392,1219,39,320,Minnesota,Minneapolis,382578
10302,2009-2010,2009-10-10,2010-03-10,152,0,171,441,612,60,547,607,1219,28,198,Minnesota,Minneapolis,382578
10303,2010-2011,2010-11-13,2011-04-20,159,0,214,533,747,135,698,833,1580,51,416,Minnesota,Minneapolis,382578
10304,2011-2012,2011-11-17,2012-03-08,113,0,69,274,343,43,71,114,457,29,153,Minnesota,Minneapolis,382578
10305,2012-2013,2012-11-12,2013-05-03,173,0,160,488,648,105,398,503,1151,47,299,Minnesota,Minneapolis,382578
10306,2013-2014,2013-11-05,2014-04-16,163,0,306,726,1032,109,679,788,1820,49,431,Minnesota,Minneapolis,382578
10307,2014-2015,2014-11-10,2015-04-10,152,0,216,510,726,59,205,264,990,42,277,Minnesota,Minneapolis,382578
10308,2015-2016,2015-11-20,2016-04-08,141,0,112,319,431,58,210,268,699,31,168,Minnesota,Minneapolis,382578
10309,2016-2017,2016-11-18,2017-04-11,145,0,129,351,480,48,139,187,667,21,154,Minnesota,Minneapolis,382578
10310,2017-2018,2017-10-27,2018-04-21,177,0,199,558,757,118,371,489,1246,42,307,Minnesota,Minneapolis,382578
10311,2018-2019,2018-10-14,2019-04-14,183,0,212,547,759,114,408,522,1281,46,351,Minnesota,Minneapolis,382578
10312,2019-2020,2019-11-01,2020-04-14,166,0,121,425,546,80,450,530,1076,36,210,Minnesota,Minneapolis,382578
10313,1951-1952,1951-10-22,1952-04-10,172,13,255,790,1045,108,551,659,1704,26,271,Minnesota,Morris,5286
10314,1953-1954,1953-11-22,1954-05-03,163,17,184,627,811,52,361,413,1224,18,131,Minnesota,Morris,5286
10315,1954-1955,1954-11-26,1955-03-26,121,2,173,589,762,48,244,292,1054,17,145,Minnesota,Morris,5286
10316,1955-1956,1955-11-03,1956-04-10,160,10,371,887,1258,86,584,670,1928,25,247,Minnesota,Morris,5286
10317,1956-1957,1956-11-15,1957-04-12,149,2,235,693,928,62,167,229,1157,32,320,Minnesota,Morris,5286
10318,1957-1958,1957-10-26,1958-04-06,163,1,214,579,793,39,147,186,979,27,195,Minnesota,Morris,5286
10319,1958-1959,1958-11-18,1959-03-17,120,1,281,692,973,32,139,171,1144,23,218,Minnesota,Morris,5286
10320,1959-1960,1959-10-09,1960-04-09,184,2,252,764,1016,73,289,362,1378,40,326,Minnesota,Morris,5286
10321,1960-1961,1960-10-20,1961-04-28,191,0,202,647,849,46,144,190,1039,26,201,Minnesota,Morris,5286
10322,1961-1962,1961-11-03,1962-04-15,164,1,328,774,1102,84,484,568,1670,40,365,Minnesota,Morris,5286
10323,1962-1963,1962-11-05,1963-04-23,170,1,275,711,986,55,136,191,1177,20,170,Minnesota,Morris,5286
10324,1964-1965,1964-10-29,1965-04-20,174,0,406,935,1341,89,415,504,1845,38,418,Minnesota,Morris,5286
10325,1965-1966,1965-09-26,1966-04-30,217,0,299,740,1039,81,252,333,1372,34,301,Minnesota,Morris,5286
10326,1966-1967,1966-11-02,1967-05-03,183,2,289,835,1124,94,491,585,1709,40,429,Minnesota,Morris,5286
10327,1967-1968,1967-10-27,1968-04-14,171,0,250,710,960,37,183,220,1180,27,230,Minnesota,Morris,5286
10328,1968-1969,1968-11-08,1969-04-02,146,2,357,775,1132,118,925,1043,2175,49,492,Minnesota,Morris,5286
10329,1969-1970,1969-10-13,1970-04-23,193,0,312,811,1123,96,612,708,1831,49,454,Minnesota,Morris,5286
10330,1970-1971,1970-10-08,1971-04-28,203,0,311,776,1087,85,439,524,1611,49,391,Minnesota,Morris,5286
10331,1971-1972,1971-10-29,1972-04-22,177,0,350,840,1190,103,647,750,1940,50,487,Minnesota,Morris,5286
10332,1972-1973,1972-10-18,1973-04-25,190,0,252,646,898,49,493,542,1440,32,263,Minnesota,Morris,5286
10333,1973-1974,1973-11-04,1974-04-01,149,0,284,763,1047,55,465,520,1567,37,330,Minnesota,Morris,5286
10334,1974-1975,1974-11-06,1975-04-19,165,2,244,750,994,113,860,973,1967,50,460,Minnesota,Morris,5286
10335,1975-1976,1975-10-25,1976-04-04,163,0,235,677,912,83,633,716,1628,43,382,Minnesota,Morris,5286
10336,1976-1977,1976-10-19,1977-04-04,168,0,323,907,1230,79,471,550,1780,49,527,Minnesota,Morris,5286
10337,1977-1978,1977-11-09,1978-04-20,163,0,398,841,1239,107,996,1103,2342,62,684,Minnesota,Morris,5286
10338,1978-1979,1978-11-10,1979-04-11,153,0,437,980,1417,94,881,975,2392,60,615,Minnesota,Morris,5286
10339,1979-1980,1979-10-22,1980-03-30,161,0,219,686,905,74,398,472,1377,44,377,Minnesota,Morris,5286
10340,1980-1981,1980-11-15,1981-03-07,113,0,177,562,739,39,138,177,916,22,247,Minnesota,Morris,5286
10341,1981-1982,1981-10-21,1982-04-10,172,0,362,895,1257,96,684,780,2037,47,533,Minnesota,Morris,5286
10342,1982-1983,1982-11-03,1983-04-16,165,1,157,515,672,61,284,345,1017,32,169,Minnesota,Morris,5286
10343,1983-1984,1983-11-09,1984-04-28,172,3,315,722,1037,103,742,845,1882,52,513,Minnesota,Morris,5286
10344,1984-1985,1984-10-30,1985-03-21,143,9,277,686,963,86,467,553,1516,38,406,Minnesota,Morris,5286
10345,1985-1986,1985-10-16,1986-03-30,166,1,334,802,1136,105,1041,1146,2282,41,433,Minnesota,Morris,5286
10346,1986-1987,1986-10-12,1987-03-30,170,0,118,507,625,43,144,187,812,24,158,Minnesota,Morris,5286
10347,1987-1988,1987-10-20,1988-03-26,159,0,243,671,914,49,465,514,1428,29,261,Minnesota,Morris,5286
10348,1988-1989,1988-10-28,1989-04-18,173,2,271,809,1080,93,758,851,1931,46,453,Minnesota,Morris,5286
10349,1989-1990,1989-11-01,1990-05-02,183,0,192,703,895,64,217,281,1176,36,279,Minnesota,Morris,5286
10350,1990-1991,1990-10-18,1991-04-23,188,0,216,712,928,77,338,415,1343,38,344,Minnesota,Morris,5286
10351,1991-1992,1991-10-30,1992-04-22,176,0,153,582,735,55,480,535,1270,31,232,Minnesota,Morris,5286
10352,1992-1993,1992-10-16,1993-04-12,179,0,284,761,1045,86,848,934,1979,48,397,Minnesota,Morris,5286
10353,1993-1994,1993-10-30,1994-04-30,183,0,356,827,1183,105,896,1001,2184,53,604,Minnesota,Morris,5286
10354,1994-1995,1994-11-18,1995-04-14,148,1,222,584,806,96,681,777,1583,43,367,Minnesota,Morris,5286
10355,1995-1996,1995-10-24,1996-04-14,174,2,362,838,1200,99,893,992,2192,39,370,Minnesota,Morris,5286
10356,1996-1997,1996-10-31,1997-04-11,163,4,370,854,1224,121,1220,1341,2565,46,510,Minnesota,Morris,5286
10357,1997-1998,1997-11-02,1998-04-02,152,0,186,478,664,70,312,382,1046,37,273,Minnesota,Morris,5286
10358,1998-1999,1998-11-06,1999-04-16,162,1,178,532,710,59,318,377,1087,26,277,Minnesota,Morris,5286
10359,1999-2000,1999-12-01,2000-04-16,138,5,149,486,635,43,244,287,922,23,199,Minnesota,Morris,5286
10360,2000-2001,2000-11-08,2001-04-07,151,4,343,841,1184,81,884,965,2149,35,326,Minnesota,Morris,5286
10361,2001-2002,2001-10-25,2002-04-06,164,1,172,511,683,65,237,302,985,32,250,Minnesota,Morris,5286
10362,2002-2003,2002-10-17,2003-04-05,171,1,231,693,924,39,127,166,1090,29,245,Minnesota,Morris,5286
10363,2003-2004,2003-11-02,2004-03-22,142,0,235,630,865,69,296,365,1230,38,362,Minnesota,Morris,5286
10364,2004-2005,2004-11-27,2005-03-19,113,6,207,531,738,39,202,241,979,23,184,Minnesota,Morris,5286
10365,2005-2006,2005-11-16,2006-03-26,131,1,202,540,742,58,475,533,1275,35,272,Minnesota,Morris,5286
10366,2006-2007,2006-10-12,2007-04-13,184,1,224,668,892,58,213,271,1163,25,215,Minnesota,Morris,5286
10367,2007-2008,2007-11-07,2008-04-30,176,1,322,822,1144,83,482,565,1709,33,302,Minnesota,Morris,5286
10368,2008-2009,2008-11-07,2009-04-03,148,2,341,835,1176,89,480,569,1745,44,465,Minnesota,Morris,5286
10369,2009-2010,2009-10-10,2010-03-26,168,1,277,639,916,59,516,575,1491,31,262,Minnesota,Morris,5286
10370,2010-2011,2010-10-27,2011-04-16,172,12,339,798,1137,105,873,978,2115,53,565,Minnesota,Morris,5286
10371,2011-2012,2011-11-17,2012-03-11,116,7,116,459,575,39,108,147,722,25,189,Minnesota,Morris,5286
10372,2012-2013,2012-10-25,2013-04-25,183,1,271,777,1048,95,684,779,1827,53,439,Minnesota,Morris,5286
10373,2013-2014,2013-10-29,2014-04-18,172,3,377,919,1296,58,507,565,1861,37,363,Minnesota,Morris,5286
10374,2014-2015,2014-11-10,2015-03-28,139,0,271,656,927,54,272,326,1253,31,293,Minnesota,Morris,5286
10375,2015-2016,2015-11-20,2016-04-09,142,0,166,469,635,44,242,286,921,30,213,Minnesota,Morris,5286
10376,2016-2017,2016-11-18,2017-05-01,165,0,193,531,724,41,192,233,957,26,218,Minnesota,Morris,5286
10377,2017-2018,2017-10-27,2018-04-17,173,7,271,750,1021,69,206,275,1296,35,311,Minnesota,Morris,5286
10378,2018-2019,2018-10-12,2019-04-16,187,0,362,831,1193,100,653,753,1946,45,543,Minnesota,Morris,5286
10379,2019-2020,2019-10-12,2020-04-15,187,0,215,670,885,50,459,509,1394,33,230,Minnesota,Morris,5286
10380,1950-1951,1950-11-09,1951-04-15,158,0,268,796,1064,112,699,811,1875,44,431,Minnesota,Rochester,6587
10381,1951-1952,1951-11-01,1952-04-14,166,0,195,622,817,104,418,522,1339,41,326,Minnesota,Rochester,6587
10382,1952-1953,1952-10-16,1953-04-19,186,1,140,547,687,71,480,551,1238,38,248,Minnesota,Rochester,6587
10383,1953-1954,1953-11-22,1954-05-03,163,0,119,488,607,41,95,136,743,25,150,Minnesota,Rochester,6587
10384,1954-1955,1954-10-29,1955-03-28,151,1,171,531,702,54,261,315,1017,34,219,Minnesota,Rochester,6587
10385,1955-1956,1955-10-29,1956-04-30,185,0,227,765,992,102,567,669,1661,49,352,Minnesota,Rochester,6587
10386,1956-1957,1956-11-15,1957-04-11,148,0,159,558,717,47,76,123,840,33,224,Minnesota,Rochester,6587
10387,1957-1958,1957-11-08,1958-03-16,129,1,148,444,592,38,125,163,755,21,102,Minnesota,Rochester,6587
10388,1958-1959,1958-11-23,1959-03-27,125,0,231,661,892,65,363,428,1320,33,289,Minnesota,Rochester,6587
10389,1959-1960,1959-10-26,1960-04-08,166,0,162,571,733,50,184,234,967,33,222,Minnesota,Rochester,6587
10390,1960-1961,1960-11-09,1961-04-18,161,0,161,498,659,61,156,217,876,35,214,Minnesota,Rochester,6587
10391,1961-1962,1961-09-30,1962-04-16,199,0,272,691,963,120,590,710,1673,54,447,Minnesota,Rochester,6587
10392,1962-1963,1962-10-24,1963-04-23,182,0,261,645,906,74,268,342,1248,47,415,Minnesota,Rochester,6587
10393,1963-1964,1963-11-23,1964-04-07,137,1,173,542,715,51,118,169,884,32,212,Minnesota,Rochester,6587
10394,1964-1965,1964-11-18,1965-04-26,160,0,293,718,1011,82,328,410,1421,47,395,Minnesota,Rochester,6587
10395,1965-1966,1965-11-18,1966-05-11,175,0,216,569,785,61,215,276,1061,37,304,Minnesota,Rochester,6587
10396,1966-1967,1966-10-15,1967-05-01,199,0,194,606,800,79,314,393,1193,45,339,Minnesota,Rochester,6587
10397,1967-1968,1967-11-04,1968-04-23,172,0,165,583,748,27,30,57,805,25,159,Minnesota,Rochester,6587
10398,1968-1969,1968-10-27,1969-04-28,184,0,214,639,853,78,670,748,1601,47,301,Minnesota,Rochester,6587
10399,1969-1970,1969-10-15,1970-04-20,188,0,224,704,928,102,714,816,1744,47,407,Minnesota,Rochester,6587
10400,1970-1971,1970-10-31,1971-04-03,155,0,239,637,876,100,699,799,1675,44,335,Minnesota,Rochester,6587
10401,1971-1972,1971-11-06,1972-04-22,169,0,233,668,901,71,457,528,1429,46,352,Minnesota,Rochester,6587
10402,1972-1973,1972-10-22,1973-05-02,193,0,198,564,762,84,332,416,1178,36,259,Minnesota,Rochester,6587
10403,1973-1974,1973-11-05,1974-04-04,151,0,219,575,794,69,450,519,1313,40,304,Minnesota,Rochester,6587
10404,1974-1975,1974-11-13,1975-04-10,149,0,186,594,780,88,640,728,1508,57,382,Minnesota,Rochester,6587
10405,1975-1976,1975-11-10,1976-05-02,175,0,128,516,644,54,169,223,867,35,206,Minnesota,Rochester,6587
10406,1976-1977,1976-10-18,1977-04-05,170,0,280,796,1076,67,239,306,1382,45,350,Minnesota,Rochester,6587
10407,1977-1978,1977-11-09,1978-04-20,163,0,312,748,1060,80,606,686,1746,47,441,Minnesota,Rochester,6587
10408,1978-1979,1978-11-12,1979-04-07,147,3,376,823,1199,108,865,973,2172,50,498,Minnesota,Rochester,6587
10409,1979-1980,1979-10-22,1980-04-12,174,0,167,545,712,91,269,360,1072,51,309,Minnesota,Rochester,6587
10410,1980-1981,1980-11-14,1981-04-04,142,0,146,460,606,46,114,160,766,26,221,Minnesota,Rochester,6587
10411,1981-1982,1981-10-22,1982-04-20,181,3,276,672,948,99,689,788,1736,45,400,Minnesota,Rochester,6587
10412,1982-1983,1982-10-20,1983-04-18,181,0,115,431,546,99,385,484,1030,49,263,Minnesota,Rochester,6587
10413,1983-1984,1983-11-09,1984-04-30,174,0,285,636,921,97,636,733,1654,45,349,Minnesota,Rochester,6587
10414,1984-1985,1984-11-02,1985-04-08,158,0,203,561,764,109,306,415,1179,52,404,Minnesota,Rochester,6587
10415,1985-1986,1985-11-08,1986-04-15,159,0,272,674,946,95,776,871,1817,50,438,Minnesota,Rochester,6587
10416,1986-1987,1986-11-09,1987-03-30,142,0,113,414,527,41,156,197,724,26,158,Minnesota,Rochester,6587
10417,1987-1988,1987-10-20,1988-04-29,193,0,214,595,809,99,424,523,1332,41,325,Minnesota,Rochester,6587
10418,1988-1989,1988-11-05,1989-05-06,183,0,191,608,799,81,263,344,1143,39,332,Minnesota,Rochester,6587
10419,1989-1990,1989-10-30,1990-04-05,158,0,152,544,696,62,177,239,935,39,294,Minnesota,Rochester,6587
10420,1990-1991,1990-10-17,1991-04-23,189,0,177,556,733,79,456,535,1268,50,312,Minnesota,Rochester,6587
10421,1991-1992,1991-10-05,1992-03-30,178,0,144,457,601,97,344,441,1042,48,327,Minnesota,Rochester,6587
10422,1992-1993,1992-10-19,1993-04-20,184,0,211,599,810,102,608,710,1520,55,331,Minnesota,Rochester,6587
10423,1993-1994,1993-11-05,1994-04-28,175,0,266,654,920,85,393,478,1398,45,414,Minnesota,Rochester,6587
10424,1994-1995,1994-11-27,1995-04-21,146,0,155,439,594,55,113,168,762,34,209,Minnesota,Rochester,6587
10425,1995-1996,1995-10-30,1996-04-15,169,0,250,677,927,93,350,443,1370,43,333,Minnesota,Rochester,6587
10426,1996-1997,1996-10-31,1997-05-15,197,0,263,656,919,143,694,837,1756,73,607,Minnesota,Rochester,6587
10427,1997-1998,1997-11-02,1998-03-21,140,0,132,374,506,65,194,259,765,33,190,Minnesota,Rochester,6587
10428,1998-1999,1998-11-04,1999-03-14,131,0,157,421,578,71,298,369,947,30,306,Minnesota,Rochester,6587
10429,1999-2000,1999-10-01,2000-04-11,194,0,122,441,563,63,261,324,887,30,203,Minnesota,Rochester,6587
10430,2000-2001,2000-11-08,2001-04-16,160,3,278,680,958,106,660,766,1724,47,403,Minnesota,Rochester,6587
10431,2001-2002,2001-11-30,2002-04-27,149,0,107,377,484,58,122,180,664,31,192,Minnesota,Rochester,6587
10432,2002-2003,2002-10-24,2003-04-08,167,0,184,574,758,46,116,162,920,28,193,Minnesota,Rochester,6587
10433,2003-2004,2003-11-03,2004-03-21,140,0,153,463,616,68,304,372,988,30,200,Minnesota,Rochester,6587
10434,2004-2005,2004-11-27,2005-04-01,126,0,148,440,588,84,243,327,915,29,204,Minnesota,Rochester,6587
10435,2005-2006,2005-11-15,2006-03-27,133,0,128,403,531,63,200,263,794,29,188,Minnesota,Rochester,6587
10436,2006-2007,2006-10-12,2007-04-13,184,0,173,486,659,88,329,417,1076,24,192,Minnesota,Rochester,6587
10437,2007-2008,2007-11-17,2008-04-12,148,1,228,563,791,72,486,558,1349,43,324,Minnesota,Rochester,6587
10438,2008-2009,2008-10-26,2009-04-05,162,0,210,628,838,79,450,529,1367,38,314,Minnesota,Rochester,6587
10439,2009-2010,2009-10-11,2010-03-14,155,0,203,502,705,83,703,786,1491,36,272,Minnesota,Rochester,6587
10440,2010-2011,2010-11-12,2011-04-20,160,0,225,555,780,114,789,903,1683,44,356,Minnesota,Rochester,6587
10441,2011-2012,2011-11-19,2012-03-04,107,0,70,293,363,39,85,124,487,27,148,Minnesota,Rochester,6587
10442,2012-2013,2012-11-12,2013-05-05,175,0,151,514,665,115,425,540,1205,43,287,Minnesota,Rochester,6587
10443,2013-2014,2013-11-11,2014-04-30,171,0,319,757,1076,94,625,719,1795,45,434,Minnesota,Rochester,6587
10444,2014-2015,2014-11-10,2015-04-09,151,0,238,580,818,73,443,516,1334,36,263,Minnesota,Rochester,6587
10445,2015-2016,2015-10-28,2016-04-08,164,0,131,378,509,73,333,406,915,33,198,Minnesota,Rochester,6587
10446,2016-2017,2016-11-19,2017-03-16,118,0,146,387,533,76,363,439,972,25,205,Minnesota,Rochester,6587
10447,2017-2018,2017-10-27,2018-04-20,176,0,213,612,825,99,305,404,1229,44,357,Minnesota,Rochester,6587
10448,2018-2019,2018-10-14,2019-04-27,196,0,249,628,877,133,533,666,1543,45,410,Minnesota,Rochester,6587
10449,2019-2020,2019-10-12,2020-04-17,189,0,154,516,670,95,408,503,1173,42,273,Minnesota,Rochester,6587
10450,1950-1951,1950-11-08,1951-04-15,159,0,309,876,1185,133,805,938,2123,61,601,Minnesota,St. Cloud,65842
10451,1951-1952,1951-10-30,1952-04-09,163,0,260,806,1066,90,763,853,1919,51,449,Minnesota,St. Cloud,65842
10452,1952-1953,1952-10-15,1953-04-19,187,0,184,646,830,76,355,431,1261,34,259,Minnesota,St. Cloud,65842
10453,1953-1954,1953-11-22,1954-05-03,163,0,193,667,860,65,363,428,1288,36,293,Minnesota,St. Cloud,65842
10454,1954-1955,1954-11-01,1955-03-27,147,0,209,691,900,52,318,370,1270,35,301,Minnesota,St. Cloud,65842
10455,1955-1956,1955-10-30,1956-04-08,162,0,295,870,1165,85,783,868,2033,46,393,Minnesota,St. Cloud,65842
10456,1956-1957,1956-11-15,1957-04-12,149,0,216,725,941,67,190,257,1198,32,300,Minnesota,St. Cloud,65842
10457,1957-1958,1957-10-25,1958-04-06,164,0,172,579,751,43,184,227,978,28,169,Minnesota,St. Cloud,65842
10458,1958-1959,1958-11-23,1959-04-11,140,0,258,733,991,33,28,61,1052,25,225,Minnesota,St. Cloud,65842
10459,1959-1960,1959-10-12,1960-04-08,180,0,211,750,961,52,269,321,1282,36,260,Minnesota,St. Cloud,65842
10460,1960-1961,1960-11-09,1961-04-25,168,0,172,622,794,46,65,111,905,30,211,Minnesota,St. Cloud,65842
10461,1961-1962,1961-11-02,1962-04-08,158,0,269,755,1024,92,650,742,1766,44,383,Minnesota,St. Cloud,65842
10462,1962-1963,1962-11-07,1963-04-23,168,0,257,702,959,62,144,206,1165,40,366,Minnesota,St. Cloud,65842
10463,1963-1964,1963-11-23,1964-04-14,144,0,207,662,869,53,245,298,1167,26,184,Minnesota,St. Cloud,65842
10464,1964-1965,1964-10-28,1965-04-26,181,0,329,910,1239,132,892,1024,2263,47,476,Minnesota,St. Cloud,65842
10465,1965-1966,1965-11-13,1966-04-29,168,0,257,671,928,52,224,276,1204,36,277,Minnesota,St. Cloud,65842
10466,1966-1967,1966-10-15,1967-04-06,174,0,247,791,1038,82,683,765,1803,40,351,Minnesota,St. Cloud,65842
10467,1967-1968,1967-10-27,1968-04-08,165,0,219,671,890,32,211,243,1133,25,174,Minnesota,St. Cloud,65842
10468,1968-1969,1968-11-07,1969-04-27,172,0,270,722,992,102,915,1017,2009,49,412,Minnesota,St. Cloud,65842
10469,1969-1970,1969-10-12,1970-04-23,194,0,267,801,1068,77,686,763,1831,47,403,Minnesota,St. Cloud,65842
10470,1970-1971,1970-10-09,1971-05-19,223,0,270,765,1035,90,463,553,1588,43,338,Minnesota,St. Cloud,65842
10471,1971-1972,1971-10-28,1972-04-22,178,0,300,820,1120,78,625,703,1823,46,374,Minnesota,St. Cloud,65842
10472,1972-1973,1972-10-18,1973-03-20,154,0,217,640,857,38,437,475,1332,17,147,Minnesota,St. Cloud,65842
10473,1973-1974,1973-11-04,1974-04-22,170,0,234,763,997,55,394,449,1446,38,271,Minnesota,St. Cloud,65842
10474,1974-1975,1974-11-04,1975-04-19,167,0,215,753,968,95,852,947,1915,48,390,Minnesota,St. Cloud,65842
10475,1975-1976,1975-11-11,1976-05-02,174,0,225,735,960,81,698,779,1739,30,261,Minnesota,St. Cloud,65842
10476,1976-1977,1976-10-18,1977-04-05,170,0,299,873,1172,50,254,304,1476,31,304,Minnesota,St. Cloud,65842
10477,1977-1978,1977-11-09,1978-04-20,163,0,306,824,1130,68,428,496,1626,38,339,Minnesota,St. Cloud,65842
10478,1978-1979,1978-11-12,1979-05-04,174,0,368,962,1330,104,899,1003,2333,52,527,Minnesota,St. Cloud,65842
10479,1979-1980,1979-11-08,1980-04-09,154,0,193,694,887,71,339,410,1297,38,275,Minnesota,St. Cloud,65842
10480,1980-1981,1980-11-24,1981-04-04,132,0,166,534,700,33,55,88,788,24,185,Minnesota,St. Cloud,65842
10481,1981-1982,1981-10-23,1982-04-06,166,0,322,836,1158,86,634,720,1878,45,439,Minnesota,St. Cloud,65842
10482,1982-1983,1982-10-19,1983-04-14,178,0,149,553,702,89,410,499,1201,43,222,Minnesota,St. Cloud,65842
10483,1983-1984,1983-10-12,1984-04-30,202,0,290,763,1053,95,798,893,1946,40,361,Minnesota,St. Cloud,65842
10484,1984-1985,1984-10-30,1985-04-01,154,0,232,702,934,74,233,307,1241,35,322,Minnesota,St. Cloud,65842
10485,1985-1986,1985-11-08,1986-03-28,141,0,305,749,1054,89,808,897,1951,42,418,Minnesota,St. Cloud,65842
10486,1986-1987,1986-10-14,1987-03-29,167,0,112,509,621,29,60,89,710,19,118,Minnesota,St. Cloud,65842
10487,1987-1988,1987-10-20,1988-04-09,173,0,215,678,893,60,354,414,1307,42,303,Minnesota,St. Cloud,65842
10488,1988-1989,1988-10-23,1989-04-18,178,5,237,792,1029,98,647,745,1774,40,362,Minnesota,St. Cloud,65842
10489,1989-1990,1989-11-02,1990-04-29,179,0,181,692,873,57,146,203,1076,32,267,Minnesota,St. Cloud,65842
10490,1990-1991,1990-11-25,1991-05-05,162,0,191,633,824,73,271,344,1168,34,277,Minnesota,St. Cloud,65842
10491,1991-1992,1991-10-30,1992-04-12,166,0,158,584,742,85,492,577,1319,35,296,Minnesota,St. Cloud,65842
10492,1992-1993,1992-10-15,1993-04-14,182,0,210,718,928,93,572,665,1593,44,296,Minnesota,St. Cloud,65842
10493,1993-1994,1993-10-30,1994-04-30,183,0,289,784,1073,101,607,708,1781,49,471,Minnesota,St. Cloud,65842
10494,1994-1995,1994-11-26,1995-04-18,144,0,167,612,779,67,513,580,1359,29,218,Minnesota,St. Cloud,65842
10495,1995-1996,1995-09-21,1996-04-14,207,0,315,864,1179,98,655,753,1932,47,375,Minnesota,St. Cloud,65842
10496,1999-2000,1999-11-23,2000-04-16,146,0,131,523,654,42,224,266,920,19,147,Minnesota,St. Cloud,65842
10497,2000-2001,2000-11-08,2001-04-06,150,3,301,776,1077,88,874,962,2039,47,415,Minnesota,St. Cloud,65842
10498,2001-2002,2001-10-24,2002-04-28,187,0,138,510,648,90,307,397,1045,26,217,Minnesota,St. Cloud,65842
10499,2002-2003,2002-10-17,2003-04-16,182,0,216,680,896,53,120,173,1069,32,253,Minnesota,St. Cloud,65842
10500,2003-2004,2003-11-03,2004-03-21,140,0,204,577,781,78,304,382,1163,41,326,Minnesota,St. Cloud,65842
10501,2004-2005,2004-11-25,2005-05-01,158,0,167,548,715,55,219,274,989,34,205,Minnesota,St. Cloud,65842
10502,2005-2006,2005-11-15,2006-03-23,129,0,143,469,612,57,347,404,1016,35,208,Minnesota,St. Cloud,65842
10503,2006-2007,2006-11-01,2007-04-11,162,0,176,557,733,51,170,221,954,26,176,Minnesota,St. Cloud,65842
10504,2007-2008,2007-11-21,2008-04-26,158,0,268,727,995,82,587,669,1664,36,285,Minnesota,St. Cloud,65842
10505,2008-2009,2008-11-09,2009-04-05,148,0,265,788,1053,85,569,654,1707,35,363,Minnesota,St. Cloud,65842
10506,2009-2010,2009-10-10,2010-03-13,155,0,205,574,779,48,517,565,1344,26,184,Minnesota,St. Cloud,65842
10507,2010-2011,2010-11-13,2011-04-20,159,0,270,695,965,107,719,826,1791,49,453,Minnesota,St. Cloud,65842
10508,2011-2012,2011-11-16,2012-03-11,117,0,84,394,478,46,152,198,676,24,145,Minnesota,St. Cloud,65842
10509,2012-2013,2012-10-25,2013-04-23,181,0,200,704,904,124,716,840,1744,50,382,Minnesota,St. Cloud,65842
10510,2013-2014,2013-10-20,2014-04-19,182,0,357,904,1261,117,844,961,2222,50,537,Minnesota,St. Cloud,65842
10511,2014-2015,2014-11-10,2015-04-10,152,0,236,599,835,57,213,270,1105,34,255,Minnesota,St. Cloud,65842
10512,2015-2016,2015-10-28,2016-04-08,164,0,136,419,555,55,206,261,816,33,204,Minnesota,St. Cloud,65842
10513,2016-2017,2016-11-18,2017-05-01,165,0,158,467,625,49,188,237,862,26,203,Minnesota,St. Cloud,65842
10514,2017-2018,2017-10-27,2018-04-20,176,0,238,737,975,94,374,468,1443,39,333,Minnesota,St. Cloud,65842
10515,2018-2019,2018-11-06,2019-05-09,185,0,274,747,1021,98,596,694,1715,40,363,Minnesota,St. Cloud,65842
10516,2019-2020,2019-10-11,2020-04-14,187,0,175,600,775,73,526,599,1374,37,253,Minnesota,St. Cloud,65842
10517,1950-1951,1950-11-10,1951-04-13,155,3,270,766,1036,133,852,985,2021,40,424,Minnesota,Winnebago,1437
10518,1951-1952,1951-11-01,1952-04-13,165,1,197,631,828,93,464,557,1385,32,284,Minnesota,Winnebago,1437
10519,1952-1953,1952-11-25,1953-04-16,143,1,150,487,637,72,610,682,1319,24,213,Minnesota,Winnebago,1437
10520,1953-1954,1953-11-23,1954-05-03,162,0,137,521,658,42,87,129,787,22,154,Minnesota,Winnebago,1437
10521,1954-1955,1954-11-02,1955-03-29,148,0,176,566,742,66,368,434,1176,27,247,Minnesota,Winnebago,1437
10522,1955-1956,1955-11-04,1956-05-01,180,0,271,780,1051,98,646,744,1795,35,329,Minnesota,Winnebago,1437
10523,1956-1957,1956-11-16,1957-04-12,148,0,161,579,740,55,128,183,923,24,215,Minnesota,Winnebago,1437
10524,1957-1958,1957-10-26,1958-04-07,164,0,148,492,640,43,152,195,835,21,123,Minnesota,Winnebago,1437
10525,1958-1959,1958-11-24,1959-03-29,126,1,222,664,886,70,293,363,1249,23,238,Minnesota,Winnebago,1437
10526,1959-1960,1959-10-13,1960-03-27,167,0,184,615,799,66,295,361,1160,20,176,Minnesota,Winnebago,1437
10527,1960-1961,1960-11-10,1961-04-18,160,0,155,550,705,79,326,405,1110,20,190,Minnesota,Winnebago,1437
10528,1961-1962,1961-10-01,1962-04-16,198,0,252,713,965,116,770,886,1851,35,338,Minnesota,Winnebago,1437
10529,1962-1963,1962-11-18,1963-04-23,157,1,233,593,826,65,385,450,1276,34,326,Minnesota,Winnebago,1437
10530,1963-1964,1963-11-24,1964-03-30,128,1,168,555,723,45,146,191,914,21,177,Minnesota,Winnebago,1437
10531,1964-1965,1964-11-20,1965-04-26,158,0,300,784,1084,108,683,791,1875,30,339,Minnesota,Winnebago,1437
10532,1965-1966,1965-11-17,1966-05-12,177,3,226,615,841,56,243,299,1140,21,196,Minnesota,Winnebago,1437
10533,1966-1967,1966-10-15,1967-03-22,159,1,198,658,856,90,511,601,1457,30,316,Minnesota,Winnebago,1437
10534,1967-1968,1967-10-27,1968-04-04,161,0,186,606,792,27,71,98,890,14,109,Minnesota,Winnebago,1437
10535,1968-1969,1968-11-08,1969-04-03,147,0,261,687,948,93,841,934,1882,27,244,Minnesota,Winnebago,1437
10536,1969-1970,1969-10-27,1970-04-14,170,0,255,739,994,80,740,820,1814,18,187,Minnesota,Winnebago,1437
10537,1970-1971,1970-10-10,1971-04-02,175,0,246,698,944,82,591,673,1617,22,210,Minnesota,Winnebago,1437
10538,1971-1972,1971-11-07,1972-04-08,154,1,241,671,912,77,493,570,1482,32,289,Minnesota,Winnebago,1437
10539,1972-1973,1972-10-18,1973-04-10,175,0,195,537,732,78,457,535,1267,25,229,Minnesota,Winnebago,1437
10540,1973-1974,1973-11-05,1974-04-05,152,0,215,589,804,60,406,466,1270,26,268,Minnesota,Winnebago,1437
10541,1974-1975,1974-11-05,1975-04-13,160,0,199,618,817,89,789,878,1695,29,232,Minnesota,Winnebago,1437
10542,1975-1976,1975-11-10,1976-03-22,134,0,157,471,628,43,114,157,785,20,134,Minnesota,Winnebago,1437
10543,1976-1977,1976-10-19,1977-04-05,169,0,242,700,942,57,274,331,1273,25,248,Minnesota,Winnebago,1437
10544,1977-1978,1977-10-11,1978-04-21,193,1,311,753,1064,90,649,739,1803,33,355,Minnesota,Winnebago,1437
10545,1978-1979,1978-11-12,1979-04-07,147,0,367,826,1193,105,965,1070,2263,37,382,Minnesota,Winnebago,1437
10546,1979-1980,1979-11-09,1980-04-10,154,3,174,563,737,55,234,289,1026,23,180,Minnesota,Winnebago,1437
10547,1980-1981,1980-11-14,1981-04-04,142,0,144,513,657,27,75,102,759,15,150,Minnesota,Winnebago,1437
10548,1981-1982,1981-10-24,1982-04-11,170,3,284,723,1007,96,680,776,1783,30,290,Minnesota,Winnebago,1437
10549,1982-1983,1982-10-20,1983-04-18,181,15,132,476,608,103,612,715,1323,30,219,Minnesota,Winnebago,1437
10550,1983-1984,1983-11-09,1984-05-01,175,1,270,707,977,136,1055,1191,2168,31,326,Minnesota,Winnebago,1437
10551,1984-1985,1984-11-02,1985-04-05,155,3,199,536,735,90,297,387,1122,28,228,Minnesota,Winnebago,1437
10552,1986-1987,1986-11-02,1987-03-29,148,1,90,402,492,24,60,84,576,15,83,Minnesota,Winnebago,1437
10553,1987-1988,1987-11-18,1988-04-27,162,1,219,593,812,64,504,568,1380,23,221,Minnesota,Winnebago,1437
10554,1989-1990,1989-11-15,1990-03-19,125,9,156,531,687,19,76,95,782,10,84,Minnesota,Winnebago,1437
10555,1990-1991,1990-11-04,1991-03-30,147,0,197,572,769,51,336,387,1156,20,188,Minnesota,Winnebago,1437
10556,1991-1992,1991-10-19,1992-04-13,178,3,137,465,602,69,320,389,991,29,207,Minnesota,Winnebago,1437
10557,1992-1993,1992-11-02,1993-04-01,151,1,236,592,828,69,521,590,1418,29,206,Minnesota,Winnebago,1437
10558,1993-1994,1993-10-30,1994-04-29,182,0,288,695,983,87,495,582,1565,31,369,Minnesota,Winnebago,1437
10559,1994-1995,1994-11-28,1995-04-11,135,0,156,465,621,35,162,197,818,12,95,Minnesota,Winnebago,1437
10560,1995-1996,1995-11-01,1996-04-15,167,1,260,674,934,59,346,405,1339,20,191,Minnesota,Winnebago,1437
10561,1996-1997,1996-10-31,1997-04-09,161,1,282,666,948,70,654,724,1672,28,262,Minnesota,Winnebago,1437
10562,1997-1998,1997-11-03,1998-03-19,137,0,148,406,554,60,250,310,864,27,186,Minnesota,Winnebago,1437
10563,1998-1999,1998-11-07,1999-04-16,161,1,149,450,599,63,313,376,975,21,214,Minnesota,Winnebago,1437
10564,1999-2000,1999-12-01,2000-04-08,130,4,91,413,504,50,240,290,794,21,164,Minnesota,Winnebago,1437
10565,2000-2001,2000-11-08,2001-04-02,146,9,268,719,987,83,766,849,1836,32,326,Minnesota,Winnebago,1437
10566,2001-2002,2001-11-30,2002-04-04,126,8,109,404,513,33,124,157,670,14,85,Minnesota,Winnebago,1437
10567,2004-2005,2004-11-27,2005-03-25,119,18,132,424,556,39,113,152,708,14,107,Minnesota,Winnebago,1437
10568,2005-2006,2005-11-16,2006-03-25,130,14,126,434,560,61,275,336,896,27,199,Minnesota,Winnebago,1437
10569,2007-2008,2007-11-22,2008-04-01,132,6,227,589,816,52,460,512,1328,27,226,Minnesota,Winnebago,1437
10570,2008-2009,2008-11-07,2009-04-05,150,2,203,644,847,76,398,474,1321,27,261,Minnesota,Winnebago,1437
10571,2009-2010,2009-10-12,2010-03-15,155,1,219,569,788,87,721,808,1596,28,261,Minnesota,Winnebago,1437
10572,2011-2012,2011-11-20,2012-03-05,107,18,72,324,396,27,93,120,516,12,90,Minnesota,Winnebago,1437
10573,2012-2013,2012-11-12,2013-05-02,172,1,162,574,736,77,275,352,1088,19,139,Minnesota,Winnebago,1437
10574,2013-2014,2013-11-06,2014-04-05,151,3,290,749,1039,81,514,595,1634,29,324,Minnesota,Winnebago,1437
10575,2014-2015,2014-11-11,2015-03-25,135,1,209,560,769,56,311,367,1136,16,166,Minnesota,Winnebago,1437
10576,2015-2016,2015-11-21,2016-03-25,126,0,127,369,496,58,352,410,906,19,140,Minnesota,Winnebago,1437
10577,2016-2017,2016-11-20,2017-03-18,119,0,134,393,527,59,306,365,892,12,128,Minnesota,Winnebago,1437
10578,2017-2018,2017-11-07,2018-04-22,167,0,228,637,865,147,573,720,1585,29,354,Minnesota,Winnebago,1437
10579,2018-2019,2018-10-14,2019-04-28,197,0,248,652,900,116,650,766,1666,29,342,Minnesota,Winnebago,1437
10580,2019-2020,2019-10-31,2020-04-15,168,0,131,492,623,71,555,626,1249,17,150,Minnesota,Winnebago,1437
10581,1950-1951,1950-11-24,1951-03-20,117,4,10,94,104,10,26,36,140,8,27,Mississippi,Cleveland,396815
10582,1951-1952,1951-12-01,1952-02-29,91,0,0,32,32,3,0,3,35,1,4,Mississippi,Cleveland,396815
10583,1952-1953,1952-12-01,1953-02-28,90,0,0,36,36,0,0,0,36,0,0,Mississippi,Cleveland,396815
10584,1953-1954,1953-12-01,1954-02-28,90,0,1,47,48,4,1,5,53,3,8,Mississippi,Cleveland,396815
10585,1954-1955,1954-12-01,1955-02-28,90,12,0,59,59,1,1,2,61,1,3,Mississippi,Cleveland,396815
10586,1955-1956,1955-12-01,1956-03-08,99,4,0,62,62,2,0,2,64,2,4,Mississippi,Cleveland,396815
10587,1956-1957,1956-12-01,1957-02-28,90,1,1,29,30,0,0,0,30,0,0,Mississippi,Cleveland,396815
10588,1957-1958,1957-12-01,1958-02-28,90,2,4,75,79,4,3,7,86,1,5,Mississippi,Cleveland,396815
10589,1958-1959,1958-12-01,1959-02-28,90,3,5,73,78,10,14,24,102,2,19,Mississippi,Cleveland,396815
10590,1959-1960,1959-12-01,1960-03-06,97,11,5,72,77,14,1,15,92,6,21,Mississippi,Cleveland,396815
10591,1960-1961,1960-12-01,1961-02-28,90,7,5,91,96,3,0,3,99,2,8,Mississippi,Cleveland,396815
10592,1961-1962,1961-12-01,1962-02-28,90,6,8,81,89,14,24,38,127,2,29,Mississippi,Cleveland,396815
10593,1962-1963,1962-12-01,1963-02-28,90,1,6,117,123,6,3,9,132,3,16,Mississippi,Cleveland,396815
10594,1963-1964,1963-12-01,1964-02-29,91,4,6,101,107,2,26,28,135,1,5,Mississippi,Cleveland,396815
10595,1964-1965,1964-12-01,1965-03-08,98,1,4,65,69,13,6,19,88,6,24,Mississippi,Cleveland,396815
10596,1965-1966,1965-12-01,1966-02-28,90,5,4,80,84,33,34,67,151,5,41,Mississippi,Cleveland,396815
10597,1966-1967,1966-12-01,1967-03-07,97,3,2,71,73,1,2,3,76,1,2,Mississippi,Cleveland,396815
10598,1967-1968,1967-12-01,1968-03-24,115,3,4,83,87,25,25,50,137,5,36,Mississippi,Cleveland,396815
10599,1968-1969,1968-12-01,1969-02-28,90,1,2,64,66,1,0,1,67,1,1,Mississippi,Cleveland,396815
10600,1969-1970,1969-12-01,1970-02-28,90,5,7,75,82,5,3,8,90,3,15,Mississippi,Cleveland,396815
10601,1970-1971,1970-12-01,1971-04-07,128,3,5,79,84,9,7,16,100,4,16,Mississippi,Cleveland,396815
10602,1971-1972,1971-12-01,1972-02-29,91,1,4,47,51,0,0,0,51,0,0,Mississippi,Cleveland,396815
10603,1972-1973,1972-12-01,1973-02-28,90,1,5,75,80,3,1,4,84,2,6,Mississippi,Cleveland,396815
10604,1973-1974,1973-12-01,1974-02-28,90,0,5,54,59,0,0,0,59,0,0,Mississippi,Cleveland,396815
10605,1974-1975,1974-12-01,1975-02-28,90,0,1,58,59,8,7,15,74,2,15,Mississippi,Cleveland,396815
10606,1975-1976,1975-11-23,1976-02-29,99,1,2,78,80,2,1,3,83,1,3,Mississippi,Cleveland,396815
10607,1976-1977,1976-11-29,1977-02-28,92,0,12,118,130,5,10,15,145,2,13,Mississippi,Cleveland,396815
10608,1977-1978,1977-12-01,1978-02-28,90,0,17,114,131,14,13,27,158,7,34,Mississippi,Cleveland,396815
10609,1978-1979,1978-12-01,1979-02-28,90,3,13,98,111,3,1,4,115,2,6,Mississippi,Cleveland,396815
10610,1979-1980,1979-12-01,1980-03-02,93,2,4,66,70,3,4,7,77,1,6,Mississippi,Cleveland,396815
10611,1980-1981,1980-12-01,1981-02-28,90,0,2,79,81,0,0,0,81,0,0,Mississippi,Cleveland,396815
10612,1981-1982,1981-12-01,1982-02-28,90,2,8,86,94,4,9,13,107,1,8,Mississippi,Cleveland,396815
10613,1982-1983,1982-12-01,1983-02-28,90,3,1,41,42,1,1,2,44,1,3,Mississippi,Cleveland,396815
10614,1983-1984,1983-12-01,1984-03-11,102,20,18,102,120,2,6,8,128,2,4,Mississippi,Cleveland,396815
10615,1984-1985,1984-12-01,1985-02-28,90,13,7,87,94,10,9,19,113,5,31,Mississippi,Cleveland,396815
10616,1985-1986,1985-12-01,1986-02-28,90,2,2,71,73,2,0,2,75,1,3,Mississippi,Cleveland,396815
10617,1986-1987,1986-12-01,1987-02-28,90,12,1,31,32,1,0,1,33,1,3,Mississippi,Cleveland,396815
10618,2004-2005,2004-12-01,2005-02-28,90,0,2,50,52,0,0,0,52,0,0,Mississippi,Cleveland,396815
10619,2005-2006,2005-12-01,2006-02-28,90,0,3,55,58,1,0,1,59,1,2,Mississippi,Cleveland,396815
10620,2006-2007,2006-12-01,2007-02-28,90,0,3,63,66,1,0,1,67,1,2,Mississippi,Cleveland,396815
10621,2007-2008,2007-12-01,2008-03-08,99,2,2,56,58,7,4,11,69,1,9,Mississippi,Cleveland,396815
10622,2008-2009,2008-12-01,2009-03-01,91,0,1,63,64,1,1,2,66,1,2,Mississippi,Cleveland,396815
10623,2009-2010,2009-12-01,2010-02-28,90,4,7,84,91,5,0,5,96,5,17,Mississippi,Cleveland,396815
10624,2010-2011,2010-12-01,2011-02-28,90,0,7,84,91,13,15,28,119,2,20,Mississippi,Cleveland,396815
10625,2011-2012,2011-12-01,2012-02-29,91,0,1,35,36,1,0,1,37,1,2,Mississippi,Cleveland,396815
10626,2012-2013,2012-12-01,2013-02-28,90,0,2,36,38,0,0,0,38,0,0,Mississippi,Cleveland,396815
10627,2013-2014,2013-12-01,2014-03-05,95,0,15,107,122,4,0,4,126,4,16,Mississippi,Cleveland,396815
10628,2014-2015,2014-12-01,2015-03-06,96,1,5,71,76,14,11,25,101,4,23,Mississippi,Cleveland,396815
10629,2015-2016,2015-12-01,2016-02-29,91,0,1,36,37,1,0,1,38,1,2,Mississippi,Cleveland,396815
10630,2016-2017,2016-12-01,2017-02-28,90,0,4,40,44,0,0,0,44,0,0,Mississippi,Cleveland,396815
10631,2017-2018,2017-12-01,2018-02-28,90,1,13,79,92,5,7,12,104,3,17,Mississippi,Cleveland,396815
10632,2018-2019,2018-11-14,2019-03-05,112,0,2,36,38,2,0,2,40,2,5,Mississippi,Cleveland,396815
10633,2019-2020,2019-11-13,2020-02-29,109,0,1,33,34,2,0,2,36,2,4,Mississippi,Cleveland,396815
10634,1950-1951,1950-11-24,1951-03-20,117,3,11,108,119,17,40,57,176,7,48,Mississippi,Oxford,18916
10635,1951-1952,1951-12-01,1952-02-29,91,1,1,37,38,0,2,2,40,0,0,Mississippi,Oxford,18916
10636,1952-1953,1952-12-01,1953-02-28,90,0,1,40,41,0,0,0,41,0,0,Mississippi,Oxford,18916
10637,1953-1954,1953-12-01,1954-02-28,90,3,1,45,46,0,6,6,52,0,0,Mississippi,Oxford,18916
10638,1954-1955,1954-12-01,1955-02-28,90,1,0,58,58,4,2,6,64,2,7,Mississippi,Oxford,18916
10639,1955-1956,1955-12-01,1956-02-29,91,2,0,61,61,3,0,3,64,1,5,Mississippi,Oxford,18916
10640,1956-1957,1956-12-01,1957-02-28,90,5,2,33,35,0,0,0,35,0,0,Mississippi,Oxford,18916
10641,1957-1958,1957-12-01,1958-02-28,90,4,5,97,102,4,0,4,106,1,5,Mississippi,Oxford,18916
10642,1958-1959,1958-12-01,1959-02-28,90,6,3,91,94,6,0,6,100,2,15,Mississippi,Oxford,18916
10643,1959-1960,1959-12-01,1960-03-02,93,15,0,60,60,9,0,9,69,2,11,Mississippi,Oxford,18916
10644,1960-1961,1960-12-01,1961-02-28,90,1,6,121,127,0,0,0,127,0,0,Mississippi,Oxford,18916
10645,1961-1962,1961-12-01,1962-03-06,96,0,14,95,109,11,20,31,140,2,20,Mississippi,Oxford,18916
10646,1962-1963,1962-12-01,1963-02-28,90,0,17,165,182,5,1,6,188,3,11,Mississippi,Oxford,18916
10647,1963-1964,1963-12-01,1964-02-29,91,9,9,164,173,11,5,16,189,2,19,Mississippi,Oxford,18916
10648,1964-1965,1964-12-01,1965-02-28,90,0,5,116,121,6,5,11,132,2,15,Mississippi,Oxford,18916
10649,1965-1966,1965-12-01,1966-02-28,90,0,12,123,135,22,31,53,188,4,33,Mississippi,Oxford,18916
10650,1966-1967,1966-12-01,1967-02-28,90,1,3,120,123,0,1,1,124,0,0,Mississippi,Oxford,18916
10651,1967-1968,1967-12-01,1968-03-23,114,0,7,154,161,29,26,55,216,6,43,Mississippi,Oxford,18916
10652,1968-1969,1968-12-01,1969-02-28,90,0,1,109,110,0,0,0,110,0,0,Mississippi,Oxford,18916
10653,1969-1970,1969-12-01,1970-02-28,90,0,11,142,153,0,1,1,154,0,0,Mississippi,Oxford,18916
10654,1970-1971,1970-11-25,1971-02-28,96,0,10,122,132,4,5,9,141,1,7,Mississippi,Oxford,18916
10655,1971-1972,1971-12-01,1972-02-29,91,0,4,90,94,0,0,0,94,0,0,Mississippi,Oxford,18916
10656,1972-1973,1972-12-01,1973-02-28,90,0,6,96,102,2,1,3,105,2,4,Mississippi,Oxford,18916
10657,1973-1974,1973-12-01,1974-02-28,90,0,6,78,84,0,0,0,84,0,0,Mississippi,Oxford,18916
10658,1974-1975,1974-12-01,1975-02-28,90,0,3,82,85,5,6,11,96,2,12,Mississippi,Oxford,18916
10659,1975-1976,1975-12-01,1976-02-29,91,0,4,119,123,0,0,0,123,0,0,Mississippi,Oxford,18916
10660,1976-1977,1976-11-29,1977-02-28,92,0,18,212,230,4,4,8,238,3,20,Mississippi,Oxford,18916
10661,1977-1978,1977-12-01,1978-03-04,94,2,17,196,213,10,4,14,227,5,23,Mississippi,Oxford,18916
10662,1978-1979,1978-12-01,1979-02-28,90,4,11,162,173,0,5,5,178,0,0,Mississippi,Oxford,18916
10663,1979-1980,1979-12-01,1980-03-03,94,3,9,122,131,5,2,7,138,3,10,Mississippi,Oxford,18916
10664,1980-1981,1980-12-01,1981-02-28,90,1,4,164,168,0,0,0,168,0,0,Mississippi,Oxford,18916
10665,1981-1982,1981-12-01,1982-02-28,90,1,14,148,162,4,9,13,175,1,7,Mississippi,Oxford,18916
10666,1982-1983,1982-12-01,1983-02-28,90,1,0,90,90,3,2,5,95,1,4,Mississippi,Oxford,18916
10667,1983-1984,1983-12-01,1984-03-10,101,2,18,192,210,6,4,10,220,2,9,Mississippi,Oxford,18916
10668,1984-1985,1984-12-01,1985-02-28,90,1,18,156,174,26,40,66,240,6,50,Mississippi,Oxford,18916
10669,1985-1986,1985-12-01,1986-02-28,90,1,10,156,166,4,4,8,174,2,12,Mississippi,Oxford,18916
10670,1986-1987,1986-12-01,1987-02-28,90,8,1,83,84,0,0,0,84,0,0,Mississippi,Oxford,18916
10671,1989-1990,1989-12-01,1990-02-28,90,3,12,83,95,0,1,1,96,0,0,Mississippi,Oxford,18916
10672,1990-1991,1990-12-01,1991-02-28,90,9,1,62,63,0,0,0,63,0,0,Mississippi,Oxford,18916
10673,1992-1993,1992-12-01,1993-03-14,104,4,1,81,82,0,0,0,82,0,0,Mississippi,Oxford,18916
10674,1994-1995,1994-12-01,1995-02-28,90,15,0,58,58,6,3,9,67,3,12,Mississippi,Oxford,18916
10675,1996-1997,1996-12-01,1997-02-28,90,1,3,84,87,0,0,0,87,0,0,Mississippi,Oxford,18916
10676,1997-1998,1997-12-01,1998-02-28,90,3,0,55,55,4,5,9,64,1,5,Mississippi,Oxford,18916
10677,1998-1999,1998-12-01,1999-02-28,90,0,6,68,74,2,0,2,76,2,8,Mississippi,Oxford,18916
10678,1999-2000,1999-12-01,2000-02-29,91,9,0,83,83,7,5,12,95,1,8,Mississippi,Oxford,18916
10679,2000-2001,2000-12-01,2001-02-28,90,1,5,134,139,3,1,4,143,2,12,Mississippi,Oxford,18916
10680,2001-2002,2001-12-01,2002-02-28,90,5,0,70,70,0,0,0,70,0,0,Mississippi,Oxford,18916
10681,2002-2003,2002-12-01,2003-02-28,90,0,2,102,104,1,0,1,105,1,2,Mississippi,Oxford,18916
10682,2003-2004,2003-12-01,2004-02-29,91,0,0,83,83,2,1,3,86,1,2,Mississippi,Oxford,18916
10683,2004-2005,2004-12-01,2005-02-28,90,0,2,69,71,1,0,1,72,1,4,Mississippi,Oxford,18916
10684,2005-2006,2005-12-01,2006-02-28,90,11,1,89,90,1,0,1,91,1,2,Mississippi,Oxford,18916
10685,2006-2007,2006-12-01,2007-02-28,90,12,0,85,85,1,1,2,87,1,2,Mississippi,Oxford,18916
10686,2008-2009,2008-12-01,2009-03-01,91,8,2,80,82,3,2,5,87,1,4,Mississippi,Oxford,18916
10687,2009-2010,2009-12-01,2010-02-28,90,7,7,111,118,4,4,8,126,4,18,Mississippi,Oxford,18916
10688,2015-2016,2015-12-01,2016-02-29,91,0,0,63,63,3,3,6,69,2,5,Mississippi,Oxford,18916
10689,2016-2017,2016-12-01,2017-02-28,90,4,2,58,60,1,0,1,61,1,3,Mississippi,Oxford,18916
10690,2017-2018,2017-12-01,2018-02-28,90,2,7,109,116,4,2,6,122,4,20,Mississippi,Oxford,18916
10691,2018-2019,2018-11-15,2019-02-28,106,2,1,70,71,1,1,2,73,1,2,Mississippi,Oxford,18916
10692,2019-2020,2019-12-01,2020-02-29,91,2,0,51,51,1,1,2,53,1,3,Mississippi,Oxford,18916
10693,1950-1951,1950-11-25,1951-02-28,96,19,9,85,94,5,3,8,102,2,12,Mississippi,Tupelo,34546
10694,1951-1952,1951-12-01,1952-02-29,91,6,1,33,34,0,0,0,34,0,0,Mississippi,Tupelo,34546
10695,1952-1953,1952-12-01,1953-02-28,90,6,1,25,26,0,0,0,26,0,0,Mississippi,Tupelo,34546
10696,1953-1954,1953-12-01,1954-02-28,90,0,2,47,49,0,0,0,49,0,0,Mississippi,Tupelo,34546
10697,1954-1955,1954-12-01,1955-02-28,90,4,1,52,53,0,0,0,53,0,0,Mississippi,Tupelo,34546
10698,1955-1956,1955-12-01,1956-02-29,91,1,0,45,45,0,0,0,45,0,0,Mississippi,Tupelo,34546
10699,1956-1957,1956-12-01,1957-02-28,90,6,1,26,27,0,0,0,27,0,0,Mississippi,Tupelo,34546
10700,1958-1959,1958-12-01,1959-02-28,90,18,3,68,71,0,0,0,71,0,0,Mississippi,Tupelo,34546
10701,1960-1961,1960-12-01,1961-02-28,90,8,5,87,92,0,0,0,92,0,0,Mississippi,Tupelo,34546
10702,1961-1962,1961-12-01,1962-02-28,90,17,8,63,71,0,0,0,71,0,0,Mississippi,Tupelo,34546
10703,1962-1963,1962-12-01,1963-02-28,90,1,12,142,154,0,0,0,154,0,0,Mississippi,Tupelo,34546
10704,1963-1964,1963-12-01,1964-02-29,91,7,8,101,109,0,8,8,117,0,0,Mississippi,Tupelo,34546
10705,1964-1965,1964-12-01,1965-02-28,90,4,5,85,90,0,0,0,90,0,0,Mississippi,Tupelo,34546
10706,1965-1966,1965-12-01,1966-02-28,90,9,5,74,79,0,0,0,79,0,0,Mississippi,Tupelo,34546
10707,1966-1967,1966-12-01,1967-02-28,90,0,1,70,71,0,0,0,71,0,0,Mississippi,Tupelo,34546
10708,1967-1968,1967-12-01,1968-03-22,113,13,3,80,83,9,4,13,96,1,10,Mississippi,Tupelo,34546
10709,1968-1969,1968-12-01,1969-02-28,90,0,2,59,61,0,0,0,61,0,0,Mississippi,Tupelo,34546
10710,1969-1970,1969-11-14,1970-02-28,107,5,7,138,145,4,0,4,149,2,8,Mississippi,Tupelo,34546
10711,1971-1972,1971-12-01,1972-02-29,91,0,1,65,66,0,0,0,66,0,0,Mississippi,Tupelo,34546
10712,1972-1973,1972-12-01,1973-02-28,90,1,4,89,93,0,0,0,93,0,0,Mississippi,Tupelo,34546
10713,1973-1974,1973-12-01,1974-02-28,90,0,0,64,64,0,0,0,64,0,0,Mississippi,Tupelo,34546
10714,1974-1975,1974-12-01,1975-02-28,90,0,1,77,78,2,0,2,80,1,3,Mississippi,Tupelo,34546
10715,1975-1976,1975-12-01,1976-02-29,91,0,0,103,103,0,0,0,103,0,0,Mississippi,Tupelo,34546
10716,1976-1977,1976-12-01,1977-02-28,90,4,7,187,194,3,0,3,197,1,9,Mississippi,Tupelo,34546
10717,1978-1979,1978-12-01,1979-02-28,90,0,3,146,149,2,1,3,152,1,3,Mississippi,Tupelo,34546
10718,1980-1981,1980-12-01,1981-02-28,90,4,0,139,139,0,0,0,139,0,0,Mississippi,Tupelo,34546
10719,1982-1983,1982-12-01,1983-02-28,90,5,0,65,65,3,0,3,68,2,5,Mississippi,Tupelo,34546
10720,1983-1984,1983-12-01,1984-03-10,101,0,16,118,134,9,6,15,149,6,17,Mississippi,Tupelo,34546
10721,1984-1985,1984-12-01,1985-02-28,90,0,11,104,115,14,29,43,158,8,43,Mississippi,Tupelo,34546
10722,1985-1986,1985-12-01,1986-02-28,90,0,7,95,102,3,2,5,107,2,9,Mississippi,Tupelo,34546
10723,1986-1987,1986-12-01,1987-04-02,123,0,1,47,48,3,0,3,51,3,3,Mississippi,Tupelo,34546
10724,1987-1988,1987-12-01,1988-02-29,91,0,8,90,98,12,24,36,134,3,22,Mississippi,Tupelo,34546
10725,1988-1989,1988-12-01,1989-02-28,90,0,4,48,52,2,1,3,55,2,5,Mississippi,Tupelo,34546
10726,1989-1990,1989-12-01,1990-02-28,90,0,12,69,81,1,0,1,82,1,2,Mississippi,Tupelo,34546
10727,1990-1991,1990-12-01,1991-02-28,90,0,2,49,51,1,0,1,52,1,5,Mississippi,Tupelo,34546
10728,1991-1992,1991-12-01,1992-02-29,91,0,0,38,38,1,0,1,39,1,2,Mississippi,Tupelo,34546
10729,1992-1993,1992-12-01,1993-03-13,103,0,0,38,38,3,0,3,41,2,5,Mississippi,Tupelo,34546
10730,1993-1994,1993-12-01,1994-02-28,90,0,4,84,88,1,0,1,89,1,3,Mississippi,Tupelo,34546
10731,1994-1995,1994-12-01,1995-02-28,90,0,0,58,58,6,2,8,66,4,13,Mississippi,Tupelo,34546
10732,1995-1996,1995-12-01,1996-03-08,99,0,14,105,119,3,6,9,128,2,10,Mississippi,Tupelo,34546
10733,1996-1997,1996-12-01,1997-02-28,90,0,6,67,73,3,2,5,78,3,11,Mississippi,Tupelo,34546
10734,1997-1998,1997-12-01,1998-02-28,90,0,0,37,37,5,3,8,45,3,7,Mississippi,Tupelo,34546
10735,1998-1999,1998-12-01,1999-02-28,90,0,5,47,52,2,3,5,57,2,4,Mississippi,Tupelo,34546
10736,1999-2000,1999-12-01,2000-02-29,91,0,0,61,61,6,2,8,69,2,9,Mississippi,Tupelo,34546
10737,2000-2001,2000-12-01,2001-05-26,177,0,7,116,123,0,3,3,126,0,0,Mississippi,Tupelo,34546
10738,2001-2002,2001-12-01,2002-02-28,90,0,0,49,49,0,0,0,49,0,0,Mississippi,Tupelo,34546
10739,2002-2003,2002-12-01,2003-02-28,90,0,3,86,89,0,0,0,89,0,0,Mississippi,Tupelo,34546
10740,2003-2004,2003-12-01,2004-02-29,91,1,0,73,73,0,0,0,73,0,0,Mississippi,Tupelo,34546
10741,2004-2005,2004-12-01,2005-02-28,90,0,2,58,60,0,0,0,60,0,0,Mississippi,Tupelo,34546
10742,2005-2006,2005-12-01,2006-02-28,90,6,1,50,51,0,0,0,51,0,0,Mississippi,Tupelo,34546
10743,2006-2007,2006-12-01,2007-02-28,90,0,0,65,65,1,0,1,66,1,3,Mississippi,Tupelo,34546
10744,2007-2008,2007-12-01,2008-03-08,99,0,3,66,69,5,2,7,76,3,10,Mississippi,Tupelo,34546
10745,2008-2009,2008-12-01,2009-03-01,91,0,2,71,73,1,0,1,74,1,2,Mississippi,Tupelo,34546
10746,2009-2010,2009-12-01,2010-02-28,90,0,4,99,103,2,0,2,105,2,6,Mississippi,Tupelo,34546
10747,2010-2011,2010-12-01,2011-02-28,90,0,5,96,101,16,20,36,137,5,23,Mississippi,Tupelo,34546
10748,2011-2012,2011-12-01,2012-02-29,91,0,0,47,47,0,0,0,47,0,0,Mississippi,Tupelo,34546
10749,2012-2013,2012-12-01,2013-02-28,90,0,0,42,42,0,0,0,42,0,0,Mississippi,Tupelo,34546
10750,2013-2014,2013-12-01,2014-02-28,90,0,7,110,117,1,1,2,119,1,2,Mississippi,Tupelo,34546
10751,2014-2015,2014-12-01,2015-03-05,95,0,2,75,77,11,5,16,93,2,14,Mississippi,Tupelo,34546
10752,2015-2016,2015-12-01,2016-02-29,91,0,0,51,51,0,0,0,51,0,0,Mississippi,Tupelo,34546
10753,2016-2017,2016-12-01,2017-02-28,90,1,2,41,43,0,0,0,43,0,0,Mississippi,Tupelo,34546
10754,2017-2018,2017-12-01,2018-02-28,90,0,5,92,97,1,0,1,98,1,6,Mississippi,Tupelo,34546
10755,2018-2019,2018-12-01,2019-02-28,90,0,0,32,32,0,0,0,32,0,0,Mississippi,Tupelo,34546
10756,2019-2020,2019-12-01,2020-02-29,91,0,0,25,25,1,0,1,26,1,2,Mississippi,Tupelo,34546
10757,1950-1951,1950-11-10,1951-03-13,124,1,33,267,300,18,40,58,358,6,52,Missouri,Appleton City,1127
10758,1951-1952,1951-10-31,1952-03-26,148,4,18,214,232,39,51,90,322,15,80,Missouri,Appleton City,1127
10759,1952-1953,1952-11-26,1953-04-18,144,0,9,158,167,11,9,20,187,8,29,Missouri,Appleton City,1127
10760,1953-1954,1953-11-07,1954-03-03,117,0,12,173,185,9,14,23,208,5,20,Missouri,Appleton City,1127
10761,1954-1955,1954-12-01,1955-03-27,117,0,13,180,193,36,52,88,281,6,52,Missouri,Appleton City,1127
10762,1955-1956,1955-11-28,1956-03-16,110,0,20,222,242,33,44,77,319,12,67,Missouri,Appleton City,1127
10763,1956-1957,1956-12-01,1957-04-12,133,0,25,173,198,13,27,40,238,6,32,Missouri,Appleton City,1127
10764,1957-1958,1957-12-01,1958-03-17,107,0,23,191,214,33,51,84,298,8,47,Missouri,Appleton City,1127
10765,1958-1959,1958-11-27,1959-02-28,94,19,32,207,239,31,58,89,328,8,65,Missouri,Appleton City,1127
10766,1959-1960,1959-11-14,1960-03-20,128,0,38,252,290,44,137,181,471,16,85,Missouri,Appleton City,1127
10767,1961-1962,1961-11-19,1962-03-01,103,0,43,222,265,32,82,114,379,10,76,Missouri,Appleton City,1127
10768,1962-1963,1962-12-01,1963-02-28,90,0,34,256,290,10,16,26,316,5,37,Missouri,Appleton City,1127
10769,1963-1964,1963-12-01,1964-03-05,96,1,32,231,263,23,53,76,339,6,39,Missouri,Appleton City,1127
10770,1964-1965,1964-11-21,1965-03-26,126,0,28,278,306,38,49,87,393,13,89,Missouri,Appleton City,1127
10771,1965-1966,1965-12-01,1966-03-27,117,0,23,200,223,7,9,16,239,5,24,Missouri,Appleton City,1127
10772,1966-1967,1966-12-01,1967-02-28,90,0,15,190,205,8,17,25,230,3,17,Missouri,Appleton City,1127
10773,1967-1968,1967-12-01,1968-03-21,112,0,30,208,238,26,49,75,313,9,55,Missouri,Appleton City,1127
10774,1968-1969,1968-12-01,1969-03-11,101,0,16,207,223,27,50,77,300,5,40,Missouri,Appleton City,1127
10775,1969-1970,1969-11-14,1970-04-04,142,0,36,273,309,33,40,73,382,14,71,Missouri,Appleton City,1127
10776,1970-1971,1970-11-23,1971-03-25,123,0,19,223,242,19,18,37,279,7,35,Missouri,Appleton City,1127
10777,1971-1972,1971-11-23,1972-03-29,128,0,20,171,191,21,20,41,232,9,45,Missouri,Appleton City,1127
10778,1972-1973,1972-11-19,1973-04-09,142,0,41,212,253,37,80,117,370,11,71,Missouri,Appleton City,1127
10779,1973-1974,1973-12-01,1974-03-24,114,0,33,193,226,44,103,147,373,12,86,Missouri,Appleton City,1127
10780,1974-1975,1974-11-29,1975-03-13,105,0,9,181,190,42,56,98,288,11,62,Missouri,Appleton City,1127
10781,1975-1976,1975-11-25,1976-03-16,113,1,15,176,191,27,30,57,248,6,42,Missouri,Appleton City,1127
10782,1976-1977,1976-11-28,1977-02-28,93,0,40,302,342,29,149,178,520,10,75,Missouri,Appleton City,1127
10783,1977-1978,1977-11-26,1978-03-25,120,0,65,330,395,36,175,211,606,13,75,Missouri,Appleton City,1127
10784,1978-1979,1978-12-01,1979-02-28,90,0,67,313,380,47,268,315,695,16,137,Missouri,Appleton City,1127
10785,1979-1980,1979-11-29,1980-03-13,106,1,26,232,258,29,50,79,337,7,52,Missouri,Appleton City,1127
10786,1980-1981,1980-11-27,1981-02-28,94,5,15,197,212,12,15,27,239,4,37,Missouri,Appleton City,1127
10787,1981-1982,1981-12-01,1982-04-07,128,1,32,258,290,18,35,53,343,7,40,Missouri,Appleton City,1127
10788,1982-1983,1982-12-01,1983-02-28,90,1,7,109,116,9,10,19,135,5,17,Missouri,Appleton City,1127
10789,1983-1984,1983-12-01,1984-03-20,111,10,66,284,350,28,113,141,491,11,96,Missouri,Appleton City,1127
10790,1984-1985,1984-11-18,1985-02-28,103,0,35,250,285,34,145,179,464,11,72,Missouri,Appleton City,1127
10791,1985-1986,1985-11-28,1986-02-28,93,12,29,224,253,18,21,39,292,7,46,Missouri,Appleton City,1127
10792,1986-1987,1986-11-12,1987-02-28,109,6,16,168,184,26,68,94,278,7,45,Missouri,Appleton City,1127
10793,1987-1988,1987-11-29,1988-03-17,110,3,31,260,291,42,64,106,397,11,83,Missouri,Appleton City,1127
10794,1988-1989,1988-11-20,1989-03-06,107,1,24,202,226,23,23,46,272,6,44,Missouri,Appleton City,1127
10795,1989-1990,1989-12-01,1990-03-24,114,0,39,201,240,19,49,68,308,8,59,Missouri,Appleton City,1127
10796,1990-1991,1990-12-01,1991-02-28,90,2,48,208,256,14,37,51,307,5,51,Missouri,Appleton City,1127
10797,1991-1992,1991-11-02,1992-03-19,139,0,13,177,190,7,6,13,203,4,14,Missouri,Appleton City,1127
10798,1992-1993,1992-11-07,1993-03-18,132,5,39,237,276,40,73,113,389,12,79,Missouri,Appleton City,1127
10799,1993-1994,1993-11-26,1994-02-28,95,2,42,229,271,11,29,40,311,2,20,Missouri,Appleton City,1127
10800,1994-1995,1994-12-01,1995-03-09,99,1,24,192,216,24,52,76,292,6,43,Missouri,Appleton City,1127
10801,1995-1996,1995-11-12,1996-03-09,119,13,69,294,363,18,66,84,447,7,64,Missouri,Appleton City,1127
10802,1996-1997,1996-11-25,1997-02-28,96,6,51,227,278,20,62,82,360,5,45,Missouri,Appleton City,1127
10803,1997-1998,1997-12-01,1998-03-20,110,6,15,149,164,15,11,26,190,8,38,Missouri,Appleton City,1127
10804,1998-1999,1998-12-01,1999-03-14,104,7,34,160,194,10,14,24,218,5,25,Missouri,Appleton City,1127
10805,1999-2000,1999-12-01,2000-03-12,103,16,12,149,161,26,20,46,207,6,49,Missouri,Appleton City,1127
10806,2000-2001,2000-11-09,2001-03-01,113,11,63,309,372,27,74,101,473,9,72,Missouri,Appleton City,1127
10807,2001-2002,2001-11-29,2002-03-26,118,19,19,197,216,14,5,19,235,6,30,Missouri,Appleton City,1127
10808,2004-2005,2004-12-01,2005-02-28,90,12,24,138,162,0,5,5,167,0,0,Missouri,Appleton City,1127
10809,2005-2006,2005-12-01,2006-02-28,90,7,19,155,174,0,3,3,177,0,0,Missouri,Appleton City,1127
10810,2007-2008,2007-12-01,2008-02-29,91,19,26,204,230,4,2,6,236,3,12,Missouri,Appleton City,1127
10811,2008-2009,2008-12-01,2009-03-02,92,4,37,214,251,11,9,20,271,4,31,Missouri,Appleton City,1127
10812,2009-2010,2009-12-01,2010-03-22,112,8,60,255,315,40,125,165,480,12,93,Missouri,Appleton City,1127
10813,2015-2016,2015-12-01,2016-02-29,91,0,16,120,136,0,0,0,136,0,0,Missouri,Appleton City,1127
10814,2016-2017,2016-12-01,2017-03-15,105,0,22,150,172,3,4,7,179,2,16,Missouri,Appleton City,1127
10815,2017-2018,2017-12-01,2018-04-16,137,0,48,244,292,5,8,13,305,3,23,Missouri,Appleton City,1127
10816,2018-2019,2018-11-13,2019-03-06,114,0,48,237,285,18,36,54,339,8,47,Missouri,Appleton City,1127
10817,2019-2020,2019-11-13,2020-02-29,109,0,25,156,181,19,26,45,226,8,43,Missouri,Appleton City,1127
10818,1950-1951,1950-11-10,1951-04-12,154,0,66,305,371,29,35,64,435,15,104,Missouri,Columbia,129272
10819,1951-1952,1951-10-31,1952-03-15,137,0,39,226,265,41,61,102,367,19,97,Missouri,Columbia,129272
10820,1952-1953,1952-11-25,1953-04-17,144,0,17,155,172,26,19,45,217,12,44,Missouri,Columbia,129272
10821,1953-1954,1953-12-01,1954-03-04,94,0,23,159,182,11,15,26,208,5,25,Missouri,Columbia,129272
10822,1954-1955,1954-10-30,1955-03-27,149,0,27,207,234,31,22,53,287,17,81,Missouri,Columbia,129272
10823,1955-1956,1955-11-27,1956-03-19,114,0,35,230,265,34,45,79,344,15,66,Missouri,Columbia,129272
10824,1956-1957,1956-11-29,1957-04-12,135,0,32,203,235,17,26,43,278,11,39,Missouri,Columbia,129272
10825,1957-1958,1957-11-29,1958-03-20,112,0,44,227,271,41,64,105,376,13,67,Missouri,Columbia,129272
10826,1958-1959,1958-11-26,1959-03-15,110,0,61,256,317,33,69,102,419,15,89,Missouri,Columbia,129272
10827,1959-1960,1959-11-06,1960-03-26,142,0,64,288,352,64,185,249,601,24,149,Missouri,Columbia,129272
10828,1960-1961,1960-11-09,1961-04-09,152,0,32,226,258,29,50,79,337,16,96,Missouri,Columbia,129272
10829,1961-1962,1961-11-18,1962-04-01,135,0,68,278,346,51,76,127,473,28,137,Missouri,Columbia,129272
10830,1962-1963,1962-12-01,1963-02-28,90,0,79,288,367,15,40,55,422,11,80,Missouri,Columbia,129272
10831,1963-1964,1963-12-01,1964-03-26,117,0,54,256,310,38,83,121,431,12,64,Missouri,Columbia,129272
10832,1964-1965,1964-11-19,1965-03-27,129,0,52,295,347,44,84,128,475,20,127,Missouri,Columbia,129272
10833,1965-1966,1965-11-29,1966-03-06,98,0,42,201,243,21,26,47,290,10,51,Missouri,Columbia,129272
10834,1966-1967,1966-11-04,1967-03-19,136,0,34,226,260,15,17,32,292,11,45,Missouri,Columbia,129272
10835,1967-1968,1967-11-22,1968-03-21,121,0,45,236,281,28,36,64,345,19,88,Missouri,Columbia,129272
10836,1968-1969,1968-11-11,1969-03-26,136,0,34,231,265,28,43,71,336,12,55,Missouri,Columbia,129272
10837,1969-1970,1969-11-14,1970-04-04,142,0,67,280,347,33,56,89,436,21,78,Missouri,Columbia,129272
10838,1970-1971,1970-11-23,1971-04-06,135,0,44,223,267,21,10,31,298,13,39,Missouri,Columbia,129272
10839,1971-1972,1971-11-23,1972-03-31,130,0,35,192,227,33,26,59,286,20,80,Missouri,Columbia,129272
10840,1972-1973,1972-11-18,1973-04-10,144,0,61,218,279,38,79,117,396,16,92,Missouri,Columbia,129272
10841,1973-1974,1973-12-01,1974-03-25,115,0,67,228,295,56,125,181,476,18,117,Missouri,Columbia,129272
10842,1974-1975,1974-11-04,1975-03-14,131,0,38,222,260,39,78,117,377,13,69,Missouri,Columbia,129272
10843,1975-1976,1975-11-25,1976-03-17,114,0,29,186,215,44,48,92,307,17,84,Missouri,Columbia,129272
10844,1976-1977,1976-10-30,1977-04-05,158,0,102,397,499,55,197,252,751,23,168,Missouri,Columbia,129272
10845,1977-1978,1977-11-09,1978-03-28,140,0,100,364,464,83,253,336,800,32,191,Missouri,Columbia,129272
10846,1978-1979,1978-12-01,1979-03-27,117,0,100,333,433,60,256,316,749,27,196,Missouri,Columbia,129272
10847,1979-1980,1979-11-27,1980-04-15,141,0,52,249,301,43,89,132,433,17,105,Missouri,Columbia,129272
10848,1980-1981,1980-11-26,1981-02-28,95,0,48,211,259,26,37,63,322,11,74,Missouri,Columbia,129272
10849,1981-1982,1981-12-01,1982-04-08,129,0,68,284,352,47,130,177,529,19,135,Missouri,Columbia,129272
10850,1982-1983,1982-11-23,1983-03-21,119,0,24,132,156,10,5,15,171,10,37,Missouri,Columbia,129272
10851,1983-1984,1983-11-12,1984-03-20,130,0,89,289,378,50,124,174,552,27,169,Missouri,Columbia,129272
10852,1984-1985,1984-11-17,1985-02-28,104,0,62,273,335,38,127,165,500,17,119,Missouri,Columbia,129272
10853,1985-1986,1985-11-24,1986-02-28,97,0,50,249,299,17,33,50,349,7,52,Missouri,Columbia,129272
10854,1986-1987,1986-11-12,1987-02-28,109,0,22,157,179,31,78,109,288,8,51,Missouri,Columbia,129272
10855,1987-1988,1987-11-29,1988-03-18,111,0,50,235,285,46,77,123,408,14,89,Missouri,Columbia,129272
10856,1988-1989,1988-11-20,1989-03-20,121,0,41,246,287,43,82,125,412,17,119,Missouri,Columbia,129272
10857,1989-1990,1989-11-15,1990-03-26,132,0,52,242,294,38,68,106,400,19,127,Missouri,Columbia,129272
10858,1990-1991,1990-11-05,1991-02-28,116,0,46,196,242,24,44,68,310,14,92,Missouri,Columbia,129272
10859,1991-1992,1991-11-02,1992-03-19,139,0,19,174,193,20,26,46,239,9,40,Missouri,Columbia,129272
10860,1992-1993,1992-11-03,1993-03-19,137,0,41,244,285,48,83,131,416,18,97,Missouri,Columbia,129272
10861,1993-1994,1993-11-06,1994-04-06,152,0,52,270,322,20,17,37,359,16,77,Missouri,Columbia,129272
10862,1994-1995,1994-12-01,1995-03-08,98,0,35,183,218,43,88,131,349,14,90,Missouri,Columbia,129272
10863,1995-1996,1995-11-05,1996-03-20,137,3,68,288,356,35,57,92,448,24,140,Missouri,Columbia,129272
10864,2000-2001,2000-11-10,2001-02-28,111,1,64,294,358,21,25,46,404,12,73,Missouri,Columbia,129272
10865,2001-2002,2001-12-01,2002-03-05,95,0,23,157,180,12,19,31,211,4,22,Missouri,Columbia,129272
10866,2002-2003,2002-12-01,2003-03-09,99,0,46,236,282,26,29,55,337,12,69,Missouri,Columbia,129272
10867,2003-2004,2003-12-01,2004-02-29,91,0,39,191,230,17,29,46,276,7,45,Missouri,Columbia,129272
10868,2004-2005,2004-11-24,2005-02-28,97,0,27,143,170,20,9,29,199,9,46,Missouri,Columbia,129272
10869,2005-2006,2005-12-01,2006-02-28,90,0,20,141,161,6,6,12,173,3,18,Missouri,Columbia,129272
10870,2006-2007,2006-11-30,2007-03-17,108,0,44,206,250,37,88,125,375,12,84,Missouri,Columbia,129272
10871,2007-2008,2007-12-01,2008-02-29,91,0,26,183,209,21,25,46,255,11,51,Missouri,Columbia,129272
10872,2008-2009,2008-11-21,2009-03-01,101,0,49,243,292,8,6,14,306,7,41,Missouri,Columbia,129272
10873,2009-2010,2009-12-01,2010-03-20,110,0,54,244,298,29,52,81,379,12,72,Missouri,Columbia,129272
10874,2010-2011,2010-12-01,2011-03-27,117,0,60,252,312,73,187,260,572,16,145,Missouri,Columbia,129272
10875,2011-2012,2011-12-01,2012-02-29,91,0,9,122,131,10,10,20,151,5,21,Missouri,Columbia,129272
10876,2012-2013,2012-12-01,2013-03-28,118,0,23,177,200,51,112,163,363,12,70,Missouri,Columbia,129272
10877,2015-2016,2015-12-01,2016-02-29,91,4,19,122,141,14,10,24,165,6,41,Missouri,Columbia,129272
10878,2016-2017,2016-12-01,2017-03-14,104,0,26,142,168,4,2,6,174,3,17,Missouri,Columbia,129272
10879,2017-2018,2017-12-01,2018-04-08,129,0,52,228,280,11,9,20,300,9,43,Missouri,Columbia,129272
10880,2018-2019,2018-11-08,2019-04-14,158,0,36,215,251,41,65,106,357,14,82,Missouri,Columbia,129272
10881,2019-2020,2019-10-31,2020-02-29,122,0,19,149,168,28,47,75,243,14,56,Missouri,Columbia,129272
10882,1950-1951,1950-11-10,1951-04-11,153,5,64,392,456,16,25,41,497,9,51,Missouri,Conception,198
10883,1951-1952,1951-11-02,1952-03-25,145,8,62,341,403,30,74,104,507,11,80,Missouri,Conception,198
10884,1952-1953,1952-11-27,1953-03-08,102,5,33,230,263,19,75,94,357,9,44,Missouri,Conception,198
10885,1953-1954,1953-12-01,1954-03-30,120,5,22,259,281,8,7,15,296,3,23,Missouri,Conception,198
10886,1954-1955,1954-12-01,1955-03-26,116,10,35,293,328,28,137,165,493,7,55,Missouri,Conception,198
10887,1955-1956,1955-11-16,1956-03-15,121,10,51,335,386,23,50,73,459,11,61,Missouri,Conception,198
10888,1956-1957,1956-11-21,1957-04-11,142,6,51,312,363,22,60,82,445,13,81,Missouri,Conception,198
10889,1958-1959,1958-11-27,1959-03-15,109,6,68,322,390,39,75,114,504,11,89,Missouri,Conception,198
10890,1959-1960,1959-11-05,1960-03-27,144,8,87,382,469,68,330,398,867,14,125,Missouri,Conception,198
10891,1960-1961,1960-12-01,1961-04-02,123,10,31,266,297,12,3,15,312,6,35,Missouri,Conception,198
10892,1962-1963,1962-12-01,1963-02-28,90,12,99,319,418,15,27,42,460,7,58,Missouri,Conception,198
10893,1963-1964,1963-12-01,1964-03-26,117,15,62,315,377,33,43,76,453,10,76,Missouri,Conception,198
10894,1964-1965,1964-11-19,1965-03-27,129,2,100,462,562,58,124,182,744,18,154,Missouri,Conception,198
10895,1965-1966,1965-11-30,1966-03-24,115,0,69,323,392,11,14,25,417,7,41,Missouri,Conception,198
10896,1966-1967,1966-12-01,1967-04-24,145,1,63,364,427,24,106,130,557,6,53,Missouri,Conception,198
10897,1967-1968,1967-12-01,1968-03-23,114,0,72,325,397,20,95,115,512,7,55,Missouri,Conception,198
10898,1968-1969,1968-11-09,1969-03-30,142,1,84,406,490,19,63,82,572,10,69,Missouri,Conception,198
10899,1969-1970,1969-11-15,1970-04-03,140,0,90,404,494,33,59,92,586,14,94,Missouri,Conception,198
10900,1971-1972,1971-11-29,1972-04-04,128,1,60,323,383,24,32,56,439,10,67,Missouri,Conception,198
10901,1972-1973,1972-11-14,1973-04-10,148,2,104,321,425,33,118,151,576,13,94,Missouri,Conception,198
10902,1973-1974,1973-12-01,1974-03-24,114,1,97,312,409,31,99,130,539,11,117,Missouri,Conception,198
10903,1974-1975,1974-11-29,1975-04-03,126,0,41,264,305,54,96,150,455,16,97,Missouri,Conception,198
10904,1975-1976,1975-11-26,1976-03-16,112,1,46,277,323,38,59,97,420,11,77,Missouri,Conception,198
10905,1976-1977,1976-11-13,1977-04-04,143,5,125,468,593,30,154,184,777,13,108,Missouri,Conception,198
10906,1977-1978,1977-11-22,1978-03-26,125,2,172,508,680,64,259,323,1003,19,187,Missouri,Conception,198
10907,1978-1979,1978-11-21,1979-04-04,135,1,167,522,689,66,316,382,1071,19,213,Missouri,Conception,198
10908,1979-1980,1979-11-29,1980-04-12,136,1,69,368,437,42,93,135,572,14,97,Missouri,Conception,198
10909,1980-1981,1980-12-01,1981-02-28,90,1,55,281,336,14,32,46,382,4,46,Missouri,Conception,198
10910,1988-1989,1988-12-01,1989-03-06,96,7,66,285,351,17,54,71,422,7,77,Missouri,Conception,198
10911,1990-1991,1990-11-05,1991-03-03,119,8,87,301,388,24,83,107,495,7,58,Missouri,Conception,198
10912,1991-1992,1991-11-02,1992-04-22,173,16,40,245,285,20,32,52,337,5,34,Missouri,Conception,198
10913,1993-1994,1993-10-31,1994-03-02,123,16,89,317,406,19,36,55,461,9,65,Missouri,Conception,198
10914,1994-1995,1994-12-01,1995-03-10,100,15,45,263,308,17,48,65,373,4,38,Missouri,Conception,198
10915,1995-1996,1995-11-05,1996-03-26,143,19,90,358,448,42,121,163,611,13,103,Missouri,Conception,198
10916,1996-1997,1996-10-23,1997-04-14,174,15,104,347,451,50,88,138,589,12,88,Missouri,Conception,198
10917,1997-1998,1997-11-03,1998-03-15,133,9,50,230,280,45,92,137,417,11,78,Missouri,Conception,198
10918,1998-1999,1998-11-07,1999-03-22,136,17,64,243,307,38,67,105,412,10,88,Missouri,Conception,198
10919,2001-2002,2001-11-28,2002-03-26,119,4,39,243,282,23,46,69,351,5,39,Missouri,Conception,198
10920,2005-2006,2005-11-17,2006-03-22,126,1,54,301,355,20,27,47,402,6,53,Missouri,Conception,198
10921,2006-2007,2006-11-30,2007-03-04,95,5,90,302,392,21,78,99,491,5,44,Missouri,Conception,198
10922,2007-2008,2007-11-22,2008-03-15,115,12,119,420,539,58,212,270,809,18,142,Missouri,Conception,198
10923,2008-2009,2008-11-22,2009-04-03,133,1,97,413,510,21,50,71,581,8,66,Missouri,Conception,198
10924,2009-2010,2009-11-17,2010-03-21,125,0,116,380,496,65,297,362,858,17,148,Missouri,Conception,198
10925,2014-2015,2014-11-12,2015-03-06,115,5,81,359,440,24,45,69,509,8,67,Missouri,Conception,198
10926,2015-2016,2015-11-28,2016-02-29,94,14,41,183,224,10,26,36,260,4,31,Missouri,Conception,198
10927,2016-2017,2016-12-01,2017-03-14,104,0,47,224,271,5,10,15,286,2,26,Missouri,Conception,198
10928,2017-2018,2017-12-01,2018-04-16,137,2,103,338,441,22,46,68,509,8,66,Missouri,Conception,198
10929,2018-2019,2018-11-09,2019-03-09,121,10,104,353,457,56,162,218,675,18,154,Missouri,Conception,198
10930,2019-2020,2019-10-31,2020-04-18,171,10,48,279,327,21,52,73,400,14,76,Missouri,Conception,198
10931,1950-1951,1950-11-10,1951-03-20,131,0,56,267,323,14,20,34,357,9,68,Missouri,Kansas City,459787
10932,1951-1952,1951-10-31,1952-03-21,143,0,41,219,260,32,43,75,335,14,73,Missouri,Kansas City,459787
10933,1952-1953,1952-11-24,1953-03-08,105,0,17,139,156,32,43,75,231,11,51,Missouri,Kansas City,459787
10934,1953-1954,1953-11-07,1954-03-29,143,0,27,177,204,18,23,41,245,7,41,Missouri,Kansas City,459787
10935,1954-1955,1954-12-01,1955-03-27,117,0,24,180,204,32,48,80,284,14,86,Missouri,Kansas City,459787
10936,1955-1956,1955-11-15,1956-03-15,122,0,42,240,282,41,53,94,376,21,103,Missouri,Kansas City,459787
10937,1956-1957,1956-12-01,1957-04-12,133,0,36,172,208,21,38,59,267,13,72,Missouri,Kansas City,459787
10938,1957-1958,1957-12-01,1958-03-17,107,0,40,186,226,43,89,132,358,12,73,Missouri,Kansas City,459787
10939,1958-1959,1958-11-26,1959-04-08,134,0,58,219,277,43,64,107,384,16,104,Missouri,Kansas City,459787
10940,1959-1960,1959-11-05,1960-04-30,178,0,63,261,324,87,216,303,627,28,180,Missouri,Kansas City,459787
10941,1960-1961,1960-11-09,1961-04-09,152,0,27,201,228,22,15,37,265,14,62,Missouri,Kansas City,459787
10942,1961-1962,1961-11-18,1962-04-01,135,0,64,269,333,73,238,311,644,19,142,Missouri,Kansas City,459787
10943,1962-1963,1962-12-01,1963-03-05,95,0,64,264,328,22,34,56,384,13,93,Missouri,Kansas City,459787
10944,1963-1964,1963-12-01,1964-03-26,117,0,45,202,247,36,66,102,349,11,71,Missouri,Kansas City,459787
10945,1964-1965,1964-11-18,1965-03-26,129,0,50,272,322,43,62,105,427,22,111,Missouri,Kansas City,459787
10946,1965-1966,1965-12-01,1966-03-27,117,0,28,189,217,16,11,27,244,10,41,Missouri,Kansas City,459787
10947,1966-1967,1966-12-01,1967-03-19,109,0,23,201,224,22,74,96,320,9,40,Missouri,Kansas City,459787
10948,1967-1968,1967-11-03,1968-02-29,119,0,47,208,255,24,56,80,335,17,83,Missouri,Kansas City,459787
10949,1968-1969,1968-11-10,1969-03-11,122,0,41,228,269,24,52,76,345,12,57,Missouri,Kansas City,459787
10950,1969-1970,1969-11-14,1970-04-02,140,0,46,220,266,26,20,46,312,16,68,Missouri,Kansas City,459787
10951,1970-1971,1970-11-23,1971-03-26,124,0,45,203,248,27,31,58,306,12,47,Missouri,Kansas City,459787
10952,1971-1972,1971-11-23,1972-03-31,130,0,37,200,237,20,16,36,273,17,75,Missouri,Kansas City,459787
10953,1972-1973,1972-11-16,1973-04-09,145,0,78,236,314,34,81,115,429,17,98,Missouri,Kansas City,459787
10954,1973-1974,1973-12-01,1974-04-04,125,3,74,231,305,24,74,98,403,15,108,Missouri,Kansas City,459787
10955,1974-1975,1974-11-04,1975-04-04,152,0,48,257,305,35,55,90,395,23,98,Missouri,Kansas City,459787
10956,1975-1976,1975-11-21,1976-03-16,117,0,44,218,262,33,43,76,338,16,89,Missouri,Kansas City,459787
10957,1976-1977,1976-11-12,1977-04-05,145,0,88,360,448,31,154,185,633,18,114,Missouri,Kansas City,459787
10958,1977-1978,1977-11-26,1978-03-26,121,0,125,394,519,47,168,215,734,22,146,Missouri,Kansas City,459787
10959,1978-1979,1978-11-19,1979-04-04,137,0,140,390,530,50,262,312,842,25,203,Missouri,Kansas City,459787
10960,1979-1980,1979-11-28,1980-03-24,118,0,60,275,335,35,99,134,469,16,107,Missouri,Kansas City,459787
10961,1980-1981,1980-12-01,1981-03-17,107,0,42,233,275,17,41,58,333,7,46,Missouri,Kansas City,459787
10962,1981-1982,1981-11-19,1982-04-08,141,0,98,354,452,46,87,133,585,21,155,Missouri,Kansas City,459787
10963,1982-1983,1982-11-04,1983-04-09,157,0,27,201,228,36,46,82,310,19,79,Missouri,Kansas City,459787
10964,1983-1984,1983-11-23,1984-03-20,119,0,118,329,447,40,100,140,587,22,182,Missouri,Kansas City,459787
10965,1984-1985,1984-11-27,1985-03-31,125,0,66,320,386,40,179,219,605,16,115,Missouri,Kansas City,459787
10966,1985-1986,1985-11-20,1986-02-28,101,0,62,268,330,22,49,71,401,15,100,Missouri,Kansas City,459787
10967,1986-1987,1986-11-10,1987-02-28,111,0,24,175,199,28,49,77,276,14,65,Missouri,Kansas City,459787
10968,1987-1988,1987-11-28,1988-03-17,111,0,51,269,320,41,54,95,415,14,93,Missouri,Kansas City,459787
10969,1988-1989,1988-11-20,1989-03-05,106,0,40,215,255,16,10,26,281,13,77,Missouri,Kansas City,459787
10970,1989-1990,1989-11-16,1990-03-26,131,0,59,275,334,30,54,84,418,12,100,Missouri,Kansas City,459787
10971,1990-1991,1990-11-05,1991-03-13,129,0,54,259,313,30,56,86,399,16,124,Missouri,Kansas City,459787
10972,1991-1992,1991-11-01,1992-04-21,173,0,16,180,196,16,16,32,228,10,34,Missouri,Kansas City,459787
10973,1992-1993,1992-11-03,1993-04-03,152,0,51,266,317,52,122,174,491,19,106,Missouri,Kansas City,459787
10974,1993-1994,1993-11-25,1994-04-06,133,0,51,265,316,30,29,59,375,17,92,Missouri,Kansas City,459787
10975,1994-1995,1994-12-01,1995-03-09,99,0,30,200,230,16,26,42,272,13,62,Missouri,Kansas City,459787
10976,1995-1996,1995-11-02,1996-04-14,165,10,81,336,417,34,59,93,510,20,107,Missouri,Kansas City,459787
10977,1996-1997,1996-10-22,1997-04-11,172,0,73,297,370,44,34,78,448,16,97,Missouri,Kansas City,459787
10978,1997-1998,1997-10-26,1998-03-13,139,0,23,158,181,31,59,90,271,15,67,Missouri,Kansas City,459787
10979,1998-1999,1998-12-01,1999-03-23,113,3,48,184,232,21,30,51,283,13,82,Missouri,Kansas City,459787
10980,1999-2000,1999-12-01,2000-03-19,110,0,14,160,174,18,24,42,216,10,40,Missouri,Kansas City,459787
10981,2000-2001,2000-11-08,2001-03-16,129,0,75,340,415,34,114,148,563,15,104,Missouri,Kansas City,459787
10982,2001-2002,2001-11-28,2002-03-04,97,0,21,175,196,13,17,30,226,8,38,Missouri,Kansas City,459787
10983,2002-2003,2002-11-25,2003-03-09,105,0,47,244,291,16,22,38,329,10,57,Missouri,Kansas City,459787
10984,2003-2004,2003-12-01,2004-02-29,91,0,48,196,244,30,52,82,326,12,76,Missouri,Kansas City,459787
10985,2004-2005,2004-11-23,2005-02-28,98,0,36,176,212,22,19,41,253,9,38,Missouri,Kansas City,459787
10986,2005-2006,2005-12-01,2006-03-21,111,0,29,145,174,21,24,45,219,9,55,Missouri,Kansas City,459787
10987,2006-2007,2006-11-29,2007-03-03,95,0,49,209,258,17,33,50,308,12,70,Missouri,Kansas City,459787
10988,2007-2008,2007-11-21,2008-03-07,108,0,52,281,333,39,60,99,432,19,108,Missouri,Kansas City,459787
10989,2008-2009,2008-11-29,2009-03-29,121,0,49,280,329,23,29,52,381,13,75,Missouri,Kansas City,459787
10990,2009-2010,2009-11-17,2010-03-21,125,0,68,255,323,65,153,218,541,25,158,Missouri,Kansas City,459787
10991,2010-2011,2010-12-01,2011-03-27,117,0,64,289,353,57,133,190,543,17,141,Missouri,Kansas City,459787
10992,2011-2012,2011-12-01,2012-03-08,99,0,9,148,157,9,3,12,169,7,17,Missouri,Kansas City,459787
10993,2012-2013,2012-12-01,2013-05-02,153,0,28,210,238,48,95,143,381,15,80,Missouri,Kansas City,459787
10994,2013-2014,2013-11-22,2014-04-14,144,0,87,379,466,39,125,164,630,19,139,Missouri,Kansas City,459787
10995,2014-2015,2014-11-11,2015-03-05,115,0,58,278,336,26,32,58,394,18,113,Missouri,Kansas City,459787
10996,2015-2016,2015-12-01,2016-03-27,118,0,21,158,179,12,19,31,210,9,42,Missouri,Kansas City,459787
10997,2016-2017,2016-12-01,2017-03-11,101,0,31,171,202,8,11,19,221,5,35,Missouri,Kansas City,459787
10998,2017-2018,2017-12-01,2018-04-15,136,0,59,270,329,14,12,26,355,9,49,Missouri,Kansas City,459787
10999,2018-2019,2018-10-14,2019-03-06,144,0,54,290,344,43,94,137,481,22,125,Missouri,Kansas City,459787
11000,2019-2020,2019-10-28,2020-02-29,125,0,19,177,196,26,29,55,251,15,68,Missouri,Kansas City,459787
11001,1951-1952,1951-11-03,1952-03-05,124,7,29,210,239,33,23,56,295,9,54,Missouri,Rolla,19559
11002,1952-1953,1952-11-28,1953-04-18,142,8,13,128,141,12,8,20,161,6,24,Missouri,Rolla,19559
11003,1953-1954,1953-12-01,1954-03-05,95,3,22,149,171,10,10,20,191,5,23,Missouri,Rolla,19559
11004,1954-1955,1954-12-01,1955-03-27,117,1,15,162,177,19,21,40,217,7,39,Missouri,Rolla,19559
11005,1955-1956,1955-11-29,1956-03-16,109,3,28,205,233,19,33,52,285,9,45,Missouri,Rolla,19559
11006,1956-1957,1956-12-01,1957-04-12,133,5,23,162,185,6,8,14,199,4,16,Missouri,Rolla,19559
11007,1957-1958,1957-12-01,1958-03-18,108,11,41,207,248,22,16,38,286,8,44,Missouri,Rolla,19559
11008,1958-1959,1958-11-27,1959-02-28,94,4,54,220,274,15,20,35,309,6,50,Missouri,Rolla,19559
11009,1962-1963,1962-12-01,1963-03-01,91,1,62,268,330,10,15,25,355,4,41,Missouri,Rolla,19559
11010,1963-1964,1963-12-01,1964-03-10,101,0,48,213,261,27,29,56,317,6,43,Missouri,Rolla,19559
11011,1966-1967,1966-11-03,1967-03-08,126,10,37,202,239,11,8,19,258,7,30,Missouri,Rolla,19559
11012,1971-1972,1971-11-24,1972-02-29,98,17,28,143,171,15,11,26,197,7,36,Missouri,Rolla,19559
11013,1973-1974,1973-12-01,1974-03-25,115,4,44,202,246,36,90,126,372,8,64,Missouri,Rolla,19559
11014,1974-1975,1974-12-01,1975-04-03,124,12,21,174,195,18,32,50,245,4,25,Missouri,Rolla,19559
11015,1979-1980,1979-11-11,1980-04-15,157,1,46,246,292,41,86,127,419,17,95,Missouri,Rolla,19559
11016,1980-1981,1980-11-17,1981-02-28,104,0,35,224,259,26,41,67,326,11,64,Missouri,Rolla,19559
11017,1981-1982,1981-11-21,1982-04-08,139,7,61,299,360,34,108,142,502,14,93,Missouri,Rolla,19559
11018,1982-1983,1982-11-25,1983-04-18,145,2,20,149,169,15,9,24,193,12,46,Missouri,Rolla,19559
11019,1983-1984,1983-11-29,1984-03-13,106,3,82,283,365,41,134,175,540,20,153,Missouri,Rolla,19559
11020,1984-1985,1984-11-19,1985-02-28,102,6,53,243,296,36,133,169,465,17,107,Missouri,Rolla,19559
11021,1985-1986,1985-11-29,1986-03-01,93,3,42,218,260,24,43,67,327,11,70,Missouri,Rolla,19559
11022,1986-1987,1986-11-14,1987-03-11,118,3,23,142,165,24,58,82,247,13,54,Missouri,Rolla,19559
11023,1987-1988,1987-12-01,1988-03-18,109,1,43,223,266,36,59,95,361,16,94,Missouri,Rolla,19559
11024,1988-1989,1988-11-20,1989-03-21,122,1,31,215,246,58,89,147,393,16,131,Missouri,Rolla,19559
11025,1989-1990,1989-11-16,1990-03-25,130,2,44,219,263,27,68,95,358,10,64,Missouri,Rolla,19559
11026,1990-1991,1990-12-01,1991-03-15,105,0,34,178,212,31,73,104,316,19,116,Missouri,Rolla,19559
11027,1991-1992,1991-11-03,1992-03-20,139,10,15,155,170,13,12,25,195,8,31,Missouri,Rolla,19559
11028,1992-1993,1992-11-07,1993-04-17,162,4,27,222,249,43,44,87,336,23,91,Missouri,Rolla,19559
11029,1993-1994,1993-10-30,1994-04-07,160,4,42,226,268,33,38,71,339,20,99,Missouri,Rolla,19559
11030,1994-1995,1994-12-01,1995-03-09,99,0,26,170,196,23,33,56,252,13,69,Missouri,Rolla,19559
11031,1995-1996,1995-11-05,1996-03-25,142,0,57,275,332,56,97,153,485,28,178,Missouri,Rolla,19559
11032,1996-1997,1996-11-26,1997-02-28,95,0,49,202,251,38,75,113,364,19,123,Missouri,Rolla,19559
11033,1997-1998,1997-11-03,1998-03-21,139,0,19,145,164,49,44,93,257,28,112,Missouri,Rolla,19559
11034,1998-1999,1998-12-01,1999-03-14,104,4,31,155,186,28,54,82,268,16,88,Missouri,Rolla,19559
11035,1999-2000,1999-12-01,2000-03-13,104,0,14,132,146,24,39,63,209,11,52,Missouri,Rolla,19559
11036,2000-2001,2000-12-01,2001-03-17,107,3,50,257,307,29,116,145,452,19,116,Missouri,Rolla,19559
11037,2001-2002,2001-11-28,2002-03-26,119,3,23,156,179,24,21,45,224,13,66,Missouri,Rolla,19559
11038,2002-2003,2002-12-01,2003-04-09,130,3,47,229,276,51,80,131,407,27,150,Missouri,Rolla,19559
11039,2003-2004,2003-11-29,2004-05-03,157,0,30,188,218,20,25,45,263,16,78,Missouri,Rolla,19559
11040,2004-2005,2004-11-25,2005-03-09,105,0,24,144,168,28,15,43,211,15,71,Missouri,Rolla,19559
11041,2005-2006,2005-11-30,2006-02-28,91,2,18,146,164,13,3,16,180,11,57,Missouri,Rolla,19559
11042,2006-2007,2006-12-01,2007-04-04,125,2,38,178,216,30,39,69,285,17,94,Missouri,Rolla,19559
11043,2007-2008,2007-11-22,2008-04-13,144,10,24,211,235,27,16,43,278,20,86,Missouri,Rolla,19559
11044,2008-2009,2008-11-30,2009-04-07,129,4,33,251,284,36,25,61,345,21,104,Missouri,Rolla,19559
11045,2009-2010,2009-12-01,2010-02-28,90,4,50,227,277,38,81,119,396,17,115,Missouri,Rolla,19559
11046,2013-2014,2013-11-25,2014-03-25,121,0,61,320,381,40,70,110,491,20,138,Missouri,Rolla,19559
11047,2014-2015,2014-11-14,2015-03-29,136,0,41,245,286,34,35,69,355,20,107,Missouri,Rolla,19559
11048,2015-2016,2015-11-22,2016-03-21,121,0,19,127,146,16,15,31,177,11,53,Missouri,Rolla,19559
11049,2016-2017,2016-12-01,2017-03-15,105,0,22,137,159,8,6,14,173,7,35,Missouri,Rolla,19559
11050,2017-2018,2017-12-01,2018-04-02,123,0,45,215,260,18,8,26,286,15,63,Missouri,Rolla,19559
11051,2018-2019,2018-11-09,2019-04-15,158,0,31,208,239,47,45,92,331,26,119,Missouri,Rolla,19559
11052,2019-2020,2019-10-31,2020-03-23,145,0,16,143,159,28,30,58,217,17,67,Missouri,Rolla,19559
11053,1950-1951,1950-11-10,1951-03-20,131,2,69,336,405,29,61,90,495,15,106,Missouri,Shelbina,1704
11054,1952-1953,1952-11-27,1953-04-18,143,11,14,198,212,17,30,47,259,7,36,Missouri,Shelbina,1704
11055,1953-1954,1953-12-01,1954-03-03,93,0,20,194,214,6,16,22,236,2,15,Missouri,Shelbina,1704
11056,1954-1955,1954-12-01,1955-03-27,117,2,28,230,258,30,46,76,334,11,89,Missouri,Shelbina,1704
11057,1955-1956,1955-11-28,1956-03-16,110,0,40,298,338,24,42,66,404,10,61,Missouri,Shelbina,1704
11058,1956-1957,1956-11-23,1957-04-12,141,1,32,262,294,18,40,58,352,9,48,Missouri,Shelbina,1704
11059,1957-1958,1957-12-01,1958-03-20,110,0,44,255,299,26,87,113,412,11,55,Missouri,Shelbina,1704
11060,1958-1959,1958-11-27,1959-03-06,100,9,61,316,377,14,134,148,525,3,25,Missouri,Shelbina,1704
11061,1959-1960,1959-11-06,1960-03-27,143,0,58,351,409,52,215,267,676,14,96,Missouri,Shelbina,1704
11062,1960-1961,1960-12-01,1961-04-09,130,18,39,271,310,33,106,139,449,9,74,Missouri,Shelbina,1704
11063,1961-1962,1961-11-19,1962-03-21,123,3,69,324,393,50,183,233,626,16,114,Missouri,Shelbina,1704
11064,1962-1963,1962-12-01,1963-03-02,92,1,85,350,435,26,101,127,562,10,102,Missouri,Shelbina,1704
11065,1963-1964,1963-12-01,1964-03-27,118,0,55,329,384,38,86,124,508,12,91,Missouri,Shelbina,1704
11066,1964-1965,1964-11-19,1965-03-28,130,0,55,360,415,66,151,217,632,21,158,Missouri,Shelbina,1704
11067,1965-1966,1965-12-01,1966-03-06,96,0,35,233,268,7,4,11,279,5,24,Missouri,Shelbina,1704
11068,1966-1967,1966-12-01,1967-03-08,98,0,26,255,281,19,69,88,369,5,37,Missouri,Shelbina,1704
11069,1967-1968,1967-12-01,1968-02-29,91,0,42,252,294,17,47,64,358,7,59,Missouri,Shelbina,1704
11070,1969-1970,1969-11-14,1970-04-02,140,3,66,356,422,27,105,132,554,10,51,Missouri,Shelbina,1704
11071,1971-1972,1971-12-01,1972-03-29,120,4,41,247,288,17,43,60,348,7,43,Missouri,Shelbina,1704
11072,1972-1973,1972-11-19,1973-04-09,142,2,53,246,299,16,26,42,341,5,29,Missouri,Shelbina,1704
11073,1973-1974,1973-12-01,1974-03-24,114,1,57,244,301,45,107,152,453,12,111,Missouri,Shelbina,1704
11074,1974-1975,1974-11-14,1975-04-03,141,0,23,250,273,47,83,130,403,15,89,Missouri,Shelbina,1704
11075,1975-1976,1975-11-26,1976-03-23,119,1,29,231,260,47,50,97,357,15,94,Missouri,Shelbina,1704
11076,1976-1977,1976-11-28,1977-03-22,115,5,98,397,495,39,207,246,741,14,126,Missouri,Shelbina,1704
11077,1978-1979,1978-11-21,1979-03-25,125,0,101,428,529,65,371,436,965,22,224,Missouri,Shelbina,1704
11078,1979-1980,1979-11-29,1980-04-14,138,3,41,293,334,36,100,136,470,10,68,Missouri,Shelbina,1704
11079,1980-1981,1980-11-27,1981-02-28,94,16,35,261,296,13,8,21,317,6,31,Missouri,Shelbina,1704
11080,1988-1989,1988-11-20,1989-02-28,101,1,32,176,208,15,47,62,270,8,43,Missouri,Shelbina,1704
11081,1989-1990,1989-12-01,1990-03-26,116,0,50,208,258,29,79,108,366,9,68,Missouri,Shelbina,1704
11082,1990-1991,1990-11-05,1991-02-28,116,0,43,215,258,13,21,34,292,6,44,Missouri,Shelbina,1704
11083,1991-1992,1991-11-02,1992-03-19,139,2,18,174,192,17,23,40,232,7,37,Missouri,Shelbina,1704
11084,1993-1994,1993-11-26,1994-03-03,98,13,58,239,297,22,71,93,390,7,45,Missouri,Shelbina,1704
11085,1994-1995,1994-12-01,1995-03-08,98,7,37,205,242,19,63,82,324,6,44,Missouri,Shelbina,1704
11086,1995-1996,1995-11-05,1996-03-08,125,12,54,297,351,22,65,87,438,12,77,Missouri,Shelbina,1704
11087,2001-2002,2001-12-01,2002-03-26,116,15,24,229,253,8,4,12,265,4,24,Missouri,Shelbina,1704
11088,2003-2004,2003-11-29,2004-03-16,109,6,60,258,318,23,90,113,431,12,83,Missouri,Shelbina,1704
11089,2004-2005,2004-11-25,2005-03-01,97,14,44,203,247,16,13,29,276,7,47,Missouri,Shelbina,1704
11090,2005-2006,2005-11-17,2006-03-20,124,5,43,252,295,18,21,39,334,10,72,Missouri,Shelbina,1704
11091,2006-2007,2006-12-01,2007-03-18,108,7,66,282,348,38,161,199,547,11,92,Missouri,Shelbina,1704
11092,2007-2008,2007-11-23,2008-03-04,103,6,67,308,375,34,78,112,487,15,98,Missouri,Shelbina,1704
11093,2008-2009,2008-11-22,2009-03-12,111,4,64,327,391,16,31,47,438,10,69,Missouri,Shelbina,1704
11094,2009-2010,2009-12-01,2010-03-21,111,3,81,320,401,34,149,183,584,14,89,Missouri,Shelbina,1704
11095,2011-2012,2011-12-01,2012-02-29,91,6,17,169,186,10,10,20,206,4,22,Missouri,Shelbina,1704
11096,2012-2013,2012-12-01,2013-03-27,117,1,44,277,321,54,122,176,497,12,84,Missouri,Shelbina,1704
11097,2013-2014,2013-11-24,2014-03-17,114,3,124,473,597,48,128,176,773,18,148,Missouri,Shelbina,1704
11098,2014-2015,2014-11-12,2015-03-06,115,4,73,332,405,30,56,86,491,12,83,Missouri,Shelbina,1704
11099,2015-2016,2015-12-01,2016-02-29,91,4,37,179,216,11,16,27,243,5,36,Missouri,Shelbina,1704
11100,2016-2017,2016-12-01,2017-03-11,101,1,37,208,245,8,10,18,263,5,33,Missouri,Shelbina,1704
11101,2017-2018,2017-12-01,2018-04-09,130,5,80,331,411,14,19,33,444,9,63,Missouri,Shelbina,1704
11102,2018-2019,2018-11-09,2019-03-08,120,7,77,322,399,38,75,113,512,18,99,Missouri,Shelbina,1704
11103,2019-2020,2019-10-31,2020-02-29,122,14,41,226,267,28,48,76,343,12,61,Missouri,Shelbina,1704
11104,1950-1951,1950-11-10,1951-04-12,154,0,43,250,293,23,30,53,346,15,100,Missouri,Springfield,159498
11105,1951-1952,1951-10-31,1952-03-15,137,0,26,186,212,37,36,73,285,18,92,Missouri,Springfield,159498
11106,1952-1953,1952-11-09,1953-04-18,161,0,14,141,155,13,4,17,172,11,37,Missouri,Springfield,159498
11107,1953-1954,1953-12-01,1954-03-04,94,0,24,139,163,13,8,21,184,8,43,Missouri,Springfield,159498
11108,1954-1955,1954-12-01,1955-03-26,116,0,16,166,182,19,18,37,219,10,44,Missouri,Springfield,159498
11109,1955-1956,1955-11-28,1956-04-23,148,0,30,198,228,29,32,61,289,17,72,Missouri,Springfield,159498
11110,1956-1957,1956-11-26,1957-04-13,139,0,23,156,179,14,8,22,201,7,30,Missouri,Springfield,159498
11111,1957-1958,1957-11-29,1958-03-24,116,0,29,186,215,36,24,60,275,15,66,Missouri,Springfield,159498
11112,1958-1959,1958-11-27,1959-03-11,105,0,34,212,246,22,29,51,297,10,58,Missouri,Springfield,159498
11113,1959-1960,1959-11-06,1960-03-21,137,0,42,245,287,49,115,164,451,25,128,Missouri,Springfield,159498
11114,1960-1961,1960-12-01,1961-02-28,90,0,20,187,207,24,23,47,254,10,60,Missouri,Springfield,159498
11115,1961-1962,1961-12-01,1962-03-05,95,0,41,205,246,23,37,60,306,14,81,Missouri,Springfield,159498
11116,1962-1963,1962-11-17,1963-03-01,105,0,40,249,289,15,10,25,314,10,53,Missouri,Springfield,159498
11117,1963-1964,1963-12-01,1964-03-10,101,0,33,226,259,17,12,29,288,11,55,Missouri,Springfield,159498
11118,1964-1965,1964-11-21,1965-03-26,126,1,25,235,260,23,26,49,309,12,51,Missouri,Springfield,159498
11119,1965-1966,1965-12-01,1966-03-05,95,0,21,182,203,16,19,35,238,12,52,Missouri,Springfield,159498
11120,1966-1967,1966-12-01,1967-03-08,98,0,18,224,242,18,35,53,295,10,53,Missouri,Springfield,159498
11121,1967-1968,1967-11-03,1968-03-21,140,0,25,212,237,38,36,74,311,17,79,Missouri,Springfield,159498
11122,1968-1969,1968-11-10,1969-03-10,121,0,11,203,214,22,21,43,257,10,39,Missouri,Springfield,159498
11123,1969-1970,1969-11-14,1970-03-28,135,0,41,262,303,63,126,189,492,17,115,Missouri,Springfield,159498
11124,1970-1971,1970-11-23,1971-04-06,135,0,25,220,245,30,21,51,296,11,49,Missouri,Springfield,159498
11125,1971-1972,1971-11-23,1972-02-29,99,0,15,143,158,9,3,12,170,6,28,Missouri,Springfield,159498
11126,1972-1973,1972-11-16,1973-04-09,145,0,36,191,227,34,60,94,321,17,86,Missouri,Springfield,159498
11127,1973-1974,1973-12-01,1974-03-25,115,0,29,174,203,35,50,85,288,17,90,Missouri,Springfield,159498
11128,1974-1975,1974-11-29,1975-03-16,108,0,13,165,178,45,69,114,292,10,69,Missouri,Springfield,159498
11129,1975-1976,1975-11-25,1976-03-16,113,0,14,157,171,18,12,30,201,8,40,Missouri,Springfield,159498
11130,1976-1977,1976-11-11,1977-04-05,146,0,46,324,370,34,123,157,527,17,105,Missouri,Springfield,159498
11131,1977-1978,1977-11-26,1978-03-25,120,0,83,324,407,49,194,243,650,28,163,Missouri,Springfield,159498
11132,1978-1979,1978-12-01,1979-02-28,90,0,69,304,373,43,217,260,633,19,157,Missouri,Springfield,159498
11133,1979-1980,1979-11-29,1980-04-14,138,0,21,178,199,38,62,100,299,15,64,Missouri,Springfield,159498
11134,1980-1981,1980-11-17,1981-02-28,104,0,17,183,200,24,22,46,246,9,41,Missouri,Springfield,159498
11135,1981-1982,1981-12-01,1982-03-06,96,0,39,222,261,39,86,125,386,15,83,Missouri,Springfield,159498
11136,1982-1983,1982-12-01,1983-03-27,117,0,7,113,120,10,11,21,141,6,18,Missouri,Springfield,159498
11137,1983-1984,1983-11-28,1984-03-31,125,0,67,250,317,47,139,186,503,18,136,Missouri,Springfield,159498
11138,1984-1985,1984-11-18,1985-02-28,103,0,36,221,257,38,128,166,423,16,103,Missouri,Springfield,159498
11139,1985-1986,1985-11-28,1986-02-28,93,0,28,200,228,24,34,58,286,14,83,Missouri,Springfield,159498
11140,1986-1987,1986-11-12,1987-02-28,109,0,14,142,156,19,37,56,212,10,40,Missouri,Springfield,159498
11141,1987-1988,1987-11-29,1988-03-18,111,0,33,218,251,39,56,95,346,17,91,Missouri,Springfield,159498
11142,1988-1989,1988-11-20,1989-03-11,112,0,26,202,228,42,67,109,337,13,98,Missouri,Springfield,159498
11143,1989-1990,1989-12-01,1990-03-24,114,0,30,185,215,23,24,47,262,12,62,Missouri,Springfield,159498
11144,1990-1991,1990-12-01,1991-02-28,90,0,25,143,168,23,60,83,251,12,74,Missouri,Springfield,159498
11145,1991-1992,1991-11-02,1992-03-19,139,0,7,130,137,7,13,20,157,2,10,Missouri,Springfield,159498
11146,1992-1993,1992-11-07,1993-04-04,149,0,22,174,196,35,50,85,281,15,60,Missouri,Springfield,159498
11147,1993-1994,1993-10-29,1994-04-06,160,0,25,213,238,29,21,50,288,20,101,Missouri,Springfield,159498
11148,1994-1995,1994-12-01,1995-03-03,93,0,14,132,146,28,45,73,219,9,49,Missouri,Springfield,159498
11149,1995-1996,1995-11-10,1996-03-08,120,0,48,244,292,35,70,105,397,13,78,Missouri,Springfield,159498
11150,1996-1997,1996-11-24,1997-02-28,97,0,41,174,215,23,51,74,289,12,64,Missouri,Springfield,159498
11151,1997-1998,1997-11-12,1998-03-21,130,0,9,128,137,26,15,41,178,16,49,Missouri,Springfield,159498
11152,1998-1999,1998-12-01,1999-03-16,106,0,23,146,169,31,35,66,235,7,47,Missouri,Springfield,159498
11153,1999-2000,1999-12-01,2000-03-11,102,0,8,126,134,13,15,28,162,6,27,Missouri,Springfield,159498
11154,2000-2001,2000-12-01,2001-02-28,90,0,42,222,264,34,149,183,447,13,88,Missouri,Springfield,159498
11155,2002-2003,2002-12-01,2003-03-28,118,0,31,216,247,53,85,138,385,14,88,Missouri,Springfield,159498
11156,2003-2004,2003-12-01,2004-02-29,91,0,19,150,169,23,24,47,216,8,52,Missouri,Springfield,159498
11157,2004-2005,2004-12-01,2005-03-09,99,0,11,132,143,11,4,15,158,8,26,Missouri,Springfield,159498
11158,2005-2006,2005-12-01,2006-02-28,90,0,12,133,145,4,2,6,151,4,22,Missouri,Springfield,159498
11159,2006-2007,2006-11-30,2007-02-28,91,0,23,163,186,26,53,79,265,8,57,Missouri,Springfield,159498
11160,2007-2008,2007-11-24,2008-03-05,103,0,16,173,189,19,16,35,224,9,37,Missouri,Springfield,159498
11161,2008-2009,2008-11-30,2009-03-28,119,0,25,197,222,15,15,30,252,12,54,Missouri,Springfield,159498
11162,2009-2010,2009-12-01,2010-03-22,112,0,43,227,270,33,45,78,348,19,116,Missouri,Springfield,159498
11163,2010-2011,2010-11-25,2011-03-28,124,0,37,230,267,33,76,109,376,14,88,Missouri,Springfield,159498
11164,2011-2012,2011-12-01,2012-02-29,91,0,5,111,116,5,1,6,122,4,14,Missouri,Springfield,159498
11165,2012-2013,2012-12-01,2013-05-04,155,0,10,162,172,22,12,34,206,12,40,Missouri,Springfield,159498
11166,2013-2014,2013-11-24,2014-03-16,113,0,44,274,318,52,88,140,458,20,142,Missouri,Springfield,159498
11167,2014-2015,2014-11-12,2015-03-05,114,0,23,205,228,24,35,59,287,10,56,Missouri,Springfield,159498
11168,2015-2016,2015-12-01,2016-02-29,91,0,8,104,112,4,4,8,120,2,9,Missouri,Springfield,159498
11169,2016-2017,2016-12-01,2017-03-14,104,0,14,118,132,4,3,7,139,3,16,Missouri,Springfield,159498
11170,2017-2018,2017-12-01,2018-04-07,128,0,30,205,235,9,13,22,257,6,29,Missouri,Springfield,159498
11171,2018-2019,2018-11-12,2019-03-05,114,0,17,158,175,13,5,18,193,11,55,Missouri,Springfield,159498
11172,2019-2020,2019-11-11,2020-02-29,111,0,8,124,132,15,2,17,149,11,33,Missouri,Springfield,159498
11173,1950-1951,1950-11-23,1951-03-20,118,0,54,231,285,38,40,78,363,19,114,Missouri,St. Louis,14545
11174,1951-1952,1951-11-04,1952-03-15,133,0,26,172,198,30,22,52,250,15,57,Missouri,St. Louis,14545
11175,1952-1953,1952-11-27,1953-03-07,101,0,16,110,126,19,11,30,156,10,44,Missouri,St. Louis,14545
11176,1953-1954,1953-12-01,1954-03-04,94,0,19,130,149,4,1,5,154,3,12,Missouri,St. Louis,14545
11177,1954-1955,1954-12-01,1955-03-27,117,0,21,161,182,10,5,15,197,7,32,Missouri,St. Louis,14545
11178,1955-1956,1955-11-28,1956-03-16,110,0,27,185,212,30,48,78,290,12,56,Missouri,St. Louis,14545
11179,1956-1957,1956-11-22,1957-04-12,142,0,31,164,195,19,7,26,221,15,43,Missouri,St. Louis,14545
11180,1957-1958,1957-12-01,1958-03-17,107,0,43,184,227,37,57,94,321,10,53,Missouri,St. Louis,14545
11181,1958-1959,1958-11-26,1959-03-11,106,0,55,225,280,17,19,36,316,9,45,Missouri,St. Louis,14545
11182,1959-1960,1959-11-06,1960-03-23,139,0,51,220,271,55,122,177,448,22,116,Missouri,St. Louis,14545
11183,1960-1961,1960-12-01,1961-02-28,90,0,34,212,246,34,91,125,371,12,76,Missouri,St. Louis,14545
11184,1961-1962,1961-11-18,1962-03-05,108,0,45,217,262,35,72,107,369,16,85,Missouri,St. Louis,14545
11185,1962-1963,1962-12-01,1963-03-09,99,0,71,292,363,14,29,43,406,11,53,Missouri,St. Louis,14545
11186,1963-1964,1963-12-01,1964-03-20,111,0,50,229,279,48,93,141,420,18,94,Missouri,St. Louis,14545
11187,1964-1965,1964-11-19,1965-03-26,128,0,51,278,329,37,45,82,411,16,99,Missouri,St. Louis,14545
11188,1965-1966,1965-11-29,1966-03-06,98,0,42,198,240,16,33,49,289,7,42,Missouri,St. Louis,14545
11189,1966-1967,1966-12-01,1967-03-19,109,0,28,194,222,11,3,14,236,10,39,Missouri,St. Louis,14545
11190,1967-1968,1967-11-30,1968-03-21,113,0,46,238,284,34,42,76,360,17,93,Missouri,St. Louis,14545
11191,1968-1969,1968-12-01,1969-03-26,116,0,30,199,229,19,13,32,261,11,44,Missouri,St. Louis,14545
11192,1969-1970,1969-11-14,1970-04-04,142,0,54,259,313,35,96,131,444,22,92,Missouri,St. Louis,14545
11193,1970-1971,1970-11-15,1971-04-06,143,0,36,252,288,17,6,23,311,11,47,Missouri,St. Louis,14545
11194,1971-1972,1971-11-23,1972-03-29,128,0,29,197,226,15,9,24,250,11,45,Missouri,St. Louis,14545
11195,1972-1973,1972-11-19,1973-04-09,142,0,39,193,232,23,19,42,274,14,59,Missouri,St. Louis,14545
11196,1973-1974,1973-12-01,1974-03-25,115,0,52,219,271,66,132,198,469,19,134,Missouri,St. Louis,14545
11197,1974-1975,1974-11-30,1975-03-13,104,0,26,170,196,39,32,71,267,14,80,Missouri,St. Louis,14545
11198,1975-1976,1975-11-26,1976-03-17,113,0,36,186,222,35,48,83,305,12,65,Missouri,St. Louis,14545
11199,1976-1977,1976-11-23,1977-04-05,134,0,94,340,434,57,212,269,703,27,195,Missouri,St. Louis,14545
11200,1977-1978,1977-11-26,1978-03-26,121,0,110,358,468,95,419,514,982,34,232,Missouri,St. Louis,14545
11201,1978-1979,1978-12-01,1979-03-27,117,1,98,316,414,39,199,238,652,20,145,Missouri,St. Louis,14545
11202,1979-1980,1979-11-28,1980-04-15,140,0,42,199,241,39,91,130,371,17,86,Missouri,St. Louis,14545
11203,1980-1981,1980-11-17,1981-03-05,109,0,33,199,232,28,44,72,304,11,59,Missouri,St. Louis,14545
11204,1981-1982,1981-12-01,1982-04-08,129,0,69,284,353,53,185,238,591,19,135,Missouri,St. Louis,14545
11205,1982-1983,1982-11-24,1983-04-18,146,0,16,121,137,13,2,15,152,9,26,Missouri,St. Louis,14545
11206,1983-1984,1983-12-01,1984-03-14,105,0,82,250,332,36,103,139,471,21,130,Missouri,St. Louis,14545
11207,1984-1985,1984-11-18,1985-02-28,103,0,53,210,263,17,34,51,314,13,68,Missouri,St. Louis,14545
11208,1985-1986,1985-11-24,1986-03-20,117,0,38,215,253,20,28,48,301,8,62,Missouri,St. Louis,14545
11209,1986-1987,1986-11-13,1987-02-28,108,0,21,134,155,34,74,108,263,10,62,Missouri,St. Louis,14545
11210,1987-1988,1987-12-01,1988-03-18,109,0,43,187,230,31,48,79,309,16,81,Missouri,St. Louis,14545
11211,1988-1989,1988-11-20,1989-03-10,111,0,25,159,184,34,67,101,285,12,81,Missouri,St. Louis,14545
11212,1989-1990,1989-12-01,1990-03-26,116,0,44,164,208,39,64,103,311,14,103,Missouri,St. Louis,14545
11213,1990-1991,1990-12-01,1991-03-14,104,0,38,146,184,29,59,88,272,18,93,Missouri,St. Louis,14545
11214,1991-1992,1991-11-02,1992-03-19,139,0,12,117,129,20,23,43,172,10,43,Missouri,St. Louis,14545
11215,1992-1993,1992-12-01,1993-04-01,122,0,30,161,191,46,77,123,314,17,82,Missouri,St. Louis,14545
11216,1993-1994,1993-11-26,1994-04-06,132,0,47,178,225,21,24,45,270,16,70,Missouri,St. Louis,14545
11217,1994-1995,1994-12-01,1995-03-08,98,0,25,121,146,13,11,24,170,11,38,Missouri,St. Louis,14545
11218,1995-1996,1995-11-05,1996-03-20,137,0,54,226,280,43,104,147,427,20,116,Missouri,St. Louis,14545
11219,1996-1997,1996-11-25,1997-04-18,145,0,56,199,255,36,65,101,356,16,86,Missouri,St. Louis,14545
11220,1997-1998,1997-11-03,1998-03-20,138,0,18,117,135,31,23,54,189,18,60,Missouri,St. Louis,14545
11221,1998-1999,1998-12-01,1999-03-08,98,0,32,134,166,24,84,108,274,12,68,Missouri,St. Louis,14545
11222,1999-2000,1999-12-01,2000-03-12,103,0,11,124,135,19,21,40,175,9,40,Missouri,St. Louis,14545
11223,2000-2001,2000-12-01,2001-02-28,90,0,56,218,274,34,115,149,423,21,129,Missouri,St. Louis,14545
11224,2001-2002,2001-11-28,2002-03-26,119,0,16,115,131,19,25,44,175,9,32,Missouri,St. Louis,14545
11225,2002-2003,2002-11-24,2003-03-09,106,0,35,184,219,44,66,110,329,19,94,Missouri,St. Louis,14545
11226,2003-2004,2003-12-01,2004-02-29,91,0,25,132,157,15,25,40,197,11,42,Missouri,St. Louis,14545
11227,2004-2005,2004-11-24,2005-03-11,108,0,21,128,149,21,24,45,194,15,50,Missouri,St. Louis,14545
11228,2005-2006,2005-12-01,2006-03-22,112,0,19,122,141,17,13,30,171,10,38,Missouri,St. Louis,14545
11229,2006-2007,2006-11-30,2007-03-03,94,0,31,148,179,21,42,63,242,13,69,Missouri,St. Louis,14545
11230,2007-2008,2007-12-01,2008-03-09,100,0,25,172,197,46,52,98,295,16,88,Missouri,St. Louis,14545
11231,2008-2009,2008-11-21,2009-04-06,137,0,38,199,237,24,26,50,287,16,73,Missouri,St. Louis,14545
11232,2009-2010,2009-12-01,2010-02-28,90,0,40,173,213,30,35,65,278,21,98,Missouri,St. Louis,14545
11233,2010-2011,2010-11-25,2011-03-27,123,0,44,189,233,55,105,160,393,22,108,Missouri,St. Louis,14545
11234,2011-2012,2011-12-01,2012-02-29,91,0,5,81,86,10,10,20,106,7,22,Missouri,St. Louis,14545
11235,2012-2013,2012-12-01,2013-03-28,118,0,11,139,150,45,41,86,236,17,72,Missouri,St. Louis,14545
11236,2013-2014,2013-11-24,2014-03-25,122,0,60,276,336,42,85,127,463,19,107,Missouri,St. Louis,14545
11237,2014-2015,2014-11-13,2015-03-05,113,0,33,208,241,27,35,62,303,18,90,Missouri,St. Louis,14545
11238,2015-2016,2015-12-01,2016-03-20,111,0,19,98,117,17,13,30,147,11,54,Missouri,St. Louis,14545
11239,2016-2017,2016-12-01,2017-03-14,104,0,20,107,127,8,3,11,138,7,31,Missouri,St. Louis,14545
11240,2017-2018,2017-12-01,2018-04-01,122,0,49,196,245,14,9,23,268,11,53,Missouri,St. Louis,14545
11241,2018-2019,2018-11-12,2019-03-07,116,0,30,181,211,36,42,78,289,15,82,Missouri,St. Louis,14545
11242,2019-2020,2019-11-11,2020-02-29,111,0,13,115,128,23,27,50,178,14,48,Missouri,St. Louis,14545
11243,1950-1951,1950-11-09,1951-04-04,147,12,110,537,647,36,180,216,863,18,166,Missouri,Unionville,1865
11244,1951-1952,1951-11-02,1952-03-25,145,5,72,347,419,32,169,201,620,14,114,Missouri,Unionville,1865
11245,1952-1953,1952-11-27,1953-03-10,104,17,40,237,277,2,104,106,383,1,4,Missouri,Unionville,1865
11246,1954-1955,1954-12-01,1955-03-28,118,1,69,311,380,41,125,166,546,15,111,Missouri,Unionville,1865
11247,1955-1956,1955-11-03,1956-03-16,135,0,73,374,447,45,66,111,558,16,120,Missouri,Unionville,1865
11248,1956-1957,1956-11-22,1957-03-27,126,1,64,306,370,39,82,121,491,13,110,Missouri,Unionville,1865
11249,1957-1958,1957-12-01,1958-03-09,99,0,71,273,344,44,144,188,532,15,105,Missouri,Unionville,1865
11250,1958-1959,1958-11-26,1959-03-16,111,1,93,345,438,70,183,253,691,17,170,Missouri,Unionville,1865
11251,1959-1960,1959-11-06,1960-03-27,143,2,88,391,479,89,327,416,895,19,167,Missouri,Unionville,1865
11252,1960-1961,1960-11-30,1961-04-09,131,1,53,284,337,39,62,101,438,12,90,Missouri,Unionville,1865
11253,1961-1962,1961-11-19,1962-03-21,123,0,124,407,531,99,416,515,1046,22,218,Missouri,Unionville,1865
11254,1962-1963,1962-10-25,1963-03-13,140,2,110,395,505,49,116,165,670,20,186,Missouri,Unionville,1865
11255,1963-1964,1963-12-01,1964-03-26,117,0,77,325,402,40,105,145,547,12,106,Missouri,Unionville,1865
11256,1964-1965,1964-11-21,1965-03-26,126,0,93,407,500,68,145,213,713,19,185,Missouri,Unionville,1865
11257,1965-1966,1965-11-29,1966-03-06,98,1,67,267,334,12,9,21,355,5,39,Missouri,Unionville,1865
11258,1966-1967,1966-11-02,1967-04-24,174,2,48,337,385,26,70,96,481,8,60,Missouri,Unionville,1865
11259,1967-1968,1967-10-27,1968-03-22,148,1,65,320,385,18,46,64,449,8,55,Missouri,Unionville,1865
11260,1968-1969,1968-11-10,1969-03-30,141,1,78,362,440,43,85,128,568,14,93,Missouri,Unionville,1865
11261,1969-1970,1969-11-14,1970-04-03,141,0,88,376,464,45,112,157,621,12,83,Missouri,Unionville,1865
11262,1970-1971,1970-11-23,1971-03-23,121,0,93,340,433,38,164,202,635,11,65,Missouri,Unionville,1865
11263,1971-1972,1971-11-24,1972-03-29,127,0,69,295,364,36,77,113,477,13,110,Missouri,Unionville,1865
11264,1972-1973,1972-11-14,1973-04-13,151,0,94,310,404,76,169,245,649,15,149,Missouri,Unionville,1865
11265,1973-1974,1973-11-09,1974-03-24,136,0,87,292,379,35,91,126,505,13,132,Missouri,Unionville,1865
11266,1974-1975,1974-11-14,1975-04-04,142,0,57,314,371,67,101,168,539,21,145,Missouri,Unionville,1865
11267,1975-1976,1975-11-21,1976-02-29,101,3,50,238,288,38,45,83,371,10,84,Missouri,Unionville,1865
11268,1976-1977,1976-11-12,1977-03-22,131,0,127,443,570,36,154,190,760,12,106,Missouri,Unionville,1865
11269,1977-1978,1977-11-25,1978-03-27,123,2,158,478,636,93,383,476,1112,23,226,Missouri,Unionville,1865
11270,1978-1979,1978-11-20,1979-04-04,136,2,179,522,701,61,449,510,1211,16,174,Missouri,Unionville,1865
11271,1986-1987,1986-10-13,1987-02-28,139,18,19,245,264,20,35,55,319,10,47,Missouri,Unionville,1865
11272,1987-1988,1987-12-01,1988-03-14,105,19,49,362,411,32,81,113,524,7,77,Missouri,Unionville,1865
11273,1989-1990,1989-12-01,1990-02-28,90,5,50,342,392,18,96,114,506,11,121,Missouri,Unionville,1865
11274,1991-1992,1991-11-03,1992-02-29,119,19,34,240,274,14,1,15,289,4,27,Missouri,Unionville,1865
11275,2005-2006,2005-11-17,2006-03-22,126,14,57,247,304,24,33,57,361,12,75,Missouri,Unionville,1865
11276,2006-2007,2006-12-01,2007-04-12,133,5,80,318,398,39,48,87,485,17,119,Missouri,Unionville,1865
11277,2007-2008,2007-11-22,2008-04-13,144,1,100,413,513,78,229,307,820,28,187,Missouri,Unionville,1865
11278,2008-2009,2008-11-22,2009-03-29,128,3,86,391,477,44,70,114,591,20,153,Missouri,Unionville,1865
11279,2009-2010,2009-12-01,2010-03-21,111,6,116,368,484,83,287,370,854,28,227,Missouri,Unionville,1865
11280,2010-2011,2010-11-30,2011-03-25,116,12,89,344,433,55,199,254,687,11,99,Missouri,Unionville,1865
11281,2011-2012,2011-12-01,2012-03-03,94,0,31,201,232,19,18,37,269,9,39,Missouri,Unionville,1865
11282,2012-2013,2012-11-27,2013-05-03,158,0,57,333,390,59,145,204,594,15,102,Missouri,Unionville,1865
11283,2013-2014,2013-11-23,2014-03-12,110,14,149,479,628,50,152,202,830,12,124,Missouri,Unionville,1865
11284,2014-2015,2014-11-12,2015-03-06,115,0,109,396,505,36,75,111,616,11,95,Missouri,Unionville,1865
11285,2015-2016,2015-11-21,2016-03-25,126,0,48,223,271,23,43,66,337,9,62,Missouri,Unionville,1865
11286,2016-2017,2016-12-01,2017-03-15,105,0,54,245,299,17,25,42,341,8,56,Missouri,Unionville,1865
11287,2017-2018,2017-12-01,2018-04-16,137,5,111,384,495,30,70,100,595,11,88,Missouri,Unionville,1865
11288,1950-1951,1950-09-29,1951-05-31,245,0,150,518,668,109,235,344,1012,50,393,Montana,Billings,104170
11289,1951-1952,1951-10-17,1952-04-21,188,0,135,501,636,79,267,346,982,42,302,Montana,Billings,104170
11290,1952-1953,1952-10-13,1953-05-12,212,0,38,292,330,58,67,125,455,31,145,Montana,Billings,104170
11291,1953-1954,1953-12-01,1954-05-04,155,0,93,381,474,97,189,286,760,37,286,Montana,Billings,104170
11292,1954-1955,1954-10-23,1955-04-10,170,0,69,417,486,130,225,355,841,39,321,Montana,Billings,104170
11293,1955-1956,1955-10-22,1956-05-04,196,0,160,550,710,124,258,382,1092,46,378,Montana,Billings,104170
11294,1956-1957,1956-10-31,1957-04-11,163,0,149,478,627,76,141,217,844,38,340,Montana,Billings,104170
11295,1957-1958,1957-09-18,1958-04-28,223,0,48,289,337,98,91,189,526,42,238,Montana,Billings,104170
11296,1958-1959,1958-11-04,1959-04-25,173,0,104,418,522,88,201,289,811,38,329,Montana,Billings,104170
11297,1959-1960,1959-10-07,1960-04-27,204,0,113,429,542,86,142,228,770,41,322,Montana,Billings,104170
11298,1960-1961,1960-11-07,1961-04-26,171,0,38,265,303,46,38,84,387,24,125,Montana,Billings,104170
11299,1961-1962,1961-09-29,1962-03-29,182,0,183,508,691,107,255,362,1053,46,385,Montana,Billings,104170
11300,1962-1963,1962-09-07,1963-04-22,228,0,101,377,478,95,158,253,731,41,374,Montana,Billings,104170
11301,1963-1964,1963-10-30,1964-05-03,187,0,85,383,468,96,131,227,695,36,249,Montana,Billings,104170
11302,1964-1965,1964-11-14,1965-05-06,174,0,146,558,704,82,210,292,996,42,370,Montana,Billings,104170
11303,1965-1966,1965-09-15,1966-04-29,227,0,127,480,607,81,189,270,877,39,308,Montana,Billings,104170
11304,1966-1967,1966-11-06,1967-05-10,186,0,72,377,449,103,156,259,708,48,308,Montana,Billings,104170
11305,1967-1968,1967-11-01,1968-04-21,173,0,83,334,417,68,169,237,654,36,204,Montana,Billings,104170
11306,1968-1969,1968-11-04,1969-04-29,177,0,212,543,755,57,256,313,1068,35,300,Montana,Billings,104170
11307,1969-1970,1969-10-10,1970-04-30,203,0,95,425,520,94,113,207,727,40,264,Montana,Billings,104170
11308,1970-1971,1970-09-11,1971-04-27,229,0,132,480,612,75,164,239,851,43,345,Montana,Billings,104170
11309,1971-1972,1971-10-01,1972-04-19,202,0,155,552,707,114,356,470,1177,42,343,Montana,Billings,104170
11310,1972-1973,1972-09-24,1973-05-01,220,0,162,436,598,93,205,298,896,41,335,Montana,Billings,104170
11311,1973-1974,1973-10-09,1974-05-13,217,0,111,336,447,86,187,273,720,39,284,Montana,Billings,104170
11312,1974-1975,1974-10-05,1975-05-25,233,0,115,458,573,94,271,365,938,48,320,Montana,Billings,104170
11313,1975-1976,1975-10-13,1976-04-27,198,0,105,402,507,100,266,366,873,39,287,Montana,Billings,104170
11314,1976-1977,1976-10-17,1977-04-17,183,0,75,387,462,80,166,246,708,42,282,Montana,Billings,104170
11315,1977-1978,1977-10-09,1978-03-19,162,0,245,562,807,126,628,754,1561,50,583,Montana,Billings,104170
11316,1978-1979,1978-11-09,1979-05-09,182,0,271,641,912,115,805,920,1832,53,460,Montana,Billings,104170
11317,1979-1980,1979-10-20,1980-04-11,175,0,113,390,503,88,150,238,741,39,255,Montana,Billings,104170
11318,1980-1981,1980-10-15,1981-05-12,210,0,55,294,349,99,78,177,526,33,224,Montana,Billings,104170
11319,1981-1982,1981-10-11,1982-05-09,211,0,153,505,658,100,150,250,908,52,382,Montana,Billings,104170
11320,1982-1983,1982-09-14,1983-05-13,242,0,31,264,295,71,77,148,443,34,150,Montana,Billings,104170
11321,1983-1984,1983-09-18,1984-04-28,224,0,147,380,527,82,225,307,834,47,310,Montana,Billings,104170
11322,1984-1985,1984-09-23,1985-04-06,196,0,145,530,675,108,286,394,1069,38,258,Montana,Billings,104170
11323,1985-1986,1985-09-23,1986-05-09,229,0,178,458,636,107,303,410,1046,47,424,Montana,Billings,104170
11324,1986-1987,1986-11-06,1987-05-20,196,0,55,302,357,55,121,176,533,32,160,Montana,Billings,104170
11325,1987-1988,1987-10-09,1988-05-01,206,0,81,371,452,55,121,176,628,26,181,Montana,Billings,104170
11326,1988-1989,1988-10-26,1989-04-28,185,0,154,470,624,109,288,397,1021,52,417,Montana,Billings,104170
11327,1989-1990,1989-10-02,1990-04-30,211,0,80,373,453,103,198,301,754,51,316,Montana,Billings,104170
11328,1990-1991,1990-10-06,1991-05-03,210,0,117,424,541,89,160,249,790,41,289,Montana,Billings,104170
11329,1991-1992,1991-10-03,1992-04-23,204,0,32,272,304,51,93,144,448,23,111,Montana,Billings,104170
11330,1992-1993,1992-10-13,1993-04-20,190,0,155,478,633,73,180,253,886,44,317,Montana,Billings,104170
11331,1993-1994,1993-10-07,1994-04-28,204,0,92,388,480,76,115,191,671,41,310,Montana,Billings,104170
11332,1994-1995,1994-11-17,1995-05-13,178,0,72,313,385,71,101,172,557,28,177,Montana,Billings,104170
11333,1995-1996,1995-09-19,1996-05-10,235,3,168,504,672,101,175,276,948,51,414,Montana,Billings,104170
11334,1996-1997,1996-10-20,1997-04-15,178,0,194,528,722,139,295,434,1156,53,489,Montana,Billings,104170
11335,1997-1998,1997-10-24,1998-03-30,158,0,72,322,394,75,102,177,571,28,200,Montana,Billings,104170
11336,1998-1999,1998-11-03,1999-04-14,163,0,59,290,349,76,97,173,522,35,221,Montana,Billings,104170
11337,1999-2000,1999-10-01,2000-05-12,225,0,30,266,296,58,101,159,455,32,162,Montana,Billings,104170
11338,2000-2001,2000-09-21,2001-04-21,213,1,106,459,565,92,160,252,817,45,290,Montana,Billings,104170
11339,2001-2002,2001-10-14,2002-05-23,222,0,93,404,497,92,105,197,694,42,315,Montana,Billings,104170
11340,2002-2003,2002-10-21,2003-04-03,165,0,82,362,444,76,111,187,631,36,272,Montana,Billings,104170
11341,2003-2004,2003-10-30,2004-05-12,196,0,76,346,422,61,131,192,614,37,206,Montana,Billings,104170
11342,2004-2005,2004-11-19,2005-05-12,175,0,84,316,400,79,97,176,576,32,237,Montana,Billings,104170
11343,2005-2006,2005-10-04,2006-04-23,202,0,69,311,380,58,81,139,519,28,196,Montana,Billings,104170
11344,2006-2007,2006-10-11,2007-04-19,191,0,87,371,458,94,113,207,665,37,253,Montana,Billings,104170
11345,2007-2008,2007-11-19,2008-05-02,166,6,58,371,429,52,78,130,559,29,173,Montana,Billings,104170
11346,2008-2009,2008-10-09,2009-04-24,198,0,117,373,490,111,207,318,808,49,343,Montana,Billings,104170
11347,2009-2010,2009-10-05,2010-05-06,214,0,123,400,523,81,247,328,851,39,290,Montana,Billings,104170
11348,2010-2011,2010-11-17,2011-05-01,166,0,155,445,600,110,272,382,982,50,356,Montana,Billings,104170
11349,2011-2012,2011-11-05,2012-05-26,204,0,42,281,323,62,69,131,454,28,187,Montana,Billings,104170
11350,2012-2013,2012-10-03,2013-04-22,202,0,56,352,408,65,73,138,546,37,186,Montana,Billings,104170
11351,2013-2014,2013-10-04,2014-05-07,216,0,147,442,589,149,310,459,1048,48,417,Montana,Billings,104170
11352,2014-2015,2014-11-09,2015-04-15,158,0,90,330,420,85,177,262,682,37,298,Montana,Billings,104170
11353,2015-2016,2015-11-20,2016-04-28,161,0,49,233,282,43,131,174,456,23,128,Montana,Billings,104170
11354,2016-2017,2016-10-11,2017-04-10,182,0,144,383,527,104,327,431,958,37,324,Montana,Billings,104170
11355,2017-2018,2017-11-01,2018-04-23,174,0,142,472,614,153,406,559,1173,52,474,Montana,Billings,104170
11356,2018-2019,2018-09-30,2019-05-18,231,0,147,483,630,100,260,360,990,52,440,Montana,Billings,104170
11357,2019-2020,2019-09-29,2020-04-16,201,0,62,367,429,84,94,178,607,48,270,Montana,Billings,104170
11358,1951-1952,1951-10-17,1952-05-21,218,4,116,624,740,171,886,1057,1797,57,428,Montana,Bozeman,37280
11359,1953-1954,1953-11-17,1954-05-01,166,12,74,404,478,94,282,376,854,24,193,Montana,Bozeman,37280
11360,1955-1956,1955-11-01,1956-04-08,160,17,156,594,750,92,755,847,1597,37,276,Montana,Bozeman,37280
11361,1958-1959,1958-11-05,1959-05-05,182,5,84,462,546,118,423,541,1087,47,318,Montana,Bozeman,37280
11362,1960-1961,1960-11-04,1961-04-27,175,2,28,404,432,126,253,379,811,36,222,Montana,Bozeman,37280
11363,1961-1962,1961-09-23,1962-04-28,218,0,153,633,786,131,757,888,1674,49,343,Montana,Bozeman,37280
11364,1962-1963,1962-11-16,1963-04-21,157,8,108,438,546,110,307,417,963,37,305,Montana,Bozeman,37280
11365,1963-1964,1963-10-30,1964-05-23,207,1,72,518,590,159,604,763,1353,65,369,Montana,Bozeman,37280
11366,1964-1965,1964-08-29,1965-05-09,254,0,79,520,599,162,335,497,1096,63,383,Montana,Bozeman,37280
11367,1965-1966,1965-09-15,1966-05-22,250,1,55,480,535,120,320,440,975,56,319,Montana,Bozeman,37280
11368,1966-1967,1966-10-02,1967-05-13,224,0,54,450,504,179,384,563,1067,71,393,Montana,Bozeman,37280
11369,1967-1968,1967-10-23,1968-06-29,251,0,98,563,661,186,690,876,1537,68,478,Montana,Bozeman,37280
11370,1968-1969,1968-09-21,1969-06-28,281,6,142,625,767,142,770,912,1679,50,395,Montana,Bozeman,37280
11371,1969-1970,1969-10-03,1970-05-14,224,0,58,444,502,131,279,410,912,59,301,Montana,Bozeman,37280
11372,1970-1971,1970-10-06,1971-05-18,225,0,81,477,558,128,412,540,1098,66,353,Montana,Bozeman,37280
11373,1971-1972,1971-09-16,1972-05-01,229,5,103,506,609,144,396,540,1149,67,402,Montana,Bozeman,37280
11374,1972-1973,1972-09-25,1973-06-17,266,0,147,588,735,164,454,618,1353,53,375,Montana,Bozeman,37280
11375,1973-1974,1973-09-14,1974-06-07,267,0,95,439,534,147,373,520,1054,54,357,Montana,Bozeman,37280
11376,1974-1975,1974-09-27,1975-05-25,241,3,95,548,643,184,670,854,1497,75,437,Montana,Bozeman,37280
11377,1975-1976,1975-10-08,1976-06-14,251,0,81,474,555,180,486,666,1221,68,416,Montana,Bozeman,37280
11378,1976-1977,1976-10-17,1977-05-28,224,0,54,413,467,100,343,443,910,55,300,Montana,Bozeman,37280
11379,1977-1978,1977-11-17,1978-05-05,170,0,103,424,527,93,525,618,1145,43,273,Montana,Bozeman,37280
11380,1978-1979,1978-09-12,1979-06-07,269,3,209,707,916,151,744,895,1811,64,472,Montana,Bozeman,37280
11381,1979-1980,1979-10-20,1980-05-25,219,0,106,496,602,155,662,817,1419,49,354,Montana,Bozeman,37280
11382,1980-1981,1980-10-15,1981-06-14,243,0,38,348,386,103,209,312,698,39,183,Montana,Bozeman,37280
11383,1981-1982,1981-10-04,1982-06-08,248,7,104,501,605,194,514,708,1313,72,434,Montana,Bozeman,37280
11384,1982-1983,1982-09-14,1983-05-13,242,3,45,374,419,143,304,447,866,61,279,Montana,Bozeman,37280
11385,1983-1984,1983-09-19,1984-05-25,250,3,135,496,631,178,518,696,1327,68,418,Montana,Bozeman,37280
11386,1984-1985,1984-09-23,1985-04-24,214,0,107,601,708,132,655,787,1495,58,380,Montana,Bozeman,37280
11387,1985-1986,1985-09-23,1986-05-22,242,0,131,520,651,129,571,700,1351,51,352,Montana,Bozeman,37280
11388,1986-1987,1986-11-06,1987-04-19,165,0,49,394,443,71,388,459,902,38,209,Montana,Bozeman,37280
11389,1987-1988,1987-11-16,1988-05-01,168,0,73,428,501,104,463,567,1068,44,230,Montana,Bozeman,37280
11390,1988-1989,1988-09-11,1989-05-29,261,0,144,556,700,139,647,786,1486,68,422,Montana,Bozeman,37280
11391,1989-1990,1989-09-10,1990-05-15,248,1,51,407,458,134,475,609,1067,47,261,Montana,Bozeman,37280
11392,1990-1991,1990-10-06,1991-05-10,217,2,99,472,571,149,422,571,1142,53,366,Montana,Bozeman,37280
11393,1991-1992,1991-10-22,1992-04-23,185,0,37,363,400,74,282,356,756,28,142,Montana,Bozeman,37280
11394,1992-1993,1992-08-24,1993-04-26,246,0,133,569,702,125,607,732,1434,54,347,Montana,Bozeman,37280
11395,1993-1994,1993-10-08,1994-04-28,203,5,48,421,469,106,339,445,914,40,227,Montana,Bozeman,37280
11396,1994-1995,1994-10-03,1995-04-30,210,3,87,469,556,160,782,942,1498,41,289,Montana,Bozeman,37280
11397,1995-1996,1995-10-21,1996-05-10,203,6,122,499,621,110,294,404,1025,57,361,Montana,Bozeman,37280
11398,1996-1997,1996-09-26,1997-05-03,220,3,103,536,639,230,969,1199,1838,71,483,Montana,Bozeman,37280
11399,1997-1998,1997-10-11,1998-04-18,190,3,51,498,549,133,724,857,1406,48,300,Montana,Bozeman,37280
11400,1999-2000,1999-09-27,2000-05-11,228,13,12,373,385,93,143,236,621,41,177,Montana,Bozeman,37280
11401,2001-2002,2001-10-05,2002-06-11,250,6,54,534,588,113,429,542,1130,48,305,Montana,Bozeman,37280
11402,2002-2003,2002-10-28,2003-05-19,204,4,51,466,517,117,308,425,942,50,260,Montana,Bozeman,37280
11403,2003-2004,2003-10-30,2004-04-28,182,8,54,484,538,104,616,720,1258,39,229,Montana,Bozeman,37280
11404,2004-2005,2004-11-03,2005-05-12,191,11,52,405,457,113,116,229,686,51,277,Montana,Bozeman,37280
11405,2005-2006,2005-10-02,2006-04-26,207,6,61,436,497,132,599,731,1228,48,250,Montana,Bozeman,37280
11406,2006-2007,2006-10-16,2007-05-29,226,10,64,472,536,150,503,653,1189,59,333,Montana,Bozeman,37280
11407,2007-2008,2007-10-06,2008-06-11,250,12,61,520,581,171,494,665,1246,73,401,Montana,Bozeman,37280
11408,2008-2009,2008-10-11,2009-05-13,215,11,80,493,573,197,547,744,1317,69,448,Montana,Bozeman,37280
11409,2009-2010,2009-09-30,2010-05-22,235,9,91,538,629,180,856,1036,1665,67,394,Montana,Bozeman,37280
11410,2010-2011,2010-10-26,2011-05-01,188,6,130,505,635,192,658,850,1485,65,450,Montana,Bozeman,37280
11411,2011-2012,2011-10-26,2012-05-26,214,14,31,393,424,116,241,357,781,49,239,Montana,Bozeman,37280
11412,2012-2013,2012-10-03,2013-05-01,211,0,73,445,518,116,520,636,1154,59,330,Montana,Bozeman,37280
11413,2013-2014,2013-10-03,2014-05-07,217,1,126,530,656,127,675,802,1458,50,408,Montana,Bozeman,37280
11414,2014-2015,2014-11-10,2015-04-16,158,10,74,383,457,100,310,410,867,36,233,Montana,Bozeman,37280
11415,2015-2016,2015-11-03,2016-05-10,190,0,65,368,433,115,457,572,1005,46,249,Montana,Bozeman,37280
11416,2016-2017,2016-10-11,2017-05-18,220,3,122,473,595,128,476,604,1199,54,362,Montana,Bozeman,37280
11417,2017-2018,2017-10-03,2018-04-23,203,9,86,516,602,207,819,1026,1628,70,446,Montana,Bozeman,37280
11418,2018-2019,2018-10-05,2019-05-02,210,9,145,617,762,140,869,1009,1771,57,469,Montana,Bozeman,37280
11419,2019-2020,2019-09-29,2020-05-11,226,7,73,481,554,155,440,595,1149,71,415,Montana,Bozeman,37280
11420,1950-1951,1950-09-30,1951-06-01,245,4,115,763,878,93,360,453,1331,49,386,Montana,Busby,0
11421,1951-1952,1951-10-15,1952-04-08,177,6,142,807,949,67,503,570,1519,42,333,Montana,Busby,0
11422,1952-1953,1952-11-16,1953-05-12,178,10,28,477,505,57,118,175,680,36,190,Montana,Busby,0
11423,1953-1954,1953-11-18,1954-04-02,136,2,72,548,620,46,154,200,820,20,168,Montana,Busby,0
11424,1954-1955,1954-09-30,1955-04-11,194,15,58,638,696,89,196,285,981,47,285,Montana,Busby,0
11425,1955-1956,1955-10-22,1956-05-03,195,5,133,873,1006,91,640,731,1737,48,395,Montana,Busby,0
11426,1956-1957,1956-11-01,1957-04-11,162,0,131,685,816,73,248,321,1137,37,345,Montana,Busby,0
11427,1957-1958,1957-10-24,1958-04-23,182,17,32,477,509,41,61,102,611,27,162,Montana,Busby,0
11428,1966-1967,1966-11-07,1967-05-03,178,1,47,591,638,123,350,473,1111,61,386,Montana,Busby,0
11429,1967-1968,1967-10-24,1968-05-06,196,0,105,689,794,84,495,579,1373,52,330,Montana,Busby,0
11430,1968-1969,1968-11-05,1969-05-03,180,1,194,865,1059,91,673,764,1823,44,402,Montana,Busby,0
11431,1974-1975,1974-12-01,1975-04-29,150,3,81,577,658,93,407,500,1158,31,237,Montana,Busby,0
11432,1975-1976,1975-10-14,1976-05-14,214,0,110,676,786,77,784,861,1647,37,275,Montana,Busby,0
11433,1976-1977,1976-10-17,1977-04-04,170,6,75,634,709,96,767,863,1572,41,324,Montana,Busby,0
11434,1977-1978,1977-10-09,1978-03-28,171,3,178,768,946,97,902,999,1945,40,395,Montana,Busby,0
11435,1978-1979,1978-09-18,1979-05-09,234,0,239,1015,1254,107,967,1074,2328,45,412,Montana,Busby,0
11436,1979-1980,1979-11-05,1980-03-26,143,3,88,586,674,58,129,187,861,29,221,Montana,Busby,0
11437,1980-1981,1980-10-16,1981-03-31,167,4,48,479,527,46,136,182,709,24,150,Montana,Busby,0
11438,1981-1982,1981-10-20,1982-04-18,181,0,133,737,870,87,374,461,1331,38,317,Montana,Busby,0
11439,1982-1983,1982-09-14,1983-05-12,241,14,27,562,589,84,368,452,1041,25,186,Montana,Busby,0
11440,1983-1984,1983-09-19,1984-04-30,225,5,150,672,822,90,397,487,1309,37,289,Montana,Busby,0
11441,1984-1985,1984-09-23,1985-04-05,195,5,154,925,1079,110,894,1004,2083,34,291,Montana,Busby,0
11442,1985-1986,1985-09-23,1986-05-10,230,1,144,672,816,128,633,761,1577,36,374,Montana,Busby,0
11443,1986-1987,1986-11-06,1987-04-09,155,5,36,459,495,55,102,157,652,25,139,Montana,Busby,0
11444,1987-1988,1987-10-09,1988-05-01,206,8,70,549,619,79,342,421,1040,25,214,Montana,Busby,0
11445,1988-1989,1988-10-27,1989-04-28,184,2,165,747,912,108,562,670,1582,34,385,Montana,Busby,0
11446,1989-1990,1989-10-02,1990-04-29,210,3,89,607,696,118,420,538,1234,41,335,Montana,Busby,0
11447,1990-1991,1990-10-06,1991-05-03,210,1,113,704,817,82,221,303,1120,34,292,Montana,Busby,0
11448,1991-1992,1991-10-22,1992-05-16,208,3,32,500,532,65,134,199,731,19,137,Montana,Busby,0
11449,1992-1993,1992-10-15,1993-04-19,187,3,163,823,986,89,560,649,1635,31,305,Montana,Busby,0
11450,1993-1994,1993-10-08,1994-04-28,203,2,98,669,767,120,381,501,1268,40,371,Montana,Busby,0
11451,1994-1995,1994-11-17,1995-05-13,178,0,78,521,599,62,246,308,907,16,134,Montana,Busby,0
11452,1995-1996,1995-10-30,1996-05-09,193,1,159,706,865,94,212,306,1171,37,319,Montana,Busby,0
11453,1996-1997,1996-10-20,1997-04-14,177,4,186,769,955,125,803,928,1883,40,420,Montana,Busby,0
11454,1997-1998,1997-10-24,1998-04-15,174,0,59,526,585,59,164,223,808,24,178,Montana,Busby,0
11455,1998-1999,1998-11-07,1999-04-10,155,0,56,443,499,70,205,275,774,23,144,Montana,Busby,0
11456,1999-2000,1999-10-01,2000-05-12,225,3,24,482,506,71,175,246,752,20,142,Montana,Busby,0
11457,2000-2001,2000-09-22,2001-04-21,212,1,123,785,908,94,706,800,1708,30,249,Montana,Busby,0
11458,2001-2002,2001-11-25,2002-04-20,147,3,70,547,617,68,132,200,817,23,190,Montana,Busby,0
11459,2002-2003,2002-10-22,2003-04-04,165,0,66,557,623,86,230,316,939,27,239,Montana,Busby,0
11460,2003-2004,2003-10-30,2004-03-10,133,0,85,532,617,56,392,448,1065,21,142,Montana,Busby,0
11461,2004-2005,2004-11-23,2005-05-12,171,1,71,443,514,51,69,120,634,18,132,Montana,Busby,0
11462,2006-2007,2006-10-11,2007-04-09,181,1,72,567,639,108,323,431,1070,24,221,Montana,Busby,0
11463,2007-2008,2007-11-20,2008-05-02,165,1,79,661,740,69,317,386,1126,26,221,Montana,Busby,0
11464,2008-2009,2008-10-10,2009-05-12,215,6,114,593,707,85,296,381,1088,24,207,Montana,Busby,0
11465,2009-2010,2009-10-05,2010-05-06,214,2,122,705,827,64,349,413,1240,24,215,Montana,Busby,0
11466,2010-2011,2010-11-13,2011-04-22,161,3,128,645,773,95,582,677,1450,32,302,Montana,Busby,0
11467,2011-2012,2011-11-06,2012-03-19,135,1,35,450,485,52,192,244,729,20,152,Montana,Busby,0
11468,2012-2013,2012-10-03,2013-04-22,202,4,63,597,660,95,388,483,1143,44,284,Montana,Busby,0
11469,2013-2014,2013-10-04,2014-05-07,216,0,137,708,845,120,484,604,1449,46,417,Montana,Busby,0
11470,2014-2015,2014-11-10,2015-04-15,157,1,84,539,623,71,284,355,978,29,233,Montana,Busby,0
11471,2015-2016,2015-11-04,2016-04-28,177,4,53,485,538,69,314,383,921,35,211,Montana,Busby,0
11472,2016-2017,2016-10-11,2017-04-25,197,0,137,638,775,85,520,605,1380,35,287,Montana,Busby,0
11473,2017-2018,2017-10-26,2018-04-24,181,0,128,736,864,156,811,967,1831,56,495,Montana,Busby,0
11474,2018-2019,2018-10-13,2019-05-01,201,2,107,692,799,94,316,410,1209,43,352,Montana,Busby,0
11475,2019-2020,2019-10-01,2020-04-15,198,0,45,581,626,73,201,274,900,37,211,Montana,Busby,0
11476,1950-1951,1950-09-30,1951-04-21,204,0,327,997,1324,84,472,556,1880,46,525,Montana,Glasgow,3250
11477,1951-1952,1951-09-24,1952-04-07,197,0,319,929,1248,102,477,579,1827,53,511,Montana,Glasgow,3250
11478,1952-1953,1952-11-23,1953-05-12,171,0,124,614,738,61,137,198,936,36,238,Montana,Glasgow,3250
11479,1953-1954,1953-12-01,1954-05-03,154,1,203,626,829,78,258,336,1165,40,401,Montana,Glasgow,3250
11480,1954-1955,1954-11-29,1955-04-25,148,0,173,634,807,70,318,388,1195,41,381,Montana,Glasgow,3250
11481,1955-1956,1955-11-01,1956-05-05,187,0,382,971,1353,57,435,492,1845,37,396,Montana,Glasgow,3250
11482,1956-1957,1956-11-14,1957-04-11,149,0,276,734,1010,42,268,310,1320,31,390,Montana,Glasgow,3250
11483,1957-1958,1957-09-18,1958-03-27,191,0,126,523,649,35,72,107,756,30,170,Montana,Glasgow,3250
11484,1958-1959,1958-11-04,1959-04-17,165,0,325,792,1117,62,458,520,1637,37,380,Montana,Glasgow,3250
11485,1959-1960,1959-10-06,1960-04-28,206,0,274,732,1006,52,305,357,1363,39,328,Montana,Glasgow,3250
11486,1960-1961,1960-10-29,1961-04-10,164,0,133,532,665,35,87,122,787,27,194,Montana,Glasgow,3250
11487,1961-1962,1961-10-22,1962-03-29,159,0,314,794,1108,51,157,208,1316,43,418,Montana,Glasgow,3250
11488,1962-1963,1962-10-15,1963-04-22,190,0,185,568,753,38,64,102,855,29,181,Montana,Glasgow,3250
11489,1963-1964,1963-11-12,1964-04-17,158,0,163,564,727,37,67,104,831,31,257,Montana,Glasgow,3250
11490,1964-1965,1964-10-28,1965-04-19,174,3,426,962,1388,67,693,760,2148,45,507,Montana,Glasgow,3250
11491,1965-1966,1965-09-26,1966-05-12,229,0,322,804,1126,37,319,356,1482,26,277,Montana,Glasgow,3250
11492,1966-1967,1966-10-21,1967-05-10,202,0,239,762,1001,98,416,514,1515,54,449,Montana,Glasgow,3250
11493,1967-1968,1967-11-02,1968-05-10,191,0,204,643,847,32,97,129,976,21,172,Montana,Glasgow,3250
11494,1968-1969,1968-11-07,1969-04-30,175,0,431,908,1339,74,582,656,1995,49,601,Montana,Glasgow,3250
11495,1969-1970,1969-10-10,1970-04-30,203,0,201,683,884,62,195,257,1141,45,297,Montana,Glasgow,3250
11496,1970-1971,1970-09-13,1971-05-18,248,0,290,802,1092,83,580,663,1755,57,565,Montana,Glasgow,3250
11497,1971-1972,1971-10-15,1972-04-17,186,4,321,798,1119,62,354,416,1535,46,539,Montana,Glasgow,3250
11498,1972-1973,1972-09-24,1973-04-22,211,1,213,640,853,39,202,241,1094,23,153,Montana,Glasgow,3250
11499,1973-1974,1973-11-01,1974-04-28,179,0,227,671,898,57,203,260,1158,47,370,Montana,Glasgow,3250
11500,1974-1975,1974-10-31,1975-04-30,182,0,165,627,792,47,106,153,945,41,267,Montana,Glasgow,3250
11501,1975-1976,1975-10-08,1976-04-17,193,0,168,619,787,53,164,217,1004,37,309,Montana,Glasgow,3250
11502,1976-1977,1976-10-22,1977-04-03,164,0,192,669,861,40,215,255,1116,35,298,Montana,Glasgow,3250
11503,1977-1978,1977-10-10,1978-04-12,185,0,452,878,1330,67,579,646,1976,50,549,Montana,Glasgow,3250
11504,1978-1979,1978-11-10,1979-05-07,179,0,466,1004,1470,90,788,878,2348,61,675,Montana,Glasgow,3250
11505,1979-1980,1979-11-07,1980-04-02,148,0,205,644,849,40,145,185,1034,32,261,Montana,Glasgow,3250
11506,1980-1981,1980-10-16,1981-03-27,163,0,118,446,564,31,46,77,641,22,156,Montana,Glasgow,3250
11507,1981-1982,1981-10-12,1982-04-09,180,0,361,829,1190,78,414,492,1682,50,538,Montana,Glasgow,3250
11508,1982-1983,1982-09-28,1983-05-15,230,0,128,522,650,56,291,347,997,32,184,Montana,Glasgow,3250
11509,1983-1984,1983-09-29,1984-05-07,222,0,258,621,879,53,192,245,1124,44,348,Montana,Glasgow,3250
11510,1984-1985,1984-09-23,1985-04-06,196,0,301,767,1068,57,237,294,1362,41,345,Montana,Glasgow,3250
11511,1985-1986,1985-09-24,1986-04-16,205,0,308,755,1063,83,572,655,1718,52,526,Montana,Glasgow,3250
11512,1986-1987,1986-11-08,1987-04-11,155,0,80,423,503,44,90,134,637,23,119,Montana,Glasgow,3250
11513,1987-1988,1987-10-19,1988-04-08,173,0,164,602,766,28,111,139,905,19,165,Montana,Glasgow,3250
11514,1988-1989,1988-10-27,1989-04-03,159,0,286,769,1055,63,468,531,1586,36,377,Montana,Glasgow,3250
11515,1989-1990,1989-11-11,1990-04-30,171,0,147,589,736,46,123,169,905,35,284,Montana,Glasgow,3250
11516,1990-1991,1990-10-07,1991-05-04,210,0,229,682,911,65,256,321,1232,41,307,Montana,Glasgow,3250
11517,1991-1992,1991-10-23,1992-04-11,172,0,75,497,572,21,15,36,608,19,113,Montana,Glasgow,3250
11518,1992-1993,1992-10-14,1993-03-28,166,0,280,735,1015,44,317,361,1376,35,364,Montana,Glasgow,3250
11519,1993-1994,1993-10-07,1994-04-25,201,0,266,704,970,76,499,575,1545,43,464,Montana,Glasgow,3250
11520,1994-1995,1994-11-02,1995-04-12,162,3,189,602,791,47,137,184,975,24,194,Montana,Glasgow,3250
11521,1995-1996,1995-10-31,1996-04-12,165,8,377,886,1263,64,373,437,1700,43,426,Montana,Glasgow,3250
11522,1996-1997,1996-10-20,1997-04-09,172,0,386,897,1283,91,639,730,2013,51,627,Montana,Glasgow,3250
11523,1997-1998,1997-10-13,1998-03-24,163,3,149,526,675,34,52,86,761,23,163,Montana,Glasgow,3250
11524,1998-1999,1998-11-03,1999-05-12,191,0,168,531,699,92,277,369,1068,52,417,Montana,Glasgow,3250
11525,1999-2000,1999-10-02,2000-05-12,224,0,95,511,606,48,77,125,731,28,186,Montana,Glasgow,3250
11526,2000-2001,2000-11-05,2001-04-13,160,0,266,742,1008,64,489,553,1561,37,346,Montana,Glasgow,3250
11527,2001-2002,2001-10-23,2002-05-23,213,3,199,721,920,61,158,219,1139,38,314,Montana,Glasgow,3250
11528,2002-2003,2002-10-21,2003-04-06,168,0,197,668,865,55,128,183,1048,39,366,Montana,Glasgow,3250
11529,2003-2004,2003-10-29,2004-05-12,197,0,270,719,989,105,762,867,1856,42,465,Montana,Glasgow,3250
11530,2004-2005,2004-10-16,2005-04-30,197,0,167,606,773,52,157,209,982,29,255,Montana,Glasgow,3250
11531,2005-2006,2005-11-03,2006-04-23,172,0,127,479,606,50,120,170,776,37,262,Montana,Glasgow,3250
11532,2006-2007,2006-10-16,2007-04-11,178,0,164,615,779,63,103,166,945,38,333,Montana,Glasgow,3250
11533,2007-2008,2007-11-21,2008-05-02,164,0,165,662,827,42,106,148,975,29,298,Montana,Glasgow,3250
11534,2008-2009,2008-10-11,2009-05-13,215,0,277,805,1082,85,247,332,1414,29,328,Montana,Glasgow,3250
11535,2009-2010,2009-10-09,2010-05-05,209,0,308,752,1060,50,384,434,1494,27,285,Montana,Glasgow,3250
11536,2010-2011,2010-10-26,2011-04-18,175,0,364,851,1215,162,786,948,2163,58,681,Montana,Glasgow,3250
11537,2011-2012,2011-11-05,2012-04-06,154,0,100,454,554,42,93,135,689,23,185,Montana,Glasgow,3250
11538,2012-2013,2012-10-05,2013-04-20,198,0,192,674,866,93,309,402,1268,45,366,Montana,Glasgow,3250
11539,2013-2014,2013-10-28,2014-03-31,155,0,261,776,1037,57,185,242,1279,40,385,Montana,Glasgow,3250
11540,2014-2015,2014-11-09,2015-04-07,150,0,181,561,742,72,170,242,984,32,285,Montana,Glasgow,3250
11541,2015-2016,2015-11-20,2016-04-25,158,1,122,440,562,42,280,322,884,24,157,Montana,Glasgow,3250
11542,2016-2017,2016-10-05,2017-03-15,162,0,238,576,814,60,238,298,1112,30,328,Montana,Glasgow,3250
11543,2017-2018,2017-10-03,2018-04-17,197,0,309,862,1171,100,400,500,1671,43,448,Montana,Glasgow,3250
11544,2018-2019,2018-10-03,2019-03-22,171,0,267,686,953,78,312,390,1343,42,475,Montana,Glasgow,3250
11545,2019-2020,2019-10-08,2020-04-15,191,0,143,570,713,69,173,242,955,46,306,Montana,Glasgow,3250
11546,1950-1951,1950-09-29,1951-05-31,245,0,185,586,771,104,253,357,1128,48,456,Montana,Great Falls,58505
11547,1951-1952,1951-09-26,1952-04-07,195,0,178,563,741,103,402,505,1246,52,473,Montana,Great Falls,58505
11548,1952-1953,1952-11-05,1953-05-12,189,0,53,321,374,79,115,194,568,39,236,Montana,Great Falls,58505
11549,1953-1954,1953-12-01,1954-05-02,153,0,151,454,605,84,158,242,847,49,400,Montana,Great Falls,58505
11550,1954-1955,1954-09-28,1955-05-16,231,0,99,423,522,111,177,288,810,45,347,Montana,Great Falls,58505
11551,1955-1956,1955-10-22,1956-05-04,196,0,207,599,806,90,175,265,1071,48,478,Montana,Great Falls,58505
11552,1956-1957,1956-10-27,1957-04-25,181,0,196,528,724,92,218,310,1034,56,534,Montana,Great Falls,58505
11553,1957-1958,1957-09-18,1958-04-26,221,0,85,328,413,115,183,298,711,55,359,Montana,Great Falls,58505
11554,1958-1959,1958-10-09,1959-04-24,198,0,136,464,600,110,284,394,994,49,386,Montana,Great Falls,58505
11555,1959-1960,1959-09-28,1960-05-05,221,0,133,469,602,97,189,286,888,47,393,Montana,Great Falls,58505
11556,1960-1961,1960-11-03,1961-04-28,177,0,51,308,359,48,37,85,444,31,160,Montana,Great Falls,58505
11557,1961-1962,1961-09-26,1962-04-11,198,0,230,618,848,91,205,296,1144,52,458,Montana,Great Falls,58505
11558,1962-1963,1962-09-07,1963-04-20,226,0,97,407,504,65,130,195,699,35,299,Montana,Great Falls,58505
11559,1963-1964,1963-11-20,1964-04-25,158,0,111,394,505,89,170,259,764,42,318,Montana,Great Falls,58505
11560,1964-1965,1964-11-14,1965-06-06,205,0,212,630,842,97,289,386,1228,52,454,Montana,Great Falls,58505
11561,1965-1966,1965-09-15,1966-04-28,226,0,153,498,651,95,185,280,931,51,412,Montana,Great Falls,58505
11562,1966-1967,1966-10-12,1967-05-11,212,0,117,509,626,156,183,339,965,63,471,Montana,Great Falls,58505
11563,1967-1968,1967-10-23,1968-04-21,182,0,109,430,539,74,136,210,749,44,297,Montana,Great Falls,58505
11564,1968-1969,1968-09-20,1969-06-12,266,0,333,764,1097,96,372,468,1565,52,614,Montana,Great Falls,58505
11565,1969-1970,1969-10-10,1970-05-12,215,0,133,470,603,98,130,228,831,54,339,Montana,Great Falls,58505
11566,1970-1971,1970-09-11,1971-04-26,228,0,164,562,726,100,135,235,961,59,473,Montana,Great Falls,58505
11567,1971-1972,1971-10-15,1972-05-06,205,0,179,644,823,105,216,321,1144,55,533,Montana,Great Falls,58505
11568,1972-1973,1972-09-24,1973-05-01,220,0,156,494,650,102,133,235,885,49,377,Montana,Great Falls,58505
11569,1973-1974,1973-09-14,1974-04-28,227,0,143,459,602,102,187,289,891,55,434,Montana,Great Falls,58505
11570,1974-1975,1974-09-11,1975-05-20,252,0,149,549,698,124,274,398,1096,63,496,Montana,Great Falls,58505
11571,1975-1976,1975-10-07,1976-04-28,205,0,117,460,577,107,109,216,793,50,392,Montana,Great Falls,58505
11572,1976-1977,1976-10-17,1977-05-17,213,0,57,391,448,87,164,251,699,36,254,Montana,Great Falls,58505
11573,1977-1978,1977-10-09,1978-04-21,195,0,301,683,984,121,520,641,1625,67,710,Montana,Great Falls,58505
11574,1978-1979,1978-11-08,1979-05-07,181,0,269,690,959,115,466,581,1540,62,570,Montana,Great Falls,58505
11575,1979-1980,1979-10-21,1980-04-11,174,0,128,485,613,56,92,148,761,38,306,Montana,Great Falls,58505
11576,1980-1981,1980-10-15,1981-04-03,171,0,99,364,463,61,88,149,612,30,217,Montana,Great Falls,58505
11577,1981-1982,1981-10-11,1982-05-29,231,0,217,675,892,149,275,424,1316,62,542,Montana,Great Falls,58505
11578,1982-1983,1982-09-14,1983-05-13,242,0,45,360,405,72,94,166,571,38,209,Montana,Great Falls,58505
11579,1983-1984,1983-09-18,1984-05-06,232,0,168,501,669,126,274,400,1069,57,443,Montana,Great Falls,58505
11580,1984-1985,1984-09-22,1985-04-25,216,0,199,634,833,104,236,340,1173,54,414,Montana,Great Falls,58505
11581,1985-1986,1985-09-22,1986-05-11,232,0,212,538,750,111,286,397,1147,52,531,Montana,Great Falls,58505
11582,1986-1987,1986-10-02,1987-05-20,231,0,39,315,354,62,106,168,522,33,188,Montana,Great Falls,58505
11583,1987-1988,1987-10-15,1988-04-25,194,0,81,380,461,66,71,137,598,33,237,Montana,Great Falls,58505
11584,1988-1989,1988-09-11,1989-05-29,261,0,169,530,699,164,251,415,1114,61,573,Montana,Great Falls,58505
11585,1989-1990,1989-09-10,1990-04-29,232,0,81,407,488,93,116,209,697,47,338,Montana,Great Falls,58505
11586,1990-1991,1990-10-05,1991-05-04,212,0,135,502,637,102,140,242,879,53,437,Montana,Great Falls,58505
11587,1991-1992,1991-10-03,1992-05-16,227,0,42,345,387,61,65,126,513,35,195,Montana,Great Falls,58505
11588,1992-1993,1992-08-22,1993-04-19,241,0,203,556,759,100,175,275,1034,55,473,Montana,Great Falls,58505
11589,1993-1994,1993-10-07,1994-04-27,203,0,102,475,577,87,116,203,780,53,380,Montana,Great Falls,58505
11590,1994-1995,1994-10-02,1995-05-26,237,0,110,525,635,73,102,175,810,35,246,Montana,Great Falls,58505
11591,1995-1996,1995-10-21,1996-05-10,203,0,201,667,868,104,187,291,1159,51,506,Montana,Great Falls,58505
11592,1996-1997,1996-10-16,1997-05-07,204,3,243,670,913,115,209,324,1237,54,553,Montana,Great Falls,58505
11593,1997-1998,1997-10-24,1998-06-02,222,0,89,420,509,61,107,168,677,35,254,Montana,Great Falls,58505
11594,1998-1999,1998-10-10,1999-06-08,242,0,68,420,488,83,99,182,670,33,249,Montana,Great Falls,58505
11595,1999-2000,1999-10-01,2000-06-01,245,0,42,381,423,67,79,146,569,33,187,Montana,Great Falls,58505
11596,2000-2001,2000-09-21,2001-05-20,242,0,131,563,694,90,155,245,939,49,362,Montana,Great Falls,58505
11597,2001-2002,2001-10-04,2002-05-23,232,0,133,532,665,87,174,261,926,39,321,Montana,Great Falls,58505
11598,2002-2003,2002-10-11,2003-05-18,220,0,99,472,571,77,109,186,757,38,301,Montana,Great Falls,58505
11599,2003-2004,2003-10-29,2004-05-23,208,0,116,476,592,71,172,243,835,37,286,Montana,Great Falls,58505
11600,2004-2005,2004-10-16,2005-04-30,197,0,105,471,576,86,149,235,811,41,352,Montana,Great Falls,58505
11601,2005-2006,2005-10-04,2006-05-09,218,0,87,377,464,96,143,239,703,45,313,Montana,Great Falls,58505
11602,2006-2007,2006-09-16,2007-04-19,216,0,95,426,521,106,160,266,787,48,375,Montana,Great Falls,58505
11603,2007-2008,2007-11-04,2008-06-11,221,0,83,486,569,104,156,260,829,43,337,Montana,Great Falls,58505
11604,2008-2009,2008-10-11,2009-06-07,240,0,139,529,668,169,222,391,1059,64,548,Montana,Great Falls,58505
11605,2009-2010,2009-10-07,2010-05-05,211,0,120,468,588,115,236,351,939,44,357,Montana,Great Falls,58505
11606,2010-2011,2010-09-17,2011-05-01,227,0,186,603,789,156,307,463,1252,58,514,Montana,Great Falls,58505
11607,2011-2012,2011-10-25,2012-05-27,216,0,50,365,415,66,47,113,528,36,226,Montana,Great Falls,58505
11608,2012-2013,2012-10-02,2013-04-30,211,0,71,406,477,111,171,282,759,47,315,Montana,Great Falls,58505
11609,2013-2014,2013-10-27,2014-05-11,197,0,167,599,766,116,212,328,1094,60,539,Montana,Great Falls,58505
11610,2014-2015,2014-10-02,2015-04-15,196,0,108,456,564,89,219,308,872,40,312,Montana,Great Falls,58505
11611,2015-2016,2015-10-03,2016-04-28,209,0,62,367,429,73,169,242,671,32,190,Montana,Great Falls,58505
11612,2016-2017,2016-10-10,2017-04-10,183,0,191,503,694,77,186,263,957,45,416,Montana,Great Falls,58505
11613,2017-2018,2017-10-02,2018-04-13,194,0,185,611,796,156,328,484,1280,58,559,Montana,Great Falls,58505
11614,2018-2019,2018-09-30,2019-05-18,231,0,211,634,845,117,363,480,1325,58,559,Montana,Great Falls,58505
11615,2019-2020,2019-09-28,2020-05-12,228,0,95,532,627,143,154,297,924,47,380,Montana,Great Falls,58505
11616,1950-1951,1950-10-20,1951-04-21,184,0,262,795,1057,64,241,305,1362,36,447,Montana,Havre,9310
11617,1951-1952,1951-09-24,1952-03-24,183,0,300,765,1065,97,425,522,1587,56,594,Montana,Havre,9310
11618,1952-1953,1952-11-16,1953-05-12,178,0,90,485,575,60,121,181,756,34,228,Montana,Havre,9310
11619,1953-1954,1953-12-01,1954-05-01,152,0,201,558,759,78,197,275,1034,41,396,Montana,Havre,9310
11620,1954-1955,1954-09-28,1955-04-15,200,0,129,564,693,88,173,261,954,32,305,Montana,Havre,9310
11621,1955-1956,1955-10-31,1956-05-02,185,0,298,851,1149,68,297,365,1514,49,486,Montana,Havre,9310
11622,1956-1957,1956-10-27,1957-04-10,166,0,232,665,897,65,323,388,1285,40,439,Montana,Havre,9310
11623,1957-1958,1957-09-18,1958-03-22,186,0,103,470,573,53,155,208,781,27,216,Montana,Havre,9310
11624,1958-1959,1958-11-04,1959-03-05,122,0,241,595,836,73,305,378,1214,26,275,Montana,Havre,9310
11625,1959-1960,1959-10-05,1960-04-27,206,0,179,603,782,79,150,229,1011,33,313,Montana,Havre,9310
11626,1960-1961,1960-10-29,1961-04-10,164,0,101,461,562,30,106,136,698,17,144,Montana,Havre,9310
11627,1961-1962,1961-10-21,1962-03-23,154,0,277,822,1099,38,180,218,1317,24,237,Montana,Havre,9310
11628,1962-1963,1962-11-15,1963-04-17,154,0,148,545,693,27,98,125,818,17,154,Montana,Havre,9310
11629,1963-1964,1963-11-19,1964-04-21,155,0,137,554,691,47,98,145,836,34,286,Montana,Havre,9310
11630,1964-1965,1964-11-14,1965-04-16,154,0,367,907,1274,82,531,613,1887,55,651,Montana,Havre,9310
11631,1965-1966,1965-09-15,1966-04-29,227,0,288,803,1091,72,333,405,1496,45,464,Montana,Havre,9310
11632,1966-1967,1966-11-05,1967-05-11,188,0,205,719,924,113,272,385,1309,53,432,Montana,Havre,9310
11633,1967-1968,1967-11-02,1968-04-13,164,0,173,592,765,53,84,137,902,39,302,Montana,Havre,9310
11634,1968-1969,1968-11-16,1969-04-26,162,0,459,997,1456,83,603,686,2142,51,741,Montana,Havre,9310
11635,1969-1970,1969-10-10,1970-04-29,202,0,186,718,904,74,189,263,1167,48,380,Montana,Havre,9310
11636,1970-1971,1970-10-06,1971-04-17,194,0,267,816,1083,102,481,583,1666,52,593,Montana,Havre,9310
11637,1971-1972,1971-10-15,1972-04-30,199,0,331,872,1203,96,419,515,1718,56,671,Montana,Havre,9310
11638,1972-1973,1972-09-23,1973-04-30,220,0,176,635,811,70,162,232,1043,33,232,Montana,Havre,9310
11639,1973-1974,1973-10-30,1974-05-13,196,0,177,631,808,69,171,240,1048,42,348,Montana,Havre,9310
11640,1974-1975,1974-10-04,1975-04-29,208,0,155,714,869,103,218,321,1190,45,387,Montana,Havre,9310
11641,1975-1976,1975-10-08,1976-04-01,177,0,129,520,649,57,134,191,840,35,339,Montana,Havre,9310
11642,1976-1977,1976-10-22,1977-05-17,208,0,110,599,709,82,210,292,1001,34,253,Montana,Havre,9310
11643,1977-1978,1977-11-18,1978-04-11,145,0,357,750,1107,108,768,876,1983,57,587,Montana,Havre,9310
11644,1978-1979,1978-10-30,1979-05-07,190,0,416,960,1376,114,825,939,2315,57,609,Montana,Havre,9310
11645,1979-1980,1979-11-08,1980-04-02,147,0,139,617,756,35,71,106,862,25,190,Montana,Havre,9310
11646,1980-1981,1980-10-16,1981-03-30,166,0,115,459,574,47,78,125,699,32,244,Montana,Havre,9310
11647,1981-1982,1981-10-11,1982-05-31,233,19,326,868,1194,145,435,580,1774,61,690,Montana,Havre,9310
11648,1982-1983,1982-09-29,1983-04-27,211,0,78,499,577,63,68,131,708,32,207,Montana,Havre,9310
11649,1983-1984,1983-11-20,1984-04-26,159,0,236,620,856,61,284,345,1201,38,338,Montana,Havre,9310
11650,1984-1985,1984-10-16,1985-04-25,192,0,267,785,1052,87,259,346,1398,42,414,Montana,Havre,9310
11651,1985-1986,1985-09-28,1986-05-09,224,0,253,680,933,80,321,401,1334,40,476,Montana,Havre,9310
11652,1986-1987,1986-10-30,1987-03-29,151,0,59,454,513,48,72,120,633,26,175,Montana,Havre,9310
11653,1987-1988,1987-11-16,1988-03-29,135,0,117,515,632,33,38,71,703,20,189,Montana,Havre,9310
11654,1988-1989,1988-10-26,1989-05-29,216,0,251,694,945,79,276,355,1300,42,428,Montana,Havre,9310
11655,1989-1990,1989-11-11,1990-04-29,170,0,115,507,622,72,192,264,886,34,276,Montana,Havre,9310
11656,1990-1991,1990-10-16,1991-05-03,200,0,187,641,828,64,147,211,1039,42,354,Montana,Havre,9310
11657,1991-1992,1991-10-26,1992-04-12,170,0,63,496,559,42,71,113,672,22,154,Montana,Havre,9310
11658,1992-1993,1992-10-14,1993-04-24,193,0,249,731,980,68,284,352,1332,43,457,Montana,Havre,9310
11659,1993-1994,1993-10-29,1994-04-25,179,0,201,658,859,94,359,453,1312,49,485,Montana,Havre,9310
11660,1994-1995,1994-11-01,1995-04-29,180,0,162,629,791,60,218,278,1069,31,248,Montana,Havre,9310
11661,1995-1996,1995-09-20,1996-04-11,205,1,317,867,1184,83,288,371,1555,50,552,Montana,Havre,9310
11662,1996-1997,1996-10-29,1997-04-10,164,8,299,801,1100,76,311,387,1487,36,421,Montana,Havre,9310
11663,1997-1998,1997-11-07,1998-03-22,136,0,126,514,640,22,60,82,722,15,116,Montana,Havre,9310
11664,1998-1999,1998-11-07,1999-05-10,185,1,122,458,580,59,147,206,786,32,218,Montana,Havre,9310
11665,2004-2005,2004-10-17,2005-03-24,159,1,136,583,719,33,84,117,836,19,156,Montana,Havre,9310
11666,2005-2006,2005-11-08,2006-03-26,139,0,120,440,560,55,133,188,748,26,184,Montana,Havre,9310
11667,2006-2007,2006-10-16,2007-04-19,186,0,132,601,733,59,142,201,934,29,265,Montana,Havre,9310
11668,2007-2008,2007-11-20,2008-04-21,154,0,119,629,748,36,49,85,833,24,229,Montana,Havre,9310
11669,2008-2009,2008-11-13,2009-05-13,182,0,200,683,883,66,375,441,1324,34,320,Montana,Havre,9310
11670,2009-2010,2009-10-09,2010-05-05,209,0,271,776,1047,65,527,592,1639,32,318,Montana,Havre,9310
11671,2010-2011,2010-11-16,2011-04-17,153,0,338,764,1102,123,622,745,1847,49,567,Montana,Havre,9310
11672,2011-2012,2011-11-18,2012-03-24,128,0,65,418,483,28,41,69,552,14,145,Montana,Havre,9310
11673,2012-2013,2012-10-24,2013-04-29,188,0,114,583,697,79,244,323,1020,27,234,Montana,Havre,9310
11674,2013-2014,2013-10-27,2014-03-28,153,1,213,695,908,73,233,306,1214,31,294,Montana,Havre,9310
11675,2014-2015,2014-11-09,2015-04-06,149,3,142,503,645,35,150,185,830,18,193,Montana,Havre,9310
11676,2015-2016,2015-11-20,2016-04-26,159,2,101,431,532,31,125,156,688,18,141,Montana,Havre,9310
11677,2016-2017,2016-10-09,2017-03-13,156,0,196,535,731,56,199,255,986,29,294,Montana,Havre,9310
11678,2017-2018,2017-10-02,2018-04-08,189,0,306,867,1173,133,828,961,2134,47,553,Montana,Havre,9310
11679,2018-2019,2018-10-03,2019-05-18,228,0,246,794,1040,57,311,368,1408,32,391,Montana,Havre,9310
11680,2019-2020,2019-09-28,2020-04-13,199,1,140,629,769,105,211,316,1085,39,333,Montana,Havre,9310
11681,1950-1951,1950-09-30,1951-06-07,251,0,172,672,844,99,296,395,1239,56,404,Montana,Helena,1984
11682,1951-1952,1951-09-26,1952-04-03,191,0,194,688,882,89,392,481,1363,50,423,Montana,Helena,1984
11683,1952-1953,1952-11-15,1953-05-11,178,0,74,414,488,64,159,223,711,34,200,Montana,Helena,1984
11684,1953-1954,1953-12-01,1954-04-30,151,0,88,426,514,74,147,221,735,35,250,Montana,Helena,1984
11685,1954-1955,1954-09-29,1955-05-16,230,0,137,629,766,88,227,315,1081,40,313,Montana,Helena,1984
11686,1955-1956,1955-09-21,1956-05-04,227,0,220,719,939,104,300,404,1343,58,471,Montana,Helena,1984
11687,1956-1957,1956-10-27,1957-04-11,167,0,200,659,859,77,237,314,1173,41,448,Montana,Helena,1984
11688,1957-1958,1957-09-18,1958-04-27,222,0,49,406,455,99,134,233,688,44,247,Montana,Helena,1984
11689,1958-1959,1958-10-09,1959-04-24,198,0,142,598,740,77,315,392,1132,36,284,Montana,Helena,1984
11690,1959-1960,1959-10-07,1960-04-29,206,0,155,593,748,110,209,319,1067,36,299,Montana,Helena,1984
11691,1960-1961,1960-10-29,1961-04-27,181,0,36,417,453,47,26,73,526,25,131,Montana,Helena,1984
11692,1961-1962,1961-10-21,1962-04-09,171,0,178,616,794,74,141,215,1009,45,366,Montana,Helena,1984
11693,1962-1963,1962-09-07,1963-04-21,227,0,113,461,574,43,86,129,703,33,252,Montana,Helena,1984
11694,1963-1964,1963-11-10,1964-05-04,177,0,99,532,631,98,309,407,1038,47,312,Montana,Helena,1984
11695,1964-1965,1964-11-13,1965-05-06,175,0,102,552,654,85,175,260,914,44,311,Montana,Helena,1984
11696,1965-1966,1965-09-15,1966-04-28,226,0,74,502,576,61,49,110,686,40,237,Montana,Helena,1984
11697,1966-1967,1966-11-06,1967-05-12,188,0,54,431,485,125,176,301,786,43,280,Montana,Helena,1984
11698,1967-1968,1967-11-01,1968-04-07,159,0,129,519,648,74,269,343,991,36,288,Montana,Helena,1984
11699,1968-1969,1968-09-20,1969-06-12,266,0,257,784,1041,113,541,654,1695,50,550,Montana,Helena,1984
11700,1969-1970,1969-10-10,1970-05-12,215,0,84,547,631,76,115,191,822,37,239,Montana,Helena,1984
11701,1970-1971,1970-10-05,1971-04-18,196,0,133,580,713,63,140,203,916,36,263,Montana,Helena,1984
11702,1971-1972,1971-10-15,1972-04-16,185,0,157,614,771,80,256,336,1107,47,368,Montana,Helena,1984
11703,1972-1973,1972-09-27,1973-04-20,206,0,181,654,835,47,99,146,981,30,265,Montana,Helena,1984
11704,1973-1974,1973-09-14,1974-05-15,244,0,125,478,603,73,187,260,863,36,293,Montana,Helena,1984
11705,1974-1975,1974-10-05,1975-05-20,228,0,139,579,718,91,281,372,1090,47,327,Montana,Helena,1984
11706,1975-1976,1975-10-13,1976-04-28,199,0,111,487,598,73,63,136,734,46,267,Montana,Helena,1984
11707,1976-1977,1976-11-21,1977-05-17,178,0,65,403,468,54,102,156,624,27,156,Montana,Helena,1984
11708,1977-1978,1977-10-10,1978-04-07,180,0,160,541,701,90,386,476,1177,49,375,Montana,Helena,1984
11709,1978-1979,1978-11-09,1979-04-24,167,0,283,734,1017,120,572,692,1709,54,490,Montana,Helena,1984
11710,1979-1980,1979-10-20,1980-04-10,174,0,127,545,672,67,174,241,913,35,261,Montana,Helena,1984
11711,1980-1981,1980-10-15,1981-04-03,171,0,57,403,460,30,36,66,526,21,126,Montana,Helena,1984
11712,1981-1982,1981-10-11,1982-05-29,231,0,132,546,678,92,200,292,970,47,315,Montana,Helena,1984
11713,1982-1983,1982-09-13,1983-05-13,243,0,66,418,484,66,117,183,667,31,155,Montana,Helena,1984
11714,1983-1984,1983-09-18,1984-05-05,231,0,163,524,687,54,134,188,875,33,201,Montana,Helena,1984
11715,1984-1985,1984-09-23,1985-04-04,194,0,203,694,897,73,206,279,1176,44,288,Montana,Helena,1984
11716,1985-1986,1985-09-06,1986-05-11,248,0,217,675,892,98,352,450,1342,49,446,Montana,Helena,1984
11717,1986-1987,1986-11-05,1987-05-21,198,0,87,505,592,51,108,159,751,26,148,Montana,Helena,1984
11718,1987-1988,1987-10-15,1988-04-25,194,0,85,496,581,42,48,90,671,29,173,Montana,Helena,1984
11719,1988-1989,1988-09-17,1989-05-29,255,0,199,635,834,123,359,482,1316,58,477,Montana,Helena,1984
11720,1989-1990,1989-10-28,1990-05-15,200,0,69,446,515,55,78,133,648,34,199,Montana,Helena,1984
11721,1990-1991,1990-10-06,1991-05-03,210,0,127,533,660,79,186,265,925,45,388,Montana,Helena,1984
11722,1991-1992,1991-10-26,1992-04-12,170,0,75,460,535,58,221,279,814,21,148,Montana,Helena,1984
11723,1992-1993,1992-08-22,1993-04-12,234,0,203,639,842,92,383,475,1317,41,347,Montana,Helena,1984
11724,1993-1994,1993-10-07,1994-04-26,202,0,69,488,557,56,61,117,674,33,221,Montana,Helena,1984
11725,1994-1995,1994-11-05,1995-05-13,190,0,98,523,621,49,67,116,737,29,191,Montana,Helena,1984
11726,1999-2000,1999-12-01,2000-03-08,99,7,38,288,326,24,33,57,383,14,85,Montana,Helena,1984
11727,2004-2005,2004-11-03,2005-03-24,142,0,95,391,486,47,110,157,643,27,207,Montana,Helena,1984
11728,2005-2006,2005-11-14,2006-04-17,155,0,82,350,432,31,117,148,580,17,96,Montana,Helena,1984
11729,2006-2007,2006-10-17,2007-04-04,170,0,83,396,479,34,47,81,560,23,133,Montana,Helena,1984
11730,2007-2008,2007-11-19,2008-04-24,158,0,76,422,498,53,93,146,644,30,185,Montana,Helena,1984
11731,2008-2009,2008-10-12,2009-06-08,240,0,104,448,552,66,104,170,722,33,265,Montana,Helena,1984
11732,2009-2010,2009-10-07,2010-05-05,211,0,146,508,654,47,271,318,972,28,188,Montana,Helena,1984
11733,2010-2011,2010-11-16,2011-04-30,166,0,160,525,685,54,170,224,909,27,260,Montana,Helena,1984
11734,2011-2012,2011-11-05,2012-03-19,136,0,45,369,414,59,109,168,582,20,154,Montana,Helena,1984
11735,2012-2013,2012-10-23,2013-04-22,182,0,69,412,481,59,170,229,710,19,143,Montana,Helena,1984
11736,2015-2016,2015-11-04,2016-02-29,118,0,83,323,406,30,214,244,650,17,86,Montana,Helena,1984
11737,2016-2017,2016-10-11,2017-03-12,153,0,180,511,691,76,350,426,1117,26,261,Montana,Helena,1984
11738,2017-2018,2017-10-02,2018-04-13,194,0,159,578,737,97,387,484,1221,47,389,Montana,Helena,1984
11739,2018-2019,2018-10-09,2019-04-28,202,0,173,611,784,84,336,420,1204,43,356,Montana,Helena,1984
11740,2019-2020,2019-09-29,2020-04-15,200,0,56,418,474,63,95,158,632,32,194,Montana,Helena,1984
11741,1952-1953,1952-11-26,1953-04-14,140,1,17,190,207,137,262,399,606,47,203,Montana,Heron,0
11742,1953-1954,1953-11-20,1954-04-29,161,5,37,268,305,130,797,927,1232,40,235,Montana,Heron,0
11743,1954-1955,1954-11-27,1955-04-11,136,7,51,317,368,189,892,1081,1449,56,318,Montana,Heron,0
11744,1955-1956,1955-10-28,1956-04-08,164,11,102,400,502,236,1281,1517,2019,74,438,Montana,Heron,0
11745,1956-1957,1956-10-24,1957-04-08,167,6,109,424,533,205,1099,1304,1837,54,400,Montana,Heron,0
11746,1957-1958,1957-10-22,1958-03-18,148,13,18,212,230,80,494,574,804,39,138,Montana,Heron,0
11747,1958-1959,1958-11-04,1959-05-05,183,6,53,321,374,119,878,997,1371,50,235,Montana,Heron,0
11748,1959-1960,1959-11-04,1960-04-15,164,1,85,408,493,157,1059,1216,1709,47,302,Montana,Heron,0
11749,1960-1961,1960-10-28,1961-05-05,190,4,29,248,277,95,313,408,685,36,154,Montana,Heron,0
11750,1961-1962,1961-10-21,1962-04-28,190,6,93,440,533,154,1119,1273,1806,43,284,Montana,Heron,0
11751,1962-1963,1962-11-16,1963-04-17,153,5,64,271,335,53,196,249,584,23,133,Montana,Heron,0
11752,1963-1964,1963-11-21,1964-05-03,165,0,34,330,364,203,1233,1436,1800,65,327,Montana,Heron,0
11753,1964-1965,1964-11-11,1965-04-16,157,1,54,364,418,190,1045,1235,1653,58,347,Montana,Heron,0
11754,1965-1966,1965-11-23,1966-03-30,128,0,35,250,285,133,799,932,1217,50,251,Montana,Heron,0
11755,1966-1967,1966-10-21,1967-03-29,160,0,18,234,252,121,626,747,999,46,213,Montana,Heron,0
11756,1967-1968,1967-11-26,1968-04-14,141,0,52,253,305,79,541,620,925,35,174,Montana,Heron,0
11757,1968-1969,1968-11-08,1969-04-04,148,1,102,387,489,176,1109,1285,1774,58,399,Montana,Heron,0
11758,1969-1970,1969-11-17,1970-05-11,176,3,49,286,335,92,614,706,1041,36,176,Montana,Heron,0
11759,1970-1971,1970-11-20,1971-04-11,143,3,56,317,373,184,1011,1195,1568,60,365,Montana,Heron,0
11760,1971-1972,1971-10-31,1972-04-17,170,0,77,381,458,248,1154,1402,1860,71,488,Montana,Heron,0
11761,1972-1973,1972-11-23,1973-04-18,147,18,82,335,417,63,377,440,857,30,154,Montana,Heron,0
11762,1973-1974,1973-11-01,1974-04-02,153,3,56,259,315,148,572,720,1035,53,273,Montana,Heron,0
11763,1974-1975,1974-11-23,1975-05-24,183,1,45,325,370,184,1071,1255,1625,57,325,Montana,Heron,0
11764,1975-1976,1975-10-23,1976-04-06,167,0,50,347,397,138,881,1019,1416,54,253,Montana,Heron,0
11765,1976-1977,1976-11-25,1977-03-21,117,7,43,240,283,59,412,471,754,25,102,Montana,Heron,0
11766,1977-1978,1977-11-15,1978-05-04,171,0,67,281,348,168,1001,1169,1517,49,291,Montana,Heron,0
11767,1978-1979,1978-11-09,1979-04-02,145,0,140,490,630,154,1098,1252,1882,62,360,Montana,Heron,0
11768,1979-1980,1979-11-23,1980-04-07,137,0,60,284,344,119,462,581,925,42,237,Montana,Heron,0
11769,1980-1981,1980-11-17,1981-04-13,148,0,22,177,199,66,127,193,392,26,116,Montana,Heron,0
11770,1981-1982,1981-11-25,1982-04-15,142,3,68,308,376,161,838,999,1375,57,338,Montana,Heron,0
11771,1982-1983,1982-10-18,1983-04-11,176,0,31,248,279,81,451,532,811,30,138,Montana,Heron,0
11772,1983-1984,1983-11-23,1984-05-03,163,8,82,311,393,93,647,740,1133,39,181,Montana,Heron,0
11773,1984-1985,1984-10-18,1985-05-11,206,2,82,454,536,199,1055,1254,1790,64,374,Montana,Heron,0
11774,1985-1986,1985-10-31,1986-05-13,195,2,94,374,468,112,734,846,1314,41,246,Montana,Heron,0
11775,1986-1987,1986-11-07,1987-03-27,141,1,34,236,270,80,557,637,907,47,156,Montana,Heron,0
11776,1987-1988,1987-11-16,1988-04-03,140,5,52,300,352,84,478,562,914,37,188,Montana,Heron,0
11777,1988-1989,1988-11-12,1989-04-03,143,2,63,325,388,156,753,909,1297,55,296,Montana,Heron,0
11778,1989-1990,1989-11-13,1990-04-26,165,3,28,234,262,135,616,751,1013,44,218,Montana,Heron,0
11779,1990-1991,1990-11-03,1991-04-11,160,6,88,339,427,161,717,878,1305,47,311,Montana,Heron,0
11780,1991-1992,1991-10-25,1992-04-07,166,15,22,205,227,79,312,391,618,33,134,Montana,Heron,0
11781,1992-1993,1992-11-09,1993-04-05,148,0,100,380,480,125,1027,1152,1632,36,237,Montana,Heron,0
11782,1993-1994,1993-11-13,1994-03-21,129,0,47,239,286,79,374,453,739,33,142,Montana,Heron,0
11783,1994-1995,1994-10-30,1995-04-15,168,1,57,267,324,108,446,554,878,46,205,Montana,Heron,0
11784,1995-1996,1995-11-06,1996-05-03,180,0,79,311,390,119,386,505,895,43,242,Montana,Heron,0
11785,1996-1997,1996-11-04,1997-03-31,148,4,79,320,399,231,1609,1840,2239,69,408,Montana,Heron,0
11786,1997-1998,1997-11-17,1998-03-10,114,7,34,168,202,70,273,343,545,37,134,Montana,Heron,0
11787,1998-1999,1998-11-10,1999-05-08,180,0,30,240,270,101,596,697,967,57,183,Montana,Heron,0
11788,1999-2000,1999-10-31,2000-04-14,167,1,20,193,213,130,678,808,1021,42,195,Montana,Heron,0
11789,2000-2001,2000-11-08,2001-04-13,157,5,54,308,362,115,801,916,1278,48,224,Montana,Heron,0
11790,2001-2002,2001-11-26,2002-04-04,130,0,45,252,297,191,799,990,1287,59,338,Montana,Heron,0
11791,2002-2003,2002-10-30,2003-05-17,200,1,17,202,219,65,181,246,465,34,108,Montana,Heron,0
11792,2003-2004,2003-10-31,2004-03-31,153,1,51,264,315,138,903,1041,1356,50,259,Montana,Heron,0
11793,2004-2005,2004-10-31,2005-04-18,170,1,31,265,296,59,127,186,482,32,129,Montana,Heron,0
11794,2005-2006,2005-11-06,2006-05-08,184,12,33,284,317,76,305,381,698,40,146,Montana,Heron,0
11795,2006-2007,2006-10-30,2007-04-03,156,3,46,269,315,103,487,590,905,44,201,Montana,Heron,0
11796,2007-2008,2007-11-23,2008-04-25,155,1,54,303,357,243,1391,1634,1991,62,374,Montana,Heron,0
11797,2008-2009,2008-11-22,2009-04-14,144,0,71,312,383,186,1004,1190,1573,51,355,Montana,Heron,0
11798,2009-2010,2009-10-29,2010-04-08,162,5,25,197,222,38,61,99,321,23,82,Montana,Heron,0
11799,2010-2011,2010-11-18,2011-04-29,163,10,57,261,318,171,911,1082,1400,62,308,Montana,Heron,0
11800,2011-2012,2011-11-07,2012-04-08,154,0,29,244,273,156,605,761,1034,51,249,Montana,Heron,0
11801,2012-2013,2012-10-24,2013-05-22,211,1,33,216,249,134,601,735,984,63,243,Montana,Heron,0
11802,2013-2014,2013-11-03,2014-04-28,177,0,74,307,381,123,661,784,1165,51,258,Montana,Heron,0
11803,2014-2015,2014-11-11,2015-03-09,119,1,35,195,230,75,413,488,718,23,116,Montana,Heron,0
11804,2015-2016,2015-11-05,2016-03-25,142,0,28,161,189,108,383,491,680,37,158,Montana,Heron,0
11805,2016-2017,2016-11-30,2017-04-10,132,1,88,292,380,166,946,1112,1492,48,287,Montana,Heron,0
11806,2017-2018,2017-11-02,2018-04-17,167,0,52,253,305,218,889,1107,1412,58,326,Montana,Heron,0
11807,2018-2019,2018-11-09,2019-04-02,145,0,52,285,337,143,675,818,1155,55,300,Montana,Heron,0
11808,2019-2020,2019-10-28,2020-04-05,161,8,24,223,247,134,537,671,918,58,229,Montana,Heron,0
11809,1950-1951,1950-11-01,1951-05-01,182,0,91,473,564,104,319,423,987,53,294,Montana,Kalispell,19927
11810,1951-1952,1951-10-16,1952-04-06,174,0,132,526,658,157,809,966,1624,69,503,Montana,Kalispell,19927
11811,1952-1953,1952-11-23,1953-04-12,141,0,29,238,267,67,176,243,510,39,153,Montana,Kalispell,19927
11812,1953-1954,1953-12-01,1954-04-29,150,0,69,342,411,86,307,393,804,47,260,Montana,Kalispell,19927
11813,1954-1955,1954-11-27,1955-04-26,151,0,93,418,511,83,396,479,990,54,275,Montana,Kalispell,19927
11814,1955-1956,1955-10-30,1956-05-02,186,0,162,552,714,125,814,939,1653,68,442,Montana,Kalispell,19927
11815,1956-1957,1956-10-25,1957-04-07,165,0,168,520,688,95,427,522,1210,51,373,Montana,Kalispell,19927
11816,1957-1958,1957-10-21,1958-04-21,183,0,36,309,345,81,343,424,769,54,198,Montana,Kalispell,19927
11817,1958-1959,1958-10-10,1959-04-23,196,0,101,431,532,116,561,677,1209,57,315,Montana,Kalispell,19927
11818,1959-1960,1959-10-28,1960-04-21,177,0,179,644,823,138,634,772,1595,60,430,Montana,Kalispell,19927
11819,1960-1961,1960-10-28,1961-05-06,191,0,78,344,422,93,151,244,666,50,208,Montana,Kalispell,19927
11820,1961-1962,1961-10-20,1962-06-04,228,0,143,576,719,131,562,693,1412,60,405,Montana,Kalispell,19927
11821,1962-1963,1962-11-16,1963-05-03,169,0,107,387,494,76,179,255,749,48,300,Montana,Kalispell,19927
11822,1963-1964,1963-11-06,1964-05-22,199,0,62,505,567,124,679,803,1370,73,388,Montana,Kalispell,19927
11823,1964-1965,1964-10-27,1965-05-02,188,0,109,527,636,131,523,654,1290,74,469,Montana,Kalispell,19927
11824,1965-1966,1965-09-15,1966-05-22,250,0,78,450,528,94,392,486,1014,61,314,Montana,Kalispell,19927
11825,1966-1967,1966-11-06,1967-05-12,188,0,48,343,391,97,194,291,682,59,262,Montana,Kalispell,19927
11826,1967-1968,1967-11-20,1968-05-06,169,0,86,374,460,76,150,226,686,41,260,Montana,Kalispell,19927
11827,1968-1969,1968-09-19,1969-04-29,223,0,178,647,825,134,785,919,1744,64,498,Montana,Kalispell,19927
11828,1969-1970,1969-10-24,1970-05-11,200,0,84,452,536,115,429,544,1080,59,308,Montana,Kalispell,19927
11829,1970-1971,1970-10-25,1971-03-30,157,0,102,430,532,119,252,371,903,64,403,Montana,Kalispell,19927
11830,1971-1972,1971-10-26,1972-04-29,187,0,130,540,670,151,485,636,1306,84,521,Montana,Kalispell,19927
11831,1972-1973,1972-09-25,1973-04-13,201,0,124,501,625,72,169,241,866,46,255,Montana,Kalispell,19927
11832,1973-1974,1973-10-02,1974-04-27,208,0,97,371,468,108,144,252,720,75,366,Montana,Kalispell,19927
11833,1974-1975,1974-10-04,1975-05-24,233,0,101,534,635,110,365,475,1110,62,355,Montana,Kalispell,19927
11834,1975-1976,1975-10-22,1976-04-20,182,0,77,415,492,93,233,326,818,54,241,Montana,Kalispell,19927
11835,1976-1977,1976-11-12,1977-04-20,160,0,81,366,447,71,140,211,658,42,192,Montana,Kalispell,19927
11836,1977-1978,1977-11-07,1978-04-23,168,0,140,467,607,131,596,727,1334,63,392,Montana,Kalispell,19927
11837,1978-1979,1978-10-21,1979-04-19,181,0,250,746,996,123,616,739,1735,70,519,Montana,Kalispell,19927
11838,1979-1980,1979-10-19,1980-04-05,170,0,114,460,574,104,289,393,967,51,312,Montana,Kalispell,19927
11839,1980-1981,1980-10-21,1981-04-13,175,0,50,306,356,79,104,183,539,40,183,Montana,Kalispell,19927
11840,1981-1982,1981-11-17,1982-05-03,168,0,130,508,638,108,466,574,1212,60,407,Montana,Kalispell,19927
11841,1982-1983,1982-11-07,1983-04-26,171,0,65,314,379,73,127,200,579,43,171,Montana,Kalispell,19927
11842,1983-1984,1983-11-07,1984-04-23,169,0,139,436,575,78,233,311,886,46,278,Montana,Kalispell,19927
11843,1984-1985,1984-10-19,1985-04-19,183,0,184,612,796,96,563,659,1455,57,404,Montana,Kalispell,19927
11844,1985-1986,1985-10-06,1986-04-29,206,0,163,543,706,98,561,659,1365,52,354,Montana,Kalispell,19927
11845,1986-1987,1986-11-07,1987-04-12,157,0,81,377,458,97,281,378,836,46,227,Montana,Kalispell,19927
11846,1987-1988,1987-11-16,1988-04-25,162,0,86,381,467,74,258,332,799,48,231,Montana,Kalispell,19927
11847,1988-1989,1988-11-06,1989-04-16,162,0,124,447,571,107,252,359,930,71,366,Montana,Kalispell,19927
11848,1989-1990,1989-10-30,1990-05-08,191,0,59,318,377,100,181,281,658,56,253,Montana,Kalispell,19927
11849,1990-1991,1990-10-05,1991-04-26,204,0,139,489,628,140,463,603,1231,54,389,Montana,Kalispell,19927
11850,1991-1992,1991-10-25,1992-04-11,170,0,50,290,340,69,143,212,552,41,155,Montana,Kalispell,19927
11851,1992-1993,1992-09-13,1993-04-13,213,0,158,539,697,95,563,658,1355,47,327,Montana,Kalispell,19927
11852,1993-1994,1993-11-17,1994-04-14,149,6,80,369,449,90,229,319,768,38,230,Montana,Kalispell,19927
11853,1994-1995,1994-10-29,1995-06-06,221,5,87,405,492,67,2,69,561,37,186,Montana,Kalispell,19927
11854,1995-1996,1995-11-01,1996-05-03,185,15,138,473,611,108,278,386,997,38,279,Montana,Kalispell,19927
11855,1996-1997,1996-10-19,1997-04-08,172,9,154,511,665,217,1648,1865,2530,80,565,Montana,Kalispell,19927
11856,1997-1998,1997-11-16,1998-04-12,148,0,53,298,351,49,93,142,493,35,159,Montana,Kalispell,19927
11857,1998-1999,1998-11-06,1999-05-10,186,0,49,303,352,82,72,154,506,48,176,Montana,Kalispell,19927
11858,2004-2005,2004-10-18,2005-04-14,179,0,70,370,440,50,93,143,583,27,154,Montana,Kalispell,19927
11859,2005-2006,2005-11-06,2006-04-02,148,1,78,364,442,70,245,315,757,41,195,Montana,Kalispell,19927
11860,2006-2007,2006-10-29,2007-04-03,157,0,107,384,491,68,289,357,848,34,204,Montana,Kalispell,19927
11861,2007-2008,2007-11-21,2008-06-10,203,3,66,395,461,94,268,362,823,50,267,Montana,Kalispell,19927
11862,2008-2009,2008-12-01,2009-04-03,124,0,105,394,499,142,789,931,1430,39,319,Montana,Kalispell,19927
11863,2009-2010,2009-10-11,2010-05-05,207,0,78,400,478,62,181,243,721,32,181,Montana,Kalispell,19927
11864,2010-2011,2010-11-16,2011-04-19,155,0,127,422,549,85,364,449,998,51,289,Montana,Kalispell,19927
11865,2011-2012,2011-11-16,2012-03-23,129,0,38,302,340,54,76,130,470,33,142,Montana,Kalispell,19927
11866,2012-2013,2012-10-23,2013-05-23,213,0,38,344,382,36,78,114,496,31,115,Montana,Kalispell,19927
11867,2013-2014,2013-11-03,2014-03-31,149,0,126,433,559,109,236,345,904,44,285,Montana,Kalispell,19927
11868,2014-2015,2014-11-09,2015-03-03,115,0,80,358,438,91,288,379,817,29,198,Montana,Kalispell,19927
11869,2015-2016,2015-11-24,2016-03-17,115,0,57,253,310,65,315,380,690,32,171,Montana,Kalispell,19927
11870,2016-2017,2016-10-10,2017-03-17,159,0,146,504,650,125,647,772,1422,46,362,Montana,Kalispell,19927
11871,2017-2018,2017-11-02,2018-04-05,155,11,102,401,503,123,564,687,1190,42,279,Montana,Kalispell,19927
11872,2018-2019,2018-11-07,2019-04-27,172,3,107,506,613,101,413,514,1127,45,310,Montana,Kalispell,19927
11873,2019-2020,2019-10-28,2020-04-03,159,1,38,345,383,67,111,178,561,40,185,Montana,Kalispell,19927
11874,1950-1951,1950-10-02,1951-05-01,212,0,90,453,543,96,275,371,914,62,315,Montana,Missoula,66788
11875,1951-1952,1951-10-29,1952-03-24,148,0,111,501,612,102,556,658,1270,56,353,Montana,Missoula,66788
11876,1952-1953,1952-11-22,1953-05-25,185,0,38,296,334,60,88,148,482,38,143,Montana,Missoula,66788
11877,1953-1954,1953-12-01,1954-04-28,149,0,42,292,334,60,139,199,533,35,189,Montana,Missoula,66788
11878,1954-1955,1954-11-30,1955-05-14,166,1,79,453,532,75,205,280,812,57,276,Montana,Missoula,66788
11879,1955-1956,1955-10-30,1956-04-24,178,0,145,547,692,127,429,556,1248,75,472,Montana,Missoula,66788
11880,1956-1957,1956-10-23,1957-03-25,154,0,135,452,587,70,180,250,837,49,339,Montana,Missoula,66788
11881,1957-1958,1957-10-22,1958-04-28,189,0,21,269,290,68,82,150,440,51,142,Montana,Missoula,66788
11882,1958-1959,1958-11-14,1959-05-16,184,0,69,355,424,96,267,363,787,56,263,Montana,Missoula,66788
11883,1959-1960,1959-10-28,1960-04-25,181,0,130,499,629,88,328,416,1045,54,332,Montana,Missoula,66788
11884,1960-1961,1960-10-29,1961-05-05,189,0,92,426,518,73,224,297,815,42,171,Montana,Missoula,66788
11885,1961-1962,1961-10-20,1962-03-23,155,0,155,510,665,94,213,307,972,56,302,Montana,Missoula,66788
11886,1962-1963,1962-11-22,1963-05-03,163,0,129,386,515,86,196,282,797,38,291,Montana,Missoula,66788
11887,1963-1964,1963-11-10,1964-05-04,177,0,104,499,603,107,435,542,1145,63,340,Montana,Missoula,66788
11888,1964-1965,1964-10-17,1965-04-16,182,0,116,535,651,131,407,538,1189,67,405,Montana,Missoula,66788
11889,1965-1966,1965-09-15,1966-04-27,225,0,62,373,435,96,174,270,705,53,250,Montana,Missoula,66788
11890,1966-1967,1966-10-22,1967-05-11,202,0,29,268,297,75,50,125,422,51,168,Montana,Missoula,66788
11891,1967-1968,1967-10-28,1968-04-21,177,0,94,385,479,74,187,261,740,47,248,Montana,Missoula,66788
11892,1968-1969,1968-11-08,1969-03-28,141,0,119,489,608,110,533,643,1251,61,398,Montana,Missoula,66788
11893,1969-1970,1969-11-16,1970-05-11,177,0,63,359,422,93,204,297,719,52,231,Montana,Missoula,66788
11894,1970-1971,1970-10-25,1971-04-24,182,0,74,372,446,79,146,225,671,59,299,Montana,Missoula,66788
11895,1971-1972,1971-10-27,1972-04-29,186,0,102,434,536,141,402,543,1079,93,427,Montana,Missoula,66788
11896,1972-1973,1972-09-24,1973-04-14,203,0,123,437,560,42,108,150,710,28,141,Montana,Missoula,66788
11897,1973-1974,1973-10-31,1974-04-02,154,0,87,333,420,93,199,292,712,51,290,Montana,Missoula,66788
11898,1974-1975,1974-10-05,1975-04-28,206,0,78,439,517,100,279,379,896,61,283,Montana,Missoula,66788
11899,1975-1976,1975-10-21,1976-04-26,189,0,69,361,430,81,146,227,657,47,208,Montana,Missoula,66788
11900,1976-1977,1976-10-05,1977-04-20,198,0,78,466,544,58,107,165,709,38,169,Montana,Missoula,66788
11901,1977-1978,1977-10-31,1978-05-24,206,0,96,355,451,101,340,441,892,51,258,Montana,Missoula,66788
11902,1978-1979,1978-11-09,1979-04-20,163,0,230,570,800,103,652,755,1555,56,415,Montana,Missoula,66788
11903,1979-1980,1979-11-03,1980-05-23,203,0,115,391,506,90,209,299,805,46,271,Montana,Missoula,66788
11904,1980-1981,1980-11-14,1981-03-30,137,0,39,243,282,31,19,50,332,22,88,Montana,Missoula,66788
11905,1981-1982,1981-10-20,1982-04-19,182,0,117,425,542,110,391,501,1043,59,337,Montana,Missoula,66788
11906,1982-1983,1982-10-17,1983-03-07,142,0,76,277,353,47,74,121,474,33,126,Montana,Missoula,66788
11907,1983-1984,1983-09-19,1984-03-25,189,0,135,401,536,65,304,369,905,35,201,Montana,Missoula,66788
11908,1984-1985,1984-10-18,1985-04-22,187,0,115,447,562,61,171,232,794,44,218,Montana,Missoula,66788
11909,1985-1986,1985-10-06,1986-05-14,221,0,143,499,642,71,306,377,1019,46,261,Montana,Missoula,66788
11910,1986-1987,1986-11-07,1987-04-12,157,0,89,386,475,56,237,293,768,35,148,Montana,Missoula,66788
11911,1987-1988,1987-11-16,1988-05-31,198,0,94,369,463,56,138,194,657,37,189,Montana,Missoula,66788
11912,1988-1989,1988-11-10,1989-04-17,159,0,122,444,566,89,162,251,817,52,287,Montana,Missoula,66788
11913,1989-1990,1989-10-28,1990-04-28,183,0,51,316,367,47,79,126,493,32,130,Montana,Missoula,66788
11914,1990-1991,1990-10-06,1991-04-29,206,3,114,445,559,76,178,254,813,47,294,Montana,Missoula,66788
11915,1991-1992,1991-10-26,1992-04-09,167,0,53,304,357,45,80,125,482,27,107,Montana,Missoula,66788
11916,1992-1993,1992-11-04,1993-04-07,155,0,153,499,652,68,312,380,1032,35,238,Montana,Missoula,66788
11917,1993-1994,1993-11-04,1994-03-23,140,0,49,331,380,44,59,103,483,27,130,Montana,Missoula,66788
11918,1994-1995,1994-10-31,1995-03-26,147,0,69,325,394,40,90,130,524,24,110,Montana,Missoula,66788
11919,1995-1996,1995-11-06,1996-05-02,179,0,100,366,466,83,178,261,727,50,258,Montana,Missoula,66788
11920,1996-1997,1996-10-16,1997-04-09,176,0,105,409,514,178,642,820,1334,76,426,Montana,Missoula,66788
11921,1997-1998,1997-11-19,1998-04-07,140,0,49,279,328,56,131,187,515,31,134,Montana,Missoula,66788
11922,1998-1999,1998-11-08,1999-05-09,183,1,50,301,351,72,64,136,487,46,163,Montana,Missoula,66788
11923,1999-2000,1999-10-15,2000-04-06,175,0,33,272,305,50,102,152,457,32,124,Montana,Missoula,66788
11924,2000-2001,2000-11-04,2001-06-04,213,6,112,469,581,68,376,444,1025,39,217,Montana,Missoula,66788
11925,2001-2002,2001-10-25,2002-05-08,196,0,68,368,436,89,156,245,681,48,246,Montana,Missoula,66788
11926,2002-2003,2002-10-29,2003-04-05,159,0,51,287,338,60,58,118,456,36,129,Montana,Missoula,66788
11927,2003-2004,2003-10-30,2004-03-07,130,0,97,343,440,72,204,276,716,42,233,Montana,Missoula,66788
11928,2004-2005,2004-11-21,2005-04-14,145,0,58,295,353,48,117,165,518,32,164,Montana,Missoula,66788
11929,2005-2006,2005-11-05,2006-04-17,164,0,75,326,401,41,97,138,539,27,106,Montana,Missoula,66788
11930,2006-2007,2006-10-30,2007-05-04,187,0,57,313,370,38,40,78,448,29,120,Montana,Missoula,66788
11931,2007-2008,2007-11-18,2008-06-11,207,0,59,336,395,89,121,210,605,57,221,Montana,Missoula,66788
11932,2008-2009,2008-12-01,2009-04-28,149,0,85,332,417,72,184,256,673,38,211,Montana,Missoula,66788
11933,2009-2010,2009-10-09,2010-04-13,187,0,67,355,422,41,21,62,484,31,119,Montana,Missoula,66788
11934,2010-2011,2010-11-14,2011-04-19,157,0,124,400,524,102,334,436,960,49,274,Montana,Missoula,66788
11935,2011-2012,2011-11-01,2012-05-02,184,0,38,339,377,76,161,237,614,44,179,Montana,Missoula,66788
11936,2012-2013,2012-10-22,2013-04-30,191,0,51,316,367,81,210,291,658,46,207,Montana,Missoula,66788
11937,2013-2014,2013-11-03,2014-05-11,190,0,105,392,497,102,212,314,811,44,283,Montana,Missoula,66788
11938,2014-2015,2014-11-10,2015-04-12,154,0,78,332,410,52,168,220,630,24,135,Montana,Missoula,66788
11939,2015-2016,2015-11-05,2016-03-17,134,0,77,300,377,51,254,305,682,31,153,Montana,Missoula,66788
11940,2016-2017,2016-10-11,2017-05-17,219,0,128,441,569,105,475,580,1149,49,307,Montana,Missoula,66788
11941,2017-2018,2017-10-02,2018-04-02,183,0,70,348,418,86,282,368,786,45,209,Montana,Missoula,66788
11942,2018-2019,2018-11-06,2019-04-28,174,0,113,449,562,99,490,589,1151,56,337,Montana,Missoula,66788
11943,2019-2020,2019-09-29,2020-04-15,200,0,38,342,380,67,107,174,554,43,161,Montana,Missoula,66788
11944,1950-1951,1950-11-09,1951-03-10,122,2,39,429,468,18,24,42,510,8,80,Nebraska,Culbertson,595
11945,1951-1952,1951-11-01,1952-04-09,161,4,34,452,486,49,99,148,634,12,100,Nebraska,Culbertson,595
11946,1952-1953,1952-11-22,1953-03-03,102,0,24,305,329,29,147,176,505,11,75,Nebraska,Culbertson,595
11947,1953-1954,1953-11-06,1954-03-31,146,1,29,328,357,40,183,223,580,8,57,Nebraska,Culbertson,595
11948,1954-1955,1954-11-29,1955-03-26,118,4,31,394,425,45,194,239,664,15,109,Nebraska,Culbertson,595
11949,1955-1956,1955-11-15,1956-04-04,142,0,53,440,493,50,171,221,714,21,154,Nebraska,Culbertson,595
11950,1956-1957,1956-11-15,1957-04-07,144,0,35,367,402,39,60,99,501,17,104,Nebraska,Culbertson,595
11951,1957-1958,1957-10-25,1958-03-30,157,0,29,433,462,63,225,288,750,25,160,Nebraska,Culbertson,595
11952,1958-1959,1958-11-17,1959-04-12,147,0,66,419,485,52,142,194,679,19,163,Nebraska,Culbertson,595
11953,1959-1960,1959-10-01,1960-03-21,173,1,80,555,635,69,298,367,1002,24,212,Nebraska,Culbertson,595
11954,1960-1961,1960-11-28,1961-04-11,135,0,31,366,397,38,104,142,539,16,87,Nebraska,Culbertson,595
11955,1961-1962,1961-11-16,1962-03-14,119,0,95,456,551,36,139,175,726,15,152,Nebraska,Culbertson,595
11956,1962-1963,1962-11-16,1963-03-15,120,0,77,394,471,51,156,207,678,15,126,Nebraska,Culbertson,595
11957,1963-1964,1963-12-01,1964-04-05,127,0,52,432,484,38,96,134,618,13,99,Nebraska,Culbertson,595
11958,1964-1965,1964-11-19,1965-03-28,130,0,57,552,609,61,171,232,841,14,143,Nebraska,Culbertson,595
11959,1970-1971,1970-11-23,1971-03-27,125,0,56,448,504,36,112,148,652,9,72,Nebraska,Culbertson,595
11960,1971-1972,1971-10-30,1972-02-29,123,2,46,394,440,18,27,45,485,6,38,Nebraska,Culbertson,595
11961,1972-1973,1972-10-31,1973-04-09,161,2,97,450,547,39,124,163,710,12,100,Nebraska,Culbertson,595
11962,1973-1974,1973-11-05,1974-04-05,152,0,85,465,550,53,220,273,823,17,133,Nebraska,Culbertson,595
11963,1974-1975,1974-11-30,1975-04-02,124,0,37,454,491,37,65,102,593,12,89,Nebraska,Culbertson,595
11964,1975-1976,1975-11-19,1976-03-30,133,0,62,420,482,66,194,260,742,14,129,Nebraska,Culbertson,595
11965,1976-1977,1976-11-27,1977-04-03,128,0,48,472,520,27,38,65,585,8,62,Nebraska,Culbertson,595
11966,1977-1978,1977-11-22,1978-03-07,106,3,106,494,600,30,133,163,763,10,88,Nebraska,Culbertson,595
11967,1978-1979,1978-11-12,1979-03-03,112,0,123,506,629,27,109,136,765,13,100,Nebraska,Culbertson,595
11968,1979-1980,1979-11-21,1980-04-05,137,2,60,425,485,87,219,306,791,14,134,Nebraska,Culbertson,595
11969,1980-1981,1980-10-28,1981-03-22,146,0,33,439,472,27,35,62,534,10,64,Nebraska,Culbertson,595
11970,1982-1983,1982-11-23,1983-04-14,143,2,35,343,378,59,178,237,615,15,100,Nebraska,Culbertson,595
11971,1983-1984,1983-11-09,1984-04-30,174,6,127,554,681,87,316,403,1084,22,248,Nebraska,Culbertson,595
11972,1984-1985,1984-11-27,1985-03-31,125,20,72,436,508,44,164,208,716,14,139,Nebraska,Culbertson,595
11973,1985-1986,1985-09-29,1986-04-27,211,9,67,439,506,49,130,179,685,17,111,Nebraska,Culbertson,595
11974,1986-1987,1986-10-12,1987-04-13,184,3,25,394,419,58,80,138,557,18,106,Nebraska,Culbertson,595
11975,1987-1988,1987-11-16,1988-04-02,139,3,66,460,526,53,203,256,782,16,125,Nebraska,Culbertson,595
11976,1989-1990,1989-12-01,1990-03-25,115,3,57,383,440,24,113,137,577,7,78,Nebraska,Culbertson,595
11977,1990-1991,1990-10-08,1991-03-30,174,1,66,443,509,49,64,113,622,19,111,Nebraska,Culbertson,595
11978,1991-1992,1991-10-29,1992-03-19,143,6,21,301,322,42,69,111,433,12,86,Nebraska,Culbertson,595
11979,1992-1993,1992-11-24,1993-04-20,148,19,100,497,597,78,287,365,962,19,173,Nebraska,Culbertson,595
11980,1993-1994,1993-11-14,1994-04-30,168,3,63,429,492,91,159,250,742,22,186,Nebraska,Culbertson,595
11981,1994-1995,1994-11-04,1995-04-18,166,1,46,388,434,64,125,189,623,21,150,Nebraska,Culbertson,595
11982,1995-1996,1995-09-21,1996-04-15,208,1,69,557,626,38,31,69,695,17,128,Nebraska,Culbertson,595
11983,1996-1997,1996-11-14,1997-04-13,151,2,72,474,546,43,55,98,644,15,117,Nebraska,Culbertson,595
11984,1997-1998,1997-10-25,1998-04-01,159,1,37,355,392,41,53,94,486,16,90,Nebraska,Culbertson,595
11985,1998-1999,1998-11-07,1999-04-03,148,0,39,367,406,41,46,87,493,15,99,Nebraska,Culbertson,595
11986,1999-2000,1999-11-23,2000-04-16,146,5,15,339,354,30,35,65,419,8,62,Nebraska,Culbertson,595
11987,2000-2001,2000-11-07,2001-03-16,130,16,61,428,489,66,191,257,746,20,150,Nebraska,Culbertson,595
11988,2001-2002,2001-11-27,2002-03-25,119,4,35,396,431,25,42,67,498,9,77,Nebraska,Culbertson,595
11989,2002-2003,2002-10-23,2003-04-08,168,2,50,440,490,47,78,125,615,15,114,Nebraska,Culbertson,595
11990,2003-2004,2003-11-23,2004-04-12,142,2,39,392,431,38,65,103,534,13,104,Nebraska,Culbertson,595
11991,2006-2007,2006-11-27,2007-04-06,131,13,63,387,450,35,235,270,720,6,68,Nebraska,Culbertson,595
11992,2008-2009,2008-11-11,2009-04-05,146,17,45,429,474,20,23,43,517,8,57,Nebraska,Culbertson,595
11993,2009-2010,2009-10-10,2010-03-11,153,9,68,418,486,46,127,173,659,12,102,Nebraska,Culbertson,595
11994,2010-2011,2010-11-21,2011-04-16,147,1,59,450,509,38,67,105,614,11,117,Nebraska,Culbertson,595
11995,2012-2013,2012-12-01,2013-05-02,153,14,43,402,445,52,188,240,685,13,109,Nebraska,Culbertson,595
11996,2013-2014,2013-11-22,2014-04-14,144,0,85,488,573,44,105,149,722,15,140,Nebraska,Culbertson,595
11997,2014-2015,2014-11-12,2015-03-04,113,0,54,393,447,21,77,98,545,7,54,Nebraska,Culbertson,595
11998,2015-2016,2015-11-12,2016-02-29,110,1,20,262,282,39,77,116,398,10,66,Nebraska,Culbertson,595
11999,2016-2017,2016-11-18,2017-05-01,165,8,38,348,386,17,19,36,422,6,41,Nebraska,Culbertson,595
12000,2017-2018,2017-12-01,2018-04-15,136,1,70,442,512,48,139,187,699,13,124,Nebraska,Culbertson,595
12001,2018-2019,2018-11-08,2019-04-12,156,1,77,462,539,45,124,169,708,12,103,Nebraska,Culbertson,595
12002,2019-2020,2019-10-29,2020-04-17,172,0,25,418,443,42,42,84,527,16,99,Nebraska,Culbertson,595
12003,1950-1951,1950-11-09,1951-03-20,132,0,86,443,529,29,48,77,606,16,140,Nebraska,Grand Island,48520
12004,1951-1952,1951-11-01,1952-04-11,163,0,90,434,524,57,125,182,706,27,175,Nebraska,Grand Island,48520
12005,1952-1953,1952-11-22,1953-03-07,106,0,52,311,363,46,192,238,601,20,124,Nebraska,Grand Island,48520
12006,1953-1954,1953-11-06,1954-05-02,178,0,57,352,409,36,64,100,509,14,93,Nebraska,Grand Island,48520
12007,1954-1955,1954-12-01,1955-03-28,118,0,67,381,448,39,130,169,617,18,133,Nebraska,Grand Island,48520
12008,1955-1956,1955-11-02,1956-04-23,174,0,115,505,620,42,145,187,807,28,222,Nebraska,Grand Island,48520
12009,1956-1957,1956-11-15,1957-04-11,148,0,78,396,474,30,50,80,554,17,102,Nebraska,Grand Island,48520
12010,1957-1958,1957-10-24,1958-03-24,152,0,65,408,473,46,133,179,652,29,173,Nebraska,Grand Island,48520
12011,1958-1959,1958-11-17,1959-04-10,145,0,94,448,542,45,70,115,657,21,164,Nebraska,Grand Island,48520
12012,1959-1960,1959-11-05,1960-04-02,150,0,135,519,654,70,344,414,1068,29,253,Nebraska,Grand Island,48520
12013,1960-1961,1960-11-09,1961-04-11,154,0,46,386,432,24,32,56,488,14,75,Nebraska,Grand Island,48520
12014,1961-1962,1961-11-02,1962-04-08,158,0,155,536,691,65,275,340,1031,30,219,Nebraska,Grand Island,48520
12015,1962-1963,1962-11-16,1963-03-14,119,0,127,451,578,35,126,161,739,23,186,Nebraska,Grand Island,48520
12016,1963-1964,1963-12-01,1964-04-05,127,0,79,392,471,27,71,98,569,20,112,Nebraska,Grand Island,48520
12017,1964-1965,1964-11-21,1965-03-27,127,0,120,521,641,54,136,190,831,24,208,Nebraska,Grand Island,48520
12018,1965-1966,1965-11-26,1966-04-20,146,0,84,391,475,24,45,69,544,21,138,Nebraska,Grand Island,48520
12019,1966-1967,1966-10-14,1967-05-04,203,0,63,444,507,40,86,126,633,18,134,Nebraska,Grand Island,48520
12020,1967-1968,1967-11-02,1968-04-04,155,0,63,406,469,21,31,52,521,15,68,Nebraska,Grand Island,48520
12021,1968-1969,1968-11-06,1969-03-30,145,0,139,466,605,83,439,522,1127,30,223,Nebraska,Grand Island,48520
12022,1969-1970,1969-10-12,1970-04-01,172,0,95,433,528,45,126,171,699,26,127,Nebraska,Grand Island,48520
12023,1970-1971,1970-10-08,1971-04-05,180,0,85,438,523,57,96,153,676,24,145,Nebraska,Grand Island,48520
12024,1971-1972,1971-11-17,1972-04-03,139,0,76,377,453,25,34,59,512,18,129,Nebraska,Grand Island,48520
12025,1972-1973,1972-10-28,1973-04-10,165,0,124,367,491,71,177,248,739,31,182,Nebraska,Grand Island,48520
12026,1973-1974,1973-11-08,1974-04-04,148,0,107,405,512,70,310,380,892,25,264,Nebraska,Grand Island,48520
12027,1974-1975,1974-11-29,1975-04-18,141,0,95,414,509,58,280,338,847,25,174,Nebraska,Grand Island,48520
12028,1975-1976,1975-11-19,1976-03-30,133,0,78,338,416,52,108,160,576,20,123,Nebraska,Grand Island,48520
12029,1976-1977,1976-11-12,1977-04-04,144,0,70,455,525,44,36,80,605,17,115,Nebraska,Grand Island,48520
12030,1977-1978,1977-11-08,1978-03-12,125,0,159,518,677,64,218,282,959,33,287,Nebraska,Grand Island,48520
12031,1978-1979,1978-11-15,1979-04-02,139,0,222,596,818,73,361,434,1252,31,287,Nebraska,Grand Island,48520
12032,1979-1980,1979-10-22,1980-03-30,161,0,92,398,490,53,139,192,682,25,155,Nebraska,Grand Island,48520
12033,1980-1981,1980-10-27,1981-03-07,132,0,47,337,384,27,27,54,438,8,65,Nebraska,Grand Island,48520
12034,1981-1982,1981-10-24,1982-04-28,187,0,145,515,660,56,195,251,911,26,232,Nebraska,Grand Island,48520
12035,1982-1983,1982-10-19,1983-04-14,178,0,55,344,399,64,139,203,602,29,153,Nebraska,Grand Island,48520
12036,1983-1984,1983-11-09,1984-04-29,173,0,160,429,589,110,416,526,1115,27,258,Nebraska,Grand Island,48520
12037,1984-1985,1984-11-09,1985-04-01,144,0,93,405,498,33,92,125,623,17,117,Nebraska,Grand Island,48520
12038,1985-1986,1985-09-29,1986-03-12,165,0,94,383,477,33,74,107,584,18,111,Nebraska,Grand Island,48520
12039,1986-1987,1986-11-01,1987-04-03,154,0,25,303,328,42,43,85,413,16,85,Nebraska,Grand Island,48520
12040,1987-1988,1987-10-10,1988-03-17,160,0,94,424,518,50,160,210,728,20,170,Nebraska,Grand Island,48520
12041,1988-1989,1988-11-15,1989-03-20,126,0,78,385,463,33,55,88,551,20,151,Nebraska,Grand Island,48520
12042,1989-1990,1989-10-30,1990-04-12,165,0,66,397,463,40,58,98,561,20,157,Nebraska,Grand Island,48520
12043,1990-1991,1990-11-06,1991-03-28,143,0,79,384,463,33,57,90,553,20,173,Nebraska,Grand Island,48520
12044,1991-1992,1991-10-29,1992-04-21,176,0,32,259,291,45,62,107,398,17,85,Nebraska,Grand Island,48520
12045,1993-1994,1993-10-31,1994-04-30,182,0,102,466,568,55,139,194,762,23,189,Nebraska,Grand Island,48520
12046,1994-1995,1994-11-09,1995-04-12,155,0,67,348,415,32,92,124,539,13,104,Nebraska,Grand Island,48520
12047,1997-1998,1997-10-25,1998-03-31,158,0,63,326,389,47,73,120,509,16,102,Nebraska,Grand Island,48520
12048,1998-1999,1998-11-03,1999-03-12,130,0,59,282,341,28,35,63,404,13,75,Nebraska,Grand Island,48520
12049,1999-2000,1999-12-01,2000-04-15,137,0,27,282,309,24,24,48,357,10,60,Nebraska,Grand Island,48520
12050,2000-2001,2000-11-07,2001-03-12,126,0,120,459,579,61,186,247,826,19,170,Nebraska,Grand Island,48520
12051,2001-2002,2001-11-27,2002-03-25,119,0,46,331,377,39,71,110,487,10,80,Nebraska,Grand Island,48520
12052,2002-2003,2002-10-23,2003-04-08,168,0,68,386,454,47,53,100,554,17,131,Nebraska,Grand Island,48520
12053,2003-2004,2003-11-05,2004-03-05,122,0,88,346,434,46,164,210,644,12,105,Nebraska,Grand Island,48520
12054,2004-2005,2004-11-28,2005-03-25,118,0,67,303,370,30,105,135,505,11,81,Nebraska,Grand Island,48520
12055,2005-2006,2005-11-16,2006-03-29,134,0,57,286,343,41,151,192,535,10,94,Nebraska,Grand Island,48520
12056,2006-2007,2006-11-15,2007-04-05,142,1,74,339,413,20,55,75,488,12,91,Nebraska,Grand Island,48520
12057,2007-2008,2007-11-21,2008-04-11,143,0,74,397,471,28,241,269,740,18,100,Nebraska,Grand Island,48520
12058,2008-2009,2008-11-29,2009-04-05,128,0,75,383,458,34,82,116,574,20,158,Nebraska,Grand Island,48520
12059,2009-2010,2009-10-09,2010-03-19,162,0,116,394,510,64,471,535,1045,23,166,Nebraska,Grand Island,48520
12060,2010-2011,2010-11-20,2011-04-15,147,0,102,423,525,51,170,221,746,24,189,Nebraska,Grand Island,48520
12061,2011-2012,2011-12-01,2012-02-29,91,0,27,241,268,26,107,133,401,8,52,Nebraska,Grand Island,48520
12062,2012-2013,2012-11-26,2013-05-01,157,0,55,344,399,53,146,199,598,20,123,Nebraska,Grand Island,48520
12063,2013-2014,2013-11-21,2014-04-14,145,0,102,446,548,34,36,70,618,22,160,Nebraska,Grand Island,48520
12064,2014-2015,2014-11-10,2015-04-09,151,0,73,415,488,35,52,87,575,16,117,Nebraska,Grand Island,48520
12065,2015-2016,2015-11-11,2016-03-24,135,0,44,243,287,54,129,183,470,21,133,Nebraska,Grand Island,48520
12066,2016-2017,2016-11-18,2017-05-01,165,0,54,302,356,19,10,29,385,16,86,Nebraska,Grand Island,48520
12067,2017-2018,2017-10-31,2018-04-15,167,0,105,430,535,52,130,182,717,23,191,Nebraska,Grand Island,48520
12068,2018-2019,2018-10-14,2019-04-11,180,0,107,413,520,55,139,194,714,31,207,Nebraska,Grand Island,48520
12069,2019-2020,2019-10-28,2020-04-17,173,0,38,306,344,48,59,107,451,23,107,Nebraska,Grand Island,48520
12070,1950-1951,1950-11-08,1951-03-20,133,5,52,372,424,25,38,63,487,10,88,Nebraska,Holdrege,5495
12071,1952-1953,1952-11-22,1953-03-04,103,1,35,245,280,45,161,206,486,10,73,Nebraska,Holdrege,5495
12072,1954-1955,1954-12-01,1955-03-26,116,1,45,315,360,45,220,265,625,16,127,Nebraska,Holdrege,5495
12073,1955-1956,1955-11-02,1956-04-23,174,0,86,426,512,44,129,173,685,21,142,Nebraska,Holdrege,5495
12074,1956-1957,1956-11-15,1957-04-11,148,0,59,348,407,50,45,95,502,20,118,Nebraska,Holdrege,5495
12075,1957-1958,1957-10-25,1958-03-28,155,1,58,328,386,70,253,323,709,27,180,Nebraska,Holdrege,5495
12076,1958-1959,1958-11-17,1959-04-10,145,3,77,351,428,73,108,181,609,26,204,Nebraska,Holdrege,5495
12077,1959-1960,1959-11-05,1960-04-17,165,0,108,403,511,77,334,411,922,26,205,Nebraska,Holdrege,5495
12078,1960-1961,1960-11-29,1961-04-11,134,12,30,283,313,42,30,72,385,15,92,Nebraska,Holdrege,5495
12079,1961-1962,1961-11-16,1962-03-18,123,1,112,403,515,55,188,243,758,20,175,Nebraska,Holdrege,5495
12080,1962-1963,1962-11-16,1963-03-14,119,0,85,340,425,36,125,161,586,14,117,Nebraska,Holdrege,5495
12081,1963-1964,1963-12-01,1964-04-05,127,0,58,346,404,50,96,146,550,22,139,Nebraska,Holdrege,5495
12082,1964-1965,1964-11-20,1965-03-27,128,0,59,469,528,31,108,139,667,9,88,Nebraska,Holdrege,5495
12083,1965-1966,1965-11-26,1966-04-12,138,0,71,368,439,24,78,102,541,17,110,Nebraska,Holdrege,5495
12084,1966-1967,1966-10-14,1967-05-03,202,0,46,417,463,46,159,205,668,17,128,Nebraska,Holdrege,5495
12085,1967-1968,1967-11-02,1968-04-04,155,1,44,395,439,21,44,65,504,14,92,Nebraska,Holdrege,5495
12086,1968-1969,1968-11-14,1969-03-30,137,0,100,439,539,61,406,467,1006,24,184,Nebraska,Holdrege,5495
12087,1969-1970,1969-10-12,1970-04-13,184,0,53,429,482,55,110,165,647,22,138,Nebraska,Holdrege,5495
12088,1970-1971,1970-10-09,1971-03-27,170,2,58,424,482,43,139,182,664,19,128,Nebraska,Holdrege,5495
12089,1971-1972,1971-11-18,1972-02-29,104,0,48,330,378,20,30,50,428,12,103,Nebraska,Holdrege,5495
12090,1972-1973,1972-10-31,1973-04-10,162,0,97,374,471,47,134,181,652,20,114,Nebraska,Holdrege,5495
12091,1973-1974,1973-11-20,1974-04-04,136,0,86,367,453,41,219,260,713,18,153,Nebraska,Holdrege,5495
12092,1974-1975,1974-11-29,1975-04-19,142,0,48,401,449,37,165,202,651,15,101,Nebraska,Holdrege,5495
12093,1975-1976,1975-11-20,1976-03-16,118,0,70,353,423,60,202,262,685,20,170,Nebraska,Holdrege,5495
12094,1976-1977,1976-11-12,1977-04-04,144,0,48,450,498,27,29,56,554,8,61,Nebraska,Holdrege,5495
12095,1977-1978,1977-11-21,1978-03-11,111,0,130,488,618,42,218,260,878,13,144,Nebraska,Holdrege,5495
12096,1978-1979,1978-11-14,1979-04-02,140,0,141,518,659,43,141,184,843,18,150,Nebraska,Holdrege,5495
12097,1979-1980,1979-10-31,1980-04-04,157,5,81,399,480,72,175,247,727,22,145,Nebraska,Holdrege,5495
12098,1980-1981,1980-10-27,1981-03-22,147,5,46,326,372,19,18,37,409,8,46,Nebraska,Holdrege,5495
12099,1981-1982,1981-11-19,1982-04-08,141,13,112,362,474,43,133,176,650,17,144,Nebraska,Holdrege,5495
12100,1983-1984,1983-11-09,1984-04-30,174,11,140,429,569,110,474,584,1153,28,249,Nebraska,Holdrege,5495
12101,1987-1988,1987-10-11,1988-03-17,159,11,84,362,446,34,119,153,599,14,97,Nebraska,Holdrege,5495
12102,1989-1990,1989-11-29,1990-04-06,129,0,76,356,432,32,95,127,559,9,98,Nebraska,Holdrege,5495
12103,1990-1991,1990-11-03,1991-03-28,146,6,93,390,483,25,57,82,565,11,74,Nebraska,Holdrege,5495
12104,1991-1992,1991-10-30,1992-04-21,175,6,35,265,300,34,69,103,403,9,62,Nebraska,Holdrege,5495
12105,1992-1993,1992-11-04,1993-03-19,136,5,128,462,590,67,359,426,1016,20,177,Nebraska,Holdrege,5495
12106,1993-1994,1993-10-30,1994-04-30,183,3,99,444,543,60,174,234,777,16,143,Nebraska,Holdrege,5495
12107,1995-1996,1995-10-24,1996-04-16,176,7,109,495,604,33,51,84,688,11,72,Nebraska,Holdrege,5495
12108,1996-1997,1996-11-12,1997-04-12,152,1,105,424,529,27,40,67,596,13,101,Nebraska,Holdrege,5495
12109,1997-1998,1997-10-26,1998-03-19,145,11,69,307,376,42,48,90,466,13,88,Nebraska,Holdrege,5495
12110,1998-1999,1998-11-04,1999-03-13,130,9,52,286,338,29,44,73,411,9,73,Nebraska,Holdrege,5495
12111,1999-2000,1999-12-01,2000-04-16,138,11,24,259,283,27,41,68,351,10,61,Nebraska,Holdrege,5495
12112,2000-2001,2000-11-07,2001-03-16,130,20,107,420,527,68,216,284,811,19,161,Nebraska,Holdrege,5495
12113,2001-2002,2001-11-28,2002-03-25,118,6,45,315,360,27,60,87,447,7,69,Nebraska,Holdrege,5495
12114,2002-2003,2002-10-24,2003-04-08,167,6,54,386,440,38,51,89,529,21,123,Nebraska,Holdrege,5495
12115,2003-2004,2003-11-23,2004-04-12,142,6,81,353,434,35,124,159,593,11,89,Nebraska,Holdrege,5495
12116,2004-2005,2004-11-29,2005-02-28,92,4,61,232,293,18,55,73,366,6,59,Nebraska,Holdrege,5495
12117,2005-2006,2005-11-29,2006-03-27,119,18,56,269,325,44,76,120,445,9,88,Nebraska,Holdrege,5495
12118,2007-2008,2007-11-22,2008-03-08,108,18,74,378,452,36,108,144,596,13,100,Nebraska,Holdrege,5495
12119,2008-2009,2008-10-23,2009-04-05,165,0,72,427,499,33,66,99,598,15,133,Nebraska,Holdrege,5495
12120,2009-2010,2009-10-11,2010-03-20,161,8,98,423,521,45,202,247,768,13,101,Nebraska,Holdrege,5495
12121,2010-2011,2010-11-21,2011-03-29,129,0,101,474,575,62,125,187,762,20,198,Nebraska,Holdrege,5495
12122,2011-2012,2011-12-01,2012-02-29,91,0,37,298,335,27,88,115,450,6,53,Nebraska,Holdrege,5495
12123,2012-2013,2012-12-01,2013-04-18,139,0,64,427,491,35,138,173,664,11,76,Nebraska,Holdrege,5495
12124,2013-2014,2013-11-22,2014-04-14,144,0,114,518,632,41,62,103,735,18,153,Nebraska,Holdrege,5495
12125,2014-2015,2014-11-12,2015-03-05,114,0,84,418,502,23,63,86,588,11,87,Nebraska,Holdrege,5495
12126,2015-2016,2015-11-26,2016-03-24,120,0,38,269,307,44,132,176,483,13,79,Nebraska,Holdrege,5495
12127,2016-2017,2016-12-01,2017-05-01,152,0,52,329,381,23,21,44,425,8,73,Nebraska,Holdrege,5495
12128,2017-2018,2017-11-01,2018-04-16,167,5,98,486,584,49,94,143,727,14,130,Nebraska,Holdrege,5495
12129,2018-2019,2018-10-14,2019-04-12,181,7,110,484,594,63,183,246,840,19,146,Nebraska,Holdrege,5495
12130,2019-2020,2019-10-29,2020-04-17,172,0,41,419,460,44,71,115,575,13,101,Nebraska,Holdrege,5495
12131,1950-1951,1950-11-08,1951-04-12,156,0,85,449,534,25,50,75,609,14,99,Nebraska,Lincoln,258379
12132,1951-1952,1951-11-02,1952-04-09,160,0,87,406,493,45,141,186,679,21,135,Nebraska,Lincoln,258379
12133,1952-1953,1952-11-25,1953-03-08,104,0,52,289,341,39,181,220,561,18,110,Nebraska,Lincoln,258379
12134,1953-1954,1953-11-07,1954-03-29,143,0,49,329,378,15,8,23,401,10,62,Nebraska,Lincoln,258379
12135,1954-1955,1954-12-01,1955-03-26,116,0,54,304,358,36,125,161,519,17,115,Nebraska,Lincoln,258379
12136,1955-1956,1955-11-02,1956-04-06,157,0,89,395,484,37,113,150,634,24,160,Nebraska,Lincoln,258379
12137,1956-1957,1956-11-15,1957-04-11,148,0,61,298,359,50,57,107,466,21,122,Nebraska,Lincoln,258379
12138,1957-1958,1957-10-26,1958-03-16,142,0,56,275,331,56,130,186,517,23,128,Nebraska,Lincoln,258379
12139,1958-1959,1958-11-17,1959-03-26,130,0,79,341,420,48,115,163,583,20,146,Nebraska,Lincoln,258379
12140,1959-1960,1959-11-05,1960-04-02,150,0,129,419,548,79,395,474,1022,28,237,Nebraska,Lincoln,258379
12141,1960-1961,1960-11-09,1961-04-09,152,0,48,302,350,28,28,56,406,21,98,Nebraska,Lincoln,258379
12142,1961-1962,1961-11-15,1962-04-01,138,0,138,408,546,49,189,238,784,30,225,Nebraska,Lincoln,258379
12143,1962-1963,1962-11-19,1963-03-13,115,0,105,346,451,42,79,121,572,26,178,Nebraska,Lincoln,258379
12144,1963-1964,1963-12-01,1964-03-27,118,0,82,323,405,25,37,62,467,19,113,Nebraska,Lincoln,258379
12145,1964-1965,1964-11-21,1965-03-27,127,3,111,436,547,65,140,205,752,24,202,Nebraska,Lincoln,258379
12146,1965-1966,1965-11-29,1966-03-27,119,0,84,310,394,22,9,31,425,18,93,Nebraska,Lincoln,258379
12147,1966-1967,1966-11-09,1967-05-03,176,0,62,338,400,36,79,115,515,19,128,Nebraska,Lincoln,258379
12148,1967-1968,1967-11-04,1968-03-22,140,0,70,308,378,14,30,44,422,12,84,Nebraska,Lincoln,258379
12149,1968-1969,1968-11-08,1969-03-30,143,0,109,384,493,61,249,310,803,27,145,Nebraska,Lincoln,258379
12150,1969-1970,1969-11-14,1970-04-01,139,0,92,349,441,42,178,220,661,23,125,Nebraska,Lincoln,258379
12151,1970-1971,1970-10-09,1971-04-01,175,0,89,356,445,70,207,277,722,22,153,Nebraska,Lincoln,258379
12152,1971-1972,1971-11-22,1972-04-03,134,0,69,310,379,33,52,85,464,18,92,Nebraska,Lincoln,258379
12153,1972-1973,1972-11-13,1973-04-16,155,0,98,363,461,48,120,168,629,24,129,Nebraska,Lincoln,258379
12154,1973-1974,1973-12-01,1974-04-03,124,0,114,396,510,52,243,295,805,24,257,Nebraska,Lincoln,258379
12155,1974-1975,1974-11-13,1975-04-03,142,0,94,450,544,61,295,356,900,22,140,Nebraska,Lincoln,258379
12156,1975-1976,1975-11-20,1976-03-30,132,0,62,342,404,34,37,71,475,19,97,Nebraska,Lincoln,258379
12157,1976-1977,1976-10-18,1977-04-04,169,1,90,553,643,33,44,77,720,13,91,Nebraska,Lincoln,258379
12158,1977-1978,1977-11-09,1978-03-16,128,0,181,574,755,50,234,284,1039,30,261,Nebraska,Lincoln,258379
12159,1978-1979,1978-11-16,1979-04-02,138,0,205,566,771,53,254,307,1078,29,241,Nebraska,Lincoln,258379
12160,1979-1980,1979-10-22,1980-04-11,173,1,76,394,470,37,121,158,628,22,121,Nebraska,Lincoln,258379
12161,1980-1981,1980-10-27,1981-03-05,130,0,44,335,379,16,22,38,417,6,42,Nebraska,Lincoln,258379
12162,1981-1982,1981-11-19,1982-04-28,161,0,145,488,633,51,214,265,898,27,193,Nebraska,Lincoln,258379
12163,1982-1983,1982-11-23,1983-04-14,143,0,44,277,321,54,142,196,517,21,118,Nebraska,Lincoln,258379
12164,1983-1984,1983-11-09,1984-04-29,173,0,158,456,614,73,356,429,1043,33,266,Nebraska,Lincoln,258379
12165,1984-1985,1984-11-09,1985-04-02,145,0,84,417,501,34,87,121,622,15,90,Nebraska,Lincoln,258379
12166,1985-1986,1985-09-29,1986-04-15,199,0,97,414,511,30,97,127,638,18,129,Nebraska,Lincoln,258379
12167,1986-1987,1986-11-01,1987-04-02,153,0,22,301,323,25,30,55,378,14,58,Nebraska,Lincoln,258379
12168,1987-1988,1987-10-10,1988-03-17,160,0,68,382,450,29,36,65,515,21,126,Nebraska,Lincoln,258379
12169,1988-1989,1988-11-15,1989-03-17,123,0,62,361,423,31,77,108,531,15,121,Nebraska,Lincoln,258379
12170,1989-1990,1989-11-16,1990-04-12,148,0,69,387,456,32,58,90,546,20,139,Nebraska,Lincoln,258379
12171,1990-1991,1990-11-27,1991-03-27,121,0,79,369,448,42,134,176,624,20,171,Nebraska,Lincoln,258379
12172,1991-1992,1991-10-31,1992-04-23,176,0,26,247,273,33,69,102,375,13,58,Nebraska,Lincoln,258379
12173,1992-1993,1992-11-05,1993-03-19,135,3,105,432,537,42,200,242,779,22,154,Nebraska,Lincoln,258379
12174,1993-1994,1993-10-30,1994-04-30,183,0,93,467,560,32,77,109,669,17,124,Nebraska,Lincoln,258379
12175,1994-1995,1994-11-28,1995-04-12,136,6,62,347,409,34,95,129,538,14,116,Nebraska,Lincoln,258379
12176,1995-1996,1995-11-10,1996-04-14,157,0,107,486,593,49,114,163,756,24,190,Nebraska,Lincoln,258379
12177,1997-1998,1997-10-26,1998-03-23,149,1,56,319,375,73,127,200,575,26,157,Nebraska,Lincoln,258379
12178,1998-1999,1998-12-01,1999-03-23,113,0,60,278,338,36,97,133,471,18,126,Nebraska,Lincoln,258379
12179,1999-2000,1999-12-01,2000-02-29,91,0,24,243,267,20,26,46,313,8,51,Nebraska,Lincoln,258379
12180,2000-2001,2000-11-06,2001-03-11,126,0,110,460,570,62,259,321,891,27,201,Nebraska,Lincoln,258379
12181,2001-2002,2001-11-27,2002-03-27,121,0,43,331,374,42,82,124,498,14,99,Nebraska,Lincoln,258379
12182,2002-2003,2002-10-23,2003-04-08,168,0,63,427,490,46,70,116,606,20,136,Nebraska,Lincoln,258379
12183,2003-2004,2003-11-23,2004-02-29,99,0,85,325,410,53,212,265,675,14,125,Nebraska,Lincoln,258379
12184,2004-2005,2004-11-28,2005-02-28,93,0,60,276,336,23,90,113,449,9,76,Nebraska,Lincoln,258379
12185,2005-2006,2005-11-15,2006-03-26,132,0,47,321,368,28,53,81,449,12,89,Nebraska,Lincoln,258379
12186,2006-2007,2006-11-29,2007-03-07,99,0,70,307,377,46,140,186,563,16,126,Nebraska,Lincoln,258379
12187,2007-2008,2007-11-21,2008-03-07,108,0,74,386,460,37,121,158,618,21,136,Nebraska,Lincoln,258379
12188,2008-2009,2008-12-01,2009-03-11,101,0,68,375,443,34,69,103,546,17,151,Nebraska,Lincoln,258379
12189,2009-2010,2009-10-10,2010-03-20,162,0,118,421,539,63,380,443,982,27,203,Nebraska,Lincoln,258379
12190,2010-2011,2010-11-22,2011-03-26,125,0,92,413,505,44,115,159,664,21,159,Nebraska,Lincoln,258379
12191,2011-2012,2011-12-01,2012-02-29,91,0,25,261,286,27,75,102,388,9,60,Nebraska,Lincoln,258379
12192,2012-2013,2012-12-01,2013-05-02,153,0,57,365,422,47,94,141,563,23,110,Nebraska,Lincoln,258379
12193,2013-2014,2013-11-21,2014-04-13,144,0,111,508,619,36,58,94,713,23,169,Nebraska,Lincoln,258379
12194,2014-2015,2014-11-10,2015-03-04,115,0,69,374,443,35,56,91,534,16,119,Nebraska,Lincoln,258379
12195,2015-2016,2015-11-27,2016-02-29,95,0,34,208,242,31,58,89,331,12,61,Nebraska,Lincoln,258379
12196,2016-2017,2016-12-01,2017-03-14,104,0,41,256,297,13,10,23,320,9,48,Nebraska,Lincoln,258379
12197,2017-2018,2017-12-01,2018-04-16,137,0,88,383,471,36,94,130,601,24,147,Nebraska,Lincoln,258379
12198,2018-2019,2018-10-14,2019-03-12,150,0,100,427,527,78,201,279,806,28,212,Nebraska,Lincoln,258379
12199,2019-2020,2019-10-28,2020-04-17,173,0,37,345,382,30,22,52,434,20,86,Nebraska,Lincoln,258379
12200,1950-1951,1950-11-09,1951-04-12,155,0,126,530,656,32,71,103,759,15,96,Nebraska,Norfolk,242803
12201,1951-1952,1951-11-01,1952-04-12,164,0,134,501,635,49,181,230,865,25,181,Nebraska,Norfolk,242803
12202,1952-1953,1952-11-25,1953-04-15,142,1,79,420,499,41,277,318,817,19,138,Nebraska,Norfolk,242803
12203,1953-1954,1953-11-06,1954-05-02,178,0,80,421,501,35,66,101,602,19,97,Nebraska,Norfolk,242803
12204,1954-1955,1954-11-01,1955-03-29,149,0,78,448,526,33,131,164,690,19,129,Nebraska,Norfolk,242803
12205,1955-1956,1955-10-23,1956-04-12,173,0,163,626,789,44,264,308,1097,28,237,Nebraska,Norfolk,242803
12206,1956-1957,1956-11-15,1957-04-08,145,0,104,462,566,29,66,95,661,16,109,Nebraska,Norfolk,242803
12207,1957-1958,1957-11-15,1958-04-23,160,0,100,422,522,38,144,182,704,20,113,Nebraska,Norfolk,242803
12208,1958-1959,1958-11-17,1959-04-20,155,0,116,526,642,46,79,125,767,22,151,Nebraska,Norfolk,242803
12209,1959-1960,1959-11-04,1960-04-03,152,0,189,588,777,89,577,666,1443,29,271,Nebraska,Norfolk,242803
12210,1960-1961,1960-11-09,1961-04-09,152,0,72,436,508,41,106,147,655,21,129,Nebraska,Norfolk,242803
12211,1961-1962,1961-09-30,1962-04-12,195,0,191,617,808,70,413,483,1291,36,289,Nebraska,Norfolk,242803
12212,1962-1963,1962-11-18,1963-03-18,121,0,134,447,581,40,132,172,753,29,229,Nebraska,Norfolk,242803
12213,1963-1964,1963-11-13,1964-04-05,145,0,117,490,607,39,94,133,740,25,161,Nebraska,Norfolk,242803
12214,1964-1965,1964-11-21,1965-04-25,156,0,150,588,738,50,213,263,1001,23,204,Nebraska,Norfolk,242803
12215,1965-1966,1965-11-26,1966-04-19,145,0,127,469,596,34,118,152,748,16,144,Nebraska,Norfolk,242803
12216,1966-1967,1966-10-14,1967-03-17,155,1,87,491,578,25,112,137,715,13,95,Nebraska,Norfolk,242803
12217,1967-1968,1967-10-26,1968-03-22,149,0,104,453,557,18,58,76,633,14,86,Nebraska,Norfolk,242803
12218,1968-1969,1968-11-06,1969-03-31,146,0,178,539,717,74,586,660,1377,28,238,Nebraska,Norfolk,242803
12219,1969-1970,1969-10-12,1970-04-13,184,0,134,523,657,55,221,276,933,25,177,Nebraska,Norfolk,242803
12220,1970-1971,1970-10-08,1971-04-01,176,0,134,494,628,38,105,143,771,27,167,Nebraska,Norfolk,242803
12221,1971-1972,1971-11-06,1972-04-03,150,0,120,480,600,38,135,173,773,25,157,Nebraska,Norfolk,242803
12222,1972-1973,1972-11-13,1973-04-08,147,0,128,406,534,44,218,262,796,19,144,Nebraska,Norfolk,242803
12223,1973-1974,1973-11-04,1974-04-04,152,0,119,434,553,44,194,238,791,23,200,Nebraska,Norfolk,242803
12224,1974-1975,1974-11-13,1975-04-18,157,0,107,478,585,57,354,411,996,27,170,Nebraska,Norfolk,242803
12225,1975-1976,1975-11-19,1976-03-29,132,0,100,377,477,51,241,292,769,23,144,Nebraska,Norfolk,242803
12226,1976-1977,1976-10-18,1977-04-04,169,0,110,545,655,40,39,79,734,25,149,Nebraska,Norfolk,242803
12227,1977-1978,1977-11-08,1978-03-18,131,0,219,589,808,66,256,322,1130,35,287,Nebraska,Norfolk,242803
12228,1978-1979,1978-11-11,1979-04-02,143,0,245,654,899,85,581,666,1565,43,342,Nebraska,Norfolk,242803
12229,1979-1980,1979-10-22,1980-04-03,165,0,98,434,532,40,86,126,658,28,167,Nebraska,Norfolk,242803
12230,1980-1981,1980-10-26,1981-02-28,126,0,64,355,419,17,23,40,459,10,73,Nebraska,Norfolk,242803
12231,1981-1982,1981-10-24,1982-04-09,168,0,163,549,712,71,275,346,1058,27,247,Nebraska,Norfolk,242803
12232,1982-1983,1982-10-19,1983-04-15,179,0,57,346,403,73,197,270,673,32,156,Nebraska,Norfolk,242803
12233,1983-1984,1983-11-09,1984-04-30,174,0,170,499,669,121,536,657,1326,36,283,Nebraska,Norfolk,242803
12234,1984-1985,1984-10-18,1985-04-06,171,0,109,448,557,32,44,76,633,21,135,Nebraska,Norfolk,242803
12235,1985-1986,1985-09-28,1986-04-15,200,0,129,471,600,53,107,160,760,31,218,Nebraska,Norfolk,242803
12236,1986-1987,1986-10-11,1987-03-31,172,0,35,339,374,28,39,67,441,16,73,Nebraska,Norfolk,242803
12237,1987-1988,1987-11-27,1988-04-26,152,0,115,423,538,36,110,146,684,20,138,Nebraska,Norfolk,242803
12238,1988-1989,1988-11-15,1989-04-09,146,0,97,439,536,38,58,96,632,23,183,Nebraska,Norfolk,242803
12239,1989-1990,1989-11-16,1990-04-13,149,0,93,454,547,35,76,111,658,20,183,Nebraska,Norfolk,242803
12240,1990-1991,1990-10-17,1991-03-30,165,0,107,456,563,52,116,168,731,25,185,Nebraska,Norfolk,242803
12241,1991-1992,1991-10-28,1992-04-22,178,1,41,322,363,37,79,116,479,20,101,Nebraska,Norfolk,242803
12242,1992-1993,1992-11-01,1993-04-14,165,0,130,478,608,71,276,347,955,39,265,Nebraska,Norfolk,242803
12243,1993-1994,1993-10-30,1994-04-30,183,0,124,506,630,49,170,219,849,26,185,Nebraska,Norfolk,242803
12244,1994-1995,1994-11-27,1995-04-12,137,0,80,359,439,43,154,197,636,17,123,Nebraska,Norfolk,242803
12245,1995-1996,1995-10-23,1996-04-15,176,0,136,509,645,51,129,180,825,27,183,Nebraska,Norfolk,242803
12246,1996-1997,1996-11-10,1997-04-14,156,1,170,492,662,60,108,168,830,30,237,Nebraska,Norfolk,242803
12247,1997-1998,1997-10-25,1998-04-01,159,0,76,360,436,37,58,95,531,27,148,Nebraska,Norfolk,242803
12248,1998-1999,1998-11-10,1999-03-22,133,0,70,329,399,31,81,112,511,13,88,Nebraska,Norfolk,242803
12249,1999-2000,1999-11-23,2000-03-18,117,0,34,292,326,18,21,39,365,13,57,Nebraska,Norfolk,242803
12250,2000-2001,2000-11-06,2001-03-25,140,0,148,505,653,49,236,285,938,27,184,Nebraska,Norfolk,242803
12251,2001-2002,2001-11-27,2002-03-21,115,0,63,336,399,27,57,84,483,10,73,Nebraska,Norfolk,242803
12252,2002-2003,2002-10-22,2003-04-09,170,0,75,434,509,47,97,144,653,21,143,Nebraska,Norfolk,242803
12253,2003-2004,2003-11-05,2004-03-17,134,0,95,364,459,48,168,216,675,20,146,Nebraska,Norfolk,242803
12254,2004-2005,2004-11-28,2005-03-25,118,0,68,328,396,21,65,86,482,10,65,Nebraska,Norfolk,242803
12255,2005-2006,2005-11-15,2006-03-27,133,0,66,322,388,54,140,194,582,16,136,Nebraska,Norfolk,242803
12256,2006-2007,2006-11-29,2007-03-07,99,0,97,327,424,37,124,161,585,16,131,Nebraska,Norfolk,242803
12257,2007-2008,2007-11-22,2008-04-25,156,0,113,489,602,53,227,280,882,30,215,Nebraska,Norfolk,242803
12258,2008-2009,2008-11-08,2009-04-05,149,0,101,468,569,59,189,248,817,32,241,Nebraska,Norfolk,242803
12259,2009-2010,2009-10-10,2010-03-19,161,0,156,443,599,77,522,599,1198,31,262,Nebraska,Norfolk,242803
12260,2010-2011,2010-11-20,2011-04-19,151,0,133,471,604,60,195,255,859,24,195,Nebraska,Norfolk,242803
12261,2011-2012,2011-11-19,2012-02-29,103,0,38,301,339,27,42,69,408,13,77,Nebraska,Norfolk,242803
12262,2012-2013,2012-11-11,2013-04-24,165,0,78,438,516,44,90,134,650,22,118,Nebraska,Norfolk,242803
12263,2013-2014,2013-11-05,2014-04-14,161,0,141,563,704,32,44,76,780,21,138,Nebraska,Norfolk,242803
12264,2014-2015,2014-11-10,2015-04-09,151,0,97,450,547,33,88,121,668,18,130,Nebraska,Norfolk,242803
12265,2015-2016,2015-11-11,2016-03-28,139,0,57,291,348,76,193,269,617,24,145,Nebraska,Norfolk,242803
12266,2016-2017,2016-11-18,2017-05-01,165,0,75,344,419,46,77,123,542,20,138,Nebraska,Norfolk,242803
12267,2017-2018,2017-12-01,2018-04-18,139,0,132,453,585,62,164,226,811,22,190,Nebraska,Norfolk,242803
12268,2018-2019,2018-10-14,2019-04-02,171,0,147,512,659,50,173,223,882,25,206,Nebraska,Norfolk,242803
12269,2019-2020,2019-11-10,2020-04-16,159,0,54,377,431,48,76,124,555,22,127,Nebraska,Norfolk,242803
12270,1950-1951,1950-11-08,1951-03-18,131,0,68,444,512,21,18,39,551,16,137,Nebraska,North Platte,24733
12271,1951-1952,1951-10-21,1952-04-09,172,0,78,480,558,52,71,123,681,28,179,Nebraska,North Platte,24733
12272,1952-1953,1952-11-22,1953-04-17,147,0,49,415,464,33,69,102,566,16,105,Nebraska,North Platte,24733
12273,1953-1954,1953-11-06,1954-05-02,178,0,52,412,464,40,57,97,561,21,107,Nebraska,North Platte,24733
12274,1954-1955,1954-11-29,1955-03-27,119,0,69,465,534,55,123,178,712,26,201,Nebraska,North Platte,24733
12275,1955-1956,1955-11-02,1956-04-28,179,0,102,575,677,55,90,145,822,32,237,Nebraska,North Platte,24733
12276,1956-1957,1956-10-25,1957-04-12,170,0,73,498,571,51,41,92,663,28,186,Nebraska,North Platte,24733
12277,1957-1958,1957-10-24,1958-04-26,185,0,58,482,540,73,213,286,826,32,207,Nebraska,North Platte,24733
12278,1958-1959,1958-10-26,1959-04-19,176,0,70,526,596,60,78,138,734,29,191,Nebraska,North Platte,24733
12279,1959-1960,1959-10-01,1960-04-27,210,0,113,600,713,61,216,277,990,30,227,Nebraska,North Platte,24733
12280,1960-1961,1960-11-22,1961-04-14,144,0,36,426,462,61,70,131,593,20,130,Nebraska,North Platte,24733
12281,1961-1962,1961-11-02,1962-03-29,148,0,113,553,666,50,112,162,828,28,228,Nebraska,North Platte,24733
12282,1962-1963,1962-11-15,1963-04-02,139,0,96,451,547,45,137,182,729,24,178,Nebraska,North Platte,24733
12283,1963-1964,1963-11-21,1964-04-05,137,0,66,503,569,41,68,109,678,22,143,Nebraska,North Platte,24733
12284,1964-1965,1964-11-26,1965-03-27,122,0,73,541,614,35,119,154,768,16,137,Nebraska,North Platte,24733
12285,1965-1966,1965-11-26,1966-05-12,168,0,103,495,598,54,149,203,801,25,231,Nebraska,North Platte,24733
12286,1966-1967,1966-10-14,1967-05-05,204,0,61,519,580,46,88,134,714,23,152,Nebraska,North Platte,24733
12287,1967-1968,1967-11-02,1968-04-07,158,0,66,574,640,21,28,49,689,13,94,Nebraska,North Platte,24733
12288,1968-1969,1968-11-05,1969-03-29,145,0,132,544,676,50,211,261,937,26,189,Nebraska,North Platte,24733
12289,1969-1970,1969-10-11,1970-04-12,184,0,57,516,573,69,55,124,697,26,169,Nebraska,North Platte,24733
12290,1970-1971,1970-10-08,1971-04-27,202,0,87,569,656,67,80,147,803,28,178,Nebraska,North Platte,24733
12291,1971-1972,1971-10-29,1972-04-03,158,0,57,504,561,23,19,42,603,17,108,Nebraska,North Platte,24733
12292,1972-1973,1972-10-28,1973-04-09,164,0,124,493,617,44,94,138,755,27,179,Nebraska,North Platte,24733
12293,1973-1974,1973-11-03,1974-04-03,152,0,102,481,583,49,168,217,800,30,224,Nebraska,North Platte,24733
12294,1974-1975,1974-11-28,1975-04-18,142,0,65,496,561,33,49,82,643,22,124,Nebraska,North Platte,24733
12295,1975-1976,1975-10-23,1976-03-15,145,0,103,534,637,53,195,248,885,23,203,Nebraska,North Platte,24733
12296,1976-1977,1976-10-27,1977-04-04,160,0,63,592,655,39,31,70,725,17,99,Nebraska,North Platte,24733
12297,1977-1978,1977-11-08,1978-03-16,129,0,156,608,764,61,167,228,992,38,317,Nebraska,North Platte,24733
12298,1978-1979,1978-11-11,1979-04-12,153,0,210,682,892,57,238,295,1187,32,257,Nebraska,North Platte,24733
12299,1979-1980,1979-10-21,1980-04-05,168,0,66,420,486,96,164,260,746,31,215,Nebraska,North Platte,24733
12300,1980-1981,1980-10-27,1981-04-03,159,0,44,452,496,10,4,14,510,9,55,Nebraska,North Platte,24733
12301,1981-1982,1981-11-18,1982-04-07,141,0,87,492,579,45,69,114,693,27,201,Nebraska,North Platte,24733
12302,1982-1983,1982-10-19,1983-04-14,178,0,44,397,441,44,80,124,565,25,104,Nebraska,North Platte,24733
12303,1983-1984,1983-11-08,1984-05-07,182,0,154,562,716,87,238,325,1041,39,277,Nebraska,North Platte,24733
12304,1984-1985,1984-10-18,1985-03-30,164,0,100,522,622,34,121,155,777,18,136,Nebraska,North Platte,24733
12305,1985-1986,1985-09-28,1986-03-16,170,0,109,468,577,57,177,234,811,21,152,Nebraska,North Platte,24733
12306,1986-1987,1986-10-11,1987-04-12,184,0,21,410,431,40,27,67,498,22,104,Nebraska,North Platte,24733
12307,1987-1988,1987-10-10,1988-04-22,196,0,85,534,619,62,187,249,868,27,175,Nebraska,North Platte,24733
12308,1988-1989,1988-11-15,1989-04-09,146,0,72,503,575,37,46,83,658,21,159,Nebraska,North Platte,24733
12309,1989-1990,1989-12-01,1990-04-05,126,0,62,395,457,28,44,72,529,17,137,Nebraska,North Platte,24733
12310,1990-1991,1990-10-08,1991-03-29,173,0,73,487,560,38,49,87,647,19,127,Nebraska,North Platte,24733
12311,1991-1992,1991-10-28,1992-04-02,158,0,23,339,362,32,47,79,441,14,72,Nebraska,North Platte,24733
12312,1992-1993,1992-11-03,1993-04-20,169,0,111,559,670,60,231,291,961,31,235,Nebraska,North Platte,24733
12313,1993-1994,1993-11-14,1994-04-30,168,0,69,452,521,52,79,131,652,23,153,Nebraska,North Platte,24733
12314,1994-1995,1994-11-03,1995-04-18,167,0,52,434,486,50,95,145,631,25,145,Nebraska,North Platte,24733
12315,1995-1996,1995-09-20,1996-04-14,208,2,71,577,648,30,27,57,705,19,119,Nebraska,North Platte,24733
12316,1996-1997,1996-11-11,1997-04-12,153,1,86,508,594,34,66,100,694,19,135,Nebraska,North Platte,24733
12317,1997-1998,1997-10-24,1998-04-01,160,2,49,445,494,43,51,94,588,22,125,Nebraska,North Platte,24733
12318,1998-1999,1998-11-02,1999-04-15,165,0,42,427,469,33,31,64,533,18,107,Nebraska,North Platte,24733
12319,1999-2000,1999-11-22,2000-04-15,146,0,18,397,415,28,17,45,460,19,104,Nebraska,North Platte,24733
12320,2000-2001,2000-09-23,2001-04-23,213,0,74,556,630,52,116,168,798,22,133,Nebraska,North Platte,24733
12321,2001-2002,2001-11-25,2002-04-02,129,0,45,511,556,28,29,57,613,12,84,Nebraska,North Platte,24733
12322,2002-2003,2002-10-22,2003-04-07,168,0,46,493,539,44,52,96,635,18,109,Nebraska,North Platte,24733
12323,2003-2004,2003-11-22,2004-04-12,143,0,50,447,497,24,42,66,563,16,112,Nebraska,North Platte,24733
12324,2004-2005,2004-11-28,2005-04-28,152,0,48,392,440,37,65,102,542,14,90,Nebraska,North Platte,24733
12325,2005-2006,2005-11-27,2006-04-25,150,0,49,399,448,30,60,90,538,14,94,Nebraska,North Platte,24733
12326,2006-2007,2006-10-17,2007-04-07,173,0,83,535,618,62,238,300,918,21,181,Nebraska,North Platte,24733
12327,2007-2008,2007-11-21,2008-05-02,164,0,49,533,582,50,80,130,712,24,167,Nebraska,North Platte,24733
12328,2008-2009,2008-10-23,2009-04-10,170,0,60,535,595,54,68,122,717,26,165,Nebraska,North Platte,24733
12329,2009-2010,2009-10-09,2010-04-07,181,0,87,493,580,86,146,232,812,32,210,Nebraska,North Platte,24733
12330,2010-2011,2010-11-20,2011-04-15,147,0,78,492,570,59,125,184,754,25,194,Nebraska,North Platte,24733
12331,2011-2012,2011-11-02,2012-02-29,120,0,22,415,437,25,40,65,502,12,71,Nebraska,North Platte,24733
12332,2012-2013,2012-10-06,2013-05-01,208,0,43,582,625,48,60,108,733,24,137,Nebraska,North Platte,24733
12333,2013-2014,2013-11-05,2014-04-13,160,0,98,569,667,41,71,112,779,23,177,Nebraska,North Platte,24733
12334,2014-2015,2014-11-11,2015-04-09,150,0,67,490,557,35,62,97,654,17,135,Nebraska,North Platte,24733
12335,2015-2016,2015-11-11,2016-04-30,172,0,25,368,393,51,76,127,520,22,108,Nebraska,North Platte,24733
12336,2016-2017,2016-11-17,2017-04-30,165,0,47,407,454,34,47,81,535,16,112,Nebraska,North Platte,24733
12337,2017-2018,2017-10-31,2018-04-15,167,0,82,545,627,70,198,268,895,27,217,Nebraska,North Platte,24733
12338,2018-2019,2018-10-14,2019-04-30,199,0,82,546,628,62,153,215,843,26,183,Nebraska,North Platte,24733
12339,2019-2020,2019-10-28,2020-04-17,173,0,20,440,460,53,56,109,569,27,141,Nebraska,North Platte,24733
12340,1950-1951,1950-11-03,1951-04-12,161,0,108,453,561,34,62,96,657,20,116,Nebraska,Omaha,408958
12341,1951-1952,1951-11-02,1952-04-09,160,0,106,407,513,57,194,251,764,24,166,Nebraska,Omaha,408958
12342,1952-1953,1952-11-24,1953-04-15,143,0,61,296,357,52,163,215,572,27,142,Nebraska,Omaha,408958
12343,1953-1954,1953-12-01,1954-03-30,120,0,54,306,360,14,11,25,385,11,73,Nebraska,Omaha,408958
12344,1954-1955,1954-12-01,1955-03-28,118,0,60,342,402,37,131,168,570,21,147,Nebraska,Omaha,408958
12345,1955-1956,1955-11-02,1956-04-06,157,0,101,444,545,27,80,107,652,18,119,Nebraska,Omaha,408958
12346,1956-1957,1956-11-15,1957-04-05,142,0,79,334,413,44,80,124,537,15,115,Nebraska,Omaha,408958
12347,1957-1958,1957-10-26,1958-03-10,136,0,73,314,387,52,108,160,547,21,111,Nebraska,Omaha,408958
12348,1958-1959,1958-11-18,1959-04-20,154,0,99,410,509,44,69,113,622,23,164,Nebraska,Omaha,408958
12349,1959-1960,1959-11-05,1960-03-28,145,0,133,452,585,86,458,544,1129,37,276,Nebraska,Omaha,408958
12350,1960-1961,1960-11-09,1961-04-11,154,0,57,316,373,35,46,81,454,24,101,Nebraska,Omaha,408958
12351,1961-1962,1961-11-05,1962-04-12,159,0,152,463,615,86,332,418,1033,43,328,Nebraska,Omaha,408958
12352,1962-1963,1962-11-18,1963-03-13,116,0,119,370,489,57,162,219,708,25,213,Nebraska,Omaha,408958
12353,1963-1964,1963-12-01,1964-03-29,120,0,88,386,474,45,80,125,599,26,165,Nebraska,Omaha,408958
12354,1964-1965,1964-11-21,1965-03-27,127,0,110,461,571,84,198,282,853,33,260,Nebraska,Omaha,408958
12355,1965-1966,1965-11-26,1966-03-24,119,0,71,324,395,23,21,44,439,15,80,Nebraska,Omaha,408958
12356,1966-1967,1966-11-09,1967-05-03,176,0,49,356,405,28,87,115,520,19,104,Nebraska,Omaha,408958
12357,1967-1968,1967-10-26,1968-03-22,149,0,68,376,444,20,73,93,537,10,87,Nebraska,Omaha,408958
12358,1968-1969,1968-11-09,1969-03-30,142,0,110,412,522,62,209,271,793,37,210,Nebraska,Omaha,408958
12359,1969-1970,1969-11-14,1970-03-27,134,0,96,405,501,47,224,271,772,25,166,Nebraska,Omaha,408958
12360,1970-1971,1970-10-09,1971-04-01,175,0,96,405,501,61,229,290,791,21,131,Nebraska,Omaha,408958
12361,1971-1972,1971-11-22,1972-04-03,134,0,79,382,461,44,59,103,564,27,159,Nebraska,Omaha,408958
12362,1972-1973,1972-11-13,1973-04-10,149,0,106,348,454,55,151,206,660,25,152,Nebraska,Omaha,408958
12363,1973-1974,1973-11-08,1974-04-04,148,0,103,376,479,52,176,228,707,25,211,Nebraska,Omaha,408958
12364,1974-1975,1974-11-14,1975-04-04,142,0,71,408,479,85,311,396,875,31,177,Nebraska,Omaha,408958
12365,1975-1976,1975-11-23,1976-03-12,111,0,48,289,337,30,46,76,413,15,82,Nebraska,Omaha,408958
12366,1976-1977,1976-10-18,1977-04-04,169,1,95,493,588,39,61,100,688,23,133,Nebraska,Omaha,408958
12367,1977-1978,1977-11-09,1978-03-18,130,0,197,547,744,66,255,321,1065,32,258,Nebraska,Omaha,408958
12368,1978-1979,1978-11-16,1979-04-03,139,0,223,561,784,68,313,381,1165,36,280,Nebraska,Omaha,408958
12369,1979-1980,1979-10-22,1980-04-11,173,0,92,371,463,46,88,134,597,24,157,Nebraska,Omaha,408958
12370,1980-1981,1980-10-27,1981-03-04,129,0,66,307,373,23,32,55,428,9,62,Nebraska,Omaha,408958
12371,1981-1982,1981-10-24,1982-04-09,168,0,163,468,631,55,252,307,938,30,229,Nebraska,Omaha,408958
12372,1982-1983,1982-10-19,1983-04-15,179,0,60,295,355,74,156,230,585,29,159,Nebraska,Omaha,408958
12373,1983-1984,1983-11-09,1984-04-29,173,0,176,434,610,87,391,478,1088,41,282,Nebraska,Omaha,408958
12374,1984-1985,1984-11-09,1985-04-02,145,0,96,376,472,42,80,122,594,21,142,Nebraska,Omaha,408958
12375,1985-1986,1985-09-29,1986-04-28,212,0,124,422,546,35,133,168,714,25,152,Nebraska,Omaha,408958
12376,1986-1987,1986-11-10,1987-04-05,147,0,31,247,278,35,61,96,374,13,76,Nebraska,Omaha,408958
12377,1987-1988,1987-10-10,1988-03-17,160,0,91,360,451,32,59,91,542,23,140,Nebraska,Omaha,408958
12378,1988-1989,1988-11-15,1989-03-17,123,0,80,330,410,30,72,102,512,17,136,Nebraska,Omaha,408958
12379,1989-1990,1989-11-16,1990-03-23,128,0,84,324,408,36,69,105,513,19,146,Nebraska,Omaha,408958
12380,1990-1991,1990-11-06,1991-03-27,142,0,110,357,467,50,195,245,712,24,210,Nebraska,Omaha,408958
12381,1991-1992,1991-10-31,1992-04-24,177,0,39,248,287,39,68,107,394,16,75,Nebraska,Omaha,408958
12382,1992-1993,1992-11-02,1993-04-20,170,0,112,382,494,67,276,343,837,36,216,Nebraska,Omaha,408958
12383,1993-1994,1993-10-30,1994-04-30,183,0,107,431,538,41,68,109,647,26,178,Nebraska,Omaha,408958
12384,1994-1995,1994-11-27,1995-04-12,137,0,64,329,393,45,138,183,576,21,122,Nebraska,Omaha,408958
12385,1998-1999,1998-12-01,1999-04-16,137,0,70,275,345,41,139,180,525,17,117,Nebraska,Omaha,408958
12386,1999-2000,1999-12-01,2000-02-29,91,0,32,230,262,21,28,49,311,12,70,Nebraska,Omaha,408958
12387,2000-2001,2000-11-06,2001-03-11,126,0,117,429,546,58,198,256,802,30,193,Nebraska,Omaha,408958
12388,2001-2002,2001-11-28,2002-03-26,119,0,49,291,340,32,49,81,421,14,76,Nebraska,Omaha,408958
12389,2002-2003,2002-10-23,2003-04-08,168,0,77,397,474,48,86,134,608,23,144,Nebraska,Omaha,408958
12390,2003-2004,2003-11-23,2004-03-17,116,3,94,317,411,68,244,312,723,15,123,Nebraska,Omaha,408958
12391,2004-2005,2004-11-28,2005-02-28,93,1,64,262,326,29,114,143,469,8,77,Nebraska,Omaha,408958
12392,2005-2006,2005-11-15,2006-03-24,130,0,55,273,328,32,59,91,419,16,101,Nebraska,Omaha,408958
12393,2006-2007,2006-11-29,2007-03-07,99,0,92,316,408,45,121,166,574,21,169,Nebraska,Omaha,408958
12394,2007-2008,2007-11-21,2008-03-07,108,0,95,410,505,41,198,239,744,26,189,Nebraska,Omaha,408958
12395,2008-2009,2008-11-21,2009-04-05,136,0,90,406,496,33,79,112,608,19,166,Nebraska,Omaha,408958
12396,2009-2010,2009-10-10,2010-03-20,162,0,130,403,533,72,475,547,1080,30,238,Nebraska,Omaha,408958
12397,2010-2011,2010-11-12,2011-03-28,137,0,102,388,490,54,184,238,728,28,186,Nebraska,Omaha,408958
12398,2011-2012,2011-11-02,2012-02-29,120,0,34,241,275,35,73,108,383,14,77,Nebraska,Omaha,408958
12399,2012-2013,2012-12-01,2013-05-02,153,0,60,314,374,55,138,193,567,24,118,Nebraska,Omaha,408958
12400,2013-2014,2013-11-21,2014-04-13,144,0,124,483,607,38,48,86,693,29,167,Nebraska,Omaha,408958
12401,2014-2015,2014-11-10,2015-03-05,116,0,84,361,445,23,42,65,510,15,96,Nebraska,Omaha,408958
12402,2015-2016,2015-11-27,2016-03-01,96,0,45,206,251,42,74,116,367,16,87,Nebraska,Omaha,408958
12403,2016-2017,2016-12-01,2017-03-13,103,0,44,226,270,20,15,35,305,13,69,Nebraska,Omaha,408958
12404,2017-2018,2017-12-01,2018-04-16,137,0,105,359,464,34,96,130,594,25,189,Nebraska,Omaha,408958
12405,2018-2019,2018-10-14,2019-03-12,150,0,112,400,512,77,261,338,850,30,215,Nebraska,Omaha,408958
12406,2019-2020,2019-10-28,2020-04-17,173,0,46,294,340,43,61,104,444,28,118,Nebraska,Omaha,408958
12407,1950-1951,1950-11-08,1951-06-02,207,0,54,516,570,41,40,81,651,26,199,Nebraska,Scottsbluff,15039
12408,1951-1952,1951-10-21,1952-04-08,171,8,55,499,554,60,49,109,663,31,190,Nebraska,Scottsbluff,15039
12409,1952-1953,1952-10-14,1953-04-17,186,0,42,431,473,64,112,176,649,23,154,Nebraska,Scottsbluff,15039
12410,1953-1954,1953-11-06,1954-05-02,178,1,32,428,460,51,67,118,578,22,120,Nebraska,Scottsbluff,15039
12411,1954-1955,1954-10-25,1955-04-14,172,0,63,520,583,67,167,234,817,31,222,Nebraska,Scottsbluff,15039
12412,1955-1956,1955-09-25,1956-04-29,218,0,76,566,642,65,114,179,821,34,217,Nebraska,Scottsbluff,15039
12413,1956-1957,1956-11-01,1957-04-13,164,0,52,481,533,72,99,171,704,26,192,Nebraska,Scottsbluff,15039
12414,1957-1958,1957-10-24,1958-04-26,185,0,33,435,468,62,105,167,635,33,179,Nebraska,Scottsbluff,15039
12415,1958-1959,1958-11-16,1959-05-07,173,0,74,477,551,82,146,228,779,37,246,Nebraska,Scottsbluff,15039
12416,1959-1960,1959-10-01,1960-04-28,211,0,80,523,603,47,65,112,715,28,199,Nebraska,Scottsbluff,15039
12417,1960-1961,1960-10-29,1961-05-13,197,0,37,474,511,61,85,146,657,29,146,Nebraska,Scottsbluff,15039
12418,1961-1962,1961-10-29,1962-03-30,153,0,102,542,644,47,80,127,771,33,238,Nebraska,Scottsbluff,15039
12419,1962-1963,1962-11-15,1963-04-22,159,0,74,438,512,48,113,161,673,27,191,Nebraska,Scottsbluff,15039
12420,1963-1964,1963-11-21,1964-04-05,137,0,57,470,527,41,47,88,615,27,173,Nebraska,Scottsbluff,15039
12421,1964-1965,1964-11-15,1965-05-09,176,0,65,497,562,43,87,130,692,29,165,Nebraska,Scottsbluff,15039
12422,1965-1966,1965-09-16,1966-05-11,238,0,82,505,587,38,105,143,730,24,157,Nebraska,Scottsbluff,15039
12423,1966-1967,1966-11-08,1967-05-05,179,0,32,404,436,39,38,77,513,25,136,Nebraska,Scottsbluff,15039
12424,1967-1968,1967-11-01,1968-04-18,170,0,54,510,564,52,98,150,714,29,179,Nebraska,Scottsbluff,15039
12425,1968-1969,1968-11-14,1969-04-08,146,0,54,460,514,47,71,118,632,30,171,Nebraska,Scottsbluff,15039
12426,1969-1970,1969-10-04,1970-04-23,202,0,39,462,501,98,83,181,682,40,212,Nebraska,Scottsbluff,15039
12427,1970-1971,1970-10-06,1971-04-27,204,0,62,479,541,63,83,146,687,33,179,Nebraska,Scottsbluff,15039
12428,1971-1972,1971-10-28,1972-04-27,183,0,43,466,509,34,20,54,563,20,109,Nebraska,Scottsbluff,15039
12429,1972-1973,1972-10-27,1973-04-26,182,0,110,513,623,82,159,241,864,43,264,Nebraska,Scottsbluff,15039
12430,1973-1974,1973-10-11,1974-04-13,185,0,84,468,552,87,213,300,852,31,241,Nebraska,Scottsbluff,15039
12431,1974-1975,1974-09-11,1975-04-19,221,0,49,534,583,70,79,149,732,33,203,Nebraska,Scottsbluff,15039
12432,1975-1976,1975-10-23,1976-04-28,189,0,64,416,480,75,149,224,704,29,197,Nebraska,Scottsbluff,15039
12433,1976-1977,1976-10-26,1977-04-04,161,0,37,449,486,46,68,114,600,26,147,Nebraska,Scottsbluff,15039
12434,1977-1978,1977-10-10,1978-05-07,210,0,105,482,587,83,208,291,878,39,276,Nebraska,Scottsbluff,15039
12435,1978-1979,1978-10-22,1979-05-10,201,0,139,586,725,92,227,319,1044,48,324,Nebraska,Scottsbluff,15039
12436,1979-1980,1979-10-29,1980-05-12,197,0,65,438,503,113,226,339,842,47,291,Nebraska,Scottsbluff,15039
12437,1980-1981,1980-10-16,1981-04-03,170,0,25,337,362,39,37,76,438,21,101,Nebraska,Scottsbluff,15039
12438,1981-1982,1981-10-20,1982-04-05,168,0,66,474,540,35,28,63,603,29,202,Nebraska,Scottsbluff,15039
12439,1982-1983,1982-10-09,1983-05-12,216,0,21,425,446,64,50,114,560,29,127,Nebraska,Scottsbluff,15039
12440,1983-1984,1983-11-08,1984-05-07,182,0,118,475,593,93,175,268,861,40,271,Nebraska,Scottsbluff,15039
12441,1984-1985,1984-09-24,1985-04-26,215,0,67,600,667,46,69,115,782,27,138,Nebraska,Scottsbluff,15039
12442,1985-1986,1985-09-23,1986-05-09,229,0,107,518,625,113,304,417,1042,45,318,Nebraska,Scottsbluff,15039
12443,1986-1987,1986-10-10,1987-04-20,193,0,37,445,482,78,83,161,643,36,201,Nebraska,Scottsbluff,15039
12444,1987-1988,1987-10-09,1988-04-24,199,0,86,567,653,89,198,287,940,33,266,Nebraska,Scottsbluff,15039
12445,1988-1989,1988-11-15,1989-04-09,146,0,87,523,610,45,92,137,747,19,192,Nebraska,Scottsbluff,15039
12446,1989-1990,1989-10-15,1990-05-09,207,0,68,484,552,82,149,231,783,29,214,Nebraska,Scottsbluff,15039
12447,1990-1991,1990-10-06,1991-04-13,190,0,75,523,598,61,61,122,720,36,245,Nebraska,Scottsbluff,15039
12448,1991-1992,1991-10-28,1992-03-18,143,0,19,374,393,40,69,109,502,18,104,Nebraska,Scottsbluff,15039
12449,1992-1993,1992-10-06,1993-04-13,190,0,111,596,707,96,309,405,1112,42,322,Nebraska,Scottsbluff,15039
12450,1993-1994,1993-09-13,1994-04-29,229,0,59,484,543,70,86,156,699,34,226,Nebraska,Scottsbluff,15039
12451,1994-1995,1994-11-03,1995-04-26,175,0,53,431,484,67,131,198,682,26,178,Nebraska,Scottsbluff,15039
12452,1995-1996,1995-09-20,1996-04-27,221,0,89,580,669,51,94,145,814,26,181,Nebraska,Scottsbluff,15039
12453,1997-1998,1997-10-24,1998-04-14,173,2,36,431,467,39,36,75,542,21,117,Nebraska,Scottsbluff,15039
12454,1998-1999,1998-11-02,1999-04-10,160,0,39,382,421,49,42,91,512,22,115,Nebraska,Scottsbluff,15039
12455,1999-2000,1999-11-22,2000-04-16,147,0,12,324,336,41,51,92,428,17,89,Nebraska,Scottsbluff,15039
12456,2000-2001,2000-09-23,2001-04-23,213,0,60,533,593,53,59,112,705,20,132,Nebraska,Scottsbluff,15039
12457,2001-2002,2001-11-25,2002-04-20,147,0,37,447,484,18,35,53,537,13,89,Nebraska,Scottsbluff,15039
12458,2002-2003,2002-10-23,2003-04-07,167,0,40,440,480,63,97,160,640,21,150,Nebraska,Scottsbluff,15039
12459,2003-2004,2003-10-30,2004-04-11,165,0,38,419,457,55,162,217,674,19,133,Nebraska,Scottsbluff,15039
12460,2004-2005,2004-11-01,2005-05-11,192,0,33,424,457,61,97,158,615,24,153,Nebraska,Scottsbluff,15039
12461,2005-2006,2005-11-14,2006-04-25,163,0,59,414,473,57,88,145,618,18,144,Nebraska,Scottsbluff,15039
12462,2006-2007,2006-10-17,2007-04-07,173,0,53,486,539,47,89,136,675,19,124,Nebraska,Scottsbluff,15039
12463,2007-2008,2007-11-20,2008-05-02,165,0,66,522,588,66,227,293,881,33,203,Nebraska,Scottsbluff,15039
12464,2008-2009,2008-11-05,2009-04-25,172,0,49,462,511,60,73,133,644,25,163,Nebraska,Scottsbluff,15039
12465,2009-2010,2009-10-08,2010-05-12,217,0,64,485,549,112,151,263,812,38,244,Nebraska,Scottsbluff,15039
12466,2010-2011,2010-11-09,2011-04-14,157,0,59,430,489,70,111,181,670,30,204,Nebraska,Scottsbluff,15039
12467,2011-2012,2011-11-01,2012-02-29,121,0,16,407,423,39,21,60,483,26,135,Nebraska,Scottsbluff,15039
12468,2012-2013,2012-10-05,2013-05-01,209,0,38,505,543,66,69,135,678,33,171,Nebraska,Scottsbluff,15039
12469,2013-2014,2013-10-04,2014-05-12,221,0,92,527,619,97,167,264,883,36,317,Nebraska,Scottsbluff,15039
12470,2014-2015,2014-11-03,2015-05-11,190,0,66,464,530,76,223,299,829,29,206,Nebraska,Scottsbluff,15039
12471,2015-2016,2015-11-11,2016-04-30,172,0,40,383,423,54,147,201,624,24,122,Nebraska,Scottsbluff,15039
12472,2016-2017,2016-11-17,2017-05-18,183,0,58,416,474,61,99,160,634,20,151,Nebraska,Scottsbluff,15039
12473,2017-2018,2017-10-31,2018-04-21,173,18,67,470,537,68,87,155,692,28,219,Nebraska,Scottsbluff,15039
12474,2018-2019,2018-10-08,2019-05-21,226,0,51,524,575,102,102,204,779,33,231,Nebraska,Scottsbluff,15039
12475,2019-2020,2019-10-09,2020-04-17,192,11,29,451,480,71,67,138,618,33,183,Nebraska,Scottsbluff,15039
12476,1950-1951,1950-11-09,1951-04-21,164,1,117,593,710,24,19,43,753,15,132,Nebraska,Valentine,2737
12477,1951-1952,1951-10-18,1952-03-27,162,0,139,561,700,66,488,554,1254,30,240,Nebraska,Valentine,2737
12478,1952-1953,1952-11-17,1953-04-16,151,1,69,426,495,72,308,380,875,25,190,Nebraska,Valentine,2737
12479,1953-1954,1953-11-06,1954-05-03,179,0,77,409,486,41,76,117,603,18,100,Nebraska,Valentine,2737
12480,1954-1955,1954-11-30,1955-03-26,117,1,81,416,497,46,184,230,727,20,165,Nebraska,Valentine,2737
12481,1955-1956,1955-11-12,1956-05-01,172,0,159,670,829,52,250,302,1131,31,288,Nebraska,Valentine,2737
12482,1956-1957,1956-11-02,1957-04-13,163,0,115,581,696,43,126,169,865,23,171,Nebraska,Valentine,2737
12483,1957-1958,1957-11-03,1958-04-25,174,1,73,495,568,31,141,172,740,26,168,Nebraska,Valentine,2737
12484,1958-1959,1958-11-17,1959-04-21,156,0,109,600,709,42,117,159,868,24,181,Nebraska,Valentine,2737
12485,1959-1960,1959-10-29,1960-04-28,183,1,134,643,777,56,222,278,1055,26,202,Nebraska,Valentine,2737
12486,1960-1961,1960-11-09,1961-04-08,151,0,71,466,537,30,65,95,632,17,118,Nebraska,Valentine,2737
12487,1961-1962,1961-11-04,1962-04-01,149,1,159,637,796,48,269,317,1113,25,209,Nebraska,Valentine,2737
12488,1962-1963,1962-11-16,1963-04-03,139,0,114,529,643,39,103,142,785,24,235,Nebraska,Valentine,2737
12489,1963-1964,1963-11-21,1964-04-07,139,0,93,509,602,37,68,105,707,25,186,Nebraska,Valentine,2737
12490,1964-1965,1964-11-20,1965-03-30,131,0,144,625,769,29,87,116,885,23,239,Nebraska,Valentine,2737
12491,1965-1966,1965-11-25,1966-04-21,148,4,136,552,688,35,215,250,938,22,215,Nebraska,Valentine,2737
12492,1966-1967,1966-11-01,1967-05-01,182,1,77,507,584,29,85,114,698,19,164,Nebraska,Valentine,2737
12493,1967-1968,1967-11-01,1968-04-08,160,0,98,576,674,45,114,159,833,24,200,Nebraska,Valentine,2737
12494,1968-1969,1968-11-06,1969-03-31,146,0,171,639,810,47,380,427,1237,32,256,Nebraska,Valentine,2737
12495,1969-1970,1969-10-12,1970-04-23,194,0,99,579,678,59,112,171,849,24,193,Nebraska,Valentine,2737
12496,1970-1971,1970-10-07,1971-04-27,203,0,141,623,764,67,239,306,1070,31,237,Nebraska,Valentine,2737
12497,1971-1972,1971-10-28,1972-04-03,159,0,109,576,685,36,107,143,828,25,184,Nebraska,Valentine,2737
12498,1972-1973,1972-10-30,1973-04-08,161,0,136,508,644,55,172,227,871,26,197,Nebraska,Valentine,2737
12499,1973-1974,1973-11-01,1974-04-15,166,1,102,490,592,44,71,115,707,22,158,Nebraska,Valentine,2737
12500,1974-1975,1974-11-13,1975-04-04,143,0,88,528,616,52,85,137,753,25,178,Nebraska,Valentine,2737
12501,1975-1976,1975-10-23,1976-03-24,154,1,97,496,593,51,105,156,749,20,179,Nebraska,Valentine,2737
12502,1976-1977,1976-10-26,1977-04-05,162,2,98,628,726,110,129,239,965,34,267,Nebraska,Valentine,2737
12503,1977-1978,1977-10-10,1978-04-22,195,0,207,742,949,74,203,277,1226,42,353,Nebraska,Valentine,2737
12504,1978-1979,1978-11-10,1979-05-10,182,0,239,819,1058,83,548,631,1689,38,340,Nebraska,Valentine,2737
12505,1979-1980,1979-10-31,1980-04-11,164,0,89,570,659,79,131,210,869,28,253,Nebraska,Valentine,2737
12506,1980-1981,1980-10-27,1981-03-29,154,0,56,455,511,26,30,56,567,13,113,Nebraska,Valentine,2737
12507,1981-1982,1981-10-20,1982-04-20,183,0,141,637,778,81,194,275,1053,40,384,Nebraska,Valentine,2737
12508,1982-1983,1982-10-19,1983-04-13,177,0,39,420,459,31,49,80,539,18,87,Nebraska,Valentine,2737
12509,1983-1984,1983-11-08,1984-05-07,182,0,168,641,809,71,266,337,1146,30,246,Nebraska,Valentine,2737
12510,1984-1985,1984-09-25,1985-04-05,193,0,100,649,749,29,44,73,822,23,161,Nebraska,Valentine,2737
12511,1985-1986,1985-09-28,1986-04-27,212,0,143,637,780,109,440,549,1329,35,297,Nebraska,Valentine,2737
12512,1986-1987,1986-10-11,1987-03-29,170,0,39,455,494,54,70,124,618,23,116,Nebraska,Valentine,2737
12513,1987-1988,1987-10-09,1988-04-27,202,0,113,681,794,88,443,531,1325,28,238,Nebraska,Valentine,2737
12514,1988-1989,1988-11-15,1989-03-20,126,0,117,557,674,48,102,150,824,22,219,Nebraska,Valentine,2737
12515,1989-1990,1989-11-15,1990-03-24,130,0,89,485,574,37,86,123,697,18,149,Nebraska,Valentine,2737
12516,1990-1991,1990-10-07,1991-04-19,195,0,103,608,711,46,86,132,843,21,156,Nebraska,Valentine,2737
12517,1991-1992,1991-10-18,1992-03-18,153,0,42,421,463,38,76,114,577,14,82,Nebraska,Valentine,2737
12518,1992-1993,1992-11-02,1993-04-19,169,0,131,624,755,66,212,278,1033,26,211,Nebraska,Valentine,2737
12519,1993-1994,1993-10-08,1994-04-30,205,0,131,618,749,52,108,160,909,29,215,Nebraska,Valentine,2737
12520,1994-1995,1994-11-04,1995-04-21,169,0,65,464,529,71,101,172,701,22,145,Nebraska,Valentine,2737
12521,1996-1997,1996-10-17,1997-04-13,179,1,166,628,794,57,206,263,1057,24,227,Nebraska,Valentine,2737
12522,1997-1998,1997-10-24,1998-03-19,147,1,75,442,517,33,66,99,616,14,102,Nebraska,Valentine,2737
12523,1998-1999,1998-11-03,1999-04-15,164,0,55,391,446,50,46,96,542,21,124,Nebraska,Valentine,2737
12524,1999-2000,1999-11-18,2000-04-15,150,0,26,399,425,26,33,59,484,15,81,Nebraska,Valentine,2737
12525,2000-2001,2000-11-06,2001-04-23,169,5,89,537,626,48,165,213,839,22,164,Nebraska,Valentine,2737
12526,2001-2002,2001-11-25,2002-05-01,158,0,78,491,569,56,106,162,731,15,123,Nebraska,Valentine,2737
12527,2002-2003,2002-10-23,2003-04-08,168,0,82,534,616,57,79,136,752,25,222,Nebraska,Valentine,2737
12528,2003-2004,2003-10-31,2004-04-10,163,0,78,458,536,40,83,123,659,14,115,Nebraska,Valentine,2737
12529,2004-2005,2004-11-28,2005-04-12,136,0,61,396,457,40,71,111,568,14,101,Nebraska,Valentine,2737
12530,2005-2006,2005-11-16,2006-04-24,160,0,78,432,510,66,128,194,704,24,162,Nebraska,Valentine,2737
12531,2006-2007,2006-10-17,2007-04-06,172,0,87,527,614,39,115,154,768,22,126,Nebraska,Valentine,2737
12532,2007-2008,2007-11-21,2008-05-02,164,0,70,542,612,52,77,129,741,22,140,Nebraska,Valentine,2737
12533,2008-2009,2008-11-06,2009-04-10,156,0,88,560,648,52,79,131,779,25,192,Nebraska,Valentine,2737
12534,2009-2010,2009-10-11,2010-03-12,153,0,107,482,589,35,80,115,704,29,182,Nebraska,Valentine,2737
12535,2010-2011,2010-11-11,2011-04-20,161,0,131,572,703,78,193,271,974,36,293,Nebraska,Valentine,2737
12536,2011-2012,2011-11-01,2012-03-06,127,0,25,412,437,28,36,64,501,15,69,Nebraska,Valentine,2737
12537,2012-2013,2012-10-24,2013-05-01,190,0,77,509,586,82,110,192,778,35,213,Nebraska,Valentine,2737
12538,2015-2016,2015-11-20,2016-04-27,160,0,52,389,441,54,200,254,695,19,133,Nebraska,Valentine,2737
12539,2016-2017,2016-10-06,2017-04-10,187,3,84,478,562,64,140,204,766,23,197,Nebraska,Valentine,2737
12540,2017-2018,2017-11-06,2018-04-18,164,0,107,527,634,70,133,203,837,37,253,Nebraska,Valentine,2737
12541,2018-2019,2018-10-14,2019-04-30,199,0,122,560,682,69,211,280,962,31,219,Nebraska,Valentine,2737
12542,2019-2020,2019-10-10,2020-04-16,190,0,34,464,498,58,144,202,700,25,139,Nebraska,Valentine,2737
12543,1950-1951,1950-12-01,1951-03-30,120,0,12,266,278,36,42,78,356,19,92,Nevada,Battle Mountain,0
12544,1951-1952,1951-11-24,1952-03-20,118,0,40,392,432,71,222,293,725,25,141,Nevada,Battle Mountain,0
12545,1952-1953,1952-12-01,1953-05-26,177,0,3,332,335,30,26,56,391,16,60,Nevada,Battle Mountain,0
12546,1953-1954,1953-11-20,1954-03-30,131,0,3,361,364,26,14,40,404,14,59,Nevada,Battle Mountain,0
12547,1954-1955,1954-12-01,1955-04-18,139,0,26,539,565,19,91,110,675,9,52,Nevada,Battle Mountain,0
12548,1955-1956,1955-11-14,1956-04-11,150,0,22,349,371,50,95,145,516,22,112,Nevada,Battle Mountain,0
12549,1956-1957,1956-11-01,1957-03-22,142,0,19,494,513,15,22,37,550,10,62,Nevada,Battle Mountain,0
12550,1957-1958,1957-11-04,1958-03-06,123,0,2,289,291,10,4,14,305,6,25,Nevada,Battle Mountain,0
12551,1958-1959,1958-11-14,1959-04-18,156,0,7,411,418,21,5,26,444,15,62,Nevada,Battle Mountain,0
12552,1959-1960,1959-12-01,1960-05-21,173,0,22,421,443,30,39,69,512,15,84,Nevada,Battle Mountain,0
12553,1960-1961,1960-11-14,1961-04-23,161,0,3,413,416,22,4,26,442,16,50,Nevada,Battle Mountain,0
12554,1961-1962,1961-10-27,1962-03-12,137,0,52,466,518,55,161,216,734,28,139,Nevada,Battle Mountain,0
12555,1962-1963,1962-11-16,1963-05-11,177,6,11,435,446,26,5,31,477,12,47,Nevada,Battle Mountain,0
12556,1963-1964,1963-12-01,1964-04-23,145,0,9,300,309,43,27,70,379,15,71,Nevada,Battle Mountain,0
12557,1964-1965,1964-11-12,1965-05-08,178,0,25,344,369,68,59,127,496,19,108,Nevada,Battle Mountain,0
12558,1965-1966,1965-12-01,1966-03-03,93,2,14,284,298,30,43,73,371,11,50,Nevada,Battle Mountain,0
12559,1966-1967,1966-12-01,1967-04-28,149,0,10,312,322,74,88,162,484,20,115,Nevada,Battle Mountain,0
12560,1967-1968,1967-11-30,1968-02-29,92,0,16,273,289,29,26,55,344,9,62,Nevada,Battle Mountain,0
12561,1968-1969,1968-11-15,1969-03-10,116,1,12,272,284,104,106,210,494,25,178,Nevada,Battle Mountain,0
12562,1970-1971,1970-12-01,1971-04-26,147,0,25,327,352,56,91,147,499,19,121,Nevada,Battle Mountain,0
12563,1971-1972,1971-10-16,1972-02-29,137,0,32,376,408,43,129,172,580,14,78,Nevada,Battle Mountain,0
12564,1973-1974,1973-11-21,1974-04-27,158,3,9,307,316,31,4,35,351,13,57,Nevada,Battle Mountain,0
12565,1974-1975,1974-12-01,1975-04-26,147,1,23,335,358,32,49,81,439,13,67,Nevada,Battle Mountain,0
12566,1975-1976,1975-11-27,1976-04-26,152,0,11,343,354,45,28,73,427,17,88,Nevada,Battle Mountain,0
12567,1976-1977,1976-11-27,1977-05-17,172,0,7,521,528,18,22,40,568,7,34,Nevada,Battle Mountain,0
12568,1977-1978,1977-11-20,1978-04-08,140,0,3,196,199,37,31,68,267,13,59,Nevada,Battle Mountain,0
12569,1978-1979,1978-11-11,1979-03-17,127,0,28,388,416,46,47,93,509,16,76,Nevada,Battle Mountain,0
12570,1979-1980,1979-10-31,1980-02-29,122,0,5,313,318,30,29,59,377,10,51,Nevada,Battle Mountain,0
12571,1980-1981,1980-12-01,1981-03-30,120,0,1,315,316,16,0,16,332,7,29,Nevada,Battle Mountain,0
12572,1981-1982,1981-10-12,1982-04-01,172,10,14,370,384,11,3,14,398,9,31,Nevada,Battle Mountain,0
12573,1986-1987,1986-12-01,1987-03-19,109,6,12,411,423,46,71,117,540,12,78,Nevada,Battle Mountain,0
12574,1989-1990,1989-12-01,1990-03-12,102,6,5,276,281,18,9,27,308,10,37,Nevada,Battle Mountain,0
12575,1990-1991,1990-11-26,1991-05-17,173,13,53,454,507,24,88,112,619,12,51,Nevada,Battle Mountain,0
12576,1992-1993,1992-11-20,1993-03-07,108,6,60,461,521,78,437,515,1036,25,162,Nevada,Battle Mountain,0
12577,1993-1994,1993-11-23,1994-02-28,98,4,2,318,320,16,60,76,396,9,32,Nevada,Battle Mountain,0
12578,1994-1995,1994-11-02,1995-04-14,164,10,5,265,270,32,39,71,341,16,68,Nevada,Battle Mountain,0
12579,1995-1996,1995-12-01,1996-04-20,142,13,7,239,246,43,88,131,377,15,68,Nevada,Battle Mountain,0
12580,1996-1997,1996-11-17,1997-02-28,104,6,6,201,207,54,45,99,306,12,81,Nevada,Battle Mountain,0
12581,1997-1998,1997-12-01,1998-03-29,119,7,3,223,226,20,4,24,250,11,37,Nevada,Battle Mountain,0
12582,1998-1999,1998-10-29,1999-04-08,162,12,20,323,343,39,39,78,421,18,81,Nevada,Battle Mountain,0
12583,1999-2000,1999-12-01,2000-03-19,110,9,0,243,243,24,4,28,271,12,39,Nevada,Battle Mountain,0
12584,2000-2001,2000-11-14,2001-04-11,149,12,5,376,381,21,18,39,420,12,42,Nevada,Battle Mountain,0
12585,2001-2002,2001-11-26,2002-03-08,103,5,5,244,249,20,9,29,278,11,48,Nevada,Battle Mountain,0
12586,2002-2003,2002-12-01,2003-04-14,135,7,1,250,251,7,3,10,261,5,14,Nevada,Battle Mountain,0
12587,2003-2004,2003-10-30,2004-02-29,123,5,18,299,317,61,70,131,448,20,91,Nevada,Battle Mountain,0
12588,2004-2005,2004-11-27,2005-03-02,96,5,27,326,353,54,284,338,691,17,103,Nevada,Battle Mountain,0
12589,2005-2006,2005-11-28,2006-04-17,141,10,6,236,242,22,7,29,271,16,56,Nevada,Battle Mountain,0
12590,2006-2007,2006-11-28,2007-04-18,142,12,27,435,462,33,91,124,586,13,58,Nevada,Battle Mountain,0
12591,2007-2008,2007-12-01,2008-06-04,187,12,11,332,343,16,11,27,370,11,39,Nevada,Battle Mountain,0
12592,2008-2009,2008-12-01,2009-04-15,136,2,8,198,206,49,85,134,340,18,85,Nevada,Battle Mountain,0
12593,2009-2010,2009-12-01,2010-05-28,179,2,10,206,216,26,37,63,279,14,49,Nevada,Battle Mountain,0
12594,2010-2011,2010-11-10,2011-04-08,150,0,9,175,184,33,27,60,244,18,56,Nevada,Battle Mountain,0
12595,2011-2012,2011-11-06,2012-03-06,122,0,0,232,232,18,6,24,256,8,30,Nevada,Battle Mountain,0
12596,2012-2013,2012-10-25,2013-03-08,135,4,18,295,313,32,137,169,482,13,50,Nevada,Battle Mountain,0
12597,2013-2014,2013-11-21,2014-03-30,130,12,6,191,197,19,78,97,294,7,34,Nevada,Battle Mountain,0
12598,2014-2015,2014-11-13,2015-02-28,108,3,3,128,131,3,0,3,134,3,6,Nevada,Battle Mountain,0
12599,2016-2017,2016-11-27,2017-05-13,168,6,17,209,226,32,62,94,320,13,57,Nevada,Battle Mountain,0
12600,2017-2018,2017-12-01,2018-03-25,115,0,2,186,188,20,28,48,236,11,39,Nevada,Battle Mountain,0
12601,2018-2019,2018-12-01,2019-03-04,94,3,1,161,162,26,45,71,233,13,45,Nevada,Battle Mountain,0
12602,2019-2020,2019-09-29,2020-03-01,155,5,1,211,212,13,9,22,234,7,21,Nevada,Battle Mountain,0
12603,1950-1951,1950-11-14,1951-05-01,169,0,23,357,380,73,92,165,545,30,153,Nevada,Elko,18297
12604,1951-1952,1951-11-11,1952-03-26,137,1,85,580,665,78,414,492,1157,54,276,Nevada,Elko,18297
12605,1952-1953,1952-11-14,1953-05-28,196,0,13,420,433,46,40,86,519,33,113,Nevada,Elko,18297
12606,1953-1954,1953-10-18,1954-03-30,164,0,26,471,497,60,146,206,703,28,139,Nevada,Elko,18297
12607,1954-1955,1954-12-01,1955-05-14,165,0,76,608,684,46,253,299,983,28,174,Nevada,Elko,18297
12608,1955-1956,1955-11-01,1956-04-11,163,0,48,496,544,114,257,371,915,45,294,Nevada,Elko,18297
12609,1956-1957,1956-10-23,1957-04-18,178,0,42,595,637,38,94,132,769,27,143,Nevada,Elko,18297
12610,1957-1958,1957-11-03,1958-04-03,152,0,5,432,437,63,46,109,546,33,139,Nevada,Elko,18297
12611,1958-1959,1958-11-15,1959-05-23,190,0,17,436,453,38,17,55,508,27,110,Nevada,Elko,18297
12612,1959-1960,1959-12-01,1960-05-21,173,0,44,467,511,47,89,136,647,33,169,Nevada,Elko,18297
12613,1960-1961,1960-11-13,1961-04-25,164,0,4,456,460,40,15,55,515,27,96,Nevada,Elko,18297
12614,1961-1962,1961-10-09,1962-05-15,219,0,66,532,598,86,165,251,849,48,238,Nevada,Elko,18297
12615,1962-1963,1962-11-16,1963-05-11,177,0,21,512,533,57,18,75,608,32,125,Nevada,Elko,18297
12616,1963-1964,1963-10-12,1964-05-05,207,0,43,680,723,99,310,409,1132,55,321,Nevada,Elko,18297
12617,1964-1965,1964-11-10,1965-05-07,179,0,23,457,480,77,61,138,618,44,203,Nevada,Elko,18297
12618,1965-1966,1965-10-15,1966-04-17,185,0,60,576,636,71,92,163,799,37,198,Nevada,Elko,18297
12619,1966-1967,1966-10-13,1967-05-12,212,0,46,520,566,107,295,402,968,44,218,Nevada,Elko,18297
12620,1967-1968,1967-11-29,1968-04-21,145,0,24,335,359,73,141,214,573,29,150,Nevada,Elko,18297
12621,1968-1969,1968-11-15,1969-04-07,144,0,29,391,420,101,186,287,707,49,249,Nevada,Elko,18297
12622,1969-1970,1969-10-03,1970-05-10,220,0,29,547,576,44,62,106,682,31,103,Nevada,Elko,18297
12623,1970-1971,1970-10-24,1971-05-22,211,0,52,408,460,110,129,239,699,52,250,Nevada,Elko,18297
12624,1971-1972,1971-10-01,1972-04-12,195,0,60,492,552,77,101,178,730,44,234,Nevada,Elko,18297
12625,1972-1973,1972-10-28,1973-04-19,174,0,87,481,568,60,41,101,669,35,173,Nevada,Elko,18297
12626,1973-1974,1973-11-20,1974-04-27,159,0,30,276,306,43,31,74,380,25,104,Nevada,Elko,18297
12627,1974-1975,1974-12-01,1975-05-19,170,0,50,403,453,83,108,191,644,35,164,Nevada,Elko,18297
12628,1975-1976,1975-10-07,1976-04-15,192,0,20,471,491,47,15,62,553,32,143,Nevada,Elko,18297
12629,1976-1977,1976-11-14,1977-05-17,185,0,13,479,492,25,26,51,543,19,55,Nevada,Elko,18297
12630,1977-1978,1977-11-19,1978-02-28,102,0,11,171,182,33,23,56,238,15,54,Nevada,Elko,18297
12631,1978-1979,1978-11-10,1979-05-07,179,0,35,413,448,48,47,95,543,29,118,Nevada,Elko,18297
12632,1979-1980,1979-10-31,1980-05-11,194,0,12,320,332,61,31,92,424,36,124,Nevada,Elko,18297
12633,1980-1981,1980-10-26,1981-05-16,203,0,1,349,350,22,4,26,376,17,42,Nevada,Elko,18297
12634,1981-1982,1981-11-27,1982-04-02,127,0,34,328,362,61,74,135,497,32,149,Nevada,Elko,18297
12635,1982-1983,1982-09-30,1983-05-06,219,0,25,351,376,83,153,236,612,35,131,Nevada,Elko,18297
12636,1983-1984,1983-11-19,1984-04-27,161,0,70,424,494,103,244,347,841,47,230,Nevada,Elko,18297
12637,1984-1985,1984-10-16,1985-04-25,192,0,46,523,569,56,93,149,718,39,164,Nevada,Elko,18297
12638,1985-1986,1985-10-21,1986-05-06,198,0,27,395,422,47,47,94,516,25,114,Nevada,Elko,18297
12639,1986-1987,1986-11-07,1987-03-24,138,0,21,497,518,30,18,48,566,15,80,Nevada,Elko,18297
12640,1987-1988,1987-11-25,1988-05-30,188,0,41,513,554,41,104,145,699,22,109,Nevada,Elko,18297
12641,1988-1989,1988-11-14,1989-03-26,133,0,93,581,674,80,311,391,1065,38,233,Nevada,Elko,18297
12642,1989-1990,1989-10-27,1990-05-24,210,0,14,544,558,44,27,71,629,25,106,Nevada,Elko,18297
12643,1990-1991,1990-11-19,1991-05-18,181,0,70,561,631,49,123,172,803,31,171,Nevada,Elko,18297
12644,1991-1992,1991-10-28,1992-03-17,142,0,10,399,409,28,22,50,459,16,55,Nevada,Elko,18297
12645,2001-2002,2001-11-24,2002-05-01,159,0,65,462,527,80,228,308,835,44,239,Nevada,Elko,18297
12646,2002-2003,2002-11-09,2003-05-09,182,0,4,340,344,34,13,47,391,25,78,Nevada,Elko,18297
12647,2003-2004,2003-10-30,2004-04-21,175,0,66,440,506,84,314,398,904,37,166,Nevada,Elko,18297
12648,2004-2005,2004-10-18,2005-04-20,185,0,61,455,516,95,409,504,1020,36,173,Nevada,Elko,18297
12649,2005-2006,2005-11-26,2006-04-17,143,0,21,297,318,73,55,128,446,41,155,Nevada,Elko,18297
12650,2006-2007,2006-11-13,2007-04-18,157,0,49,476,525,40,127,167,692,24,107,Nevada,Elko,18297
12651,2007-2008,2007-10-05,2008-04-20,199,0,50,574,624,85,370,455,1079,45,247,Nevada,Elko,18297
12652,2008-2009,2008-11-04,2009-04-24,172,0,22,399,421,66,134,200,621,34,167,Nevada,Elko,18297
12653,2009-2010,2009-10-05,2010-05-11,219,0,45,565,610,87,379,466,1076,45,212,Nevada,Elko,18297
12654,2010-2011,2010-10-26,2011-05-15,202,0,38,387,425,75,117,192,617,42,173,Nevada,Elko,18297
12655,2011-2012,2011-10-06,2012-04-06,184,0,6,504,510,46,38,84,594,20,98,Nevada,Elko,18297
12656,2012-2013,2012-10-24,2013-04-16,175,0,75,471,546,63,301,364,910,32,177,Nevada,Elko,18297
12657,2013-2014,2013-10-28,2014-05-10,195,0,29,402,431,40,47,87,518,28,105,Nevada,Elko,18297
12658,2014-2015,2014-11-13,2015-05-07,176,0,13,300,313,27,13,40,353,20,74,Nevada,Elko,18297
12659,2015-2016,2015-11-02,2016-04-23,174,0,60,426,486,97,388,485,971,48,237,Nevada,Elko,18297
12660,2016-2017,2016-11-16,2017-03-31,136,0,46,328,374,85,223,308,682,41,194,Nevada,Elko,18297
12661,2017-2018,2017-11-17,2018-04-12,147,0,14,339,353,47,41,88,441,26,116,Nevada,Elko,18297
12662,2018-2019,2018-11-24,2019-05-22,180,0,42,324,366,85,230,315,681,46,183,Nevada,Elko,18297
12663,2019-2020,2019-11-26,2020-03-25,121,0,9,235,244,48,78,126,370,33,104,Nevada,Elko,18297
12664,1950-1951,1950-11-09,1951-04-29,172,0,24,467,491,23,14,37,528,19,102,Nevada,Ely,4255
12665,1951-1952,1951-11-12,1952-04-10,151,0,89,707,796,122,681,803,1599,52,366,Nevada,Ely,4255
12666,1952-1953,1952-11-14,1953-05-24,192,0,31,557,588,43,97,140,728,26,132,Nevada,Ely,4255
12667,1953-1954,1953-10-23,1954-06-05,226,0,18,546,564,63,74,137,701,24,145,Nevada,Ely,4255
12668,1954-1955,1954-10-23,1955-06-01,222,0,68,734,802,82,286,368,1170,35,237,Nevada,Ely,4255
12669,1955-1956,1955-11-13,1956-05-27,197,0,42,542,584,87,207,294,878,32,225,Nevada,Ely,4255
12670,1956-1957,1956-10-28,1957-05-19,204,0,32,620,652,65,81,146,798,36,187,Nevada,Ely,4255
12671,1957-1958,1957-10-03,1958-04-24,204,0,14,543,557,103,83,186,743,43,202,Nevada,Ely,4255
12672,1958-1959,1958-09-23,1959-05-19,239,0,21,577,598,61,65,126,724,30,146,Nevada,Ely,4255
12673,1959-1960,1959-09-30,1960-05-18,232,0,52,672,724,72,198,270,994,44,246,Nevada,Ely,4255
12674,1960-1961,1960-10-09,1961-05-13,217,0,14,567,581,74,57,131,712,38,161,Nevada,Ely,4255
12675,1961-1962,1961-10-07,1962-04-09,185,0,43,624,667,75,137,212,879,36,207,Nevada,Ely,4255
12676,1962-1963,1962-11-16,1963-05-11,177,0,25,546,571,51,29,80,651,20,107,Nevada,Ely,4255
12677,1963-1964,1963-11-06,1964-05-07,184,0,40,696,736,114,173,287,1023,39,261,Nevada,Ely,4255
12678,1964-1965,1964-11-09,1965-05-24,197,0,37,565,602,90,153,243,845,43,245,Nevada,Ely,4255
12679,1965-1966,1965-10-15,1966-04-18,186,0,43,624,667,48,180,228,895,21,130,Nevada,Ely,4255
12680,1966-1967,1966-11-08,1967-06-01,206,0,19,508,527,82,117,199,726,35,196,Nevada,Ely,4255
12681,1967-1968,1967-11-21,1968-05-14,176,0,37,548,585,88,221,309,894,36,210,Nevada,Ely,4255
12682,1968-1969,1968-10-14,1969-04-24,193,0,31,559,590,93,184,277,867,38,216,Nevada,Ely,4255
12683,1969-1970,1969-10-04,1970-04-30,209,0,14,553,567,65,21,86,653,39,156,Nevada,Ely,4255
12684,1970-1971,1970-11-06,1971-05-31,207,0,50,560,610,98,206,304,914,36,227,Nevada,Ely,4255
12685,1971-1972,1971-09-30,1972-05-20,234,0,39,668,707,67,106,173,880,41,230,Nevada,Ely,4255
12686,1972-1973,1972-10-30,1973-05-05,188,0,49,678,727,92,220,312,1039,43,221,Nevada,Ely,4255
12687,1973-1974,1973-10-08,1974-05-19,224,0,28,602,630,71,83,154,784,35,194,Nevada,Ely,4255
12688,1974-1975,1974-10-29,1975-05-21,205,0,37,612,649,107,92,199,848,55,293,Nevada,Ely,4255
12689,1975-1976,1975-10-07,1976-04-18,195,0,22,632,654,91,159,250,904,44,251,Nevada,Ely,4255
12690,1976-1977,1976-11-14,1977-05-18,186,0,12,685,697,53,47,100,797,23,121,Nevada,Ely,4255
12691,1977-1978,1977-09-16,1978-05-16,243,0,11,470,481,95,81,176,657,45,182,Nevada,Ely,4255
12692,1978-1979,1978-09-17,1979-06-17,274,0,46,729,775,113,281,394,1169,50,276,Nevada,Ely,4255
12693,1979-1980,1979-10-28,1980-06-02,219,0,8,504,512,90,63,153,665,47,185,Nevada,Ely,4255
12694,1980-1981,1980-10-14,1981-05-20,219,0,6,504,510,76,106,182,692,29,130,Nevada,Ely,4255
12695,1981-1982,1981-10-11,1982-06-05,238,0,23,571,594,93,106,199,793,52,238,Nevada,Ely,4255
12696,1982-1983,1982-09-27,1983-05-16,232,0,13,554,567,110,165,275,842,53,221,Nevada,Ely,4255
12697,1983-1984,1983-11-19,1984-04-25,159,0,19,501,520,68,157,225,745,33,192,Nevada,Ely,4255
12698,1984-1985,1984-10-11,1985-05-10,212,0,38,697,735,89,290,379,1114,42,243,Nevada,Ely,4255
12699,1985-1986,1985-10-08,1986-05-07,212,0,21,501,522,86,117,203,725,40,208,Nevada,Ely,4255
12700,1986-1987,1986-09-24,1987-03-23,181,0,26,533,559,54,109,163,722,25,116,Nevada,Ely,4255
12701,1987-1988,1987-11-06,1988-05-29,206,0,33,576,609,63,210,273,882,28,167,Nevada,Ely,4255
12702,1988-1989,1988-11-14,1989-05-30,198,0,61,653,714,86,333,419,1133,28,219,Nevada,Ely,4255
12703,1989-1990,1989-10-25,1990-06-01,220,0,19,626,645,54,96,150,795,22,120,Nevada,Ely,4255
12704,1990-1991,1990-10-07,1991-05-30,236,0,31,710,741,63,57,120,861,32,143,Nevada,Ely,4255
12705,1991-1992,1991-10-26,1992-06-14,233,0,12,526,538,50,96,146,684,28,109,Nevada,Ely,4255
12706,1992-1993,1992-10-30,1993-05-05,188,0,38,704,742,96,487,583,1325,52,292,Nevada,Ely,4255
12707,1993-1994,1993-11-11,1994-04-28,169,0,19,621,640,57,113,170,810,34,165,Nevada,Ely,4255
12708,1994-1995,1994-10-15,1995-06-07,236,0,37,531,568,106,87,193,761,59,264,Nevada,Ely,4255
12709,2001-2002,2001-11-24,2002-04-20,148,0,51,573,624,70,198,268,892,27,183,Nevada,Ely,4255
12710,2002-2003,2002-10-01,2003-05-09,221,0,15,542,557,85,59,144,701,32,157,Nevada,Ely,4255
12711,2003-2004,2003-10-31,2004-04-22,175,0,42,525,567,66,283,349,916,28,136,Nevada,Ely,4255
12712,2004-2005,2004-10-18,2005-05-16,211,0,22,452,474,103,130,233,707,51,213,Nevada,Ely,4255
12713,2008-2009,2008-10-11,2009-04-25,197,0,33,556,589,82,172,254,843,33,211,Nevada,Ely,4255
12714,2009-2010,2009-10-04,2010-05-24,233,0,37,744,781,155,590,745,1526,49,317,Nevada,Ely,4255
12715,2010-2011,2010-11-08,2011-05-30,204,0,46,543,589,152,433,585,1174,38,258,Nevada,Ely,4255
12716,2011-2012,2011-10-05,2012-04-12,191,0,12,528,540,71,100,171,711,26,148,Nevada,Ely,4255
12717,2012-2013,2012-10-23,2013-04-18,178,0,55,553,608,92,366,458,1066,29,193,Nevada,Ely,4255
12718,2013-2014,2013-10-13,2014-05-10,210,0,25,542,567,71,206,277,844,23,125,Nevada,Ely,4255
12719,2014-2015,2014-11-02,2015-04-14,164,0,14,394,408,28,45,73,481,17,75,Nevada,Ely,4255
12720,2015-2016,2015-11-03,2016-04-28,178,0,59,586,645,139,523,662,1307,39,287,Nevada,Ely,4255
12721,2016-2017,2016-11-16,2017-05-18,184,4,32,495,527,97,299,396,923,34,213,Nevada,Ely,4255
12722,2017-2018,2017-09-21,2018-05-12,234,0,12,581,593,67,102,169,762,27,157,Nevada,Ely,4255
12723,2018-2019,2018-11-28,2019-05-22,176,0,38,447,485,104,233,337,822,50,251,Nevada,Ely,4255
12724,2019-2020,2019-11-21,2020-04-19,151,0,19,432,451,72,117,189,640,32,177,Nevada,Ely,4255
12725,1950-1951,1950-12-01,1951-02-28,90,0,0,37,37,0,0,0,37,0,0,Nevada,Las Vegas,583756
12726,1951-1952,1951-12-01,1952-02-29,91,0,0,60,60,0,0,0,60,0,0,Nevada,Las Vegas,583756
12727,1952-1953,1952-12-01,1953-02-28,90,0,0,30,30,0,0,0,30,0,0,Nevada,Las Vegas,583756
12728,1953-1954,1953-12-01,1954-02-28,90,0,0,42,42,0,0,0,42,0,0,Nevada,Las Vegas,583756
12729,1954-1955,1954-12-01,1955-02-28,90,0,0,68,68,2,0,2,70,1,3,Nevada,Las Vegas,583756
12730,1955-1956,1955-12-01,1956-02-29,91,0,0,37,37,0,0,0,37,0,0,Nevada,Las Vegas,583756
12731,1956-1957,1956-12-01,1957-02-28,90,0,0,50,50,2,0,2,52,1,4,Nevada,Las Vegas,583756
12732,1957-1958,1957-12-01,1958-02-28,90,0,0,32,32,0,0,0,32,0,0,Nevada,Las Vegas,583756
12733,1958-1959,1958-11-16,1959-02-28,105,0,0,41,41,2,0,2,43,1,3,Nevada,Las Vegas,583756
12734,1959-1960,1959-12-01,1960-02-29,91,0,0,36,36,1,0,1,37,1,2,Nevada,Las Vegas,583756
12735,1960-1961,1960-12-01,1961-02-28,90,0,0,32,32,0,0,0,32,0,0,Nevada,Las Vegas,583756
12736,1961-1962,1961-12-01,1962-02-28,90,0,0,48,48,0,0,0,48,0,0,Nevada,Las Vegas,583756
12737,1962-1963,1962-12-01,1963-02-28,90,0,2,59,61,0,0,0,61,0,0,Nevada,Las Vegas,583756
12738,1963-1964,1963-12-01,1964-02-29,91,0,0,65,65,0,0,0,65,0,0,Nevada,Las Vegas,583756
12739,1964-1965,1964-11-15,1965-02-28,106,0,0,44,44,6,3,9,53,2,8,Nevada,Las Vegas,583756
12740,1965-1966,1965-12-01,1966-02-28,90,0,0,39,39,0,0,0,39,0,0,Nevada,Las Vegas,583756
12741,1966-1967,1966-12-01,1967-02-28,90,0,0,35,35,0,0,0,35,0,0,Nevada,Las Vegas,583756
12742,1967-1968,1967-12-01,1968-02-29,91,0,0,40,40,3,2,5,45,1,4,Nevada,Las Vegas,583756
12743,1968-1969,1968-12-01,1969-02-28,90,0,0,43,43,0,0,0,43,0,0,Nevada,Las Vegas,583756
12744,1969-1970,1969-12-01,1970-02-28,90,0,0,42,42,0,0,0,42,0,0,Nevada,Las Vegas,583756
12745,1970-1971,1970-12-01,1971-02-28,90,0,0,48,48,0,0,0,48,0,0,Nevada,Las Vegas,583756
12746,1971-1972,1971-12-01,1972-02-29,91,0,0,59,59,0,0,0,59,0,0,Nevada,Las Vegas,583756
12747,1972-1973,1972-12-01,1973-02-28,90,0,1,50,51,2,0,2,53,2,4,Nevada,Las Vegas,583756
12748,1973-1974,1973-12-01,1974-02-28,90,0,2,40,42,18,10,28,70,3,22,Nevada,Las Vegas,583756
12749,1974-1975,1974-12-01,1975-02-28,90,0,0,31,31,0,0,0,31,0,0,Nevada,Las Vegas,583756
12750,1975-1976,1975-12-01,1976-03-03,94,0,0,27,27,1,0,1,28,1,1,Nevada,Las Vegas,583756
12751,1976-1977,1976-12-01,1977-02-28,90,0,0,38,38,0,0,0,38,0,0,Nevada,Las Vegas,583756
12752,1977-1978,1977-12-01,1978-02-28,90,0,0,2,2,0,0,0,2,0,0,Nevada,Las Vegas,583756
12753,1978-1979,1978-12-01,1979-02-28,90,0,0,44,44,15,9,24,68,4,21,Nevada,Las Vegas,583756
12754,1979-1980,1979-12-01,1980-02-29,91,0,0,15,15,0,0,0,15,0,0,Nevada,Las Vegas,583756
12755,1980-1981,1980-12-01,1981-02-28,90,0,0,9,9,0,0,0,9,0,0,Nevada,Las Vegas,583756
12756,1981-1982,1981-12-01,1982-02-28,90,0,0,25,25,0,0,0,25,0,0,Nevada,Las Vegas,583756
12757,1982-1983,1982-12-01,1983-02-28,90,0,0,13,13,0,0,0,13,0,0,Nevada,Las Vegas,583756
12758,1983-1984,1983-12-01,1984-02-29,91,0,0,17,17,0,0,0,17,0,0,Nevada,Las Vegas,583756
12759,1984-1985,1984-12-01,1985-02-28,90,0,0,36,36,0,0,0,36,0,0,Nevada,Las Vegas,583756
12760,1985-1986,1985-12-01,1986-02-28,90,0,0,14,14,0,0,0,14,0,0,Nevada,Las Vegas,583756
12761,1986-1987,1986-12-01,1987-02-28,90,0,0,26,26,1,0,1,27,1,1,Nevada,Las Vegas,583756
12762,1987-1988,1987-12-01,1988-02-29,91,0,0,27,27,0,0,0,27,0,0,Nevada,Las Vegas,583756
12763,1988-1989,1988-12-01,1989-02-28,90,0,0,42,42,1,0,1,43,1,2,Nevada,Las Vegas,583756
12764,1989-1990,1989-12-01,1990-02-28,90,0,0,31,31,2,0,2,33,1,2,Nevada,Las Vegas,583756
12765,1990-1991,1990-12-01,1991-02-28,90,0,0,51,51,0,0,0,51,0,0,Nevada,Las Vegas,583756
12766,1991-1992,1991-12-01,1992-02-29,91,0,0,9,9,0,0,0,9,0,0,Nevada,Las Vegas,583756
12767,1992-1993,1992-12-01,1993-02-28,90,0,0,17,17,0,0,0,17,0,0,Nevada,Las Vegas,583756
12768,1993-1994,1993-12-01,1994-02-28,90,0,0,21,21,0,0,0,21,0,0,Nevada,Las Vegas,583756
12769,1994-1995,1994-12-01,1995-02-28,90,0,0,7,7,0,0,0,7,0,0,Nevada,Las Vegas,583756
12770,1995-1996,1995-12-01,1996-02-29,91,0,0,18,18,0,0,0,18,0,0,Nevada,Las Vegas,583756
12771,1996-1997,1996-12-01,1997-02-28,90,0,0,12,12,0,0,0,12,0,0,Nevada,Las Vegas,583756
12772,1997-1998,1997-12-01,1998-02-28,90,0,0,8,8,0,0,0,8,0,0,Nevada,Las Vegas,583756
12773,1998-1999,1998-12-01,1999-02-28,90,0,0,14,14,2,0,2,16,1,3,Nevada,Las Vegas,583756
12774,1999-2000,1999-12-01,2000-02-29,91,0,0,8,8,0,0,0,8,0,0,Nevada,Las Vegas,583756
12775,2000-2001,2000-12-01,2001-02-28,90,0,0,4,4,0,0,0,4,0,0,Nevada,Las Vegas,583756
12776,2001-2002,2001-12-01,2002-02-28,90,0,0,21,21,0,0,0,21,0,0,Nevada,Las Vegas,583756
12777,2002-2003,2002-12-01,2003-02-28,90,0,0,11,11,0,0,0,11,0,0,Nevada,Las Vegas,583756
12778,2003-2004,2003-12-01,2004-02-29,91,0,0,9,9,2,1,3,12,1,3,Nevada,Las Vegas,583756
12779,2004-2005,2004-12-01,2005-02-28,90,0,0,2,2,0,0,0,2,0,0,Nevada,Las Vegas,583756
12780,2005-2006,2005-12-01,2006-02-28,90,0,0,3,3,0,0,0,3,0,0,Nevada,Las Vegas,583756
12781,2006-2007,2006-12-01,2007-02-28,90,0,0,15,15,0,0,0,15,0,0,Nevada,Las Vegas,583756
12782,2007-2008,2007-12-01,2008-02-29,91,0,0,13,13,0,0,0,13,0,0,Nevada,Las Vegas,583756
12783,2008-2009,2008-12-01,2009-02-28,90,0,0,7,7,4,4,8,15,1,5,Nevada,Las Vegas,583756
12784,2009-2010,2009-12-01,2010-02-28,90,0,0,5,5,0,0,0,5,0,0,Nevada,Las Vegas,583756
12785,2010-2011,2010-12-01,2011-02-28,90,0,0,9,9,0,0,0,9,0,0,Nevada,Las Vegas,583756
12786,2011-2012,2011-12-01,2012-02-29,91,0,0,3,3,0,0,0,3,0,0,Nevada,Las Vegas,583756
12787,2012-2013,2012-12-01,2013-02-28,90,0,0,16,16,0,0,0,16,0,0,Nevada,Las Vegas,583756
12788,2013-2014,2013-12-01,2014-02-28,90,0,0,8,8,0,0,0,8,0,0,Nevada,Las Vegas,583756
12789,2014-2015,2014-12-01,2015-02-28,90,0,0,5,5,0,0,0,5,0,0,Nevada,Las Vegas,583756
12790,2015-2016,2015-12-01,2016-02-29,91,0,0,8,8,0,0,0,8,0,0,Nevada,Las Vegas,583756
12791,2016-2017,2016-12-01,2017-02-28,90,0,0,5,5,0,0,0,5,0,0,Nevada,Las Vegas,583756
12792,2017-2018,2017-12-01,2018-02-28,90,0,0,1,1,0,0,0,1,0,0,Nevada,Las Vegas,583756
12793,2018-2019,2018-12-01,2019-02-28,90,0,0,5,5,2,0,2,7,2,3,Nevada,Las Vegas,583756
12794,2019-2020,2019-12-01,2020-02-29,91,0,0,2,2,0,0,0,2,0,0,Nevada,Las Vegas,583756
12795,1950-1951,1950-12-01,1951-03-29,119,0,5,236,241,24,19,43,284,11,53,Nevada,Reno,225221
12796,1951-1952,1951-11-20,1952-03-23,125,0,16,317,333,85,134,219,552,28,147,Nevada,Reno,225221
12797,1952-1953,1952-11-15,1953-04-10,147,0,2,307,309,24,10,34,343,13,47,Nevada,Reno,225221
12798,1953-1954,1953-11-19,1954-04-30,163,0,0,313,313,39,15,54,367,15,70,Nevada,Reno,225221
12799,1954-1955,1954-12-01,1955-05-31,182,0,12,392,404,35,29,64,468,18,87,Nevada,Reno,225221
12800,1955-1956,1955-11-13,1956-04-14,154,0,16,324,340,54,67,121,461,19,97,Nevada,Reno,225221
12801,1956-1957,1956-10-23,1957-04-20,180,0,10,449,459,16,4,20,479,12,46,Nevada,Reno,225221
12802,1957-1958,1957-10-20,1958-04-07,170,0,0,279,279,50,11,61,340,26,85,Nevada,Reno,225221
12803,1958-1959,1958-11-14,1959-05-02,170,0,5,329,334,40,37,77,411,10,70,Nevada,Reno,225221
12804,1959-1960,1959-12-01,1960-04-22,144,0,12,321,333,33,50,83,416,18,75,Nevada,Reno,225221
12805,1960-1961,1960-10-09,1961-04-23,197,0,0,398,398,13,1,14,412,9,20,Nevada,Reno,225221
12806,1961-1962,1961-11-15,1962-05-16,183,0,25,388,413,70,39,109,522,21,131,Nevada,Reno,225221
12807,1962-1963,1962-12-01,1963-04-21,142,0,5,323,328,16,6,22,350,11,36,Nevada,Reno,225221
12808,1963-1964,1963-11-20,1964-05-06,169,0,1,356,357,59,27,86,443,19,90,Nevada,Reno,225221
12809,1964-1965,1964-11-12,1965-03-27,136,0,14,252,266,34,32,66,332,16,80,Nevada,Reno,225221
12810,1965-1966,1965-11-24,1966-03-01,98,0,8,264,272,24,11,35,307,14,58,Nevada,Reno,225221
12811,1966-1967,1966-12-01,1967-05-31,182,0,2,223,225,60,46,106,331,19,84,Nevada,Reno,225221
12812,1967-1968,1967-12-01,1968-03-16,107,0,9,253,262,30,22,52,314,11,50,Nevada,Reno,225221
12813,1968-1969,1968-11-14,1969-04-24,162,0,7,263,270,68,45,113,383,21,113,Nevada,Reno,225221
12814,1969-1970,1969-12-01,1970-04-27,148,0,2,246,248,13,6,19,267,9,26,Nevada,Reno,225221
12815,1970-1971,1970-10-25,1971-05-21,209,0,28,346,374,73,86,159,533,27,138,Nevada,Reno,225221
12816,1971-1972,1971-10-16,1972-04-13,181,0,25,421,446,54,126,180,626,19,101,Nevada,Reno,225221
12817,1972-1973,1972-12-01,1973-04-17,138,0,41,327,368,58,87,145,513,28,155,Nevada,Reno,225221
12818,1973-1974,1973-11-13,1974-04-24,163,0,15,261,276,44,52,96,372,21,88,Nevada,Reno,225221
12819,1974-1975,1974-12-01,1975-05-20,171,0,13,339,352,67,46,113,465,32,127,Nevada,Reno,225221
12820,1975-1976,1975-11-27,1976-04-15,141,0,5,362,367,40,31,71,438,16,80,Nevada,Reno,225221
12821,1976-1977,1976-12-01,1977-05-16,167,0,1,349,350,16,1,17,367,13,34,Nevada,Reno,225221
12822,1977-1978,1977-11-21,1978-05-24,185,0,0,169,169,22,8,30,199,15,43,Nevada,Reno,225221
12823,1978-1979,1978-10-31,1979-05-07,189,0,26,375,401,53,70,123,524,30,115,Nevada,Reno,225221
12824,1979-1980,1979-10-20,1980-04-02,166,0,2,263,265,36,12,48,313,19,60,Nevada,Reno,225221
12825,1980-1981,1980-12-01,1981-03-29,119,0,1,200,201,10,2,12,213,6,16,Nevada,Reno,225221
12826,1981-1982,1981-10-11,1982-05-09,211,0,10,277,287,42,48,90,377,23,79,Nevada,Reno,225221
12827,1982-1983,1982-09-29,1983-05-10,224,0,1,280,281,37,15,52,333,23,64,Nevada,Reno,225221
12828,1983-1984,1983-11-13,1984-03-16,125,0,7,175,182,26,29,55,237,15,52,Nevada,Reno,225221
12829,1984-1985,1984-10-16,1985-03-28,164,0,6,300,306,36,15,51,357,23,78,Nevada,Reno,225221
12830,1985-1986,1985-10-08,1986-04-01,176,0,13,217,230,36,47,83,313,12,68,Nevada,Reno,225221
12831,1986-1987,1986-11-29,1987-03-23,115,0,5,210,215,24,11,35,250,14,51,Nevada,Reno,225221
12832,1987-1988,1987-11-24,1988-02-29,98,0,8,213,221,28,27,55,276,16,62,Nevada,Reno,225221
12833,1988-1989,1988-11-23,1989-04-24,153,0,25,281,306,53,132,185,491,22,129,Nevada,Reno,225221
12834,1989-1990,1989-12-01,1990-03-11,101,0,6,241,247,46,75,121,368,15,87,Nevada,Reno,225221
12835,1990-1991,1990-11-25,1991-05-09,166,0,25,316,341,19,22,41,382,16,45,Nevada,Reno,225221
12836,1991-1992,1991-11-14,1992-02-29,108,0,1,189,190,15,2,17,207,8,23,Nevada,Reno,225221
12837,1992-1993,1992-12-01,1993-02-28,90,0,20,223,243,72,150,222,465,26,156,Nevada,Reno,225221
12838,1993-1994,1993-12-01,1994-02-28,90,0,0,142,142,11,4,15,157,9,18,Nevada,Reno,225221
12839,1994-1995,1994-11-03,1995-06-07,217,0,1,172,173,44,36,80,253,22,74,Nevada,Reno,225221
12840,2004-2005,2004-11-27,2005-02-28,94,1,12,163,175,67,209,276,451,10,84,Nevada,Reno,225221
12841,2005-2006,2005-12-01,2006-04-17,138,0,0,141,141,35,19,54,195,20,65,Nevada,Reno,225221
12842,2006-2007,2006-12-01,2007-04-17,138,0,5,192,197,14,5,19,216,9,26,Nevada,Reno,225221
12843,2007-2008,2007-09-28,2008-03-16,171,0,6,181,187,40,32,72,259,18,72,Nevada,Reno,225221
12844,2008-2009,2008-10-10,2009-04-03,176,0,3,180,183,25,13,38,221,16,48,Nevada,Reno,225221
12845,2009-2010,2009-10-27,2010-04-21,177,0,15,199,214,52,153,205,419,17,86,Nevada,Reno,225221
12846,2010-2011,2010-11-20,2011-04-07,139,0,7,176,183,50,39,89,272,21,82,Nevada,Reno,225221
12847,2011-2012,2011-12-01,2012-05-25,177,0,1,187,188,13,7,20,208,8,21,Nevada,Reno,225221
12848,2012-2013,2012-11-10,2013-03-06,117,0,12,187,199,15,23,38,237,11,41,Nevada,Reno,225221
12849,2013-2014,2013-11-20,2014-02-28,101,0,12,184,196,13,27,40,236,10,33,Nevada,Reno,225221
12850,2014-2015,2014-12-01,2015-02-28,90,0,2,84,86,4,1,5,91,3,7,Nevada,Reno,225221
12851,2015-2016,2015-11-09,2016-03-29,142,0,8,147,155,46,36,82,237,19,69,Nevada,Reno,225221
12852,2016-2017,2016-11-27,2017-03-05,99,0,4,125,129,39,43,82,211,14,59,Nevada,Reno,225221
12853,2017-2018,2017-12-01,2018-04-19,140,0,2,163,165,37,20,57,222,12,51,Nevada,Reno,225221
12854,2018-2019,2018-12-01,2019-03-23,113,0,1,115,116,41,29,70,186,18,60,Nevada,Reno,225221
12855,2019-2020,2019-11-28,2020-04-06,131,0,1,124,125,25,15,40,165,14,40,Nevada,Reno,225221
12856,1950-1951,1950-11-14,1951-03-29,136,0,12,264,276,32,14,46,322,21,90,Nevada,Winnemucca,7396
12857,1951-1952,1951-11-20,1952-03-20,122,0,27,313,340,78,37,115,455,33,155,Nevada,Winnemucca,7396
12858,1952-1953,1952-12-01,1953-05-25,176,0,2,312,314,13,5,18,332,8,30,Nevada,Winnemucca,7396
12859,1953-1954,1953-11-20,1954-03-29,130,0,2,327,329,21,7,28,357,15,56,Nevada,Winnemucca,7396
12860,1954-1955,1954-12-01,1955-04-25,146,0,25,506,531,34,139,173,704,19,103,Nevada,Winnemucca,7396
12861,1955-1956,1955-11-13,1956-04-14,154,0,17,335,352,51,52,103,455,22,109,Nevada,Winnemucca,7396
12862,1956-1957,1956-10-30,1957-03-31,153,0,17,477,494,33,75,108,602,13,76,Nevada,Winnemucca,7396
12863,1957-1958,1957-11-04,1958-04-07,155,0,1,340,341,33,11,44,385,16,57,Nevada,Winnemucca,7396
12864,1958-1959,1958-11-14,1959-02-28,107,0,7,279,286,30,34,64,350,14,67,Nevada,Winnemucca,7396
12865,1959-1960,1959-12-01,1960-05-04,156,0,17,424,441,28,58,86,527,21,115,Nevada,Winnemucca,7396
12866,1960-1961,1960-11-14,1961-04-24,162,0,1,404,405,12,2,14,419,12,29,Nevada,Winnemucca,7396
12867,1961-1962,1961-10-28,1962-05-20,205,0,31,500,531,65,169,234,765,25,138,Nevada,Winnemucca,7396
12868,1962-1963,1962-11-16,1963-04-19,155,0,15,443,458,27,8,35,493,17,62,Nevada,Winnemucca,7396
12869,1963-1964,1963-11-20,1964-05-02,165,0,5,406,411,65,70,135,546,32,131,Nevada,Winnemucca,7396
12870,1964-1965,1964-11-11,1965-05-24,195,0,15,364,379,44,49,93,472,28,114,Nevada,Winnemucca,7396
12871,1965-1966,1965-11-24,1966-03-03,100,0,7,298,305,28,31,59,364,18,74,Nevada,Winnemucca,7396
12872,1966-1967,1966-12-01,1967-04-27,148,0,2,279,281,48,41,89,370,22,87,Nevada,Winnemucca,7396
12873,1967-1968,1967-11-28,1968-03-17,111,0,11,277,288,26,41,67,355,13,62,Nevada,Winnemucca,7396
12874,1968-1969,1968-11-14,1969-04-24,162,0,8,291,299,68,96,164,463,37,154,Nevada,Winnemucca,7396
12875,1969-1970,1969-10-18,1970-05-10,205,0,8,475,483,34,31,65,548,15,59,Nevada,Winnemucca,7396
12876,1970-1971,1970-10-25,1971-05-21,209,0,19,424,443,47,21,68,511,31,119,Nevada,Winnemucca,7396
12877,1971-1972,1971-09-30,1972-04-13,197,0,20,478,498,64,96,160,658,34,152,Nevada,Winnemucca,7396
12878,1972-1973,1972-10-28,1973-04-19,174,0,53,430,483,60,90,150,633,33,175,Nevada,Winnemucca,7396
12879,1973-1974,1973-11-17,1974-04-27,162,0,11,299,310,51,33,84,394,31,125,Nevada,Winnemucca,7396
12880,1974-1975,1974-12-01,1975-05-20,171,0,23,345,368,53,59,112,480,33,127,Nevada,Winnemucca,7396
12881,1975-1976,1975-11-10,1976-04-25,168,0,6,355,361,34,8,42,403,20,72,Nevada,Winnemucca,7396
12882,1976-1977,1976-12-01,1977-05-17,168,0,4,473,477,23,14,37,514,15,42,Nevada,Winnemucca,7396
12883,1977-1978,1977-11-19,1978-05-24,187,0,2,184,186,38,13,51,237,23,68,Nevada,Winnemucca,7396
12884,1978-1979,1978-11-10,1979-05-07,179,0,23,420,443,55,48,103,546,36,139,Nevada,Winnemucca,7396
12885,1979-1980,1979-11-22,1980-04-02,133,0,5,270,275,16,8,24,299,15,52,Nevada,Winnemucca,7396
12886,1980-1981,1980-12-01,1981-03-29,119,0,1,317,318,13,1,14,332,12,29,Nevada,Winnemucca,7396
12887,1981-1982,1981-11-26,1982-04-06,132,0,15,233,248,50,19,69,317,31,111,Nevada,Winnemucca,7396
12888,1982-1983,1982-11-09,1983-05-11,184,0,6,288,294,34,53,87,381,19,59,Nevada,Winnemucca,7396
12889,1983-1984,1983-11-19,1984-04-27,161,0,33,299,332,52,87,139,471,36,143,Nevada,Winnemucca,7396
12890,1984-1985,1984-10-15,1985-04-25,193,0,37,529,566,57,222,279,845,32,159,Nevada,Winnemucca,7396
12891,1985-1986,1985-11-08,1986-05-05,179,0,24,307,331,44,50,94,425,24,98,Nevada,Winnemucca,7396
12892,1986-1987,1986-09-26,1987-04-18,205,0,7,479,486,27,14,41,527,19,68,Nevada,Winnemucca,7396
12893,1987-1988,1987-11-24,1988-05-06,165,0,15,377,392,24,57,81,473,15,61,Nevada,Winnemucca,7396
12894,1988-1989,1988-11-15,1989-04-24,161,0,40,420,460,41,125,166,626,26,129,Nevada,Winnemucca,7396
12895,1989-1990,1989-10-27,1990-03-11,136,0,11,391,402,28,37,65,467,16,73,Nevada,Winnemucca,7396
12896,1990-1991,1990-11-25,1991-04-25,152,0,58,479,537,37,89,126,663,18,78,Nevada,Winnemucca,7396
12897,1991-1992,1991-10-23,1992-03-16,146,1,7,289,296,16,3,19,315,14,42,Nevada,Winnemucca,7396
12898,1992-1993,1992-11-19,1993-04-11,144,1,28,368,396,57,172,229,625,30,158,Nevada,Winnemucca,7396
12899,1993-1994,1993-11-13,1994-04-25,164,0,3,391,394,26,13,39,433,16,55,Nevada,Winnemucca,7396
12900,1994-1995,1994-11-12,1995-06-06,207,0,12,266,278,36,30,66,344,22,73,Nevada,Winnemucca,7396
12901,2001-2002,2001-11-24,2002-04-18,146,0,10,298,308,34,28,62,370,20,83,Nevada,Winnemucca,7396
12902,2002-2003,2002-12-01,2003-05-09,160,0,3,256,259,13,1,14,273,11,29,Nevada,Winnemucca,7396
12903,2003-2004,2003-10-30,2004-02-29,123,0,12,251,263,47,48,95,358,26,89,Nevada,Winnemucca,7396
12904,2004-2005,2004-10-26,2005-03-28,154,0,28,333,361,45,217,262,623,25,92,Nevada,Winnemucca,7396
12905,2005-2006,2005-11-26,2006-04-17,143,0,9,282,291,42,31,73,364,21,86,Nevada,Winnemucca,7396
12906,2006-2007,2006-11-11,2007-04-18,159,0,18,450,468,28,50,78,546,12,62,Nevada,Winnemucca,7396
12907,2007-2008,2007-11-27,2008-04-20,146,0,16,340,356,37,42,79,435,26,100,Nevada,Winnemucca,7396
12908,2008-2009,2008-10-11,2009-04-16,188,0,15,425,440,53,73,126,566,24,141,Nevada,Winnemucca,7396
12909,2009-2010,2009-11-12,2010-05-11,181,0,12,388,400,38,60,98,498,24,89,Nevada,Winnemucca,7396
12910,2010-2011,2010-11-10,2011-04-29,171,0,20,318,338,61,99,160,498,30,121,Nevada,Winnemucca,7396
12911,2011-2012,2011-11-04,2012-03-19,137,0,1,454,455,36,24,60,515,17,76,Nevada,Winnemucca,7396
12912,2012-2013,2012-10-23,2013-02-28,129,0,47,417,464,35,151,186,650,20,84,Nevada,Winnemucca,7396
12913,2013-2014,2013-10-28,2014-04-02,157,0,32,415,447,32,106,138,585,13,76,Nevada,Winnemucca,7396
12914,2014-2015,2014-11-13,2015-04-25,164,0,3,289,292,9,2,11,303,6,18,Nevada,Winnemucca,7396
12915,2015-2016,2015-11-25,2016-03-28,125,0,18,239,257,34,45,79,336,23,86,Nevada,Winnemucca,7396
12916,2016-2017,2016-11-27,2017-05-13,168,0,25,286,311,30,63,93,404,22,83,Nevada,Winnemucca,7396
12917,2017-2018,2017-12-01,2018-04-19,140,0,3,307,310,44,38,82,392,20,92,Nevada,Winnemucca,7396
12918,2018-2019,2018-11-29,2019-04-30,153,0,15,240,255,62,102,164,419,31,126,Nevada,Winnemucca,7396
12919,2019-2020,2019-09-29,2020-06-07,253,0,4,439,443,22,11,33,476,17,55,Nevada,Winnemucca,7396
12920,1950-1951,1950-11-22,1951-03-30,129,11,105,485,590,92,289,381,971,29,220,New Hampshire,Berlin,10051
12921,1951-1952,1951-11-02,1952-03-31,151,14,117,603,720,135,687,822,1542,24,271,New Hampshire,Berlin,10051
12922,1953-1954,1953-11-06,1954-04-18,164,17,110,539,649,171,417,588,1237,32,337,New Hampshire,Berlin,10051
12923,1955-1956,1955-11-18,1956-04-03,138,7,166,663,829,147,713,860,1689,34,302,New Hampshire,Berlin,10051
12924,1958-1959,1958-11-22,1959-04-29,159,19,170,733,903,122,600,722,1625,44,384,New Hampshire,Berlin,10051
12925,1959-1960,1959-10-19,1960-04-10,175,10,99,538,637,162,701,863,1500,52,354,New Hampshire,Berlin,10051
12926,1960-1961,1960-12-01,1961-04-17,138,1,135,644,779,143,648,791,1570,40,340,New Hampshire,Berlin,10051
12927,1962-1963,1962-10-25,1963-05-11,199,6,137,679,816,147,701,848,1664,39,304,New Hampshire,Berlin,10051
12928,1963-1964,1963-10-30,1964-04-06,160,0,121,645,766,157,455,612,1378,46,374,New Hampshire,Berlin,10051
12929,1964-1965,1964-10-21,1965-04-18,180,0,146,676,822,107,515,622,1444,53,417,New Hampshire,Berlin,10051
12930,1965-1966,1965-11-02,1966-05-11,191,7,111,602,713,145,613,758,1471,37,290,New Hampshire,Berlin,10051
12931,1966-1967,1966-11-05,1967-05-08,185,0,148,686,834,112,615,727,1561,41,311,New Hampshire,Berlin,10051
12932,1967-1968,1967-11-15,1968-03-25,132,1,185,700,885,123,671,794,1679,45,413,New Hampshire,Berlin,10051
12933,1970-1971,1970-12-01,1971-04-18,139,0,194,704,898,215,1097,1312,2210,62,585,New Hampshire,Berlin,10051
12934,1974-1975,1974-11-22,1975-04-17,147,1,101,589,690,132,791,923,1613,31,246,New Hampshire,Berlin,10051
12935,1975-1976,1975-11-26,1976-04-26,153,2,155,705,860,122,549,671,1531,29,303,New Hampshire,Berlin,10051
12936,1976-1977,1976-10-28,1977-04-08,163,1,192,676,868,127,793,920,1788,27,275,New Hampshire,Berlin,10051
12937,1977-1978,1977-11-15,1978-05-01,168,1,180,718,898,170,1181,1351,2249,30,334,New Hampshire,Berlin,10051
12938,1978-1979,1978-11-21,1979-04-11,142,0,191,608,799,132,793,925,1724,32,315,New Hampshire,Berlin,10051
12939,1982-1983,1982-11-16,1983-04-13,149,12,84,498,582,80,361,441,1023,19,147,New Hampshire,Berlin,10051
12940,1983-1984,1983-11-05,1984-04-10,158,8,126,602,728,134,759,893,1621,24,247,New Hampshire,Berlin,10051
12941,1984-1985,1984-11-14,1985-04-07,145,11,111,565,676,119,563,682,1358,32,256,New Hampshire,Berlin,10051
12942,1985-1986,1985-11-16,1986-03-26,131,6,139,553,692,98,837,935,1627,20,195,New Hampshire,Berlin,10051
12943,1986-1987,1986-11-05,1987-04-30,177,18,126,590,716,160,1192,1352,2068,25,274,New Hampshire,Berlin,10051
12944,1987-1988,1987-11-06,1988-04-17,164,2,122,604,726,113,763,876,1602,23,225,New Hampshire,Berlin,10051
12945,1988-1989,1988-11-30,1989-04-11,133,12,131,559,690,64,208,272,962,24,162,New Hampshire,Berlin,10051
12946,1989-1990,1989-11-05,1990-04-06,153,2,170,626,796,124,590,714,1510,31,285,New Hampshire,Berlin,10051
12947,1990-1991,1990-11-09,1991-03-27,139,7,98,467,565,90,465,555,1120,20,183,New Hampshire,Berlin,10051
12948,1991-1992,1991-11-12,1992-04-18,159,2,153,610,763,96,440,536,1299,21,190,New Hampshire,Berlin,10051
12949,1992-1993,1992-11-06,1993-04-11,157,3,149,646,795,154,711,865,1660,34,364,New Hampshire,Berlin,10051
12950,1994-1995,1994-11-24,1995-04-16,144,1,116,512,628,96,526,622,1250,22,198,New Hampshire,Berlin,10051
12951,1995-1996,1995-11-10,1996-04-18,161,1,183,617,800,192,812,1004,1804,43,382,New Hampshire,Berlin,10051
12952,1996-1997,1996-11-14,1997-04-13,151,1,119,513,632,112,521,633,1265,28,236,New Hampshire,Berlin,10051
12953,1997-1998,1997-10-27,1998-03-28,153,5,76,474,550,138,643,781,1331,32,245,New Hampshire,Berlin,10051
12954,1998-1999,1998-11-18,1999-03-31,134,2,86,453,539,110,520,630,1169,26,258,New Hampshire,Berlin,10051
12955,1999-2000,1999-11-13,2000-04-12,152,2,125,468,593,95,391,486,1079,26,214,New Hampshire,Berlin,10051
12956,2000-2001,2000-10-29,2001-04-23,177,5,144,627,771,180,1020,1200,1971,35,326,New Hampshire,Berlin,10051
12957,2001-2002,2001-11-05,2002-05-14,191,1,63,432,495,105,548,653,1148,29,193,New Hampshire,Berlin,10051
12958,2002-2003,2002-11-02,2003-04-09,159,5,190,690,880,109,802,911,1791,29,218,New Hampshire,Berlin,10051
12959,2003-2004,2003-10-23,2004-04-06,167,13,174,599,773,127,816,943,1716,24,246,New Hampshire,Berlin,10051
12960,2004-2005,2004-11-05,2005-04-03,150,3,154,600,754,132,574,706,1460,27,308,New Hampshire,Berlin,10051
12961,2005-2006,2005-10-26,2006-04-07,164,3,118,461,579,73,272,345,924,22,165,New Hampshire,Berlin,10051
12962,2006-2007,2006-11-21,2007-04-19,150,5,153,550,703,120,468,588,1291,24,236,New Hampshire,Berlin,10051
12963,2007-2008,2007-11-17,2008-04-10,146,7,118,564,682,169,913,1082,1764,39,355,New Hampshire,Berlin,10051
12964,2008-2009,2008-11-19,2009-03-27,129,6,163,624,787,145,782,927,1714,26,300,New Hampshire,Berlin,10051
12965,2009-2010,2009-10-13,2010-04-29,199,16,118,442,560,122,558,680,1240,26,206,New Hampshire,Berlin,10051
12966,2010-2011,2010-11-26,2011-04-17,143,9,131,611,742,181,914,1095,1837,34,353,New Hampshire,Berlin,10051
12967,2011-2012,2011-10-30,2012-03-28,151,1,58,430,488,84,345,429,917,21,160,New Hampshire,Berlin,10051
12968,2012-2013,2012-11-25,2013-04-13,140,1,96,437,533,135,684,819,1352,34,277,New Hampshire,Berlin,10051
12969,2013-2014,2013-11-13,2014-04-16,155,1,181,705,886,118,704,822,1708,28,290,New Hampshire,Berlin,10051
12970,2014-2015,2014-11-14,2015-04-10,148,4,184,734,918,151,804,955,1873,39,392,New Hampshire,Berlin,10051
12971,2015-2016,2015-11-25,2016-04-07,135,0,78,425,503,53,174,227,730,19,155,New Hampshire,Berlin,10051
12972,2016-2017,2016-11-21,2017-04-09,140,1,118,493,611,183,758,941,1552,43,371,New Hampshire,Berlin,10051
12973,2017-2018,2017-11-10,2018-04-20,162,0,156,596,752,161,726,887,1639,49,412,New Hampshire,Berlin,10051
12974,2018-2019,2018-10-18,2019-04-13,178,0,159,692,851,187,1002,1189,2040,57,466,New Hampshire,Berlin,10051
12975,2019-2020,2019-11-09,2020-05-09,183,0,101,553,654,146,637,783,1437,49,350,New Hampshire,Berlin,10051
12976,1950-1951,1950-12-01,1951-03-26,116,0,45,333,378,52,132,184,562,24,166,New Hampshire,Concord,42695
12977,1951-1952,1951-11-01,1952-04-01,153,0,60,465,525,127,740,867,1392,36,288,New Hampshire,Concord,42695
12978,1952-1953,1952-10-28,1953-04-20,175,0,33,360,393,54,160,214,607,27,135,New Hampshire,Concord,42695
12979,1953-1954,1953-11-07,1954-04-01,146,3,62,377,439,58,125,183,622,29,178,New Hampshire,Concord,42695
12980,1954-1955,1954-11-24,1955-04-03,131,0,65,382,447,62,110,172,619,27,153,New Hampshire,Concord,42695
12981,1955-1956,1955-11-11,1956-04-24,166,0,79,500,579,129,578,707,1286,47,302,New Hampshire,Concord,42695
12982,1956-1957,1956-11-10,1957-04-10,152,0,73,503,576,109,435,544,1120,29,252,New Hampshire,Concord,42695
12983,1957-1958,1957-12-01,1958-04-28,149,3,56,348,404,95,487,582,986,33,174,New Hampshire,Concord,42695
12984,1958-1959,1958-11-28,1959-04-01,125,0,85,537,622,101,472,573,1195,30,237,New Hampshire,Concord,42695
12985,1959-1960,1959-11-18,1960-03-31,135,0,39,377,416,86,551,637,1053,34,193,New Hampshire,Concord,42695
12986,1960-1961,1960-12-01,1961-04-14,135,0,85,544,629,86,590,676,1305,24,184,New Hampshire,Concord,42695
12987,1961-1962,1961-11-20,1962-04-13,145,0,74,457,531,99,641,740,1271,32,237,New Hampshire,Concord,42695
12988,1962-1963,1962-11-18,1963-04-23,157,0,82,520,602,87,636,723,1325,31,190,New Hampshire,Concord,42695
12989,1963-1964,1963-12-01,1964-03-29,120,0,74,460,534,102,477,579,1113,29,242,New Hampshire,Concord,42695
12990,1964-1965,1964-12-01,1965-04-18,139,0,88,436,524,60,215,275,799,30,186,New Hampshire,Concord,42695
12991,1965-1966,1965-11-18,1966-05-08,172,0,51,487,538,93,456,549,1087,27,159,New Hampshire,Concord,42695
12992,1966-1967,1966-12-01,1967-04-19,140,0,68,491,559,113,615,728,1287,34,230,New Hampshire,Concord,42695
12993,1967-1968,1967-11-15,1968-03-17,124,0,95,503,598,85,441,526,1124,27,203,New Hampshire,Concord,42695
12994,1968-1969,1968-11-10,1969-04-06,148,3,80,482,562,118,768,886,1448,33,208,New Hampshire,Concord,42695
12995,1969-1970,1969-10-22,1970-04-03,164,0,113,564,677,85,498,583,1260,34,243,New Hampshire,Concord,42695
12996,1970-1971,1970-12-01,1971-04-16,137,0,121,541,662,133,956,1089,1751,39,307,New Hampshire,Concord,42695
12997,1971-1972,1971-11-09,1972-04-20,164,0,79,526,605,140,588,728,1333,43,302,New Hampshire,Concord,42695
12998,1972-1973,1972-11-05,1973-04-11,158,0,102,457,559,88,609,697,1256,35,240,New Hampshire,Concord,42695
12999,1973-1974,1973-12-01,1974-04-11,132,0,80,420,500,59,184,243,743,26,158,New Hampshire,Concord,42695
13000,1974-1975,1974-11-21,1975-04-06,137,0,57,484,541,100,545,645,1186,36,228,New Hampshire,Concord,42695
13001,1975-1976,1975-11-24,1976-03-20,118,0,124,533,657,106,428,534,1191,34,332,New Hampshire,Concord,42695
13002,1976-1977,1976-11-09,1977-04-08,151,0,136,628,764,123,570,693,1457,34,305,New Hampshire,Concord,42695
13003,1977-1978,1977-11-27,1978-04-01,126,0,134,559,693,118,584,702,1395,31,297,New Hampshire,Concord,42695
13004,1978-1979,1978-11-21,1979-04-11,142,0,118,467,585,112,521,633,1218,32,245,New Hampshire,Concord,42695
13005,1979-1980,1979-10-10,1980-03-17,160,0,71,458,529,41,56,97,626,14,90,New Hampshire,Concord,42695
13006,1980-1981,1980-11-17,1981-03-27,131,0,103,521,624,81,168,249,873,28,205,New Hampshire,Concord,42695
13007,1981-1982,1981-12-01,1982-04-12,133,0,110,539,649,131,841,972,1621,43,332,New Hampshire,Concord,42695
13008,1982-1983,1982-11-24,1983-03-28,125,0,53,333,386,56,123,179,565,22,119,New Hampshire,Concord,42695
13009,1983-1984,1983-12-01,1984-04-01,123,0,93,452,545,112,402,514,1059,34,254,New Hampshire,Concord,42695
13010,1984-1985,1984-11-20,1985-04-18,150,0,80,425,505,71,199,270,775,28,193,New Hampshire,Concord,42695
13011,1985-1986,1985-11-16,1986-03-21,126,0,73,441,514,73,409,482,996,31,189,New Hampshire,Concord,42695
13012,1986-1987,1986-11-06,1987-04-29,175,0,54,472,526,118,601,719,1245,32,214,New Hampshire,Concord,42695
13013,1987-1988,1987-11-06,1988-04-16,163,0,71,474,545,96,407,503,1048,33,194,New Hampshire,Concord,42695
13014,1988-1989,1988-11-20,1989-04-08,140,0,68,443,511,50,57,107,618,32,164,New Hampshire,Concord,42695
13015,1989-1990,1989-11-20,1990-03-31,132,0,98,492,590,92,335,427,1017,29,229,New Hampshire,Concord,42695
13016,1990-1991,1990-11-12,1991-04-02,142,0,49,369,418,48,119,167,585,21,109,New Hampshire,Concord,42695
13017,1991-1992,1991-11-11,1992-04-18,160,0,69,445,514,54,100,154,668,36,209,New Hampshire,Concord,42695
13018,1992-1993,1992-11-17,1993-04-27,162,0,84,496,580,142,442,584,1164,41,307,New Hampshire,Concord,42695
13019,1993-1994,1993-11-20,1994-03-28,129,0,129,546,675,124,605,729,1404,41,369,New Hampshire,Concord,42695
13020,1994-1995,1994-11-24,1995-04-05,133,0,57,372,429,51,131,182,611,23,131,New Hampshire,Concord,42695
13021,1995-1996,1995-11-09,1996-04-11,155,0,107,496,603,156,460,616,1219,49,372,New Hampshire,Concord,42695
13022,1996-1997,1996-11-14,1997-04-09,147,2,60,380,440,107,343,450,890,39,244,New Hampshire,Concord,42695
13023,1997-1998,1997-11-14,1998-03-26,133,0,29,318,347,88,317,405,752,31,169,New Hampshire,Concord,42695
13024,1998-1999,1998-11-16,1999-03-16,121,0,52,347,399,60,185,245,644,26,161,New Hampshire,Concord,42695
13025,1999-2000,1999-12-01,2000-03-21,112,1,69,357,426,71,234,305,731,18,146,New Hampshire,Concord,42695
13026,2001-2002,2001-12-01,2002-04-26,147,0,23,296,319,48,161,209,528,20,95,New Hampshire,Concord,42695
13027,2002-2003,2002-10-23,2003-04-09,169,0,111,597,708,127,828,955,1663,42,294,New Hampshire,Concord,42695
13028,2003-2004,2003-12-01,2004-03-23,114,3,96,401,497,78,385,463,960,23,171,New Hampshire,Concord,42695
13029,2004-2005,2004-11-02,2005-04-02,152,0,86,464,550,116,556,672,1222,34,295,New Hampshire,Concord,42695
13030,2005-2006,2005-11-23,2006-03-20,118,0,57,359,416,71,314,385,801,19,137,New Hampshire,Concord,42695
13031,2006-2007,2006-12-01,2007-04-15,136,0,78,383,461,73,291,364,825,23,147,New Hampshire,Concord,42695
13032,2007-2008,2007-11-20,2008-04-14,147,0,55,440,495,167,1235,1402,1897,37,293,New Hampshire,Concord,42695
13033,2009-2010,2009-12-01,2010-03-05,95,2,56,272,328,74,420,494,822,19,126,New Hampshire,Concord,42695
13034,2010-2011,2010-12-01,2011-04-23,144,2,73,452,525,116,737,853,1378,26,238,New Hampshire,Concord,42695
13035,2011-2012,2011-10-27,2012-03-11,137,0,30,308,338,68,204,272,610,19,122,New Hampshire,Concord,42695
13036,2012-2013,2012-11-08,2013-04-12,156,0,54,386,440,122,462,584,1024,35,241,New Hampshire,Concord,42695
13037,2013-2014,2013-11-24,2014-04-16,144,0,110,539,649,118,816,934,1583,36,314,New Hampshire,Concord,42695
13038,2014-2015,2014-11-17,2015-04-11,146,0,103,519,622,132,773,905,1527,37,305,New Hampshire,Concord,42695
13039,2015-2016,2015-12-01,2016-04-05,127,0,36,265,301,42,213,255,556,18,102,New Hampshire,Concord,42695
13040,2016-2017,2016-11-20,2017-04-09,141,0,49,359,408,123,742,865,1273,36,254,New Hampshire,Concord,42695
13041,2017-2018,2017-11-13,2018-04-16,155,0,80,404,484,125,599,724,1208,30,220,New Hampshire,Concord,42695
13042,2018-2019,2018-11-14,2019-04-09,147,0,70,426,496,76,461,537,1033,32,177,New Hampshire,Concord,42695
13043,2019-2020,2019-11-12,2020-05-09,180,0,43,363,406,68,410,478,884,30,154,New Hampshire,Concord,42695
13044,1951-1952,1951-11-01,1952-03-20,141,0,40,349,389,131,383,514,903,26,195,New Hampshire,Durham,14638
13045,1952-1953,1952-11-09,1953-04-14,157,1,17,276,293,48,115,163,456,20,91,New Hampshire,Durham,14638
13046,1953-1954,1953-11-07,1954-04-01,146,2,41,303,344,44,91,135,479,21,124,New Hampshire,Durham,14638
13047,1954-1955,1954-11-25,1955-03-27,123,3,42,310,352,73,208,281,633,27,151,New Hampshire,Durham,14638
13048,1955-1956,1955-10-25,1956-04-23,182,1,54,431,485,152,668,820,1305,44,260,New Hampshire,Durham,14638
13049,1956-1957,1956-11-18,1957-04-09,143,2,51,394,445,102,429,531,976,31,224,New Hampshire,Durham,14638
13050,1957-1958,1957-12-01,1958-03-28,118,3,33,278,311,68,374,442,753,14,102,New Hampshire,Durham,14638
13051,1959-1960,1959-11-29,1960-04-03,127,3,25,347,372,92,620,712,1084,24,159,New Hampshire,Durham,14638
13052,1960-1961,1960-12-01,1961-04-14,135,1,65,490,555,111,678,789,1344,18,177,New Hampshire,Durham,14638
13053,1961-1962,1961-11-20,1962-04-16,148,1,53,436,489,87,652,739,1228,23,174,New Hampshire,Durham,14638
13054,1962-1963,1962-10-26,1963-03-26,152,2,53,462,515,85,621,706,1221,30,172,New Hampshire,Durham,14638
13055,1964-1965,1964-12-01,1965-03-29,119,1,60,379,439,47,199,246,685,20,127,New Hampshire,Durham,14638
13056,1965-1966,1965-12-01,1966-03-28,118,1,33,339,372,93,531,624,996,19,150,New Hampshire,Durham,14638
13057,1966-1967,1966-12-01,1967-04-08,129,1,46,407,453,120,496,616,1069,34,234,New Hampshire,Durham,14638
13058,1967-1968,1967-11-15,1968-03-18,125,19,61,486,547,80,460,540,1087,15,148,New Hampshire,Durham,14638
13059,1968-1969,1968-11-13,1969-03-30,138,14,42,421,463,107,720,827,1290,21,161,New Hampshire,Durham,14638
13060,1969-1970,1969-10-22,1970-03-31,161,0,60,466,526,92,355,447,973,22,159,New Hampshire,Durham,14638
13061,1970-1971,1970-12-01,1971-04-07,128,8,81,487,568,138,915,1053,1621,31,255,New Hampshire,Durham,14638
13062,1971-1972,1971-11-11,1972-04-20,162,1,50,453,503,142,404,546,1049,24,221,New Hampshire,Durham,14638
13063,1972-1973,1972-11-14,1973-04-05,143,2,50,310,360,75,475,550,910,17,120,New Hampshire,Durham,14638
13064,1974-1975,1974-11-22,1975-04-05,135,7,24,348,372,68,295,363,735,20,103,New Hampshire,Durham,14638
13065,1975-1976,1975-11-24,1976-03-20,118,0,59,416,475,117,419,536,1011,24,199,New Hampshire,Durham,14638
13066,1976-1977,1976-11-10,1977-03-25,136,0,70,487,557,112,586,698,1255,19,180,New Hampshire,Durham,14638
13067,1977-1978,1977-11-28,1978-03-26,119,0,68,448,516,131,567,698,1214,21,225,New Hampshire,Durham,14638
13068,1978-1979,1978-11-21,1979-04-10,141,4,77,430,507,84,343,427,934,20,148,New Hampshire,Durham,14638
13069,1979-1980,1979-10-11,1980-03-17,159,1,41,428,469,36,53,89,558,9,57,New Hampshire,Durham,14638
13070,1980-1981,1980-11-18,1981-03-21,124,0,63,477,540,56,119,175,715,14,102,New Hampshire,Durham,14638
13071,1981-1982,1981-12-01,1982-04-12,133,6,66,467,533,130,659,789,1322,27,232,New Hampshire,Durham,14638
13072,1982-1983,1982-11-26,1983-03-01,96,6,35,284,319,74,252,326,645,13,108,New Hampshire,Durham,14638
13073,1983-1984,1983-12-01,1984-03-31,122,12,54,387,441,94,229,323,764,18,161,New Hampshire,Durham,14638
13074,1984-1985,1984-11-20,1985-04-16,148,0,47,419,466,53,143,196,662,17,130,New Hampshire,Durham,14638
13075,1985-1986,1985-11-22,1986-03-13,112,8,45,403,448,45,290,335,783,17,106,New Hampshire,Durham,14638
13076,1986-1987,1986-11-11,1987-03-24,134,1,35,395,430,84,649,733,1163,15,136,New Hampshire,Durham,14638
13077,1987-1988,1987-11-11,1988-03-21,132,2,45,368,413,68,335,403,816,13,105,New Hampshire,Durham,14638
13078,1988-1989,1988-12-01,1989-03-30,120,1,46,352,398,22,57,79,477,10,60,New Hampshire,Durham,14638
13079,1989-1990,1989-11-22,1990-03-11,110,2,75,395,470,60,338,398,868,14,118,New Hampshire,Durham,14638
13080,1990-1991,1990-11-13,1991-03-25,133,2,27,300,327,40,112,152,479,9,71,New Hampshire,Durham,14638
13081,1991-1992,1991-12-01,1992-04-18,140,1,51,373,424,39,119,158,582,13,97,New Hampshire,Durham,14638
13082,1992-1993,1992-11-17,1993-04-02,137,4,68,407,475,83,405,488,963,21,152,New Hampshire,Durham,14638
13083,1993-1994,1993-12-01,1994-03-19,109,0,98,415,513,67,489,556,1069,18,161,New Hampshire,Durham,14638
13084,1994-1995,1994-11-24,1995-03-07,104,0,39,284,323,29,174,203,526,8,65,New Hampshire,Durham,14638
13085,1995-1996,1995-11-29,1996-03-18,111,0,83,384,467,110,549,659,1126,24,226,New Hampshire,Durham,14638
13086,1996-1997,1996-11-15,1997-04-03,140,14,36,286,322,48,131,179,501,14,90,New Hampshire,Durham,14638
13087,1997-1998,1997-11-14,1998-03-23,130,2,19,256,275,50,221,271,546,12,79,New Hampshire,Durham,14638
13088,1998-1999,1998-12-01,1999-03-16,106,8,34,268,302,45,129,174,476,8,75,New Hampshire,Durham,14638
13089,1999-2000,1999-12-01,2000-03-19,110,3,50,286,336,34,181,215,551,9,74,New Hampshire,Durham,14638
13090,2014-2015,2014-11-18,2015-04-09,143,15,86,450,536,68,635,703,1239,23,161,New Hampshire,Durham,14638
13091,2015-2016,2015-12-01,2016-04-04,126,10,27,225,252,36,125,161,413,9,49,New Hampshire,Durham,14638
13092,2017-2018,2017-12-01,2018-04-15,136,3,85,364,449,87,316,403,852,16,150,New Hampshire,Durham,14638
13093,2018-2019,2018-11-15,2019-03-15,121,0,50,384,434,49,153,202,636,13,99,New Hampshire,Durham,14638
13094,2019-2020,2019-11-13,2020-03-24,133,4,32,319,351,52,202,254,605,13,83,New Hampshire,Durham,14638
13095,1950-1951,1950-12-01,1951-03-23,113,1,39,297,336,58,142,200,536,26,150,New Hampshire,Keene,23409
13096,1951-1952,1951-11-01,1952-03-20,141,0,40,396,436,125,435,560,996,38,243,New Hampshire,Keene,23409
13097,1952-1953,1952-10-29,1953-04-20,174,0,21,338,359,64,156,220,579,23,118,New Hampshire,Keene,23409
13098,1953-1954,1953-11-06,1954-04-01,147,5,38,338,376,61,137,198,574,24,141,New Hampshire,Keene,23409
13099,1954-1955,1954-11-29,1955-03-28,120,1,54,334,388,69,116,185,573,31,153,New Hampshire,Keene,23409
13100,1955-1956,1955-11-11,1956-04-26,168,0,65,490,555,141,471,612,1167,48,263,New Hampshire,Keene,23409
13101,1956-1957,1956-11-18,1957-04-10,144,0,53,450,503,116,354,470,973,36,247,New Hampshire,Keene,23409
13102,1957-1958,1957-12-01,1958-03-23,113,2,48,334,382,108,510,618,1000,27,189,New Hampshire,Keene,23409
13103,1958-1959,1958-11-03,1959-04-07,156,0,72,532,604,109,345,454,1058,41,255,New Hampshire,Keene,23409
13104,1959-1960,1959-11-29,1960-04-09,133,0,42,371,413,98,480,578,991,31,176,New Hampshire,Keene,23409
13105,1960-1961,1960-10-25,1961-04-17,175,3,76,631,707,99,628,727,1434,29,220,New Hampshire,Keene,23409
13106,1961-1962,1961-11-20,1962-04-14,146,4,58,435,493,124,652,776,1269,35,234,New Hampshire,Keene,23409
13107,1962-1963,1962-10-26,1963-03-28,154,1,64,578,642,111,718,829,1471,36,256,New Hampshire,Keene,23409
13108,1965-1966,1965-11-02,1966-05-08,188,1,46,450,496,84,349,433,929,34,201,New Hampshire,Keene,23409
13109,1966-1967,1966-11-06,1967-05-26,202,2,53,485,538,147,652,799,1337,39,255,New Hampshire,Keene,23409
13110,1967-1968,1967-11-10,1968-03-17,129,0,77,480,557,85,446,531,1088,34,207,New Hampshire,Keene,23409
13111,1968-1969,1968-11-11,1969-03-31,141,1,69,433,502,134,764,898,1400,35,222,New Hampshire,Keene,23409
13112,1969-1970,1969-10-23,1970-04-03,163,0,74,540,614,102,646,748,1362,36,234,New Hampshire,Keene,23409
13113,1970-1971,1970-12-01,1971-04-17,138,0,92,509,601,140,868,1008,1609,45,286,New Hampshire,Keene,23409
13114,1971-1972,1971-11-11,1972-04-14,156,4,62,462,524,134,425,559,1083,38,262,New Hampshire,Keene,23409
13115,1973-1974,1973-12-01,1974-04-11,132,2,60,377,437,72,236,308,745,21,152,New Hampshire,Keene,23409
13116,1974-1975,1974-11-21,1975-04-09,140,10,38,372,410,120,533,653,1063,34,211,New Hampshire,Keene,23409
13117,1975-1976,1975-11-26,1976-03-20,116,5,73,407,480,95,472,567,1047,28,209,New Hampshire,Keene,23409
13118,1976-1977,1976-11-11,1977-03-28,138,1,85,505,590,111,573,684,1274,32,245,New Hampshire,Keene,23409
13119,1977-1978,1977-11-28,1978-04-08,132,0,80,484,564,114,669,783,1347,27,221,New Hampshire,Keene,23409
13120,1978-1979,1978-11-21,1979-04-10,141,1,93,438,531,84,484,568,1099,29,159,New Hampshire,Keene,23409
13121,1979-1980,1979-12-01,1980-03-17,108,1,47,357,404,27,95,122,526,8,49,New Hampshire,Keene,23409
13122,1980-1981,1980-12-01,1981-03-27,117,1,75,463,538,38,221,259,797,19,122,New Hampshire,Keene,23409
13123,1982-1983,1982-11-26,1983-04-17,143,8,39,319,358,50,166,216,574,18,98,New Hampshire,Keene,23409
13124,1983-1984,1983-11-26,1984-03-31,127,10,60,404,464,95,402,497,961,23,159,New Hampshire,Keene,23409
13125,1984-1985,1984-11-18,1985-04-01,135,9,46,386,432,62,262,324,756,21,137,New Hampshire,Keene,23409
13126,1985-1986,1985-11-17,1986-03-21,125,5,61,407,468,65,358,423,891,24,139,New Hampshire,Keene,23409
13127,1986-1987,1986-11-12,1987-04-29,169,11,43,413,456,86,489,575,1031,19,124,New Hampshire,Keene,23409
13128,1987-1988,1987-11-11,1988-03-23,134,4,50,395,445,75,371,446,891,19,135,New Hampshire,Keene,23409
13129,1988-1989,1988-12-01,1989-04-02,123,3,48,365,413,50,68,118,531,23,117,New Hampshire,Keene,23409
13130,1989-1990,1989-11-20,1990-03-14,115,4,71,426,497,66,367,433,930,21,147,New Hampshire,Keene,23409
13131,1990-1991,1990-11-12,1991-03-24,133,2,43,332,375,37,136,173,548,15,82,New Hampshire,Keene,23409
13132,1991-1992,1991-12-01,1992-04-18,140,1,75,495,570,45,118,163,733,25,159,New Hampshire,Keene,23409
13133,1992-1993,1992-11-18,1993-04-07,141,2,79,528,607,117,509,626,1233,24,218,New Hampshire,Keene,23409
13134,1993-1994,1993-12-01,1994-04-06,127,0,128,599,727,97,774,871,1598,30,289,New Hampshire,Keene,23409
13135,1994-1995,1994-11-23,1995-04-06,135,2,59,414,473,35,184,219,692,12,73,New Hampshire,Keene,23409
13136,1995-1996,1995-11-14,1996-04-11,150,7,109,540,649,135,621,756,1405,34,298,New Hampshire,Keene,23409
13137,1996-1997,1996-11-16,1997-04-03,139,2,57,411,468,114,376,490,958,24,216,New Hampshire,Keene,23409
13138,1997-1998,1997-11-15,1998-03-25,131,0,26,377,403,60,463,523,926,18,115,New Hampshire,Keene,23409
13139,1998-1999,1998-12-01,1999-03-21,111,7,45,381,426,54,356,410,836,13,117,New Hampshire,Keene,23409
13140,1999-2000,1999-12-01,2000-03-20,111,5,67,402,469,69,291,360,829,18,157,New Hampshire,Keene,23409
13141,2001-2002,2001-12-01,2002-04-23,144,3,11,309,320,58,198,256,576,19,96,New Hampshire,Keene,23409
13142,2003-2004,2003-10-23,2004-03-24,154,5,90,467,557,92,483,575,1132,36,236,New Hampshire,Keene,23409
13143,2004-2005,2004-11-09,2005-03-25,137,6,79,479,558,111,347,458,1016,32,267,New Hampshire,Keene,23409
13144,2005-2006,2005-11-24,2006-03-21,118,2,50,386,436,94,294,388,824,31,216,New Hampshire,Keene,23409
13145,2006-2007,2006-12-01,2007-04-16,137,7,76,419,495,70,233,303,798,21,149,New Hampshire,Keene,23409
13146,2008-2009,2008-11-20,2009-03-24,125,2,80,496,576,111,638,749,1325,34,284,New Hampshire,Keene,23409
13147,2009-2010,2009-12-01,2010-03-08,98,3,56,303,359,63,370,433,792,24,126,New Hampshire,Keene,23409
13148,2012-2013,2012-11-28,2013-04-13,137,0,50,363,413,76,316,392,805,31,171,New Hampshire,Keene,23409
13149,2013-2014,2013-11-14,2014-04-16,154,1,109,571,680,99,572,671,1351,35,270,New Hampshire,Keene,23409
13150,2014-2015,2014-11-14,2015-04-09,147,1,107,586,693,112,577,689,1382,41,362,New Hampshire,Keene,23409
13151,2015-2016,2015-12-01,2016-04-05,127,4,37,281,318,40,98,138,456,21,105,New Hampshire,Keene,23409
13152,2016-2017,2016-11-21,2017-04-03,134,2,53,411,464,106,469,575,1039,33,244,New Hampshire,Keene,23409
13153,2017-2018,2017-11-12,2018-04-20,160,0,98,512,610,110,520,630,1240,37,259,New Hampshire,Keene,23409
13154,2018-2019,2018-11-15,2019-04-06,143,0,80,474,554,71,253,324,878,29,162,New Hampshire,Keene,23409
13155,2019-2020,2019-11-09,2020-05-09,183,0,52,426,478,79,271,350,828,30,159,New Hampshire,Keene,23409
13156,1950-1951,1950-09-17,1951-06-07,264,6,416,949,1365,228,1054,1282,2647,107,930,New Hampshire,Mount Washington,0
13157,1951-1952,1951-09-07,1952-06-20,288,4,471,1081,1552,260,1178,1438,2990,101,1020,New Hampshire,Mount Washington,0
13158,1952-1953,1952-08-23,1953-06-11,293,11,455,969,1424,399,1527,1926,3350,109,1168,New Hampshire,Mount Washington,0
13159,1953-1954,1953-09-09,1954-06-06,271,1,439,1003,1442,283,759,1042,2484,131,1353,New Hampshire,Mount Washington,0
13160,1954-1955,1954-09-12,1955-05-20,251,2,463,1020,1483,446,1280,1726,3209,139,1532,New Hampshire,Mount Washington,0
13161,1955-1956,1955-09-08,1956-05-28,264,2,578,1184,1762,322,1574,1896,3658,121,1232,New Hampshire,Mount Washington,0
13162,1956-1957,1956-09-08,1957-06-07,273,2,516,1102,1618,276,572,848,2466,108,1143,New Hampshire,Mount Washington,0
13163,1957-1958,1957-07-01,1958-06-18,353,0,445,997,1442,478,1004,1482,2924,121,1353,New Hampshire,Mount Washington,0
13164,1958-1959,1958-09-11,1959-06-20,283,3,586,1273,1859,342,841,1183,3042,131,1524,New Hampshire,Mount Washington,0
13165,1959-1960,1959-09-14,1960-05-15,245,5,511,1012,1523,373,734,1107,2630,111,1259,New Hampshire,Mount Washington,0
13166,1960-1961,1960-10-04,1961-06-15,255,2,569,1161,1730,299,602,901,2631,95,1066,New Hampshire,Mount Washington,0
13167,1961-1962,1961-10-15,1962-05-10,208,0,503,1053,1556,270,855,1125,2681,84,937,New Hampshire,Mount Washington,0
13168,1962-1963,1962-07-05,1963-05-23,323,3,549,1219,1768,365,1008,1373,3141,102,1172,New Hampshire,Mount Washington,0
13169,1963-1964,1963-09-21,1964-06-06,260,0,541,1126,1667,346,607,953,2620,112,1276,New Hampshire,Mount Washington,0
13170,1964-1965,1964-08-14,1965-06-19,310,0,547,1203,1750,277,527,804,2554,117,1178,New Hampshire,Mount Washington,0
13171,1965-1966,1965-08-29,1966-06-02,278,0,542,1162,1704,409,1120,1529,3233,128,1314,New Hampshire,Mount Washington,0
13172,1966-1967,1966-09-23,1967-06-01,252,2,518,1165,1683,367,427,794,2477,127,1319,New Hampshire,Mount Washington,0
13173,1967-1968,1967-09-02,1968-06-21,294,0,552,1168,1720,303,197,500,2220,108,1196,New Hampshire,Mount Washington,0
13174,1968-1969,1968-09-13,1969-05-26,256,0,530,1100,1630,747,1329,2076,3706,134,1789,New Hampshire,Mount Washington,0
13175,1969-1970,1969-09-29,1970-05-09,223,0,550,1145,1695,560,1420,1980,3675,112,1540,New Hampshire,Mount Washington,0
13176,1970-1971,1970-09-01,1971-05-27,269,0,565,1155,1720,539,1481,2020,3740,134,1651,New Hampshire,Mount Washington,0
13177,1971-1972,1971-08-23,1972-06-11,294,0,542,1164,1706,522,1257,1779,3485,136,1793,New Hampshire,Mount Washington,0
13178,1972-1973,1972-10-01,1973-06-17,260,0,464,1041,1505,591,1306,1897,3402,128,1618,New Hampshire,Mount Washington,0
13179,1973-1974,1973-09-08,1974-05-29,264,0,501,1126,1627,512,955,1467,3094,144,1616,New Hampshire,Mount Washington,0
13180,1974-1975,1974-09-22,1975-06-09,261,0,550,1115,1665,612,1359,1971,3636,142,1793,New Hampshire,Mount Washington,0
13181,1975-1976,1975-09-13,1976-06-03,265,0,461,1123,1584,434,662,1096,2680,125,1462,New Hampshire,Mount Washington,0
13182,1976-1977,1976-08-30,1977-06-10,285,0,658,1305,1963,678,1389,2067,4030,164,2165,New Hampshire,Mount Washington,0
13183,1977-1978,1977-09-23,1978-06-15,266,0,620,1190,1810,528,1548,2076,3886,134,1692,New Hampshire,Mount Washington,0
13184,1978-1979,1978-09-29,1979-06-25,270,0,525,1112,1637,296,521,817,2454,111,1261,New Hampshire,Mount Washington,0
13185,1979-1980,1979-07-05,1980-06-11,343,0,530,1088,1618,222,408,630,2248,116,1085,New Hampshire,Mount Washington,0
13186,1980-1981,1980-09-26,1981-05-19,236,0,571,1209,1780,311,937,1248,3028,132,1473,New Hampshire,Mount Washington,0
13187,1981-1982,1981-09-09,1982-05-04,238,1,551,1148,1699,375,1221,1596,3295,142,1654,New Hampshire,Mount Washington,0
13188,1982-1983,1982-08-21,1983-05-28,281,3,391,919,1310,266,588,854,2164,107,1013,New Hampshire,Mount Washington,0
13189,1983-1984,1983-09-17,1984-05-28,255,1,489,1058,1547,534,1061,1595,3142,127,1454,New Hampshire,Mount Washington,0
13190,1984-1985,1984-09-06,1985-06-26,294,2,521,1114,1635,463,618,1081,2716,118,1514,New Hampshire,Mount Washington,0
13191,1985-1986,1985-09-12,1986-06-25,287,0,491,1080,1571,391,637,1028,2599,116,1343,New Hampshire,Mount Washington,0
13192,1986-1987,1986-08-24,1987-05-06,256,6,492,1029,1521,467,1032,1499,3020,95,1260,New Hampshire,Mount Washington,0
13193,1987-1988,1987-08-24,1988-06-30,312,0,507,1137,1644,531,896,1427,3071,138,1631,New Hampshire,Mount Washington,0
13194,1988-1989,1988-07-01,1989-05-28,332,0,535,1162,1697,404,705,1109,2806,123,1300,New Hampshire,Mount Washington,0
13195,1989-1990,1989-09-24,1990-06-06,256,0,539,1160,1699,439,430,869,2568,123,1443,New Hampshire,Mount Washington,0
13196,1990-1991,1990-09-17,1991-06-05,262,6,401,970,1371,403,446,849,2220,104,1222,New Hampshire,Mount Washington,0
13197,1991-1992,1991-09-20,1992-05-29,253,3,511,1137,1648,352,696,1048,2696,113,1290,New Hampshire,Mount Washington,0
13198,1992-1993,1992-09-01,1993-06-07,280,5,482,1064,1546,286,447,733,2279,101,1113,New Hampshire,Mount Washington,0
13199,1993-1994,1993-09-11,1994-06-03,266,3,543,1247,1790,372,671,1043,2833,118,1333,New Hampshire,Mount Washington,0
13200,1994-1995,1994-09-05,1995-05-28,266,0,435,999,1434,265,497,762,2196,95,949,New Hampshire,Mount Washington,0
13201,1995-1996,1995-09-15,1996-05-30,259,1,552,1153,1705,486,878,1364,3069,132,1587,New Hampshire,Mount Washington,0
13202,1996-1997,1996-09-24,1997-06-06,256,11,521,1154,1675,594,1062,1656,3331,147,1711,New Hampshire,Mount Washington,0
13203,1997-1998,1997-09-04,1998-06-08,278,7,368,891,1259,390,557,947,2206,103,1080,New Hampshire,Mount Washington,0
13204,1998-1999,1998-09-23,1999-05-27,247,0,430,1015,1445,352,670,1022,2467,118,1193,New Hampshire,Mount Washington,0
13205,1999-2000,1999-09-17,2000-06-07,265,3,421,1026,1447,357,537,894,2341,112,1150,New Hampshire,Mount Washington,0
13206,2000-2001,2000-08-20,2001-06-01,286,0,533,1120,1653,396,1187,1583,3236,117,1373,New Hampshire,Mount Washington,0
13207,2001-2002,2001-09-14,2002-06-02,262,0,398,976,1374,443,946,1389,2763,121,1317,New Hampshire,Mount Washington,0
13208,2002-2003,2002-09-11,2003-06-01,264,0,563,1223,1786,349,797,1146,2932,122,1346,New Hampshire,Mount Washington,0
13209,2003-2004,2003-09-30,2004-06-03,248,5,532,1134,1666,276,576,852,2518,100,1095,New Hampshire,Mount Washington,0
13210,2004-2005,2004-09-19,2005-05-29,253,2,491,1025,1516,369,1027,1396,2912,120,1324,New Hampshire,Mount Washington,0
13211,2005-2006,2005-09-30,2006-05-26,239,2,466,985,1451,475,1404,1879,3330,134,1465,New Hampshire,Mount Washington,0
13212,2006-2007,2006-09-21,2007-06-22,275,0,476,1076,1552,349,856,1205,2757,127,1362,New Hampshire,Mount Washington,0
13213,2007-2008,2007-07-01,2008-05-28,333,1,471,1064,1535,344,855,1199,2734,129,1339,New Hampshire,Mount Washington,0
13214,2008-2009,2008-10-02,2009-06-07,249,0,493,1099,1592,327,1133,1460,3052,116,1283,New Hampshire,Mount Washington,0
13215,2010-2011,2010-07-01,2011-06-02,337,16,509,1069,1578,338,1340,1678,3256,129,1341,New Hampshire,Mount Washington,0
13216,2011-2012,2011-09-15,2012-06-08,268,0,380,880,1260,336,1137,1473,2733,135,1265,New Hampshire,Mount Washington,0
13217,2012-2013,2012-09-15,2013-06-18,277,0,472,1000,1472,444,1169,1613,3085,136,1524,New Hampshire,Mount Washington,0
13218,2013-2014,2013-09-08,2014-05-30,265,3,571,1191,1762,455,1123,1578,3340,142,1651,New Hampshire,Mount Washington,0
13219,2014-2015,2014-08-07,2015-05-24,291,0,566,1200,1766,454,1235,1689,3455,150,1750,New Hampshire,Mount Washington,0
13220,2015-2016,2015-10-03,2016-06-14,256,0,371,959,1330,308,745,1053,2383,121,1130,New Hampshire,Mount Washington,0
13221,2016-2017,2016-09-24,2017-06-28,278,0,450,1005,1455,550,1050,1600,3055,135,1546,New Hampshire,Mount Washington,0
13222,2017-2018,2017-09-01,2018-06-05,278,0,477,1065,1542,477,963,1440,2982,117,1385,New Hampshire,Mount Washington,0
13223,2018-2019,2018-10-13,2019-06-04,235,0,550,1170,1720,448,1150,1598,3318,143,1661,New Hampshire,Mount Washington,0
13224,2019-2020,2019-08-10,2020-06-02,298,0,453,1007,1460,440,1138,1578,3038,153,1502,New Hampshire,Mount Washington,0
13225,1974-1975,1974-11-21,1975-04-18,149,0,56,505,561,153,958,1111,1672,44,306,New Hampshire,North Conway,0
13226,1975-1976,1975-11-25,1976-04-26,154,0,113,583,696,161,829,990,1686,49,421,New Hampshire,North Conway,0
13227,1976-1977,1976-10-25,1977-04-10,168,3,113,590,703,146,841,987,1690,48,366,New Hampshire,North Conway,0
13228,1977-1978,1977-11-24,1978-04-20,148,0,104,581,685,165,1225,1390,2075,44,367,New Hampshire,North Conway,0
13229,1978-1979,1978-11-21,1979-04-11,142,0,113,524,637,148,905,1053,1690,43,328,New Hampshire,North Conway,0
13230,1979-1980,1979-10-10,1980-04-05,179,0,81,490,571,75,202,277,848,25,157,New Hampshire,North Conway,0
13231,1980-1981,1980-11-17,1981-04-15,150,0,116,539,655,78,326,404,1059,35,262,New Hampshire,North Conway,0
13232,1981-1982,1981-11-27,1982-04-16,141,1,118,564,682,152,1083,1235,1917,50,358,New Hampshire,North Conway,0
13233,1982-1983,1982-11-15,1983-04-21,158,0,61,404,465,95,240,335,800,31,187,New Hampshire,North Conway,0
13234,1983-1984,1983-11-16,1984-03-31,137,6,94,489,583,124,662,786,1369,38,287,New Hampshire,North Conway,0
13235,1984-1985,1984-11-20,1985-04-06,138,1,87,485,572,109,703,812,1384,31,258,New Hampshire,North Conway,0
13236,1985-1986,1985-11-13,1986-04-11,150,2,78,521,599,125,774,899,1498,39,269,New Hampshire,North Conway,0
13237,1986-1987,1986-11-06,1987-04-29,175,1,62,507,569,137,947,1084,1653,29,237,New Hampshire,North Conway,0
13238,1987-1988,1987-10-24,1988-04-17,177,1,73,536,609,101,676,777,1386,35,225,New Hampshire,North Conway,0
13239,1988-1989,1988-11-14,1989-04-16,154,4,92,529,621,93,485,578,1199,44,264,New Hampshire,North Conway,0
13240,1989-1990,1989-11-20,1990-04-06,138,6,104,562,666,126,628,754,1420,35,286,New Hampshire,North Conway,0
13241,1990-1991,1990-11-12,1991-03-28,137,1,65,419,484,89,417,506,990,28,199,New Hampshire,North Conway,0
13242,1991-1992,1991-12-01,1992-04-19,141,0,88,494,582,101,425,526,1108,31,248,New Hampshire,North Conway,0
13243,1992-1993,1992-11-17,1993-04-10,145,2,99,546,645,139,592,731,1376,40,335,New Hampshire,North Conway,0
13244,1993-1994,1993-11-21,1994-04-11,142,2,126,579,705,134,850,984,1689,38,351,New Hampshire,North Conway,0
13245,1994-1995,1994-11-24,1995-04-06,134,0,67,436,503,92,324,416,919,32,216,New Hampshire,North Conway,0
13246,1995-1996,1995-11-15,1996-04-17,155,0,111,539,650,173,817,990,1640,58,410,New Hampshire,North Conway,0
13247,1996-1997,1996-11-15,1997-04-13,150,3,84,470,554,155,829,984,1538,42,334,New Hampshire,North Conway,0
13248,1997-1998,1997-10-27,1998-03-28,153,1,40,393,433,126,718,844,1277,37,237,New Hampshire,North Conway,0
13249,1998-1999,1998-11-15,1999-03-31,137,1,50,397,447,115,749,864,1311,32,233,New Hampshire,North Conway,0
13250,1999-2000,1999-11-13,2000-04-22,162,4,81,415,496,104,456,560,1056,31,216,New Hampshire,North Conway,0
13251,2000-2001,2000-11-24,2001-04-17,145,1,84,509,593,151,900,1051,1644,37,288,New Hampshire,North Conway,0
13252,2001-2002,2001-11-30,2002-04-29,151,6,27,321,348,97,418,515,863,35,179,New Hampshire,North Conway,0
13253,2002-2003,2002-10-27,2003-04-08,164,2,129,581,710,120,754,874,1584,48,303,New Hampshire,North Conway,0
13254,2003-2004,2003-11-09,2004-03-24,137,9,118,469,587,77,523,600,1187,27,193,New Hampshire,North Conway,0
13255,2004-2005,2004-11-21,2005-04-02,133,8,100,470,570,114,657,771,1341,40,303,New Hampshire,North Conway,0
13256,2005-2006,2005-11-10,2006-04-05,147,3,64,393,457,71,285,356,813,30,169,New Hampshire,North Conway,0
13257,2006-2007,2006-12-01,2007-04-19,140,1,109,433,542,116,576,692,1234,29,221,New Hampshire,North Conway,0
13258,2007-2008,2007-11-21,2008-04-21,153,0,92,505,597,209,1487,1696,2293,66,469,New Hampshire,North Conway,0
13259,2008-2009,2008-11-20,2009-04-08,140,0,118,538,656,159,959,1118,1774,38,368,New Hampshire,North Conway,0
13260,2009-2010,2009-12-01,2010-04-29,150,0,63,337,400,72,542,614,1014,26,140,New Hampshire,North Conway,0
13261,2010-2011,2010-11-22,2011-04-24,154,0,97,498,595,128,646,774,1369,43,306,New Hampshire,North Conway,0
13262,2011-2012,2011-10-30,2012-03-28,151,0,59,389,448,105,487,592,1040,30,224,New Hampshire,North Conway,0
13263,2012-2013,2012-11-08,2013-04-13,157,0,78,425,503,118,626,744,1247,38,269,New Hampshire,North Conway,0
13264,2013-2014,2013-11-10,2014-04-16,158,0,152,612,764,146,984,1130,1894,49,410,New Hampshire,North Conway,0
13265,2014-2015,2014-11-14,2015-04-14,152,0,148,619,767,135,893,1028,1795,48,394,New Hampshire,North Conway,0
13266,2015-2016,2015-12-01,2016-04-27,149,0,48,347,395,64,305,369,764,27,150,New Hampshire,North Conway,0
13267,2016-2017,2016-11-25,2017-04-10,137,1,76,396,472,176,934,1110,1582,39,334,New Hampshire,North Conway,0
13268,2017-2018,2017-11-11,2018-04-18,159,0,108,480,588,150,663,813,1401,35,279,New Hampshire,North Conway,0
13269,2018-2019,2018-10-28,2019-04-11,166,0,99,566,665,137,1136,1273,1938,37,285,New Hampshire,North Conway,0
13270,2019-2020,2019-11-09,2020-05-09,183,0,53,412,465,110,511,621,1086,37,211,New Hampshire,North Conway,0
13271,1950-1951,1950-12-01,1951-03-22,112,0,13,135,148,8,4,12,160,7,27,New Jersey,Atlantic City,39558
13272,1951-1952,1951-12-01,1952-03-03,94,0,9,112,121,24,13,37,158,6,33,New Jersey,Atlantic City,39558
13273,1952-1953,1952-11-30,1953-03-09,100,0,5,84,89,19,10,29,118,5,27,New Jersey,Atlantic City,39558
13274,1953-1954,1953-11-06,1954-03-11,126,0,10,120,130,22,24,46,176,7,35,New Jersey,Atlantic City,39558
13275,1954-1955,1954-12-01,1955-03-18,108,0,18,146,164,13,14,27,191,7,23,New Jersey,Atlantic City,39558
13276,1955-1956,1955-11-19,1956-04-24,158,0,15,195,210,33,40,73,283,15,57,New Jersey,Atlantic City,39558
13277,1956-1957,1956-12-01,1957-02-28,90,2,14,112,126,8,14,22,148,5,29,New Jersey,Atlantic City,39558
13278,1957-1958,1957-12-01,1958-03-23,113,1,26,180,206,46,95,141,347,12,71,New Jersey,Atlantic City,39558
13279,1958-1959,1958-12-01,1959-04-13,134,0,27,227,254,14,27,41,295,7,36,New Jersey,Atlantic City,39558
13280,1959-1960,1959-11-18,1960-03-22,126,0,15,164,179,35,43,78,257,16,73,New Jersey,Atlantic City,39558
13281,1960-1961,1960-12-01,1961-03-10,100,0,32,211,243,51,120,171,414,18,114,New Jersey,Atlantic City,39558
13282,1961-1962,1961-12-01,1962-03-09,99,0,14,168,182,25,21,46,228,12,47,New Jersey,Atlantic City,39558
13283,1962-1963,1962-12-01,1963-02-28,90,0,28,202,230,16,4,20,250,11,39,New Jersey,Atlantic City,39558
13284,1963-1964,1963-12-01,1964-03-30,121,0,15,173,188,56,59,115,303,17,88,New Jersey,Atlantic City,39558
13285,1964-1965,1964-12-01,1965-04-02,123,0,24,251,275,30,40,70,345,14,87,New Jersey,Atlantic City,39558
13286,1965-1966,1965-12-01,1966-02-28,90,0,25,203,228,32,74,106,334,12,79,New Jersey,Atlantic City,39558
13287,1966-1967,1966-12-01,1967-03-23,113,0,18,201,219,69,80,149,368,21,123,New Jersey,Atlantic City,39558
13288,1967-1968,1967-11-16,1968-03-13,119,0,44,270,314,29,22,51,365,14,68,New Jersey,Atlantic City,39558
13289,1968-1969,1968-12-01,1969-03-13,103,0,19,235,254,41,47,88,342,8,53,New Jersey,Atlantic City,39558
13290,1969-1970,1969-12-01,1970-02-28,90,0,24,172,196,22,43,65,261,12,54,New Jersey,Atlantic City,39558
13291,1970-1971,1970-12-01,1971-03-23,113,0,18,173,191,18,11,29,220,11,41,New Jersey,Atlantic City,39558
13292,1971-1972,1971-12-01,1972-03-10,101,0,13,161,174,15,10,25,199,8,36,New Jersey,Atlantic City,39558
13293,1972-1973,1972-12-01,1973-02-28,90,0,10,111,121,1,0,1,122,1,5,New Jersey,Atlantic City,39558
13294,1973-1974,1973-11-05,1974-02-28,116,0,8,129,137,16,21,37,174,4,21,New Jersey,Atlantic City,39558
13295,1974-1975,1974-11-25,1975-03-10,106,0,4,132,136,13,3,16,152,8,25,New Jersey,Atlantic City,39558
13296,1975-1976,1975-12-01,1976-03-11,102,0,19,181,200,17,12,29,229,11,45,New Jersey,Atlantic City,39558
13297,1976-1977,1976-11-30,1977-02-28,91,0,53,273,326,18,24,42,368,10,54,New Jersey,Atlantic City,39558
13298,1977-1978,1977-12-01,1978-03-17,107,0,38,248,286,35,85,120,406,12,63,New Jersey,Atlantic City,39558
13299,1978-1979,1978-11-27,1979-02-28,94,0,42,231,273,63,90,153,426,16,135,New Jersey,Atlantic City,39558
13300,1979-1980,1979-12-01,1980-03-03,94,0,22,198,220,22,21,43,263,9,58,New Jersey,Atlantic City,39558
13301,1980-1981,1980-12-01,1981-02-28,90,0,47,268,315,5,3,8,323,3,16,New Jersey,Atlantic City,39558
13302,1981-1982,1981-12-01,1982-04-10,131,0,24,214,238,23,26,49,287,12,48,New Jersey,Atlantic City,39558
13303,1982-1983,1982-12-01,1983-04-20,141,0,12,146,158,29,40,69,227,5,41,New Jersey,Atlantic City,39558
13304,1983-1984,1983-11-25,1984-03-13,110,0,28,215,243,14,12,26,269,10,48,New Jersey,Atlantic City,39558
13305,1984-1985,1984-12-01,1985-04-09,130,0,22,185,207,22,34,56,263,8,48,New Jersey,Atlantic City,39558
13306,1985-1986,1985-12-01,1986-03-08,98,0,21,203,224,27,36,63,287,12,69,New Jersey,Atlantic City,39558
13307,1986-1987,1986-12-01,1987-04-05,126,0,9,200,209,45,88,133,342,10,67,New Jersey,Atlantic City,39558
13308,1987-1988,1987-11-21,1988-02-29,101,0,19,198,217,12,23,35,252,4,28,New Jersey,Atlantic City,39558
13309,1988-1989,1988-12-01,1989-03-11,101,0,18,175,193,28,32,60,253,8,53,New Jersey,Atlantic City,39558
13310,1989-1990,1989-11-22,1990-04-07,137,0,24,227,251,31,45,76,327,12,69,New Jersey,Atlantic City,39558
13311,1990-1991,1990-12-01,1991-02-28,90,0,6,139,145,14,5,19,164,6,27,New Jersey,Atlantic City,39558
13312,1991-1992,1991-12-01,1992-02-29,91,0,8,157,165,5,2,7,172,4,18,New Jersey,Atlantic City,39558
13313,1992-1993,1992-12-01,1993-03-18,108,0,7,184,191,14,10,24,215,8,29,New Jersey,Atlantic City,39558
13314,1993-1994,1993-12-01,1994-03-02,92,0,30,213,243,14,15,29,272,9,50,New Jersey,Atlantic City,39558
13315,1994-1995,1994-12-01,1995-02-28,90,0,9,145,154,2,0,2,156,2,7,New Jersey,Atlantic City,39558
13316,2004-2005,2004-12-01,2005-03-09,99,1,20,175,195,25,36,61,256,16,71,New Jersey,Atlantic City,39558
13317,2005-2006,2005-12-01,2006-02-28,90,1,5,118,123,19,20,39,162,6,30,New Jersey,Atlantic City,39558
13318,2006-2007,2006-12-01,2007-03-09,99,0,14,148,162,11,7,18,180,8,33,New Jersey,Atlantic City,39558
13319,2007-2008,2007-12-01,2008-02-29,91,0,3,121,124,14,11,25,149,5,23,New Jersey,Atlantic City,39558
13320,2008-2009,2008-12-01,2009-03-20,110,0,17,162,179,21,26,47,226,10,41,New Jersey,Atlantic City,39558
13321,2009-2010,2009-12-01,2010-02-28,90,0,12,132,144,77,164,241,385,17,111,New Jersey,Atlantic City,39558
13322,2010-2011,2010-12-01,2011-02-28,90,0,13,169,182,56,90,146,328,15,96,New Jersey,Atlantic City,39558
13323,2011-2012,2011-12-01,2012-02-29,91,0,3,90,93,7,2,9,102,5,13,New Jersey,Atlantic City,39558
13324,2012-2013,2012-11-07,2013-03-25,139,0,10,147,157,25,7,32,189,17,61,New Jersey,Atlantic City,39558
13325,2013-2014,2013-12-01,2014-03-26,116,0,32,238,270,60,60,120,390,23,136,New Jersey,Atlantic City,39558
13326,2014-2015,2014-12-01,2015-03-20,110,0,25,228,253,33,31,64,317,13,87,New Jersey,Atlantic City,39558
13327,2015-2016,2015-12-01,2016-04-09,131,0,11,125,136,40,20,60,196,13,61,New Jersey,Atlantic City,39558
13328,2016-2017,2016-12-01,2017-03-15,105,0,7,114,121,14,9,23,144,5,23,New Jersey,Atlantic City,39558
13329,2017-2018,2017-12-01,2018-03-22,112,0,24,170,194,47,49,96,290,12,75,New Jersey,Atlantic City,39558
13330,2018-2019,2018-12-01,2019-03-06,96,0,11,131,142,23,17,40,182,7,42,New Jersey,Atlantic City,39558
13331,2019-2020,2019-12-01,2020-02-29,91,0,1,82,83,1,1,2,85,1,2,New Jersey,Atlantic City,39558
13332,1954-1955,1954-12-01,1955-02-28,90,20,9,82,91,8,2,10,101,3,11,New Jersey,Cape May,3607
13333,1955-1956,1955-12-01,1956-02-29,91,13,8,85,93,0,0,0,93,0,0,New Jersey,Cape May,3607
13334,1966-1967,1966-12-01,1967-03-19,109,19,7,99,106,25,21,46,152,5,33,New Jersey,Cape May,3607
13335,1968-1969,1968-12-01,1969-03-12,102,18,19,132,151,30,5,35,186,6,40,New Jersey,Cape May,3607
13336,1969-1970,1969-12-01,1970-02-28,90,8,22,144,166,8,7,15,181,3,18,New Jersey,Cape May,3607
13337,1970-1971,1970-12-01,1971-02-28,90,2,22,122,144,2,0,2,146,1,3,New Jersey,Cape May,3607
13338,1971-1972,1971-12-01,1972-04-08,130,0,8,122,130,9,5,14,144,4,16,New Jersey,Cape May,3607
13339,1972-1973,1972-12-01,1973-02-28,90,9,14,88,102,0,1,1,103,0,0,New Jersey,Cape May,3607
13340,1974-1975,1974-12-01,1975-03-02,92,2,1,71,72,7,5,12,84,3,12,New Jersey,Cape May,3607
13341,1975-1976,1975-12-01,1976-03-17,108,0,12,117,129,12,7,19,148,10,28,New Jersey,Cape May,3607
13342,1976-1977,1976-11-12,1977-02-28,109,0,39,186,225,22,17,39,264,12,52,New Jersey,Cape May,3607
13343,1977-1978,1977-12-01,1978-03-16,106,0,39,169,208,46,169,215,423,10,68,New Jersey,Cape May,3607
13344,1978-1979,1978-11-27,1979-02-28,94,0,33,146,179,53,94,147,326,15,107,New Jersey,Cape May,3607
13345,1979-1980,1979-12-01,1980-03-04,95,0,20,104,124,23,28,51,175,11,55,New Jersey,Cape May,3607
13346,1980-1981,1980-12-01,1981-03-20,110,0,28,158,186,8,1,9,195,7,16,New Jersey,Cape May,3607
13347,1981-1982,1981-12-01,1982-04-09,130,1,23,153,176,27,46,73,249,12,60,New Jersey,Cape May,3607
13348,1982-1983,1982-12-01,1983-02-28,90,0,7,78,85,25,39,64,149,4,33,New Jersey,Cape May,3607
13349,1985-1986,1985-12-01,1986-03-08,98,1,16,122,138,28,38,66,204,13,63,New Jersey,Cape May,3607
13350,1986-1987,1986-12-01,1987-03-13,103,3,9,112,121,45,110,155,276,10,65,New Jersey,Cape May,3607
13351,1987-1988,1987-11-11,1988-02-29,111,1,15,120,135,11,4,15,150,8,29,New Jersey,Cape May,3607
13352,1988-1989,1988-12-01,1989-03-10,100,0,13,100,113,30,44,74,187,9,47,New Jersey,Cape May,3607
13353,1989-1990,1989-11-22,1990-04-07,137,1,21,141,162,28,52,80,242,14,58,New Jersey,Cape May,3607
13354,1990-1991,1990-12-01,1991-02-28,90,2,5,68,73,9,3,12,85,4,12,New Jersey,Cape May,3607
13355,1991-1992,1991-12-01,1992-03-19,110,0,6,94,100,5,0,5,105,4,12,New Jersey,Cape May,3607
13356,1992-1993,1992-12-01,1993-03-18,108,0,8,109,117,17,13,30,147,7,33,New Jersey,Cape May,3607
13357,1993-1994,1993-12-01,1994-03-02,92,1,25,143,168,13,15,28,196,8,44,New Jersey,Cape May,3607
13358,1994-1995,1994-12-01,1995-02-28,90,0,8,85,93,1,0,1,94,1,3,New Jersey,Cape May,3607
13359,1995-1996,1995-12-01,1996-04-09,131,1,24,156,180,66,121,187,367,16,107,New Jersey,Cape May,3607
13360,1996-1997,1996-11-28,1997-02-28,93,0,11,77,88,6,7,13,101,3,9,New Jersey,Cape May,3607
13361,1997-1998,1997-12-01,1998-02-28,90,1,0,48,48,3,3,6,54,1,4,New Jersey,Cape May,3607
13362,1998-1999,1998-12-01,1999-03-15,105,2,8,91,99,9,7,16,115,7,22,New Jersey,Cape May,3607
13363,1999-2000,1999-12-01,2000-02-29,91,1,10,98,108,15,66,81,189,6,25,New Jersey,Cape May,3607
13364,2000-2001,2000-12-01,2001-03-26,116,0,6,122,128,28,47,75,203,9,45,New Jersey,Cape May,3607
13365,2001-2002,2001-12-01,2002-04-06,127,0,0,57,57,10,0,10,67,5,14,New Jersey,Cape May,3607
13366,2002-2003,2002-12-01,2003-02-28,90,1,14,112,126,56,93,149,275,16,83,New Jersey,Cape May,3607
13367,2003-2004,2003-12-01,2004-02-29,91,0,19,118,137,22,22,44,181,12,50,New Jersey,Cape May,3607
13368,2004-2005,2004-12-01,2005-03-08,98,0,13,108,121,21,17,38,159,14,62,New Jersey,Cape May,3607
13369,2005-2006,2005-12-01,2006-03-01,91,0,3,72,75,13,10,23,98,6,21,New Jersey,Cape May,3607
13370,2006-2007,2006-12-01,2007-04-08,129,2,13,110,123,14,9,23,146,8,32,New Jersey,Cape May,3607
13371,2007-2008,2007-12-01,2008-02-29,91,0,4,82,86,13,10,23,109,6,21,New Jersey,Cape May,3607
13372,2008-2009,2008-12-01,2009-03-05,95,0,14,115,129,17,25,42,171,6,29,New Jersey,Cape May,3607
13373,2009-2010,2009-12-01,2010-02-28,90,3,9,96,105,74,153,227,332,15,102,New Jersey,Cape May,3607
13374,2010-2011,2010-12-01,2011-02-28,90,0,12,126,138,45,69,114,252,14,77,New Jersey,Cape May,3607
13375,2011-2012,2011-12-01,2012-02-29,91,0,1,57,58,5,1,6,64,5,11,New Jersey,Cape May,3607
13376,2012-2013,2012-12-01,2013-03-25,115,0,6,73,79,17,13,30,109,9,33,New Jersey,Cape May,3607
13377,2013-2014,2013-12-01,2014-03-26,116,0,22,162,184,61,60,121,305,22,118,New Jersey,Cape May,3607
13378,2014-2015,2014-12-01,2015-03-20,110,0,21,167,188,35,52,87,275,13,81,New Jersey,Cape May,3607
13379,2015-2016,2015-12-01,2016-03-21,112,0,9,80,89,33,16,49,138,13,53,New Jersey,Cape May,3607
13380,2016-2017,2016-12-01,2017-03-15,105,1,5,77,82,15,13,28,110,4,21,New Jersey,Cape May,3607
13381,2017-2018,2017-12-01,2018-03-21,111,0,19,120,139,28,49,77,216,10,51,New Jersey,Cape May,3607
13382,2018-2019,2018-12-01,2019-03-06,96,0,8,91,99,15,11,26,125,6,29,New Jersey,Cape May,3607
13383,2019-2020,2019-12-01,2020-02-29,91,0,1,61,62,1,0,1,63,1,2,New Jersey,Cape May,3607
13384,1950-1951,1950-11-28,1951-03-03,96,2,17,141,158,14,10,24,182,7,37,New Jersey,New Brunswick,55181
13385,1951-1952,1951-12-01,1952-03-04,95,9,9,139,148,18,33,51,199,4,27,New Jersey,New Brunswick,55181
13386,1952-1953,1952-11-30,1953-03-08,99,0,3,122,125,18,12,30,155,9,33,New Jersey,New Brunswick,55181
13387,1953-1954,1953-11-06,1954-04-01,147,6,9,195,204,21,47,68,272,6,31,New Jersey,New Brunswick,55181
13388,1954-1955,1954-12-01,1955-03-18,108,0,13,183,196,17,10,27,223,8,41,New Jersey,New Brunswick,55181
13389,1955-1956,1955-11-19,1956-04-08,142,0,12,211,223,38,54,92,315,12,65,New Jersey,New Brunswick,55181
13390,1956-1957,1956-12-01,1957-04-04,125,0,13,164,177,31,25,56,233,13,56,New Jersey,New Brunswick,55181
13391,1957-1958,1957-11-23,1958-03-23,121,1,26,176,202,62,98,160,362,13,88,New Jersey,New Brunswick,55181
13392,1958-1959,1958-12-01,1959-03-28,118,4,23,227,250,15,10,25,275,8,31,New Jersey,New Brunswick,55181
13393,1959-1960,1959-11-29,1960-03-22,115,1,12,178,190,39,70,109,299,13,68,New Jersey,New Brunswick,55181
13394,1960-1961,1960-12-01,1961-02-28,90,0,44,240,284,82,264,346,630,14,148,New Jersey,New Brunswick,55181
13395,1961-1962,1961-12-01,1962-03-10,100,5,16,204,220,41,109,150,370,15,71,New Jersey,New Brunswick,55181
13396,1962-1963,1962-10-26,1963-03-01,127,0,32,243,275,32,38,70,345,12,62,New Jersey,New Brunswick,55181
13397,1963-1964,1963-12-01,1964-03-22,113,0,21,191,212,52,141,193,405,14,82,New Jersey,New Brunswick,55181
13398,1965-1966,1965-12-01,1966-02-28,90,1,19,146,165,34,110,144,309,8,52,New Jersey,New Brunswick,55181
13399,1966-1967,1966-12-01,1967-03-24,114,6,15,189,204,81,116,197,401,19,118,New Jersey,New Brunswick,55181
13400,1967-1968,1967-11-30,1968-03-13,105,0,26,201,227,26,69,95,322,9,46,New Jersey,New Brunswick,55181
13401,1968-1969,1968-12-01,1969-03-27,117,2,32,201,233,51,146,197,430,16,77,New Jersey,New Brunswick,55181
13402,1969-1970,1969-12-01,1970-04-01,122,2,46,251,297,46,171,217,514,24,105,New Jersey,New Brunswick,55181
13403,1970-1971,1970-12-01,1971-04-07,128,1,39,213,252,33,55,88,340,16,62,New Jersey,New Brunswick,55181
13404,1971-1972,1971-12-01,1972-04-08,130,1,20,199,219,32,51,83,302,14,63,New Jersey,New Brunswick,55181
13405,1972-1973,1972-10-19,1973-02-28,133,0,20,152,172,7,1,8,180,6,14,New Jersey,New Brunswick,55181
13406,1973-1974,1973-12-01,1974-04-10,131,15,21,171,192,36,75,111,303,13,76,New Jersey,New Brunswick,55181
13407,1974-1975,1974-11-26,1975-03-15,110,0,9,122,131,33,42,75,206,12,55,New Jersey,New Brunswick,55181
13408,1975-1976,1975-12-01,1976-03-18,109,0,35,198,233,38,64,102,335,14,75,New Jersey,New Brunswick,55181
13409,1976-1977,1976-12-01,1977-03-21,111,0,65,268,333,45,230,275,608,21,111,New Jersey,New Brunswick,55181
13410,1977-1978,1977-11-28,1978-03-17,110,0,56,270,326,80,275,355,681,21,141,New Jersey,New Brunswick,55181
13411,1978-1979,1978-11-27,1979-03-16,110,0,56,238,294,45,99,144,438,16,105,New Jersey,New Brunswick,55181
13412,1979-1980,1979-12-01,1980-04-01,123,3,25,211,236,31,35,66,302,12,68,New Jersey,New Brunswick,55181
13413,1980-1981,1980-11-18,1981-03-08,111,0,47,290,337,29,75,104,441,11,73,New Jersey,New Brunswick,55181
13414,1981-1982,1981-12-01,1982-04-10,131,2,42,253,295,46,128,174,469,16,99,New Jersey,New Brunswick,55181
13415,1982-1983,1982-12-01,1983-04-20,141,0,16,165,181,45,105,150,331,7,64,New Jersey,New Brunswick,55181
13416,1983-1984,1983-11-26,1984-03-31,127,0,43,249,292,59,124,183,475,20,109,New Jersey,New Brunswick,55181
13417,1984-1985,1984-12-01,1985-02-28,90,0,31,168,199,38,76,114,313,16,93,New Jersey,New Brunswick,55181
13418,1985-1986,1985-11-17,1986-04-23,158,0,30,230,260,36,65,101,361,18,85,New Jersey,New Brunswick,55181
13419,1986-1987,1986-12-01,1987-03-13,103,0,19,186,205,63,154,217,422,16,101,New Jersey,New Brunswick,55181
13420,1987-1988,1987-11-07,1988-03-21,136,1,34,238,272,36,101,137,409,14,74,New Jersey,New Brunswick,55181
13421,1988-1989,1988-12-01,1989-03-21,111,4,24,197,221,19,22,41,262,9,41,New Jersey,New Brunswick,55181
13422,1989-1990,1989-11-23,1990-04-08,137,0,32,227,259,32,23,55,314,19,80,New Jersey,New Brunswick,55181
13423,1990-1991,1990-12-01,1991-03-31,121,0,10,155,165,34,28,62,227,14,64,New Jersey,New Brunswick,55181
13424,1991-1992,1991-12-01,1992-03-24,115,1,17,191,208,15,15,30,238,10,47,New Jersey,New Brunswick,55181
13425,1992-1993,1992-12-01,1993-03-24,114,0,13,212,225,46,83,129,354,19,85,New Jersey,New Brunswick,55181
13426,1993-1994,1993-12-01,1994-03-19,109,3,61,264,325,74,224,298,623,24,167,New Jersey,New Brunswick,55181
13427,1994-1995,1994-12-01,1995-02-28,90,0,15,160,175,24,68,92,267,9,52,New Jersey,New Brunswick,55181
13428,1995-1996,1995-11-29,1996-04-10,134,1,50,268,318,110,271,381,699,31,212,New Jersey,New Brunswick,55181
13429,1996-1997,1996-11-29,1997-04-01,124,2,16,168,184,24,25,49,233,8,36,New Jersey,New Brunswick,55181
13430,1997-1998,1997-12-01,1998-03-23,113,0,3,117,120,6,3,9,129,5,11,New Jersey,New Brunswick,55181
13431,1998-1999,1998-12-01,1999-03-17,107,0,12,180,192,21,29,50,242,7,39,New Jersey,New Brunswick,55181
13432,1999-2000,1999-12-01,2000-04-10,132,4,25,173,198,24,92,116,314,8,40,New Jersey,New Brunswick,55181
13433,2000-2001,2000-12-01,2001-03-07,97,1,15,208,223,60,187,247,470,15,100,New Jersey,New Brunswick,55181
13434,2001-2002,2001-12-01,2002-03-18,108,0,3,119,122,8,10,18,140,4,16,New Jersey,New Brunswick,55181
13435,2002-2003,2002-11-27,2003-04-09,134,1,39,258,297,70,172,242,539,18,120,New Jersey,New Brunswick,55181
13436,2003-2004,2003-12-01,2004-03-20,111,0,37,217,254,53,120,173,427,15,96,New Jersey,New Brunswick,55181
13437,2004-2005,2004-12-01,2005-03-24,114,4,26,206,232,56,128,184,416,16,111,New Jersey,New Brunswick,55181
13438,2005-2006,2005-12-01,2006-04-06,127,3,9,160,169,42,72,114,283,8,59,New Jersey,New Brunswick,55181
13439,2006-2007,2006-12-01,2007-03-20,110,4,28,177,205,18,23,41,246,10,43,New Jersey,New Brunswick,55181
13440,2007-2008,2007-12-01,2008-03-01,92,1,7,137,144,16,16,32,176,10,36,New Jersey,New Brunswick,55181
13441,2008-2009,2008-10-29,2009-03-20,143,0,25,233,258,37,53,90,348,18,91,New Jersey,New Brunswick,55181
13442,2009-2010,2009-12-01,2010-03-05,95,0,14,159,173,72,180,252,425,16,103,New Jersey,New Brunswick,55181
13443,2010-2011,2010-12-01,2011-03-24,114,2,19,222,241,78,313,391,632,16,121,New Jersey,New Brunswick,55181
13444,2011-2012,2011-10-30,2012-02-29,123,2,5,126,131,10,14,24,155,5,19,New Jersey,New Brunswick,55181
13445,2012-2013,2012-11-08,2013-03-09,122,0,14,148,162,36,36,72,234,13,62,New Jersey,New Brunswick,55181
13446,2013-2014,2013-11-25,2014-04-16,143,0,47,301,348,76,226,302,650,22,154,New Jersey,New Brunswick,55181
13447,2014-2015,2014-11-27,2015-03-21,115,2,41,261,302,59,233,292,594,22,135,New Jersey,New Brunswick,55181
13448,2015-2016,2015-12-01,2016-03-21,112,7,13,132,145,53,84,137,282,12,76,New Jersey,New Brunswick,55181
13449,2016-2017,2016-12-01,2017-03-20,110,0,13,139,152,31,56,87,239,11,62,New Jersey,New Brunswick,55181
13450,2017-2018,2017-12-01,2018-04-03,124,0,30,201,231,62,85,147,378,17,104,New Jersey,New Brunswick,55181
13451,2018-2019,2018-11-16,2019-03-08,113,0,12,165,177,23,21,44,221,8,37,New Jersey,New Brunswick,55181
13452,2019-2020,2019-12-01,2020-02-29,91,0,3,101,104,6,4,10,114,4,11,New Jersey,New Brunswick,55181
13453,1950-1951,1950-12-01,1951-03-22,112,0,18,128,146,22,20,42,188,17,58,New Jersey,Newark,2406
13454,1951-1952,1951-12-01,1952-03-13,104,0,12,121,133,27,23,50,183,13,44,New Jersey,Newark,2406
13455,1952-1953,1952-10-20,1953-03-08,140,0,3,102,105,21,15,36,141,12,37,New Jersey,Newark,2406
13456,1953-1954,1953-11-06,1954-04-01,147,0,17,147,164,21,44,65,229,10,48,New Jersey,Newark,2406
13457,1954-1955,1954-12-01,1955-03-26,116,0,17,146,163,20,17,37,200,13,49,New Jersey,Newark,2406
13458,1955-1956,1955-11-19,1956-04-08,142,0,19,187,206,59,52,111,317,19,98,New Jersey,Newark,2406
13459,1956-1957,1956-11-23,1957-04-05,134,0,18,149,167,37,27,64,231,17,77,New Jersey,Newark,2406
13460,1957-1958,1957-12-01,1958-03-23,113,0,31,146,177,87,115,202,379,19,129,New Jersey,Newark,2406
13461,1958-1959,1958-11-30,1959-04-12,134,0,31,209,240,32,28,60,300,20,72,New Jersey,Newark,2406
13462,1959-1960,1959-11-29,1960-03-26,119,0,8,140,148,54,78,132,280,20,94,New Jersey,Newark,2406
13463,1960-1961,1960-12-01,1961-03-31,121,0,41,211,252,102,265,367,619,20,161,New Jersey,Newark,2406
13464,1961-1962,1961-11-20,1962-03-10,111,0,28,172,200,50,55,105,305,24,95,New Jersey,Newark,2406
13465,1962-1963,1962-11-18,1963-03-20,123,0,42,211,253,36,61,97,350,21,81,New Jersey,Newark,2406
13466,1963-1964,1963-12-01,1964-03-22,113,0,25,156,181,66,112,178,359,25,121,New Jersey,Newark,2406
13467,1964-1965,1964-12-01,1965-04-02,123,0,32,167,199,37,78,115,314,15,70,New Jersey,Newark,2406
13468,1965-1966,1965-12-01,1966-02-28,90,0,20,123,143,25,68,93,236,12,56,New Jersey,Newark,2406
13469,1966-1967,1966-12-01,1967-03-25,115,0,22,154,176,80,122,202,378,24,135,New Jersey,Newark,2406
13470,1967-1968,1967-11-30,1968-03-13,105,0,32,175,207,25,50,75,282,16,74,New Jersey,Newark,2406
13471,1968-1969,1968-11-12,1969-03-11,120,0,24,159,183,44,93,137,320,17,69,New Jersey,Newark,2406
13472,1969-1970,1969-12-01,1970-04-01,122,0,35,196,231,43,138,181,412,25,117,New Jersey,Newark,2406
13473,1970-1971,1970-12-01,1971-04-06,127,0,31,144,175,39,45,84,259,21,71,New Jersey,Newark,2406
13474,1971-1972,1971-12-01,1972-03-14,105,0,18,136,154,28,34,62,216,16,56,New Jersey,Newark,2406
13475,1972-1973,1972-12-01,1973-03-18,108,0,14,102,116,7,0,7,123,7,15,New Jersey,Newark,2406
13476,1973-1974,1973-12-01,1974-04-10,131,0,21,127,148,31,60,91,239,14,66,New Jersey,Newark,2406
13477,1974-1975,1974-12-01,1975-03-15,105,0,8,93,101,28,24,52,153,12,55,New Jersey,Newark,2406
13478,1975-1976,1975-12-01,1976-03-12,103,0,29,163,192,30,49,79,271,15,73,New Jersey,Newark,2406
13479,1976-1977,1976-11-30,1977-03-20,111,0,64,242,306,38,94,132,438,19,90,New Jersey,Newark,2406
13480,1977-1978,1977-11-27,1978-03-17,111,0,51,228,279,86,204,290,569,19,126,New Jersey,Newark,2406
13481,1978-1979,1978-11-27,1979-02-28,94,0,46,168,214,53,84,137,351,14,97,New Jersey,Newark,2406
13482,1979-1980,1979-12-01,1980-04-01,123,0,19,145,164,20,24,44,208,8,34,New Jersey,Newark,2406
13483,1980-1981,1980-11-17,1981-03-11,115,0,52,233,285,30,52,82,367,13,70,New Jersey,Newark,2406
13484,1981-1982,1981-12-01,1982-04-10,131,0,40,192,232,49,105,154,386,19,107,New Jersey,Newark,2406
13485,1982-1983,1982-12-01,1983-04-19,140,0,13,111,124,43,73,116,240,11,61,New Jersey,Newark,2406
13486,1983-1984,1983-11-25,1984-03-31,128,0,39,178,217,43,79,122,339,22,88,New Jersey,Newark,2406
13487,1984-1985,1984-12-01,1985-03-04,94,0,35,159,194,34,70,104,298,16,85,New Jersey,Newark,2406
13488,1985-1986,1985-11-16,1986-04-23,159,0,25,165,190,37,55,92,282,18,76,New Jersey,Newark,2406
13489,1986-1987,1986-12-01,1987-03-13,103,0,14,133,147,47,94,141,288,15,69,New Jersey,Newark,2406
13490,1987-1988,1987-11-10,1988-03-20,132,0,22,159,181,35,89,124,305,15,62,New Jersey,Newark,2406
13491,1988-1989,1988-12-01,1989-03-09,99,0,19,124,143,13,14,27,170,6,28,New Jersey,Newark,2406
13492,1989-1990,1989-11-22,1990-04-07,137,0,22,163,185,23,20,43,228,12,44,New Jersey,Newark,2406
13493,1990-1991,1990-12-01,1991-03-30,120,0,8,100,108,34,31,65,173,12,58,New Jersey,Newark,2406
13494,1991-1992,1991-12-01,1992-03-24,115,0,10,128,138,23,24,47,185,9,44,New Jersey,Newark,2406
13495,1992-1993,1992-12-01,1993-03-22,112,0,10,131,141,41,63,104,245,15,62,New Jersey,Newark,2406
13496,1993-1994,1993-12-01,1994-03-19,109,0,41,202,243,92,188,280,523,25,173,New Jersey,Newark,2406
13497,1994-1995,1994-12-01,1995-02-28,90,0,14,106,120,17,31,48,168,5,32,New Jersey,Newark,2406
13498,1995-1996,1995-11-29,1996-04-10,134,0,42,203,245,113,215,328,573,26,177,New Jersey,Newark,2406
13499,1996-1997,1996-11-28,1997-04-01,125,0,12,124,136,26,9,35,171,14,42,New Jersey,Newark,2406
13500,1997-1998,1997-11-14,1998-03-22,129,0,1,81,82,15,2,17,99,10,22,New Jersey,Newark,2406
13501,1998-1999,1998-12-01,1999-03-15,105,0,16,112,128,20,10,30,158,12,42,New Jersey,Newark,2406
13502,1999-2000,1999-12-01,2000-04-09,131,0,25,121,146,27,51,78,224,9,47,New Jersey,Newark,2406
13503,2000-2001,2000-12-01,2001-03-26,116,0,14,141,155,59,100,159,314,18,94,New Jersey,Newark,2406
13504,2001-2002,2001-12-01,2002-02-28,90,0,2,58,60,6,6,12,72,4,11,New Jersey,Newark,2406
13505,2002-2003,2002-11-27,2003-04-08,133,0,37,200,237,76,121,197,434,21,123,New Jersey,Newark,2406
13506,2003-2004,2003-12-01,2004-03-19,110,0,38,172,210,69,111,180,390,16,113,New Jersey,Newark,2406
13507,2004-2005,2004-12-01,2005-03-24,114,0,30,168,198,63,117,180,378,24,138,New Jersey,Newark,2406
13508,2005-2006,2005-12-01,2006-04-05,126,0,11,118,129,56,64,120,249,14,77,New Jersey,Newark,2406
13509,2006-2007,2006-12-01,2007-03-20,110,0,23,149,172,28,29,57,229,15,61,New Jersey,Newark,2406
13510,2007-2008,2007-11-19,2008-02-29,103,0,7,103,110,22,19,41,151,9,38,New Jersey,Newark,2406
13511,2008-2009,2008-12-01,2009-03-20,110,0,26,155,181,35,52,87,268,14,65,New Jersey,Newark,2406
13512,2009-2010,2009-12-01,2010-03-01,91,0,15,122,137,68,103,171,308,14,89,New Jersey,Newark,2406
13513,2010-2011,2010-12-01,2011-03-24,114,0,17,145,162,92,244,336,498,20,131,New Jersey,Newark,2406
13514,2011-2012,2011-10-29,2012-02-29,124,0,4,68,72,13,10,23,95,4,18,New Jersey,Newark,2406
13515,2012-2013,2012-11-07,2013-03-19,133,0,10,106,116,45,27,72,188,17,74,New Jersey,Newark,2406
13516,2013-2014,2013-11-24,2014-04-16,144,0,43,221,264,85,193,278,542,21,139,New Jersey,Newark,2406
13517,2014-2015,2014-11-26,2015-03-21,116,0,35,220,255,69,209,278,533,25,147,New Jersey,Newark,2406
13518,2015-2016,2015-12-01,2016-03-20,111,0,13,93,106,54,70,124,230,15,81,New Jersey,Newark,2406
13519,2016-2017,2016-12-01,2017-03-20,110,0,14,99,113,42,57,99,212,12,67,New Jersey,Newark,2406
13520,2017-2018,2017-12-01,2018-04-03,124,0,30,153,183,56,55,111,294,15,83,New Jersey,Newark,2406
13521,2018-2019,2018-11-15,2019-03-10,116,0,14,134,148,33,15,48,196,13,51,New Jersey,Newark,2406
13522,2019-2020,2019-12-01,2020-02-29,91,0,2,73,75,11,3,14,89,7,20,New Jersey,Newark,2406
13523,1950-1951,1950-12-01,1951-02-28,90,0,8,124,132,10,6,16,148,4,24,New Mexico,Albuquerque,545852
13524,1951-1952,1951-12-01,1952-03-17,108,0,1,144,145,7,6,13,158,2,11,New Mexico,Albuquerque,545852
13525,1952-1953,1952-11-23,1953-02-28,98,0,5,150,155,13,5,18,173,9,31,New Mexico,Albuquerque,545852
13526,1953-1954,1953-11-18,1954-02-28,103,0,2,124,126,19,12,31,157,9,35,New Mexico,Albuquerque,545852
13527,1954-1955,1954-12-01,1955-02-28,90,0,5,169,174,8,0,8,182,3,11,New Mexico,Albuquerque,545852
13528,1955-1956,1955-12-01,1956-02-29,91,0,5,117,122,12,7,19,141,6,33,New Mexico,Albuquerque,545852
13529,1956-1957,1956-11-20,1957-02-28,101,0,1,112,113,3,0,3,116,2,5,New Mexico,Albuquerque,545852
13530,1957-1958,1957-11-22,1958-03-08,107,0,2,132,134,17,4,21,155,7,28,New Mexico,Albuquerque,545852
13531,1958-1959,1958-11-16,1959-03-05,110,0,10,157,167,34,51,85,252,10,58,New Mexico,Albuquerque,545852
13532,1959-1960,1959-12-01,1960-03-17,108,0,6,152,158,32,16,48,206,13,52,New Mexico,Albuquerque,545852
13533,1960-1961,1960-12-01,1961-03-30,120,0,2,158,160,12,6,18,178,8,26,New Mexico,Albuquerque,545852
13534,1961-1962,1961-11-14,1962-03-21,128,0,12,218,230,18,4,22,252,11,38,New Mexico,Albuquerque,545852
13535,1962-1963,1962-12-01,1963-03-05,95,0,14,188,202,11,8,19,221,6,27,New Mexico,Albuquerque,545852
13536,1963-1964,1963-12-01,1964-03-08,99,0,12,249,261,17,15,32,293,11,44,New Mexico,Albuquerque,545852
13537,1964-1965,1964-12-01,1965-03-03,93,0,4,138,142,8,3,11,153,5,17,New Mexico,Albuquerque,545852
13538,1965-1966,1965-12-01,1966-03-04,94,0,5,208,213,17,11,28,241,9,37,New Mexico,Albuquerque,545852
13539,1966-1967,1966-12-01,1967-03-05,95,0,4,199,203,4,1,5,208,2,6,New Mexico,Albuquerque,545852
13540,1967-1968,1967-10-29,1968-03-21,145,0,8,163,171,16,6,22,193,11,35,New Mexico,Albuquerque,545852
13541,1968-1969,1968-12-01,1969-03-11,101,0,4,200,204,21,15,36,240,12,49,New Mexico,Albuquerque,545852
13542,1969-1970,1969-12-01,1970-03-27,117,0,4,165,169,10,1,11,180,5,18,New Mexico,Albuquerque,545852
13543,1970-1971,1970-10-15,1971-03-02,139,0,21,226,247,11,12,23,270,7,26,New Mexico,Albuquerque,545852
13544,1971-1972,1971-12-01,1972-02-29,91,0,9,178,187,13,24,37,224,5,25,New Mexico,Albuquerque,545852
13545,1972-1973,1972-11-12,1973-04-20,160,0,4,214,218,59,21,80,298,22,83,New Mexico,Albuquerque,545852
13546,1973-1974,1973-10-30,1974-03-10,132,0,12,242,254,23,17,40,294,11,50,New Mexico,Albuquerque,545852
13547,1974-1975,1974-12-01,1975-04-12,133,0,15,234,249,29,22,51,300,19,70,New Mexico,Albuquerque,545852
13548,1975-1976,1975-11-29,1976-04-16,140,0,2,219,221,10,0,10,231,8,19,New Mexico,Albuquerque,545852
13549,1976-1977,1976-11-27,1977-04-03,128,0,12,276,288,25,50,75,363,11,59,New Mexico,Albuquerque,545852
13550,1977-1978,1977-12-01,1978-05-02,153,0,2,127,129,20,7,27,156,10,37,New Mexico,Albuquerque,545852
13551,1978-1979,1978-12-01,1979-05-03,154,0,7,183,190,18,13,31,221,10,30,New Mexico,Albuquerque,545852
13552,1979-1980,1979-10-30,1980-03-31,154,0,0,173,173,15,10,25,198,12,29,New Mexico,Albuquerque,545852
13553,1980-1981,1980-11-15,1981-03-06,112,0,1,181,182,21,6,27,209,8,32,New Mexico,Albuquerque,545852
13554,1981-1982,1981-12-01,1982-03-05,95,0,0,145,145,11,4,15,160,8,25,New Mexico,Albuquerque,545852
13555,1982-1983,1982-11-26,1983-03-19,114,0,4,162,166,26,13,39,205,13,46,New Mexico,Albuquerque,545852
13556,1983-1984,1983-11-19,1984-04-26,160,0,1,203,204,13,4,17,221,7,23,New Mexico,Albuquerque,545852
13557,1984-1985,1984-12-01,1985-03-30,120,0,8,143,151,19,5,24,175,15,48,New Mexico,Albuquerque,545852
13558,1985-1986,1985-11-14,1986-03-18,125,0,5,134,139,21,20,41,180,10,47,New Mexico,Albuquerque,545852
13559,1986-1987,1986-10-12,1987-04-04,175,0,9,200,209,25,21,46,255,13,50,New Mexico,Albuquerque,545852
13560,1987-1988,1987-11-15,1988-04-02,140,0,6,179,185,27,8,35,220,13,47,New Mexico,Albuquerque,545852
13561,1988-1989,1988-11-19,1989-03-21,123,0,6,192,198,18,10,28,226,10,42,New Mexico,Albuquerque,545852
13562,1989-1990,1989-12-01,1990-04-18,139,0,2,179,181,16,4,20,201,11,33,New Mexico,Albuquerque,545852
13563,1990-1991,1990-11-07,1991-03-30,144,0,11,189,200,14,14,28,228,8,35,New Mexico,Albuquerque,545852
13564,1991-1992,1991-10-30,1992-03-08,131,0,4,148,152,24,7,31,183,16,47,New Mexico,Albuquerque,545852
13565,1992-1993,1992-11-04,1993-03-01,118,0,5,145,150,25,26,51,201,13,47,New Mexico,Albuquerque,545852
13566,1993-1994,1993-11-14,1994-03-28,135,0,0,166,166,10,3,13,179,7,18,New Mexico,Albuquerque,545852
13567,1994-1995,1994-12-01,1995-04-22,143,0,0,70,70,13,2,15,85,7,19,New Mexico,Albuquerque,545852
13568,1995-1996,1995-12-01,1996-03-06,97,3,0,93,93,8,2,10,103,7,17,New Mexico,Albuquerque,545852
13569,1996-1997,1996-10-21,1997-04-12,174,0,9,153,162,21,9,30,192,13,46,New Mexico,Albuquerque,545852
13570,1997-1998,1997-11-14,1998-04-26,164,0,3,162,165,21,10,31,196,14,39,New Mexico,Albuquerque,545852
13571,1998-1999,1998-11-09,1999-03-18,130,0,0,115,115,10,4,14,129,5,15,New Mexico,Albuquerque,545852
13572,1999-2000,1999-12-01,2000-03-23,114,0,1,110,111,8,1,9,120,6,11,New Mexico,Albuquerque,545852
13573,2000-2001,2000-11-07,2001-03-17,131,0,3,136,139,21,3,24,163,12,34,New Mexico,Albuquerque,545852
13574,2001-2002,2001-12-01,2002-02-28,90,0,1,119,120,9,2,11,131,6,18,New Mexico,Albuquerque,545852
13575,2002-2003,2002-12-01,2003-03-18,108,0,0,86,86,5,2,7,93,3,9,New Mexico,Albuquerque,545852
13576,2003-2004,2003-12-01,2004-03-04,95,0,2,120,122,10,3,13,135,7,15,New Mexico,Albuquerque,545852
13577,2004-2005,2004-11-29,2005-04-10,133,0,1,88,89,11,3,14,103,7,20,New Mexico,Albuquerque,545852
13578,2005-2006,2005-12-01,2006-03-22,112,0,0,114,114,5,0,5,119,4,9,New Mexico,Albuquerque,545852
13579,2006-2007,2006-11-30,2007-02-28,91,0,4,139,143,44,52,96,239,14,65,New Mexico,Albuquerque,545852
13580,2007-2008,2007-11-22,2008-03-03,103,0,4,144,148,12,1,13,161,11,24,New Mexico,Albuquerque,545852
13581,2008-2009,2008-12-01,2009-02-28,90,0,2,78,80,7,2,9,89,5,13,New Mexico,Albuquerque,545852
13582,2009-2010,2009-10-29,2010-03-24,147,0,1,150,151,11,0,11,162,11,23,New Mexico,Albuquerque,545852
13583,2010-2011,2010-11-25,2011-02-28,96,0,11,149,160,6,1,7,167,5,19,New Mexico,Albuquerque,545852
13584,2011-2012,2011-12-01,2012-04-03,125,0,2,118,120,17,8,25,145,12,35,New Mexico,Albuquerque,545852
13585,2012-2013,2012-12-01,2013-02-28,90,0,4,153,157,6,3,9,166,4,13,New Mexico,Albuquerque,545852
13586,2013-2014,2013-11-23,2014-02-28,98,0,2,123,125,11,6,17,142,8,23,New Mexico,Albuquerque,545852
13587,2014-2015,2014-12-01,2015-02-28,90,0,3,106,109,25,9,34,143,14,50,New Mexico,Albuquerque,545852
13588,2015-2016,2015-12-01,2016-02-29,91,0,2,113,115,15,11,26,141,10,27,New Mexico,Albuquerque,545852
13589,2016-2017,2016-11-28,2017-04-29,153,0,0,86,86,8,2,10,96,7,18,New Mexico,Albuquerque,545852
13590,2017-2018,2017-12-01,2018-02-28,90,0,0,101,101,2,0,2,103,2,4,New Mexico,Albuquerque,545852
13591,2018-2019,2018-12-01,2019-02-28,90,0,4,118,122,14,8,22,144,7,27,New Mexico,Albuquerque,545852
13592,2019-2020,2019-11-27,2020-04-13,139,0,2,110,112,12,3,15,127,9,22,New Mexico,Albuquerque,545852
13593,1950-1951,1950-11-09,1951-04-10,153,0,29,331,360,24,6,30,390,14,86,New Mexico,Clayton,2980
13594,1951-1952,1951-11-01,1952-04-09,161,0,17,329,346,24,12,36,382,15,77,New Mexico,Clayton,2980
13595,1952-1953,1952-11-09,1953-05-13,186,0,21,287,308,30,55,85,393,15,86,New Mexico,Clayton,2980
13596,1953-1954,1953-11-18,1954-03-13,116,0,14,223,237,22,26,48,285,16,76,New Mexico,Clayton,2980
13597,1954-1955,1954-12-01,1955-04-13,134,0,14,298,312,24,12,36,348,9,61,New Mexico,Clayton,2980
13598,1955-1956,1955-11-07,1956-03-15,130,0,16,305,321,10,6,16,337,9,51,New Mexico,Clayton,2980
13599,1956-1957,1956-11-02,1957-04-13,163,0,17,292,309,30,20,50,359,15,71,New Mexico,Clayton,2980
13600,1957-1958,1957-11-05,1958-04-12,159,0,15,297,312,59,80,139,451,28,133,New Mexico,Clayton,2980
13601,1958-1959,1958-11-16,1959-04-20,156,1,25,332,357,58,68,126,483,20,122,New Mexico,Clayton,2980
13602,1959-1960,1959-10-30,1960-03-16,139,0,32,340,372,30,39,69,441,20,102,New Mexico,Clayton,2980
13603,1960-1961,1960-10-15,1961-04-08,176,0,18,282,300,28,41,69,369,18,79,New Mexico,Clayton,2980
13604,1961-1962,1961-11-14,1962-03-30,137,0,43,333,376,31,45,76,452,11,92,New Mexico,Clayton,2980
13605,1962-1963,1962-11-17,1963-03-12,116,1,39,314,353,14,17,31,384,8,41,New Mexico,Clayton,2980
13606,1963-1964,1963-12-01,1964-04-07,129,0,18,333,351,21,34,55,406,12,66,New Mexico,Clayton,2980
13607,1964-1965,1964-11-04,1965-03-26,143,0,24,311,335,26,39,65,400,17,87,New Mexico,Clayton,2980
13608,1965-1966,1965-12-01,1966-03-22,112,0,17,254,271,21,37,58,329,11,66,New Mexico,Clayton,2980
13609,1966-1967,1966-10-17,1967-03-07,142,0,11,287,298,14,11,25,323,12,57,New Mexico,Clayton,2980
13610,1967-1968,1967-10-29,1968-03-13,137,0,23,293,316,31,43,74,390,16,90,New Mexico,Clayton,2980
13611,1968-1969,1968-11-07,1969-05-08,183,0,16,301,317,40,33,73,390,19,96,New Mexico,Clayton,2980
13612,1969-1970,1969-10-11,1970-04-30,202,0,19,337,356,41,36,77,433,19,92,New Mexico,Clayton,2980
13613,1970-1971,1970-10-07,1971-04-05,181,0,28,344,372,34,29,63,435,21,97,New Mexico,Clayton,2980
13614,1971-1972,1971-09-17,1972-04-15,212,1,12,280,292,28,29,57,349,12,71,New Mexico,Clayton,2980
13615,1972-1973,1972-10-31,1973-04-08,160,0,36,324,360,66,96,162,522,28,146,New Mexico,Clayton,2980
13616,1973-1974,1973-11-20,1974-03-10,111,2,24,244,268,27,42,69,337,14,85,New Mexico,Clayton,2980
13617,1974-1975,1974-11-28,1975-04-12,136,0,16,300,316,28,29,57,373,20,100,New Mexico,Clayton,2980
13618,1975-1976,1975-11-18,1976-03-29,133,1,17,244,261,16,13,29,290,11,47,New Mexico,Clayton,2980
13619,1976-1977,1976-11-12,1977-04-21,161,0,21,313,334,19,20,39,373,13,85,New Mexico,Clayton,2980
13620,1977-1978,1977-11-01,1978-05-04,185,0,32,305,337,40,45,85,422,23,130,New Mexico,Clayton,2980
13621,1978-1979,1978-11-11,1979-05-03,174,0,51,346,397,47,65,112,509,25,167,New Mexico,Clayton,2980
13622,1979-1980,1979-10-29,1980-04-25,180,0,15,309,324,32,32,64,388,20,84,New Mexico,Clayton,2980
13623,1980-1981,1980-11-14,1981-04-04,142,0,13,217,230,19,23,42,272,11,56,New Mexico,Clayton,2980
13624,1981-1982,1981-12-01,1982-04-10,131,1,27,267,294,23,36,59,353,11,76,New Mexico,Clayton,2980
13625,1982-1983,1982-11-23,1983-05-02,161,0,23,249,272,71,151,222,494,24,131,New Mexico,Clayton,2980
13626,1983-1984,1983-11-22,1984-03-31,131,0,64,352,416,48,80,128,544,21,129,New Mexico,Clayton,2980
13627,1985-1986,1985-11-30,1986-02-28,91,0,29,193,222,18,31,49,271,11,81,New Mexico,Clayton,2980
13628,1987-1988,1987-11-15,1988-04-02,140,0,29,320,349,58,79,137,486,24,143,New Mexico,Clayton,2980
13629,1988-1989,1988-11-15,1989-04-10,147,0,33,297,330,24,14,38,368,20,112,New Mexico,Clayton,2980
13630,1989-1990,1989-12-01,1990-05-03,154,0,25,265,290,65,86,151,441,18,135,New Mexico,Clayton,2980
13631,1990-1991,1990-10-08,1991-05-05,210,1,27,296,323,38,32,70,393,19,110,New Mexico,Clayton,2980
13632,1991-1992,1991-10-30,1992-04-01,155,0,13,209,222,24,24,48,270,11,60,New Mexico,Clayton,2980
13633,2004-2005,2004-11-01,2005-05-02,183,0,12,203,215,64,72,136,351,23,113,New Mexico,Clayton,2980
13634,2005-2006,2005-11-27,2006-03-23,117,0,11,225,236,13,5,18,254,8,41,New Mexico,Clayton,2980
13635,2006-2007,2006-11-29,2007-04-13,136,0,31,233,264,70,262,332,596,18,140,New Mexico,Clayton,2980
13636,2007-2008,2007-11-23,2008-04-17,147,0,10,255,265,26,14,40,305,18,70,New Mexico,Clayton,2980
13637,2008-2009,2008-11-27,2009-03-28,122,0,10,196,206,29,17,46,252,9,60,New Mexico,Clayton,2980
13638,2009-2010,2009-10-25,2010-03-20,147,0,17,248,265,48,124,172,437,19,96,New Mexico,Clayton,2980
13639,2010-2011,2010-12-01,2011-05-01,152,0,22,230,252,23,26,49,301,15,78,New Mexico,Clayton,2980
13640,2011-2012,2011-10-26,2012-02-29,127,0,13,202,215,44,77,121,336,15,85,New Mexico,Clayton,2980
13641,2012-2013,2012-12-01,2013-04-23,144,0,19,240,259,30,36,66,325,16,84,New Mexico,Clayton,2980
13642,2013-2014,2013-11-22,2014-04-13,143,1,32,269,301,19,10,29,330,13,90,New Mexico,Clayton,2980
13643,2014-2015,2014-11-11,2015-03-04,114,0,31,220,251,42,35,77,328,22,137,New Mexico,Clayton,2980
13644,2015-2016,2015-11-17,2016-05-01,167,0,8,205,213,41,35,76,289,17,78,New Mexico,Clayton,2980
13645,2016-2017,2016-12-01,2017-04-30,151,1,11,193,204,37,12,49,253,14,65,New Mexico,Clayton,2980
13646,2017-2018,2017-11-07,2018-02-28,114,0,11,229,240,2,0,2,242,2,10,New Mexico,Clayton,2980
13647,2018-2019,2018-10-14,2019-04-11,180,3,20,305,325,24,15,39,364,16,67,New Mexico,Clayton,2980
13648,2019-2020,2019-10-28,2020-04-14,170,0,12,251,263,22,8,30,293,15,69,New Mexico,Clayton,2980
13649,1952-1953,1952-11-09,1953-05-13,186,20,37,296,333,51,62,113,446,30,138,New Mexico,Los Alamos,17950
13650,1953-1954,1953-11-19,1954-03-31,133,3,18,228,246,45,62,107,353,19,95,New Mexico,Los Alamos,17950
13651,1954-1955,1954-12-01,1955-04-07,128,0,28,285,313,40,49,89,402,14,78,New Mexico,Los Alamos,17950
13652,1955-1956,1955-11-08,1956-04-03,148,1,14,225,239,72,108,180,419,20,133,New Mexico,Los Alamos,17950
13653,1956-1957,1956-11-02,1957-04-24,174,0,11,271,282,54,21,75,357,27,101,New Mexico,Los Alamos,17950
13654,1957-1958,1957-10-23,1958-04-15,175,2,19,373,392,182,259,441,833,44,293,New Mexico,Los Alamos,17950
13655,1958-1959,1958-10-30,1959-04-08,161,0,15,286,301,58,71,129,430,17,104,New Mexico,Los Alamos,17950
13656,1959-1960,1959-10-30,1960-05-01,185,2,36,356,392,128,202,330,722,32,236,New Mexico,Los Alamos,17950
13657,1960-1961,1960-10-15,1961-04-11,179,2,13,334,347,127,187,314,661,26,196,New Mexico,Los Alamos,17950
13658,1961-1962,1961-10-29,1962-05-28,212,7,26,347,373,98,331,429,802,31,185,New Mexico,Los Alamos,17950
13659,1962-1963,1962-11-17,1963-03-19,123,0,31,316,347,92,189,281,628,22,181,New Mexico,Los Alamos,17950
13660,1963-1964,1963-11-21,1964-04-07,139,0,32,389,421,73,106,179,600,30,177,New Mexico,Los Alamos,17950
13661,1964-1965,1964-11-18,1965-04-27,161,0,27,346,373,79,128,207,580,29,180,New Mexico,Los Alamos,17950
13662,1965-1966,1965-10-17,1966-04-19,185,1,31,350,381,56,162,218,599,22,130,New Mexico,Los Alamos,17950
13663,1966-1967,1966-10-17,1967-03-06,141,0,18,248,266,24,43,67,333,10,49,New Mexico,Los Alamos,17950
13664,1967-1968,1967-10-29,1968-04-23,178,0,20,316,336,111,243,354,690,33,200,New Mexico,Los Alamos,17950
13665,1968-1969,1968-11-16,1969-05-07,173,0,21,308,329,82,81,163,492,31,167,New Mexico,Los Alamos,17950
13666,1969-1970,1969-10-12,1970-05-02,203,0,28,321,349,72,108,180,529,28,154,New Mexico,Los Alamos,17950
13667,1970-1971,1970-09-22,1971-04-20,211,0,35,362,397,47,83,130,527,21,116,New Mexico,Los Alamos,17950
13668,1971-1972,1971-09-18,1972-03-28,193,1,16,308,324,67,216,283,607,19,128,New Mexico,Los Alamos,17950
13669,1976-1977,1976-11-12,1977-04-04,144,2,26,433,459,49,420,469,928,15,105,New Mexico,Los Alamos,17950
13670,1977-1978,1977-11-07,1978-05-08,183,18,15,268,283,50,41,91,374,13,83,New Mexico,Los Alamos,17950
13671,1978-1979,1978-10-25,1979-03-20,147,5,33,358,391,103,369,472,863,18,152,New Mexico,Los Alamos,17950
13672,1981-1982,1981-11-28,1982-05-05,159,14,21,286,307,124,187,311,618,29,203,New Mexico,Los Alamos,17950
13673,1983-1984,1983-11-18,1984-04-26,161,15,19,385,404,99,143,242,646,35,185,New Mexico,Los Alamos,17950
13674,1984-1985,1984-10-15,1985-04-27,195,14,24,341,365,174,350,524,889,47,280,New Mexico,Los Alamos,17950
13675,1985-1986,1985-11-14,1986-05-17,185,6,12,251,263,73,103,176,439,21,124,New Mexico,Los Alamos,17950
13676,1986-1987,1986-10-11,1987-04-07,179,3,24,342,366,210,382,592,958,40,308,New Mexico,Los Alamos,17950
13677,1987-1988,1987-11-15,1988-04-22,160,1,42,350,392,115,289,404,796,31,223,New Mexico,Los Alamos,17950
13678,1988-1989,1988-11-15,1989-03-20,126,2,24,300,324,76,105,181,505,25,152,New Mexico,Los Alamos,17950
13679,1989-1990,1989-11-30,1990-05-03,155,1,20,298,318,61,117,178,496,21,118,New Mexico,Los Alamos,17950
13680,1990-1991,1990-11-03,1991-03-30,148,5,36,358,394,56,228,284,678,23,125,New Mexico,Los Alamos,17950
13681,1991-1992,1991-10-30,1992-03-09,132,0,24,314,338,66,267,333,671,19,117,New Mexico,Los Alamos,17950
13682,1992-1993,1992-11-03,1993-03-29,147,7,27,349,376,113,650,763,1139,25,183,New Mexico,Los Alamos,17950
13683,1995-1996,1995-11-04,1996-03-15,133,0,18,261,279,60,193,253,532,17,124,New Mexico,Los Alamos,17950
13684,1996-1997,1996-10-21,1997-04-24,186,0,36,384,420,114,368,482,902,30,225,New Mexico,Los Alamos,17950
13685,1997-1998,1997-10-25,1998-04-26,184,5,21,374,395,78,364,442,837,27,149,New Mexico,Los Alamos,17950
13686,1998-1999,1998-12-01,1999-04-04,125,12,6,232,238,30,20,50,288,7,45,New Mexico,Los Alamos,17950
13687,1999-2000,1999-10-16,2000-04-01,169,8,8,274,282,23,10,33,315,12,43,New Mexico,Los Alamos,17950
13688,2000-2001,2000-11-03,2001-03-17,135,8,20,299,319,95,291,386,705,26,159,New Mexico,Los Alamos,17950
13689,2001-2002,2001-11-27,2002-03-03,97,4,19,277,296,20,49,69,365,5,41,New Mexico,Los Alamos,17950
13690,2002-2003,2002-11-04,2003-03-28,145,6,13,239,252,37,139,176,428,12,66,New Mexico,Los Alamos,17950
13691,2003-2004,2003-11-12,2004-04-11,152,2,25,296,321,91,238,329,650,23,148,New Mexico,Los Alamos,17950
13692,2004-2005,2004-11-13,2005-04-10,149,4,21,247,268,95,136,231,499,29,167,New Mexico,Los Alamos,17950
13693,2005-2006,2005-12-01,2006-03-23,113,3,7,219,226,11,2,13,239,6,23,New Mexico,Los Alamos,17950
13694,2006-2007,2006-11-30,2007-03-05,96,6,31,253,284,63,421,484,768,17,110,New Mexico,Los Alamos,17950
13695,2007-2008,2007-10-22,2008-04-17,179,15,36,344,380,64,291,355,735,21,124,New Mexico,Los Alamos,17950
13696,2008-2009,2008-11-27,2009-04-17,142,13,14,233,247,74,330,404,651,18,120,New Mexico,Los Alamos,17950
13697,2009-2010,2009-10-26,2010-05-02,189,7,33,369,402,89,709,798,1200,33,165,New Mexico,Los Alamos,17950
13698,2012-2013,2012-11-11,2013-03-08,118,0,32,294,326,28,120,148,474,10,63,New Mexico,Los Alamos,17950
13699,2013-2014,2013-10-15,2014-03-26,163,0,20,258,278,29,37,66,344,14,70,New Mexico,Los Alamos,17950
13700,2014-2015,2014-11-16,2015-04-26,162,4,18,223,241,62,64,126,367,23,118,New Mexico,Los Alamos,17950
13701,2015-2016,2015-11-05,2016-05-01,179,0,20,243,263,67,176,243,506,26,116,New Mexico,Los Alamos,17950
13702,2016-2017,2016-11-21,2017-05-19,180,0,12,206,218,47,109,156,374,24,86,New Mexico,Los Alamos,17950
13703,2017-2018,2017-12-01,2018-03-27,117,0,4,179,183,11,1,12,195,5,26,New Mexico,Los Alamos,17950
13704,2018-2019,2018-10-16,2019-03-31,167,0,35,287,322,91,373,464,786,22,166,New Mexico,Los Alamos,17950
13705,2019-2020,2019-10-24,2020-04-13,173,0,15,278,293,46,90,136,429,20,90,New Mexico,Los Alamos,17950
13706,1950-1951,1950-12-01,1951-02-28,90,0,7,187,194,5,1,6,200,4,22,New Mexico,Roswell,48366
13707,1951-1952,1951-11-01,1952-02-29,121,0,3,149,152,13,8,21,173,7,26,New Mexico,Roswell,48366
13708,1952-1953,1952-11-24,1953-02-28,97,0,1,141,142,11,3,14,156,4,18,New Mexico,Roswell,48366
13709,1953-1954,1953-12-01,1954-02-28,90,0,2,155,157,6,4,10,167,4,14,New Mexico,Roswell,48366
13710,1954-1955,1954-12-01,1955-03-21,111,0,0,174,174,6,4,10,184,4,15,New Mexico,Roswell,48366
13711,1955-1956,1955-11-07,1956-03-07,122,0,7,184,191,23,40,63,254,8,55,New Mexico,Roswell,48366
13712,1956-1957,1956-12-01,1957-02-28,90,0,0,105,105,0,0,0,105,0,0,New Mexico,Roswell,48366
13713,1957-1958,1957-11-21,1958-04-13,144,0,1,146,147,17,9,26,173,9,31,New Mexico,Roswell,48366
13714,1958-1959,1958-12-01,1959-03-04,94,0,4,161,165,5,0,5,170,3,14,New Mexico,Roswell,48366
13715,1959-1960,1959-12-01,1960-03-01,92,0,3,147,150,16,12,28,178,8,38,New Mexico,Roswell,48366
13716,1960-1961,1960-12-01,1961-03-19,109,0,14,260,274,38,63,101,375,10,61,New Mexico,Roswell,48366
13717,1961-1962,1961-11-13,1962-03-14,122,0,11,231,242,22,25,47,289,6,47,New Mexico,Roswell,48366
13718,1962-1963,1962-11-19,1963-02-28,102,2,13,238,251,17,12,29,280,10,60,New Mexico,Roswell,48366
13719,1963-1964,1963-12-01,1964-03-08,99,0,1,288,289,21,21,42,331,8,39,New Mexico,Roswell,48366
13720,1964-1965,1964-12-01,1965-03-03,93,0,3,162,165,18,11,29,194,9,43,New Mexico,Roswell,48366
13721,1965-1966,1965-12-01,1966-02-28,90,0,9,214,223,12,13,25,248,5,30,New Mexico,Roswell,48366
13722,1966-1967,1966-12-01,1967-03-05,95,0,0,211,211,5,0,5,216,3,8,New Mexico,Roswell,48366
13723,1967-1968,1967-11-27,1968-03-21,116,0,9,179,188,35,24,59,247,16,77,New Mexico,Roswell,48366
13724,1968-1969,1968-11-26,1969-03-24,119,0,0,195,195,29,12,41,236,8,39,New Mexico,Roswell,48366
13725,1969-1970,1969-12-01,1970-03-27,117,0,11,164,175,27,30,57,232,11,43,New Mexico,Roswell,48366
13726,1970-1971,1970-10-16,1971-03-02,138,0,7,185,192,10,5,15,207,6,26,New Mexico,Roswell,48366
13727,1971-1972,1971-12-01,1972-02-29,91,0,2,153,155,13,9,22,177,8,31,New Mexico,Roswell,48366
13728,1972-1973,1972-10-31,1973-04-08,160,1,8,155,163,32,20,52,215,14,58,New Mexico,Roswell,48366
13729,1973-1974,1973-12-01,1974-03-20,110,0,3,161,164,3,0,3,167,2,9,New Mexico,Roswell,48366
13730,1974-1975,1974-12-01,1975-03-29,119,0,3,129,132,13,9,22,154,7,26,New Mexico,Roswell,48366
13731,1975-1976,1975-12-01,1976-03-30,121,0,0,114,114,7,1,8,122,5,10,New Mexico,Roswell,48366
13732,1976-1977,1976-10-27,1977-03-05,130,0,7,174,181,17,12,29,210,12,50,New Mexico,Roswell,48366
13733,1977-1978,1977-12-01,1978-03-03,93,0,4,102,106,10,3,13,119,7,23,New Mexico,Roswell,48366
13734,1978-1979,1978-11-16,1979-02-28,105,0,19,148,167,24,23,47,214,9,59,New Mexico,Roswell,48366
13735,1979-1980,1979-10-30,1980-04-13,167,0,10,155,165,28,37,65,230,9,46,New Mexico,Roswell,48366
13736,1980-1981,1980-11-15,1981-02-28,106,0,5,120,125,25,42,67,192,8,38,New Mexico,Roswell,48366
13737,1981-1982,1981-12-01,1982-03-05,95,0,9,130,139,17,18,35,174,7,41,New Mexico,Roswell,48366
13738,1982-1983,1982-11-24,1983-04-07,135,0,10,112,122,38,33,71,193,14,61,New Mexico,Roswell,48366
13739,1983-1984,1983-12-01,1984-03-06,97,0,22,137,159,14,7,21,180,6,47,New Mexico,Roswell,48366
13740,1984-1985,1984-12-01,1985-02-28,90,0,10,113,123,15,14,29,152,11,51,New Mexico,Roswell,48366
13741,1985-1986,1985-12-01,1986-02-28,90,0,7,123,130,16,23,39,169,5,36,New Mexico,Roswell,48366
13742,1986-1987,1986-11-13,1987-03-29,137,0,6,125,131,27,25,52,183,11,52,New Mexico,Roswell,48366
13743,1987-1988,1987-12-01,1988-02-29,91,0,8,143,151,44,55,99,250,8,66,New Mexico,Roswell,48366
13744,1988-1989,1988-12-01,1989-03-21,111,0,5,129,134,13,12,25,159,6,29,New Mexico,Roswell,48366
13745,1989-1990,1989-12-01,1990-03-14,104,0,3,143,146,5,3,8,154,2,7,New Mexico,Roswell,48366
13746,1990-1991,1990-11-07,1991-02-28,114,0,3,100,103,6,2,8,111,5,17,New Mexico,Roswell,48366
13747,1991-1992,1991-10-30,1992-02-29,123,0,2,113,115,13,6,19,134,8,31,New Mexico,Roswell,48366
13748,1992-1993,1992-12-01,1993-02-28,90,0,1,90,91,7,14,21,112,3,17,New Mexico,Roswell,48366
13749,1993-1994,1993-10-29,1994-03-27,150,0,1,180,181,6,2,8,189,5,17,New Mexico,Roswell,48366
13750,1994-1995,1994-12-01,1995-02-28,90,0,1,56,57,2,1,3,60,2,5,New Mexico,Roswell,48366
13751,1995-1996,1995-11-28,1996-04-05,130,0,3,111,114,11,2,13,127,8,23,New Mexico,Roswell,48366
13752,2000-2001,2000-11-07,2001-02-28,114,3,4,152,156,25,39,64,220,7,37,New Mexico,Roswell,48366
13753,2004-2005,2004-11-13,2005-03-15,123,0,5,80,85,25,23,48,133,5,40,New Mexico,Roswell,48366
13754,2005-2006,2005-12-01,2006-03-22,112,0,1,111,112,1,0,1,113,1,2,New Mexico,Roswell,48366
13755,2006-2007,2006-11-29,2007-04-07,130,0,2,147,149,23,24,47,196,10,41,New Mexico,Roswell,48366
13756,2007-2008,2007-11-23,2008-03-07,106,0,0,131,131,22,16,38,169,6,30,New Mexico,Roswell,48366
13757,2008-2009,2008-12-01,2009-03-27,117,0,0,157,157,1,0,1,158,1,2,New Mexico,Roswell,48366
13758,2009-2010,2009-12-01,2010-03-20,110,0,5,144,149,25,13,38,187,9,46,New Mexico,Roswell,48366
13759,2010-2011,2010-12-01,2011-02-28,90,0,10,182,192,4,3,7,199,2,21,New Mexico,Roswell,48366
13760,2011-2012,2011-12-01,2012-02-29,91,0,6,122,128,21,37,58,186,6,34,New Mexico,Roswell,48366
13761,2012-2013,2012-12-01,2013-02-28,90,0,3,124,127,5,3,8,135,4,13,New Mexico,Roswell,48366
13762,2013-2014,2013-11-23,2014-02-28,98,0,8,149,157,9,6,15,172,5,17,New Mexico,Roswell,48366
13763,2014-2015,2014-11-13,2015-02-28,108,0,11,143,154,25,26,51,205,10,62,New Mexico,Roswell,48366
13764,2015-2016,2015-12-01,2016-02-29,91,0,5,131,136,26,74,100,236,4,38,New Mexico,Roswell,48366
13765,2016-2017,2016-12-01,2017-02-28,90,0,4,107,111,3,4,7,118,1,10,New Mexico,Roswell,48366
13766,2017-2018,2017-12-01,2018-02-28,90,0,2,139,141,0,0,0,141,0,0,New Mexico,Roswell,48366
13767,2018-2019,2018-12-01,2019-03-04,94,0,4,95,99,8,5,13,112,3,14,New Mexico,Roswell,48366
13768,2019-2020,2019-11-27,2020-02-29,95,1,0,75,75,7,2,9,84,3,10,New Mexico,Roswell,48366
13769,1950-1951,1950-11-23,1951-04-03,132,0,68,312,380,77,159,236,616,38,216,New York,Albany,97856
13770,1951-1952,1951-11-01,1952-03-20,141,0,69,361,430,96,256,352,782,37,223,New York,Albany,97856
13771,1952-1953,1952-10-28,1953-04-20,175,0,38,285,323,74,125,199,522,34,175,New York,Albany,97856
13772,1953-1954,1953-11-07,1954-04-04,149,0,66,331,397,69,122,191,588,27,159,New York,Albany,97856
13773,1954-1955,1954-11-29,1955-04-04,127,0,83,327,410,59,80,139,549,33,150,New York,Albany,97856
13774,1955-1956,1955-11-11,1956-04-23,165,0,99,421,520,114,261,375,895,41,259,New York,Albany,97856
13775,1956-1957,1956-11-10,1957-04-12,154,0,71,390,461,105,175,280,741,38,247,New York,Albany,97856
13776,1957-1958,1957-10-27,1958-03-24,149,0,85,333,418,109,292,401,819,32,241,New York,Albany,97856
13777,1958-1959,1958-11-03,1959-03-31,149,0,111,475,586,95,142,237,823,42,262,New York,Albany,97856
13778,1959-1960,1959-11-17,1960-04-08,144,0,80,353,433,101,291,392,825,47,253,New York,Albany,97856
13779,1960-1961,1960-11-06,1961-04-13,159,0,112,478,590,110,478,588,1178,30,246,New York,Albany,97856
13780,1961-1962,1961-11-20,1962-04-13,145,0,91,380,471,96,296,392,863,37,239,New York,Albany,97856
13781,1962-1963,1962-11-13,1963-03-25,133,0,108,464,572,113,422,535,1107,50,318,New York,Albany,97856
13782,1963-1964,1963-12-01,1964-03-31,122,0,96,410,506,113,350,463,969,38,282,New York,Albany,97856
13783,1964-1965,1964-11-22,1965-04-19,149,0,97,421,518,71,177,248,766,35,223,New York,Albany,97856
13784,1965-1966,1965-11-29,1966-05-09,162,0,60,368,428,99,195,294,722,37,226,New York,Albany,97856
13785,1966-1967,1966-12-01,1967-05-07,158,0,78,434,512,123,271,394,906,47,315,New York,Albany,97856
13786,1967-1968,1967-11-09,1968-03-16,129,0,102,450,552,71,167,238,790,35,250,New York,Albany,97856
13787,1968-1969,1968-11-12,1969-04-19,159,0,86,433,519,98,405,503,1022,46,253,New York,Albany,97856
13788,1969-1970,1969-11-20,1970-04-02,134,0,120,534,654,129,534,663,1317,47,403,New York,Albany,97856
13789,1970-1971,1970-12-01,1971-04-24,145,0,108,499,607,163,646,809,1416,49,366,New York,Albany,97856
13790,1971-1972,1971-11-22,1972-04-11,142,0,65,437,502,127,254,381,883,41,280,New York,Albany,97856
13791,1972-1973,1972-11-14,1973-04-04,142,0,59,351,410,102,194,296,706,31,191,New York,Albany,97856
13792,1973-1974,1973-11-06,1974-04-11,157,0,85,417,502,89,217,306,808,38,256,New York,Albany,97856
13793,1974-1975,1974-11-21,1975-04-06,137,0,49,365,414,88,212,300,714,42,221,New York,Albany,97856
13794,1975-1976,1975-11-14,1976-03-20,128,0,83,399,482,82,259,341,823,37,268,New York,Albany,97856
13795,1976-1977,1976-11-05,1977-05-09,186,0,110,476,586,108,293,401,987,45,296,New York,Albany,97856
13796,1977-1978,1977-11-13,1978-04-03,142,0,106,418,524,136,509,645,1169,48,319,New York,Albany,97856
13797,1978-1979,1978-11-21,1979-04-10,141,0,113,397,510,93,314,407,917,38,252,New York,Albany,97856
13798,1979-1980,1979-12-01,1980-03-17,108,0,73,345,418,44,48,92,510,16,114,New York,Albany,97856
13799,1980-1981,1980-11-17,1981-03-21,125,0,115,459,574,74,184,258,832,33,242,New York,Albany,97856
13800,1981-1982,1981-11-07,1982-04-11,156,0,113,464,577,147,361,508,1085,45,332,New York,Albany,97856
13801,1982-1983,1982-11-26,1983-05-09,165,0,54,285,339,109,173,282,621,24,172,New York,Albany,97856
13802,1983-1984,1983-11-25,1984-03-31,128,0,105,382,487,98,190,288,775,38,241,New York,Albany,97856
13803,1984-1985,1984-11-12,1985-04-01,141,0,73,326,399,66,119,185,584,33,198,New York,Albany,97856
13804,1985-1986,1985-11-16,1986-04-23,159,0,80,376,456,94,280,374,830,41,233,New York,Albany,97856
13805,1986-1987,1986-11-05,1987-04-28,175,0,59,386,445,111,408,519,964,28,182,New York,Albany,97856
13806,1987-1988,1987-10-04,1988-04-16,196,0,73,396,469,115,190,305,774,35,207,New York,Albany,97856
13807,1988-1989,1988-12-01,1989-04-10,131,0,62,356,418,36,36,72,490,26,136,New York,Albany,97856
13808,1989-1990,1989-11-20,1990-03-30,131,0,86,380,466,85,139,224,690,32,207,New York,Albany,97856
13809,1990-1991,1990-11-11,1991-03-30,140,0,44,278,322,47,83,130,452,24,115,New York,Albany,97856
13810,1991-1992,1991-11-11,1992-04-16,158,0,55,365,420,54,46,100,520,34,175,New York,Albany,97856
13811,1992-1993,1992-11-17,1993-04-26,161,1,63,381,444,134,351,485,929,42,273,New York,Albany,97856
13812,1993-1994,1993-11-01,1994-03-30,150,0,129,473,602,129,420,549,1151,45,371,New York,Albany,97856
13813,1994-1995,1994-11-23,1995-04-05,134,0,51,297,348,52,99,151,499,25,125,New York,Albany,97856
13814,1995-1996,1995-11-08,1996-04-08,153,19,123,415,538,125,335,460,998,44,317,New York,Albany,97856
13815,1996-1997,1996-11-13,1997-04-19,158,0,61,323,384,96,111,207,591,43,242,New York,Albany,97856
13816,1997-1998,1997-11-14,1998-03-23,130,0,33,247,280,78,185,263,543,32,150,New York,Albany,97856
13817,1998-1999,1998-12-01,1999-03-22,112,0,61,297,358,64,140,204,562,29,182,New York,Albany,97856
13818,1999-2000,1999-11-29,2000-04-11,135,0,75,313,388,91,215,306,694,24,180,New York,Albany,97856
13819,2000-2001,2000-10-29,2001-03-30,153,0,73,369,442,117,313,430,872,41,227,New York,Albany,97856
13820,2001-2002,2001-12-01,2002-05-18,169,0,17,231,248,75,113,188,436,31,138,New York,Albany,97856
13821,2002-2003,2002-10-23,2003-04-10,170,0,116,451,567,154,594,748,1315,55,352,New York,Albany,97856
13822,2003-2004,2003-11-25,2004-04-05,133,0,107,362,469,104,283,387,856,40,255,New York,Albany,97856
13823,2004-2005,2004-11-12,2005-03-24,133,0,90,369,459,114,232,346,805,41,288,New York,Albany,97856
13824,2005-2006,2005-10-23,2006-03-15,144,0,45,276,321,56,97,153,474,36,167,New York,Albany,97856
13825,2006-2007,2006-12-01,2007-04-16,137,0,78,325,403,75,195,270,673,30,189,New York,Albany,97856
13826,2007-2008,2007-11-20,2008-03-29,131,0,54,299,353,92,200,292,645,36,207,New York,Albany,97856
13827,2008-2009,2008-11-21,2009-03-12,112,0,82,331,413,77,239,316,729,26,177,New York,Albany,97856
13828,2009-2010,2009-12-01,2010-03-26,116,0,62,239,301,74,106,180,481,31,144,New York,Albany,97856
13829,2010-2011,2010-11-08,2011-04-01,145,0,91,364,455,118,434,552,1007,35,268,New York,Albany,97856
13830,2011-2012,2011-10-27,2012-03-09,135,0,22,221,243,39,35,74,317,21,91,New York,Albany,97856
13831,2012-2013,2012-11-07,2013-04-02,147,0,45,295,340,79,147,226,566,32,173,New York,Albany,97856
13832,2013-2014,2013-11-23,2014-04-16,145,0,110,440,550,111,273,384,934,39,279,New York,Albany,97856
13833,2014-2015,2014-11-14,2015-03-30,137,0,107,440,547,112,360,472,1019,43,300,New York,Albany,97856
13834,2015-2016,2015-12-01,2016-04-06,128,0,31,209,240,29,22,51,291,17,80,New York,Albany,97856
13835,2016-2017,2016-10-27,2017-04-01,157,0,37,271,308,93,150,243,551,36,176,New York,Albany,97856
13836,2017-2018,2017-12-01,2018-04-07,128,0,77,311,388,106,258,364,752,30,196,New York,Albany,97856
13837,2018-2019,2018-11-13,2019-04-06,145,0,61,322,383,80,181,261,644,37,181,New York,Albany,97856
13838,2019-2020,2019-11-12,2020-04-22,163,0,26,224,250,80,106,186,436,33,135,New York,Albany,97856
13839,1951-1952,1951-11-01,1952-04-08,160,3,96,380,476,122,198,320,796,64,360,New York,Binghamton,47376
13840,1952-1953,1952-10-20,1953-04-21,184,0,67,295,362,120,112,232,594,68,329,New York,Binghamton,47376
13841,1953-1954,1953-11-05,1954-04-04,151,0,88,335,423,104,105,209,632,58,345,New York,Binghamton,47376
13842,1954-1955,1954-11-01,1955-04-07,158,0,117,379,496,147,262,409,905,79,448,New York,Binghamton,47376
13843,1955-1956,1955-11-10,1956-04-23,166,0,133,448,581,189,405,594,1175,95,620,New York,Binghamton,47376
13844,1956-1957,1956-11-09,1957-04-14,157,0,96,387,483,141,198,339,822,77,430,New York,Binghamton,47376
13845,1957-1958,1957-10-27,1958-04-13,169,0,127,380,507,167,511,678,1185,77,469,New York,Binghamton,47376
13846,1958-1959,1958-10-26,1959-03-31,157,0,125,442,567,127,262,389,956,73,461,New York,Binghamton,47376
13847,1959-1960,1959-11-02,1960-04-11,162,0,103,346,449,159,442,601,1050,74,407,New York,Binghamton,47376
13848,1960-1961,1960-10-21,1961-04-18,180,5,150,420,570,148,494,642,1212,64,405,New York,Binghamton,47376
13849,1961-1962,1961-11-08,1962-05-08,182,0,136,432,568,106,222,328,896,65,371,New York,Binghamton,47376
13850,1962-1963,1962-10-26,1963-05-01,188,0,158,455,613,143,496,639,1252,61,409,New York,Binghamton,47376
13851,1963-1964,1963-11-02,1964-04-04,155,0,144,397,541,163,486,649,1190,74,509,New York,Binghamton,47376
13852,1964-1965,1964-11-22,1965-04-20,150,0,118,386,504,120,194,314,818,61,375,New York,Binghamton,47376
13853,1965-1966,1965-10-04,1966-05-10,219,0,115,364,479,140,214,354,833,76,417,New York,Binghamton,47376
13854,1966-1967,1966-11-29,1967-05-08,161,0,122,355,477,135,286,421,898,69,459,New York,Binghamton,47376
13855,1967-1968,1967-11-08,1968-03-24,138,0,147,420,567,105,229,334,901,64,452,New York,Binghamton,47376
13856,1968-1969,1968-10-26,1969-04-24,181,0,135,373,508,97,171,268,776,67,373,New York,Binghamton,47376
13857,1969-1970,1969-10-23,1970-04-11,171,0,139,417,556,180,653,833,1389,87,534,New York,Binghamton,47376
13858,1970-1971,1970-10-17,1971-04-26,192,0,159,419,578,166,636,802,1380,68,456,New York,Binghamton,47376
13859,1971-1972,1971-11-07,1972-04-10,156,0,110,396,506,167,314,481,987,85,501,New York,Binghamton,47376
13860,1972-1973,1972-10-18,1973-05-18,213,0,101,357,458,110,161,271,729,62,320,New York,Binghamton,47376
13861,1973-1974,1973-11-09,1974-04-12,155,0,91,329,420,126,265,391,811,49,321,New York,Binghamton,47376
13862,1974-1975,1974-10-02,1975-04-08,189,0,109,371,480,119,258,377,857,77,387,New York,Binghamton,47376
13863,1975-1976,1975-11-14,1976-04-27,166,0,111,382,493,125,315,440,933,61,400,New York,Binghamton,47376
13864,1976-1977,1976-10-22,1977-05-09,200,0,181,488,669,134,370,504,1173,82,558,New York,Binghamton,47376
13865,1977-1978,1977-11-11,1978-04-21,162,0,185,446,631,180,605,785,1416,77,568,New York,Binghamton,47376
13866,1978-1979,1978-11-20,1979-04-10,142,0,155,394,549,125,347,472,1021,63,400,New York,Binghamton,47376
13867,1979-1980,1979-10-26,1980-04-16,174,0,108,342,450,103,133,236,686,59,337,New York,Binghamton,47376
13868,1980-1981,1980-10-13,1981-03-21,160,0,146,433,579,111,269,380,959,73,434,New York,Binghamton,47376
13869,1981-1982,1981-11-07,1982-04-12,157,3,126,424,550,125,341,466,1016,61,378,New York,Binghamton,47376
13870,1982-1983,1982-10-16,1983-05-08,205,0,57,294,351,128,220,348,699,49,278,New York,Binghamton,47376
13871,1983-1984,1983-11-04,1984-04-04,153,0,120,375,495,116,288,404,899,67,389,New York,Binghamton,47376
13872,1984-1985,1984-11-12,1985-04-09,149,0,90,335,425,107,219,326,751,67,378,New York,Binghamton,47376
13873,1985-1986,1985-11-15,1986-04-23,160,0,129,370,499,124,440,564,1063,73,463,New York,Binghamton,47376
13874,1986-1987,1986-11-05,1987-04-28,175,0,72,311,383,119,412,531,914,48,256,New York,Binghamton,47376
13875,1987-1988,1987-11-06,1988-04-23,170,0,110,381,491,141,301,442,933,74,455,New York,Binghamton,47376
13876,1988-1989,1988-10-22,1989-05-08,199,0,94,385,479,93,108,201,680,66,355,New York,Binghamton,47376
13877,1989-1990,1989-10-21,1990-04-18,180,0,108,400,508,130,218,348,856,75,415,New York,Binghamton,47376
13878,1990-1991,1990-10-28,1991-04-22,177,0,65,291,356,114,120,234,590,65,328,New York,Binghamton,47376
13879,1991-1992,1991-11-07,1992-04-03,149,0,77,327,404,99,141,240,644,65,351,New York,Binghamton,47376
13880,1992-1993,1992-10-18,1993-04-26,191,0,104,418,522,182,460,642,1164,79,449,New York,Binghamton,47376
13881,1993-1994,1993-10-10,1994-04-07,180,0,160,470,630,192,807,999,1629,69,550,New York,Binghamton,47376
13882,1994-1995,1994-11-23,1995-04-09,138,0,81,320,401,89,156,245,646,51,301,New York,Binghamton,47376
13883,1995-1996,1995-11-09,1996-05-12,186,15,170,475,645,193,440,633,1278,75,523,New York,Binghamton,47376
13884,1996-1997,1996-11-02,1997-04-19,169,0,89,359,448,141,179,320,768,71,390,New York,Binghamton,47376
13885,1997-1998,1997-11-12,1998-03-26,135,3,62,244,306,142,257,399,705,57,309,New York,Binghamton,47376
13886,1998-1999,1998-11-21,1999-04-12,143,0,75,313,388,117,168,285,673,52,337,New York,Binghamton,47376
13887,1999-2000,1999-11-04,2000-04-11,160,0,95,323,418,127,277,404,822,56,388,New York,Binghamton,47376
13888,2000-2001,2000-10-09,2001-04-04,178,0,120,388,508,173,394,567,1075,80,495,New York,Binghamton,47376
13889,2001-2002,2001-10-27,2002-05-18,204,0,37,261,298,98,98,196,494,50,236,New York,Binghamton,47376
13890,2002-2003,2002-11-01,2003-04-10,161,0,159,439,598,181,555,736,1334,76,510,New York,Binghamton,47376
13891,2003-2004,2003-10-02,2004-04-05,187,0,136,395,531,160,396,556,1087,71,496,New York,Binghamton,47376
13892,2004-2005,2004-11-08,2005-04-04,148,0,112,373,485,146,342,488,973,58,417,New York,Binghamton,47376
13893,2005-2006,2005-10-25,2006-04-05,163,0,95,322,417,118,178,296,713,64,360,New York,Binghamton,47376
13894,2006-2007,2006-12-01,2007-04-19,140,0,105,320,425,116,242,358,783,54,366,New York,Binghamton,47376
13895,2007-2008,2007-11-09,2008-04-04,148,0,77,315,392,114,210,324,716,62,305,New York,Binghamton,47376
13896,2008-2009,2008-10-28,2009-04-08,163,0,119,396,515,120,310,430,945,71,433,New York,Binghamton,47376
13897,2009-2010,2009-10-15,2010-05-09,207,0,94,295,389,128,372,500,889,65,383,New York,Binghamton,47376
13898,2010-2011,2010-11-25,2011-04-06,133,3,129,369,498,177,454,631,1129,74,473,New York,Binghamton,47376
13899,2011-2012,2011-10-27,2012-04-27,184,0,34,228,262,70,59,129,391,44,186,New York,Binghamton,47376
13900,2012-2013,2012-11-04,2013-04-03,151,0,88,294,382,122,279,401,783,74,376,New York,Binghamton,47376
13901,2013-2014,2013-11-11,2014-04-16,157,0,166,469,635,142,345,487,1122,68,466,New York,Binghamton,47376
13902,2014-2015,2014-11-07,2015-04-24,169,0,156,474,630,149,552,701,1331,75,501,New York,Binghamton,47376
13903,2015-2016,2015-10-17,2016-04-12,179,0,64,275,339,59,62,121,460,43,224,New York,Binghamton,47376
13904,2016-2017,2016-10-27,2017-04-07,163,0,84,295,379,203,332,535,914,64,439,New York,Binghamton,47376
13905,2017-2018,2017-11-10,2018-04-20,162,2,120,382,502,144,306,450,952,63,448,New York,Binghamton,47376
13906,2018-2019,2018-10-18,2019-04-05,170,0,104,376,480,143,303,446,926,76,425,New York,Binghamton,47376
13907,2019-2020,2019-11-07,2020-05-12,188,0,61,304,365,126,264,390,755,65,312,New York,Binghamton,47376
13908,1950-1951,1950-11-03,1951-03-26,144,3,82,265,347,113,152,265,612,57,305,New York,Buffalo,261310
13909,1951-1952,1951-11-02,1952-04-11,162,0,65,291,356,127,147,274,630,59,311,New York,Buffalo,261310
13910,1952-1953,1952-10-19,1953-04-20,184,0,37,205,242,92,91,183,425,44,204,New York,Buffalo,261310
13911,1953-1954,1953-11-07,1954-04-05,150,0,65,253,318,129,125,254,572,55,315,New York,Buffalo,261310
13912,1954-1955,1954-10-31,1955-04-07,159,0,77,264,341,132,146,278,619,65,360,New York,Buffalo,261310
13913,1955-1956,1955-11-17,1956-04-23,159,0,80,318,398,167,167,334,732,74,417,New York,Buffalo,261310
13914,1956-1957,1956-11-23,1957-04-13,142,0,67,267,334,164,243,407,741,58,366,New York,Buffalo,261310
13915,1957-1958,1957-11-09,1958-04-08,151,0,88,278,366,180,293,473,839,64,398,New York,Buffalo,261310
13916,1958-1959,1958-11-24,1959-04-04,132,0,118,397,515,167,206,373,888,66,463,New York,Buffalo,261310
13917,1959-1960,1959-11-12,1960-04-09,150,1,90,311,401,168,337,505,906,64,368,New York,Buffalo,261310
13918,1960-1961,1960-10-24,1961-04-18,177,0,136,391,527,156,402,558,1085,65,455,New York,Buffalo,261310
13919,1961-1962,1961-11-08,1962-04-15,159,3,103,362,465,153,258,411,876,68,452,New York,Buffalo,261310
13920,1962-1963,1962-10-26,1963-05-01,188,0,134,426,560,145,608,753,1313,74,498,New York,Buffalo,261310
13921,1963-1964,1963-11-24,1964-04-09,138,0,87,303,390,121,341,462,852,69,346,New York,Buffalo,261310
13922,1964-1965,1964-11-19,1965-04-19,152,0,102,327,429,111,222,333,762,66,386,New York,Buffalo,261310
13923,1965-1966,1965-10-28,1966-05-09,194,0,93,314,407,159,299,458,865,74,415,New York,Buffalo,261310
13924,1966-1967,1966-11-03,1967-05-07,186,0,102,343,445,113,184,297,742,77,422,New York,Buffalo,261310
13925,1967-1968,1967-11-05,1968-04-25,173,0,119,345,464,121,280,401,865,66,398,New York,Buffalo,261310
13926,1968-1969,1968-11-12,1969-04-19,159,0,99,325,424,126,193,319,743,72,400,New York,Buffalo,261310
13927,1969-1970,1969-10-22,1970-04-10,171,0,118,400,518,181,396,577,1095,91,555,New York,Buffalo,261310
13928,1970-1971,1970-11-15,1971-04-25,162,0,103,343,446,152,258,410,856,78,435,New York,Buffalo,261310
13929,1971-1972,1971-11-04,1972-04-09,158,0,84,358,442,164,255,419,861,81,455,New York,Buffalo,261310
13930,1972-1973,1972-10-15,1973-05-05,203,3,73,288,361,128,199,327,688,65,326,New York,Buffalo,261310
13931,1973-1974,1973-11-05,1974-05-07,184,0,94,318,412,142,249,391,803,78,413,New York,Buffalo,261310
13932,1974-1975,1974-11-13,1975-04-13,152,0,57,248,305,144,216,360,665,68,299,New York,Buffalo,261310
13933,1975-1976,1975-11-13,1976-04-27,167,0,90,314,404,129,316,445,849,69,362,New York,Buffalo,261310
13934,1976-1977,1976-10-21,1977-05-08,200,0,156,422,578,288,811,1099,1677,99,775,New York,Buffalo,261310
13935,1977-1978,1977-11-11,1978-05-01,172,0,149,411,560,220,629,849,1409,80,594,New York,Buffalo,261310
13936,1978-1979,1978-11-20,1979-04-12,144,0,147,371,518,147,463,610,1128,66,484,New York,Buffalo,261310
13937,1979-1980,1979-11-15,1980-04-16,154,0,94,291,385,110,176,286,671,53,330,New York,Buffalo,261310
13938,1980-1981,1980-11-17,1981-03-27,131,0,105,330,435,101,276,377,812,66,382,New York,Buffalo,261310
13939,1981-1982,1981-11-06,1982-04-12,158,0,123,376,499,168,410,578,1077,67,447,New York,Buffalo,261310
13940,1982-1983,1982-11-05,1983-04-25,172,0,54,250,304,87,117,204,508,41,194,New York,Buffalo,261310
13941,1983-1984,1983-11-03,1984-04-07,157,0,130,358,488,192,521,713,1201,71,467,New York,Buffalo,261310
13942,1984-1985,1984-11-12,1985-04-09,149,0,86,293,379,155,362,517,896,59,378,New York,Buffalo,261310
13943,1985-1986,1985-11-22,1986-04-22,152,0,98,300,398,179,343,522,920,76,470,New York,Buffalo,261310
13944,1986-1987,1986-11-11,1987-04-04,145,0,53,264,317,105,180,285,602,50,242,New York,Buffalo,261310
13945,1987-1988,1987-11-05,1988-04-19,167,0,77,290,367,92,109,201,568,51,267,New York,Buffalo,261310
13946,1988-1989,1988-10-25,1989-05-07,195,0,82,298,380,111,115,226,606,58,310,New York,Buffalo,261310
13947,1989-1990,1989-11-03,1990-04-12,161,0,88,315,403,149,230,379,782,68,390,New York,Buffalo,261310
13948,1990-1991,1990-11-11,1991-04-02,143,0,44,223,267,97,110,207,474,57,262,New York,Buffalo,261310
13949,1991-1992,1991-10-06,1992-04-04,182,0,62,305,367,149,168,317,684,64,364,New York,Buffalo,261310
13950,1992-1993,1992-10-20,1993-04-17,180,0,61,316,377,146,290,436,813,62,325,New York,Buffalo,261310
13951,1993-1994,1993-10-30,1994-04-07,160,0,120,386,506,161,391,552,1058,60,425,New York,Buffalo,261310
13952,1994-1995,1994-11-23,1995-04-10,139,0,66,281,347,112,182,294,641,44,275,New York,Buffalo,261310
13953,1995-1996,1995-11-04,1996-04-17,166,0,141,394,535,220,406,626,1161,84,552,New York,Buffalo,261310
13954,1996-1997,1996-11-09,1997-04-19,162,0,67,296,363,156,167,323,686,74,394,New York,Buffalo,261310
13955,1997-1998,1997-10-22,1998-03-26,156,0,42,186,228,123,192,315,543,54,246,New York,Buffalo,261310
13956,1998-1999,1998-11-11,1999-04-12,153,0,77,261,338,145,273,418,756,43,314,New York,Buffalo,261310
13957,1999-2000,1999-11-03,2000-04-12,162,0,75,256,331,104,208,312,643,54,294,New York,Buffalo,261310
13958,2000-2001,2000-11-14,2001-04-17,155,0,91,299,390,239,440,679,1069,88,519,New York,Buffalo,261310
13959,2001-2002,2001-10-25,2002-04-06,164,0,38,184,222,186,309,495,717,45,292,New York,Buffalo,261310
13960,2002-2003,2002-11-01,2003-04-09,160,0,127,372,499,168,375,543,1042,69,448,New York,Buffalo,261310
13961,2003-2004,2003-11-13,2004-04-27,167,0,98,311,409,156,360,516,925,65,411,New York,Buffalo,261310
13962,2004-2005,2004-11-08,2005-04-24,168,0,97,347,444,157,308,465,909,62,407,New York,Buffalo,261310
13963,2005-2006,2005-11-16,2006-04-04,140,0,59,232,291,117,156,273,564,58,292,New York,Buffalo,261310
13964,2006-2007,2006-10-12,2007-04-15,186,1,94,277,371,140,164,304,675,60,376,New York,Buffalo,261310
13965,2007-2008,2007-11-06,2008-03-29,145,0,64,272,336,157,221,378,714,66,351,New York,Buffalo,261310
13966,2008-2009,2008-10-29,2009-04-08,162,0,102,333,435,152,242,394,829,69,427,New York,Buffalo,261310
13967,2009-2010,2009-12-01,2010-03-26,116,0,82,243,325,117,316,433,758,50,302,New York,Buffalo,261310
13968,2010-2011,2010-11-26,2011-04-18,144,0,104,322,426,161,411,572,998,66,403,New York,Buffalo,261310
13969,2011-2012,2011-12-01,2012-04-24,146,0,22,162,184,62,53,115,299,36,152,New York,Buffalo,261310
13970,2012-2013,2012-11-25,2013-04-02,129,0,59,210,269,103,137,240,509,58,269,New York,Buffalo,261310
13971,2013-2014,2013-11-11,2014-04-15,156,0,148,419,567,191,304,495,1062,73,572,New York,Buffalo,261310
13972,2014-2015,2014-11-13,2015-04-04,143,0,143,410,553,172,526,698,1251,68,519,New York,Buffalo,261310
13973,2015-2016,2015-12-01,2016-04-10,132,0,48,205,253,80,97,177,430,35,201,New York,Buffalo,261310
13974,2016-2017,2016-11-20,2017-04-08,140,0,54,200,254,109,144,253,507,41,232,New York,Buffalo,261310
13975,2017-2018,2017-10-31,2018-04-19,171,0,105,319,424,159,312,471,895,65,435,New York,Buffalo,261310
13976,2018-2019,2018-11-09,2019-04-27,170,0,84,315,399,176,230,406,805,61,391,New York,Buffalo,261310
13977,2019-2020,2019-11-07,2020-05-09,185,0,33,202,235,104,138,242,477,51,208,New York,Buffalo,261310
13978,1950-1951,1950-11-22,1951-04-04,134,0,67,358,425,86,246,332,757,46,265,New York,Cooperstown,1852
13979,1951-1952,1951-11-01,1952-03-23,144,0,68,401,469,108,398,506,975,53,302,New York,Cooperstown,1852
13980,1953-1954,1953-11-06,1954-04-04,150,0,61,388,449,77,208,285,734,43,271,New York,Cooperstown,1852
13981,1954-1955,1954-11-02,1955-04-04,154,0,87,446,533,96,298,394,927,49,266,New York,Cooperstown,1852
13982,1955-1956,1955-10-27,1956-05-17,204,0,95,535,630,191,789,980,1610,68,451,New York,Cooperstown,1852
13983,1956-1957,1956-11-10,1957-04-14,156,2,65,450,515,123,281,404,919,56,362,New York,Cooperstown,1852
13984,1957-1958,1957-10-27,1958-04-12,168,0,80,426,506,125,642,767,1273,52,329,New York,Cooperstown,1852
13985,1958-1959,1958-10-27,1959-03-31,156,0,108,534,642,107,386,493,1135,48,336,New York,Cooperstown,1852
13986,1959-1960,1959-11-03,1960-04-09,159,1,76,468,544,117,577,694,1238,46,279,New York,Cooperstown,1852
13987,1960-1961,1960-10-25,1961-04-17,175,2,105,533,638,110,512,622,1260,38,286,New York,Cooperstown,1852
13988,1961-1962,1961-11-09,1962-04-15,158,0,81,464,545,89,362,451,996,35,214,New York,Cooperstown,1852
13989,1964-1965,1964-10-11,1965-04-19,191,5,82,496,578,101,297,398,976,41,273,New York,Cooperstown,1852
13990,1966-1967,1966-11-30,1967-05-08,160,0,80,436,516,108,442,550,1066,49,309,New York,Cooperstown,1852
13991,1967-1968,1967-11-10,1968-03-25,137,0,112,509,621,86,371,457,1078,38,272,New York,Cooperstown,1852
13992,1968-1969,1968-11-13,1969-03-31,139,0,103,461,564,101,585,686,1250,40,270,New York,Cooperstown,1852
13993,1969-1970,1969-10-23,1970-04-11,171,0,126,584,710,158,884,1042,1752,56,425,New York,Cooperstown,1852
13994,1970-1971,1970-11-17,1971-05-05,170,0,109,519,628,200,857,1057,1685,65,471,New York,Cooperstown,1852
13995,1971-1972,1971-11-08,1972-04-12,157,0,75,475,550,156,488,644,1194,63,404,New York,Cooperstown,1852
13996,1972-1973,1972-11-14,1973-05-19,187,0,66,396,462,113,299,412,874,47,284,New York,Cooperstown,1852
13997,1973-1974,1973-11-06,1974-04-12,158,1,78,438,516,108,303,411,927,41,273,New York,Cooperstown,1852
13998,1974-1975,1974-10-04,1975-04-12,191,0,61,433,494,116,374,490,984,56,304,New York,Cooperstown,1852
13999,1975-1976,1975-11-14,1976-05-20,189,0,92,481,573,136,502,638,1211,56,414,New York,Cooperstown,1852
14000,1976-1977,1976-11-06,1977-05-10,186,0,129,555,684,174,633,807,1491,65,506,New York,Cooperstown,1852
14001,1977-1978,1977-10-16,1978-04-16,183,0,116,530,646,191,840,1031,1677,75,570,New York,Cooperstown,1852
14002,1978-1979,1978-11-21,1979-04-12,143,0,127,491,618,148,654,802,1420,65,437,New York,Cooperstown,1852
14003,1979-1980,1979-11-15,1980-04-05,143,0,92,415,507,87,315,402,909,44,280,New York,Cooperstown,1852
14004,1980-1981,1980-11-02,1981-04-21,171,0,110,537,647,101,411,512,1159,53,383,New York,Cooperstown,1852
14005,1981-1982,1981-10-25,1982-04-12,170,0,108,519,627,123,632,755,1382,62,372,New York,Cooperstown,1852
14006,1982-1983,1982-11-27,1983-04-27,152,0,52,370,422,139,328,467,889,35,253,New York,Cooperstown,1852
14007,1983-1984,1983-11-12,1984-04-05,146,1,99,447,546,108,403,511,1057,49,324,New York,Cooperstown,1852
14008,1984-1985,1984-11-13,1985-04-10,149,0,87,413,500,101,336,437,937,47,328,New York,Cooperstown,1852
14009,1985-1986,1985-11-17,1986-04-24,159,1,86,432,518,123,617,740,1258,48,338,New York,Cooperstown,1852
14010,1986-1987,1986-11-06,1987-04-28,174,2,58,469,527,135,621,756,1283,42,263,New York,Cooperstown,1852
14011,1987-1988,1987-10-04,1988-04-20,200,3,76,455,531,103,343,446,977,48,296,New York,Cooperstown,1852
14012,1988-1989,1988-10-13,1989-04-11,181,6,64,457,521,60,116,176,697,40,231,New York,Cooperstown,1852
14013,1989-1990,1989-11-13,1990-04-19,158,0,94,465,559,143,364,507,1066,65,419,New York,Cooperstown,1852
14014,1990-1991,1990-11-08,1991-04-02,146,1,58,357,415,87,215,302,717,46,281,New York,Cooperstown,1852
14015,1991-1992,1991-11-12,1992-04-17,158,4,68,451,519,90,232,322,841,53,361,New York,Cooperstown,1852
14016,1992-1993,1992-10-21,1993-04-24,186,0,89,513,602,176,649,825,1427,57,436,New York,Cooperstown,1852
14017,1993-1994,1993-10-31,1994-04-18,170,1,155,593,748,189,836,1025,1773,59,518,New York,Cooperstown,1852
14018,1994-1995,1994-11-23,1995-04-10,139,1,70,401,471,79,237,316,787,35,243,New York,Cooperstown,1852
14019,1995-1996,1995-11-09,1996-05-13,187,5,134,522,656,169,495,664,1320,57,413,New York,Cooperstown,1852
14020,1996-1997,1996-11-03,1997-05-02,181,1,68,409,477,160,362,522,999,70,410,New York,Cooperstown,1852
14021,1997-1998,1997-11-14,1998-03-25,132,0,48,307,355,117,382,499,854,42,236,New York,Cooperstown,1852
14022,1998-1999,1998-12-01,1999-03-26,116,0,69,358,427,86,277,363,790,31,228,New York,Cooperstown,1852
14023,1999-2000,1999-11-16,2000-04-14,151,8,94,405,499,110,409,519,1018,31,258,New York,Cooperstown,1852
14024,2000-2001,2000-11-18,2001-04-12,146,4,87,464,551,146,720,866,1417,57,395,New York,Cooperstown,1852
14025,2001-2002,2001-11-20,2002-05-19,181,2,33,320,353,79,188,267,620,34,168,New York,Cooperstown,1852
14026,2002-2003,2002-10-23,2003-04-24,184,10,121,566,687,161,806,967,1654,39,317,New York,Cooperstown,1852
14027,2005-2006,2005-10-26,2006-04-04,161,12,66,336,402,85,272,357,759,33,193,New York,Cooperstown,1852
14028,2006-2007,2006-11-04,2007-04-18,166,10,76,403,479,140,461,601,1080,38,321,New York,Cooperstown,1852
14029,2010-2011,2010-11-08,2011-03-27,140,12,134,395,529,213,543,756,1285,49,464,New York,Cooperstown,1852
14030,2011-2012,2011-10-27,2012-03-10,136,13,45,260,305,53,81,134,439,27,150,New York,Cooperstown,1852
14031,2012-2013,2012-11-17,2013-04-02,137,3,92,302,394,110,299,409,803,37,268,New York,Cooperstown,1852
14032,2014-2015,2014-11-13,2015-04-23,162,1,171,521,692,137,672,809,1501,45,400,New York,Cooperstown,1852
14033,2015-2016,2015-11-23,2016-04-07,137,1,62,255,317,40,73,113,430,23,150,New York,Cooperstown,1852
14034,2016-2017,2016-11-20,2017-03-30,131,0,89,334,423,165,433,598,1021,36,338,New York,Cooperstown,1852
14035,2017-2018,2017-11-08,2018-04-19,163,2,158,442,600,130,410,540,1140,28,253,New York,Cooperstown,1852
14036,2018-2019,2018-11-11,2019-04-01,142,6,174,412,586,152,462,614,1200,39,312,New York,Cooperstown,1852
14037,2019-2020,2019-11-08,2020-04-26,171,5,109,319,428,97,315,412,840,28,204,New York,Cooperstown,1852
14038,1963-1964,1963-12-01,1964-03-13,104,9,27,203,230,56,110,166,396,11,94,New York,Islip,335543
14039,1964-1965,1964-12-01,1965-04-02,123,1,35,226,261,58,106,164,425,14,103,New York,Islip,335543
14040,1965-1966,1965-12-01,1966-02-28,90,5,16,160,176,24,50,74,250,8,34,New York,Islip,335543
14041,1966-1967,1966-12-01,1967-03-27,117,5,32,262,294,78,86,164,458,15,124,New York,Islip,335543
14042,1967-1968,1967-11-16,1968-03-14,120,0,63,288,351,34,62,96,447,13,92,New York,Islip,335543
14043,1968-1969,1968-12-01,1969-03-30,120,0,33,217,250,63,74,137,387,11,83,New York,Islip,335543
14044,1969-1970,1969-12-01,1970-03-30,120,7,43,227,270,42,67,109,379,12,92,New York,Islip,335543
14045,1970-1971,1970-12-01,1971-04-07,128,0,32,184,216,29,32,61,277,12,46,New York,Islip,335543
14046,1971-1972,1971-12-01,1972-03-12,103,0,18,148,166,24,28,52,218,8,41,New York,Islip,335543
14047,1972-1973,1972-12-01,1973-02-28,90,1,19,132,151,7,4,11,162,3,22,New York,Islip,335543
14048,1973-1974,1973-12-01,1974-03-30,120,0,23,171,194,50,62,112,306,11,79,New York,Islip,335543
14049,1974-1975,1974-11-25,1975-03-11,107,0,8,153,161,21,23,44,205,5,36,New York,Islip,335543
14050,1975-1976,1975-12-01,1976-03-11,102,0,31,194,225,43,64,107,332,10,73,New York,Islip,335543
14051,1976-1977,1976-11-30,1977-03-18,109,2,61,255,316,41,110,151,467,13,82,New York,Islip,335543
14052,1977-1978,1977-11-27,1978-03-19,113,1,58,270,328,95,244,339,667,18,143,New York,Islip,335543
14053,1978-1979,1978-11-27,1979-02-28,94,0,60,190,250,43,50,93,343,13,95,New York,Islip,335543
14054,1979-1980,1979-12-01,1980-03-14,105,0,23,163,186,14,9,23,209,5,24,New York,Islip,335543
14055,1980-1981,1980-12-01,1981-03-17,107,0,35,211,246,31,61,92,338,9,58,New York,Islip,335543
14056,1981-1982,1981-12-01,1982-04-09,130,0,29,179,208,51,69,120,328,11,80,New York,Islip,335543
14057,1982-1983,1982-12-01,1983-04-20,141,0,21,124,145,46,57,103,248,9,64,New York,Islip,335543
14058,1983-1984,1983-12-01,1984-03-30,121,0,42,188,230,40,62,102,332,13,82,New York,Islip,335543
14059,1984-1985,1984-12-01,1985-02-28,90,0,31,145,176,38,61,99,275,13,82,New York,Islip,335543
14060,1985-1986,1985-12-01,1986-03-21,111,0,25,194,219,27,61,88,307,15,76,New York,Islip,335543
14061,1986-1987,1986-12-01,1987-03-21,111,0,20,173,193,35,66,101,294,15,58,New York,Islip,335543
14062,1987-1988,1987-11-11,1988-03-21,132,0,27,203,230,29,73,102,332,13,55,New York,Islip,335543
14063,1988-1989,1988-12-01,1989-03-09,99,0,23,154,177,29,40,69,246,7,51,New York,Islip,335543
14064,1989-1990,1989-11-23,1990-04-07,136,0,34,200,234,30,24,54,288,10,57,New York,Islip,335543
14065,1990-1991,1990-12-01,1991-03-15,105,0,10,133,143,18,10,28,171,6,26,New York,Islip,335543
14066,1991-1992,1991-12-01,1992-03-23,114,0,14,170,184,21,15,36,220,9,45,New York,Islip,335543
14067,1992-1993,1992-12-01,1993-03-18,108,0,12,176,188,40,23,63,251,10,60,New York,Islip,335543
14068,1993-1994,1993-12-01,1994-03-19,109,6,50,224,274,54,113,167,441,14,100,New York,Islip,335543
14069,1994-1995,1994-12-01,1995-02-28,90,0,10,109,119,8,20,28,147,2,16,New York,Islip,335543
14070,1995-1996,1995-11-29,1996-04-11,135,6,37,218,255,107,204,311,566,24,172,New York,Islip,335543
14071,1996-1997,1996-11-28,1997-04-01,125,2,15,161,176,20,17,37,213,9,36,New York,Islip,335543
14072,1997-1998,1997-12-01,1998-03-22,112,0,2,89,91,4,0,4,95,2,6,New York,Islip,335543
14073,1998-1999,1998-12-01,1999-03-17,107,0,14,147,161,28,24,52,213,10,48,New York,Islip,335543
14074,2004-2005,2004-12-01,2005-03-24,114,0,37,208,245,83,210,293,538,27,170,New York,Islip,335543
14075,2005-2006,2005-11-24,2006-04-05,133,0,13,153,166,48,61,109,275,10,64,New York,Islip,335543
14076,2006-2007,2006-12-01,2007-03-20,110,0,24,170,194,16,12,28,222,11,39,New York,Islip,335543
14077,2007-2008,2007-12-01,2008-02-29,91,0,8,133,141,19,10,29,170,11,43,New York,Islip,335543
14078,2008-2009,2008-11-22,2009-03-20,119,0,26,196,222,51,75,126,348,17,89,New York,Islip,335543
14079,2009-2010,2009-12-01,2010-03-05,95,0,22,139,161,76,136,212,373,17,106,New York,Islip,335543
14080,2010-2011,2010-12-01,2011-03-24,114,0,25,197,222,76,230,306,528,19,114,New York,Islip,335543
14081,2011-2012,2011-10-29,2012-02-29,124,0,5,103,108,8,8,16,124,5,16,New York,Islip,335543
14082,2012-2013,2012-11-07,2013-03-21,135,0,20,137,157,69,105,174,331,23,107,New York,Islip,335543
14083,2013-2014,2013-11-12,2014-04-16,156,0,42,240,282,91,165,256,538,24,154,New York,Islip,335543
14084,2014-2015,2014-12-01,2015-03-29,119,0,39,245,284,88,294,382,666,22,157,New York,Islip,335543
14085,2015-2016,2015-12-01,2016-04-03,125,0,14,111,125,51,94,145,270,10,68,New York,Islip,335543
14086,2016-2017,2016-12-01,2017-03-15,105,0,14,125,139,54,76,130,269,11,78,New York,Islip,335543
14087,2017-2018,2017-12-01,2018-04-02,123,0,35,164,199,91,107,198,397,18,125,New York,Islip,335543
14088,2018-2019,2018-11-15,2019-03-10,116,0,18,158,176,21,5,26,202,11,35,New York,Islip,335543
14089,2019-2020,2019-11-12,2020-02-29,110,0,5,100,105,13,4,17,122,9,25,New York,Islip,335543
14090,1950-1951,1950-11-11,1951-03-26,136,4,71,333,404,135,301,436,840,55,339,New York,Ithaca,30014
14091,1953-1954,1953-11-07,1954-04-17,162,1,58,325,383,95,140,235,618,50,293,New York,Ithaca,30014
14092,1954-1955,1954-11-02,1955-04-07,157,1,74,365,439,114,269,383,822,56,309,New York,Ithaca,30014
14093,1956-1957,1956-11-11,1957-04-14,155,8,75,342,417,96,218,314,731,48,271,New York,Ithaca,30014
14094,1957-1958,1957-10-27,1958-04-09,165,2,90,376,466,170,643,813,1279,59,414,New York,Ithaca,30014
14095,1958-1959,1958-11-25,1959-03-31,127,3,117,478,595,115,329,444,1039,45,352,New York,Ithaca,30014
14096,1959-1960,1959-11-19,1960-04-10,144,3,91,374,465,135,427,562,1027,57,352,New York,Ithaca,30014
14097,1960-1961,1960-10-25,1961-04-15,173,1,116,494,610,149,485,634,1244,51,365,New York,Ithaca,30014
14098,1961-1962,1961-11-09,1962-04-16,159,0,92,380,472,89,175,264,736,49,268,New York,Ithaca,30014
14099,1962-1963,1962-10-27,1963-05-02,188,3,123,502,625,101,439,540,1165,49,341,New York,Ithaca,30014
14100,1963-1964,1963-11-03,1964-04-05,155,0,80,389,469,116,393,509,978,59,358,New York,Ithaca,30014
14101,1964-1965,1964-10-23,1965-04-19,179,0,84,438,522,98,230,328,850,52,330,New York,Ithaca,30014
14102,1965-1966,1965-10-29,1966-05-10,194,0,80,384,464,130,263,393,857,67,406,New York,Ithaca,30014
14103,1966-1967,1966-12-01,1967-05-08,159,3,91,373,464,106,211,317,781,62,375,New York,Ithaca,30014
14104,1967-1968,1967-11-08,1968-03-25,139,0,112,438,550,77,231,308,858,43,313,New York,Ithaca,30014
14105,1968-1969,1968-11-13,1969-04-01,140,0,81,371,452,96,158,254,706,57,313,New York,Ithaca,30014
14106,1969-1970,1969-10-23,1970-04-11,171,0,131,515,646,173,615,788,1434,83,585,New York,Ithaca,30014
14107,1970-1971,1970-10-17,1971-04-25,191,0,110,447,557,151,503,654,1211,60,436,New York,Ithaca,30014
14108,1971-1972,1971-11-07,1972-04-10,156,0,88,449,537,144,344,488,1025,62,424,New York,Ithaca,30014
14109,1972-1973,1972-10-19,1973-05-18,212,0,77,377,454,75,158,233,687,41,233,New York,Ithaca,30014
14110,1973-1974,1973-11-10,1974-04-11,153,0,94,380,474,118,225,343,817,36,283,New York,Ithaca,30014
14111,1974-1975,1974-10-21,1975-04-10,172,3,68,339,407,89,209,298,705,45,225,New York,Ithaca,30014
14112,1975-1976,1975-10-31,1976-04-26,179,0,100,411,511,124,335,459,970,49,352,New York,Ithaca,30014
14113,1976-1977,1976-11-08,1977-05-10,184,0,150,490,640,132,425,557,1197,60,428,New York,Ithaca,30014
14114,1977-1978,1977-11-13,1978-03-26,134,0,131,451,582,180,661,841,1423,52,455,New York,Ithaca,30014
14115,1978-1979,1978-11-21,1979-04-10,141,1,150,417,567,112,357,469,1036,46,343,New York,Ithaca,30014
14116,1979-1980,1979-11-16,1980-04-17,154,0,106,360,466,62,104,166,632,30,207,New York,Ithaca,30014
14117,1980-1981,1980-10-14,1981-03-21,159,0,113,453,566,90,292,382,948,50,334,New York,Ithaca,30014
14118,1982-1983,1982-11-27,1983-04-25,150,9,59,322,381,72,158,230,611,29,175,New York,Ithaca,30014
14119,1983-1984,1983-11-05,1984-04-04,152,0,119,433,552,114,254,368,920,46,328,New York,Ithaca,30014
14120,1984-1985,1984-11-13,1985-04-10,149,2,88,361,449,86,212,298,747,42,266,New York,Ithaca,30014
14121,1985-1986,1985-11-26,1986-04-12,138,0,96,347,443,106,304,410,853,51,309,New York,Ithaca,30014
14122,1986-1987,1986-11-11,1987-04-01,142,2,79,413,492,97,411,508,1000,37,227,New York,Ithaca,30014
14123,1987-1988,1987-11-06,1988-04-20,167,0,81,391,472,105,244,349,821,49,310,New York,Ithaca,30014
14124,1989-1990,1989-11-04,1990-04-12,160,0,99,385,484,112,196,308,792,53,327,New York,Ithaca,30014
14125,1990-1991,1990-10-29,1991-04-22,176,0,55,308,363,86,128,214,577,49,273,New York,Ithaca,30014
14126,1991-1992,1991-11-08,1992-04-03,148,1,75,357,432,85,135,220,652,53,310,New York,Ithaca,30014
14127,1992-1993,1992-11-06,1993-04-23,169,6,83,437,520,118,432,550,1070,40,241,New York,Ithaca,30014
14128,1993-1994,1993-10-31,1994-04-08,160,2,151,509,660,165,763,928,1588,46,392,New York,Ithaca,30014
14129,1994-1995,1994-11-23,1995-04-10,139,4,70,342,412,63,134,197,609,28,174,New York,Ithaca,30014
14130,1995-1996,1995-11-12,1996-04-09,150,0,142,470,612,150,387,537,1149,59,419,New York,Ithaca,30014
14131,1996-1997,1996-11-03,1997-04-10,159,3,66,329,395,83,106,189,584,44,245,New York,Ithaca,30014
14132,1997-1998,1997-11-14,1998-03-25,132,0,43,256,299,115,301,416,715,31,193,New York,Ithaca,30014
14133,1998-1999,1998-12-01,1999-03-24,114,0,67,331,398,87,224,311,709,35,253,New York,Ithaca,30014
14134,1999-2000,1999-11-16,2000-04-11,148,0,79,334,413,99,222,321,734,37,293,New York,Ithaca,30014
14135,2000-2001,2000-11-23,2001-03-30,128,2,85,378,463,124,395,519,982,49,336,New York,Ithaca,30014
14136,2001-2002,2001-12-01,2002-04-06,127,0,27,230,257,44,43,87,344,26,126,New York,Ithaca,30014
14137,2002-2003,2002-11-02,2003-04-23,173,0,123,466,589,144,455,599,1188,59,465,New York,Ithaca,30014
14138,2003-2004,2003-11-08,2004-04-06,151,3,116,404,520,112,405,517,1037,49,363,New York,Ithaca,30014
14139,2004-2005,2004-11-09,2005-03-25,137,3,92,400,492,115,406,521,1013,47,326,New York,Ithaca,30014
14140,2005-2006,2005-11-19,2006-03-25,127,0,75,297,372,78,191,269,641,51,278,New York,Ithaca,30014
14141,2006-2007,2006-11-20,2007-04-19,151,0,102,369,471,106,325,431,902,40,290,New York,Ithaca,30014
14142,2007-2008,2007-11-16,2008-03-31,137,0,60,334,394,86,202,288,682,43,225,New York,Ithaca,30014
14143,2008-2009,2008-10-30,2009-04-08,161,3,105,430,535,84,286,370,905,39,255,New York,Ithaca,30014
14144,2009-2010,2009-10-16,2010-03-27,163,0,90,330,420,123,355,478,898,45,305,New York,Ithaca,30014
14145,2010-2011,2010-12-01,2011-03-28,118,0,107,380,487,128,425,553,1040,49,349,New York,Ithaca,30014
14146,2011-2012,2011-12-01,2012-04-23,145,0,28,228,256,41,47,88,344,20,123,New York,Ithaca,30014
14147,2012-2013,2012-12-01,2013-03-28,118,0,65,265,330,78,185,263,593,39,230,New York,Ithaca,30014
14148,2013-2014,2013-11-12,2014-04-16,156,0,146,518,664,97,295,392,1056,49,359,New York,Ithaca,30014
14149,2014-2015,2014-11-14,2015-04-06,144,0,158,530,688,103,468,571,1259,50,365,New York,Ithaca,30014
14150,2015-2016,2015-11-23,2016-04-06,136,0,63,272,335,41,70,111,446,27,166,New York,Ithaca,30014
14151,2016-2017,2016-10-27,2017-04-07,163,0,70,307,377,100,167,267,644,49,291,New York,Ithaca,30014
14152,2017-2018,2017-11-10,2018-04-20,162,0,114,418,532,99,209,308,840,53,338,New York,Ithaca,30014
14153,2018-2019,2018-11-11,2019-04-01,142,0,88,391,479,92,204,296,775,49,292,New York,Ithaca,30014
14154,2019-2020,2019-11-08,2020-05-09,184,0,61,332,393,89,220,309,702,43,215,New York,Ithaca,30014
14155,1950-1951,1950-11-23,1951-04-03,132,1,56,255,311,93,257,350,661,32,192,New York,Mohonk Lake,0
14156,1951-1952,1951-11-01,1952-03-24,145,1,54,279,333,92,337,429,762,30,178,New York,Mohonk Lake,0
14157,1952-1953,1952-10-28,1953-03-10,134,1,32,209,241,46,132,178,419,21,97,New York,Mohonk Lake,0
14158,1953-1954,1953-11-06,1954-03-06,121,13,51,225,276,60,182,242,518,20,128,New York,Mohonk Lake,0
14159,1954-1955,1954-11-24,1955-04-03,131,0,66,281,347,48,100,148,495,21,105,New York,Mohonk Lake,0
14160,1955-1956,1955-11-11,1956-04-26,168,3,73,346,419,138,412,550,969,38,248,New York,Mohonk Lake,0
14161,1956-1957,1956-11-18,1957-04-09,143,0,53,288,341,84,169,253,594,33,168,New York,Mohonk Lake,0
14162,1957-1958,1957-12-01,1958-04-12,133,2,66,272,338,139,610,749,1087,25,199,New York,Mohonk Lake,0
14163,1958-1959,1958-10-26,1959-03-30,156,6,88,383,471,79,232,311,782,29,174,New York,Mohonk Lake,0
14164,1959-1960,1959-11-18,1960-04-08,143,3,67,301,368,89,522,611,979,28,176,New York,Mohonk Lake,0
14165,1960-1961,1960-12-01,1961-04-18,139,0,98,368,466,140,719,859,1325,29,247,New York,Mohonk Lake,0
14166,1961-1962,1961-11-20,1962-04-15,147,0,81,330,411,99,570,669,1080,33,201,New York,Mohonk Lake,0
14167,1962-1963,1962-10-26,1963-03-28,154,0,100,392,492,116,769,885,1377,36,243,New York,Mohonk Lake,0
14168,1963-1964,1963-11-30,1964-03-29,121,0,78,288,366,108,585,693,1059,31,218,New York,Mohonk Lake,0
14169,1964-1965,1964-12-01,1965-04-28,149,1,104,404,508,92,622,714,1222,41,244,New York,Mohonk Lake,0
14170,1965-1966,1965-11-02,1966-04-08,158,0,56,290,346,95,388,483,829,28,175,New York,Mohonk Lake,0
14171,1966-1967,1966-11-30,1967-05-06,158,0,74,319,393,170,561,731,1124,40,326,New York,Mohonk Lake,0
14172,1967-1968,1967-11-09,1968-03-16,129,0,98,358,456,63,431,494,950,29,171,New York,Mohonk Lake,0
14173,1968-1969,1968-11-10,1969-03-31,142,0,81,329,410,110,613,723,1133,31,204,New York,Mohonk Lake,0
14174,1969-1970,1969-11-15,1970-04-06,143,3,105,386,491,123,792,915,1406,37,283,New York,Mohonk Lake,0
14175,1970-1971,1970-11-24,1971-04-25,153,0,103,349,452,138,1031,1169,1621,36,241,New York,Mohonk Lake,0
14176,1971-1972,1971-11-10,1972-04-11,154,0,68,348,416,130,391,521,937,45,272,New York,Mohonk Lake,0
14177,1972-1973,1972-10-19,1973-04-11,175,0,54,286,340,66,188,254,594,25,133,New York,Mohonk Lake,0
14178,1973-1974,1973-12-01,1974-04-11,132,0,71,290,361,70,236,306,667,31,185,New York,Mohonk Lake,0
14179,1974-1975,1974-11-22,1975-04-04,134,0,39,247,286,83,431,514,800,32,169,New York,Mohonk Lake,0
14180,1975-1976,1975-11-26,1976-03-19,115,1,87,297,384,83,401,484,868,31,212,New York,Mohonk Lake,0
14181,1976-1977,1976-11-05,1977-05-10,187,0,108,386,494,135,516,651,1145,39,259,New York,Mohonk Lake,0
14182,1977-1978,1977-11-23,1978-05-05,164,0,113,384,497,125,937,1062,1559,40,287,New York,Mohonk Lake,0
14183,1978-1979,1978-11-21,1979-04-14,145,0,104,367,471,90,462,552,1023,36,228,New York,Mohonk Lake,0
14184,1979-1980,1979-10-10,1980-04-01,175,3,66,306,372,56,116,172,544,19,117,New York,Mohonk Lake,0
14185,1980-1981,1980-11-17,1981-03-27,131,3,93,359,452,62,258,320,772,28,192,New York,Mohonk Lake,0
14186,1981-1982,1981-11-25,1982-04-13,140,17,105,380,485,137,790,927,1412,42,304,New York,Mohonk Lake,0
14187,1982-1983,1982-11-26,1983-04-21,147,0,49,254,303,110,315,425,728,24,173,New York,Mohonk Lake,0
14188,1983-1984,1983-11-25,1984-04-05,133,4,86,321,407,116,397,513,920,36,242,New York,Mohonk Lake,0
14189,1984-1985,1984-11-20,1985-04-08,140,8,66,279,345,56,230,286,631,24,134,New York,Mohonk Lake,0
14190,1985-1986,1985-11-16,1986-04-23,159,1,75,326,401,88,467,555,956,30,195,New York,Mohonk Lake,0
14191,1986-1987,1986-11-05,1987-04-28,175,10,56,298,354,96,642,738,1092,25,159,New York,Mohonk Lake,0
14192,1987-1988,1987-10-04,1988-04-15,195,6,57,286,343,113,593,706,1049,25,171,New York,Mohonk Lake,0
14193,1988-1989,1988-12-01,1989-03-24,114,1,47,281,328,23,22,45,373,11,57,New York,Mohonk Lake,0
14194,1989-1990,1989-11-22,1990-03-31,130,0,74,324,398,89,272,361,759,18,155,New York,Mohonk Lake,0
14195,1990-1991,1990-12-01,1991-03-30,120,1,29,217,246,55,147,202,448,19,108,New York,Mohonk Lake,0
14196,1991-1992,1991-11-12,1992-03-26,136,1,51,257,308,44,74,118,426,22,117,New York,Mohonk Lake,0
14197,1992-1993,1992-11-17,1993-04-09,144,0,65,312,377,126,624,750,1127,30,210,New York,Mohonk Lake,0
14198,1993-1994,1993-12-01,1994-04-06,127,0,119,375,494,117,857,974,1468,36,285,New York,Mohonk Lake,0
14199,1994-1995,1994-11-24,1995-04-08,136,0,49,247,296,46,188,234,530,18,99,New York,Mohonk Lake,0
14200,1995-1996,1995-11-13,1996-04-10,150,2,106,369,475,173,676,849,1324,44,353,New York,Mohonk Lake,0
14201,1996-1997,1996-11-14,1997-04-18,156,3,43,278,321,97,288,385,706,26,160,New York,Mohonk Lake,0
14202,1997-1998,1997-11-12,1998-03-25,134,1,28,198,226,69,278,347,573,27,120,New York,Mohonk Lake,0
14203,1998-1999,1998-12-01,1999-04-12,133,0,43,227,270,58,251,309,579,24,143,New York,Mohonk Lake,0
14204,1999-2000,1999-12-01,2000-04-09,131,0,57,239,296,56,333,389,685,18,124,New York,Mohonk Lake,0
14205,2000-2001,2000-11-21,2001-04-10,141,1,53,297,350,144,847,991,1341,36,236,New York,Mohonk Lake,0
14206,2001-2002,2001-12-01,2002-05-18,169,1,12,170,182,51,128,179,361,14,80,New York,Mohonk Lake,0
14207,2002-2003,2002-11-02,2003-04-09,159,1,90,350,440,134,813,947,1387,41,263,New York,Mohonk Lake,0
14208,2003-2004,2003-10-23,2004-03-23,153,1,74,311,385,82,362,444,829,27,172,New York,Mohonk Lake,0
14209,2004-2005,2004-11-12,2005-03-31,140,0,68,296,364,115,546,661,1025,33,237,New York,Mohonk Lake,0
14210,2005-2006,2005-11-24,2006-03-20,117,0,35,216,251,72,237,309,560,19,125,New York,Mohonk Lake,0
14211,2006-2007,2006-12-01,2007-04-15,136,0,49,266,315,58,249,307,622,17,109,New York,Mohonk Lake,0
14212,2007-2008,2007-11-10,2008-04-04,147,3,39,262,301,90,468,558,859,30,162,New York,Mohonk Lake,0
14213,2008-2009,2008-11-19,2009-03-08,110,0,66,278,344,69,446,515,859,27,173,New York,Mohonk Lake,0
14214,2009-2010,2009-10-15,2010-03-20,157,1,52,217,269,114,503,617,886,30,173,New York,Mohonk Lake,0
14215,2012-2013,2012-11-08,2013-03-27,140,3,40,229,269,81,287,368,637,25,151,New York,Mohonk Lake,0
14216,2013-2014,2013-11-25,2014-04-16,143,2,86,364,450,101,507,608,1058,33,244,New York,Mohonk Lake,0
14217,2014-2015,2014-11-14,2015-04-02,140,9,82,382,464,92,514,606,1070,35,233,New York,Mohonk Lake,0
14218,2015-2016,2015-12-01,2016-04-05,127,0,32,178,210,23,19,42,252,10,50,New York,Mohonk Lake,0
14219,2016-2017,2016-10-27,2017-03-29,154,0,27,220,247,95,390,485,732,20,132,New York,Mohonk Lake,0
14220,2017-2018,2017-11-11,2018-04-06,147,2,62,283,345,91,284,375,720,25,162,New York,Mohonk Lake,0
14221,2018-2019,2018-11-15,2019-03-17,123,0,41,262,303,58,224,282,585,15,116,New York,Mohonk Lake,0
14222,2019-2020,2019-11-13,2020-03-24,133,2,22,181,203,36,81,117,320,12,63,New York,Mohonk Lake,0
14223,1950-1951,1950-12-01,1951-03-22,112,2,19,105,124,15,14,29,153,10,36,New York,New,19378102
14224,1951-1952,1951-12-01,1952-03-19,110,2,14,110,124,31,29,60,184,14,47,New York,New,19378102
14225,1952-1953,1952-10-20,1953-03-08,140,0,2,76,78,24,19,43,121,13,39,New York,New,19378102
14226,1953-1954,1953-11-06,1954-04-01,147,0,17,112,129,24,52,76,205,12,49,New York,New,19378102
14227,1954-1955,1954-12-01,1955-03-26,116,0,21,128,149,18,16,34,183,13,44,New York,New,19378102
14228,1955-1956,1955-11-20,1956-04-09,142,0,24,160,184,49,46,95,279,19,84,New York,New,19378102
14229,1956-1957,1956-12-01,1957-04-05,126,0,19,119,138,35,29,64,202,18,72,New York,New,19378102
14230,1957-1958,1957-12-01,1958-04-11,132,0,30,128,158,64,103,167,325,16,92,New York,New,19378102
14231,1958-1959,1958-11-30,1959-04-12,134,0,33,194,227,24,26,50,277,16,55,New York,New,19378102
14232,1959-1960,1959-11-29,1960-03-26,119,0,15,130,145,61,72,133,278,22,109,New York,New,19378102
14233,1960-1961,1960-12-01,1961-03-13,103,0,42,170,212,75,254,329,541,19,135,New York,New,19378102
14234,1961-1962,1961-12-01,1962-03-06,96,0,17,137,154,28,43,71,225,18,50,New York,New,19378102
14235,1962-1963,1962-12-01,1963-03-21,111,0,39,191,230,28,41,69,299,16,59,New York,New,19378102
14236,1963-1964,1963-12-01,1964-03-22,113,0,21,126,147,67,120,187,334,23,105,New York,New,19378102
14237,1964-1965,1964-11-22,1965-04-02,132,0,31,150,181,38,50,88,269,16,75,New York,New,19378102
14238,1965-1966,1965-12-01,1966-02-28,90,0,18,106,124,29,65,94,218,11,51,New York,New,19378102
14239,1966-1967,1966-12-01,1967-03-25,115,0,29,157,186,73,112,185,371,21,127,New York,New,19378102
14240,1967-1968,1967-11-30,1968-03-13,105,0,41,183,224,30,47,77,301,14,69,New York,New,19378102
14241,1968-1969,1968-12-01,1969-03-11,101,0,22,131,153,41,123,164,317,10,54,New York,New,19378102
14242,1969-1970,1969-12-01,1970-03-30,120,0,39,185,224,39,104,143,367,15,87,New York,New,19378102
14243,1970-1971,1970-12-01,1971-04-06,127,0,39,152,191,23,24,47,238,9,39,New York,New,19378102
14244,1971-1972,1971-12-01,1972-03-15,106,0,20,131,151,32,33,65,216,11,57,New York,New,19378102
14245,1972-1973,1972-11-22,1973-03-18,117,0,19,109,128,4,5,9,137,3,12,New York,New,19378102
14246,1973-1974,1973-12-01,1974-04-10,131,0,27,127,154,35,74,109,263,14,72,New York,New,19378102
14247,1974-1975,1974-11-25,1975-03-14,110,0,8,81,89,20,24,44,133,8,34,New York,New,19378102
14248,1975-1976,1975-12-01,1976-03-16,107,0,28,141,169,27,34,61,230,12,54,New York,New,19378102
14249,1976-1977,1976-11-30,1977-03-18,109,0,67,206,273,36,101,137,410,18,90,New York,New,19378102
14250,1977-1978,1977-11-27,1978-03-19,113,0,48,181,229,71,209,280,509,16,100,New York,New,19378102
14251,1978-1979,1978-11-27,1979-02-28,94,0,43,145,188,42,65,107,295,11,77,New York,New,19378102
14252,1979-1980,1979-12-01,1980-03-15,106,0,20,120,140,17,12,29,169,6,28,New York,New,19378102
14253,1980-1981,1980-12-01,1981-03-07,97,0,44,168,212,31,54,85,297,11,60,New York,New,19378102
14254,1981-1982,1981-12-01,1982-04-10,131,0,34,145,179,36,72,108,287,13,64,New York,New,19378102
14255,1982-1983,1982-12-01,1983-04-19,140,0,17,83,100,38,78,116,216,8,54,New York,New,19378102
14256,1983-1984,1983-12-01,1984-03-30,121,0,40,145,185,39,77,116,301,20,80,New York,New,19378102
14257,1984-1985,1984-12-01,1985-03-04,94,0,24,102,126,34,63,97,223,13,65,New York,New,19378102
14258,1985-1986,1985-12-01,1986-03-08,98,3,24,129,153,25,24,49,202,14,62,New York,New,19378102
14259,1986-1987,1986-12-01,1987-03-13,103,0,15,115,130,34,81,115,245,11,51,New York,New,19378102
14260,1987-1988,1987-11-11,1988-02-29,111,0,26,130,156,27,73,100,256,10,49,New York,New,19378102
14261,1988-1989,1988-12-01,1989-03-09,99,0,20,107,127,12,14,26,153,4,22,New York,New,19378102
14262,1989-1990,1989-11-22,1990-04-07,137,0,25,149,174,20,26,46,220,10,38,New York,New,19378102
14263,1990-1991,1990-12-01,1991-03-30,120,0,8,80,88,36,32,68,156,9,51,New York,New,19378102
14264,1991-1992,1991-12-01,1992-03-25,116,0,10,118,128,20,18,38,166,7,35,New York,New,19378102
14265,1992-1993,1992-12-01,1993-03-21,111,0,8,133,141,39,40,79,220,15,62,New York,New,19378102
14266,1993-1994,1993-12-01,1994-03-20,110,0,46,194,240,75,237,312,552,23,151,New York,New,19378102
14267,1994-1995,1994-12-01,1995-02-28,90,0,12,92,104,17,60,77,181,4,30,New York,New,19378102
14268,2000-2001,2000-12-01,2001-03-26,116,13,20,123,143,52,89,141,284,14,81,New York,New,19378102
14269,2001-2002,2001-12-01,2002-02-28,90,17,3,46,49,5,4,9,58,2,8,New York,New,19378102
14270,2003-2004,2003-12-01,2004-03-18,109,0,39,151,190,59,118,177,367,13,98,New York,New,19378102
14271,2004-2005,2004-12-01,2005-03-24,114,0,26,134,160,59,149,208,368,20,114,New York,New,19378102
14272,2005-2006,2005-12-01,2006-04-05,126,0,11,96,107,58,68,126,233,9,71,New York,New,19378102
14273,2006-2007,2006-12-01,2007-03-20,110,0,25,127,152,22,22,44,196,12,50,New York,New,19378102
14274,2007-2008,2007-12-01,2008-02-29,91,0,8,85,93,19,18,37,130,7,32,New York,New,19378102
14275,2008-2009,2008-11-22,2009-03-05,104,0,29,141,170,41,63,104,274,13,69,New York,New,19378102
14276,2009-2010,2009-12-01,2010-03-03,93,0,20,104,124,71,122,193,317,12,90,New York,New,19378102
14277,2010-2011,2010-12-01,2011-03-24,114,0,26,132,158,90,300,390,548,15,124,New York,New,19378102
14278,2011-2012,2011-10-29,2012-02-29,124,0,6,51,57,10,6,16,73,3,16,New York,New,19378102
14279,2012-2013,2012-11-07,2013-03-19,133,0,18,86,104,40,36,76,180,12,65,New York,New,19378102
14280,2013-2014,2013-11-24,2014-03-13,110,0,45,174,219,81,268,349,568,19,139,New York,New,19378102
14281,2014-2015,2014-11-26,2015-03-21,116,0,36,187,223,70,285,355,578,19,119,New York,New,19378102
14282,2015-2016,2015-12-01,2016-03-21,112,0,13,76,89,46,59,105,194,8,61,New York,New,19378102
14283,2016-2017,2016-12-01,2017-03-19,109,0,12,81,93,42,56,98,191,9,59,New York,New,19378102
14284,2017-2018,2017-12-01,2018-04-02,123,0,36,125,161,58,60,118,279,14,82,New York,New,19378102
14285,2018-2019,2018-11-15,2019-03-07,113,0,19,106,125,32,23,55,180,11,46,New York,New,19378102
14286,2019-2020,2019-12-01,2020-02-29,91,0,3,54,57,9,2,11,68,6,17,New York,New,19378102
14287,1950-1951,1950-11-23,1951-03-22,120,0,20,106,126,22,16,38,164,15,50,New York,New,19378102
14288,1951-1952,1951-12-01,1952-03-19,110,0,13,102,115,25,16,41,156,14,40,New York,New,19378102
14289,1952-1953,1952-11-30,1953-03-08,99,0,2,65,67,23,12,35,102,14,39,New York,New,19378102
14290,1953-1954,1953-11-06,1954-03-04,119,0,17,93,110,26,48,74,184,8,45,New York,New,19378102
14291,1954-1955,1954-12-01,1955-03-26,116,0,18,123,141,19,16,35,176,12,44,New York,New,19378102
14292,1955-1956,1955-11-19,1956-04-09,143,0,21,150,171,47,41,88,259,16,77,New York,New,19378102
14293,1956-1957,1956-12-01,1957-04-05,126,0,19,110,129,32,29,61,190,15,66,New York,New,19378102
14294,1957-1958,1957-12-01,1958-04-11,132,0,30,117,147,71,92,163,310,18,100,New York,New,19378102
14295,1958-1959,1958-11-30,1959-04-12,134,0,33,180,213,28,27,55,268,15,50,New York,New,19378102
14296,1959-1960,1959-11-18,1960-03-23,127,0,16,115,131,51,67,118,249,18,85,New York,New,19378102
14297,1960-1961,1960-12-01,1961-04-13,134,0,42,170,212,74,218,292,504,20,125,New York,New,19378102
14298,1961-1962,1961-11-20,1962-03-06,107,0,25,131,156,27,24,51,207,17,48,New York,New,19378102
14299,1962-1963,1962-10-26,1963-03-21,147,0,45,186,231,30,32,62,293,18,65,New York,New,19378102
14300,1963-1964,1963-12-01,1964-03-22,113,0,27,118,145,53,83,136,281,22,97,New York,New,19378102
14301,1964-1965,1964-11-22,1965-04-02,132,0,34,126,160,34,38,72,232,16,60,New York,New,19378102
14302,1965-1966,1965-12-01,1966-02-28,90,0,21,86,107,29,39,68,175,13,51,New York,New,19378102
14303,1966-1967,1966-12-01,1967-03-25,115,0,26,129,155,66,83,149,304,24,116,New York,New,19378102
14304,1967-1968,1967-11-30,1968-03-13,105,0,39,176,215,23,25,48,263,14,62,New York,New,19378102
14305,1968-1969,1968-12-01,1969-03-11,101,0,27,140,167,47,58,105,272,17,70,New York,New,19378102
14306,1969-1970,1969-12-01,1970-03-31,121,0,36,171,207,39,49,88,295,20,98,New York,New,19378102
14307,1970-1971,1970-12-01,1971-04-06,127,0,32,120,152,26,20,46,198,14,50,New York,New,19378102
14308,1971-1972,1971-12-01,1972-04-07,129,0,28,136,164,36,30,66,230,15,63,New York,New,19378102
14309,1972-1973,1972-11-22,1973-02-28,99,0,20,98,118,4,0,4,122,4,12,New York,New,19378102
14310,1973-1974,1973-12-01,1974-04-10,131,0,26,113,139,30,43,73,212,15,65,New York,New,19378102
14311,1974-1975,1974-12-01,1975-03-14,104,0,9,74,83,17,17,34,117,8,32,New York,New,19378102
14312,1975-1976,1975-12-01,1976-03-12,103,0,25,117,142,27,40,67,209,16,59,New York,New,19378102
14313,1976-1977,1976-11-30,1977-03-18,109,0,62,197,259,35,79,114,373,18,83,New York,New,19378102
14314,1977-1978,1977-12-01,1978-03-17,107,0,53,164,217,62,150,212,429,16,88,New York,New,19378102
14315,1978-1979,1978-11-27,1979-02-28,94,0,57,165,222,39,50,89,311,14,86,New York,New,19378102
14316,1979-1980,1979-12-01,1980-03-15,106,0,26,120,146,15,13,28,174,7,29,New York,New,19378102
14317,1980-1981,1980-11-17,1981-03-07,111,0,56,181,237,26,41,67,304,12,56,New York,New,19378102
14318,1981-1982,1981-12-01,1982-04-08,129,0,36,153,189,54,53,107,296,18,98,New York,New,19378102
14319,1982-1983,1982-12-01,1983-02-28,90,0,19,80,99,39,63,102,201,7,57,New York,New,19378102
14320,1983-1984,1983-12-01,1984-03-30,121,0,37,153,190,35,60,95,285,14,70,New York,New,19378102
14321,1984-1985,1984-12-01,1985-03-04,94,0,28,102,130,32,56,88,218,13,65,New York,New,19378102
14322,1985-1986,1985-11-16,1986-03-08,113,0,24,125,149,30,44,74,223,13,60,New York,New,19378102
14323,1986-1987,1986-12-01,1987-03-13,103,0,16,105,121,32,50,82,203,12,48,New York,New,19378102
14324,1987-1988,1987-12-01,1988-03-20,111,0,25,118,143,32,68,100,243,11,54,New York,New,19378102
14325,1988-1989,1988-12-01,1989-03-09,99,0,21,100,121,17,13,30,151,7,31,New York,New,19378102
14326,1989-1990,1989-11-22,1990-04-07,137,0,32,128,160,31,36,67,227,13,55,New York,New,19378102
14327,1990-1991,1990-12-01,1991-03-15,105,0,8,74,82,34,28,62,144,11,52,New York,New,19378102
14328,1991-1992,1991-12-01,1992-03-24,115,0,11,97,108,23,22,45,153,12,47,New York,New,19378102
14329,1992-1993,1992-12-01,1993-03-22,112,0,12,129,141,43,65,108,249,17,65,New York,New,19378102
14330,1993-1994,1993-12-01,1994-03-19,109,0,49,190,239,85,198,283,522,25,170,New York,New,19378102
14331,1994-1995,1994-12-01,1995-02-28,90,0,12,89,101,18,44,62,163,5,33,New York,New,19378102
14332,1995-1996,1995-11-29,1996-04-09,133,0,31,145,176,108,219,327,503,23,158,New York,New,19378102
14333,1996-1997,1996-11-28,1997-04-01,125,0,11,90,101,22,14,36,137,16,44,New York,New,19378102
14334,1997-1998,1997-11-14,1998-03-23,130,0,3,46,49,16,4,20,69,11,19,New York,New,19378102
14335,1998-1999,1998-12-01,1999-03-16,106,0,12,88,100,23,11,34,134,13,43,New York,New,19378102
14336,1999-2000,1999-12-01,2000-04-09,131,0,24,98,122,22,57,79,201,9,40,New York,New,19378102
14337,2000-2001,2000-12-01,2001-03-26,116,0,16,110,126,61,100,161,287,19,93,New York,New,19378102
14338,2001-2002,2001-12-01,2002-03-18,108,0,3,47,50,6,5,11,61,4,10,New York,New,19378102
14339,2002-2003,2002-12-01,2003-04-09,130,0,35,159,194,74,138,212,406,20,121,New York,New,19378102
14340,2003-2004,2003-12-01,2004-03-19,110,0,34,139,173,62,120,182,355,16,103,New York,New,19378102
14341,2004-2005,2004-12-01,2005-03-24,114,0,29,133,162,58,110,168,330,22,116,New York,New,19378102
14342,2005-2006,2005-12-01,2006-03-03,93,0,7,65,72,43,49,92,164,8,55,New York,New,19378102
14343,2006-2007,2006-12-01,2007-03-20,110,0,19,103,122,22,25,47,169,12,44,New York,New,19378102
14344,2007-2008,2007-12-01,2008-02-29,91,0,6,69,75,17,19,36,111,7,30,New York,New,19378102
14345,2008-2009,2008-12-01,2009-03-06,96,0,26,124,150,38,57,95,245,14,67,New York,New,19378102
14346,2009-2010,2009-12-01,2010-03-02,92,0,18,97,115,59,99,158,273,14,85,New York,New,19378102
14347,2010-2011,2010-12-01,2011-03-24,114,0,16,108,124,72,177,249,373,17,100,New York,New,19378102
14348,2011-2012,2011-10-29,2012-02-29,124,0,5,45,50,6,8,14,64,2,9,New York,New,19378102
14349,2012-2013,2012-11-07,2013-03-19,133,0,13,69,82,35,23,58,140,15,57,New York,New,19378102
14350,2013-2014,2013-11-23,2014-04-16,145,0,41,184,225,78,146,224,449,23,135,New York,New,19378102
14351,2014-2015,2014-11-26,2015-03-21,116,0,34,179,213,82,201,283,496,25,146,New York,New,19378102
14352,2015-2016,2015-12-01,2016-03-21,112,0,12,64,76,50,57,107,183,10,64,New York,New,19378102
14353,2016-2017,2016-12-01,2017-03-20,110,0,9,63,72,47,60,107,179,10,62,New York,New,19378102
14354,2017-2018,2017-12-01,2018-04-03,124,0,30,109,139,54,53,107,246,16,76,New York,New,19378102
14355,2018-2019,2018-11-15,2019-03-10,116,0,16,105,121,26,12,38,159,11,41,New York,New,19378102
14356,2019-2020,2019-12-01,2020-02-29,91,0,3,51,54,8,2,10,64,7,17,New York,New,19378102
14357,1950-1951,1950-11-21,1951-03-26,126,0,72,254,326,116,272,388,714,58,284,New York,Oswego,18142
14358,1951-1952,1951-11-01,1952-03-28,149,0,70,262,332,140,325,465,797,60,323,New York,Oswego,18142
14359,1952-1953,1952-10-20,1953-03-10,142,3,39,187,226,74,97,171,397,44,200,New York,Oswego,18142
14360,1953-1954,1953-11-07,1954-04-05,150,1,50,260,310,100,197,297,607,31,196,New York,Oswego,18142
14361,1958-1959,1958-11-27,1959-03-31,125,17,79,360,439,231,1018,1249,1688,57,470,New York,Oswego,18142
14362,1959-1960,1959-11-18,1960-03-29,133,20,71,253,324,151,472,623,947,45,280,New York,Oswego,18142
14363,1961-1962,1961-11-21,1962-04-02,133,12,71,270,341,92,196,288,629,26,203,New York,Oswego,18142
14364,1962-1963,1962-11-18,1963-03-22,125,0,97,332,429,121,496,617,1046,41,333,New York,Oswego,18142
14365,1963-1964,1963-11-30,1964-04-08,131,2,107,338,445,190,338,528,973,40,355,New York,Oswego,18142
14366,1964-1965,1964-11-22,1965-04-19,149,0,104,326,430,193,248,441,871,49,427,New York,Oswego,18142
14367,1965-1966,1965-11-18,1966-03-29,132,1,70,251,321,213,331,544,865,40,362,New York,Oswego,18142
14368,1969-1970,1969-10-22,1970-04-10,171,0,120,414,534,270,734,1004,1538,86,677,New York,Oswego,18142
14369,1970-1971,1970-10-17,1971-04-24,190,0,103,355,458,298,807,1105,1563,87,618,New York,Oswego,18142
14370,1971-1972,1971-11-07,1972-04-11,157,0,80,356,436,345,745,1090,1526,76,611,New York,Oswego,18142
14371,1972-1973,1972-10-19,1973-05-17,211,0,67,294,361,168,288,456,817,65,379,New York,Oswego,18142
14372,1973-1974,1973-11-06,1974-04-09,155,1,91,310,401,223,359,582,983,70,480,New York,Oswego,18142
14373,1974-1975,1974-10-02,1975-04-13,194,0,55,276,331,221,431,652,983,73,399,New York,Oswego,18142
14374,1975-1976,1975-11-14,1976-04-26,165,0,92,344,436,202,520,722,1158,70,509,New York,Oswego,18142
14375,1976-1977,1976-10-22,1977-05-09,200,0,123,391,514,353,959,1312,1826,97,764,New York,Oswego,18142
14376,1977-1978,1977-11-12,1978-04-21,161,0,136,394,530,327,1067,1394,1924,80,675,New York,Oswego,18142
14377,1978-1979,1978-11-20,1979-04-10,142,0,130,350,480,192,510,702,1182,66,498,New York,Oswego,18142
14378,1979-1980,1979-11-16,1980-04-16,153,0,92,299,391,160,373,533,924,66,426,New York,Oswego,18142
14379,1980-1981,1980-10-21,1981-04-06,168,0,115,381,496,225,569,794,1290,70,573,New York,Oswego,18142
14380,1981-1982,1981-11-07,1982-04-11,156,1,96,365,461,222,653,875,1336,75,529,New York,Oswego,18142
14381,1982-1983,1982-11-15,1983-04-25,162,3,49,255,304,112,169,281,585,47,245,New York,Oswego,18142
14382,1983-1984,1983-11-04,1984-04-02,151,9,110,346,456,209,541,750,1206,78,532,New York,Oswego,18142
14383,1984-1985,1984-11-13,1985-04-18,157,6,75,294,369,211,481,692,1061,75,490,New York,Oswego,18142
14384,1985-1986,1985-11-16,1986-04-11,147,3,91,304,395,266,711,977,1372,82,576,New York,Oswego,18142
14385,1986-1987,1986-11-10,1987-04-02,144,2,61,274,335,137,383,520,855,53,299,New York,Oswego,18142
14386,1987-1988,1987-10-09,1988-04-20,195,1,68,305,373,208,433,641,1014,74,437,New York,Oswego,18142
14387,1988-1989,1988-10-22,1989-04-11,172,0,76,318,394,165,244,409,803,68,384,New York,Oswego,18142
14388,1989-1990,1989-11-12,1990-04-18,158,0,84,349,433,222,434,656,1089,73,506,New York,Oswego,18142
14389,1990-1991,1990-11-08,1991-03-15,128,1,50,231,281,167,226,393,674,56,347,New York,Oswego,18142
14390,1991-1992,1991-11-07,1992-04-01,147,2,68,303,371,225,523,748,1119,64,480,New York,Oswego,18142
14391,1992-1993,1992-11-07,1993-04-22,167,2,71,329,400,246,672,918,1318,70,494,New York,Oswego,18142
14392,1993-1994,1993-11-01,1994-04-07,158,0,147,408,555,288,1017,1305,1860,73,675,New York,Oswego,18142
14393,1994-1995,1994-11-23,1995-04-09,138,1,71,264,335,139,305,444,779,48,322,New York,Oswego,18142
14394,1995-1996,1995-11-04,1996-04-08,157,2,131,373,504,331,685,1016,1520,90,695,New York,Oswego,18142
14395,1996-1997,1996-11-02,1997-04-09,159,1,71,271,342,241,506,747,1089,76,471,New York,Oswego,18142
14396,1997-1998,1997-10-23,1998-03-26,155,0,39,193,232,152,278,430,662,57,271,New York,Oswego,18142
14397,1998-1999,1998-11-06,1999-03-23,138,0,66,242,308,165,417,582,890,46,357,New York,Oswego,18142
14398,1999-2000,1999-11-28,2000-04-12,137,0,66,229,295,118,283,401,696,51,287,New York,Oswego,18142
14399,2000-2001,2000-10-10,2001-04-02,175,0,79,269,348,291,665,956,1304,84,526,New York,Oswego,18142
14400,2001-2002,2001-10-27,2002-04-26,182,5,21,165,186,113,122,235,421,54,218,New York,Oswego,18142
14401,2002-2003,2002-11-01,2003-04-23,174,0,112,367,479,253,788,1041,1520,82,580,New York,Oswego,18142
14402,2003-2004,2003-11-14,2004-04-05,144,0,111,305,416,257,688,945,1361,67,546,New York,Oswego,18142
14403,2004-2005,2004-11-09,2005-03-24,136,1,93,308,401,179,444,623,1024,61,438,New York,Oswego,18142
14404,2005-2006,2005-10-28,2006-04-06,161,1,67,219,286,174,282,456,742,66,353,New York,Oswego,18142
14405,2006-2007,2006-11-03,2007-04-17,166,4,93,271,364,236,507,743,1107,68,492,New York,Oswego,18142
14406,2007-2008,2007-11-18,2008-03-29,133,0,62,247,309,234,498,732,1041,67,433,New York,Oswego,18142
14407,2008-2009,2008-11-10,2009-04-08,150,1,102,304,406,222,506,728,1134,67,486,New York,Oswego,18142
14408,2009-2010,2009-12-01,2010-03-11,101,0,65,196,261,163,416,579,840,48,323,New York,Oswego,18142
14409,2010-2011,2010-11-27,2011-03-27,121,14,93,272,365,256,673,929,1294,63,469,New York,Oswego,18142
14410,2013-2014,2013-10-24,2014-04-16,175,1,130,379,509,229,594,823,1332,75,576,New York,Oswego,18142
14411,2014-2015,2014-11-14,2015-04-23,161,0,126,395,521,210,728,938,1459,67,499,New York,Oswego,18142
14412,2015-2016,2015-10-18,2016-04-11,177,0,36,200,236,117,202,319,555,42,247,New York,Oswego,18142
14413,2017-2018,2017-11-11,2018-04-19,160,0,84,294,378,230,460,690,1068,60,459,New York,Oswego,18142
14414,2019-2020,2019-11-08,2020-05-09,184,0,42,251,293,81,178,259,552,41,207,New York,Oswego,18142
14415,1950-1951,1950-11-21,1951-03-25,125,0,73,293,366,116,240,356,722,63,347,New York,Rochester,6587
14416,1951-1952,1951-11-01,1952-03-18,139,0,64,296,360,120,222,342,702,62,328,New York,Rochester,6587
14417,1952-1953,1952-11-29,1953-04-20,143,0,39,203,242,70,78,148,390,39,185,New York,Rochester,6587
14418,1953-1954,1953-11-07,1954-04-05,150,0,69,277,346,116,171,287,633,51,319,New York,Rochester,6587
14419,1954-1955,1954-11-02,1955-04-07,157,0,82,301,383,114,207,321,704,58,344,New York,Rochester,6587
14420,1955-1956,1955-11-08,1956-04-23,168,0,90,363,453,174,322,496,949,81,460,New York,Rochester,6587
14421,1956-1957,1956-11-13,1957-04-13,152,0,73,315,388,125,229,354,742,63,343,New York,Rochester,6587
14422,1957-1958,1957-10-27,1958-04-07,163,0,90,301,391,190,402,592,983,69,455,New York,Rochester,6587
14423,1958-1959,1958-11-22,1959-04-04,134,0,119,422,541,203,300,503,1044,69,533,New York,Rochester,6587
14424,1959-1960,1959-11-13,1960-04-06,146,0,100,353,453,219,598,817,1270,66,469,New York,Rochester,6587
14425,1960-1961,1960-10-24,1961-04-17,176,0,113,389,502,135,331,466,968,65,434,New York,Rochester,6587
14426,1961-1962,1961-11-08,1962-04-18,162,0,91,357,448,107,160,267,715,53,315,New York,Rochester,6587
14427,1962-1963,1962-10-24,1963-05-01,190,0,128,441,569,124,299,423,992,67,461,New York,Rochester,6587
14428,1963-1964,1963-11-30,1964-04-09,132,0,76,336,412,139,308,447,859,61,362,New York,Rochester,6587
14429,1964-1965,1964-11-19,1965-04-18,151,0,90,370,460,113,235,348,808,52,320,New York,Rochester,6587
14430,1965-1966,1965-10-28,1966-04-06,161,0,75,303,378,164,271,435,813,60,402,New York,Rochester,6587
14431,1966-1967,1966-11-04,1967-05-07,185,0,72,317,389,116,228,344,733,62,343,New York,Rochester,6587
14432,1967-1968,1967-11-05,1968-03-25,142,0,105,356,461,116,224,340,801,54,389,New York,Rochester,6587
14433,1968-1969,1968-11-12,1969-04-19,159,0,77,303,380,123,218,341,721,63,330,New York,Rochester,6587
14434,1969-1970,1969-11-14,1970-04-05,143,0,105,403,508,183,481,664,1172,74,500,New York,Rochester,6587
14435,1970-1971,1970-10-16,1971-04-10,177,0,111,378,489,204,498,702,1191,78,549,New York,Rochester,6587
14436,1971-1972,1971-11-07,1972-04-09,155,0,76,375,451,159,294,453,904,72,430,New York,Rochester,6587
14437,1972-1973,1972-10-18,1973-04-11,176,0,67,296,363,116,226,342,705,61,341,New York,Rochester,6587
14438,1973-1974,1973-11-05,1974-04-10,157,0,82,323,405,150,242,392,797,63,387,New York,Rochester,6587
14439,1974-1975,1974-10-20,1975-04-12,175,0,60,263,323,142,205,347,670,70,330,New York,Rochester,6587
14440,1975-1976,1975-11-14,1976-05-19,188,0,83,316,399,136,298,434,833,75,412,New York,Rochester,6587
14441,1976-1977,1976-10-27,1977-05-09,195,0,131,406,537,146,497,643,1180,84,516,New York,Rochester,6587
14442,1977-1978,1977-11-11,1978-05-01,172,0,108,397,505,233,609,842,1347,72,510,New York,Rochester,6587
14443,1978-1979,1978-11-20,1979-04-11,143,0,131,394,525,205,364,569,1094,77,572,New York,Rochester,6587
14444,1979-1980,1979-10-26,1980-04-16,174,0,107,332,439,116,123,239,678,66,413,New York,Rochester,6587
14445,1980-1981,1980-11-10,1981-04-25,167,0,108,403,511,140,277,417,928,68,453,New York,Rochester,6587
14446,1981-1982,1981-10-19,1982-04-11,175,0,117,390,507,190,389,579,1086,74,513,New York,Rochester,6587
14447,1982-1983,1982-11-05,1983-04-25,172,0,45,247,292,93,120,213,505,47,233,New York,Rochester,6587
14448,1983-1984,1983-11-03,1984-04-07,157,0,116,360,476,178,379,557,1033,72,455,New York,Rochester,6587
14449,1984-1985,1984-11-12,1985-04-09,149,0,73,280,353,134,291,425,778,70,387,New York,Rochester,6587
14450,1985-1986,1985-11-22,1986-04-22,152,0,95,316,411,118,235,353,764,70,386,New York,Rochester,6587
14451,1986-1987,1986-11-11,1987-04-04,145,0,57,305,362,108,196,304,666,57,292,New York,Rochester,6587
14452,1987-1988,1987-11-05,1988-04-19,167,0,77,335,412,115,145,260,672,68,356,New York,Rochester,6587
14453,1988-1989,1988-10-30,1989-05-08,191,0,77,330,407,132,122,254,661,64,361,New York,Rochester,6587
14454,1989-1990,1989-11-03,1990-04-12,161,0,85,334,419,158,261,419,838,72,432,New York,Rochester,6587
14455,1990-1991,1990-11-08,1991-04-22,166,0,53,255,308,107,124,231,539,64,296,New York,Rochester,6587
14456,1991-1992,1991-11-07,1992-04-03,149,0,66,318,384,172,206,378,762,74,443,New York,Rochester,6587
14457,1992-1993,1992-11-02,1993-04-22,172,0,71,352,423,193,404,597,1020,71,425,New York,Rochester,6587
14458,1993-1994,1993-10-31,1994-04-08,160,0,133,424,557,182,398,580,1137,75,561,New York,Rochester,6587
14459,1994-1995,1994-11-23,1995-04-10,139,0,54,263,317,89,137,226,543,51,266,New York,Rochester,6587
14460,1995-1996,1995-11-08,1996-05-12,187,0,122,407,529,192,288,480,1009,87,537,New York,Rochester,6587
14461,1996-1997,1996-11-02,1997-04-19,169,0,61,317,378,166,128,294,672,82,421,New York,Rochester,6587
14462,1997-1998,1997-10-27,1998-03-26,151,0,36,215,251,139,179,318,569,50,261,New York,Rochester,6587
14463,1998-1999,1998-11-04,1999-04-11,159,0,73,300,373,158,264,422,795,45,345,New York,Rochester,6587
14464,1999-2000,1999-11-15,2000-04-12,150,0,71,272,343,160,253,413,756,58,392,New York,Rochester,6587
14465,2000-2001,2000-11-17,2001-04-02,137,0,75,318,393,187,285,472,865,85,465,New York,Rochester,6587
14466,2001-2002,2001-11-20,2002-04-22,154,0,26,193,219,88,73,161,380,43,187,New York,Rochester,6587
14467,2002-2003,2002-11-01,2003-04-10,161,0,119,399,518,206,373,579,1097,87,564,New York,Rochester,6587
14468,2003-2004,2003-11-13,2004-04-05,145,0,96,327,423,181,352,533,956,69,464,New York,Rochester,6587
14469,2004-2005,2004-11-08,2005-03-24,137,0,95,353,448,166,322,488,936,66,469,New York,Rochester,6587
14470,2005-2006,2005-11-10,2006-04-04,146,0,52,225,277,114,112,226,503,62,285,New York,Rochester,6587
14471,2006-2007,2006-10-12,2007-04-16,187,0,75,268,343,153,231,384,727,63,405,New York,Rochester,6587
14472,2007-2008,2007-11-16,2008-03-29,135,0,54,274,328,154,188,342,670,64,340,New York,Rochester,6587
14473,2008-2009,2008-10-29,2009-04-07,161,0,90,326,416,155,254,409,825,67,409,New York,Rochester,6587
14474,2009-2010,2009-12-01,2010-05-09,160,0,75,248,323,132,243,375,698,51,325,New York,Rochester,6587
14475,2010-2011,2010-11-26,2011-03-31,126,0,92,320,412,195,383,578,990,75,490,New York,Rochester,6587
14476,2011-2012,2011-11-17,2012-04-24,160,0,25,179,204,88,63,151,355,38,194,New York,Rochester,6587
14477,2012-2013,2012-11-05,2013-04-02,149,0,58,239,297,122,164,286,583,63,313,New York,Rochester,6587
14478,2013-2014,2013-11-08,2014-04-15,159,0,128,429,557,172,286,458,1015,79,558,New York,Rochester,6587
14479,2014-2015,2014-11-13,2015-04-24,163,0,125,428,553,160,412,572,1125,78,561,New York,Rochester,6587
14480,2015-2016,2015-11-22,2016-04-10,141,0,45,224,269,99,106,205,474,46,251,New York,Rochester,6587
14481,2016-2017,2016-10-27,2017-04-07,163,0,49,214,263,155,173,328,591,56,311,New York,Rochester,6587
14482,2017-2018,2017-11-09,2018-04-29,172,0,87,309,396,176,339,515,911,73,441,New York,Rochester,6587
14483,2018-2019,2018-10-18,2019-04-27,192,0,67,303,370,149,226,375,745,69,357,New York,Rochester,6587
14484,2019-2020,2019-11-07,2020-05-09,185,0,40,242,282,135,222,357,639,64,295,New York,Rochester,6587
14485,1950-1951,1950-11-11,1951-03-26,136,0,87,328,415,137,308,445,860,62,354,New York,Syracuse,3084
14486,1951-1952,1951-11-01,1952-03-28,149,0,70,312,382,145,282,427,809,66,355,New York,Syracuse,3084
14487,1952-1953,1952-10-20,1953-04-18,181,0,42,241,283,115,147,262,545,49,249,New York,Syracuse,3084
14488,1953-1954,1953-11-07,1954-04-05,150,0,70,291,361,126,187,313,674,61,369,New York,Syracuse,3084
14489,1954-1955,1954-10-31,1955-04-07,159,0,88,329,417,151,249,400,817,62,359,New York,Syracuse,3084
14490,1955-1956,1955-10-25,1956-04-19,178,0,109,387,496,210,425,635,1131,88,538,New York,Syracuse,3084
14491,1956-1957,1956-11-10,1957-04-14,156,0,69,328,397,119,213,332,729,61,314,New York,Syracuse,3084
14492,1957-1958,1957-11-09,1958-04-09,152,0,96,328,424,194,599,793,1217,59,446,New York,Syracuse,3084
14493,1958-1959,1958-11-21,1959-03-30,130,0,131,447,578,200,367,567,1145,68,550,New York,Syracuse,3084
14494,1959-1960,1959-11-02,1960-04-10,161,0,86,341,427,194,534,728,1155,72,412,New York,Syracuse,3084
14495,1960-1961,1960-10-24,1961-04-16,175,0,121,402,523,194,495,689,1212,72,473,New York,Syracuse,3084
14496,1961-1962,1961-11-08,1962-04-15,159,1,85,358,443,119,217,336,779,55,310,New York,Syracuse,3084
14497,1962-1963,1962-10-24,1963-05-01,190,0,117,447,564,174,558,732,1296,77,509,New York,Syracuse,3084
14498,1963-1964,1963-11-02,1964-04-09,160,0,88,378,466,134,347,481,947,71,428,New York,Syracuse,3084
14499,1964-1965,1964-10-10,1965-04-18,191,0,90,392,482,142,276,418,900,65,390,New York,Syracuse,3084
14500,1965-1966,1965-10-28,1966-05-09,194,0,88,395,483,169,334,503,986,65,439,New York,Syracuse,3084
14501,1966-1967,1966-12-01,1967-04-07,128,0,82,335,417,127,356,483,900,59,356,New York,Syracuse,3084
14502,1967-1968,1967-11-09,1968-03-25,138,0,101,373,474,117,333,450,924,59,370,New York,Syracuse,3084
14503,1968-1969,1968-10-29,1969-03-31,154,0,93,320,413,142,435,577,990,67,347,New York,Syracuse,3084
14504,1969-1970,1969-10-22,1970-05-06,197,0,125,425,550,181,577,758,1308,77,529,New York,Syracuse,3084
14505,1970-1971,1970-10-16,1971-04-24,191,0,107,373,480,222,679,901,1381,80,538,New York,Syracuse,3084
14506,1971-1972,1971-11-07,1972-04-08,154,0,76,371,447,193,383,576,1023,78,455,New York,Syracuse,3084
14507,1972-1973,1972-10-17,1973-05-17,213,0,63,310,373,116,184,300,673,58,269,New York,Syracuse,3084
14508,1973-1974,1973-11-05,1974-04-11,158,0,88,338,426,184,335,519,945,66,418,New York,Syracuse,3084
14509,1974-1975,1974-10-02,1975-04-12,193,1,46,290,336,159,260,419,755,74,329,New York,Syracuse,3084
14510,1975-1976,1975-11-14,1976-04-26,165,1,90,365,455,145,357,502,957,65,423,New York,Syracuse,3084
14511,1976-1977,1976-10-28,1977-05-09,194,0,126,409,535,212,481,693,1228,90,620,New York,Syracuse,3084
14512,1977-1978,1977-11-13,1978-04-15,154,0,107,418,525,233,575,808,1333,79,589,New York,Syracuse,3084
14513,1978-1979,1978-11-21,1979-04-11,142,0,121,392,513,168,406,574,1087,63,433,New York,Syracuse,3084
14514,1979-1980,1979-10-26,1980-04-16,174,0,87,332,419,138,303,441,860,58,381,New York,Syracuse,3084
14515,1980-1981,1980-11-10,1981-04-06,148,0,111,428,539,122,328,450,989,68,442,New York,Syracuse,3084
14516,1981-1982,1981-10-19,1982-04-12,176,0,106,414,520,195,369,564,1084,73,493,New York,Syracuse,3084
14517,1982-1983,1982-11-15,1983-04-25,162,0,57,323,380,94,140,234,614,41,215,New York,Syracuse,3084
14518,1983-1984,1983-11-04,1984-04-01,150,0,128,428,556,165,383,548,1104,65,494,New York,Syracuse,3084
14519,1984-1985,1984-11-12,1985-04-18,158,0,69,309,378,169,284,453,831,67,426,New York,Syracuse,3084
14520,1985-1986,1985-11-22,1986-04-11,141,0,90,328,418,161,284,445,863,76,458,New York,Syracuse,3084
14521,1986-1987,1986-11-11,1987-04-01,142,0,59,332,391,136,289,425,816,50,275,New York,Syracuse,3084
14522,1987-1988,1987-11-05,1988-04-20,168,0,80,351,431,168,207,375,806,72,428,New York,Syracuse,3084
14523,1988-1989,1988-10-12,1989-04-11,182,0,75,352,427,149,136,285,712,74,406,New York,Syracuse,3084
14524,1989-1990,1989-11-12,1990-04-18,158,0,82,383,465,229,310,539,1004,78,536,New York,Syracuse,3084
14525,1990-1991,1990-10-28,1991-04-22,177,0,48,290,338,143,165,308,646,61,308,New York,Syracuse,3084
14526,1991-1992,1991-11-07,1992-04-03,149,0,68,351,419,235,304,539,958,67,513,New York,Syracuse,3084
14527,1992-1993,1992-10-19,1993-04-23,187,0,73,393,466,268,534,802,1268,76,510,New York,Syracuse,3084
14528,1993-1994,1993-10-10,1994-04-08,181,4,142,500,642,237,637,874,1516,74,623,New York,Syracuse,3084
14529,1994-1995,1994-11-24,1995-04-10,138,0,67,325,392,102,166,268,660,50,324,New York,Syracuse,3084
14530,1995-1996,1995-11-04,1996-05-12,191,1,130,418,548,242,372,614,1162,89,596,New York,Syracuse,3084
14531,1996-1997,1996-11-02,1997-04-09,159,0,63,297,360,187,146,333,693,75,438,New York,Syracuse,3084
14532,1997-1998,1997-10-23,1998-03-25,154,0,39,234,273,193,270,463,736,55,334,New York,Syracuse,3084
14533,1998-1999,1998-12-01,1999-03-24,114,0,71,287,358,141,205,346,704,49,352,New York,Syracuse,3084
14534,1999-2000,1999-11-15,2000-04-10,148,0,73,298,371,124,217,341,712,50,313,New York,Syracuse,3084
14535,2000-2001,2000-11-17,2001-04-02,137,2,87,336,423,277,404,681,1104,87,589,New York,Syracuse,3084
14536,2001-2002,2001-10-08,2002-04-26,201,0,16,190,206,99,64,163,369,57,203,New York,Syracuse,3084
14537,2002-2003,2002-11-01,2003-04-08,159,0,109,390,499,218,528,746,1245,85,553,New York,Syracuse,3084
14538,2003-2004,2003-11-13,2004-04-05,145,0,118,377,495,246,602,848,1343,69,546,New York,Syracuse,3084
14539,2004-2005,2004-11-08,2005-03-26,139,0,89,370,459,190,389,579,1038,65,475,New York,Syracuse,3084
14540,2005-2006,2005-11-17,2006-03-23,127,0,69,261,330,172,266,438,768,68,397,New York,Syracuse,3084
14541,2006-2007,2006-11-03,2007-04-17,166,0,97,324,421,197,393,590,1011,67,501,New York,Syracuse,3084
14542,2007-2008,2007-11-16,2008-03-30,136,0,55,293,348,163,252,415,763,65,375,New York,Syracuse,3084
14543,2008-2009,2008-10-28,2009-04-07,162,0,109,375,484,214,358,572,1056,71,540,New York,Syracuse,3084
14544,2009-2010,2009-11-06,2010-05-09,185,0,74,269,343,152,379,531,874,58,345,New York,Syracuse,3084
14545,2010-2011,2010-11-19,2011-04-21,154,0,101,353,454,254,546,800,1254,73,540,New York,Syracuse,3084
14546,2011-2012,2011-11-18,2012-03-10,114,0,19,172,191,82,68,150,341,38,180,New York,Syracuse,3084
14547,2012-2013,2012-11-24,2013-04-04,132,0,61,254,315,172,301,473,788,68,408,New York,Syracuse,3084
14548,2013-2014,2013-11-08,2014-04-16,160,0,133,455,588,194,434,628,1216,75,554,New York,Syracuse,3084
14549,2014-2015,2014-11-13,2015-04-24,163,0,153,496,649,175,556,731,1380,76,588,New York,Syracuse,3084
14550,2015-2016,2015-10-18,2016-04-08,174,0,49,262,311,116,232,348,659,37,258,New York,Syracuse,3084
14551,2016-2017,2016-10-27,2017-04-07,163,0,57,265,322,201,277,478,800,63,397,New York,Syracuse,3084
14552,2017-2018,2017-11-10,2018-04-20,162,1,97,381,478,218,447,665,1143,70,516,New York,Syracuse,3084
14553,2018-2019,2018-11-10,2019-04-05,147,0,89,363,452,172,372,544,996,74,426,New York,Syracuse,3084
14554,2019-2020,2019-11-07,2020-05-09,185,0,41,274,315,133,276,409,724,59,282,New York,Syracuse,3084
14555,1950-1951,1950-11-11,1951-04-05,146,1,113,384,497,187,347,534,1031,66,439,New York,Watertown,21482
14556,1951-1952,1951-11-02,1952-03-18,138,0,118,406,524,175,297,472,996,57,432,New York,Watertown,21482
14557,1953-1954,1953-11-06,1954-04-05,151,13,101,429,530,103,273,376,906,42,297,New York,Watertown,21482
14558,1954-1955,1954-11-22,1955-04-08,138,3,129,450,579,137,370,507,1086,42,293,New York,Watertown,21482
14559,1955-1956,1955-11-09,1956-04-20,164,5,137,509,646,125,349,474,1120,52,345,New York,Watertown,21482
14560,1956-1957,1956-11-23,1957-04-13,142,1,101,450,551,124,306,430,981,52,385,New York,Watertown,21482
14561,1957-1958,1957-11-10,1958-03-25,136,4,118,376,494,87,445,532,1026,49,298,New York,Watertown,21482
14562,1958-1959,1958-11-25,1959-04-06,133,4,160,559,719,180,551,731,1450,53,510,New York,Watertown,21482
14563,1959-1960,1959-11-04,1960-04-10,159,0,138,486,624,193,690,883,1507,60,411,New York,Watertown,21482
14564,1960-1961,1960-10-25,1961-04-11,169,1,154,521,675,144,560,704,1379,39,374,New York,Watertown,21482
14565,1961-1962,1961-11-09,1962-04-16,159,11,133,471,604,143,385,528,1132,45,340,New York,Watertown,21482
14566,1962-1963,1962-10-25,1963-05-01,189,2,161,565,726,236,988,1224,1950,67,606,New York,Watertown,21482
14567,1963-1964,1963-11-30,1964-04-09,132,1,126,462,588,123,514,637,1225,47,341,New York,Watertown,21482
14568,1965-1966,1965-11-28,1966-04-06,130,0,116,406,522,116,396,512,1034,37,266,New York,Watertown,21482
14569,1966-1967,1966-11-05,1967-05-08,185,14,104,453,557,113,343,456,1013,47,311,New York,Watertown,21482
14570,1967-1968,1967-11-05,1968-03-26,143,3,147,533,680,109,452,561,1241,37,318,New York,Watertown,21482
14571,1968-1969,1968-11-13,1969-04-19,158,0,132,475,607,130,344,474,1081,42,304,New York,Watertown,21482
14572,1969-1970,1969-10-22,1970-05-06,197,0,162,615,777,162,824,986,1763,47,387,New York,Watertown,21482
14573,1970-1971,1970-11-23,1971-04-25,154,0,144,539,683,211,821,1032,1715,55,486,New York,Watertown,21482
14574,1971-1972,1971-11-07,1972-04-10,156,0,107,510,617,152,593,745,1362,55,400,New York,Watertown,21482
14575,1972-1973,1972-10-19,1973-04-11,175,1,98,419,517,128,318,446,963,40,298,New York,Watertown,21482
14576,1973-1974,1973-11-12,1974-04-10,150,0,132,473,605,135,269,404,1009,46,362,New York,Watertown,21482
14577,1974-1975,1974-11-16,1975-04-11,147,0,73,402,475,162,367,529,1004,53,344,New York,Watertown,21482
14578,1975-1976,1975-11-14,1976-05-20,189,1,128,540,668,154,424,578,1246,46,421,New York,Watertown,21482
14579,1976-1977,1976-10-22,1977-05-09,200,0,166,573,739,318,907,1225,1964,70,757,New York,Watertown,21482
14580,1977-1978,1977-11-12,1978-04-01,141,1,153,563,716,215,1021,1236,1952,66,550,New York,Watertown,21482
14581,1978-1979,1978-11-21,1979-04-11,142,1,176,524,700,200,679,879,1579,51,466,New York,Watertown,21482
14582,1979-1980,1979-11-16,1980-04-05,142,2,117,457,574,105,307,412,986,32,232,New York,Watertown,21482
14583,1980-1981,1980-11-12,1981-04-06,146,0,161,559,720,151,445,596,1316,53,447,New York,Watertown,21482
14584,1981-1982,1981-11-07,1982-04-10,155,3,143,523,666,138,642,780,1446,55,420,New York,Watertown,21482
14585,1982-1983,1982-11-15,1983-04-25,162,19,83,359,442,55,95,150,592,29,149,New York,Watertown,21482
14586,1983-1984,1983-11-12,1984-03-31,141,3,148,485,633,237,799,1036,1669,58,507,New York,Watertown,21482
14587,1984-1985,1984-11-13,1985-04-04,143,6,115,452,567,213,548,761,1328,47,474,New York,Watertown,21482
14588,1985-1986,1985-11-16,1986-04-10,146,8,127,488,615,250,859,1109,1724,58,539,New York,Watertown,21482
14589,1986-1987,1986-11-13,1987-04-01,140,0,93,422,515,81,286,367,882,37,239,New York,Watertown,21482
14590,1989-1990,1989-11-17,1990-04-06,141,2,122,489,611,139,268,407,1018,42,384,New York,Watertown,21482
14591,1990-1991,1990-11-13,1991-03-22,130,7,65,347,412,86,150,236,648,31,222,New York,Watertown,21482
14592,1999-2000,1999-11-30,2000-04-12,135,3,104,404,508,98,219,317,825,33,267,New York,Watertown,21482
14593,2000-2001,2000-11-19,2001-04-07,140,3,101,464,565,228,668,896,1461,52,438,New York,Watertown,21482
14594,2001-2002,2001-12-01,2002-04-29,150,0,42,297,339,172,314,486,825,43,312,New York,Watertown,21482
14595,2002-2003,2002-11-03,2003-04-10,159,2,162,593,755,233,654,887,1642,56,519,New York,Watertown,21482
14596,2003-2004,2003-11-19,2004-04-05,139,4,129,471,600,131,324,455,1055,37,284,New York,Watertown,21482
14597,2008-2009,2008-10-29,2009-04-09,163,9,121,513,634,256,511,767,1401,49,511,New York,Watertown,21482
14598,2009-2010,2009-12-01,2010-03-27,117,0,101,353,454,122,399,521,975,34,263,New York,Watertown,21482
14599,2010-2011,2010-11-27,2011-03-28,122,2,154,504,658,173,472,645,1303,43,445,New York,Watertown,21482
14600,2012-2013,2012-11-26,2013-04-03,129,1,87,370,457,117,313,430,887,35,258,New York,Watertown,21482
14601,2013-2014,2013-11-12,2014-04-16,156,7,177,596,773,290,675,965,1738,51,621,New York,Watertown,21482
14602,2014-2015,2014-11-14,2015-04-05,143,0,190,611,801,213,723,936,1737,51,535,New York,Watertown,21482
14603,2015-2016,2015-11-24,2016-04-06,135,0,75,312,387,75,181,256,643,21,166,New York,Watertown,21482
14604,2016-2017,2016-11-21,2017-03-26,126,0,76,319,395,131,225,356,751,26,241,New York,Watertown,21482
14605,2018-2019,2018-11-16,2019-04-01,137,0,122,490,612,242,411,653,1265,48,502,New York,Watertown,21482
14606,2019-2020,2019-11-08,2020-05-09,184,0,75,394,469,134,356,490,959,32,248,New York,Watertown,21482
14607,1950-1951,1950-11-24,1951-02-28,97,0,18,151,169,11,8,19,188,8,45,North Carolina,Asheville,83393
14608,1951-1952,1951-11-18,1952-03-24,128,0,4,105,109,13,1,14,123,10,27,North Carolina,Asheville,83393
14609,1952-1953,1952-11-21,1953-02-28,100,0,4,73,77,23,5,28,105,10,32,North Carolina,Asheville,83393
14610,1953-1954,1953-11-26,1954-03-15,110,0,6,118,124,14,8,22,146,8,25,North Carolina,Asheville,83393
14611,1954-1955,1954-11-02,1955-03-27,146,0,9,147,156,15,15,30,186,8,30,North Carolina,Asheville,83393
14612,1955-1956,1955-11-10,1956-04-11,154,0,7,139,146,21,5,26,172,15,40,North Carolina,Asheville,83393
14613,1956-1957,1956-11-27,1957-03-08,102,0,6,65,71,9,0,9,80,7,18,North Carolina,Asheville,83393
14614,1957-1958,1957-11-30,1958-03-21,112,0,29,176,205,28,35,63,268,12,70,North Carolina,Asheville,83393
14615,1958-1959,1958-12-01,1959-04-14,135,0,11,144,155,6,6,12,167,4,14,North Carolina,Asheville,83393
14616,1959-1960,1959-11-29,1960-04-05,129,0,21,166,187,58,80,138,325,17,99,North Carolina,Asheville,83393
14617,1960-1961,1960-12-01,1961-02-28,90,0,11,139,150,8,2,10,160,5,21,North Carolina,Asheville,83393
14618,1961-1962,1961-12-01,1962-03-09,99,0,11,99,110,31,29,60,170,12,59,North Carolina,Asheville,83393
14619,1962-1963,1962-11-05,1963-02-28,116,0,18,195,213,14,5,19,232,10,39,North Carolina,Asheville,83393
14620,1963-1964,1963-11-14,1964-03-30,138,0,12,165,177,43,27,70,247,23,84,North Carolina,Asheville,83393
14621,1964-1965,1964-12-01,1965-03-20,110,0,8,163,171,22,22,44,215,9,43,North Carolina,Asheville,83393
14622,1965-1966,1965-12-01,1966-03-06,96,0,17,168,185,32,101,133,318,11,61,North Carolina,Asheville,83393
14623,1966-1967,1966-11-21,1967-02-28,100,0,5,148,153,16,3,19,172,11,41,North Carolina,Asheville,83393
14624,1967-1968,1967-12-01,1968-03-02,93,0,8,158,166,25,35,60,226,13,57,North Carolina,Asheville,83393
14625,1968-1969,1968-11-09,1969-03-10,122,0,6,155,161,71,65,136,297,15,87,North Carolina,Asheville,83393
14626,1969-1970,1969-12-01,1970-03-23,113,0,15,172,187,27,52,79,266,12,48,North Carolina,Asheville,83393
14627,1970-1971,1970-11-24,1971-04-07,135,0,7,156,163,25,21,46,209,12,43,North Carolina,Asheville,83393
14628,1971-1972,1971-11-24,1972-03-31,129,0,4,114,118,44,25,69,187,11,55,North Carolina,Asheville,83393
14629,1972-1973,1972-11-22,1973-03-21,120,0,7,119,126,15,25,40,166,5,26,North Carolina,Asheville,83393
14630,1973-1974,1973-12-01,1974-03-25,115,0,2,91,93,9,1,10,103,6,20,North Carolina,Asheville,83393
14631,1974-1975,1974-11-14,1975-03-10,117,0,2,123,125,20,9,29,154,11,36,North Carolina,Asheville,83393
14632,1975-1976,1975-11-23,1976-02-29,99,0,6,153,159,15,10,25,184,6,28,North Carolina,Asheville,83393
14633,1976-1977,1976-11-22,1977-02-28,99,0,17,244,261,22,56,78,339,10,44,North Carolina,Asheville,83393
14634,1977-1978,1977-12-01,1978-03-18,108,0,15,213,228,37,51,88,316,23,91,North Carolina,Asheville,83393
14635,1978-1979,1978-12-01,1979-02-28,90,0,3,148,151,33,53,86,237,8,46,North Carolina,Asheville,83393
14636,1979-1980,1979-12-01,1980-03-13,104,0,8,133,141,21,20,41,182,11,48,North Carolina,Asheville,83393
14637,1980-1981,1980-12-01,1981-03-24,114,0,7,180,187,24,15,39,226,7,32,North Carolina,Asheville,83393
14638,1981-1982,1981-12-01,1982-04-08,129,0,10,152,162,30,36,66,228,8,45,North Carolina,Asheville,83393
14639,1982-1983,1982-12-01,1983-04-18,139,0,2,107,109,38,29,67,176,16,61,North Carolina,Asheville,83393
14640,1983-1984,1983-12-01,1984-02-29,91,0,10,159,169,5,6,11,180,4,15,North Carolina,Asheville,83393
14641,1984-1985,1984-12-01,1985-04-08,129,0,12,162,174,13,12,25,199,9,39,North Carolina,Asheville,83393
14642,1985-1986,1985-12-01,1986-03-04,94,0,8,175,183,10,5,15,198,7,30,North Carolina,Asheville,83393
14643,1986-1987,1986-12-01,1987-04-06,127,0,2,124,126,41,49,90,216,11,59,North Carolina,Asheville,83393
14644,1987-1988,1987-11-11,1988-04-12,154,0,8,192,200,23,53,76,276,5,32,North Carolina,Asheville,83393
14645,1988-1989,1988-12-01,1989-04-07,128,0,6,119,125,11,5,16,141,6,20,North Carolina,Asheville,83393
14646,1989-1990,1989-12-01,1990-02-28,90,0,11,111,122,8,1,9,131,6,18,North Carolina,Asheville,83393
14647,1990-1991,1990-12-01,1991-03-08,98,0,1,90,91,6,1,7,98,3,14,North Carolina,Asheville,83393
14648,1991-1992,1991-11-09,1992-03-13,126,0,1,104,105,4,0,4,109,3,8,North Carolina,Asheville,83393
14649,1992-1993,1992-12-01,1993-03-20,110,0,6,109,115,29,49,78,193,5,46,North Carolina,Asheville,83393
14650,1993-1994,1993-12-01,1994-03-03,93,0,9,143,152,20,31,51,203,10,35,North Carolina,Asheville,83393
14651,1994-1995,1994-12-01,1995-02-28,90,0,4,94,98,7,3,10,108,4,22,North Carolina,Asheville,83393
14652,1995-1996,1995-12-01,1996-03-21,112,0,18,167,185,31,55,86,271,13,70,North Carolina,Asheville,83393
14653,1996-1997,1996-11-10,1997-02-28,111,0,8,125,133,12,17,29,162,7,20,North Carolina,Asheville,83393
14654,1997-1998,1997-12-01,1998-03-21,111,0,6,96,102,22,23,45,147,7,35,North Carolina,Asheville,83393
14655,1998-1999,1998-12-01,1999-03-26,116,0,5,96,101,12,6,18,119,6,18,North Carolina,Asheville,83393
14656,1999-2000,1999-11-02,2000-04-04,155,0,8,117,125,11,8,19,144,5,18,North Carolina,Asheville,83393
14657,2000-2001,2000-11-19,2001-04-17,150,0,7,156,163,25,15,40,203,9,41,North Carolina,Asheville,83393
14658,2001-2002,2001-12-01,2002-03-04,94,0,3,104,107,3,0,3,110,3,7,North Carolina,Asheville,83393
14659,2002-2003,2002-12-01,2003-04-10,131,0,4,126,130,26,16,42,172,7,39,North Carolina,Asheville,83393
14660,2003-2004,2003-12-01,2004-02-29,91,0,4,132,136,23,10,33,169,9,38,North Carolina,Asheville,83393
14661,2004-2005,2004-12-01,2005-04-24,145,0,6,123,129,11,1,12,141,7,24,North Carolina,Asheville,83393
14662,2005-2006,2005-12-01,2006-02-28,90,0,1,97,98,4,0,4,102,3,9,North Carolina,Asheville,83393
14663,2006-2007,2006-12-01,2007-04-07,128,0,1,129,130,5,1,6,136,3,11,North Carolina,Asheville,83393
14664,2007-2008,2007-12-01,2008-02-29,91,0,5,94,99,6,4,10,109,4,15,North Carolina,Asheville,83393
14665,2008-2009,2008-12-01,2009-03-02,92,0,8,130,138,9,3,12,150,2,12,North Carolina,Asheville,83393
14666,2009-2010,2009-12-01,2010-03-22,112,0,21,151,172,54,75,129,301,9,68,North Carolina,Asheville,83393
14667,2010-2011,2010-12-01,2011-02-28,90,0,14,143,157,29,56,85,242,8,55,North Carolina,Asheville,83393
14668,2011-2012,2011-12-01,2012-02-29,91,0,2,76,78,0,0,0,78,0,0,North Carolina,Asheville,83393
14669,2012-2013,2012-12-01,2013-03-20,110,0,1,82,83,2,0,2,85,2,5,North Carolina,Asheville,83393
14670,2013-2014,2013-11-27,2014-03-25,119,0,10,170,180,17,12,29,209,7,35,North Carolina,Asheville,83393
14671,2014-2015,2014-11-01,2015-02-28,120,0,10,150,160,18,20,38,198,6,31,North Carolina,Asheville,83393
14672,2015-2016,2015-12-01,2016-02-29,91,0,8,90,98,22,34,56,154,5,35,North Carolina,Asheville,83393
14673,2016-2017,2016-12-01,2017-03-15,105,0,4,74,78,14,21,35,113,6,25,North Carolina,Asheville,83393
14674,2017-2018,2017-12-01,2018-03-14,104,0,10,115,125,20,21,41,166,7,33,North Carolina,Asheville,83393
14675,2018-2019,2018-12-01,2019-02-28,90,0,1,59,60,15,25,40,100,3,17,North Carolina,Asheville,83393
14676,2019-2020,2019-12-01,2020-02-29,91,0,2,54,56,5,1,6,62,4,8,North Carolina,Asheville,83393
14677,1950-1951,1950-11-25,1951-02-28,96,0,4,99,103,1,0,1,104,1,3,North Carolina,Charlotte,731424
14678,1951-1952,1951-12-01,1952-02-29,91,0,1,54,55,6,4,10,65,1,7,North Carolina,Charlotte,731424
14679,1952-1953,1952-12-01,1953-02-28,90,0,0,41,41,0,0,0,41,0,0,North Carolina,Charlotte,731424
14680,1953-1954,1953-12-01,1954-02-28,90,0,0,60,60,5,2,7,67,3,8,North Carolina,Charlotte,731424
14681,1954-1955,1954-12-01,1955-02-28,90,0,1,71,72,13,10,23,95,3,16,North Carolina,Charlotte,731424
14682,1955-1956,1955-12-01,1956-02-29,91,0,0,68,68,1,1,2,70,1,2,North Carolina,Charlotte,731424
14683,1956-1957,1956-12-01,1957-02-28,90,0,0,38,38,0,0,0,38,0,0,North Carolina,Charlotte,731424
14684,1957-1958,1957-12-01,1958-02-28,90,0,5,109,114,5,6,11,125,2,7,North Carolina,Charlotte,731424
14685,1958-1959,1958-12-01,1959-03-02,92,0,2,92,94,6,8,14,108,3,12,North Carolina,Charlotte,731424
14686,1959-1960,1959-12-01,1960-03-14,105,0,3,91,94,32,53,85,179,6,44,North Carolina,Charlotte,731424
14687,1960-1961,1960-12-01,1961-02-28,90,0,4,98,102,4,3,7,109,3,12,North Carolina,Charlotte,731424
14688,1961-1962,1961-12-01,1962-03-09,99,0,3,76,79,20,19,39,118,6,25,North Carolina,Charlotte,731424
14689,1962-1963,1962-12-01,1963-02-28,90,0,5,142,147,3,3,6,153,1,5,North Carolina,Charlotte,731424
14690,1963-1964,1963-12-01,1964-02-29,91,0,1,107,108,5,2,7,115,4,11,North Carolina,Charlotte,731424
14691,1964-1965,1964-12-01,1965-02-28,90,0,2,79,81,19,17,36,117,4,29,North Carolina,Charlotte,731424
14692,1965-1966,1965-12-01,1966-02-28,90,0,4,85,89,17,19,36,125,5,33,North Carolina,Charlotte,731424
14693,1966-1967,1966-12-01,1967-02-28,90,0,1,80,81,7,5,12,93,1,8,North Carolina,Charlotte,731424
14694,1967-1968,1967-12-01,1968-02-29,91,0,4,87,91,9,10,19,110,5,19,North Carolina,Charlotte,731424
14695,1968-1969,1968-11-11,1969-03-02,112,0,4,116,120,26,31,57,177,6,33,North Carolina,Charlotte,731424
14696,1969-1970,1969-12-01,1970-02-28,90,0,7,124,131,6,4,10,141,3,15,North Carolina,Charlotte,731424
14697,1970-1971,1970-12-01,1971-03-27,117,0,5,108,113,14,12,26,139,6,22,North Carolina,Charlotte,731424
14698,1971-1972,1971-12-01,1972-03-26,117,0,2,67,69,15,10,25,94,3,18,North Carolina,Charlotte,731424
14699,1972-1973,1972-12-01,1973-02-28,90,0,5,84,89,8,19,27,116,3,17,North Carolina,Charlotte,731424
14700,1973-1974,1973-12-01,1974-03-25,115,0,1,61,62,10,3,13,75,4,16,North Carolina,Charlotte,731424
14701,1974-1975,1974-12-01,1975-03-10,100,0,0,56,56,3,0,3,59,2,4,North Carolina,Charlotte,731424
14702,1975-1976,1975-11-23,1976-02-29,99,0,1,82,83,1,0,1,84,1,1,North Carolina,Charlotte,731424
14703,1976-1977,1976-12-01,1977-02-28,90,0,5,142,147,6,2,8,155,4,13,North Carolina,Charlotte,731424
14704,1977-1978,1977-12-01,1978-03-17,107,0,1,104,105,9,4,13,118,4,12,North Carolina,Charlotte,731424
14705,1978-1979,1978-12-01,1979-02-28,90,0,3,101,104,22,24,46,150,4,30,North Carolina,Charlotte,731424
14706,1979-1980,1979-12-01,1980-03-04,95,0,3,89,92,22,15,37,129,8,37,North Carolina,Charlotte,731424
14707,1980-1981,1980-12-01,1981-02-28,90,0,5,111,116,3,2,5,121,2,8,North Carolina,Charlotte,731424
14708,1981-1982,1981-12-01,1982-04-08,129,0,6,88,94,15,24,39,133,6,27,North Carolina,Charlotte,731424
14709,1982-1983,1982-12-01,1983-03-25,115,0,1,65,66,18,7,25,91,4,25,North Carolina,Charlotte,731424
14710,1983-1984,1983-12-01,1984-02-29,91,0,5,94,99,7,4,11,110,1,9,North Carolina,Charlotte,731424
14711,1984-1985,1984-12-01,1985-02-28,90,0,2,93,95,3,1,4,99,2,11,North Carolina,Charlotte,731424
14712,1985-1986,1985-12-01,1986-02-28,90,0,2,96,98,1,0,1,99,1,4,North Carolina,Charlotte,731424
14713,1986-1987,1986-12-01,1987-03-12,102,0,0,62,62,11,17,28,90,4,16,North Carolina,Charlotte,731424
14714,1987-1988,1987-12-01,1988-02-29,91,0,4,82,86,18,43,61,147,1,23,North Carolina,Charlotte,731424
14715,1988-1989,1988-12-01,1989-02-28,90,0,1,41,42,5,4,9,51,2,8,North Carolina,Charlotte,731424
14716,1989-1990,1989-12-01,1990-02-28,90,0,5,60,65,1,0,1,66,1,3,North Carolina,Charlotte,731424
14717,1990-1991,1990-12-01,1991-02-28,90,0,0,35,35,2,0,2,37,1,2,North Carolina,Charlotte,731424
14718,1991-1992,1991-12-01,1992-02-29,91,0,0,32,32,0,0,0,32,0,0,North Carolina,Charlotte,731424
14719,1992-1993,1992-12-01,1993-03-14,104,0,0,43,43,2,2,4,47,1,3,North Carolina,Charlotte,731424
14720,1993-1994,1993-12-01,1994-02-28,90,0,4,65,69,3,2,5,74,1,3,North Carolina,Charlotte,731424
14721,1994-1995,1994-12-01,1995-02-28,90,0,1,52,53,0,0,0,53,0,0,North Carolina,Charlotte,731424
14722,1995-1996,1995-12-01,1996-02-29,91,0,5,85,90,4,5,9,99,2,10,North Carolina,Charlotte,731424
14723,1996-1997,1996-12-01,1997-02-28,90,0,0,42,42,2,0,2,44,2,3,North Carolina,Charlotte,731424
14724,1997-1998,1997-12-01,1998-03-12,102,0,0,30,30,6,3,9,39,3,8,North Carolina,Charlotte,731424
14725,1998-1999,1998-12-01,1999-03-09,99,0,1,63,64,3,0,3,67,2,4,North Carolina,Charlotte,731424
14726,1999-2000,1999-12-01,2000-02-29,91,0,2,82,84,16,9,25,109,6,25,North Carolina,Charlotte,731424
14727,2000-2001,2000-11-19,2001-02-28,102,0,0,105,105,4,0,4,109,2,5,North Carolina,Charlotte,731424
14728,2001-2002,2001-12-01,2002-02-28,90,0,2,70,72,5,10,15,87,2,9,North Carolina,Charlotte,731424
14729,2002-2003,2002-12-01,2003-02-28,90,0,0,87,87,15,19,34,121,3,24,North Carolina,Charlotte,731424
14730,2003-2004,2003-12-01,2004-03-01,92,0,1,99,100,19,19,38,138,4,24,North Carolina,Charlotte,731424
14731,2004-2005,2004-12-01,2005-02-28,90,0,3,76,79,1,1,2,81,1,4,North Carolina,Charlotte,731424
14732,2005-2006,2005-12-01,2006-02-28,90,0,0,64,64,0,0,0,64,0,0,North Carolina,Charlotte,731424
14733,2006-2007,2006-12-01,2007-02-28,90,0,0,70,70,2,0,2,72,1,3,North Carolina,Charlotte,731424
14734,2007-2008,2007-12-01,2008-02-29,91,0,0,61,61,2,0,2,63,1,3,North Carolina,Charlotte,731424
14735,2008-2009,2008-12-01,2009-03-02,92,0,1,80,81,6,4,10,91,1,7,North Carolina,Charlotte,731424
14736,2009-2010,2009-12-01,2010-03-02,92,0,1,106,107,8,11,19,126,4,13,North Carolina,Charlotte,731424
14737,2010-2011,2010-12-01,2011-02-28,90,0,1,111,112,9,13,22,134,3,13,North Carolina,Charlotte,731424
14738,2011-2012,2011-12-01,2012-02-29,91,0,0,48,48,0,0,0,48,0,0,North Carolina,Charlotte,731424
14739,2012-2013,2012-12-01,2013-02-28,90,0,1,50,51,3,3,6,57,1,4,North Carolina,Charlotte,731424
14740,2013-2014,2013-12-01,2014-02-28,90,0,4,95,99,12,13,25,124,4,19,North Carolina,Charlotte,731424
14741,2014-2015,2014-12-01,2015-02-28,90,0,3,90,93,5,3,8,101,4,10,North Carolina,Charlotte,731424
14742,2015-2016,2015-12-01,2016-02-29,91,0,1,67,68,5,7,12,80,2,7,North Carolina,Charlotte,731424
14743,2016-2017,2016-12-01,2017-03-12,102,0,2,48,50,5,3,8,58,3,10,North Carolina,Charlotte,731424
14744,2017-2018,2017-12-01,2018-03-14,104,0,2,91,93,6,5,11,104,3,10,North Carolina,Charlotte,731424
14745,2018-2019,2018-12-01,2019-04-02,123,0,0,42,42,5,3,8,50,3,6,North Carolina,Charlotte,731424
14746,2019-2020,2019-12-01,2020-02-29,91,0,0,36,36,1,0,1,37,1,1,North Carolina,Charlotte,731424
14747,1950-1951,1950-11-24,1951-02-28,97,0,8,146,154,7,2,9,163,6,22,North Carolina,Greensboro,269666
14748,1951-1952,1951-12-01,1952-03-15,106,0,3,95,98,17,5,22,120,6,25,North Carolina,Greensboro,269666
14749,1952-1953,1952-12-01,1953-03-03,93,0,1,68,69,0,0,0,69,0,0,North Carolina,Greensboro,269666
14750,1953-1954,1953-12-01,1954-02-28,90,0,5,96,101,13,15,28,129,5,22,North Carolina,Greensboro,269666
14751,1954-1955,1954-12-01,1955-02-28,90,0,1,113,114,18,17,35,149,5,28,North Carolina,Greensboro,269666
14752,1955-1956,1955-12-01,1956-02-29,91,0,1,106,107,6,3,9,116,4,12,North Carolina,Greensboro,269666
14753,1956-1957,1956-11-26,1957-02-28,95,0,2,75,77,2,0,2,79,2,8,North Carolina,Greensboro,269666
14754,1957-1958,1957-12-01,1958-02-28,90,0,10,144,154,14,19,33,187,4,20,North Carolina,Greensboro,269666
14755,1958-1959,1958-12-01,1959-02-28,90,0,8,139,147,13,16,29,176,4,28,North Carolina,Greensboro,269666
14756,1959-1960,1959-12-01,1960-03-21,112,0,8,133,141,43,93,136,277,7,57,North Carolina,Greensboro,269666
14757,1960-1961,1960-12-01,1961-02-28,90,0,9,150,159,4,3,7,166,4,15,North Carolina,Greensboro,269666
14758,1961-1962,1961-12-01,1962-03-10,100,0,5,119,124,34,26,60,184,8,51,North Carolina,Greensboro,269666
14759,1962-1963,1962-12-01,1963-02-28,90,0,9,166,175,7,8,15,190,3,13,North Carolina,Greensboro,269666
14760,1963-1964,1963-12-01,1964-02-29,91,0,6,139,145,12,10,22,167,8,30,North Carolina,Greensboro,269666
14761,1964-1965,1964-11-30,1965-03-20,111,0,4,126,130,16,34,50,180,6,33,North Carolina,Greensboro,269666
14762,1965-1966,1965-12-01,1966-02-28,90,0,8,124,132,36,100,136,268,9,65,North Carolina,Greensboro,269666
14763,1966-1967,1966-12-01,1967-02-28,90,0,2,97,99,7,8,15,114,3,16,North Carolina,Greensboro,269666
14764,1967-1968,1967-12-01,1968-03-02,93,0,3,120,123,14,27,41,164,8,31,North Carolina,Greensboro,269666
14765,1968-1969,1968-11-09,1969-03-05,117,0,2,132,134,25,22,47,181,7,34,North Carolina,Greensboro,269666
14766,1969-1970,1969-12-01,1970-02-28,90,0,12,135,147,13,6,19,166,9,31,North Carolina,Greensboro,269666
14767,1970-1971,1970-11-24,1971-03-27,124,0,15,170,185,13,10,23,208,9,37,North Carolina,Greensboro,269666
14768,1971-1972,1971-11-09,1972-03-26,139,0,4,118,122,19,11,30,152,7,32,North Carolina,Greensboro,269666
14769,1972-1973,1972-12-01,1973-03-21,111,0,9,117,126,10,23,33,159,3,20,North Carolina,Greensboro,269666
14770,1973-1974,1973-12-01,1974-03-26,116,0,4,87,91,18,24,42,133,5,27,North Carolina,Greensboro,269666
14771,1974-1975,1974-12-01,1975-03-10,100,0,1,75,76,6,3,9,85,2,9,North Carolina,Greensboro,269666
14772,1975-1976,1975-12-01,1976-02-29,91,0,4,102,106,1,0,1,107,1,2,North Carolina,Greensboro,269666
14773,1976-1977,1976-12-01,1977-02-28,90,0,9,197,206,16,23,39,245,7,28,North Carolina,Greensboro,269666
14774,1977-1978,1977-12-01,1978-03-04,94,0,6,178,184,17,7,24,208,11,35,North Carolina,Greensboro,269666
14775,1978-1979,1978-12-01,1979-02-28,90,0,9,137,146,22,48,70,216,4,40,North Carolina,Greensboro,269666
14776,1979-1980,1979-12-01,1980-03-04,95,0,6,127,133,26,28,54,187,9,50,North Carolina,Greensboro,269666
14777,1980-1981,1980-12-01,1981-03-24,114,0,7,164,171,14,10,24,195,4,22,North Carolina,Greensboro,269666
14778,1981-1982,1981-12-01,1982-02-28,90,0,9,125,134,20,33,53,187,7,39,North Carolina,Greensboro,269666
14779,1982-1983,1982-12-01,1983-02-28,90,0,5,94,99,10,13,23,122,5,20,North Carolina,Greensboro,269666
14780,1983-1984,1983-12-01,1984-02-29,91,0,10,118,128,4,7,11,139,1,6,North Carolina,Greensboro,269666
14781,1984-1985,1984-12-01,1985-02-28,90,0,4,116,120,8,6,14,134,3,18,North Carolina,Greensboro,269666
14782,1985-1986,1985-12-01,1986-02-28,90,0,5,117,122,3,1,4,126,2,9,North Carolina,Greensboro,269666
14783,1986-1987,1986-12-01,1987-03-12,102,0,4,107,111,33,61,94,205,7,45,North Carolina,Greensboro,269666
14784,1987-1988,1987-11-11,1988-02-29,111,0,10,132,142,13,48,61,203,2,20,North Carolina,Greensboro,269666
14785,1988-1989,1988-12-01,1989-03-08,98,1,3,94,97,19,24,43,140,6,28,North Carolina,Greensboro,269666
14786,1989-1990,1989-12-01,1990-02-28,90,0,10,95,105,6,4,10,115,4,12,North Carolina,Greensboro,269666
14787,1990-1991,1990-12-01,1991-02-28,90,0,0,57,57,0,0,0,57,0,0,North Carolina,Greensboro,269666
14788,1991-1992,1991-12-01,1992-02-29,91,0,0,66,66,0,0,0,66,0,0,North Carolina,Greensboro,269666
14789,1992-1993,1992-12-01,1993-03-16,106,0,4,104,108,9,13,22,130,3,16,North Carolina,Greensboro,269666
14790,1993-1994,1993-12-01,1994-03-03,93,0,10,124,134,7,3,10,144,5,14,North Carolina,Greensboro,269666
14791,1994-1995,1994-12-01,1995-03-03,93,0,3,80,83,2,0,2,85,2,4,North Carolina,Greensboro,269666
14792,1995-1996,1995-12-01,1996-03-08,99,0,15,125,140,24,55,79,219,7,47,North Carolina,Greensboro,269666
14793,1996-1997,1996-12-01,1997-02-28,90,1,6,85,91,6,4,10,101,3,13,North Carolina,Greensboro,269666
14794,1997-1998,1997-12-01,1998-02-28,90,0,1,56,57,8,11,19,76,2,11,North Carolina,Greensboro,269666
14795,1998-1999,1998-12-01,1999-02-28,90,0,7,65,72,5,0,5,77,5,15,North Carolina,Greensboro,269666
14796,1999-2000,1999-12-01,2000-02-29,91,0,6,89,95,21,71,92,187,6,32,North Carolina,Greensboro,269666
14797,2000-2001,2000-11-19,2001-02-28,102,0,2,121,123,8,2,10,133,5,15,North Carolina,Greensboro,269666
14798,2001-2002,2001-12-01,2002-02-28,90,0,2,73,75,10,19,29,104,2,16,North Carolina,Greensboro,269666
14799,2002-2003,2002-12-01,2003-03-30,120,3,6,100,106,21,19,40,146,8,38,North Carolina,Greensboro,269666
14800,2003-2004,2003-12-01,2004-02-29,91,0,4,111,115,27,29,56,171,6,35,North Carolina,Greensboro,269666
14801,2004-2005,2004-12-01,2005-03-17,107,0,7,88,95,3,1,4,99,2,6,North Carolina,Greensboro,269666
14802,2005-2006,2005-12-01,2006-02-28,90,0,1,59,60,3,0,3,63,3,5,North Carolina,Greensboro,269666
14803,2006-2007,2006-12-01,2007-02-28,90,0,0,78,78,2,0,2,80,2,4,North Carolina,Greensboro,269666
14804,2007-2008,2007-12-01,2008-02-29,91,0,1,61,62,5,4,9,71,3,8,North Carolina,Greensboro,269666
14805,2008-2009,2008-11-21,2009-03-04,104,0,2,100,102,9,11,20,122,5,19,North Carolina,Greensboro,269666
14806,2009-2010,2009-12-01,2010-03-03,93,0,3,112,115,23,28,51,166,8,34,North Carolina,Greensboro,269666
14807,2010-2011,2010-12-01,2011-02-28,90,0,6,107,113,16,14,30,143,7,26,North Carolina,Greensboro,269666
14808,2011-2012,2011-12-01,2012-02-29,91,0,0,49,49,2,2,4,53,1,3,North Carolina,Greensboro,269666
14809,2012-2013,2012-12-01,2013-02-28,90,0,1,56,57,6,5,11,68,3,9,North Carolina,Greensboro,269666
14810,2013-2014,2013-12-01,2014-03-17,107,0,7,121,128,24,16,40,168,8,39,North Carolina,Greensboro,269666
14811,2014-2015,2014-12-01,2015-03-01,91,0,8,103,111,13,15,28,139,5,27,North Carolina,Greensboro,269666
14812,2015-2016,2015-12-01,2016-02-29,91,0,5,71,76,7,5,12,88,3,15,North Carolina,Greensboro,269666
14813,2016-2017,2016-12-01,2017-02-28,90,0,4,50,54,12,20,32,86,2,17,North Carolina,Greensboro,269666
14814,2017-2018,2017-12-01,2018-03-25,115,0,9,120,129,21,19,40,169,7,31,North Carolina,Greensboro,269666
14815,2018-2019,2018-12-01,2019-02-28,90,0,1,61,62,19,27,46,108,2,21,North Carolina,Greensboro,269666
14816,2019-2020,2019-12-01,2020-02-29,91,0,0,44,44,3,1,4,48,1,4,North Carolina,Greensboro,269666
14817,1951-1952,1951-12-01,1952-02-29,91,0,0,40,40,1,0,1,41,1,2,North Carolina,Laurinburg,300
14818,1952-1953,1952-12-01,1953-02-28,90,2,0,36,36,0,0,0,36,0,0,North Carolina,Laurinburg,300
14819,1953-1954,1953-12-01,1954-02-28,90,1,0,51,51,0,0,0,51,0,0,North Carolina,Laurinburg,300
14820,1954-1955,1954-12-01,1955-02-28,90,3,0,70,70,9,0,9,79,2,11,North Carolina,Laurinburg,300
14821,1955-1956,1955-12-01,1956-02-29,91,7,0,66,66,0,0,0,66,0,0,North Carolina,Laurinburg,300
14822,1956-1957,1956-12-01,1957-02-28,90,0,0,37,37,0,0,0,37,0,0,North Carolina,Laurinburg,300
14823,1957-1958,1957-12-01,1958-02-28,90,6,3,92,95,0,1,1,96,0,0,North Carolina,Laurinburg,300
14824,1958-1959,1958-12-01,1959-02-28,90,4,0,87,87,0,6,6,93,0,0,North Carolina,Laurinburg,300
14825,1959-1960,1959-12-01,1960-03-12,103,14,0,75,75,12,0,12,87,4,17,North Carolina,Laurinburg,300
14826,1960-1961,1960-12-01,1961-02-28,90,4,3,97,100,2,0,2,102,1,5,North Carolina,Laurinburg,300
14827,1961-1962,1961-12-01,1962-02-28,90,6,1,63,64,0,3,3,67,0,0,North Carolina,Laurinburg,300
14828,1962-1963,1962-12-01,1963-02-28,90,2,1,112,113,0,0,0,113,0,0,North Carolina,Laurinburg,300
14829,1963-1964,1963-12-01,1964-02-29,91,5,0,95,95,0,0,0,95,0,0,North Carolina,Laurinburg,300
14830,1964-1965,1964-12-01,1965-02-28,90,3,1,65,66,4,3,7,73,2,8,North Carolina,Laurinburg,300
14831,1965-1966,1965-12-01,1966-02-28,90,11,2,72,74,0,0,0,74,0,0,North Carolina,Laurinburg,300
14832,1966-1967,1966-12-01,1967-02-28,90,3,0,67,67,0,2,2,69,0,0,North Carolina,Laurinburg,300
14833,1967-1968,1967-12-01,1968-02-29,91,1,3,93,96,3,1,4,100,2,8,North Carolina,Laurinburg,300
14834,1968-1969,1968-12-01,1969-02-28,90,1,1,81,82,3,2,5,87,1,4,North Carolina,Laurinburg,300
14835,1969-1970,1969-12-01,1970-02-28,90,0,3,95,98,5,1,6,104,4,14,North Carolina,Laurinburg,300
14836,1970-1971,1970-12-01,1971-03-27,117,0,0,88,88,7,1,8,96,3,12,North Carolina,Laurinburg,300
14837,1971-1972,1971-12-01,1972-02-29,91,0,0,44,44,3,2,5,49,1,4,North Carolina,Laurinburg,300
14838,1972-1973,1972-12-01,1973-02-28,90,0,1,73,74,20,23,43,117,4,30,North Carolina,Laurinburg,300
14839,1973-1974,1973-12-01,1974-02-28,90,0,0,43,43,4,3,7,50,1,5,North Carolina,Laurinburg,300
14840,1974-1975,1974-12-01,1975-02-28,90,0,0,37,37,0,0,0,37,0,0,North Carolina,Laurinburg,300
14841,1975-1976,1975-12-01,1976-02-29,91,0,0,67,67,0,0,0,67,0,0,North Carolina,Laurinburg,300
14842,1976-1977,1976-12-01,1977-02-28,90,0,2,121,123,0,0,0,123,0,0,North Carolina,Laurinburg,300
14843,1977-1978,1977-12-01,1978-02-28,90,0,0,103,103,0,0,0,103,0,0,North Carolina,Laurinburg,300
14844,1978-1979,1978-12-01,1979-02-28,90,0,1,88,89,6,13,19,108,2,14,North Carolina,Laurinburg,300
14845,1979-1980,1979-12-01,1980-03-04,95,0,2,81,83,23,14,37,120,3,31,North Carolina,Laurinburg,300
14846,1980-1981,1980-12-01,1981-02-28,90,1,1,106,107,2,0,2,109,1,6,North Carolina,Laurinburg,300
14847,1981-1982,1981-12-01,1982-02-28,90,2,2,80,82,4,3,7,89,2,8,North Carolina,Laurinburg,300
14848,1983-1984,1983-12-01,1984-02-29,91,0,2,74,76,0,0,0,76,0,0,North Carolina,Laurinburg,300
14849,1985-1986,1985-12-01,1986-02-28,90,0,1,77,78,0,0,0,78,0,0,North Carolina,Laurinburg,300
14850,1986-1987,1986-12-01,1987-02-28,90,2,0,52,52,3,2,5,57,1,4,North Carolina,Laurinburg,300
14851,1987-1988,1987-12-01,1988-02-29,91,1,1,80,81,7,25,32,113,1,10,North Carolina,Laurinburg,300
14852,1988-1989,1988-12-01,1989-02-28,90,0,0,55,55,3,0,3,58,1,4,North Carolina,Laurinburg,300
14853,1989-1990,1989-12-01,1990-02-28,90,0,4,85,89,2,1,3,92,1,8,North Carolina,Laurinburg,300
14854,1990-1991,1990-12-01,1991-02-28,90,1,0,42,42,0,0,0,42,0,0,North Carolina,Laurinburg,300
14855,1991-1992,1991-12-01,1992-02-29,91,1,0,49,49,0,0,0,49,0,0,North Carolina,Laurinburg,300
14856,1992-1993,1992-12-01,1993-02-28,90,2,0,47,47,0,0,0,47,0,0,North Carolina,Laurinburg,300
14857,1993-1994,1993-12-01,1994-02-28,90,1,4,83,87,0,1,1,88,0,0,North Carolina,Laurinburg,300
14858,1994-1995,1994-12-01,1995-02-28,90,6,0,59,59,0,0,0,59,0,0,North Carolina,Laurinburg,300
14859,1996-1997,1996-12-01,1997-02-28,90,0,1,58,59,0,0,0,59,0,0,North Carolina,Laurinburg,300
14860,1997-1998,1997-12-01,1998-02-28,90,6,0,32,32,0,0,0,32,0,0,North Carolina,Laurinburg,300
14861,1998-1999,1998-12-01,1999-02-28,90,2,1,41,42,0,0,0,42,0,0,North Carolina,Laurinburg,300
14862,1999-2000,1999-12-01,2000-02-29,91,4,0,61,61,0,38,38,99,0,0,North Carolina,Laurinburg,300
14863,2000-2001,2000-12-01,2001-02-28,90,5,0,79,79,0,0,0,79,0,0,North Carolina,Laurinburg,300
14864,2001-2002,2001-12-01,2002-02-28,90,16,1,59,60,0,0,0,60,0,0,North Carolina,Laurinburg,300
14865,2002-2003,2002-12-01,2003-02-28,90,5,1,71,72,0,0,0,72,0,0,North Carolina,Laurinburg,300
14866,2003-2004,2003-12-01,2004-02-29,91,11,2,79,81,0,7,7,88,0,0,North Carolina,Laurinburg,300
14867,2004-2005,2004-12-01,2005-02-28,90,5,1,65,66,0,0,0,66,0,0,North Carolina,Laurinburg,300
14868,2005-2006,2005-12-01,2006-02-28,90,0,0,55,55,0,0,0,55,0,0,North Carolina,Laurinburg,300
14869,2006-2007,2006-12-01,2007-02-28,90,5,0,58,58,0,0,0,58,0,0,North Carolina,Laurinburg,300
14870,2007-2008,2007-12-01,2008-02-29,91,0,0,52,52,2,0,2,54,1,5,North Carolina,Laurinburg,300
14871,2008-2009,2008-12-01,2009-02-28,90,2,2,65,67,2,3,5,72,1,3,North Carolina,Laurinburg,300
14872,2009-2010,2009-12-01,2010-02-28,90,6,1,79,80,5,5,10,90,2,7,North Carolina,Laurinburg,300
14873,2010-2011,2010-12-01,2011-02-28,90,1,1,103,104,13,21,34,138,3,18,North Carolina,Laurinburg,300
14874,2011-2012,2011-12-01,2012-02-29,91,0,0,41,41,0,0,0,41,0,0,North Carolina,Laurinburg,300
14875,2012-2013,2012-12-01,2013-02-28,90,15,1,51,52,0,0,0,52,0,0,North Carolina,Laurinburg,300
14876,2013-2014,2013-12-01,2014-02-28,90,7,4,79,83,13,15,28,111,4,21,North Carolina,Laurinburg,300
14877,2014-2015,2014-12-01,2015-02-28,90,9,3,83,86,2,0,2,88,2,7,North Carolina,Laurinburg,300
14878,2015-2016,2015-12-01,2016-02-29,91,5,1,42,43,1,0,1,44,1,2,North Carolina,Laurinburg,300
14879,2016-2017,2016-12-01,2017-03-12,102,15,2,32,34,1,0,1,35,1,2,North Carolina,Laurinburg,300
14880,2017-2018,2017-12-01,2018-02-28,90,1,3,84,87,6,4,10,97,1,10,North Carolina,Laurinburg,300
14881,2018-2019,2018-12-01,2019-02-28,90,6,0,28,28,0,0,0,28,0,0,North Carolina,Laurinburg,300
14882,2019-2020,2019-12-01,2020-02-29,91,0,0,32,32,0,0,0,32,0,0,North Carolina,Laurinburg,300
14883,1950-1951,1950-12-01,1951-02-28,90,1,1,95,96,11,9,20,116,2,14,North Carolina,Plymouth,3878
14884,1952-1953,1952-12-01,1953-02-28,90,2,0,44,44,0,0,0,44,0,0,North Carolina,Plymouth,3878
14885,1953-1954,1953-12-01,1954-02-28,90,0,0,76,76,0,0,0,76,0,0,North Carolina,Plymouth,3878
14886,1954-1955,1954-12-01,1955-02-28,90,2,0,104,104,6,2,8,112,3,9,North Carolina,Plymouth,3878
14887,1955-1956,1955-12-01,1956-02-29,91,1,0,81,81,3,4,7,88,2,4,North Carolina,Plymouth,3878
14888,1956-1957,1956-12-01,1957-02-28,90,0,1,51,52,0,0,0,52,0,0,North Carolina,Plymouth,3878
14889,1958-1959,1958-12-01,1959-02-28,90,2,1,107,108,20,41,61,169,3,25,North Carolina,Plymouth,3878
14890,1959-1960,1959-11-29,1960-03-10,103,5,0,68,68,20,0,20,88,5,27,North Carolina,Plymouth,3878
14891,1960-1961,1960-12-01,1961-02-28,90,5,5,118,123,1,0,1,124,1,4,North Carolina,Plymouth,3878
14892,1961-1962,1961-12-01,1962-03-07,97,6,3,80,83,15,19,34,117,5,24,North Carolina,Plymouth,3878
14893,1962-1963,1962-12-01,1963-02-28,90,4,1,116,117,9,0,9,126,2,13,North Carolina,Plymouth,3878
14894,1963-1964,1963-12-01,1964-02-29,91,2,1,85,86,0,0,0,86,0,0,North Carolina,Plymouth,3878
14895,1964-1965,1964-12-01,1965-02-28,90,0,1,79,80,10,12,22,102,3,17,North Carolina,Plymouth,3878
14896,1965-1966,1965-12-01,1966-02-28,90,1,0,95,95,8,24,32,127,3,13,North Carolina,Plymouth,3878
14897,1966-1967,1966-12-01,1967-02-28,90,0,0,70,70,3,0,3,73,1,4,North Carolina,Plymouth,3878
14898,1967-1968,1967-12-01,1968-02-29,91,1,5,105,110,3,8,11,121,1,7,North Carolina,Plymouth,3878
14899,1968-1969,1968-12-01,1969-02-28,90,3,0,86,86,0,0,0,86,0,0,North Carolina,Plymouth,3878
14900,1969-1970,1969-12-01,1970-02-28,90,1,5,109,114,2,0,2,116,1,5,North Carolina,Plymouth,3878
14901,1970-1971,1970-12-01,1971-03-27,117,0,1,112,113,7,0,7,120,3,11,North Carolina,Plymouth,3878
14902,1971-1972,1971-12-01,1972-02-29,91,0,0,50,50,0,0,0,50,0,0,North Carolina,Plymouth,3878
14903,1972-1973,1972-12-01,1973-02-28,90,0,3,89,92,15,32,47,139,2,21,North Carolina,Plymouth,3878
14904,1973-1974,1973-12-01,1974-02-28,90,1,0,42,42,2,2,4,46,1,3,North Carolina,Plymouth,3878
14905,1974-1975,1974-12-01,1975-02-28,90,1,0,58,58,0,0,0,58,0,0,North Carolina,Plymouth,3878
14906,1975-1976,1975-12-01,1976-02-29,91,0,3,84,87,3,7,10,97,1,5,North Carolina,Plymouth,3878
14907,1976-1977,1976-12-01,1977-02-28,90,1,2,154,156,2,0,2,158,1,3,North Carolina,Plymouth,3878
14908,1977-1978,1977-12-01,1978-02-28,90,1,1,138,139,9,7,16,155,2,13,North Carolina,Plymouth,3878
14909,1978-1979,1978-12-01,1979-02-28,90,1,2,114,116,9,4,13,129,3,20,North Carolina,Plymouth,3878
14910,1979-1980,1979-12-01,1980-03-05,96,12,2,107,109,31,49,80,189,5,43,North Carolina,Plymouth,3878
14911,1980-1981,1980-12-01,1981-02-28,90,3,2,124,126,3,2,5,131,1,6,North Carolina,Plymouth,3878
14912,1981-1982,1981-12-01,1982-02-28,90,9,3,102,105,0,0,0,105,0,0,North Carolina,Plymouth,3878
14913,1982-1983,1982-12-01,1983-03-25,115,4,0,62,62,10,1,11,73,2,12,North Carolina,Plymouth,3878
14914,1983-1984,1983-12-01,1984-02-29,91,6,6,95,101,0,0,0,101,0,0,North Carolina,Plymouth,3878
14915,1984-1985,1984-12-01,1985-02-28,90,6,3,98,101,6,2,8,109,2,12,North Carolina,Plymouth,3878
14916,1985-1986,1985-12-01,1986-02-28,90,2,0,94,94,0,0,0,94,0,0,North Carolina,Plymouth,3878
14917,1987-1988,1987-12-01,1988-02-29,91,10,1,67,68,0,0,0,68,0,0,North Carolina,Plymouth,3878
14918,1988-1989,1988-12-01,1989-02-28,90,5,0,51,51,8,0,8,59,2,10,North Carolina,Plymouth,3878
14919,1989-1990,1989-12-01,1990-02-28,90,2,4,59,63,9,5,14,77,1,14,North Carolina,Plymouth,3878
14920,1990-1991,1990-12-01,1991-02-28,90,5,0,29,29,0,0,0,29,0,0,North Carolina,Plymouth,3878
14921,1991-1992,1991-12-01,1992-02-29,91,4,0,46,46,0,0,0,46,0,0,North Carolina,Plymouth,3878
14922,1992-1993,1992-12-01,1993-02-28,90,3,0,41,41,0,0,0,41,0,0,North Carolina,Plymouth,3878
14923,1993-1994,1993-12-01,1994-02-28,90,8,2,73,75,0,0,0,75,0,0,North Carolina,Plymouth,3878
14924,1994-1995,1994-12-01,1995-02-28,90,2,1,48,49,4,2,6,55,1,5,North Carolina,Plymouth,3878
14925,1995-1996,1995-12-01,1996-02-29,91,6,4,81,85,0,10,10,95,0,0,North Carolina,Plymouth,3878
14926,1996-1997,1996-12-01,1997-02-28,90,3,1,45,46,0,0,0,46,0,0,North Carolina,Plymouth,3878
14927,1997-1998,1997-12-01,1998-02-28,90,0,0,25,25,0,0,0,25,0,0,North Carolina,Plymouth,3878
14928,1998-1999,1998-12-01,1999-02-28,90,0,0,40,40,0,0,0,40,0,0,North Carolina,Plymouth,3878
14929,1999-2000,1999-12-01,2000-02-29,91,15,0,66,66,0,3,3,69,0,0,North Carolina,Plymouth,3878
14930,2000-2001,2000-12-01,2001-02-28,90,5,0,75,75,0,15,15,90,0,0,North Carolina,Plymouth,3878
14931,2001-2002,2001-12-01,2002-02-28,90,3,0,38,38,0,5,5,43,0,0,North Carolina,Plymouth,3878
14932,2002-2003,2002-12-01,2003-02-28,90,17,3,72,75,6,4,10,85,1,10,North Carolina,Plymouth,3878
14933,2003-2004,2003-12-01,2004-02-29,91,12,1,72,73,8,0,8,81,3,12,North Carolina,Plymouth,3878
14934,2004-2005,2004-12-01,2005-02-28,90,5,2,61,63,4,0,4,67,2,10,North Carolina,Plymouth,3878
14935,2005-2006,2005-12-01,2006-02-28,90,0,0,35,35,0,0,0,35,0,0,North Carolina,Plymouth,3878
14936,2006-2007,2006-12-01,2007-02-28,90,1,0,57,57,0,0,0,57,0,0,North Carolina,Plymouth,3878
14937,2007-2008,2007-12-01,2008-02-29,91,4,0,42,42,1,1,2,44,1,2,North Carolina,Plymouth,3878
14938,2008-2009,2008-11-21,2009-03-03,103,4,1,82,83,1,4,5,88,1,2,North Carolina,Plymouth,3878
14939,2009-2010,2009-12-01,2010-02-28,90,4,0,77,77,0,0,0,77,0,0,North Carolina,Plymouth,3878
14940,2017-2018,2017-12-01,2018-02-28,90,0,5,81,86,13,20,33,119,2,18,North Carolina,Plymouth,3878
14941,2018-2019,2018-12-01,2019-02-28,90,0,0,41,41,0,0,0,41,0,0,North Carolina,Plymouth,3878
14942,2019-2020,2019-12-01,2020-02-29,91,0,0,29,29,2,1,3,32,1,3,North Carolina,Plymouth,3878
14943,1950-1951,1950-12-01,1951-02-28,90,0,4,99,103,3,1,4,107,2,9,North Carolina,Raleigh,403892
14944,1951-1952,1951-12-01,1952-03-15,106,0,1,71,72,6,2,8,80,2,8,North Carolina,Raleigh,403892
14945,1952-1953,1952-12-01,1953-02-28,90,0,0,49,49,0,0,0,49,0,0,North Carolina,Raleigh,403892
14946,1953-1954,1953-11-06,1954-02-28,115,0,1,92,93,11,14,25,118,4,19,North Carolina,Raleigh,403892
14947,1954-1955,1954-12-01,1955-02-28,90,0,1,103,104,24,25,49,153,5,30,North Carolina,Raleigh,403892
14948,1955-1956,1955-12-01,1956-02-29,91,0,1,87,88,3,1,4,92,1,4,North Carolina,Raleigh,403892
14949,1956-1957,1956-12-01,1957-02-28,90,0,2,61,63,0,0,0,63,0,0,North Carolina,Raleigh,403892
14950,1957-1958,1957-12-01,1958-02-28,90,0,8,117,125,11,7,18,143,4,17,North Carolina,Raleigh,403892
14951,1958-1959,1958-12-01,1959-02-28,90,0,6,121,127,19,32,51,178,4,31,North Carolina,Raleigh,403892
14952,1959-1960,1959-12-01,1960-03-17,108,0,5,112,117,25,63,88,205,4,35,North Carolina,Raleigh,403892
14953,1960-1961,1960-12-01,1961-02-28,90,0,8,124,132,7,7,14,146,4,20,North Carolina,Raleigh,403892
14954,1961-1962,1961-12-01,1962-03-09,99,0,3,109,112,22,17,39,151,8,34,North Carolina,Raleigh,403892
14955,1962-1963,1962-11-25,1963-02-28,96,0,7,147,154,12,9,21,175,3,19,North Carolina,Raleigh,403892
14956,1963-1964,1963-12-01,1964-02-29,91,0,3,115,118,8,1,9,127,5,16,North Carolina,Raleigh,403892
14957,1964-1965,1964-11-30,1965-02-28,91,0,3,116,119,17,25,42,161,7,38,North Carolina,Raleigh,403892
14958,1965-1966,1965-12-01,1966-02-28,90,3,5,103,108,18,44,62,170,6,32,North Carolina,Raleigh,403892
14959,1966-1967,1966-12-01,1967-02-28,90,0,1,84,85,16,12,28,113,3,21,North Carolina,Raleigh,403892
14960,1967-1968,1967-12-01,1968-03-01,92,0,4,122,126,9,9,18,144,5,20,North Carolina,Raleigh,403892
14961,1968-1969,1968-11-12,1969-03-04,113,0,1,126,127,18,13,31,158,5,23,North Carolina,Raleigh,403892
14962,1969-1970,1969-12-01,1970-02-28,90,0,10,163,173,4,2,6,179,2,10,North Carolina,Raleigh,403892
14963,1970-1971,1970-12-01,1971-03-27,117,0,8,127,135,10,5,15,150,4,18,North Carolina,Raleigh,403892
14964,1971-1972,1971-12-01,1972-03-26,117,0,4,78,82,10,6,16,98,5,16,North Carolina,Raleigh,403892
14965,1972-1973,1972-12-01,1973-03-21,111,0,7,97,104,15,34,49,153,4,26,North Carolina,Raleigh,403892
14966,1973-1974,1973-12-01,1974-03-25,115,0,3,63,66,7,8,15,81,3,13,North Carolina,Raleigh,403892
14967,1974-1975,1974-12-01,1975-03-10,100,0,0,82,82,1,0,1,83,1,2,North Carolina,Raleigh,403892
14968,1975-1976,1975-11-23,1976-02-29,99,0,2,95,97,4,0,4,101,2,6,North Carolina,Raleigh,403892
14969,1976-1977,1976-11-30,1977-02-28,91,0,8,209,217,5,3,8,225,3,14,North Carolina,Raleigh,403892
14970,1977-1978,1977-12-01,1978-03-03,93,0,2,155,157,16,16,32,189,7,29,North Carolina,Raleigh,403892
14971,1978-1979,1978-12-01,1979-02-28,90,0,4,111,115,24,36,60,175,6,42,North Carolina,Raleigh,403892
14972,1979-1980,1979-12-01,1980-03-05,96,0,6,112,118,28,27,55,173,8,51,North Carolina,Raleigh,403892
14973,1980-1981,1980-12-01,1981-02-28,90,0,7,147,154,7,7,14,168,2,14,North Carolina,Raleigh,403892
14974,1981-1982,1981-12-01,1982-02-28,90,0,8,84,92,10,20,30,122,3,16,North Carolina,Raleigh,403892
14975,1982-1983,1982-12-01,1983-04-18,139,0,1,83,84,17,5,22,106,5,22,North Carolina,Raleigh,403892
14976,1983-1984,1983-12-01,1984-02-29,91,0,7,104,111,9,4,13,124,1,11,North Carolina,Raleigh,403892
14977,1984-1985,1984-12-01,1985-02-28,90,0,6,102,108,5,6,11,119,2,13,North Carolina,Raleigh,403892
14978,1985-1986,1985-12-01,1986-02-28,90,0,4,103,107,3,1,4,111,3,11,North Carolina,Raleigh,403892
14979,1986-1987,1986-12-01,1987-02-28,90,0,3,82,85,16,27,43,128,5,27,North Carolina,Raleigh,403892
14980,1987-1988,1987-11-11,1988-02-29,111,0,6,112,118,12,29,41,159,3,22,North Carolina,Raleigh,403892
14981,1988-1989,1988-12-01,1989-04-11,132,0,3,76,79,17,19,36,115,7,29,North Carolina,Raleigh,403892
14982,1989-1990,1989-12-01,1990-02-28,90,0,9,73,82,4,4,8,90,3,8,North Carolina,Raleigh,403892
14983,1990-1991,1990-12-01,1991-02-28,90,0,0,53,53,0,0,0,53,0,0,North Carolina,Raleigh,403892
14984,1991-1992,1991-12-01,1992-02-29,91,0,0,55,55,0,0,0,55,0,0,North Carolina,Raleigh,403892
14985,1992-1993,1992-12-01,1993-03-14,104,0,0,67,67,5,1,6,73,5,11,North Carolina,Raleigh,403892
14986,1993-1994,1993-12-01,1994-03-03,93,0,9,107,116,7,4,11,127,5,14,North Carolina,Raleigh,403892
14987,1994-1995,1994-12-01,1995-02-28,90,0,1,62,63,5,1,6,69,4,12,North Carolina,Raleigh,403892
14988,1995-1996,1995-12-01,1996-03-08,99,0,11,101,112,19,35,54,166,7,41,North Carolina,Raleigh,403892
14989,1996-1997,1996-12-01,1997-02-28,90,0,2,68,70,1,0,1,71,1,3,North Carolina,Raleigh,403892
14990,1997-1998,1997-12-01,1998-02-28,90,0,0,50,50,5,0,5,55,3,8,North Carolina,Raleigh,403892
14991,1998-1999,1998-12-01,1999-02-28,90,0,1,59,60,0,0,0,60,0,0,North Carolina,Raleigh,403892
14992,1999-2000,1999-12-01,2000-02-29,91,0,5,95,100,33,66,99,199,5,43,North Carolina,Raleigh,403892
14993,2000-2001,2000-11-19,2001-02-28,102,0,0,102,102,5,2,7,109,3,8,North Carolina,Raleigh,403892
14994,2001-2002,2001-12-01,2002-02-28,90,0,2,67,69,15,24,39,108,2,20,North Carolina,Raleigh,403892
14995,2002-2003,2002-12-01,2003-02-28,90,0,4,89,93,11,10,21,114,5,25,North Carolina,Raleigh,403892
14996,2003-2004,2003-12-01,2004-02-29,91,0,4,95,99,21,12,33,132,7,32,North Carolina,Raleigh,403892
14997,2004-2005,2004-12-01,2005-03-17,107,0,3,90,93,2,0,2,95,2,7,North Carolina,Raleigh,403892
14998,2005-2006,2005-12-01,2006-02-28,90,0,1,60,61,0,0,0,61,0,0,North Carolina,Raleigh,403892
14999,2006-2007,2006-12-01,2007-02-28,90,0,0,65,65,3,0,3,68,2,5,North Carolina,Raleigh,403892
15000,2007-2008,2007-12-01,2008-02-29,91,0,0,51,51,1,1,2,53,1,1,North Carolina,Raleigh,403892
15001,2008-2009,2008-11-21,2009-03-03,103,0,1,78,79,9,8,17,96,3,14,North Carolina,Raleigh,403892
15002,2009-2010,2009-12-01,2010-03-03,93,0,3,100,103,14,14,28,131,8,23,North Carolina,Raleigh,403892
15003,2010-2011,2010-12-01,2011-02-28,90,0,2,95,97,14,10,24,121,6,20,North Carolina,Raleigh,403892
15004,2011-2012,2011-12-01,2012-02-29,91,0,0,42,42,1,1,2,44,1,1,North Carolina,Raleigh,403892
15005,2012-2013,2012-12-01,2013-02-28,90,0,1,47,48,4,1,5,53,4,9,North Carolina,Raleigh,403892
15006,2013-2014,2013-12-01,2014-03-03,93,0,5,92,97,10,4,14,111,6,25,North Carolina,Raleigh,403892
15007,2014-2015,2014-12-01,2015-03-01,91,0,7,97,104,11,11,22,126,6,29,North Carolina,Raleigh,403892
15008,2015-2016,2015-12-01,2016-02-29,91,0,5,56,61,3,3,6,67,2,7,North Carolina,Raleigh,403892
15009,2016-2017,2016-12-01,2017-03-12,102,0,4,48,52,2,3,5,57,2,6,North Carolina,Raleigh,403892
15010,2017-2018,2017-12-01,2018-03-24,114,0,8,106,114,13,12,25,139,6,28,North Carolina,Raleigh,403892
15011,2018-2019,2018-12-01,2019-02-28,90,0,1,49,50,12,7,19,69,2,14,North Carolina,Raleigh,403892
15012,2019-2020,2019-12-01,2020-02-29,91,0,0,36,36,3,2,5,41,1,3,North Carolina,Raleigh,403892
15013,1950-1951,1950-12-01,1951-02-28,90,0,1,31,32,5,4,9,41,2,9,North Carolina,Wilmington,106476
15014,1951-1952,1951-12-01,1952-02-29,91,0,0,28,28,0,0,0,28,0,0,North Carolina,Wilmington,106476
15015,1952-1953,1952-12-01,1953-02-28,90,0,0,19,19,0,0,0,19,0,0,North Carolina,Wilmington,106476
15016,1953-1954,1953-12-01,1954-02-28,90,1,0,28,28,0,0,0,28,0,0,North Carolina,Wilmington,106476
15017,1954-1955,1954-12-01,1955-02-28,90,0,0,54,54,1,0,1,55,1,3,North Carolina,Wilmington,106476
15018,1955-1956,1955-12-01,1956-02-29,91,0,0,47,47,1,1,2,49,1,2,North Carolina,Wilmington,106476
15019,1956-1957,1956-12-01,1957-02-28,90,0,0,29,29,0,0,0,29,0,0,North Carolina,Wilmington,106476
15020,1957-1958,1957-12-01,1958-02-28,90,0,3,70,73,5,3,8,81,2,7,North Carolina,Wilmington,106476
15021,1958-1959,1958-12-01,1959-02-28,90,0,0,59,59,5,5,10,69,2,8,North Carolina,Wilmington,106476
15022,1959-1960,1959-12-01,1960-03-12,103,1,1,49,50,8,4,12,62,3,12,North Carolina,Wilmington,106476
15023,1960-1961,1960-12-01,1961-02-28,90,0,2,64,66,0,0,0,66,0,0,North Carolina,Wilmington,106476
15024,1961-1962,1961-12-01,1962-03-07,97,0,2,50,52,6,2,8,60,4,12,North Carolina,Wilmington,106476
15025,1962-1963,1962-12-01,1963-02-28,90,0,2,80,82,3,1,4,86,3,10,North Carolina,Wilmington,106476
15026,1963-1964,1963-12-01,1964-02-29,91,0,0,46,46,0,0,0,46,0,0,North Carolina,Wilmington,106476
15027,1964-1965,1964-12-01,1965-03-06,96,0,1,48,49,6,3,9,58,4,11,North Carolina,Wilmington,106476
15028,1965-1966,1965-12-01,1966-02-28,90,0,1,47,48,0,0,0,48,0,0,North Carolina,Wilmington,106476
15029,1966-1967,1966-12-01,1967-02-28,90,0,1,35,36,0,0,0,36,0,0,North Carolina,Wilmington,106476
15030,1967-1968,1967-12-01,1968-02-29,91,0,1,60,61,6,3,9,70,3,9,North Carolina,Wilmington,106476
15031,1968-1969,1968-12-01,1969-02-28,90,0,1,59,60,2,0,2,62,2,4,North Carolina,Wilmington,106476
15032,1969-1970,1969-12-01,1970-02-28,90,0,4,70,74,4,2,6,80,3,10,North Carolina,Wilmington,106476
15033,1970-1971,1970-12-01,1971-02-28,90,0,0,41,41,6,2,8,49,1,7,North Carolina,Wilmington,106476
15034,1971-1972,1971-12-01,1972-02-29,91,0,0,24,24,0,0,0,24,0,0,North Carolina,Wilmington,106476
15035,1972-1973,1972-12-01,1973-02-28,90,0,0,43,43,19,29,48,91,4,23,North Carolina,Wilmington,106476
15036,1973-1974,1973-12-01,1974-02-28,90,0,0,24,24,1,0,1,25,1,2,North Carolina,Wilmington,106476
15037,1974-1975,1974-12-01,1975-02-28,90,0,0,17,17,0,0,0,17,0,0,North Carolina,Wilmington,106476
15038,1975-1976,1975-12-01,1976-02-29,91,0,1,41,42,0,0,0,42,0,0,North Carolina,Wilmington,106476
15039,1976-1977,1976-12-01,1977-02-28,90,0,2,89,91,2,0,2,93,2,5,North Carolina,Wilmington,106476
15040,1977-1978,1977-12-01,1978-02-28,90,0,0,74,74,0,0,0,74,0,0,North Carolina,Wilmington,106476
15041,1978-1979,1978-12-01,1979-02-28,90,0,0,59,59,1,0,1,60,1,3,North Carolina,Wilmington,106476
15042,1979-1980,1979-12-01,1980-03-05,96,0,2,68,70,10,15,25,95,4,21,North Carolina,Wilmington,106476
15043,1980-1981,1980-12-01,1981-02-28,90,0,1,95,96,2,0,2,98,1,4,North Carolina,Wilmington,106476
15044,1981-1982,1981-12-01,1982-02-28,90,0,1,68,69,1,0,1,70,1,2,North Carolina,Wilmington,106476
15045,1982-1983,1982-12-01,1983-03-25,115,0,0,41,41,5,4,9,50,2,7,North Carolina,Wilmington,106476
15046,1983-1984,1983-12-01,1984-02-29,91,0,1,59,60,0,0,0,60,0,0,North Carolina,Wilmington,106476
15047,1984-1985,1984-12-01,1985-02-28,90,0,1,41,42,0,0,0,42,0,0,North Carolina,Wilmington,106476
15048,1985-1986,1985-12-01,1986-02-28,90,0,1,49,50,0,0,0,50,0,0,North Carolina,Wilmington,106476
15049,1986-1987,1986-12-01,1987-02-28,90,0,0,30,30,0,0,0,30,0,0,North Carolina,Wilmington,106476
15050,1987-1988,1987-12-01,1988-02-29,91,0,0,53,53,8,4,12,65,2,13,North Carolina,Wilmington,106476
15051,1988-1989,1988-12-01,1989-02-28,90,0,0,34,34,4,2,6,40,3,9,North Carolina,Wilmington,106476
15052,1989-1990,1989-12-01,1990-02-28,90,0,4,51,55,21,41,62,117,3,34,North Carolina,Wilmington,106476
15053,1990-1991,1990-12-01,1991-02-28,90,0,0,20,20,0,0,0,20,0,0,North Carolina,Wilmington,106476
15054,1991-1992,1991-12-01,1992-02-29,91,0,0,30,30,2,1,3,33,1,3,North Carolina,Wilmington,106476
15055,1992-1993,1992-12-01,1993-02-28,90,0,0,23,23,0,0,0,23,0,0,North Carolina,Wilmington,106476
15056,1993-1994,1993-12-01,1994-02-28,90,0,2,51,53,1,0,1,54,1,2,North Carolina,Wilmington,106476
15057,1994-1995,1994-12-01,1995-02-28,90,0,0,29,29,0,0,0,29,0,0,North Carolina,Wilmington,106476
15058,1995-1996,1995-12-01,1996-02-29,91,4,2,68,70,2,0,2,72,2,7,North Carolina,Wilmington,106476
15059,1996-1997,1996-12-01,1997-02-28,90,0,0,33,33,2,0,2,35,1,3,North Carolina,Wilmington,106476
15060,1997-1998,1997-12-01,1998-02-28,90,0,0,20,20,0,0,0,20,0,0,North Carolina,Wilmington,106476
15061,1998-1999,1998-12-01,1999-02-28,90,0,0,23,23,0,0,0,23,0,0,North Carolina,Wilmington,106476
15062,1999-2000,1999-12-01,2000-02-29,91,0,0,33,33,9,6,15,48,2,11,North Carolina,Wilmington,106476
15063,2000-2001,2000-12-01,2001-02-28,90,0,0,57,57,1,0,1,58,1,2,North Carolina,Wilmington,106476
15064,2001-2002,2001-12-01,2002-02-28,90,0,0,29,29,3,2,5,34,2,5,North Carolina,Wilmington,106476
15065,2002-2003,2002-12-01,2003-02-28,90,0,1,51,52,4,1,5,57,1,8,North Carolina,Wilmington,106476
15066,2003-2004,2003-12-01,2004-02-29,91,0,0,59,59,0,0,0,59,0,0,North Carolina,Wilmington,106476
15067,2004-2005,2004-12-01,2005-02-28,90,0,1,54,55,0,0,0,55,0,0,North Carolina,Wilmington,106476
15068,2005-2006,2005-12-01,2006-02-28,90,0,0,35,35,0,0,0,35,0,0,North Carolina,Wilmington,106476
15069,2006-2007,2006-12-01,2007-02-28,90,0,0,37,37,0,0,0,37,0,0,North Carolina,Wilmington,106476
15070,2007-2008,2007-12-01,2008-02-29,91,0,0,29,29,0,0,0,29,0,0,North Carolina,Wilmington,106476
15071,2008-2009,2008-12-01,2009-02-28,90,0,1,46,47,2,1,3,50,2,4,North Carolina,Wilmington,106476
15072,2009-2010,2009-12-01,2010-02-28,90,0,0,63,63,5,3,8,71,2,7,North Carolina,Wilmington,106476
15073,2010-2011,2010-12-01,2011-02-28,90,0,2,70,72,6,5,11,83,3,12,North Carolina,Wilmington,106476
15074,2011-2012,2011-12-01,2012-02-29,91,0,0,20,20,0,0,0,20,0,0,North Carolina,Wilmington,106476
15075,2012-2013,2012-12-01,2013-02-28,90,0,0,26,26,0,0,0,26,0,0,North Carolina,Wilmington,106476
15076,2013-2014,2013-12-01,2014-02-28,90,0,2,47,49,2,3,5,54,2,7,North Carolina,Wilmington,106476
15077,2014-2015,2014-12-01,2015-02-28,90,0,3,57,60,1,0,1,61,1,3,North Carolina,Wilmington,106476
15078,2015-2016,2015-12-01,2016-02-29,91,0,0,31,31,0,0,0,31,0,0,North Carolina,Wilmington,106476
15079,2016-2017,2016-12-01,2017-03-12,102,0,1,33,34,2,0,2,36,1,3,North Carolina,Wilmington,106476
15080,2017-2018,2017-12-01,2018-02-28,90,0,2,52,54,5,14,19,73,2,10,North Carolina,Wilmington,106476
15081,2018-2019,2018-12-01,2019-02-28,90,0,0,30,30,0,0,0,30,0,0,North Carolina,Wilmington,106476
15082,2019-2020,2019-12-01,2020-02-29,91,0,0,14,14,0,0,0,14,0,0,North Carolina,Wilmington,106476
15083,1950-1951,1950-10-01,1951-04-20,202,1,371,1006,1377,80,549,629,2006,48,470,North Dakota,Bismarck,61272
15084,1951-1952,1951-10-29,1952-04-04,159,0,343,930,1273,82,654,736,2009,50,512,North Dakota,Bismarck,61272
15085,1952-1953,1952-11-24,1953-05-11,169,0,136,610,746,67,123,190,936,41,285,North Dakota,Bismarck,61272
15086,1953-1954,1953-11-07,1954-04-04,149,1,186,630,816,48,129,177,993,33,266,North Dakota,Bismarck,61272
15087,1954-1955,1954-10-25,1955-04-05,163,0,185,678,863,42,122,164,1027,36,296,North Dakota,Bismarck,61272
15088,1955-1956,1955-10-27,1956-04-27,184,0,377,995,1372,69,602,671,2043,34,353,North Dakota,Bismarck,61272
15089,1956-1957,1956-11-02,1957-04-11,161,0,239,753,992,50,128,178,1170,41,379,North Dakota,Bismarck,61272
15090,1957-1958,1957-10-24,1958-05-01,190,0,174,623,797,44,175,219,1016,28,186,North Dakota,Bismarck,61272
15091,1958-1959,1958-11-15,1959-04-18,155,0,301,791,1092,63,385,448,1540,34,330,North Dakota,Bismarck,61272
15092,1959-1960,1959-10-08,1960-05-03,209,0,249,715,964,78,248,326,1290,43,326,North Dakota,Bismarck,61272
15093,1960-1961,1960-11-09,1961-04-27,170,0,155,596,751,57,133,190,941,30,226,North Dakota,Bismarck,61272
15094,1961-1962,1961-11-04,1962-04-11,159,1,280,811,1091,47,219,266,1357,36,331,North Dakota,Bismarck,61272
15095,1962-1963,1962-11-14,1963-04-19,157,0,211,673,884,40,92,132,1016,32,221,North Dakota,Bismarck,61272
15096,1963-1964,1963-11-13,1964-04-07,147,0,178,742,920,45,143,188,1108,27,262,North Dakota,Bismarck,61272
15097,1964-1965,1964-10-28,1965-05-26,211,0,393,978,1371,84,495,579,1950,44,468,North Dakota,Bismarck,61272
15098,1965-1966,1965-09-16,1966-05-11,238,0,272,843,1115,70,234,304,1419,31,285,North Dakota,Bismarck,61272
15099,1966-1967,1966-10-21,1967-05-11,203,0,239,901,1140,100,315,415,1555,52,501,North Dakota,Bismarck,61272
15100,1967-1968,1967-10-27,1968-05-18,205,0,247,835,1082,60,216,276,1358,39,340,North Dakota,Bismarck,61272
15101,1968-1969,1968-11-06,1969-04-27,173,0,323,826,1149,86,654,740,1889,48,457,North Dakota,Bismarck,61272
15102,1969-1970,1969-10-11,1970-04-23,195,0,246,838,1084,95,471,566,1650,58,489,North Dakota,Bismarck,61272
15103,1970-1971,1970-10-27,1971-04-27,183,0,297,815,1112,72,381,453,1565,47,347,North Dakota,Bismarck,61272
15104,1971-1972,1971-10-28,1972-04-11,167,1,314,816,1130,87,394,481,1611,54,519,North Dakota,Bismarck,61272
15105,1972-1973,1972-10-17,1973-04-15,181,0,207,651,858,38,176,214,1072,24,182,North Dakota,Bismarck,61272
15106,1973-1974,1973-10-11,1974-04-13,185,0,274,858,1132,58,388,446,1578,44,376,North Dakota,Bismarck,61272
15107,1974-1975,1974-11-01,1975-04-16,167,0,205,764,969,91,287,378,1347,41,374,North Dakota,Bismarck,61272
15108,1975-1976,1975-11-11,1976-04-03,145,0,165,638,803,47,242,289,1092,32,227,North Dakota,Bismarck,61272
15109,1976-1977,1976-10-17,1977-04-03,169,0,242,796,1038,59,198,257,1295,43,429,North Dakota,Bismarck,61272
15110,1977-1978,1977-10-07,1978-04-17,193,3,394,854,1248,105,708,813,2061,53,517,North Dakota,Bismarck,61272
15111,1978-1979,1978-11-10,1979-05-10,182,0,426,1024,1450,130,856,986,2436,62,651,North Dakota,Bismarck,61272
15112,1979-1980,1979-11-01,1980-04-08,160,0,190,733,923,54,137,191,1114,39,273,North Dakota,Bismarck,61272
15113,1980-1981,1980-10-16,1981-03-01,137,0,127,482,609,29,41,70,679,26,207,North Dakota,Bismarck,61272
15114,1981-1982,1981-10-21,1982-04-08,170,0,349,847,1196,128,576,704,1900,62,664,North Dakota,Bismarck,61272
15115,1982-1983,1982-10-05,1983-04-16,194,0,110,502,612,60,98,158,770,35,218,North Dakota,Bismarck,61272
15116,1983-1984,1983-11-11,1984-05-02,174,0,262,701,963,103,253,356,1319,49,447,North Dakota,Bismarck,61272
15117,1984-1985,1984-09-23,1985-04-16,206,0,271,833,1104,68,249,317,1421,39,371,North Dakota,Bismarck,61272
15118,1985-1986,1985-10-07,1986-04-17,193,0,279,749,1028,103,435,538,1566,54,583,North Dakota,Bismarck,61272
15119,1986-1987,1986-11-07,1987-04-10,155,0,113,518,631,106,361,467,1098,44,326,North Dakota,Bismarck,61272
15120,1987-1988,1987-10-19,1988-04-26,191,0,170,734,904,53,135,188,1092,29,304,North Dakota,Bismarck,61272
15121,1988-1989,1988-10-27,1989-04-29,185,0,255,754,1009,80,298,378,1387,45,452,North Dakota,Bismarck,61272
15122,1989-1990,1989-10-31,1990-05-01,183,0,175,685,860,55,83,138,998,40,272,North Dakota,Bismarck,61272
15123,1990-1991,1990-10-17,1991-05-04,200,0,201,738,939,73,130,203,1142,43,393,North Dakota,Bismarck,61272
15124,1991-1992,1991-10-23,1992-04-24,185,0,107,542,649,94,166,260,909,40,323,North Dakota,Bismarck,61272
15125,1992-1993,1992-10-15,1993-03-31,168,0,262,727,989,79,297,376,1365,52,430,North Dakota,Bismarck,61272
15126,1993-1994,1993-10-28,1994-04-29,184,0,311,830,1141,152,746,898,2039,72,765,North Dakota,Bismarck,61272
15127,1994-1995,1994-11-17,1995-04-11,146,0,229,665,894,107,546,653,1547,46,432,North Dakota,Bismarck,61272
15128,1995-1996,1995-10-30,1996-04-26,180,0,334,881,1215,123,433,556,1771,50,469,North Dakota,Bismarck,61272
15129,1996-1997,1996-10-20,1997-04-17,180,0,363,911,1274,152,737,889,2163,59,623,North Dakota,Bismarck,61272
15130,1997-1998,1997-10-13,1998-03-18,157,0,157,502,659,48,123,171,830,35,239,North Dakota,Bismarck,61272
15131,1998-1999,1998-11-05,1999-04-06,153,0,172,562,734,103,377,480,1214,47,452,North Dakota,Bismarck,61272
15132,1999-2000,1999-12-01,2000-04-15,137,0,113,495,608,54,142,196,804,35,298,North Dakota,Bismarck,61272
15133,2000-2001,2000-11-06,2001-04-21,167,0,259,763,1022,81,426,507,1529,55,470,North Dakota,Bismarck,61272
15134,2001-2002,2001-10-24,2002-05-09,198,0,163,643,806,66,140,206,1012,45,314,North Dakota,Bismarck,61272
15135,2002-2003,2002-10-21,2003-04-17,179,0,211,706,917,62,158,220,1137,46,399,North Dakota,Bismarck,61272
15136,2003-2004,2003-10-29,2004-05-12,197,0,211,679,890,77,356,433,1323,44,415,North Dakota,Bismarck,61272
15137,2004-2005,2004-10-17,2005-05-01,197,0,154,635,789,37,87,124,913,30,232,North Dakota,Bismarck,61272
15138,2005-2006,2005-11-03,2006-03-31,149,0,117,460,577,59,126,185,762,42,237,North Dakota,Bismarck,61272
15139,2006-2007,2006-10-17,2007-04-13,179,0,183,714,897,73,331,404,1301,35,304,North Dakota,Bismarck,61272
15140,2007-2008,2007-11-17,2008-05-10,176,0,180,744,924,42,139,181,1105,33,282,North Dakota,Bismarck,61272
15141,2008-2009,2008-11-06,2009-04-24,170,0,291,815,1106,153,743,896,2002,62,624,North Dakota,Bismarck,61272
15142,2009-2010,2009-10-09,2010-05-07,211,0,273,675,948,91,696,787,1735,44,365,North Dakota,Bismarck,61272
15143,2010-2011,2010-10-26,2011-05-01,188,0,322,798,1120,137,748,885,2005,77,733,North Dakota,Bismarck,61272
15144,2011-2012,2011-11-16,2012-03-07,113,0,84,443,527,28,60,88,615,20,130,North Dakota,Bismarck,61272
15145,2012-2013,2012-11-02,2013-04-24,174,0,194,693,887,96,405,501,1388,49,361,North Dakota,Bismarck,61272
15146,2013-2014,2013-10-04,2014-04-29,208,0,278,853,1131,69,266,335,1466,41,416,North Dakota,Bismarck,61272
15147,2014-2015,2014-11-09,2015-05-17,190,0,199,670,869,48,165,213,1082,36,287,North Dakota,Bismarck,61272
15148,2015-2016,2015-10-28,2016-04-01,157,0,111,458,569,47,210,257,826,33,184,North Dakota,Bismarck,61272
15149,2016-2017,2016-11-24,2017-03-21,118,0,227,576,803,105,681,786,1589,37,397,North Dakota,Bismarck,61272
15150,2017-2018,2017-11-03,2018-04-13,162,0,227,759,986,72,246,318,1304,34,317,North Dakota,Bismarck,61272
15151,2018-2019,2018-10-04,2019-04-28,207,0,298,778,1076,99,421,520,1596,48,498,North Dakota,Bismarck,61272
15152,2019-2020,2019-10-10,2020-04-13,187,0,167,597,764,93,351,444,1208,43,348,North Dakota,Bismarck,61272
15153,1965-1966,1965-11-08,1966-05-11,185,16,207,678,885,31,149,180,1065,13,105,North Dakota,Bowman,1650
15154,1967-1968,1967-11-03,1968-04-22,172,10,178,605,783,28,129,157,940,11,90,North Dakota,Bowman,1650
15155,1972-1973,1972-09-26,1973-04-09,196,12,199,556,755,50,168,218,973,18,160,North Dakota,Bowman,1650
15156,1975-1976,1975-11-12,1976-04-03,144,4,143,543,686,80,445,525,1211,32,296,North Dakota,Bowman,1650
15157,1976-1977,1976-11-11,1977-04-09,150,2,167,633,800,88,506,594,1394,36,316,North Dakota,Bowman,1650
15158,1977-1978,1977-10-07,1978-04-18,194,16,356,798,1154,142,1573,1715,2869,44,505,North Dakota,Bowman,1650
15159,1978-1979,1978-11-09,1979-04-27,170,4,367,895,1262,140,1436,1576,2838,55,547,North Dakota,Bowman,1650
15160,1979-1980,1979-10-21,1980-04-01,164,1,164,641,805,65,112,177,982,39,304,North Dakota,Bowman,1650
15161,1980-1981,1980-10-16,1981-02-28,136,0,105,424,529,42,102,144,673,22,160,North Dakota,Bowman,1650
15162,1988-1989,1988-10-27,1989-05-01,187,9,221,751,972,126,438,564,1536,44,460,North Dakota,Bowman,1650
15163,1989-1990,1989-10-29,1990-05-09,193,2,142,613,755,88,245,333,1088,35,302,North Dakota,Bowman,1650
15164,1990-1991,1990-10-17,1991-05-04,200,0,191,659,850,85,255,340,1190,35,356,North Dakota,Bowman,1650
15165,1991-1992,1991-10-23,1992-04-21,182,1,68,528,596,51,124,175,771,16,144,North Dakota,Bowman,1650
15166,1992-1993,1992-10-15,1993-04-21,189,5,218,700,918,111,462,573,1491,35,344,North Dakota,Bowman,1650
15167,1993-1994,1993-10-30,1994-04-29,182,2,211,749,960,174,831,1005,1965,54,595,North Dakota,Bowman,1650
15168,1994-1995,1994-11-18,1995-04-15,149,1,141,579,720,76,323,399,1119,23,214,North Dakota,Bowman,1650
15169,1995-1996,1995-10-30,1996-05-11,195,1,245,807,1052,119,448,567,1619,40,393,North Dakota,Bowman,1650
15170,1996-1997,1996-10-21,1997-04-29,191,3,282,815,1097,130,920,1050,2147,34,405,North Dakota,Bowman,1650
15171,1997-1998,1997-10-13,1998-04-10,180,6,115,571,686,72,333,405,1091,22,206,North Dakota,Bowman,1650
15172,1998-1999,1998-11-04,1999-05-11,189,2,113,497,610,120,409,529,1139,42,372,North Dakota,Bowman,1650
15173,1999-2000,1999-11-19,2000-05-13,177,11,51,457,508,46,135,181,689,18,138,North Dakota,Bowman,1650
15174,2001-2002,2001-11-25,2002-05-08,165,4,139,609,748,78,230,308,1056,26,236,North Dakota,Bowman,1650
15175,2002-2003,2002-10-21,2003-04-17,179,8,138,606,744,74,283,357,1101,31,278,North Dakota,Bowman,1650
15176,2003-2004,2003-10-29,2004-03-17,141,1,193,578,771,89,439,528,1299,40,380,North Dakota,Bowman,1650
15177,2004-2005,2004-10-30,2005-05-13,196,0,121,537,658,38,70,108,766,23,165,North Dakota,Bowman,1650
15178,2005-2006,2005-10-05,2006-04-21,199,0,122,488,610,91,221,312,922,29,216,North Dakota,Bowman,1650
15179,2006-2007,2006-10-11,2007-04-12,184,0,142,640,782,55,125,180,962,30,241,North Dakota,Bowman,1650
15180,2007-2008,2007-11-20,2008-05-10,173,0,135,672,807,37,77,114,921,31,211,North Dakota,Bowman,1650
15181,2008-2009,2008-10-12,2009-06-07,239,0,238,741,979,122,640,762,1741,47,434,North Dakota,Bowman,1650
15182,2009-2010,2009-10-05,2010-05-08,216,1,258,691,949,83,797,880,1829,39,371,North Dakota,Bowman,1650
15183,2010-2011,2010-09-18,2011-05-02,227,2,293,765,1058,127,763,890,1948,52,506,North Dakota,Bowman,1650
15184,2011-2012,2011-11-19,2012-03-07,110,0,93,433,526,23,85,108,634,17,122,North Dakota,Bowman,1650
15185,2012-2013,2012-10-04,2013-04-21,200,0,123,634,757,55,179,234,991,35,251,North Dakota,Bowman,1650
15186,2013-2014,2013-10-05,2014-04-30,208,0,250,787,1037,93,491,584,1621,40,353,North Dakota,Bowman,1650
15187,2014-2015,2014-11-10,2015-04-09,151,0,177,570,747,49,201,250,997,25,208,North Dakota,Bowman,1650
15188,2015-2016,2015-11-20,2016-05-13,176,2,88,450,538,39,98,137,675,21,152,North Dakota,Bowman,1650
15189,2016-2017,2016-11-18,2017-04-26,160,0,265,600,865,39,469,508,1373,27,278,North Dakota,Bowman,1650
15190,2017-2018,2017-10-31,2018-04-24,176,1,271,770,1041,67,451,518,1559,40,365,North Dakota,Bowman,1650
15191,2018-2019,2018-10-01,2019-05-19,231,2,280,760,1040,101,538,639,1679,53,471,North Dakota,Bowman,1650
15192,2019-2020,2019-10-03,2020-04-15,196,2,129,601,730,62,293,355,1085,43,276,North Dakota,Bowman,1650
15193,1954-1955,1954-11-01,1955-04-01,152,18,325,787,1112,55,470,525,1637,30,312,North Dakota,Cavalier,1302
15194,1957-1958,1957-11-07,1958-04-29,174,12,213,664,877,26,66,92,969,20,127,North Dakota,Cavalier,1302
15195,1959-1960,1959-10-09,1960-04-26,201,8,313,853,1166,88,579,667,1833,38,337,North Dakota,Cavalier,1302
15196,1960-1961,1960-10-19,1961-04-27,191,2,257,789,1046,46,538,584,1630,26,232,North Dakota,Cavalier,1302
15197,1961-1962,1961-11-03,1962-05-07,186,13,417,971,1388,86,873,959,2347,36,397,North Dakota,Cavalier,1302
15198,1962-1963,1962-11-06,1963-04-03,149,6,298,779,1077,31,150,181,1258,20,207,North Dakota,Cavalier,1302
15199,1963-1964,1963-11-13,1964-04-15,155,0,276,793,1069,68,436,504,1573,25,224,North Dakota,Cavalier,1302
15200,1966-1967,1966-11-01,1967-05-04,185,15,370,1009,1379,61,687,748,2127,16,176,North Dakota,Cavalier,1302
15201,1968-1969,1968-11-06,1969-04-08,154,16,417,850,1267,46,639,685,1952,25,278,North Dakota,Cavalier,1302
15202,1971-1972,1971-10-29,1972-04-17,172,4,408,936,1344,69,441,510,1854,28,343,North Dakota,Cavalier,1302
15203,1972-1973,1972-09-26,1973-04-07,194,1,284,729,1013,42,391,433,1446,16,126,North Dakota,Cavalier,1302
15204,1974-1975,1974-10-06,1975-04-19,196,13,269,796,1065,63,378,441,1506,19,170,North Dakota,Cavalier,1302
15205,1977-1978,1977-11-10,1978-04-20,162,2,509,1002,1511,49,877,926,2437,24,272,North Dakota,Cavalier,1302
15206,1978-1979,1978-11-11,1979-05-11,182,0,583,1291,1874,79,1107,1186,3060,40,416,North Dakota,Cavalier,1302
15207,1979-1980,1979-11-01,1980-03-28,149,0,339,839,1178,37,466,503,1681,21,215,North Dakota,Cavalier,1302
15208,1980-1981,1980-10-23,1981-03-18,147,2,246,646,892,31,175,206,1098,12,92,North Dakota,Cavalier,1302
15209,1981-1982,1981-10-23,1982-04-10,170,1,449,947,1396,47,533,580,1976,21,291,North Dakota,Cavalier,1302
15210,1982-1983,1982-11-03,1983-05-15,194,7,248,675,923,23,130,153,1076,15,87,North Dakota,Cavalier,1302
15211,1983-1984,1983-10-12,1984-04-28,200,1,352,845,1197,34,491,525,1722,20,182,North Dakota,Cavalier,1302
15212,1984-1985,1984-10-28,1985-04-01,156,0,386,897,1283,46,501,547,1830,26,280,North Dakota,Cavalier,1302
15213,1985-1986,1985-10-08,1986-04-26,201,2,410,973,1383,75,894,969,2352,32,355,North Dakota,Cavalier,1302
15214,1986-1987,1986-11-04,1987-04-04,152,2,225,684,909,70,1017,1087,1996,23,187,North Dakota,Cavalier,1302
15215,1987-1988,1987-10-22,1988-03-30,161,3,294,750,1044,33,268,301,1345,19,147,North Dakota,Cavalier,1302
15216,1988-1989,1988-10-27,1989-04-15,171,4,397,1018,1415,89,1140,1229,2644,29,355,North Dakota,Cavalier,1302
15217,1989-1990,1989-11-02,1990-05-02,182,1,343,883,1226,75,347,422,1648,32,289,North Dakota,Cavalier,1302
15218,1990-1991,1990-11-07,1991-05-04,179,0,359,851,1210,47,308,355,1565,23,228,North Dakota,Cavalier,1302
15219,1991-1992,1991-10-21,1992-04-25,188,2,271,768,1039,79,703,782,1821,33,304,North Dakota,Cavalier,1302
15220,1992-1993,1992-10-14,1993-04-03,172,2,400,920,1320,70,958,1028,2348,25,266,North Dakota,Cavalier,1302
15221,1993-1994,1993-10-29,1994-04-09,163,7,465,926,1391,50,634,684,2075,25,288,North Dakota,Cavalier,1302
15222,1994-1995,1994-11-18,1995-04-09,143,3,360,766,1126,63,845,908,2034,18,181,North Dakota,Cavalier,1302
15223,1995-1996,1995-11-02,1996-04-26,177,6,543,1140,1683,79,1325,1404,3087,31,330,North Dakota,Cavalier,1302
15224,1996-1997,1996-10-31,1997-04-21,173,1,528,1129,1657,108,1433,1541,3198,32,430,North Dakota,Cavalier,1302
15225,1998-1999,1998-11-05,1999-04-07,154,0,342,758,1100,68,583,651,1751,23,235,North Dakota,Cavalier,1302
15226,1999-2000,1999-11-19,2000-04-15,149,1,214,671,885,18,173,191,1076,12,100,North Dakota,Cavalier,1302
15227,2000-2001,2000-10-05,2001-04-22,200,3,446,977,1423,51,747,798,2221,25,272,North Dakota,Cavalier,1302
15228,2001-2002,2001-10-24,2002-05-10,199,2,287,769,1056,61,342,403,1459,25,246,North Dakota,Cavalier,1302
15229,2002-2003,2002-10-17,2003-04-18,184,0,393,903,1296,65,319,384,1680,25,205,North Dakota,Cavalier,1302
15230,2003-2004,2003-10-28,2004-05-13,199,0,356,883,1239,81,674,755,1994,38,373,North Dakota,Cavalier,1302
15231,2004-2005,2004-10-18,2005-05-02,197,1,334,869,1203,59,640,699,1902,24,249,North Dakota,Cavalier,1302
15232,2005-2006,2005-10-06,2006-04-05,182,0,253,680,933,73,727,800,1733,22,198,North Dakota,Cavalier,1302
15233,2006-2007,2006-10-18,2007-04-09,174,0,327,845,1172,65,636,701,1873,21,236,North Dakota,Cavalier,1302
15234,2007-2008,2007-11-18,2008-04-06,141,2,404,900,1304,45,755,800,2104,24,261,North Dakota,Cavalier,1302
15235,2008-2009,2008-11-07,2009-04-08,153,1,470,961,1431,52,660,712,2143,29,319,North Dakota,Cavalier,1302
15236,2009-2010,2009-10-15,2010-03-28,165,0,342,744,1086,54,806,860,1946,23,212,North Dakota,Cavalier,1302
15237,2010-2011,2010-11-14,2011-05-02,170,3,443,846,1289,59,877,936,2225,27,285,North Dakota,Cavalier,1302
15238,2011-2012,2011-11-16,2012-03-12,118,0,183,546,729,32,154,186,915,17,144,North Dakota,Cavalier,1302
15239,2012-2013,2012-10-05,2013-04-28,206,0,428,1007,1435,96,1112,1208,2643,29,327,North Dakota,Cavalier,1302
15240,2013-2014,2013-10-29,2014-04-16,170,8,548,1114,1662,62,916,978,2640,26,319,North Dakota,Cavalier,1302
15241,2014-2015,2014-11-09,2015-04-08,151,20,352,790,1142,42,356,398,1540,16,165,North Dakota,Cavalier,1302
15242,2016-2017,2016-11-28,2017-04-25,149,16,295,654,949,62,719,781,1730,23,214,North Dakota,Cavalier,1302
15243,2017-2018,2017-10-27,2018-04-12,168,4,360,850,1210,47,521,568,1778,28,257,North Dakota,Cavalier,1302
15244,2018-2019,2018-10-05,2019-04-13,191,11,466,990,1456,73,789,862,2318,24,276,North Dakota,Cavalier,1302
15245,2019-2020,2019-10-11,2020-04-15,188,16,315,807,1122,75,631,706,1828,25,245,North Dakota,Cavalier,1302
15246,1950-1951,1950-10-02,1951-04-21,202,0,408,930,1338,84,612,696,2034,54,534,North Dakota,Fargo,105549
15247,1951-1952,1951-10-29,1952-04-08,163,0,381,877,1258,98,742,840,2098,48,473,North Dakota,Fargo,105549
15248,1952-1953,1952-11-09,1953-04-17,160,0,211,622,833,49,232,281,1114,40,296,North Dakota,Fargo,105549
15249,1953-1954,1953-11-20,1954-05-03,165,0,264,672,936,52,491,543,1479,34,283,North Dakota,Fargo,105549
15250,1954-1955,1954-11-01,1955-04-05,156,0,280,736,1016,52,337,389,1405,37,358,North Dakota,Fargo,105549
15251,1955-1956,1955-11-02,1956-04-09,160,0,411,934,1345,57,500,557,1902,33,319,North Dakota,Fargo,105549
15252,1956-1957,1956-11-15,1957-04-11,148,0,289,730,1019,38,81,119,1138,32,305,North Dakota,Fargo,105549
15253,1957-1958,1957-10-25,1958-03-20,147,0,191,568,759,24,67,91,850,22,169,North Dakota,Fargo,105549
15254,1958-1959,1958-11-17,1959-04-24,159,0,323,744,1067,29,218,247,1314,20,165,North Dakota,Fargo,105549
15255,1959-1960,1959-10-10,1960-05-02,206,0,282,787,1069,44,293,337,1406,28,201,North Dakota,Fargo,105549
15256,1960-1961,1960-10-19,1961-04-27,191,0,242,712,954,40,291,331,1285,24,214,North Dakota,Fargo,105549
15257,1961-1962,1961-11-02,1962-04-14,164,0,347,825,1172,69,565,634,1806,43,389,North Dakota,Fargo,105549
15258,1962-1963,1962-10-24,1963-05-21,210,0,284,761,1045,45,57,102,1147,32,277,North Dakota,Fargo,105549
15259,1963-1964,1963-11-21,1964-04-14,146,0,222,711,933,54,261,315,1248,25,189,North Dakota,Fargo,105549
15260,1964-1965,1964-11-19,1965-04-07,140,0,435,979,1414,54,469,523,1937,32,329,North Dakota,Fargo,105549
15261,1965-1966,1965-11-09,1966-04-28,171,0,359,846,1205,63,405,468,1673,29,242,North Dakota,Fargo,105549
15262,1966-1967,1966-10-22,1967-05-02,193,0,306,890,1196,61,340,401,1597,42,395,North Dakota,Fargo,105549
15263,1967-1968,1967-10-27,1968-05-17,204,0,267,740,1007,56,260,316,1323,31,253,North Dakota,Fargo,105549
15264,1968-1969,1968-10-18,1969-04-07,172,0,379,864,1243,72,710,782,2025,48,450,North Dakota,Fargo,105549
15265,1969-1970,1969-10-25,1970-04-23,181,0,326,843,1169,75,499,574,1743,49,421,North Dakota,Fargo,105549
15266,1970-1971,1970-10-09,1971-04-02,176,0,322,801,1123,63,399,462,1585,35,352,North Dakota,Fargo,105549
15267,1971-1972,1971-10-29,1972-04-09,164,0,366,839,1205,95,418,513,1718,60,562,North Dakota,Fargo,105549
15268,1972-1973,1972-10-17,1973-04-15,181,0,272,710,982,54,302,356,1338,30,264,North Dakota,Fargo,105549
15269,1973-1974,1973-11-03,1974-04-29,178,0,360,822,1182,85,418,503,1685,59,558,North Dakota,Fargo,105549
15270,1974-1975,1974-10-06,1975-04-19,196,0,259,714,973,104,441,545,1518,66,507,North Dakota,Fargo,105549
15271,1975-1976,1975-10-24,1976-05-01,191,0,253,691,944,70,322,392,1336,34,307,North Dakota,Fargo,105549
15272,1976-1977,1976-10-18,1977-04-05,170,0,361,855,1216,65,265,330,1546,40,373,North Dakota,Fargo,105549
15273,1977-1978,1977-11-08,1978-04-20,164,0,472,876,1348,86,807,893,2241,41,429,North Dakota,Fargo,105549
15274,1978-1979,1978-11-10,1979-05-05,177,0,501,1031,1532,97,822,919,2451,58,543,North Dakota,Fargo,105549
15275,1979-1980,1979-10-31,1980-03-27,149,0,293,737,1030,73,288,361,1391,42,344,North Dakota,Fargo,105549
15276,1980-1981,1980-10-23,1981-03-31,160,0,215,617,832,30,46,76,908,25,191,North Dakota,Fargo,105549
15277,1981-1982,1981-10-21,1982-04-06,168,0,415,895,1310,110,534,644,1954,47,523,North Dakota,Fargo,105549
15278,1982-1983,1982-11-04,1983-04-14,162,0,185,518,703,41,66,107,810,24,143,North Dakota,Fargo,105549
15279,1983-1984,1983-11-12,1984-04-28,169,0,331,678,1009,61,525,586,1595,36,315,North Dakota,Fargo,105549
15280,1984-1985,1984-10-28,1985-03-30,154,0,315,723,1038,47,227,274,1312,28,281,North Dakota,Fargo,105549
15281,1985-1986,1985-11-08,1986-04-15,159,0,361,778,1139,89,708,797,1936,41,469,North Dakota,Fargo,105549
15282,1986-1987,1986-11-08,1987-03-29,142,0,148,480,628,41,108,149,777,24,153,North Dakota,Fargo,105549
15283,1987-1988,1987-11-16,1988-03-28,134,0,261,622,883,66,457,523,1406,26,244,North Dakota,Fargo,105549
15284,1988-1989,1988-10-28,1989-04-17,172,0,307,828,1135,113,745,858,1993,43,419,North Dakota,Fargo,105549
15285,1989-1990,1989-11-01,1990-04-29,180,0,230,711,941,78,201,279,1220,35,261,North Dakota,Fargo,105549
15286,1990-1991,1990-10-17,1991-04-30,196,0,250,708,958,77,290,367,1325,37,387,North Dakota,Fargo,105549
15287,1991-1992,1991-10-29,1992-04-25,180,0,162,583,745,50,182,232,977,35,266,North Dakota,Fargo,105549
15288,1992-1993,1992-10-15,1993-03-26,163,0,317,733,1050,86,679,765,1815,44,404,North Dakota,Fargo,105549
15289,1993-1994,1993-10-29,1994-04-29,183,0,361,820,1181,139,839,978,2159,56,633,North Dakota,Fargo,105549
15290,1994-1995,1994-11-18,1995-04-11,145,0,219,611,830,81,346,427,1257,35,293,North Dakota,Fargo,105549
15291,1995-1996,1995-10-31,1996-04-07,160,0,429,899,1328,109,718,827,2155,35,404,North Dakota,Fargo,105549
15292,1996-1997,1996-10-30,1997-04-12,165,0,416,948,1364,167,1181,1348,2712,45,614,North Dakota,Fargo,105549
15293,2004-2005,2004-11-25,2005-05-01,158,1,231,621,852,51,285,336,1188,32,260,North Dakota,Fargo,105549
15294,2005-2006,2005-11-15,2006-03-29,135,0,200,534,734,65,593,658,1392,36,270,North Dakota,Fargo,105549
15295,2006-2007,2006-10-11,2007-04-11,183,0,223,645,868,68,244,312,1180,39,308,North Dakota,Fargo,105549
15296,2007-2008,2007-11-18,2008-04-26,161,0,333,787,1120,103,644,747,1867,50,454,North Dakota,Fargo,105549
15297,2008-2009,2008-10-26,2009-04-09,166,1,355,832,1187,118,689,807,1994,41,467,North Dakota,Fargo,105549
15298,2009-2010,2009-10-09,2010-03-25,168,0,285,636,921,73,675,748,1669,33,284,North Dakota,Fargo,105549
15299,2010-2011,2010-10-26,2011-05-01,188,0,359,812,1171,136,916,1052,2223,62,617,North Dakota,Fargo,105549
15300,2011-2012,2011-11-15,2012-03-11,118,0,104,441,545,52,214,266,811,32,204,North Dakota,Fargo,105549
15301,2012-2013,2012-10-04,2013-04-25,204,0,269,776,1045,112,685,797,1842,61,491,North Dakota,Fargo,105549
15302,2013-2014,2013-11-11,2014-04-16,157,0,396,886,1282,64,603,667,1949,49,518,North Dakota,Fargo,105549
15303,2014-2015,2014-11-05,2015-03-25,141,0,234,634,868,38,142,180,1048,32,247,North Dakota,Fargo,105549
15304,2015-2016,2015-11-19,2016-04-11,145,0,149,457,606,53,263,316,922,36,215,North Dakota,Fargo,105549
15305,2016-2017,2016-11-17,2017-04-27,162,0,200,495,695,56,236,292,987,32,282,North Dakota,Fargo,105549
15306,2017-2018,2017-10-26,2018-04-14,171,0,287,775,1062,81,463,544,1606,44,366,North Dakota,Fargo,105549
15307,2018-2019,2018-10-10,2019-04-14,187,0,358,844,1202,92,690,782,1984,44,446,North Dakota,Fargo,105549
15308,2019-2020,2019-10-11,2020-04-14,187,0,243,712,955,81,751,832,1787,38,315,North Dakota,Fargo,105549
15309,1950-1951,1950-10-02,1951-04-21,202,0,434,952,1386,63,445,508,1894,46,480,North Dakota,Grand Forks,52838
15310,1951-1952,1951-10-30,1952-04-03,157,0,399,907,1306,78,597,675,1981,44,469,North Dakota,Grand Forks,52838
15311,1952-1953,1952-11-09,1953-05-11,184,0,246,682,928,46,154,200,1128,30,259,North Dakota,Grand Forks,52838
15312,1953-1954,1953-11-20,1954-05-03,165,0,284,731,1015,75,399,474,1489,44,458,North Dakota,Grand Forks,52838
15313,1954-1955,1954-10-31,1955-04-01,153,2,334,832,1166,63,457,520,1686,34,364,North Dakota,Grand Forks,52838
15314,1955-1956,1955-10-31,1956-04-27,180,1,461,1104,1565,102,925,1027,2592,49,523,North Dakota,Grand Forks,52838
15315,1956-1957,1956-11-15,1957-04-11,148,3,315,803,1118,46,233,279,1397,28,281,North Dakota,Grand Forks,52838
15316,1957-1958,1957-11-02,1958-03-20,139,4,207,611,818,26,34,60,878,19,131,North Dakota,Grand Forks,52838
15317,1958-1959,1958-11-15,1959-03-24,130,0,408,879,1287,70,670,740,2027,27,293,North Dakota,Grand Forks,52838
15318,1959-1960,1959-10-11,1960-04-27,200,0,328,887,1215,64,512,576,1791,34,263,North Dakota,Grand Forks,52838
15319,1960-1961,1960-10-19,1961-04-24,188,0,284,747,1031,48,346,394,1425,35,293,North Dakota,Grand Forks,52838
15320,1961-1962,1961-11-03,1962-04-14,163,0,387,895,1282,70,620,690,1972,39,360,North Dakota,Grand Forks,52838
15321,1962-1963,1962-11-04,1963-05-21,199,2,318,764,1082,28,108,136,1218,22,202,North Dakota,Grand Forks,52838
15322,1963-1964,1963-11-21,1964-04-14,146,0,277,745,1022,53,338,391,1413,23,212,North Dakota,Grand Forks,52838
15323,1964-1965,1964-10-19,1965-05-27,221,5,453,978,1431,54,593,647,2078,38,414,North Dakota,Grand Forks,52838
15324,1965-1966,1965-11-08,1966-04-30,174,0,401,891,1292,99,579,678,1970,47,449,North Dakota,Grand Forks,52838
15325,1966-1967,1966-11-01,1967-05-04,185,0,380,990,1370,75,622,697,2067,41,391,North Dakota,Grand Forks,52838
15326,1967-1968,1967-10-27,1968-04-14,171,0,328,777,1105,41,272,313,1418,34,319,North Dakota,Grand Forks,52838
15327,1968-1969,1968-10-18,1969-04-07,172,0,437,922,1359,67,690,757,2116,48,468,North Dakota,Grand Forks,52838
15328,1969-1970,1969-10-26,1970-04-22,179,0,378,956,1334,69,599,668,2002,49,470,North Dakota,Grand Forks,52838
15329,1970-1971,1970-11-19,1971-04-25,158,0,353,799,1152,65,540,605,1757,40,395,North Dakota,Grand Forks,52838
15330,1971-1972,1971-10-30,1972-04-23,177,0,395,899,1294,66,255,321,1615,42,386,North Dakota,Grand Forks,52838
15331,1972-1973,1972-10-17,1973-04-15,181,0,283,753,1036,33,189,222,1258,26,210,North Dakota,Grand Forks,52838
15332,1973-1974,1973-11-02,1974-05-03,183,0,461,1008,1469,69,609,678,2147,48,523,North Dakota,Grand Forks,52838
15333,1974-1975,1974-10-06,1975-04-10,187,0,288,796,1084,72,365,437,1521,44,395,North Dakota,Grand Forks,52838
15334,1975-1976,1975-11-11,1976-03-25,136,0,281,768,1049,76,360,436,1485,44,404,North Dakota,Grand Forks,52838
15335,1976-1977,1976-10-24,1977-04-05,164,0,316,843,1159,54,242,296,1455,38,407,North Dakota,Grand Forks,52838
15336,1977-1978,1977-11-08,1978-04-19,163,0,478,931,1409,57,547,604,2013,38,352,North Dakota,Grand Forks,52838
15337,1978-1979,1978-11-10,1979-05-11,183,0,549,1177,1726,90,891,981,2707,56,594,North Dakota,Grand Forks,52838
15338,1979-1980,1979-10-31,1980-03-26,148,0,273,729,1002,61,276,337,1339,32,259,North Dakota,Grand Forks,52838
15339,1980-1981,1980-11-10,1981-03-06,117,0,197,511,708,28,67,95,803,19,155,North Dakota,Grand Forks,52838
15340,1981-1982,1981-10-21,1982-04-06,168,0,407,871,1278,78,386,464,1742,43,531,North Dakota,Grand Forks,52838
15341,1982-1983,1982-11-04,1983-05-15,193,0,178,538,716,34,111,145,861,25,129,North Dakota,Grand Forks,52838
15342,1983-1984,1983-10-12,1984-03-20,161,0,326,696,1022,64,335,399,1421,41,372,North Dakota,Grand Forks,52838
15343,1984-1985,1984-10-19,1985-04-02,166,0,302,742,1044,66,352,418,1462,33,330,North Dakota,Grand Forks,52838
15344,1985-1986,1985-10-07,1986-04-15,191,0,418,953,1371,96,873,969,2340,43,523,North Dakota,Grand Forks,52838
15345,1986-1987,1986-11-03,1987-04-01,150,0,198,587,785,71,478,549,1334,35,277,North Dakota,Grand Forks,52838
15346,1987-1988,1987-10-21,1988-03-28,160,0,285,760,1045,65,421,486,1531,36,317,North Dakota,Grand Forks,52838
15347,1988-1989,1988-10-27,1989-04-16,172,0,361,931,1292,124,806,930,2222,45,475,North Dakota,Grand Forks,52838
15348,1989-1990,1989-11-01,1990-04-29,180,0,260,803,1063,71,158,229,1292,44,353,North Dakota,Grand Forks,52838
15349,1990-1991,1990-10-17,1991-04-30,196,0,281,804,1085,72,317,389,1474,40,413,North Dakota,Grand Forks,52838
15350,1991-1992,1991-09-17,1992-04-23,220,0,208,657,865,78,237,315,1180,45,390,North Dakota,Grand Forks,52838
15351,1992-1993,1992-10-13,1993-03-22,161,0,335,775,1110,74,527,601,1711,40,406,North Dakota,Grand Forks,52838
15352,1993-1994,1993-10-29,1994-04-28,182,0,417,932,1349,103,794,897,2246,48,600,North Dakota,Grand Forks,52838
15353,1995-1996,1995-10-30,1996-04-25,179,0,473,1005,1478,139,702,841,2319,60,600,North Dakota,Grand Forks,52838
15354,1996-1997,1996-10-01,1997-04-13,195,0,437,966,1403,140,1261,1401,2804,56,677,North Dakota,Grand Forks,52838
15355,1998-1999,1998-11-04,1999-04-04,152,0,284,715,999,112,620,732,1731,40,437,North Dakota,Grand Forks,52838
15356,1999-2000,1999-11-29,2000-04-14,138,0,172,576,748,30,55,85,833,22,189,North Dakota,Grand Forks,52838
15357,2000-2001,2000-10-05,2001-04-15,193,0,373,847,1220,81,527,608,1828,48,440,North Dakota,Grand Forks,52838
15358,2001-2002,2001-10-24,2002-05-06,195,0,217,686,903,67,176,243,1146,38,306,North Dakota,Grand Forks,52838
15359,2002-2003,2002-10-17,2003-04-17,183,0,329,838,1167,64,302,366,1533,44,379,North Dakota,Grand Forks,52838
15360,2003-2004,2003-10-27,2004-03-29,155,0,319,833,1152,102,458,560,1712,55,510,North Dakota,Grand Forks,52838
15361,2004-2005,2004-11-23,2005-05-01,160,0,287,791,1078,63,326,389,1467,36,329,North Dakota,Grand Forks,52838
15362,2005-2006,2005-10-05,2006-03-30,177,0,236,662,898,72,547,619,1517,49,372,North Dakota,Grand Forks,52838
15363,2006-2007,2006-10-12,2007-04-07,178,0,271,767,1038,74,269,343,1381,37,329,North Dakota,Grand Forks,52838
15364,2007-2008,2007-11-06,2008-05-10,187,0,382,932,1314,77,651,728,2042,43,443,North Dakota,Grand Forks,52838
15365,2008-2009,2008-10-26,2009-04-26,183,0,411,948,1359,96,531,627,1986,56,664,North Dakota,Grand Forks,52838
15366,2009-2010,2009-10-14,2010-03-25,163,0,316,689,1005,56,610,666,1671,33,263,North Dakota,Grand Forks,52838
15367,2010-2011,2010-11-13,2011-05-01,170,0,404,868,1272,92,576,668,1940,55,563,North Dakota,Grand Forks,52838
15368,2011-2012,2011-11-15,2012-03-28,135,0,139,526,665,43,187,230,895,31,235,North Dakota,Grand Forks,52838
15369,2012-2013,2012-10-04,2013-04-22,201,1,319,864,1183,96,595,691,1874,61,532,North Dakota,Grand Forks,52838
15370,2013-2014,2013-11-10,2014-04-15,157,0,461,1070,1531,101,682,783,2314,49,633,North Dakota,Grand Forks,52838
15371,2014-2015,2014-11-05,2015-04-07,154,0,288,762,1050,39,144,183,1233,33,258,North Dakota,Grand Forks,52838
15372,2015-2016,2015-11-05,2016-04-08,156,0,182,522,704,49,247,296,1000,25,163,North Dakota,Grand Forks,52838
15373,2016-2017,2016-11-22,2017-04-27,157,1,235,564,799,69,391,460,1259,32,282,North Dakota,Grand Forks,52838
15374,2017-2018,2017-10-26,2018-04-17,174,0,328,842,1170,79,635,714,1884,41,336,North Dakota,Grand Forks,52838
15375,2018-2019,2018-10-04,2019-04-14,193,0,433,990,1423,107,721,828,2251,48,532,North Dakota,Grand Forks,52838
15376,2019-2020,2019-10-10,2020-04-14,188,0,287,872,1159,111,818,929,2088,50,490,North Dakota,Grand Forks,52838
15377,1954-1955,1954-10-25,1955-04-05,163,1,247,762,1009,33,278,311,1320,22,209,North Dakota,Max,334
15378,1955-1956,1955-10-31,1956-04-07,160,1,435,999,1434,58,656,714,2148,25,237,North Dakota,Max,334
15379,1956-1957,1956-11-06,1957-04-12,158,0,310,823,1133,38,198,236,1369,22,229,North Dakota,Max,334
15380,1957-1958,1957-10-23,1958-03-28,157,1,223,706,929,38,195,233,1162,16,120,North Dakota,Max,334
15381,1958-1959,1958-11-15,1959-04-17,154,0,354,845,1199,47,619,666,1865,22,261,North Dakota,Max,334
15382,1959-1960,1959-10-08,1960-04-27,203,11,328,895,1223,81,699,780,2003,37,311,North Dakota,Max,334
15383,1960-1961,1960-11-09,1961-04-28,171,0,192,720,912,50,266,316,1228,21,202,North Dakota,Max,334
15384,1961-1962,1961-11-03,1962-04-12,161,0,373,955,1328,56,384,440,1768,32,342,North Dakota,Max,334
15385,1962-1963,1962-11-03,1963-04-05,154,0,261,758,1019,49,119,168,1187,23,255,North Dakota,Max,334
15386,1968-1969,1968-11-06,1969-04-11,157,0,425,934,1359,70,802,872,2231,38,444,North Dakota,Max,334
15387,1969-1970,1969-10-11,1970-04-28,200,20,320,928,1248,92,814,906,2154,39,358,North Dakota,Max,334
15388,1970-1971,1970-10-29,1971-04-27,181,0,391,936,1327,61,666,727,2054,33,350,North Dakota,Max,334
15389,1971-1972,1971-10-17,1972-04-06,173,1,401,984,1385,63,504,567,1952,22,285,North Dakota,Max,334
15390,1972-1973,1972-09-26,1973-04-08,195,0,274,744,1018,40,322,362,1380,16,131,North Dakota,Max,334
15391,1974-1975,1974-12-01,1975-04-22,143,5,259,762,1021,69,636,705,1726,19,195,North Dakota,Max,334
15392,1975-1976,1975-10-09,1976-03-26,170,2,239,752,991,88,695,783,1774,28,265,North Dakota,Max,334
15393,1976-1977,1976-10-24,1977-04-07,166,1,296,869,1165,50,432,482,1647,16,202,North Dakota,Max,334
15394,1977-1978,1977-11-19,1978-04-04,137,0,468,900,1368,60,705,765,2133,20,232,North Dakota,Max,334
15395,1978-1979,1978-11-10,1979-05-05,177,1,508,1140,1648,85,844,929,2577,32,377,North Dakota,Max,334
15396,1980-1981,1980-10-16,1981-03-07,143,7,199,609,808,61,267,328,1136,20,208,North Dakota,Max,334
15397,1982-1983,1982-10-06,1983-05-12,219,15,137,625,762,52,254,306,1068,12,103,North Dakota,Max,334
15398,1983-1984,1983-11-12,1984-05-03,174,7,280,714,994,52,392,444,1438,19,193,North Dakota,Max,334
15399,1984-1985,1984-09-24,1985-04-04,193,11,326,861,1187,69,354,423,1610,20,210,North Dakota,Max,334
15400,1986-1987,1986-11-01,1987-04-02,153,10,148,541,689,67,290,357,1046,15,151,North Dakota,Max,334
15401,1987-1988,1987-10-23,1988-03-29,159,16,213,585,798,28,179,207,1005,9,99,North Dakota,Max,334
15402,1988-1989,1988-10-28,1989-04-09,164,4,319,836,1155,60,457,517,1672,16,179,North Dakota,Max,334
15403,1989-1990,1989-11-01,1990-05-01,182,6,207,770,977,44,91,135,1112,14,128,North Dakota,Max,334
15404,1990-1991,1990-10-17,1991-05-05,201,0,253,777,1030,49,222,271,1301,15,156,North Dakota,Max,334
15405,2003-2004,2003-10-30,2004-05-13,197,9,287,767,1054,83,764,847,1901,25,248,North Dakota,Max,334
15406,2004-2005,2004-10-17,2005-03-27,162,9,199,662,861,48,217,265,1126,16,145,North Dakota,Max,334
15407,2005-2006,2005-10-05,2006-03-20,167,4,160,509,669,62,112,174,843,18,134,North Dakota,Max,334
15408,2006-2007,2006-10-18,2007-04-13,178,7,227,754,981,57,331,388,1369,18,181,North Dakota,Max,334
15409,2007-2008,2007-11-17,2008-05-10,176,3,261,816,1077,35,107,142,1219,14,150,North Dakota,Max,334
15410,2008-2009,2008-11-06,2009-04-13,159,6,406,867,1273,136,1227,1363,2636,28,405,North Dakota,Max,334
15411,2009-2010,2009-10-11,2010-05-07,209,3,306,709,1015,76,784,860,1875,26,278,North Dakota,Max,334
15412,2010-2011,2010-10-27,2011-05-01,187,6,379,863,1242,148,1163,1311,2553,40,499,North Dakota,Max,334
15413,2011-2012,2011-11-14,2012-03-09,117,7,118,447,565,38,93,131,696,13,108,North Dakota,Max,334
15414,2014-2015,2014-11-10,2015-05-18,190,0,287,694,981,45,265,310,1291,18,149,North Dakota,Max,334
15415,2015-2016,2015-11-20,2016-04-17,150,0,145,469,614,38,174,212,826,16,123,North Dakota,Max,334
15416,2016-2017,2016-10-08,2017-04-25,200,0,300,652,952,117,821,938,1890,31,354,North Dakota,Max,334
15417,2017-2018,2017-10-31,2018-04-21,173,2,336,892,1228,95,602,697,1925,26,288,North Dakota,Max,334
15418,2018-2019,2018-10-05,2019-04-30,208,0,389,866,1255,88,612,700,1955,28,366,North Dakota,Max,334
15419,2019-2020,2019-10-03,2020-04-15,196,0,235,709,944,72,370,442,1386,26,234,North Dakota,Max,334
15420,1951-1952,1951-10-31,1952-03-29,151,20,342,963,1305,45,524,569,1874,20,241,North Dakota,Upham,130
15421,1953-1954,1953-11-07,1954-04-03,148,15,233,805,1038,71,569,640,1678,32,358,North Dakota,Upham,130
15422,1955-1956,1955-10-31,1956-05-03,186,19,393,1042,1435,70,1163,1233,2668,28,274,North Dakota,Upham,130
15423,1956-1957,1956-11-09,1957-04-11,154,9,265,810,1075,19,313,332,1407,15,177,North Dakota,Upham,130
15424,1957-1958,1957-10-23,1958-03-23,152,6,198,717,915,33,157,190,1105,20,157,North Dakota,Upham,130
15425,1977-1978,1977-12-01,1978-04-12,133,11,456,1038,1494,47,805,852,2346,25,288,North Dakota,Upham,130
15426,1978-1979,1978-11-11,1979-05-10,181,7,522,1289,1811,121,1062,1183,2994,55,647,North Dakota,Upham,130
15427,1981-1982,1981-10-22,1982-05-09,200,18,457,1081,1538,81,915,996,2534,42,511,North Dakota,Upham,130
15428,1982-1983,1982-10-06,1983-05-13,220,9,198,752,950,47,335,382,1332,23,153,North Dakota,Upham,130
15429,1983-1984,1983-11-12,1984-05-01,172,15,330,778,1108,68,475,543,1651,32,307,North Dakota,Upham,130
15430,1986-1987,1986-11-01,1987-04-10,161,17,163,635,798,63,855,918,1716,19,164,North Dakota,Upham,130
15431,1987-1988,1987-11-18,1988-03-26,130,17,242,643,885,42,209,251,1136,16,185,North Dakota,Upham,130
15432,1989-1990,1989-11-01,1990-04-28,179,1,238,882,1120,65,155,220,1340,32,272,North Dakota,Upham,130
15433,1990-1991,1990-11-07,1991-05-05,180,2,287,912,1199,63,294,357,1556,26,258,North Dakota,Upham,130
15434,1991-1992,1991-09-18,1992-04-21,217,6,201,828,1029,72,856,928,1957,33,301,North Dakota,Upham,130
15435,1992-1993,1992-11-01,1993-04-11,162,1,342,924,1266,76,744,820,2086,38,345,North Dakota,Upham,130
15436,1993-1994,1993-10-30,1994-04-09,162,0,397,1051,1448,83,819,902,2350,35,512,North Dakota,Upham,130
15437,1994-1995,1994-11-14,1995-04-16,154,2,321,837,1158,110,969,1079,2237,34,365,North Dakota,Upham,130
15438,1995-1996,1995-10-30,1996-04-27,181,3,474,1176,1650,102,1151,1253,2903,41,498,North Dakota,Upham,130
15439,1996-1997,1996-10-02,1997-04-14,195,9,465,1121,1586,121,1142,1263,2849,41,507,North Dakota,Upham,130
15440,1997-1998,1997-10-14,1998-03-31,169,13,203,741,944,82,441,523,1467,27,280,North Dakota,Upham,130
15441,1998-1999,1998-11-06,1999-04-08,154,2,274,787,1061,112,1091,1203,2264,42,493,North Dakota,Upham,130
15442,1999-2000,1999-11-19,2000-05-13,177,7,155,640,795,55,199,254,1049,20,196,North Dakota,Upham,130
15443,2000-2001,2000-10-05,2001-04-16,194,10,352,1045,1397,88,995,1083,2480,36,356,North Dakota,Upham,130
15444,2001-2002,2001-10-24,2002-05-09,198,6,240,815,1055,88,546,634,1689,32,293,North Dakota,Upham,130
15445,2002-2003,2002-10-18,2003-04-17,182,6,337,994,1331,87,648,735,2066,36,382,North Dakota,Upham,130
15446,2003-2004,2003-10-30,2004-05-14,198,2,329,990,1319,109,1144,1253,2572,39,436,North Dakota,Upham,130
15447,2004-2005,2004-10-17,2005-05-13,209,3,235,855,1090,55,419,474,1564,28,259,North Dakota,Upham,130
15448,2005-2006,2005-10-05,2006-03-31,178,1,177,636,813,77,378,455,1268,36,294,North Dakota,Upham,130
15449,2006-2007,2006-10-12,2007-04-11,182,1,274,911,1185,65,539,604,1789,35,288,North Dakota,Upham,130
15450,2007-2008,2007-11-10,2008-03-30,142,4,307,917,1224,47,508,555,1779,27,326,North Dakota,Upham,130
15451,2008-2009,2008-11-07,2009-04-14,159,0,438,1091,1529,94,1096,1190,2719,38,495,North Dakota,Upham,130
15452,2009-2010,2009-10-10,2010-05-07,210,0,315,813,1128,70,697,767,1895,36,332,North Dakota,Upham,130
15453,2010-2011,2010-10-27,2011-05-01,187,0,392,916,1308,110,1144,1254,2562,45,473,North Dakota,Upham,130
15454,2011-2012,2011-11-07,2012-04-20,166,0,143,615,758,51,294,345,1103,24,217,North Dakota,Upham,130
15455,2012-2013,2012-10-29,2013-05-02,186,0,352,997,1349,120,1244,1364,2713,57,555,North Dakota,Upham,130
15456,2013-2014,2013-10-29,2014-05-05,189,0,440,1090,1530,66,751,817,2347,41,468,North Dakota,Upham,130
15457,2014-2015,2014-11-05,2015-05-18,195,0,312,841,1153,66,543,609,1762,37,302,North Dakota,Upham,130
15458,2015-2016,2015-11-06,2016-04-17,164,0,175,565,740,49,327,376,1116,27,175,North Dakota,Upham,130
15459,2016-2017,2016-10-12,2017-04-25,196,0,306,753,1059,105,1058,1163,2222,35,372,North Dakota,Upham,130
15460,2017-2018,2017-10-31,2018-04-15,167,0,310,945,1255,52,533,585,1840,26,237,North Dakota,Upham,130
15461,2018-2019,2018-10-04,2019-04-30,209,0,394,1039,1433,89,928,1017,2450,32,396,North Dakota,Upham,130
15462,2019-2020,2019-10-03,2020-05-10,221,10,249,781,1030,67,471,538,1568,31,235,North Dakota,Upham,130
15463,1950-1951,1950-11-11,1951-04-13,154,0,87,348,435,107,259,366,801,44,282,Ohio,Akron,199110
15464,1951-1952,1951-11-01,1952-04-06,158,0,66,296,362,86,97,183,545,41,219,Ohio,Akron,199110
15465,1952-1953,1952-10-20,1953-04-20,183,0,29,241,270,54,51,105,375,34,152,Ohio,Akron,199110
15466,1953-1954,1953-11-07,1954-04-03,148,0,56,268,324,77,85,162,486,44,239,Ohio,Akron,199110
15467,1954-1955,1954-10-31,1955-03-28,149,0,62,288,350,57,122,179,529,41,194,Ohio,Akron,199110
15468,1955-1956,1955-11-17,1956-04-24,160,0,61,333,394,70,87,157,551,45,199,Ohio,Akron,199110
15469,1956-1957,1956-11-21,1957-04-14,145,0,65,276,341,87,125,212,553,59,274,Ohio,Akron,199110
15470,1957-1958,1957-10-27,1958-04-10,166,0,75,323,398,65,121,186,584,49,238,Ohio,Akron,199110
15471,1958-1959,1958-11-21,1959-04-04,135,0,101,396,497,81,161,242,739,45,282,Ohio,Akron,199110
15472,1959-1960,1959-11-12,1960-04-10,151,0,76,319,395,94,248,342,737,56,293,Ohio,Akron,199110
15473,1960-1961,1960-11-06,1961-04-18,164,0,94,341,435,117,268,385,820,56,346,Ohio,Akron,199110
15474,1961-1962,1961-11-08,1962-04-15,159,0,81,321,402,81,91,172,574,43,243,Ohio,Akron,199110
15475,1962-1963,1962-10-25,1963-05-01,189,0,122,419,541,110,241,351,892,52,352,Ohio,Akron,199110
15476,1963-1964,1963-11-02,1964-04-09,160,0,86,338,424,96,225,321,745,54,265,Ohio,Akron,199110
15477,1964-1965,1964-11-20,1965-03-26,127,0,80,320,400,77,102,179,579,39,231,Ohio,Akron,199110
15478,1965-1966,1965-10-28,1966-05-09,194,0,72,292,364,77,111,188,552,53,255,Ohio,Akron,199110
15479,1966-1967,1966-11-03,1967-04-24,173,0,54,280,334,93,139,232,566,51,242,Ohio,Akron,199110
15480,1967-1968,1967-11-13,1968-04-25,165,0,68,336,404,72,155,227,631,43,225,Ohio,Akron,199110
15481,1968-1969,1968-10-29,1969-03-30,153,0,51,274,325,63,64,127,452,50,214,Ohio,Akron,199110
15482,1969-1970,1969-10-22,1970-04-02,163,0,80,374,454,94,223,317,771,65,344,Ohio,Akron,199110
15483,1970-1971,1970-11-23,1971-03-30,128,0,75,290,365,81,111,192,557,54,281,Ohio,Akron,199110
15484,1971-1972,1971-11-06,1972-04-08,155,0,80,349,429,71,109,180,609,42,208,Ohio,Akron,199110
15485,1972-1973,1972-10-18,1973-04-11,176,0,39,223,262,62,66,128,390,38,160,Ohio,Akron,199110
15486,1973-1974,1973-11-09,1974-04-09,152,0,46,246,292,67,93,160,452,39,195,Ohio,Akron,199110
15487,1974-1975,1974-10-02,1975-04-05,186,0,30,215,245,120,165,285,530,61,253,Ohio,Akron,199110
15488,1975-1976,1975-11-13,1976-04-04,144,0,49,251,300,81,154,235,535,40,211,Ohio,Akron,199110
15489,1976-1977,1976-10-27,1977-04-07,163,0,136,449,585,82,301,383,968,61,405,Ohio,Akron,199110
15490,1977-1978,1977-11-11,1978-04-21,162,0,134,436,570,133,402,535,1105,62,455,Ohio,Akron,199110
15491,1978-1979,1978-11-26,1979-04-08,134,0,117,359,476,80,228,308,784,49,305,Ohio,Akron,199110
15492,1979-1980,1979-10-25,1980-04-16,175,0,72,297,369,63,70,133,502,46,213,Ohio,Akron,199110
15493,1980-1981,1980-11-17,1981-03-22,126,0,74,302,376,85,185,270,646,51,253,Ohio,Akron,199110
15494,1981-1982,1981-11-20,1982-04-09,141,0,80,321,401,100,164,264,665,56,343,Ohio,Akron,199110
15495,1982-1983,1982-11-05,1983-04-18,165,0,29,200,229,65,81,146,375,34,152,Ohio,Akron,199110
15496,1983-1984,1983-11-04,1984-04-18,167,0,94,328,422,100,167,267,689,54,301,Ohio,Akron,199110
15497,1984-1985,1984-11-11,1985-04-09,150,0,84,310,394,83,249,332,726,53,321,Ohio,Akron,199110
15498,1985-1986,1985-12-01,1986-04-22,143,0,79,295,374,64,111,175,549,49,261,Ohio,Akron,199110
15499,1986-1987,1986-11-11,1987-04-07,148,0,39,240,279,76,76,152,431,30,140,Ohio,Akron,199110
15500,1987-1988,1987-11-20,1988-04-16,149,0,68,279,347,85,95,180,527,55,279,Ohio,Akron,199110
15501,1988-1989,1988-10-24,1989-05-07,196,0,56,282,338,62,47,109,447,39,172,Ohio,Akron,199110
15502,1989-1990,1989-10-19,1990-04-17,181,0,75,289,364,73,107,180,544,43,230,Ohio,Akron,199110
15503,1990-1991,1990-11-11,1991-04-01,142,0,31,196,227,50,56,106,333,33,138,Ohio,Akron,199110
15504,1991-1992,1991-11-04,1992-04-03,152,0,43,259,302,79,71,150,452,50,235,Ohio,Akron,199110
15505,1992-1993,1992-10-18,1993-04-17,182,0,51,258,309,85,109,194,503,49,203,Ohio,Akron,199110
15506,1993-1994,1993-10-30,1994-04-07,160,0,107,343,450,107,237,344,794,57,336,Ohio,Akron,199110
15507,1994-1995,1994-11-23,1995-04-04,133,0,51,262,313,48,89,137,450,33,173,Ohio,Akron,199110
15508,1995-1996,1995-11-04,1996-04-23,172,2,124,400,524,99,232,331,855,54,332,Ohio,Akron,199110
15509,1997-1998,1997-11-11,1998-03-24,134,0,29,174,203,47,27,74,277,34,124,Ohio,Akron,199110
15510,1998-1999,1998-12-01,1999-03-21,111,0,51,224,275,83,134,217,492,35,211,Ohio,Akron,199110
15511,1999-2000,1999-11-02,2000-04-09,160,0,57,240,297,61,89,150,447,40,204,Ohio,Akron,199110
15512,2000-2001,2000-10-08,2001-04-17,192,0,84,325,409,87,134,221,630,56,298,Ohio,Akron,199110
15513,2001-2002,2001-12-01,2002-04-06,127,0,38,191,229,45,42,87,316,31,138,Ohio,Akron,199110
15514,2002-2003,2002-10-29,2003-03-31,154,0,98,351,449,91,154,245,694,56,330,Ohio,Akron,199110
15515,2003-2004,2003-11-28,2004-04-27,152,0,68,276,344,82,140,222,566,48,241,Ohio,Akron,199110
15516,2004-2005,2004-11-25,2005-04-25,152,0,69,295,364,90,143,233,597,47,268,Ohio,Akron,199110
15517,2005-2006,2005-10-28,2006-04-05,160,0,51,238,289,63,69,132,421,45,187,Ohio,Akron,199110
15518,2006-2007,2006-10-12,2007-04-14,185,0,80,294,374,74,88,162,536,51,259,Ohio,Akron,199110
15519,2007-2008,2007-11-06,2008-03-22,138,0,63,275,338,104,148,252,590,49,275,Ohio,Akron,199110
15520,2008-2009,2008-10-29,2009-04-07,161,0,84,347,431,97,170,267,698,57,330,Ohio,Akron,199110
15521,2009-2010,2009-12-01,2010-03-26,116,0,70,240,310,95,231,326,636,41,250,Ohio,Akron,199110
15522,2010-2011,2010-11-06,2011-03-31,146,0,89,308,397,96,247,343,740,52,303,Ohio,Akron,199110
15523,2011-2012,2011-11-30,2012-04-11,134,0,25,151,176,51,45,96,272,34,132,Ohio,Akron,199110
15524,2012-2013,2012-11-24,2013-04-20,148,0,49,225,274,78,118,196,470,44,224,Ohio,Akron,199110
15525,2013-2014,2013-11-11,2014-04-15,156,0,109,381,490,111,198,309,799,61,384,Ohio,Akron,199110
15526,2014-2015,2014-11-16,2015-03-28,133,2,97,354,451,93,293,386,837,44,292,Ohio,Akron,199110
15527,2015-2016,2015-12-01,2016-04-09,131,0,44,192,236,54,51,105,341,35,188,Ohio,Akron,199110
15528,2016-2017,2016-11-19,2017-04-07,140,0,42,180,222,58,70,128,350,34,150,Ohio,Akron,199110
15529,2017-2018,2017-11-19,2018-04-19,152,0,75,293,368,86,110,196,564,51,262,Ohio,Akron,199110
15530,2018-2019,2018-11-09,2019-03-31,143,0,56,236,292,71,73,144,436,46,212,Ohio,Akron,199110
15531,2019-2020,2019-11-07,2020-04-17,163,0,18,166,184,52,28,80,264,35,112,Ohio,Akron,199110
15532,1963-1964,1963-12-01,1964-04-01,123,3,39,315,354,63,180,243,597,20,137,Ohio,Cambridge,10635
15533,1965-1966,1965-12-01,1966-04-09,130,3,41,251,292,39,95,134,426,14,88,Ohio,Cambridge,10635
15534,1966-1967,1966-11-29,1967-03-20,112,1,31,250,281,59,80,139,420,19,124,Ohio,Cambridge,10635
15535,1967-1968,1967-11-08,1968-03-24,138,1,40,330,370,55,169,224,594,16,110,Ohio,Cambridge,10635
15536,1968-1969,1968-12-01,1969-03-11,101,1,37,225,262,19,21,40,302,7,42,Ohio,Cambridge,10635
15537,1970-1971,1970-11-24,1971-03-08,105,19,49,229,278,15,17,32,310,6,40,Ohio,Cambridge,10635
15538,1971-1972,1971-12-01,1972-04-08,130,5,26,251,277,15,9,24,301,6,36,Ohio,Cambridge,10635
15539,1976-1977,1976-11-23,1977-03-01,99,1,80,389,469,53,245,298,767,28,210,Ohio,Cambridge,10635
15540,1977-1978,1977-11-26,1978-03-16,111,1,84,376,460,74,289,363,823,23,175,Ohio,Cambridge,10635
15541,1978-1979,1978-11-27,1979-02-28,94,0,64,284,348,46,189,235,583,14,109,Ohio,Cambridge,10635
15542,1979-1980,1979-11-30,1980-03-03,95,0,40,228,268,16,19,35,303,8,46,Ohio,Cambridge,10635
15543,1981-1982,1981-11-21,1982-04-09,140,5,46,292,338,49,87,136,474,20,128,Ohio,Cambridge,10635
15544,1982-1983,1982-12-01,1983-03-11,101,0,11,149,160,11,16,27,187,7,21,Ohio,Cambridge,10635
15545,1983-1984,1983-11-12,1984-03-22,132,6,53,277,330,27,53,80,410,12,72,Ohio,Cambridge,10635
15546,1984-1985,1984-11-19,1985-02-28,102,1,49,251,300,52,207,259,559,21,136,Ohio,Cambridge,10635
15547,1985-1986,1985-12-01,1986-03-21,111,2,50,236,286,31,55,86,372,13,77,Ohio,Cambridge,10635
15548,1986-1987,1986-12-01,1987-04-07,128,0,14,180,194,33,42,75,269,5,41,Ohio,Cambridge,10635
15549,1987-1988,1987-11-11,1988-03-21,132,0,40,240,280,21,26,47,327,11,57,Ohio,Cambridge,10635
15550,1988-1989,1988-12-01,1989-03-21,111,0,27,191,218,23,13,36,254,11,57,Ohio,Cambridge,10635
15551,1989-1990,1989-11-22,1990-03-24,123,0,51,219,270,33,62,95,365,14,78,Ohio,Cambridge,10635
15552,1990-1991,1990-12-01,1991-03-14,104,0,14,148,162,14,9,23,185,6,31,Ohio,Cambridge,10635
15553,1991-1992,1991-11-04,1992-03-21,139,1,21,206,227,29,49,78,305,13,77,Ohio,Cambridge,10635
15554,1992-1993,1992-12-01,1993-03-18,108,4,21,171,192,19,38,57,249,4,33,Ohio,Cambridge,10635
15555,1993-1994,1993-12-01,1994-03-11,101,3,56,249,305,32,125,157,462,13,73,Ohio,Cambridge,10635
15556,1994-1995,1994-12-01,1995-03-09,99,0,28,196,224,22,98,120,344,8,52,Ohio,Cambridge,10635
15557,1995-1996,1995-11-13,1996-03-22,131,5,71,294,365,43,108,151,516,23,135,Ohio,Cambridge,10635
15558,1996-1997,1996-11-27,1997-02-28,94,2,33,161,194,6,7,13,207,3,9,Ohio,Cambridge,10635
15559,1997-1998,1997-12-01,1998-03-12,102,1,7,101,108,8,4,12,120,4,18,Ohio,Cambridge,10635
15560,1998-1999,1998-12-01,1999-03-15,105,5,27,180,207,37,92,129,336,11,74,Ohio,Cambridge,10635
15561,1999-2000,1999-12-01,2000-03-12,103,4,31,186,217,26,84,110,327,11,57,Ohio,Cambridge,10635
15562,2000-2001,2000-11-18,2001-03-26,129,6,45,251,296,20,74,94,390,10,57,Ohio,Cambridge,10635
15563,2002-2003,2002-11-27,2003-03-10,104,3,52,234,286,54,158,212,498,20,130,Ohio,Cambridge,10635
15564,2003-2004,2003-11-29,2004-03-22,115,7,37,216,253,31,53,84,337,17,76,Ohio,Cambridge,10635
15565,2004-2005,2004-12-01,2005-03-12,102,9,32,180,212,23,48,71,283,15,89,Ohio,Cambridge,10635
15566,2005-2006,2005-11-24,2006-03-07,104,0,21,145,166,14,14,28,194,10,39,Ohio,Cambridge,10635
15567,2006-2007,2006-12-01,2007-04-08,129,5,48,222,270,36,79,115,385,19,117,Ohio,Cambridge,10635
15568,2007-2008,2007-12-01,2008-03-12,103,5,29,186,215,49,73,122,337,23,140,Ohio,Cambridge,10635
15569,2008-2009,2008-11-17,2009-03-03,107,6,47,260,307,22,68,90,397,15,79,Ohio,Cambridge,10635
15570,2009-2010,2009-12-01,2010-03-07,97,0,43,214,257,63,229,292,549,22,132,Ohio,Cambridge,10635
15571,2010-2011,2010-12-01,2011-03-11,101,2,50,237,287,31,102,133,420,13,68,Ohio,Cambridge,10635
15572,2011-2012,2011-12-01,2012-02-29,91,1,9,116,125,3,7,10,135,1,7,Ohio,Cambridge,10635
15573,2012-2013,2012-12-01,2013-03-25,115,7,26,176,202,26,99,125,327,9,48,Ohio,Cambridge,10635
15574,2013-2014,2013-11-12,2014-03-30,139,5,65,335,400,46,131,177,577,15,106,Ohio,Cambridge,10635
15575,2014-2015,2014-11-18,2015-03-24,127,2,60,282,342,33,97,130,472,16,104,Ohio,Cambridge,10635
15576,2015-2016,2015-12-01,2016-02-29,91,9,24,157,181,3,28,31,212,1,11,Ohio,Cambridge,10635
15577,2016-2017,2016-11-20,2017-03-15,116,7,20,142,162,4,9,13,175,2,7,Ohio,Cambridge,10635
15578,2017-2018,2017-12-01,2018-02-28,90,11,53,194,247,3,63,66,313,1,9,Ohio,Cambridge,10635
15579,2018-2019,2018-11-28,2019-03-06,99,4,31,189,220,19,29,48,268,5,48,Ohio,Cambridge,10635
15580,2019-2020,2019-11-13,2020-03-15,124,5,13,187,200,9,9,18,218,5,14,Ohio,Cambridge,10635
15581,1950-1951,1950-11-10,1951-03-25,136,0,62,264,326,69,103,172,498,33,206,Ohio,Cincinnati,296943
15582,1951-1952,1951-11-02,1952-03-02,122,0,27,167,194,30,33,63,257,20,72,Ohio,Cincinnati,296943
15583,1952-1953,1952-11-28,1953-04-19,143,0,15,120,135,40,26,66,201,17,78,Ohio,Cincinnati,296943
15584,1953-1954,1953-11-25,1954-03-15,111,0,21,149,170,21,18,39,209,14,44,Ohio,Cincinnati,296943
15585,1954-1955,1954-11-02,1955-03-27,146,0,33,186,219,41,35,76,295,31,113,Ohio,Cincinnati,296943
15586,1955-1956,1955-11-18,1956-04-08,143,0,25,219,244,44,54,98,342,25,96,Ohio,Cincinnati,296943
15587,1956-1957,1956-11-21,1957-04-08,139,0,24,159,183,30,11,41,224,27,89,Ohio,Cincinnati,296943
15588,1957-1958,1957-11-30,1958-03-20,111,0,48,208,256,37,19,56,312,24,107,Ohio,Cincinnati,296943
15589,1958-1959,1958-11-28,1959-04-12,136,0,46,258,304,49,54,103,407,22,114,Ohio,Cincinnati,296943
15590,1959-1960,1959-11-24,1960-03-22,120,0,37,212,249,58,61,119,368,39,164,Ohio,Cincinnati,296943
15591,1960-1961,1960-11-30,1961-04-17,139,0,46,207,253,54,93,147,400,28,167,Ohio,Cincinnati,296943
15592,1961-1962,1961-11-19,1962-04-01,134,0,44,213,257,42,38,80,337,22,111,Ohio,Cincinnati,296943
15593,1962-1963,1962-10-25,1963-03-21,148,0,74,363,437,43,57,100,537,29,161,Ohio,Cincinnati,296943
15594,1963-1964,1963-11-13,1964-03-29,138,0,48,281,329,55,66,121,450,31,139,Ohio,Cincinnati,296943
15595,1964-1965,1964-11-20,1965-03-26,127,0,43,283,326,36,59,95,421,22,129,Ohio,Cincinnati,296943
15596,1965-1966,1965-11-29,1966-04-05,128,0,50,215,265,35,69,104,369,15,95,Ohio,Cincinnati,296943
15597,1966-1967,1966-11-02,1967-03-20,139,0,36,231,267,50,34,84,351,24,113,Ohio,Cincinnati,296943
15598,1967-1968,1967-11-05,1968-03-24,141,0,45,264,309,51,62,113,422,25,132,Ohio,Cincinnati,296943
15599,1968-1969,1968-11-12,1969-03-26,135,0,33,210,243,20,1,21,264,18,55,Ohio,Cincinnati,296943
15600,1969-1970,1969-11-14,1970-03-29,136,0,56,274,330,55,79,134,464,35,179,Ohio,Cincinnati,296943
15601,1970-1971,1970-11-14,1971-03-26,133,0,46,227,273,44,41,85,358,22,106,Ohio,Cincinnati,296943
15602,1971-1972,1971-11-06,1972-04-02,149,0,32,237,269,28,28,56,325,18,79,Ohio,Cincinnati,296943
15603,1972-1973,1972-11-22,1973-04-10,140,0,25,169,194,29,12,41,235,17,56,Ohio,Cincinnati,296943
15604,1973-1974,1973-11-05,1974-04-08,155,0,32,182,214,22,13,35,249,16,73,Ohio,Cincinnati,296943
15605,1974-1975,1974-11-30,1975-04-03,125,0,12,149,161,37,19,56,217,24,79,Ohio,Cincinnati,296943
15606,1975-1976,1975-11-13,1976-03-16,125,0,23,195,218,25,20,45,263,18,70,Ohio,Cincinnati,296943
15607,1976-1977,1976-11-22,1977-04-06,136,0,106,400,506,72,216,288,794,35,222,Ohio,Cincinnati,296943
15608,1977-1978,1977-11-26,1978-03-16,111,0,116,390,506,83,304,387,893,38,264,Ohio,Cincinnati,296943
15609,1978-1979,1978-12-01,1979-04-07,128,0,78,300,378,49,142,191,569,28,180,Ohio,Cincinnati,296943
15610,1979-1980,1979-11-28,1980-03-17,111,0,53,242,295,50,89,139,434,25,144,Ohio,Cincinnati,296943
15611,1980-1981,1980-11-17,1981-03-19,123,0,57,267,324,26,35,61,385,18,76,Ohio,Cincinnati,296943
15612,1981-1982,1981-11-20,1982-04-09,141,0,65,298,363,41,62,103,466,23,145,Ohio,Cincinnati,296943
15613,1982-1983,1982-12-01,1983-03-21,111,0,19,124,143,14,10,24,167,11,31,Ohio,Cincinnati,296943
15614,1983-1984,1983-12-01,1984-03-22,113,0,80,279,359,34,39,73,432,25,118,Ohio,Cincinnati,296943
15615,1984-1985,1984-11-18,1985-04-07,141,0,58,236,294,55,173,228,522,27,153,Ohio,Cincinnati,296943
15616,1985-1986,1985-12-01,1986-03-07,97,0,47,228,275,36,37,73,348,23,116,Ohio,Cincinnati,296943
15617,1986-1987,1986-11-13,1987-04-05,144,0,17,163,180,26,13,39,219,14,51,Ohio,Cincinnati,296943
15618,1987-1988,1987-11-20,1988-03-18,120,0,44,237,281,25,16,41,322,20,110,Ohio,Cincinnati,296943
15619,1988-1989,1988-11-06,1989-05-06,182,0,19,181,200,19,7,26,226,16,57,Ohio,Cincinnati,296943
15620,1989-1990,1989-10-19,1990-03-25,158,0,42,221,263,47,80,127,390,19,117,Ohio,Cincinnati,296943
15621,1990-1991,1990-12-01,1991-02-28,90,0,20,131,151,28,14,42,193,16,85,Ohio,Cincinnati,296943
15622,1991-1992,1991-11-04,1992-04-04,153,0,15,173,188,26,8,34,222,21,73,Ohio,Cincinnati,296943
15623,1992-1993,1992-11-05,1993-03-18,134,1,29,191,220,46,50,96,316,23,99,Ohio,Cincinnati,296943
15624,1993-1994,1993-10-30,1994-04-03,156,0,60,247,307,52,73,125,432,25,136,Ohio,Cincinnati,296943
15625,1994-1995,1994-12-01,1995-03-10,100,0,31,173,204,38,88,126,330,16,86,Ohio,Cincinnati,296943
15626,1995-1996,1995-11-13,1996-04-07,147,0,72,300,372,72,83,155,527,38,221,Ohio,Cincinnati,296943
15627,1996-1997,1996-11-09,1997-02-28,112,0,36,192,228,23,6,29,257,17,69,Ohio,Cincinnati,296943
15628,1997-1998,1997-11-15,1998-03-21,127,0,9,122,131,50,42,92,223,21,86,Ohio,Cincinnati,296943
15629,1998-1999,1998-12-01,1999-03-16,106,0,28,178,206,41,56,97,303,20,121,Ohio,Cincinnati,296943
15630,1999-2000,1999-12-01,2000-04-04,126,0,33,187,220,25,58,83,303,19,97,Ohio,Cincinnati,296943
15631,2000-2001,2000-11-21,2001-04-17,148,0,44,252,296,33,56,89,385,24,119,Ohio,Cincinnati,296943
15632,2001-2002,2001-12-01,2002-04-06,127,0,12,157,169,17,14,31,200,11,50,Ohio,Cincinnati,296943
15633,2002-2003,2002-11-26,2003-03-10,105,0,49,225,274,50,107,157,431,29,134,Ohio,Cincinnati,296943
15634,2003-2004,2003-11-28,2004-04-13,138,0,28,191,219,35,50,85,304,17,78,Ohio,Cincinnati,296943
15635,2004-2005,2004-12-01,2005-04-24,145,0,27,184,211,39,81,120,331,22,91,Ohio,Cincinnati,296943
15636,2005-2006,2005-11-17,2006-03-22,126,0,21,164,185,31,28,59,244,17,65,Ohio,Cincinnati,296943
15637,2006-2007,2006-12-01,2007-04-06,127,0,42,204,246,29,60,89,335,15,91,Ohio,Cincinnati,296943
15638,2007-2008,2007-12-01,2008-03-19,110,3,30,188,218,42,37,79,297,23,113,Ohio,Cincinnati,296943
15639,2008-2009,2008-12-01,2009-03-03,93,0,43,214,257,36,64,100,357,19,109,Ohio,Cincinnati,296943
15640,2009-2010,2009-12-01,2010-02-28,90,0,44,201,245,62,145,207,452,27,154,Ohio,Cincinnati,296943
15641,2010-2011,2010-11-26,2011-03-30,125,0,50,224,274,58,123,181,455,33,149,Ohio,Cincinnati,296943
15642,2011-2012,2011-11-29,2012-03-05,98,0,10,107,117,11,4,15,132,10,35,Ohio,Cincinnati,296943
15643,2012-2013,2012-12-01,2013-03-26,116,0,25,161,186,43,38,81,267,28,99,Ohio,Cincinnati,296943
15644,2013-2014,2013-11-12,2014-04-15,155,0,56,311,367,78,119,197,564,41,231,Ohio,Cincinnati,296943
15645,2014-2015,2014-11-13,2015-03-07,115,0,51,258,309,47,90,137,446,19,128,Ohio,Cincinnati,296943
15646,2015-2016,2015-12-01,2016-03-04,95,0,26,132,158,29,34,63,221,14,83,Ohio,Cincinnati,296943
15647,2016-2017,2016-12-01,2017-03-17,107,0,22,130,152,19,6,25,177,14,46,Ohio,Cincinnati,296943
15648,2017-2018,2017-12-01,2018-04-16,137,0,50,216,266,41,40,81,347,28,123,Ohio,Cincinnati,296943
15649,2018-2019,2018-11-10,2019-03-08,119,0,29,163,192,39,47,86,278,24,107,Ohio,Cincinnati,296943
15650,2019-2020,2019-11-11,2020-02-29,111,0,7,107,114,22,9,31,145,15,46,Ohio,Cincinnati,296943
15651,1950-1951,1950-11-11,1951-04-17,158,0,75,292,367,119,245,364,731,50,301,Ohio,Cleveland,396815
15652,1951-1952,1951-11-02,1952-04-07,158,0,50,247,297,115,129,244,541,50,250,Ohio,Cleveland,396815
15653,1952-1953,1952-10-20,1953-04-21,184,0,22,177,199,58,43,101,300,39,144,Ohio,Cleveland,396815
15654,1953-1954,1953-11-05,1954-04-03,150,0,41,214,255,107,107,214,469,52,241,Ohio,Cleveland,396815
15655,1954-1955,1954-10-16,1955-03-30,166,0,54,237,291,81,97,178,469,46,236,Ohio,Cleveland,396815
15656,1955-1956,1955-11-17,1956-04-18,154,2,52,260,312,91,136,227,539,52,229,Ohio,Cleveland,396815
15657,1956-1957,1956-11-21,1957-04-13,144,0,51,225,276,90,126,216,492,51,221,Ohio,Cleveland,396815
15658,1957-1958,1957-10-27,1958-04-07,163,0,65,229,294,56,65,121,415,39,177,Ohio,Cleveland,396815
15659,1958-1959,1958-11-26,1959-03-22,117,0,93,322,415,85,172,257,672,46,267,Ohio,Cleveland,396815
15660,1959-1960,1959-11-12,1960-04-09,150,0,68,270,338,88,178,266,604,59,257,Ohio,Cleveland,396815
15661,1960-1961,1960-11-05,1961-04-18,165,0,95,335,430,64,148,212,642,42,224,Ohio,Cleveland,396815
15662,1961-1962,1961-11-17,1962-04-15,150,0,87,313,400,62,63,125,525,38,194,Ohio,Cleveland,396815
15663,1962-1963,1962-10-25,1963-05-01,189,0,130,419,549,113,341,454,1003,53,378,Ohio,Cleveland,396815
15664,1963-1964,1963-11-29,1964-04-09,133,0,88,287,375,91,168,259,634,51,261,Ohio,Cleveland,396815
15665,1964-1965,1964-11-20,1965-04-02,134,0,81,280,361,86,112,198,559,55,303,Ohio,Cleveland,396815
15666,1965-1966,1965-11-29,1966-04-07,130,0,80,260,340,71,100,171,511,49,252,Ohio,Cleveland,396815
15667,1966-1967,1966-11-03,1967-04-24,173,0,59,256,315,86,128,214,529,52,252,Ohio,Cleveland,396815
15668,1967-1968,1967-10-28,1968-04-25,181,0,87,325,412,71,142,213,625,46,251,Ohio,Cleveland,396815
15669,1968-1969,1968-11-09,1969-04-19,162,0,83,267,350,69,83,152,502,44,200,Ohio,Cleveland,396815
15670,1969-1970,1969-10-22,1970-04-02,163,0,106,323,429,94,209,303,732,67,335,Ohio,Cleveland,396815
15671,1970-1971,1970-11-15,1971-04-24,161,0,91,319,410,83,131,214,624,46,283,Ohio,Cleveland,396815
15672,1971-1972,1971-11-04,1972-04-08,157,0,67,276,343,82,81,163,506,55,267,Ohio,Cleveland,396815
15673,1972-1973,1972-10-18,1973-05-04,199,0,43,199,242,106,139,245,487,46,213,Ohio,Cleveland,396815
15674,1973-1974,1973-11-09,1974-05-07,180,0,50,209,259,101,139,240,499,56,249,Ohio,Cleveland,396815
15675,1974-1975,1974-10-02,1975-04-15,196,0,39,214,253,109,111,220,473,56,219,Ohio,Cleveland,396815
15676,1975-1976,1975-11-13,1976-04-04,144,0,64,240,304,89,143,232,536,49,252,Ohio,Cleveland,396815
15677,1976-1977,1976-10-26,1977-04-06,163,0,141,472,613,114,322,436,1049,73,494,Ohio,Cleveland,396815
15678,1977-1978,1977-11-11,1978-04-21,162,0,108,436,544,138,449,587,1131,56,421,Ohio,Cleveland,396815
15679,1978-1979,1978-11-27,1979-04-09,134,0,92,324,416,68,209,277,693,43,251,Ohio,Cleveland,396815
15680,1979-1980,1979-10-25,1980-03-18,146,0,87,298,385,67,163,230,615,39,224,Ohio,Cleveland,396815
15681,1980-1981,1980-11-17,1981-03-21,125,0,90,306,396,95,212,307,703,53,323,Ohio,Cleveland,396815
15682,1981-1982,1981-10-19,1982-04-10,174,0,90,347,437,150,252,402,839,62,407,Ohio,Cleveland,396815
15683,1982-1983,1982-11-15,1983-04-19,156,0,28,171,199,58,82,140,339,31,131,Ohio,Cleveland,396815
15684,1983-1984,1983-11-11,1984-03-29,140,0,121,341,462,126,250,376,838,52,342,Ohio,Cleveland,396815
15685,1984-1985,1984-11-11,1985-04-09,150,0,88,290,378,96,222,318,696,48,292,Ohio,Cleveland,396815
15686,1985-1986,1985-12-01,1986-04-11,132,0,80,286,366,90,164,254,620,52,312,Ohio,Cleveland,396815
15687,1986-1987,1986-11-11,1987-04-05,146,0,35,232,267,88,113,201,468,36,168,Ohio,Cleveland,396815
15688,1987-1988,1987-11-20,1988-04-16,149,0,63,274,337,107,127,234,571,52,281,Ohio,Cleveland,396815
15689,1988-1989,1988-11-06,1989-04-18,164,0,48,237,285,83,82,165,450,44,212,Ohio,Cleveland,396815
15690,1989-1990,1989-11-03,1990-04-12,161,0,62,274,336,93,127,220,556,43,236,Ohio,Cleveland,396815
15691,1990-1991,1990-12-01,1991-03-11,101,0,32,178,210,78,90,168,378,41,202,Ohio,Cleveland,396815
15692,1991-1992,1991-11-04,1992-04-03,152,0,37,216,253,103,106,209,462,51,243,Ohio,Cleveland,396815
15693,1992-1993,1992-11-05,1993-04-21,168,0,44,225,269,129,162,291,560,51,246,Ohio,Cleveland,396815
15694,1993-1994,1993-10-31,1994-04-07,159,0,97,329,426,115,221,336,762,56,320,Ohio,Cleveland,396815
15695,1994-1995,1994-12-01,1995-04-01,122,0,39,212,251,68,121,189,440,30,169,Ohio,Cleveland,396815
15696,1995-1996,1995-11-08,1996-04-23,168,1,113,350,463,148,251,399,862,63,410,Ohio,Cleveland,396815
15697,1996-1997,1996-11-02,1997-04-17,167,0,60,243,303,89,85,174,477,46,230,Ohio,Cleveland,396815
15698,1997-1998,1997-11-13,1998-03-24,132,0,25,141,166,58,45,103,269,35,122,Ohio,Cleveland,396815
15699,1998-1999,1998-11-21,1999-03-16,116,0,54,209,263,92,135,227,490,37,239,Ohio,Cleveland,396815
15700,1999-2000,1999-11-03,2000-04-09,159,0,55,226,281,88,145,233,514,39,218,Ohio,Cleveland,396815
15701,2000-2001,2000-10-08,2001-04-17,192,0,78,285,363,119,176,295,658,56,313,Ohio,Cleveland,396815
15702,2001-2002,2001-10-26,2002-04-06,163,0,30,160,190,73,63,136,326,35,162,Ohio,Cleveland,396815
15703,2002-2003,2002-11-22,2003-04-05,135,0,88,290,378,144,239,383,761,60,376,Ohio,Cleveland,396815
15704,2003-2004,2003-10-02,2004-04-27,209,0,63,243,306,130,179,309,615,59,286,Ohio,Cleveland,396815
15705,2004-2005,2004-11-25,2005-04-25,152,0,67,250,317,166,257,423,740,49,304,Ohio,Cleveland,396815
15706,2005-2006,2005-11-17,2006-04-05,140,0,44,189,233,78,116,194,427,41,172,Ohio,Cleveland,396815
15707,2006-2007,2006-11-02,2007-04-14,164,0,84,256,340,112,168,280,620,49,307,Ohio,Cleveland,396815
15708,2007-2008,2007-11-22,2008-03-25,125,0,51,240,291,109,166,275,566,44,245,Ohio,Cleveland,396815
15709,2008-2009,2008-10-29,2009-04-07,161,0,82,309,391,123,233,356,747,53,313,Ohio,Cleveland,396815
15710,2009-2010,2009-11-27,2010-03-25,119,0,46,186,232,86,286,372,604,41,198,Ohio,Cleveland,396815
15711,2010-2011,2010-12-01,2011-03-31,121,0,79,261,340,105,232,337,677,46,246,Ohio,Cleveland,396815
15712,2011-2012,2011-11-11,2012-04-11,153,0,19,120,139,64,50,114,253,34,133,Ohio,Cleveland,396815
15713,2012-2013,2012-11-24,2013-04-20,148,0,51,202,253,83,110,193,446,44,215,Ohio,Cleveland,396815
15714,2013-2014,2013-11-08,2014-04-15,159,0,103,361,464,124,259,383,847,61,376,Ohio,Cleveland,396815
15715,2014-2015,2014-11-13,2015-04-23,162,0,117,370,487,96,279,375,862,42,294,Ohio,Cleveland,396815
15716,2015-2016,2015-10-17,2016-04-10,177,0,41,185,226,54,75,129,355,32,146,Ohio,Cleveland,396815
15717,2016-2017,2016-11-19,2017-04-07,140,0,33,138,171,59,45,104,275,36,139,Ohio,Cleveland,396815
15718,2017-2018,2017-11-10,2018-04-19,161,0,72,267,339,88,144,232,571,53,252,Ohio,Cleveland,396815
15719,2018-2019,2018-11-09,2019-04-01,144,0,48,205,253,66,58,124,377,44,182,Ohio,Cleveland,396815
15720,2019-2020,2019-11-07,2020-05-11,187,0,15,144,159,55,43,98,257,37,110,Ohio,Cleveland,396815
15721,1950-1951,1950-11-23,1951-03-21,119,0,69,279,348,62,144,206,554,27,175,Ohio,Columbus,787033
15722,1951-1952,1951-11-01,1952-03-09,130,0,29,208,237,41,53,94,331,23,80,Ohio,Columbus,787033
15723,1952-1953,1952-11-28,1953-04-21,145,0,20,168,188,47,25,72,260,24,111,Ohio,Columbus,787033
15724,1953-1954,1953-11-07,1954-04-04,149,0,18,206,224,38,30,68,292,21,78,Ohio,Columbus,787033
15725,1954-1955,1954-10-31,1955-03-27,148,0,41,234,275,44,38,82,357,36,135,Ohio,Columbus,787033
15726,1955-1956,1955-11-18,1956-04-16,151,0,29,252,281,54,62,116,397,31,131,Ohio,Columbus,787033
15727,1956-1957,1956-11-21,1957-04-09,140,0,27,205,232,47,29,76,308,35,149,Ohio,Columbus,787033
15728,1957-1958,1957-12-01,1958-03-20,110,0,49,223,272,42,29,71,343,23,121,Ohio,Columbus,787033
15729,1958-1959,1958-11-28,1959-04-12,136,0,67,315,382,45,88,133,515,22,100,Ohio,Columbus,787033
15730,1959-1960,1959-11-25,1960-03-26,123,0,50,232,282,49,74,123,405,31,132,Ohio,Columbus,787033
15731,1960-1961,1960-11-29,1961-04-17,140,0,63,276,339,61,197,258,597,26,155,Ohio,Columbus,787033
15732,1961-1962,1961-11-19,1962-04-20,153,0,66,300,366,59,91,150,516,28,152,Ohio,Columbus,787033
15733,1962-1963,1962-10-25,1963-03-21,148,0,95,374,469,57,116,173,642,35,206,Ohio,Columbus,787033
15734,1963-1964,1963-11-13,1964-03-31,140,0,69,296,365,57,93,150,515,28,148,Ohio,Columbus,787033
15735,1964-1965,1964-11-21,1965-03-25,125,0,64,268,332,56,59,115,447,34,169,Ohio,Columbus,787033
15736,1965-1966,1965-11-28,1966-04-09,133,0,62,245,307,33,76,109,416,22,111,Ohio,Columbus,787033
15737,1966-1967,1966-11-02,1967-03-20,139,0,46,237,283,72,70,142,425,31,155,Ohio,Columbus,787033
15738,1967-1968,1967-11-05,1968-03-24,141,0,69,301,370,53,78,131,501,29,134,Ohio,Columbus,787033
15739,1968-1969,1968-11-09,1969-04-19,162,0,50,267,317,35,9,44,361,27,107,Ohio,Columbus,787033
15740,1969-1970,1969-11-13,1970-04-06,145,0,84,334,418,73,122,195,613,49,271,Ohio,Columbus,787033
15741,1970-1971,1970-11-15,1971-03-23,129,0,67,257,324,57,46,103,427,33,161,Ohio,Columbus,787033
15742,1971-1972,1971-11-06,1972-04-08,155,0,50,283,333,44,31,75,408,31,131,Ohio,Columbus,787033
15743,1972-1973,1972-11-26,1973-04-12,138,0,32,166,198,40,18,58,256,17,70,Ohio,Columbus,787033
15744,1973-1974,1973-12-01,1974-04-08,129,0,38,189,227,30,43,73,300,19,91,Ohio,Columbus,787033
15745,1974-1975,1974-11-13,1975-03-26,134,0,26,168,194,42,18,60,254,30,100,Ohio,Columbus,787033
15746,1975-1976,1975-11-25,1976-03-17,114,0,51,209,260,34,32,66,326,21,100,Ohio,Columbus,787033
15747,1976-1977,1976-11-08,1977-04-05,149,0,139,428,567,59,243,302,869,34,215,Ohio,Columbus,787033
15748,1977-1978,1977-11-26,1978-03-16,111,0,132,374,506,87,330,417,923,40,294,Ohio,Columbus,787033
15749,1978-1979,1978-11-26,1979-04-09,135,0,94,314,408,63,187,250,658,34,187,Ohio,Columbus,787033
15750,1979-1980,1979-11-28,1980-03-17,111,0,55,230,285,32,27,59,344,21,97,Ohio,Columbus,787033
15751,1980-1981,1980-11-17,1981-03-20,124,0,60,262,322,53,109,162,484,32,124,Ohio,Columbus,787033
15752,1981-1982,1981-11-21,1982-04-09,140,0,76,311,387,66,96,162,549,40,245,Ohio,Columbus,787033
15753,1982-1983,1982-12-01,1983-04-18,139,0,21,172,193,23,18,41,234,18,61,Ohio,Columbus,787033
15754,1983-1984,1983-11-11,1984-04-18,160,0,83,305,388,60,112,172,560,34,163,Ohio,Columbus,787033
15755,1984-1985,1984-11-18,1985-04-08,142,0,72,272,344,62,233,295,639,28,203,Ohio,Columbus,787033
15756,1985-1986,1985-12-01,1986-03-21,111,0,53,233,286,46,44,90,376,31,146,Ohio,Columbus,787033
15757,1986-1987,1986-11-11,1987-04-06,147,0,19,177,196,43,20,63,259,20,69,Ohio,Columbus,787033
15758,1987-1988,1987-11-20,1988-03-20,122,0,48,242,290,54,31,85,375,44,209,Ohio,Columbus,787033
15759,1988-1989,1988-11-06,1989-05-07,183,0,27,223,250,34,15,49,299,25,90,Ohio,Columbus,787033
15760,1989-1990,1989-10-19,1990-04-11,175,0,57,257,314,43,73,116,430,29,139,Ohio,Columbus,787033
15761,1990-1991,1990-12-01,1991-03-14,104,0,20,159,179,26,25,51,230,19,91,Ohio,Columbus,787033
15762,1991-1992,1991-11-04,1992-04-04,153,0,21,190,211,38,39,77,288,26,89,Ohio,Columbus,787033
15763,1992-1993,1992-11-05,1993-04-02,149,0,31,195,226,51,57,108,334,32,110,Ohio,Columbus,787033
15764,1993-1994,1993-10-30,1994-04-07,160,0,69,284,353,66,108,174,527,41,202,Ohio,Columbus,787033
15765,1994-1995,1994-12-01,1995-03-10,100,0,41,201,242,36,83,119,361,23,110,Ohio,Columbus,787033
15766,1995-1996,1995-11-11,1996-04-16,158,0,75,308,383,90,132,222,605,49,261,Ohio,Columbus,787033
15767,1996-1997,1996-11-09,1997-03-15,127,1,42,201,243,16,6,22,265,14,56,Ohio,Columbus,787033
15768,1997-1998,1997-11-04,1998-03-23,140,0,11,118,129,21,7,28,157,19,52,Ohio,Columbus,787033
15769,1998-1999,1998-12-01,1999-03-15,105,0,33,171,204,63,122,185,389,28,154,Ohio,Columbus,787033
15770,1999-2000,1999-11-02,2000-04-04,155,0,39,205,244,50,123,173,417,30,134,Ohio,Columbus,787033
15771,2000-2001,2000-11-14,2001-04-17,155,0,56,257,313,53,72,125,438,41,194,Ohio,Columbus,787033
15772,2001-2002,2001-12-01,2002-04-03,124,0,22,139,161,21,8,29,190,17,66,Ohio,Columbus,787033
15773,2002-2003,2002-11-22,2003-03-10,109,0,63,252,315,80,99,179,494,46,220,Ohio,Columbus,787033
15774,2003-2004,2003-11-24,2004-04-04,133,0,50,211,261,47,40,87,348,32,145,Ohio,Columbus,787033
15775,2004-2005,2004-11-25,2005-04-24,151,0,44,211,255,61,67,128,383,35,148,Ohio,Columbus,787033
15776,2005-2006,2005-11-17,2006-03-25,129,0,28,159,187,27,25,52,239,22,60,Ohio,Columbus,787033
15777,2006-2007,2006-11-20,2007-04-07,139,0,53,208,261,42,57,99,360,25,121,Ohio,Columbus,787033
15778,2007-2008,2007-12-01,2008-03-19,110,0,30,181,211,72,70,142,353,30,160,Ohio,Columbus,787033
15779,2008-2009,2008-11-17,2009-04-06,141,0,58,251,309,38,87,125,434,22,118,Ohio,Columbus,787033
15780,2009-2010,2009-12-01,2010-03-26,116,0,53,207,260,79,177,256,516,35,193,Ohio,Columbus,787033
15781,2010-2011,2010-12-01,2011-03-30,120,0,59,228,287,51,94,145,432,36,148,Ohio,Columbus,787033
15782,2011-2012,2011-12-01,2012-03-05,96,0,15,103,118,23,14,37,155,16,63,Ohio,Columbus,787033
15783,2012-2013,2012-10-30,2013-03-27,149,0,31,181,212,60,92,152,364,31,137,Ohio,Columbus,787033
15784,2013-2014,2013-11-11,2014-04-15,156,0,69,323,392,87,159,246,638,42,235,Ohio,Columbus,787033
15785,2014-2015,2014-11-16,2015-03-24,129,0,82,303,385,46,117,163,548,22,139,Ohio,Columbus,787033
15786,2015-2016,2015-12-01,2016-04-09,131,0,35,161,196,28,29,57,253,17,92,Ohio,Columbus,787033
15787,2016-2017,2016-12-01,2017-03-17,107,0,27,138,165,19,12,31,196,15,54,Ohio,Columbus,787033
15788,2017-2018,2017-12-01,2018-04-19,140,0,61,234,295,51,65,116,411,34,148,Ohio,Columbus,787033
15789,2018-2019,2018-11-15,2019-03-06,112,0,39,167,206,49,48,97,303,29,137,Ohio,Columbus,787033
15790,2019-2020,2019-11-11,2020-03-14,125,0,15,140,155,21,13,34,189,16,45,Ohio,Columbus,787033
15791,1950-1951,1950-11-10,1951-03-21,132,3,83,304,387,86,157,243,630,36,242,Ohio,Dayton,141527
15792,1951-1952,1951-11-02,1952-03-09,129,6,39,210,249,40,57,97,346,20,96,Ohio,Dayton,141527
15793,1952-1953,1952-11-28,1953-04-20,144,0,23,162,185,36,26,62,247,23,102,Ohio,Dayton,141527
15794,1953-1954,1953-11-25,1954-04-04,131,0,28,193,221,33,33,66,287,21,85,Ohio,Dayton,141527
15795,1954-1955,1954-10-30,1955-03-28,150,0,45,223,268,46,44,90,358,34,127,Ohio,Dayton,141527
15796,1955-1956,1955-11-18,1956-04-07,142,0,44,263,307,50,73,123,430,29,130,Ohio,Dayton,141527
15797,1956-1957,1956-11-22,1957-04-13,143,0,35,217,252,33,30,63,315,26,120,Ohio,Dayton,141527
15798,1957-1958,1957-10-27,1958-03-21,146,0,60,248,308,40,32,72,380,23,91,Ohio,Dayton,141527
15799,1958-1959,1958-11-28,1959-03-17,110,0,79,315,394,52,87,139,533,26,150,Ohio,Dayton,141527
15800,1959-1960,1959-11-18,1960-04-09,144,0,62,266,328,56,80,136,464,35,162,Ohio,Dayton,141527
15801,1960-1961,1960-11-06,1961-04-17,163,0,76,286,362,65,158,223,585,37,216,Ohio,Dayton,141527
15802,1961-1962,1961-11-19,1962-04-01,134,0,65,287,352,61,83,144,496,28,161,Ohio,Dayton,141527
15803,1962-1963,1962-10-25,1963-03-21,148,0,102,377,479,56,102,158,637,33,228,Ohio,Dayton,141527
15804,1963-1964,1963-11-13,1964-03-30,139,0,56,293,349,66,106,172,521,28,144,Ohio,Dayton,141527
15805,1964-1965,1964-11-19,1965-03-26,128,0,56,273,329,43,58,101,430,26,140,Ohio,Dayton,141527
15806,1965-1966,1965-11-29,1966-04-09,132,0,61,248,309,36,58,94,403,22,117,Ohio,Dayton,141527
15807,1966-1967,1966-11-02,1967-03-21,140,0,47,251,298,60,69,129,427,32,157,Ohio,Dayton,141527
15808,1967-1968,1967-11-04,1968-03-25,143,0,58,323,381,57,79,136,517,26,144,Ohio,Dayton,141527
15809,1968-1969,1968-11-11,1969-04-19,160,0,45,262,307,26,6,32,339,23,74,Ohio,Dayton,141527
15810,1969-1970,1969-11-14,1970-03-29,136,0,74,301,375,69,119,188,563,41,213,Ohio,Dayton,141527
15811,1970-1971,1970-11-14,1971-03-24,131,0,60,263,323,47,37,84,407,29,141,Ohio,Dayton,141527
15812,1971-1972,1971-11-06,1972-04-08,155,0,51,285,336,42,39,81,417,30,142,Ohio,Dayton,141527
15813,1972-1973,1972-11-22,1973-04-12,142,0,31,207,238,34,24,58,296,22,80,Ohio,Dayton,141527
15814,1973-1974,1973-12-01,1974-04-09,130,0,47,220,267,46,96,142,409,25,135,Ohio,Dayton,141527
15815,1974-1975,1974-11-14,1975-03-28,135,0,20,165,185,68,87,155,340,38,140,Ohio,Dayton,141527
15816,1975-1976,1975-11-13,1976-03-16,125,0,40,214,254,39,53,92,346,28,113,Ohio,Dayton,141527
15817,1976-1977,1976-11-12,1977-04-05,145,0,119,416,535,65,276,341,876,38,230,Ohio,Dayton,141527
15818,1977-1978,1977-11-12,1978-03-15,124,0,119,406,525,97,378,475,1000,39,288,Ohio,Dayton,141527
15819,1978-1979,1978-12-01,1979-03-25,115,0,93,315,408,65,184,249,657,31,212,Ohio,Dayton,141527
15820,1979-1980,1979-11-28,1980-03-17,111,0,61,266,327,40,63,103,430,24,133,Ohio,Dayton,141527
15821,1980-1981,1980-11-17,1981-03-20,124,0,61,275,336,41,73,114,450,29,130,Ohio,Dayton,141527
15822,1981-1982,1981-11-20,1982-04-10,142,0,78,330,408,69,122,191,599,37,237,Ohio,Dayton,141527
15823,1982-1983,1982-11-05,1983-04-17,164,0,29,195,224,17,6,23,247,16,65,Ohio,Dayton,141527
15824,1983-1984,1983-12-01,1984-03-25,116,0,110,316,426,65,95,160,586,34,189,Ohio,Dayton,141527
15825,1984-1985,1984-11-18,1985-04-09,143,0,90,293,383,56,198,254,637,28,184,Ohio,Dayton,141527
15826,1985-1986,1985-12-01,1986-04-16,137,0,64,270,334,49,50,99,433,35,168,Ohio,Dayton,141527
15827,1986-1987,1986-11-11,1987-04-05,146,0,31,201,232,32,19,51,283,16,65,Ohio,Dayton,141527
15828,1987-1988,1987-11-20,1988-03-20,122,0,55,252,307,35,28,63,370,28,131,Ohio,Dayton,141527
15829,1988-1989,1988-11-06,1989-04-09,155,0,38,220,258,33,21,54,312,26,110,Ohio,Dayton,141527
15830,1989-1990,1989-10-18,1990-04-11,176,0,64,264,328,43,68,111,439,27,144,Ohio,Dayton,141527
15831,1990-1991,1990-12-01,1991-03-14,104,0,28,170,198,24,22,46,244,18,79,Ohio,Dayton,141527
15832,1991-1992,1991-11-03,1992-04-04,154,0,30,223,253,34,31,65,318,25,119,Ohio,Dayton,141527
15833,1992-1993,1992-10-20,1993-03-18,150,0,41,229,270,50,64,114,384,31,114,Ohio,Dayton,141527
15834,1993-1994,1993-10-30,1994-04-07,160,0,84,306,390,73,83,156,546,41,246,Ohio,Dayton,141527
15835,1994-1995,1994-12-01,1995-04-24,145,0,50,215,265,32,57,89,354,22,92,Ohio,Dayton,141527
15836,1997-1998,1997-11-15,1998-03-23,129,0,21,143,164,20,5,25,189,13,55,Ohio,Dayton,141527
15837,1998-1999,1998-12-01,1999-03-14,104,0,43,202,245,45,94,139,384,18,130,Ohio,Dayton,141527
15838,1999-2000,1999-12-01,2000-03-12,103,2,45,212,257,41,97,138,395,16,116,Ohio,Dayton,141527
15839,2000-2001,2000-11-21,2001-04-17,148,0,62,291,353,29,68,97,450,22,119,Ohio,Dayton,141527
15840,2001-2002,2001-12-01,2002-04-05,126,0,26,166,192,15,9,24,216,12,44,Ohio,Dayton,141527
15841,2002-2003,2002-11-22,2003-03-31,130,6,78,293,371,69,109,178,549,34,194,Ohio,Dayton,141527
15842,2003-2004,2003-11-29,2004-03-18,111,0,52,228,280,30,33,63,343,16,87,Ohio,Dayton,141527
15843,2004-2005,2004-12-01,2005-04-24,145,0,58,243,301,55,94,149,450,27,136,Ohio,Dayton,141527
15844,2005-2006,2005-11-17,2006-03-25,129,0,44,213,257,43,65,108,365,25,109,Ohio,Dayton,141527
15845,2006-2007,2006-12-01,2007-04-06,127,0,65,243,308,32,68,100,408,19,121,Ohio,Dayton,141527
15846,2007-2008,2007-11-22,2008-03-22,122,0,47,245,292,66,67,133,425,30,181,Ohio,Dayton,141527
15847,2008-2009,2008-11-09,2009-03-12,124,3,77,296,373,35,62,97,470,23,121,Ohio,Dayton,141527
15848,2009-2010,2009-12-01,2010-03-26,116,0,65,245,310,67,149,216,526,37,205,Ohio,Dayton,141527
15849,2010-2011,2010-12-01,2011-03-30,120,0,73,265,338,45,123,168,506,31,148,Ohio,Dayton,141527
15850,2011-2012,2011-11-29,2012-03-04,97,0,18,142,160,21,9,30,190,18,75,Ohio,Dayton,141527
15851,2012-2013,2012-10-30,2013-04-20,173,0,42,220,262,61,82,143,405,32,147,Ohio,Dayton,141527
15852,2013-2014,2013-10-23,2014-04-15,175,0,83,361,444,85,200,285,729,41,248,Ohio,Dayton,141527
15853,2014-2015,2014-11-13,2015-03-24,132,0,77,305,382,45,102,147,529,26,161,Ohio,Dayton,141527
15854,2015-2016,2015-12-01,2016-04-09,131,0,35,176,211,28,26,54,265,21,105,Ohio,Dayton,141527
15855,2016-2017,2016-12-01,2017-03-17,107,0,38,164,202,19,16,35,237,14,66,Ohio,Dayton,141527
15856,2017-2018,2017-11-10,2018-04-16,158,0,77,288,365,49,70,119,484,33,172,Ohio,Dayton,141527
15857,2018-2019,2018-11-09,2019-03-17,129,0,44,197,241,50,60,110,351,30,156,Ohio,Dayton,141527
15858,2019-2020,2019-11-11,2020-03-15,126,0,16,137,153,28,31,59,212,17,60,Ohio,Dayton,141527
15859,1950-1951,1950-11-05,1951-03-22,138,3,100,368,468,58,152,210,678,36,227,Ohio,Defiance,16494
15860,1951-1952,1951-11-04,1952-03-17,135,0,50,296,346,53,122,175,521,29,174,Ohio,Defiance,16494
15861,1952-1953,1952-11-28,1953-03-09,102,0,33,208,241,31,51,82,323,17,95,Ohio,Defiance,16494
15862,1953-1954,1953-11-26,1954-03-31,126,5,35,262,297,42,57,99,396,21,109,Ohio,Defiance,16494
15863,1954-1955,1954-11-02,1955-03-29,148,1,53,305,358,37,79,116,474,19,104,Ohio,Defiance,16494
15864,1955-1956,1955-11-18,1956-04-24,159,3,57,371,428,50,101,151,579,20,105,Ohio,Defiance,16494
15865,1956-1957,1956-11-23,1957-04-10,139,11,62,308,370,71,130,201,571,27,152,Ohio,Defiance,16494
15866,1957-1958,1957-11-10,1958-03-25,136,1,67,303,370,27,118,145,515,14,67,Ohio,Defiance,16494
15867,1958-1959,1958-11-27,1959-03-18,112,1,99,396,495,31,142,173,668,12,96,Ohio,Defiance,16494
15868,1959-1960,1959-11-13,1960-03-26,135,2,58,349,407,45,149,194,601,14,90,Ohio,Defiance,16494
15869,1960-1961,1960-11-07,1961-04-17,162,0,80,404,484,30,110,140,624,11,89,Ohio,Defiance,16494
15870,1961-1962,1961-11-20,1962-03-16,117,1,87,371,458,55,144,199,657,17,128,Ohio,Defiance,16494
15871,1962-1963,1962-10-25,1963-03-08,135,4,132,492,624,43,188,231,855,22,184,Ohio,Defiance,16494
15872,1963-1964,1963-12-01,1964-03-31,122,1,79,402,481,50,158,208,689,16,111,Ohio,Defiance,16494
15873,1964-1965,1964-11-19,1965-04-02,135,3,88,430,518,63,138,201,719,20,146,Ohio,Defiance,16494
15874,1965-1966,1965-11-29,1966-04-06,129,3,63,327,390,15,41,56,446,9,47,Ohio,Defiance,16494
15875,1966-1967,1966-11-02,1967-03-20,139,3,71,344,415,54,105,159,574,17,105,Ohio,Defiance,16494
15876,1967-1968,1967-11-16,1968-03-25,131,0,82,385,467,35,112,147,614,14,101,Ohio,Defiance,16494
15877,1968-1969,1968-11-21,1969-03-31,131,0,72,343,415,17,51,68,483,8,44,Ohio,Defiance,16494
15878,1969-1970,1969-11-15,1970-03-19,125,0,99,421,520,47,199,246,766,18,111,Ohio,Defiance,16494
15879,1970-1971,1970-11-15,1971-03-24,130,3,81,374,455,36,62,98,553,18,102,Ohio,Defiance,16494
15880,1971-1972,1971-11-23,1972-04-08,138,3,62,389,451,29,61,90,541,14,83,Ohio,Defiance,16494
15881,1972-1973,1972-10-19,1973-04-12,176,3,48,313,361,30,38,68,429,16,76,Ohio,Defiance,16494
15882,1973-1974,1973-12-01,1974-04-08,129,4,71,325,396,57,176,233,629,20,155,Ohio,Defiance,16494
15883,1974-1975,1974-11-14,1975-04-03,141,0,37,318,355,41,104,145,500,17,92,Ohio,Defiance,16494
15884,1975-1976,1975-11-25,1976-03-18,115,0,52,312,364,41,133,174,538,17,100,Ohio,Defiance,16494
15885,1976-1977,1976-11-05,1977-04-06,153,1,146,537,683,50,273,323,1006,19,151,Ohio,Defiance,16494
15886,1977-1978,1977-11-12,1978-03-25,134,3,130,560,690,85,582,667,1357,29,242,Ohio,Defiance,16494
15887,1978-1979,1978-11-27,1979-04-05,130,0,115,425,540,38,226,264,804,23,144,Ohio,Defiance,16494
15888,1979-1980,1979-11-28,1980-03-21,115,0,78,384,462,27,122,149,611,13,88,Ohio,Defiance,16494
15889,1980-1981,1980-10-28,1981-03-20,144,0,89,471,560,45,179,224,784,24,152,Ohio,Defiance,16494
15890,1981-1982,1981-11-23,1982-04-08,137,6,108,556,664,80,303,383,1047,30,269,Ohio,Defiance,16494
15891,1982-1983,1982-12-01,1983-03-26,116,6,31,203,234,13,32,45,279,8,35,Ohio,Defiance,16494
15892,1983-1984,1983-12-01,1984-03-21,112,8,125,408,533,44,212,256,789,20,136,Ohio,Defiance,16494
15893,1986-1987,1986-11-14,1987-03-30,137,14,46,230,276,17,64,81,357,5,30,Ohio,Defiance,16494
15894,1987-1988,1987-12-01,1988-03-21,112,6,75,287,362,23,75,98,460,5,47,Ohio,Defiance,16494
15895,1989-1990,1989-10-19,1990-04-07,171,14,78,300,378,16,80,96,474,13,82,Ohio,Defiance,16494
15896,1990-1991,1990-12-01,1991-03-04,94,16,45,196,241,16,49,65,306,8,55,Ohio,Defiance,16494
15897,1991-1992,1991-11-03,1992-04-01,151,14,42,249,291,20,53,73,364,9,54,Ohio,Defiance,16494
15898,1992-1993,1992-10-21,1993-03-19,150,6,58,266,324,33,115,148,472,18,79,Ohio,Defiance,16494
15899,1993-1994,1993-11-08,1994-04-07,151,10,120,381,501,36,140,176,677,14,116,Ohio,Defiance,16494
15900,1994-1995,1994-12-01,1995-03-10,100,10,63,234,297,21,76,97,394,9,58,Ohio,Defiance,16494
15901,1997-1998,1997-11-14,1998-03-13,120,13,28,143,171,10,17,27,198,7,25,Ohio,Defiance,16494
15902,2001-2002,2001-12-01,2002-03-30,120,12,34,197,231,26,25,51,282,11,60,Ohio,Defiance,16494
15903,2002-2003,2002-11-16,2003-03-31,136,17,106,374,480,72,165,237,717,31,206,Ohio,Defiance,16494
15904,2003-2004,2003-12-01,2004-03-18,109,0,83,277,360,44,163,207,567,26,140,Ohio,Defiance,16494
15905,2004-2005,2004-11-25,2005-04-24,151,6,78,298,376,60,150,210,586,28,165,Ohio,Defiance,16494
15906,2005-2006,2005-11-18,2006-03-17,120,3,54,218,272,26,88,114,386,13,61,Ohio,Defiance,16494
15907,2006-2007,2006-12-01,2007-04-15,136,5,82,292,374,33,94,127,501,13,102,Ohio,Defiance,16494
15908,2007-2008,2007-12-01,2008-03-11,102,11,75,267,342,49,102,151,493,16,128,Ohio,Defiance,16494
15909,2010-2011,2010-11-27,2011-03-10,104,4,99,326,425,49,195,244,669,19,138,Ohio,Defiance,16494
15910,2011-2012,2011-11-30,2012-02-29,92,1,26,154,180,15,19,34,214,8,45,Ohio,Defiance,16494
15911,2012-2013,2012-12-01,2013-03-25,115,1,53,226,279,32,69,101,380,16,90,Ohio,Defiance,16494
15912,2013-2014,2013-11-12,2014-04-15,155,0,153,492,645,108,330,438,1083,38,334,Ohio,Defiance,16494
15913,2014-2015,2014-11-17,2015-03-28,132,4,116,395,511,63,225,288,799,24,217,Ohio,Defiance,16494
15914,2015-2016,2015-11-22,2016-04-09,140,0,44,204,248,22,37,59,307,12,66,Ohio,Defiance,16494
15915,2016-2017,2016-12-01,2017-03-16,106,11,39,181,220,14,68,82,302,7,42,Ohio,Defiance,16494
15916,2017-2018,2017-12-01,2018-03-21,111,4,89,294,383,32,121,153,536,17,117,Ohio,Defiance,16494
15917,2018-2019,2018-11-09,2019-03-31,143,0,82,310,392,31,43,74,466,20,108,Ohio,Defiance,16494
15918,2019-2020,2019-11-12,2020-04-17,158,8,26,212,238,28,39,67,305,16,61,Ohio,Defiance,16494
15919,1950-1951,1950-11-04,1951-04-17,165,2,101,341,442,95,228,323,765,52,306,Ohio,Mansfield,47821
15920,1951-1952,1951-11-01,1952-04-15,167,0,73,287,360,63,66,129,489,43,206,Ohio,Mansfield,47821
15921,1952-1953,1952-10-20,1953-04-27,190,0,39,218,257,71,47,118,375,43,195,Ohio,Mansfield,47821
15922,1953-1954,1953-11-07,1954-04-03,148,0,55,249,304,63,81,144,448,40,189,Ohio,Mansfield,47821
15923,1954-1955,1954-10-31,1955-03-30,151,0,71,267,338,54,109,163,501,36,156,Ohio,Mansfield,47821
15924,1955-1956,1955-10-31,1956-04-22,175,1,67,321,388,60,104,164,552,35,154,Ohio,Mansfield,47821
15925,1959-1960,1959-11-18,1960-04-09,144,4,91,303,394,78,200,278,672,46,255,Ohio,Mansfield,47821
15926,1960-1961,1960-11-06,1961-04-18,164,0,101,334,435,67,167,234,669,37,217,Ohio,Mansfield,47821
15927,1961-1962,1961-11-08,1962-04-20,164,2,84,347,431,55,75,130,561,32,169,Ohio,Mansfield,47821
15928,1962-1963,1962-10-25,1963-05-01,189,0,141,448,589,90,171,261,850,46,320,Ohio,Mansfield,47821
15929,1963-1964,1963-11-12,1964-04-01,142,0,85,339,424,81,160,241,665,44,235,Ohio,Mansfield,47821
15930,1964-1965,1964-11-19,1965-03-27,129,3,95,325,420,70,84,154,574,43,240,Ohio,Mansfield,47821
15931,1965-1966,1965-11-29,1966-05-09,162,0,81,288,369,43,67,110,479,32,155,Ohio,Mansfield,47821
15932,1966-1967,1966-11-02,1967-03-20,139,0,72,285,357,63,93,156,513,33,158,Ohio,Mansfield,47821
15933,1967-1968,1967-11-06,1968-04-05,152,0,86,329,415,78,169,247,662,37,226,Ohio,Mansfield,47821
15934,1968-1969,1968-11-10,1969-04-19,161,0,62,274,336,52,76,128,464,38,168,Ohio,Mansfield,47821
15935,1969-1970,1969-11-13,1970-03-22,130,0,97,334,431,70,183,253,684,54,303,Ohio,Mansfield,47821
15936,1970-1971,1970-11-23,1971-03-24,122,0,76,292,368,67,99,166,534,32,187,Ohio,Mansfield,47821
15937,1971-1972,1971-11-06,1972-04-08,155,0,52,304,356,50,66,116,472,37,176,Ohio,Mansfield,47821
15938,1972-1973,1972-11-14,1973-04-11,149,0,43,229,272,46,67,113,385,30,128,Ohio,Mansfield,47821
15939,1973-1974,1973-11-16,1974-04-09,145,0,53,230,283,60,123,183,466,30,171,Ohio,Mansfield,47821
15940,1974-1975,1974-11-13,1975-04-03,142,0,47,240,287,84,125,209,496,45,212,Ohio,Mansfield,47821
15941,1975-1976,1975-11-13,1976-04-04,144,0,77,289,366,59,117,176,542,32,180,Ohio,Mansfield,47821
15942,1976-1977,1976-11-05,1977-04-06,153,0,181,499,680,94,282,376,1056,55,418,Ohio,Mansfield,47821
15943,1977-1978,1977-11-11,1978-03-18,128,0,145,431,576,117,453,570,1146,49,376,Ohio,Mansfield,47821
15944,1978-1979,1978-11-27,1979-04-08,133,0,128,368,496,56,182,238,734,31,195,Ohio,Mansfield,47821
15945,1979-1980,1979-11-29,1980-04-15,139,0,81,313,394,43,98,141,535,27,162,Ohio,Mansfield,47821
15946,1980-1981,1980-11-17,1981-03-21,125,0,69,289,358,69,170,239,597,39,206,Ohio,Mansfield,47821
15947,1981-1982,1981-11-20,1982-04-11,143,0,109,367,476,101,184,285,761,47,326,Ohio,Mansfield,47821
15948,1982-1983,1982-11-24,1983-04-18,146,0,35,183,218,29,43,72,290,22,80,Ohio,Mansfield,47821
15949,1983-1984,1983-11-11,1984-04-17,159,0,129,354,483,85,213,298,781,43,265,Ohio,Mansfield,47821
15950,1984-1985,1984-11-11,1985-04-09,150,0,84,288,372,83,237,320,692,43,260,Ohio,Mansfield,47821
15951,1985-1986,1985-12-01,1986-04-22,143,0,92,306,398,63,110,173,571,43,236,Ohio,Mansfield,47821
15952,1986-1987,1986-11-11,1987-04-06,147,0,45,239,284,66,52,118,402,30,128,Ohio,Mansfield,47821
15953,1987-1988,1987-11-20,1988-04-15,148,0,78,300,378,77,104,181,559,45,246,Ohio,Mansfield,47821
15954,1988-1989,1988-10-24,1989-05-07,196,0,59,291,350,51,46,97,447,38,179,Ohio,Mansfield,47821
15955,1989-1990,1989-10-19,1990-04-11,175,0,79,308,387,58,93,151,538,33,176,Ohio,Mansfield,47821
15956,1990-1991,1990-12-01,1991-03-30,120,0,39,208,247,42,65,107,354,28,128,Ohio,Mansfield,47821
15957,1991-1992,1991-11-03,1992-04-04,154,0,54,271,325,64,80,144,469,41,205,Ohio,Mansfield,47821
15958,1992-1993,1992-10-18,1993-04-02,167,0,65,269,334,80,141,221,555,40,179,Ohio,Mansfield,47821
15959,1993-1994,1993-10-30,1994-04-07,160,0,116,351,467,98,253,351,818,51,341,Ohio,Mansfield,47821
15960,1994-1995,1994-12-01,1995-04-01,122,0,63,251,314,49,165,214,528,27,166,Ohio,Mansfield,47821
15961,1995-1996,1995-11-05,1996-04-23,171,0,122,397,519,140,300,440,959,60,399,Ohio,Mansfield,47821
15962,1996-1997,1996-11-09,1997-04-17,160,3,75,302,377,50,26,76,453,37,189,Ohio,Mansfield,47821
15963,1999-2000,1999-11-02,2000-04-09,160,0,67,270,337,62,118,180,517,38,210,Ohio,Mansfield,47821
15964,2000-2001,2000-11-14,2001-04-17,155,0,93,332,425,91,150,241,666,51,311,Ohio,Mansfield,47821
15965,2001-2002,2001-12-01,2002-04-06,127,0,40,191,231,57,50,107,338,35,173,Ohio,Mansfield,47821
15966,2002-2003,2002-10-29,2003-03-31,154,3,106,361,467,93,231,324,791,52,320,Ohio,Mansfield,47821
15967,2003-2004,2003-11-13,2004-04-27,167,0,77,304,381,98,144,242,623,55,300,Ohio,Mansfield,47821
15968,2004-2005,2004-11-25,2005-04-25,152,0,80,305,385,127,190,317,702,39,258,Ohio,Mansfield,47821
15969,2005-2006,2005-11-17,2006-03-25,129,5,54,236,290,53,94,147,437,31,140,Ohio,Mansfield,47821
15970,2006-2007,2006-11-19,2007-04-15,148,0,90,276,366,71,85,156,522,35,224,Ohio,Mansfield,47821
15971,2007-2008,2007-12-01,2008-03-22,113,0,63,255,318,113,148,261,579,35,250,Ohio,Mansfield,47821
15972,2008-2009,2008-11-10,2009-04-07,149,0,100,364,464,99,181,280,744,43,295,Ohio,Mansfield,47821
15973,2009-2010,2009-12-01,2010-03-26,116,0,81,253,334,118,276,394,728,39,273,Ohio,Mansfield,47821
15974,2010-2011,2010-11-27,2011-03-31,125,0,101,317,418,91,232,323,741,44,271,Ohio,Mansfield,47821
15975,2011-2012,2011-11-30,2012-03-05,97,0,28,142,170,51,50,101,271,29,139,Ohio,Mansfield,47821
15976,2012-2013,2012-10-30,2013-04-20,173,0,59,263,322,61,102,163,485,34,180,Ohio,Mansfield,47821
15977,2013-2014,2013-11-11,2014-04-15,156,0,125,428,553,99,155,254,807,50,345,Ohio,Mansfield,47821
15978,2014-2015,2014-11-13,2015-03-28,136,0,115,386,501,95,222,317,818,41,318,Ohio,Mansfield,47821
15979,2015-2016,2015-12-01,2016-04-10,132,0,48,204,252,44,53,97,349,27,156,Ohio,Mansfield,47821
15980,2016-2017,2016-11-19,2017-04-07,140,0,51,198,249,57,67,124,373,31,139,Ohio,Mansfield,47821
15981,2017-2018,2017-11-01,2018-04-19,170,0,90,319,409,78,100,178,587,46,223,Ohio,Mansfield,47821
15982,2018-2019,2018-11-09,2019-04-15,158,0,65,282,347,77,86,163,510,38,209,Ohio,Mansfield,47821
15983,2019-2020,2019-11-11,2020-04-17,159,0,21,182,203,32,34,66,269,24,81,Ohio,Mansfield,47821
15984,1950-1951,1950-11-04,1951-03-22,139,3,91,331,422,70,141,211,633,35,203,Ohio,Toledo,287208
15985,1951-1952,1951-11-03,1952-04-06,156,0,60,286,346,82,124,206,552,36,193,Ohio,Toledo,287208
15986,1952-1953,1952-11-28,1953-04-19,143,3,25,204,229,34,24,58,287,23,99,Ohio,Toledo,287208
15987,1953-1954,1953-11-07,1954-04-03,148,0,40,242,282,62,49,111,393,30,123,Ohio,Toledo,287208
15988,1954-1955,1954-10-31,1955-03-29,150,0,51,261,312,40,42,82,394,30,136,Ohio,Toledo,287208
15989,1955-1956,1955-11-17,1956-04-17,153,0,55,333,388,63,89,152,540,37,157,Ohio,Toledo,287208
15990,1956-1957,1956-11-22,1957-04-12,142,0,63,280,343,69,101,170,513,43,193,Ohio,Toledo,287208
15991,1957-1958,1957-12-01,1958-03-25,115,0,61,258,319,41,49,90,409,27,103,Ohio,Toledo,287208
15992,1958-1959,1958-11-27,1959-03-27,121,0,97,383,480,44,90,134,614,32,187,Ohio,Toledo,287208
15993,1959-1960,1959-11-12,1960-03-26,136,0,64,305,369,70,117,187,556,39,185,Ohio,Toledo,287208
15994,1960-1961,1960-11-09,1961-04-17,160,0,89,362,451,42,44,86,537,29,175,Ohio,Toledo,287208
15995,1961-1962,1961-11-19,1962-03-14,116,0,93,319,412,67,95,162,574,33,208,Ohio,Toledo,287208
15996,1962-1963,1962-10-25,1963-04-30,188,0,153,491,644,69,162,231,875,46,304,Ohio,Toledo,287208
15997,1963-1964,1963-12-01,1964-04-03,125,0,87,340,427,66,97,163,590,36,209,Ohio,Toledo,287208
15998,1964-1965,1964-11-19,1965-04-02,135,0,85,354,439,70,118,188,627,39,230,Ohio,Toledo,287208
15999,1965-1966,1965-11-18,1966-04-06,140,0,77,304,381,45,44,89,470,36,193,Ohio,Toledo,287208
16000,1966-1967,1966-11-02,1967-04-24,174,0,78,341,419,101,163,264,683,52,281,Ohio,Toledo,287208
16001,1967-1968,1967-11-14,1968-04-25,164,0,73,353,426,57,90,147,573,35,185,Ohio,Toledo,287208
16002,1968-1969,1968-11-12,1969-04-19,159,0,80,371,451,55,71,126,577,39,220,Ohio,Toledo,287208
16003,1969-1970,1969-11-14,1970-04-11,149,0,103,434,537,98,197,295,832,50,326,Ohio,Toledo,287208
16004,1970-1971,1970-11-14,1971-03-24,131,0,85,333,418,63,54,117,535,44,248,Ohio,Toledo,287208
16005,1971-1972,1971-11-03,1972-04-08,158,0,73,379,452,54,46,100,552,39,182,Ohio,Toledo,287208
16006,1972-1973,1972-10-18,1973-03-19,153,0,59,257,316,51,56,107,423,29,120,Ohio,Toledo,287208
16007,1973-1974,1973-11-09,1974-04-08,151,0,82,323,405,61,125,186,591,34,220,Ohio,Toledo,287208
16008,1974-1975,1974-11-13,1975-04-15,154,0,44,287,331,76,115,191,522,41,163,Ohio,Toledo,287208
16009,1975-1976,1975-11-24,1976-04-25,154,0,74,318,392,76,166,242,634,43,215,Ohio,Toledo,287208
16010,1976-1977,1976-11-04,1977-04-07,155,0,162,514,676,89,227,316,992,48,374,Ohio,Toledo,287208
16011,1977-1978,1977-11-10,1978-03-25,136,0,167,514,681,114,448,562,1243,51,423,Ohio,Toledo,287208
16012,1978-1979,1978-11-20,1979-04-09,141,0,139,399,538,56,108,164,702,48,269,Ohio,Toledo,287208
16013,1979-1980,1979-11-08,1980-04-15,160,0,87,331,418,43,52,95,513,37,174,Ohio,Toledo,287208
16014,1980-1981,1980-10-27,1981-03-20,145,0,103,391,494,64,196,260,754,37,206,Ohio,Toledo,287208
16015,1981-1982,1981-11-20,1982-04-11,143,0,132,427,559,107,322,429,988,55,400,Ohio,Toledo,287208
16016,1982-1983,1982-11-24,1983-04-18,146,0,45,229,274,30,28,58,332,25,100,Ohio,Toledo,287208
16017,1983-1984,1983-11-11,1984-03-29,140,0,145,407,552,71,225,296,848,40,257,Ohio,Toledo,287208
16018,1984-1985,1984-11-11,1985-04-09,150,0,87,330,417,62,216,278,695,38,231,Ohio,Toledo,287208
16019,1985-1986,1985-11-22,1986-04-22,152,0,90,341,431,57,155,212,643,39,193,Ohio,Toledo,287208
16020,1986-1987,1986-11-11,1987-04-05,146,0,38,255,293,60,104,164,457,29,127,Ohio,Toledo,287208
16021,1987-1988,1987-11-20,1988-03-21,123,0,74,303,377,64,105,169,546,32,174,Ohio,Toledo,287208
16022,1988-1989,1988-11-06,1989-05-07,183,0,52,314,366,40,41,81,447,30,142,Ohio,Toledo,287208
16023,1989-1990,1989-10-19,1990-04-06,170,0,70,312,382,51,88,139,521,34,172,Ohio,Toledo,287208
16024,1990-1991,1990-12-01,1991-03-03,93,0,43,192,235,38,53,91,326,23,114,Ohio,Toledo,287208
16025,1991-1992,1991-11-03,1992-04-02,152,0,40,252,292,59,81,140,432,39,157,Ohio,Toledo,287208
16026,1992-1993,1992-10-20,1993-04-21,184,0,46,258,304,69,127,196,500,33,135,Ohio,Toledo,287208
16027,1993-1994,1993-10-30,1994-04-07,160,0,113,382,495,91,178,269,764,45,302,Ohio,Toledo,287208
16028,1994-1995,1994-12-01,1995-04-09,130,3,52,247,299,38,80,118,417,21,111,Ohio,Toledo,287208
16029,1995-1996,1995-11-12,1996-03-26,136,7,109,359,468,55,106,161,629,36,186,Ohio,Toledo,287208
16030,1996-1997,1996-11-09,1997-03-18,130,0,70,285,355,58,81,139,494,29,154,Ohio,Toledo,287208
16031,2004-2005,2004-11-25,2005-04-24,151,0,70,286,356,84,140,224,580,32,176,Ohio,Toledo,287208
16032,2005-2006,2005-11-17,2006-03-16,120,0,42,210,252,47,79,126,378,21,98,Ohio,Toledo,287208
16033,2006-2007,2006-12-01,2007-04-15,136,0,81,268,349,48,74,122,471,30,187,Ohio,Toledo,287208
16034,2007-2008,2007-11-26,2008-03-28,124,2,61,286,347,88,97,185,532,45,218,Ohio,Toledo,287208
16035,2008-2009,2008-11-15,2009-04-06,143,0,94,378,472,72,178,250,722,32,195,Ohio,Toledo,287208
16036,2009-2010,2009-12-01,2010-03-04,94,0,64,218,282,63,147,210,492,32,151,Ohio,Toledo,287208
16037,2010-2011,2010-12-01,2011-03-11,101,6,96,295,391,74,206,280,671,33,203,Ohio,Toledo,287208
16038,2011-2012,2011-11-29,2012-03-06,99,0,26,150,176,38,26,64,240,26,103,Ohio,Toledo,287208
16039,2012-2013,2012-12-01,2013-04-20,141,0,51,252,303,40,49,89,392,27,148,Ohio,Toledo,287208
16040,2013-2014,2013-11-11,2014-04-15,156,0,150,489,639,125,332,457,1096,44,376,Ohio,Toledo,287208
16041,2014-2015,2014-11-15,2015-03-26,132,0,126,413,539,68,265,333,872,28,231,Ohio,Toledo,287208
16042,2015-2016,2015-11-21,2016-04-10,142,0,45,210,255,42,23,65,320,25,138,Ohio,Toledo,287208
16043,2016-2017,2016-12-01,2017-04-07,128,0,53,200,253,44,55,99,352,27,135,Ohio,Toledo,287208
16044,2017-2018,2017-11-10,2018-04-19,161,0,91,321,412,55,144,199,611,31,180,Ohio,Toledo,287208
16045,2018-2019,2018-11-10,2019-03-30,141,0,62,260,322,47,69,116,438,31,149,Ohio,Toledo,287208
16046,2019-2020,2019-11-11,2020-04-17,159,0,17,173,190,38,58,96,286,19,69,Ohio,Toledo,287208
16047,1950-1951,1950-11-05,1951-04-17,164,0,83,346,429,134,252,386,815,56,347,Ohio,Youngstown,66982
16048,1951-1952,1951-11-01,1952-04-15,167,0,62,306,368,85,94,179,547,54,236,Ohio,Youngstown,66982
16049,1952-1953,1952-10-20,1953-04-20,183,0,32,215,247,66,40,106,353,50,185,Ohio,Youngstown,66982
16050,1953-1954,1953-11-05,1954-04-03,150,0,51,271,322,82,54,136,458,49,238,Ohio,Youngstown,66982
16051,1954-1955,1954-10-31,1955-03-28,149,0,62,296,358,102,123,225,583,62,308,Ohio,Youngstown,66982
16052,1955-1956,1955-10-24,1956-05-16,206,0,59,351,410,123,114,237,647,78,354,Ohio,Youngstown,66982
16053,1956-1957,1956-11-08,1957-04-14,158,0,59,288,347,118,109,227,574,70,327,Ohio,Youngstown,66982
16054,1957-1958,1957-10-26,1958-04-10,167,0,76,304,380,87,155,242,622,59,287,Ohio,Youngstown,66982
16055,1958-1959,1958-11-27,1959-03-27,121,0,102,390,492,96,116,212,704,54,358,Ohio,Youngstown,66982
16056,1959-1960,1959-11-12,1960-04-09,150,0,79,319,398,117,216,333,731,67,342,Ohio,Youngstown,66982
16057,1960-1961,1960-10-24,1961-04-28,187,0,100,351,451,103,210,313,764,59,368,Ohio,Youngstown,66982
16058,1961-1962,1961-11-08,1962-04-15,159,0,93,345,438,105,129,234,672,59,320,Ohio,Youngstown,66982
16059,1962-1963,1962-10-24,1963-05-01,190,0,140,440,580,124,251,375,955,66,440,Ohio,Youngstown,66982
16060,1963-1964,1963-11-02,1964-04-09,160,0,98,342,440,122,254,376,816,63,373,Ohio,Youngstown,66982
16061,1964-1965,1964-11-20,1965-04-02,134,0,96,331,427,102,122,224,651,53,350,Ohio,Youngstown,66982
16062,1965-1966,1965-10-28,1966-05-09,194,0,87,305,392,93,114,207,599,53,293,Ohio,Youngstown,66982
16063,1966-1967,1966-11-03,1967-04-24,173,0,92,341,433,104,144,248,681,57,333,Ohio,Youngstown,66982
16064,1967-1968,1967-10-28,1968-03-24,149,0,115,383,498,79,164,243,741,48,299,Ohio,Youngstown,66982
16065,1968-1969,1968-11-12,1969-03-31,140,0,93,312,405,97,106,203,608,60,339,Ohio,Youngstown,66982
16066,1969-1970,1969-10-22,1970-04-02,163,0,118,402,520,109,237,346,866,75,437,Ohio,Youngstown,66982
16067,1970-1971,1970-11-23,1971-04-24,153,0,108,340,448,121,171,292,740,62,392,Ohio,Youngstown,66982
16068,1971-1972,1971-11-04,1972-04-08,157,0,86,342,428,107,162,269,697,59,307,Ohio,Youngstown,66982
16069,1972-1973,1972-10-18,1973-04-11,176,0,60,271,331,71,83,154,485,42,207,Ohio,Youngstown,66982
16070,1973-1974,1973-11-05,1974-04-10,157,0,62,256,318,70,95,165,483,42,209,Ohio,Youngstown,66982
16071,1974-1975,1974-10-03,1975-04-05,185,0,52,235,287,101,110,211,498,56,229,Ohio,Youngstown,66982
16072,1975-1976,1975-11-13,1976-04-26,166,0,78,293,371,74,141,215,586,43,224,Ohio,Youngstown,66982
16073,1976-1977,1976-11-05,1977-04-06,153,0,161,469,630,97,348,445,1075,62,409,Ohio,Youngstown,66982
16074,1977-1978,1977-11-11,1978-03-17,127,0,142,416,558,117,389,506,1064,62,444,Ohio,Youngstown,66982
16075,1978-1979,1978-11-21,1979-03-27,127,0,117,343,460,61,184,245,705,42,231,Ohio,Youngstown,66982
16076,1979-1980,1979-11-14,1980-03-22,130,3,95,300,395,57,109,166,561,39,198,Ohio,Youngstown,66982
16077,1980-1981,1980-10-25,1981-03-22,149,0,110,361,471,81,195,276,747,52,291,Ohio,Youngstown,66982
16078,1981-1982,1981-10-19,1982-04-10,174,0,96,355,451,88,175,263,714,42,245,Ohio,Youngstown,66982
16079,1982-1983,1982-11-15,1983-04-19,156,0,30,188,218,59,87,146,364,26,123,Ohio,Youngstown,66982
16080,1983-1984,1983-11-04,1984-03-31,149,0,111,338,449,98,186,284,733,51,277,Ohio,Youngstown,66982
16081,1984-1985,1984-11-12,1985-04-09,149,0,97,326,423,82,214,296,719,40,263,Ohio,Youngstown,66982
16082,1985-1986,1985-12-01,1986-04-16,137,0,80,306,386,67,155,222,608,34,194,Ohio,Youngstown,66982
16083,1986-1987,1986-11-11,1987-04-06,147,0,42,270,312,96,108,204,516,36,179,Ohio,Youngstown,66982
16084,1987-1988,1987-10-21,1988-04-16,179,0,73,316,389,117,137,254,643,61,321,Ohio,Youngstown,66982
16085,1988-1989,1988-10-12,1989-05-07,208,0,57,315,372,71,61,132,504,46,226,Ohio,Youngstown,66982
16086,1989-1990,1989-10-19,1990-04-17,181,0,71,313,384,79,116,195,579,50,252,Ohio,Youngstown,66982
16087,1990-1991,1990-11-11,1991-04-02,143,0,35,233,268,54,57,111,379,40,183,Ohio,Youngstown,66982
16088,1991-1992,1991-11-04,1992-04-03,152,0,43,275,318,92,91,183,501,51,265,Ohio,Youngstown,66982
16089,1992-1993,1992-10-18,1993-04-03,168,0,53,271,324,127,168,295,619,55,266,Ohio,Youngstown,66982
16090,1993-1994,1993-10-30,1994-04-07,160,0,104,359,463,122,241,363,826,56,326,Ohio,Youngstown,66982
16091,1994-1995,1994-11-23,1995-04-14,143,0,45,270,315,53,81,134,449,33,162,Ohio,Youngstown,66982
16092,1995-1996,1995-11-09,1996-04-23,167,0,135,408,543,86,237,323,866,49,326,Ohio,Youngstown,66982
16093,1997-1998,1997-10-22,1998-03-24,154,0,28,169,197,71,76,147,344,48,168,Ohio,Youngstown,66982
16094,1998-1999,1998-11-21,1999-03-22,122,2,55,246,301,99,184,283,584,42,273,Ohio,Youngstown,66982
16095,1999-2000,1999-11-03,2000-04-09,159,0,62,256,318,74,132,206,524,46,238,Ohio,Youngstown,66982
16096,2000-2001,2000-10-08,2001-04-17,192,0,83,318,401,95,159,254,655,69,332,Ohio,Youngstown,66982
16097,2001-2002,2001-10-26,2002-04-05,162,0,39,196,235,77,66,143,378,48,211,Ohio,Youngstown,66982
16098,2002-2003,2002-10-29,2003-04-01,155,0,101,350,451,128,269,397,848,72,423,Ohio,Youngstown,66982
16099,2003-2004,2003-10-02,2004-04-14,196,0,78,307,385,116,235,351,736,61,339,Ohio,Youngstown,66982
16100,2004-2005,2004-11-25,2005-04-25,152,0,70,308,378,122,206,328,706,59,331,Ohio,Youngstown,66982
16101,2005-2006,2005-11-17,2006-04-05,140,0,50,234,284,87,126,213,497,52,237,Ohio,Youngstown,66982
16102,2006-2007,2006-10-23,2007-04-15,175,0,87,292,379,134,186,320,699,58,353,Ohio,Youngstown,66982
16103,2007-2008,2007-11-06,2008-03-25,141,0,52,277,329,145,224,369,698,59,310,Ohio,Youngstown,66982
16104,2008-2009,2008-10-28,2009-04-08,163,0,88,343,431,133,254,387,818,66,421,Ohio,Youngstown,66982
16105,2009-2010,2009-10-15,2010-03-26,163,3,60,241,301,114,313,427,728,53,284,Ohio,Youngstown,66982
16106,2010-2011,2010-11-27,2011-04-01,126,0,88,315,403,166,395,561,964,65,428,Ohio,Youngstown,66982
16107,2011-2012,2011-11-11,2012-04-11,153,0,23,158,181,83,93,176,357,44,173,Ohio,Youngstown,66982
16108,2012-2013,2012-11-24,2013-04-02,130,0,57,240,297,127,170,297,594,64,327,Ohio,Youngstown,66982
16109,2013-2014,2013-10-24,2014-04-15,174,0,120,439,559,139,260,399,958,69,462,Ohio,Youngstown,66982
16110,2014-2015,2014-11-13,2015-04-23,162,0,114,408,522,121,382,503,1025,57,379,Ohio,Youngstown,66982
16111,2015-2016,2015-10-17,2016-05-15,212,0,48,228,276,71,95,166,442,41,209,Ohio,Youngstown,66982
16112,2016-2017,2016-11-19,2017-04-07,140,0,46,208,254,104,148,252,506,47,236,Ohio,Youngstown,66982
16113,2017-2018,2017-11-10,2018-04-19,161,0,80,323,403,126,178,304,707,64,359,Ohio,Youngstown,66982
16114,2018-2019,2018-11-09,2019-04-01,144,0,57,261,318,77,108,185,503,50,246,Ohio,Youngstown,66982
16115,2019-2020,2019-11-07,2020-05-09,185,0,21,204,225,79,69,148,373,50,167,Ohio,Youngstown,66982
16116,1950-1951,1950-12-01,1951-02-28,90,6,20,152,172,1,0,1,173,1,12,Oklahoma,Mutual,61
16117,1951-1952,1951-11-02,1952-03-03,123,9,6,158,164,13,8,21,185,7,31,Oklahoma,Mutual,61
16118,1953-1954,1953-12-01,1954-02-28,90,8,6,122,128,2,0,2,130,1,5,Oklahoma,Mutual,61
16119,1954-1955,1954-12-01,1955-03-26,116,6,1,232,233,2,0,2,235,2,11,Oklahoma,Mutual,61
16120,1955-1956,1955-12-01,1956-02-29,91,6,10,209,219,14,7,21,240,5,31,Oklahoma,Mutual,61
16121,1956-1957,1956-12-01,1957-04-12,133,17,14,160,174,10,0,10,184,6,27,Oklahoma,Mutual,61
16122,1957-1958,1957-12-01,1958-03-12,102,10,9,168,177,0,3,3,180,0,0,Oklahoma,Mutual,61
16123,1960-1961,1960-12-01,1961-02-28,90,11,11,171,182,16,5,21,203,5,37,Oklahoma,Mutual,61
16124,1961-1962,1961-12-01,1962-02-28,90,6,27,196,223,9,11,20,243,5,25,Oklahoma,Mutual,61
16125,1962-1963,1962-12-01,1963-02-28,90,4,16,228,244,4,0,4,248,2,11,Oklahoma,Mutual,61
16126,1963-1964,1963-12-01,1964-02-29,91,1,14,171,185,12,13,25,210,5,34,Oklahoma,Mutual,61
16127,1964-1965,1964-12-01,1965-03-24,114,0,12,208,220,18,27,45,265,4,28,Oklahoma,Mutual,61
16128,1965-1966,1965-12-01,1966-02-28,90,0,27,166,193,16,62,78,271,5,27,Oklahoma,Mutual,61
16129,1966-1967,1966-12-01,1967-02-28,90,0,8,167,175,2,1,3,178,1,5,Oklahoma,Mutual,61
16130,1968-1969,1968-12-01,1969-03-15,105,0,7,172,179,26,28,54,233,7,38,Oklahoma,Mutual,61
16131,1970-1971,1970-12-01,1971-02-28,90,1,10,170,180,23,38,61,241,3,33,Oklahoma,Mutual,61
16132,1971-1972,1971-12-01,1972-02-29,91,0,12,148,160,15,21,36,196,2,24,Oklahoma,Mutual,61
16133,1974-1975,1974-11-30,1975-03-11,102,6,17,167,184,23,36,59,243,7,43,Oklahoma,Mutual,61
16134,1975-1976,1975-11-26,1976-02-29,96,5,15,148,163,5,2,7,170,3,17,Oklahoma,Mutual,61
16135,1977-1978,1977-12-01,1978-03-04,94,0,51,264,315,25,97,122,437,10,76,Oklahoma,Mutual,61
16136,1978-1979,1978-11-21,1979-04-03,134,9,68,287,355,19,46,65,420,10,81,Oklahoma,Mutual,61
16137,1979-1980,1979-11-10,1980-03-30,142,1,27,205,232,8,9,17,249,4,14,Oklahoma,Mutual,61
16138,1980-1981,1980-11-25,1981-03-08,104,1,14,152,166,9,6,15,181,5,21,Oklahoma,Mutual,61
16139,1981-1982,1981-12-01,1982-03-27,117,3,39,224,263,23,46,69,332,8,61,Oklahoma,Mutual,61
16140,1982-1983,1982-11-28,1983-04-05,129,4,15,142,157,20,27,47,204,10,39,Oklahoma,Mutual,61
16141,1984-1985,1984-12-01,1985-02-28,90,10,26,191,217,14,20,34,251,3,25,Oklahoma,Mutual,61
16142,1985-1986,1985-11-28,1986-02-28,93,1,27,179,206,17,36,53,259,7,52,Oklahoma,Mutual,61
16143,1986-1987,1986-11-13,1987-02-28,108,3,14,140,154,23,45,68,222,8,50,Oklahoma,Mutual,61
16144,1987-1988,1987-12-01,1988-03-18,109,2,39,240,279,63,145,208,487,13,110,Oklahoma,Mutual,61
16145,1988-1989,1988-11-20,1989-03-05,106,3,23,215,238,11,10,21,259,3,17,Oklahoma,Mutual,61
16146,1990-1991,1990-12-01,1991-03-03,93,3,33,199,232,8,14,22,254,4,41,Oklahoma,Mutual,61
16147,1991-1992,1991-10-31,1992-02-29,122,1,8,129,137,10,7,17,154,4,27,Oklahoma,Mutual,61
16148,1992-1993,1992-11-22,1993-03-13,112,11,32,208,240,48,104,152,392,16,89,Oklahoma,Mutual,61
16149,1993-1994,1993-11-25,1994-03-10,106,5,14,233,247,18,14,32,279,4,34,Oklahoma,Mutual,61
16150,1994-1995,1994-12-01,1995-03-08,98,3,14,161,175,23,31,54,229,11,66,Oklahoma,Mutual,61
16151,1995-1996,1995-12-01,1996-03-09,100,17,35,243,278,13,19,32,310,6,47,Oklahoma,Mutual,61
16152,1996-1997,1996-10-22,1997-04-12,173,10,26,234,260,27,42,69,329,10,60,Oklahoma,Mutual,61
16153,1997-1998,1997-11-10,1998-03-20,131,15,10,160,170,23,29,52,222,8,33,Oklahoma,Mutual,61
16154,1998-1999,1998-12-01,1999-03-14,104,1,17,154,171,7,4,11,182,6,30,Oklahoma,Mutual,61
16155,1999-2000,1999-12-01,2000-03-17,108,5,5,159,164,20,18,38,202,9,41,Oklahoma,Mutual,61
16156,2000-2001,2000-11-08,2001-03-27,140,9,27,238,265,26,29,55,320,14,87,Oklahoma,Mutual,61
16157,2001-2002,2001-11-28,2002-03-03,96,7,9,196,205,16,27,43,248,8,44,Oklahoma,Mutual,61
16158,2002-2003,2002-12-01,2003-03-06,96,12,16,181,197,33,68,101,298,9,65,Oklahoma,Mutual,61
16159,2003-2004,2003-12-01,2004-02-29,91,7,16,180,196,12,14,26,222,5,30,Oklahoma,Mutual,61
16160,2004-2005,2004-11-24,2005-03-15,112,7,15,135,150,14,13,27,177,8,33,Oklahoma,Mutual,61
16161,2005-2006,2005-12-01,2006-03-23,113,17,13,202,215,7,6,13,228,3,17,Oklahoma,Mutual,61
16162,2006-2007,2006-11-30,2007-04-14,136,2,29,198,227,29,43,72,299,15,92,Oklahoma,Mutual,61
16163,2007-2008,2007-11-24,2008-02-29,98,9,14,223,237,15,17,32,269,8,49,Oklahoma,Mutual,61
16164,2008-2009,2008-12-01,2009-03-30,120,1,12,156,168,26,15,41,209,5,43,Oklahoma,Mutual,61
16165,2009-2010,2009-12-01,2010-03-21,111,0,23,209,232,31,40,71,303,9,51,Oklahoma,Mutual,61
16166,2010-2011,2010-12-01,2011-02-28,90,9,19,219,238,19,37,56,294,5,43,Oklahoma,Mutual,61
16167,2011-2012,2011-12-01,2012-02-29,91,0,7,138,145,8,6,14,159,3,16,Oklahoma,Mutual,61
16168,2012-2013,2012-12-01,2013-03-24,114,6,12,201,213,74,51,125,338,7,91,Oklahoma,Mutual,61
16169,2013-2014,2013-11-23,2014-03-04,102,2,56,273,329,26,52,78,407,9,83,Oklahoma,Mutual,61
16170,2014-2015,2014-11-13,2015-03-05,113,0,26,198,224,9,9,18,242,5,25,Oklahoma,Mutual,61
16171,2015-2016,2015-11-28,2016-03-27,121,0,8,141,149,14,30,44,193,6,24,Oklahoma,Mutual,61
16172,2016-2017,2016-12-01,2017-02-28,90,3,15,159,174,2,2,4,178,1,9,Oklahoma,Mutual,61
16173,2017-2018,2017-12-01,2018-04-07,128,1,23,262,285,1,0,1,286,1,4,Oklahoma,Mutual,61
16174,2018-2019,2018-11-12,2019-03-05,114,8,18,184,202,9,8,17,219,7,27,Oklahoma,Mutual,61
16175,2019-2020,2019-10-25,2020-04-14,173,12,6,177,183,14,11,25,208,6,21,Oklahoma,Mutual,61
16176,1951-1952,1951-11-01,1952-02-29,121,3,6,100,106,14,8,22,128,8,26,Oklahoma,Oklahoma City,579999
16177,1952-1953,1952-11-28,1953-02-28,93,0,5,77,82,8,5,13,95,6,27,Oklahoma,Oklahoma City,579999
16178,1953-1954,1953-12-01,1954-03-05,95,0,11,100,111,11,7,18,129,5,30,Oklahoma,Oklahoma City,579999
16179,1954-1955,1954-12-01,1955-03-22,112,0,3,117,120,19,19,38,158,7,35,Oklahoma,Oklahoma City,579999
16180,1955-1956,1955-11-30,1956-03-07,99,0,9,131,140,11,6,17,157,7,31,Oklahoma,Oklahoma City,579999
16181,1956-1957,1956-12-01,1957-04-12,133,0,18,99,117,4,4,8,125,3,11,Oklahoma,Oklahoma City,579999
16182,1957-1958,1957-12-01,1958-03-14,104,0,8,106,114,14,8,22,136,5,25,Oklahoma,Oklahoma City,579999
16183,1958-1959,1958-11-27,1959-03-05,99,0,29,155,184,23,30,53,237,13,70,Oklahoma,Oklahoma City,579999
16184,1959-1960,1959-11-14,1960-03-08,116,0,28,153,181,25,44,69,250,12,65,Oklahoma,Oklahoma City,579999
16185,1960-1961,1960-12-01,1961-03-18,108,0,9,112,121,25,22,47,168,12,50,Oklahoma,Oklahoma City,579999
16186,1961-1962,1961-12-01,1962-02-28,90,0,26,144,170,19,13,32,202,10,72,Oklahoma,Oklahoma City,579999
16187,1962-1963,1962-12-01,1963-02-28,90,0,24,181,205,6,2,8,213,4,19,Oklahoma,Oklahoma City,579999
16188,1963-1964,1963-12-01,1964-03-09,100,0,18,141,159,8,2,10,169,7,31,Oklahoma,Oklahoma City,579999
16189,1964-1965,1964-11-21,1965-03-19,119,0,11,169,180,6,3,9,189,4,20,Oklahoma,Oklahoma City,579999
16190,1965-1966,1965-12-01,1966-02-28,90,0,19,103,122,12,19,31,153,6,29,Oklahoma,Oklahoma City,579999
16191,1966-1967,1966-12-01,1967-03-07,97,0,6,130,136,4,1,5,141,4,13,Oklahoma,Oklahoma City,579999
16192,1967-1968,1967-11-02,1968-03-22,142,0,15,136,151,42,26,68,219,18,76,Oklahoma,Oklahoma City,579999
16193,1968-1969,1968-11-28,1969-03-15,108,0,5,124,129,20,7,27,156,11,27,Oklahoma,Oklahoma City,579999
16194,1969-1970,1969-12-01,1970-03-28,118,0,16,140,156,11,17,28,184,7,34,Oklahoma,Oklahoma City,579999
16195,1970-1971,1970-12-01,1971-03-03,93,0,7,120,127,9,9,18,145,4,21,Oklahoma,Oklahoma City,579999
16196,1971-1972,1971-11-23,1972-02-29,99,1,11,110,121,17,18,35,156,8,36,Oklahoma,Oklahoma City,579999
16197,1972-1973,1972-11-18,1973-02-28,103,0,33,145,178,25,39,64,242,12,51,Oklahoma,Oklahoma City,579999
16198,1973-1974,1973-12-01,1974-03-21,111,0,15,131,146,6,2,8,154,5,24,Oklahoma,Oklahoma City,579999
16199,1974-1975,1974-11-29,1975-03-29,121,0,5,115,120,10,3,13,133,7,19,Oklahoma,Oklahoma City,579999
16200,1975-1976,1975-11-26,1976-02-29,96,0,7,106,113,8,2,10,123,6,16,Oklahoma,Oklahoma City,579999
16201,1976-1977,1976-11-13,1977-02-28,108,0,14,179,193,8,8,16,209,6,29,Oklahoma,Oklahoma City,579999
16202,1977-1978,1977-12-01,1978-03-03,93,1,38,191,229,30,65,95,324,12,73,Oklahoma,Oklahoma City,579999
16203,1978-1979,1978-12-01,1979-02-28,90,0,47,222,269,24,58,82,351,12,84,Oklahoma,Oklahoma City,579999
16204,1979-1980,1979-12-01,1980-03-01,92,0,13,112,125,3,9,12,137,2,9,Oklahoma,Oklahoma City,579999
16205,1980-1981,1980-11-17,1981-02-28,104,0,5,131,136,6,3,9,145,1,7,Oklahoma,Oklahoma City,579999
16206,1981-1982,1981-12-01,1982-03-27,117,0,18,158,176,13,6,19,195,7,31,Oklahoma,Oklahoma City,579999
16207,1982-1983,1982-12-01,1983-02-28,90,0,3,68,71,14,11,25,96,6,23,Oklahoma,Oklahoma City,579999
16208,1983-1984,1983-12-01,1984-02-29,91,0,53,177,230,16,13,29,259,10,75,Oklahoma,Oklahoma City,579999
16209,1984-1985,1984-12-01,1985-02-28,90,0,21,132,153,13,16,29,182,5,29,Oklahoma,Oklahoma City,579999
16210,1985-1986,1985-11-28,1986-02-28,93,0,17,119,136,20,22,42,178,7,46,Oklahoma,Oklahoma City,579999
16211,1986-1987,1986-11-13,1987-02-28,108,0,7,84,91,18,44,62,153,5,29,Oklahoma,Oklahoma City,579999
16212,1987-1988,1987-11-18,1988-03-17,121,3,19,130,149,35,75,110,259,8,60,Oklahoma,Oklahoma City,579999
16213,1988-1989,1988-11-19,1989-04-10,143,0,15,118,133,18,16,34,167,9,29,Oklahoma,Oklahoma City,579999
16214,1989-1990,1989-12-01,1990-03-24,114,0,18,100,118,9,2,11,129,7,35,Oklahoma,Oklahoma City,579999
16215,1990-1991,1990-12-01,1991-02-28,90,0,20,104,124,7,7,14,138,4,31,Oklahoma,Oklahoma City,579999
16216,1991-1992,1991-11-02,1992-02-29,120,0,2,59,61,12,4,16,77,5,22,Oklahoma,Oklahoma City,579999
16217,1992-1993,1992-11-26,1993-02-28,95,0,13,104,117,8,8,16,133,4,14,Oklahoma,Oklahoma City,579999
16218,1993-1994,1993-10-30,1994-03-10,132,0,10,167,177,11,5,16,193,4,20,Oklahoma,Oklahoma City,579999
16219,1994-1995,1994-12-01,1995-03-07,97,0,8,90,98,13,16,29,127,5,27,Oklahoma,Oklahoma City,579999
16220,1995-1996,1995-11-10,1996-03-08,120,1,21,160,181,12,8,20,201,8,45,Oklahoma,Oklahoma City,579999
16221,1996-1997,1996-12-01,1997-02-28,90,0,12,104,116,9,11,20,136,3,18,Oklahoma,Oklahoma City,579999
16222,1997-1998,1997-11-14,1998-02-28,107,0,2,68,70,5,2,7,77,4,8,Oklahoma,Oklahoma City,579999
16223,1998-1999,1998-12-01,1999-03-14,104,0,9,86,95,4,1,5,100,2,9,Oklahoma,Oklahoma City,579999
16224,1999-2000,1999-12-01,2000-02-29,91,0,4,64,68,13,24,37,105,3,20,Oklahoma,Oklahoma City,579999
16225,2000-2001,2000-12-01,2001-02-28,90,0,18,121,139,16,37,53,192,6,37,Oklahoma,Oklahoma City,579999
16226,2001-2002,2001-11-27,2002-03-03,97,0,7,117,124,12,12,24,148,6,27,Oklahoma,Oklahoma City,579999
16227,2002-2003,2002-12-01,2003-03-05,95,0,13,125,138,11,6,17,155,6,29,Oklahoma,Oklahoma City,579999
16228,2003-2004,2003-12-01,2004-02-29,91,0,4,102,106,6,4,10,116,5,15,Oklahoma,Oklahoma City,579999
16229,2004-2005,2004-12-01,2005-02-28,90,0,5,71,76,5,2,7,83,3,8,Oklahoma,Oklahoma City,579999
16230,2005-2006,2005-12-01,2006-03-23,113,0,8,94,102,8,4,12,114,6,26,Oklahoma,Oklahoma City,579999
16231,2006-2007,2006-11-30,2007-02-28,91,0,13,100,113,17,21,38,151,9,42,Oklahoma,Oklahoma City,579999
16232,2007-2008,2007-12-01,2008-03-03,94,0,5,110,115,7,2,9,124,7,15,Oklahoma,Oklahoma City,579999
16233,2008-2009,2008-12-01,2009-03-28,118,0,10,126,136,6,4,10,146,3,13,Oklahoma,Oklahoma City,579999
16234,2009-2010,2009-12-01,2010-03-21,111,0,13,133,146,34,58,92,238,9,47,Oklahoma,Oklahoma City,579999
16235,2010-2011,2010-12-01,2011-02-28,90,0,17,145,162,26,41,67,229,6,57,Oklahoma,Oklahoma City,579999
16236,2011-2012,2011-12-01,2012-02-29,91,0,2,66,68,2,2,4,72,2,6,Oklahoma,Oklahoma City,579999
16237,2012-2013,2012-12-01,2013-02-28,90,0,2,87,89,10,1,11,100,6,16,Oklahoma,Oklahoma City,579999
16238,2013-2014,2013-11-22,2014-03-04,103,0,24,167,191,15,20,35,226,9,52,Oklahoma,Oklahoma City,579999
16239,2014-2015,2014-11-12,2015-03-05,114,0,9,119,128,18,10,28,156,7,39,Oklahoma,Oklahoma City,579999
16240,2015-2016,2015-12-01,2016-02-29,91,0,3,70,73,3,0,3,76,3,9,Oklahoma,Oklahoma City,579999
16241,2016-2017,2016-12-01,2017-02-28,90,0,7,85,92,4,3,7,99,3,22,Oklahoma,Oklahoma City,579999
16242,2017-2018,2017-12-01,2018-02-28,90,0,15,142,157,2,0,2,159,2,6,Oklahoma,Oklahoma City,579999
16243,2018-2019,2018-11-12,2019-03-04,113,0,9,125,134,9,6,15,149,4,14,Oklahoma,Oklahoma City,579999
16244,2019-2020,2019-12-01,2020-04-14,136,0,2,79,81,9,7,16,97,4,14,Oklahoma,Oklahoma City,579999
16245,1950-1951,1950-12-01,1951-02-28,90,0,22,139,161,11,20,31,192,5,35,Oklahoma,Tulsa,391906
16246,1951-1952,1951-11-01,1952-02-29,121,0,8,108,116,18,6,24,140,12,39,Oklahoma,Tulsa,391906
16247,1952-1953,1952-11-28,1953-02-28,93,0,4,86,90,12,12,24,114,5,26,Oklahoma,Tulsa,391906
16248,1953-1954,1953-12-01,1954-03-02,92,0,11,87,98,9,10,19,117,5,30,Oklahoma,Tulsa,391906
16249,1954-1955,1954-12-01,1955-03-22,112,0,1,99,100,20,19,39,139,4,28,Oklahoma,Tulsa,391906
16250,1955-1956,1955-11-30,1956-02-29,92,0,7,120,127,9,3,12,139,6,26,Oklahoma,Tulsa,391906
16251,1956-1957,1956-12-01,1957-04-12,133,0,15,87,102,8,2,10,112,6,26,Oklahoma,Tulsa,391906
16252,1957-1958,1957-12-01,1958-03-17,107,0,12,108,120,25,14,39,159,8,41,Oklahoma,Tulsa,391906
16253,1958-1959,1958-11-27,1959-02-28,94,0,21,143,164,28,49,77,241,12,64,Oklahoma,Tulsa,391906
16254,1959-1960,1959-11-17,1960-03-09,114,0,21,150,171,27,54,81,252,10,54,Oklahoma,Tulsa,391906
16255,1960-1961,1960-12-01,1961-02-28,90,0,8,123,131,8,7,15,146,3,13,Oklahoma,Tulsa,391906
16256,1961-1962,1961-12-01,1962-03-02,92,0,25,168,193,12,19,31,224,7,44,Oklahoma,Tulsa,391906
16257,1962-1963,1962-12-01,1963-02-28,90,0,24,190,214,6,0,6,220,5,26,Oklahoma,Tulsa,391906
16258,1963-1964,1963-12-01,1964-03-10,101,0,19,173,192,20,20,40,232,6,45,Oklahoma,Tulsa,391906
16259,1964-1965,1964-12-01,1965-03-25,115,0,13,168,181,6,1,7,188,5,23,Oklahoma,Tulsa,391906
16260,1965-1966,1965-12-01,1966-02-28,90,0,16,130,146,15,15,30,176,9,46,Oklahoma,Tulsa,391906
16261,1966-1967,1966-12-01,1967-03-08,98,0,10,161,171,10,7,17,188,7,28,Oklahoma,Tulsa,391906
16262,1967-1968,1967-11-28,1968-03-21,115,0,12,146,158,24,15,39,197,9,45,Oklahoma,Tulsa,391906
16263,1968-1969,1968-12-01,1969-03-15,105,0,6,144,150,12,3,15,165,5,17,Oklahoma,Tulsa,391906
16264,1969-1970,1969-12-01,1970-03-21,111,0,25,151,176,30,54,84,260,10,66,Oklahoma,Tulsa,391906
16265,1970-1971,1970-12-01,1971-02-28,90,0,11,111,122,9,9,18,140,4,17,Oklahoma,Tulsa,391906
16266,1971-1972,1971-11-22,1972-02-29,100,0,13,114,127,16,10,26,153,9,44,Oklahoma,Tulsa,391906
16267,1972-1973,1972-11-18,1973-04-09,143,0,33,149,182,26,20,46,228,14,61,Oklahoma,Tulsa,391906
16268,1973-1974,1973-12-01,1974-02-28,90,0,21,130,151,2,4,6,157,1,6,Oklahoma,Tulsa,391906
16269,1974-1975,1974-11-29,1975-03-13,105,0,6,107,113,9,6,15,128,6,23,Oklahoma,Tulsa,391906
16270,1975-1976,1975-11-26,1976-02-29,96,0,11,115,126,3,0,3,129,2,8,Oklahoma,Tulsa,391906
16271,1976-1977,1976-11-14,1977-02-28,107,0,23,190,213,17,30,47,260,7,45,Oklahoma,Tulsa,391906
16272,1977-1978,1977-12-01,1978-03-04,94,0,44,211,255,21,35,56,311,14,76,Oklahoma,Tulsa,391906
16273,1978-1979,1978-12-01,1979-02-28,90,0,49,231,280,29,89,118,398,18,114,Oklahoma,Tulsa,391906
16274,1979-1980,1979-12-01,1980-03-01,92,0,11,102,113,6,14,20,133,4,10,Oklahoma,Tulsa,391906
16275,1980-1981,1980-12-01,1981-02-28,90,0,6,121,127,2,0,2,129,2,8,Oklahoma,Tulsa,391906
16276,1981-1982,1981-12-01,1982-02-28,90,0,23,141,164,10,7,17,181,7,27,Oklahoma,Tulsa,391906
16277,1982-1983,1982-12-01,1983-02-28,90,0,2,57,59,9,5,14,73,5,16,Oklahoma,Tulsa,391906
16278,1983-1984,1983-12-01,1984-02-29,91,0,50,157,207,12,34,46,253,9,64,Oklahoma,Tulsa,391906
16279,1984-1985,1984-12-01,1985-02-28,90,0,23,142,165,20,20,40,205,6,38,Oklahoma,Tulsa,391906
16280,1985-1986,1985-11-28,1986-02-28,93,0,16,124,140,11,12,23,163,5,30,Oklahoma,Tulsa,391906
16281,1986-1987,1986-11-11,1987-02-28,110,0,6,92,98,20,43,63,161,4,27,Oklahoma,Tulsa,391906
16282,1987-1988,1987-12-01,1988-03-04,95,0,19,123,142,26,49,75,217,6,48,Oklahoma,Tulsa,391906
16283,1988-1989,1988-11-20,1989-03-09,110,0,17,122,139,24,21,45,184,8,39,Oklahoma,Tulsa,391906
16284,1989-1990,1989-12-01,1990-03-24,114,0,18,119,137,5,2,7,144,4,14,Oklahoma,Tulsa,391906
16285,1990-1991,1990-12-01,1991-02-28,90,0,17,103,120,9,12,21,141,6,38,Oklahoma,Tulsa,391906
16286,1991-1992,1991-11-02,1992-02-29,120,0,1,51,52,3,0,3,55,3,8,Oklahoma,Tulsa,391906
16287,1992-1993,1992-11-22,1993-02-28,99,0,14,114,128,18,16,34,162,7,34,Oklahoma,Tulsa,391906
16288,1993-1994,1993-10-30,1994-03-10,132,0,12,158,170,21,10,31,201,3,25,Oklahoma,Tulsa,391906
16289,1994-1995,1994-12-01,1995-03-04,94,0,5,78,83,12,9,21,104,7,26,Oklahoma,Tulsa,391906
16290,1995-1996,1995-11-10,1996-03-08,120,2,23,163,186,11,14,25,211,4,27,Oklahoma,Tulsa,391906
16291,1996-1997,1996-12-01,1997-02-28,90,0,17,115,132,11,7,18,150,5,25,Oklahoma,Tulsa,391906
16292,1997-1998,1997-12-01,1998-03-11,101,2,4,66,70,8,3,11,81,3,10,Oklahoma,Tulsa,391906
16293,1998-1999,1998-12-01,1999-03-14,104,0,11,91,102,12,8,20,122,4,16,Oklahoma,Tulsa,391906
16294,1999-2000,1999-12-01,2000-03-11,102,0,4,76,80,14,17,31,111,6,26,Oklahoma,Tulsa,391906
16295,2000-2001,2000-11-08,2001-02-28,113,0,21,173,194,21,38,59,253,8,47,Oklahoma,Tulsa,391906
16296,2001-2002,2001-11-28,2002-03-04,97,0,5,106,111,15,14,29,140,4,23,Oklahoma,Tulsa,391906
16297,2002-2003,2002-12-01,2003-03-05,95,0,13,120,133,31,35,66,199,8,52,Oklahoma,Tulsa,391906
16298,2003-2004,2003-12-01,2004-02-29,91,0,7,102,109,11,8,19,128,5,19,Oklahoma,Tulsa,391906
16299,2004-2005,2004-12-01,2005-02-28,90,0,6,77,83,3,1,4,87,2,5,Oklahoma,Tulsa,391906
16300,2005-2006,2005-12-01,2006-03-23,113,0,7,92,99,12,12,24,123,7,39,Oklahoma,Tulsa,391906
16301,2006-2007,2006-11-29,2007-04-05,128,0,15,121,136,25,37,62,198,10,54,Oklahoma,Tulsa,391906
16302,2007-2008,2007-12-01,2008-03-03,94,0,5,110,115,10,2,12,127,8,22,Oklahoma,Tulsa,391906
16303,2008-2009,2008-12-01,2009-03-29,119,0,12,128,140,20,6,26,166,7,40,Oklahoma,Tulsa,391906
16304,2009-2010,2009-12-01,2010-03-21,111,0,19,148,167,35,42,77,244,12,64,Oklahoma,Tulsa,391906
16305,2010-2011,2010-12-01,2011-02-28,90,0,19,162,181,35,82,117,298,7,68,Oklahoma,Tulsa,391906
16306,2011-2012,2011-12-01,2012-02-29,91,0,1,66,67,3,2,5,72,2,5,Oklahoma,Tulsa,391906
16307,2012-2013,2012-12-01,2013-02-28,90,0,2,95,97,6,0,6,103,3,9,Oklahoma,Tulsa,391906
16308,2013-2014,2013-11-24,2014-03-04,101,0,30,196,226,20,24,44,270,10,65,Oklahoma,Tulsa,391906
16309,2014-2015,2014-11-16,2015-03-04,109,0,10,128,138,13,10,23,161,8,36,Oklahoma,Tulsa,391906
16310,2015-2016,2015-12-01,2016-02-29,91,0,3,64,67,4,1,5,72,2,7,Oklahoma,Tulsa,391906
16311,2016-2017,2016-12-01,2017-02-28,90,0,5,85,90,2,0,2,92,2,13,Oklahoma,Tulsa,391906
16312,2017-2018,2017-12-01,2018-04-07,128,0,13,130,143,4,2,6,149,2,6,Oklahoma,Tulsa,391906
16313,2018-2019,2018-11-12,2019-03-04,113,0,7,121,128,6,1,7,135,5,23,Oklahoma,Tulsa,391906
16314,2019-2020,2019-11-11,2020-02-29,111,0,1,72,73,6,3,9,82,4,11,Oklahoma,Tulsa,391906
16315,1950-1951,1950-12-01,1951-03-13,103,4,2,44,46,51,41,92,138,12,66,Oregon,Clatskanie,1737
16316,1951-1952,1951-12-01,1952-02-29,91,8,3,57,60,38,46,84,144,12,53,Oregon,Clatskanie,1737
16317,1952-1953,1952-12-01,1953-02-28,90,0,0,16,16,0,0,0,16,0,0,Oregon,Clatskanie,1737
16318,1953-1954,1953-12-01,1954-02-28,90,0,1,34,35,49,84,133,168,10,59,Oregon,Clatskanie,1737
16319,1954-1955,1954-12-01,1955-03-13,103,0,0,51,51,14,3,17,68,6,20,Oregon,Clatskanie,1737
16320,1955-1956,1955-11-11,1956-03-06,117,1,8,85,93,62,85,147,240,15,91,Oregon,Clatskanie,1737
16321,1956-1957,1956-12-01,1957-02-28,90,1,8,74,82,24,50,74,156,14,47,Oregon,Clatskanie,1737
16322,1957-1958,1957-12-01,1958-02-28,90,1,0,10,10,0,0,0,10,0,0,Oregon,Clatskanie,1737
16323,1958-1959,1958-12-01,1959-02-28,90,0,2,22,24,3,3,6,30,1,5,Oregon,Clatskanie,1737
16324,1959-1960,1959-12-01,1960-03-04,95,1,1,50,51,26,22,48,99,7,35,Oregon,Clatskanie,1737
16325,1960-1961,1960-12-01,1961-03-03,93,0,0,23,23,2,0,2,25,1,3,Oregon,Clatskanie,1737
16326,1961-1962,1961-12-01,1962-03-04,94,0,5,53,58,23,23,46,104,7,30,Oregon,Clatskanie,1737
16327,1962-1963,1962-12-01,1963-02-28,90,0,4,46,50,12,20,32,82,3,20,Oregon,Clatskanie,1737
16328,1963-1964,1963-12-01,1964-02-29,91,0,0,25,25,0,0,0,25,0,0,Oregon,Clatskanie,1737
16329,1964-1965,1964-11-13,1965-03-25,133,0,4,61,65,43,53,96,161,13,57,Oregon,Clatskanie,1737
16330,1965-1966,1965-12-01,1966-03-21,111,0,0,44,44,30,33,63,107,10,40,Oregon,Clatskanie,1737
16331,1966-1967,1966-12-01,1967-02-28,90,0,0,16,16,2,0,2,18,1,3,Oregon,Clatskanie,1737
16332,1967-1968,1967-12-01,1968-02-29,91,0,0,44,44,18,3,21,65,7,25,Oregon,Clatskanie,1737
16333,1968-1969,1968-12-01,1969-02-28,90,7,11,73,84,49,129,178,262,19,83,Oregon,Clatskanie,1737
16334,1969-1970,1969-12-01,1970-02-28,90,0,0,25,25,2,0,2,27,1,3,Oregon,Clatskanie,1737
16335,1970-1971,1970-11-22,1971-03-06,105,0,1,44,45,61,58,119,164,13,75,Oregon,Clatskanie,1737
16336,1971-1972,1971-12-01,1972-03-25,116,0,3,38,41,16,15,31,72,6,23,Oregon,Clatskanie,1737
16337,1972-1973,1972-12-01,1973-02-28,90,0,14,60,74,13,41,54,128,4,23,Oregon,Clatskanie,1737
16338,1973-1974,1973-11-03,1974-03-07,125,3,7,48,55,7,1,8,63,5,14,Oregon,Clatskanie,1737
16339,1974-1975,1974-12-01,1975-02-28,90,0,0,21,21,6,3,9,30,1,7,Oregon,Clatskanie,1737
16340,1975-1976,1975-11-29,1976-02-29,93,9,0,32,32,5,3,8,40,2,7,Oregon,Clatskanie,1737
16341,1976-1977,1976-12-01,1977-02-28,90,6,1,34,35,2,0,2,37,1,2,Oregon,Clatskanie,1737
16342,1977-1978,1977-11-22,1978-03-03,102,6,0,19,19,2,1,3,22,2,4,Oregon,Clatskanie,1737
16343,1978-1979,1978-11-19,1979-02-28,102,0,10,83,93,25,56,81,174,10,44,Oregon,Clatskanie,1737
16344,1979-1980,1979-12-01,1980-03-15,106,0,4,43,47,35,19,54,101,10,46,Oregon,Clatskanie,1737
16345,1980-1981,1980-12-01,1981-02-28,90,1,0,20,20,4,0,4,24,2,5,Oregon,Clatskanie,1737
16346,1981-1982,1981-12-01,1982-02-28,90,5,1,31,32,21,21,42,74,7,25,Oregon,Clatskanie,1737
16347,1982-1983,1982-12-01,1983-02-28,90,6,0,23,23,0,0,0,23,0,0,Oregon,Clatskanie,1737
16348,1983-1984,1983-12-01,1984-02-29,91,1,6,55,61,5,13,18,79,3,18,Oregon,Clatskanie,1737
16349,1984-1985,1984-12-01,1985-02-28,90,0,2,69,71,16,9,25,96,7,26,Oregon,Clatskanie,1737
16350,1985-1986,1985-11-22,1986-02-28,99,4,8,96,104,11,28,39,143,7,31,Oregon,Clatskanie,1737
16351,1987-1988,1987-12-01,1988-02-29,91,5,0,51,51,2,1,3,54,1,3,Oregon,Clatskanie,1737
16352,1989-1990,1989-12-01,1990-02-28,90,6,0,43,43,13,1,14,57,3,17,Oregon,Clatskanie,1737
16353,1990-1991,1990-12-01,1991-02-28,90,10,15,89,104,6,12,18,122,4,18,Oregon,Clatskanie,1737
16354,1991-1992,1991-12-01,1992-02-29,91,0,0,30,30,0,0,0,30,0,0,Oregon,Clatskanie,1737
16355,1992-1993,1992-12-01,1993-02-28,90,7,0,97,97,0,2,2,99,0,0,Oregon,Clatskanie,1737
16356,1993-1994,1993-12-01,1994-02-28,90,3,0,58,58,3,0,3,61,1,4,Oregon,Clatskanie,1737
16357,1994-1995,1994-12-01,1995-02-28,90,5,0,44,44,4,0,4,48,4,9,Oregon,Clatskanie,1737
16358,1995-1996,1995-12-01,1996-02-29,91,1,2,58,60,0,0,0,60,0,0,Oregon,Clatskanie,1737
16359,1996-1997,1996-12-01,1997-02-28,90,0,0,46,46,2,1,3,49,1,3,Oregon,Clatskanie,1737
16360,1997-1998,1997-12-01,1998-02-28,90,0,1,35,36,8,12,20,56,3,12,Oregon,Clatskanie,1737
16361,1998-1999,1998-12-01,1999-02-28,90,0,6,49,55,6,7,13,68,4,24,Oregon,Clatskanie,1737
16362,1999-2000,1999-12-01,2000-02-29,91,0,0,46,46,1,1,2,48,1,2,Oregon,Clatskanie,1737
16363,2000-2001,2000-12-01,2001-02-28,90,0,0,60,60,1,0,1,61,1,3,Oregon,Clatskanie,1737
16364,2001-2002,2001-12-01,2002-03-17,107,2,0,53,53,4,0,4,57,3,7,Oregon,Clatskanie,1737
16365,2002-2003,2002-12-01,2003-02-28,90,16,0,37,37,0,0,0,37,0,0,Oregon,Clatskanie,1737
16366,2003-2004,2003-12-01,2004-02-29,91,2,3,44,47,11,23,34,81,4,18,Oregon,Clatskanie,1737
16367,2004-2005,2004-12-01,2005-02-28,90,0,0,59,59,0,0,0,59,0,0,Oregon,Clatskanie,1737
16368,2005-2006,2005-12-01,2006-03-10,100,0,0,62,62,1,0,1,63,1,2,Oregon,Clatskanie,1737
16369,2006-2007,2006-11-27,2007-03-01,95,0,2,65,67,9,8,17,84,6,15,Oregon,Clatskanie,1737
16370,2007-2008,2007-12-01,2008-03-27,118,1,0,65,65,5,0,5,70,4,9,Oregon,Clatskanie,1737
16371,2008-2009,2008-12-01,2009-03-09,99,7,8,90,98,31,71,102,200,17,59,Oregon,Clatskanie,1737
16372,2009-2010,2009-12-01,2010-02-28,90,10,2,65,67,2,1,3,70,1,3,Oregon,Clatskanie,1737
16373,2013-2014,2013-12-01,2014-02-28,90,14,9,76,85,11,0,11,96,3,21,Oregon,Clatskanie,1737
16374,2014-2015,2014-12-01,2015-02-28,90,0,0,42,42,0,0,0,42,0,0,Oregon,Clatskanie,1737
16375,2015-2016,2015-12-01,2016-02-29,91,0,1,42,43,2,1,3,46,1,6,Oregon,Clatskanie,1737
16376,2016-2017,2016-12-01,2017-02-28,90,0,2,93,95,0,0,0,95,0,0,Oregon,Clatskanie,1737
16377,2017-2018,2017-12-01,2018-02-28,90,17,0,48,48,5,0,5,53,2,8,Oregon,Clatskanie,1737
16378,2018-2019,2018-12-01,2019-02-28,90,2,0,58,58,5,0,5,63,2,7,Oregon,Clatskanie,1737
16379,2019-2020,2019-12-01,2020-02-29,91,0,0,34,34,0,0,0,34,0,0,Oregon,Clatskanie,1737
16380,1950-1951,1950-12-01,1951-03-12,102,0,0,48,48,28,31,59,107,5,35,Oregon,Cottage Grove,9686
16381,1951-1952,1951-12-01,1952-02-29,91,0,1,57,58,24,12,36,94,10,35,Oregon,Cottage Grove,9686
16382,1952-1953,1952-12-01,1953-04-07,128,3,0,44,44,1,0,1,45,1,1,Oregon,Cottage Grove,9686
16383,1953-1954,1953-12-01,1954-03-11,101,0,0,44,44,11,0,11,55,5,16,Oregon,Cottage Grove,9686
16384,1954-1955,1954-12-01,1955-03-14,104,0,0,70,70,6,1,7,77,3,9,Oregon,Cottage Grove,9686
16385,1955-1956,1955-11-15,1956-03-05,112,1,2,64,66,25,22,47,113,7,39,Oregon,Cottage Grove,9686
16386,1956-1957,1956-12-01,1957-02-28,90,0,6,91,97,9,18,27,124,5,17,Oregon,Cottage Grove,9686
16387,1957-1958,1957-12-01,1958-02-28,90,1,0,22,22,0,0,0,22,0,0,Oregon,Cottage Grove,9686
16388,1958-1959,1958-12-01,1959-02-28,90,0,1,26,27,5,1,6,33,3,10,Oregon,Cottage Grove,9686
16389,1959-1960,1959-12-01,1960-02-29,91,0,0,49,49,1,0,1,50,1,1,Oregon,Cottage Grove,9686
16390,1960-1961,1960-12-01,1961-02-28,90,0,0,32,32,0,0,0,32,0,0,Oregon,Cottage Grove,9686
16391,1961-1962,1961-11-24,1962-03-03,100,9,4,81,85,21,31,52,137,5,34,Oregon,Cottage Grove,9686
16392,1962-1963,1962-12-01,1963-04-16,137,0,3,78,81,7,1,8,89,3,13,Oregon,Cottage Grove,9686
16393,1963-1964,1963-12-01,1964-05-05,157,0,0,72,72,4,0,4,76,3,6,Oregon,Cottage Grove,9686
16394,1965-1966,1965-12-01,1966-03-03,93,0,2,60,62,22,6,28,90,7,29,Oregon,Cottage Grove,9686
16395,1966-1967,1966-12-01,1967-02-28,90,0,0,27,27,0,0,0,27,0,0,Oregon,Cottage Grove,9686
16396,1967-1968,1967-12-01,1968-02-29,91,0,1,65,66,12,4,16,82,4,18,Oregon,Cottage Grove,9686
16397,1968-1969,1968-12-01,1969-02-28,90,3,3,64,67,64,96,160,227,11,82,Oregon,Cottage Grove,9686
16398,1969-1970,1969-12-01,1970-03-01,91,0,0,33,33,3,0,3,36,1,4,Oregon,Cottage Grove,9686
16399,1970-1971,1970-12-01,1971-03-02,92,0,1,53,54,39,26,65,119,6,46,Oregon,Cottage Grove,9686
16400,1971-1972,1971-12-01,1972-03-25,116,0,1,58,59,6,2,8,67,4,12,Oregon,Cottage Grove,9686
16401,1972-1973,1972-12-01,1973-02-28,90,1,10,76,86,10,24,34,120,5,25,Oregon,Cottage Grove,9686
16402,1973-1974,1973-11-05,1974-02-28,116,0,2,61,63,4,0,4,67,2,6,Oregon,Cottage Grove,9686
16403,1974-1975,1974-12-01,1975-02-28,90,0,0,38,38,5,3,8,46,2,7,Oregon,Cottage Grove,9686
16404,1975-1976,1975-12-01,1976-03-31,122,0,0,72,72,7,4,11,83,3,10,Oregon,Cottage Grove,9686
16405,1976-1977,1976-12-01,1977-02-28,90,0,0,73,73,0,0,0,73,0,0,Oregon,Cottage Grove,9686
16406,1977-1978,1977-11-21,1978-02-28,100,0,0,26,26,3,1,4,30,1,4,Oregon,Cottage Grove,9686
16407,1978-1979,1978-12-01,1979-02-28,90,0,7,95,102,2,0,2,104,1,6,Oregon,Cottage Grove,9686
16408,1979-1980,1979-12-01,1980-03-15,106,0,2,69,71,4,0,4,75,2,6,Oregon,Cottage Grove,9686
16409,1980-1981,1980-12-01,1981-02-28,90,0,0,33,33,1,0,1,34,1,2,Oregon,Cottage Grove,9686
16410,1981-1982,1981-12-01,1982-02-28,90,0,0,61,61,8,22,30,91,3,11,Oregon,Cottage Grove,9686
16411,1982-1983,1982-12-01,1983-02-28,90,1,0,41,41,0,0,0,41,0,0,Oregon,Cottage Grove,9686
16412,1983-1984,1983-12-01,1984-02-29,91,6,4,52,56,5,4,9,65,2,11,Oregon,Cottage Grove,9686
16413,1984-1985,1984-12-01,1985-02-28,90,0,1,70,71,1,0,1,72,1,2,Oregon,Cottage Grove,9686
16414,1985-1986,1985-11-24,1986-02-28,97,0,2,95,97,16,6,22,119,5,25,Oregon,Cottage Grove,9686
16415,1986-1987,1986-12-01,1987-02-28,90,1,0,55,55,0,0,0,55,0,0,Oregon,Cottage Grove,9686
16416,1987-1988,1987-12-01,1988-02-29,91,0,0,47,47,9,9,18,65,3,12,Oregon,Cottage Grove,9686
16417,1988-1989,1988-12-01,1989-02-28,90,0,4,84,88,14,26,40,128,3,17,Oregon,Cottage Grove,9686
16418,1989-1990,1989-12-01,1990-02-28,90,3,0,37,37,14,18,32,69,2,16,Oregon,Cottage Grove,9686
16419,1990-1991,1990-12-01,1991-02-28,90,2,9,89,98,3,6,9,107,1,4,Oregon,Cottage Grove,9686
16420,1991-1992,1991-12-01,1992-02-29,91,0,0,26,26,0,0,0,26,0,0,Oregon,Cottage Grove,9686
16421,1992-1993,1992-12-01,1993-02-28,90,3,0,62,62,1,3,4,66,1,2,Oregon,Cottage Grove,9686
16422,1993-1994,1993-12-01,1994-02-28,90,0,0,54,54,0,0,0,54,0,0,Oregon,Cottage Grove,9686
16423,1994-1995,1994-12-01,1995-02-28,90,2,0,29,29,0,0,0,29,0,0,Oregon,Cottage Grove,9686
16424,1995-1996,1995-12-01,1996-02-29,91,12,1,35,36,0,0,0,36,0,0,Oregon,Cottage Grove,9686
16425,1998-1999,1998-12-01,1999-02-28,90,15,4,54,58,4,2,6,64,3,8,Oregon,Cottage Grove,9686
16426,1999-2000,1999-12-01,2000-02-29,91,1,0,30,30,0,0,0,30,0,0,Oregon,Cottage Grove,9686
16427,2000-2001,2000-12-01,2001-02-28,90,1,0,46,46,0,0,0,46,0,0,Oregon,Cottage Grove,9686
16428,2001-2002,2001-12-01,2002-02-28,90,1,0,35,35,0,0,0,35,0,0,Oregon,Cottage Grove,9686
16429,2002-2003,2002-12-01,2003-02-28,90,1,0,23,23,0,0,0,23,0,0,Oregon,Cottage Grove,9686
16430,2003-2004,2003-12-01,2004-02-29,91,14,1,20,21,0,1,1,22,0,0,Oregon,Cottage Grove,9686
16431,2004-2005,2004-12-01,2005-02-28,90,4,0,48,48,0,0,0,48,0,0,Oregon,Cottage Grove,9686
16432,2005-2006,2005-12-01,2006-02-28,90,0,4,55,59,0,0,0,59,0,0,Oregon,Cottage Grove,9686
16433,2006-2007,2006-12-01,2007-02-28,90,0,3,65,68,3,0,3,71,1,4,Oregon,Cottage Grove,9686
16434,2007-2008,2007-12-01,2008-04-20,142,13,1,75,76,25,2,27,103,7,34,Oregon,Cottage Grove,9686
16435,2008-2009,2008-12-01,2009-04-13,134,0,1,66,67,11,8,19,86,6,16,Oregon,Cottage Grove,9686
16436,2009-2010,2009-12-01,2010-02-28,90,0,4,43,47,0,0,0,47,0,0,Oregon,Cottage Grove,9686
16437,2010-2011,2010-11-22,2011-02-28,99,1,1,49,50,5,1,6,56,5,7,Oregon,Cottage Grove,9686
16438,2011-2012,2011-12-01,2012-03-21,112,0,1,65,66,20,13,33,99,6,22,Oregon,Cottage Grove,9686
16439,2012-2013,2012-12-01,2013-02-28,90,0,0,36,36,1,0,1,37,1,1,Oregon,Cottage Grove,9686
16440,2013-2014,2013-12-01,2014-02-28,90,0,8,78,86,9,29,38,124,4,20,Oregon,Cottage Grove,9686
16441,2014-2015,2014-12-01,2015-02-28,90,0,0,25,25,0,0,0,25,0,0,Oregon,Cottage Grove,9686
16442,2015-2016,2015-12-01,2016-02-29,91,0,1,31,32,1,0,1,33,1,2,Oregon,Cottage Grove,9686
16443,2016-2017,2016-12-01,2017-03-06,96,0,6,73,79,6,10,16,95,3,13,Oregon,Cottage Grove,9686
16444,2017-2018,2017-12-01,2018-02-28,90,0,0,36,36,7,5,12,48,2,8,Oregon,Cottage Grove,9686
16445,2018-2019,2018-12-01,2019-03-11,101,0,1,60,61,32,69,101,162,7,40,Oregon,Cottage Grove,9686
16446,2019-2020,2019-12-01,2020-02-29,91,0,0,29,29,0,0,0,29,0,0,Oregon,Cottage Grove,9686
16447,1951-1952,1951-08-29,1952-06-30,307,14,115,562,677,1145,3569,4714,5391,114,1535,Oregon,Crater Lake,0
16448,1952-1953,1952-11-12,1953-06-30,231,10,75,492,567,860,3261,4121,4688,100,1166,Oregon,Crater Lake,0
16449,1954-1955,1954-10-13,1955-06-13,244,8,124,585,709,719,2824,3543,4252,99,1095,Oregon,Crater Lake,0
16450,1955-1956,1955-09-15,1956-06-29,289,20,136,598,734,913,3323,4236,4970,111,1353,Oregon,Crater Lake,0
16451,1956-1957,1956-10-11,1957-06-15,248,14,92,488,580,670,2981,3651,4231,89,966,Oregon,Crater Lake,0
16452,1957-1958,1957-10-03,1958-06-22,263,1,74,480,554,799,3193,3992,4546,109,1101,Oregon,Crater Lake,0
16453,1958-1959,1958-10-19,1959-06-11,236,1,61,441,502,547,2582,3129,3631,87,809,Oregon,Crater Lake,0
16454,1959-1960,1959-09-18,1960-06-25,282,1,85,499,584,671,2765,3436,4020,107,1004,Oregon,Crater Lake,0
16455,1960-1961,1960-08-22,1961-06-21,304,3,71,502,573,720,3208,3928,4501,111,1062,Oregon,Crater Lake,0
16456,1961-1962,1961-09-21,1962-06-21,274,2,109,673,782,788,3374,4162,4944,105,1197,Oregon,Crater Lake,0
16457,1962-1963,1962-09-29,1963-06-29,274,0,56,474,530,662,2707,3369,3899,94,911,Oregon,Crater Lake,0
16458,1963-1964,1963-10-06,1964-06-24,263,1,82,546,628,807,3117,3924,4552,96,1140,Oregon,Crater Lake,0
16459,1964-1965,1964-09-01,1965-06-19,292,0,81,523,604,752,3197,3949,4553,89,1053,Oregon,Crater Lake,0
16460,1965-1966,1965-10-15,1966-06-07,236,10,94,531,625,631,2646,3277,3902,80,934,Oregon,Crater Lake,0
16461,1966-1967,1966-07-02,1967-06-27,361,3,93,585,678,792,3251,4043,4721,117,1202,Oregon,Crater Lake,0
16462,1967-1968,1967-10-02,1968-06-29,272,2,91,494,585,518,2529,3047,3632,88,844,Oregon,Crater Lake,0
16463,1968-1969,1968-08-18,1969-06-28,315,4,147,624,771,837,3046,3883,4654,131,1360,Oregon,Crater Lake,0
16464,1969-1970,1969-10-02,1970-06-29,271,0,83,524,607,731,2932,3663,4270,110,1048,Oregon,Crater Lake,0
16465,1970-1971,1970-10-06,1971-06-30,268,3,120,612,732,935,3623,4558,5290,119,1366,Oregon,Crater Lake,0
16466,1971-1972,1971-09-25,1972-06-30,280,0,119,618,737,856,3561,4417,5154,125,1283,Oregon,Crater Lake,0
16467,1972-1973,1972-08-16,1973-06-18,307,2,117,618,735,636,2943,3579,4314,111,1019,Oregon,Crater Lake,0
16468,1973-1974,1973-09-24,1974-06-30,280,0,126,612,738,877,3622,4499,5237,131,1328,Oregon,Crater Lake,0
16469,1974-1975,1974-07-10,1975-06-30,356,9,103,611,714,892,3220,4112,4826,106,1271,Oregon,Crater Lake,0
16470,1975-1976,1975-10-06,1976-06-25,264,4,92,616,708,717,3501,4218,4926,104,1079,Oregon,Crater Lake,0
16471,1976-1977,1976-07-01,1977-06-04,339,6,55,518,573,355,1710,2065,2638,70,581,Oregon,Crater Lake,0
16472,1977-1978,1977-10-07,1978-06-19,256,3,75,489,564,574,3178,3752,4316,107,882,Oregon,Crater Lake,0
16473,1978-1979,1978-09-11,1979-04-30,232,9,107,570,677,443,2107,2550,3227,83,722,Oregon,Crater Lake,0
16474,1979-1980,1979-10-19,1980-06-24,250,4,76,573,649,577,3437,4014,4663,106,899,Oregon,Crater Lake,0
16475,1980-1981,1980-10-12,1981-06-14,246,5,40,496,536,398,2477,2875,3411,80,620,Oregon,Crater Lake,0
16476,1981-1982,1981-07-07,1982-06-30,359,4,106,644,750,855,3501,4356,5106,111,1240,Oregon,Crater Lake,0
16477,1983-1984,1983-07-07,1984-06-30,360,14,83,571,654,788,3560,4348,5002,110,1100,Oregon,Crater Lake,0
16478,1984-1985,1984-09-23,1985-06-16,267,4,110,628,738,710,3434,4144,4882,96,1101,Oregon,Crater Lake,0
16479,1985-1986,1985-09-09,1986-06-18,283,11,80,546,626,720,3145,3865,4491,96,1020,Oregon,Crater Lake,0
16480,1986-1987,1986-07-04,1987-06-12,344,10,58,537,595,604,2849,3453,4048,91,872,Oregon,Crater Lake,0
16481,1987-1988,1987-11-02,1988-06-29,241,7,73,540,613,507,2775,3282,3895,99,805,Oregon,Crater Lake,0
16482,1988-1989,1988-11-06,1989-06-24,231,4,108,543,651,842,3277,4119,4770,101,1214,Oregon,Crater Lake,0
16483,1991-1992,1991-10-24,1992-06-13,234,9,33,356,389,341,2344,2685,3074,64,487,Oregon,Crater Lake,0
16484,1992-1993,1992-09-24,1993-06-30,280,4,103,534,637,843,3329,4172,4809,114,1232,Oregon,Crater Lake,0
16485,1993-1994,1993-10-16,1994-06-14,242,17,53,425,478,493,2510,3003,3481,74,705,Oregon,Crater Lake,0
16486,1994-1995,1994-11-01,1995-06-30,242,7,104,521,625,847,3501,4348,4973,110,1207,Oregon,Crater Lake,0
16487,1995-1996,1995-10-12,1996-06-15,248,7,72,437,509,741,2701,3442,3951,93,1014,Oregon,Crater Lake,0
16488,1996-1997,1996-09-16,1997-06-17,275,12,61,512,573,753,3157,3910,4483,105,1024,Oregon,Crater Lake,0
16489,1998-1999,1998-10-02,1999-06-30,272,11,123,582,705,958,3487,4445,5150,123,1384,Oregon,Crater Lake,0
16490,1999-2000,1999-08-31,2000-06-17,292,9,67,431,498,676,2970,3646,4144,122,994,Oregon,Crater Lake,0
16491,2000-2001,2000-09-02,2001-06-12,284,2,69,508,577,387,2431,2818,3395,89,654,Oregon,Crater Lake,0
16492,2001-2002,2001-10-24,2002-06-15,235,6,82,499,581,639,2919,3558,4139,93,957,Oregon,Crater Lake,0
16493,2002-2003,2002-09-30,2003-06-19,263,9,57,436,493,597,2965,3562,4055,94,835,Oregon,Crater Lake,0
16494,2003-2004,2003-09-17,2004-06-24,282,11,75,460,535,724,3234,3958,4493,109,1031,Oregon,Crater Lake,0
16495,2004-2005,2004-09-18,2005-06-20,276,12,54,470,524,542,3106,3648,4172,103,796,Oregon,Crater Lake,0
16496,2005-2006,2005-09-10,2006-06-30,294,10,94,528,622,794,3422,4216,4838,116,1157,Oregon,Crater Lake,0
16497,2008-2009,2008-10-10,2009-06-21,255,10,87,521,608,635,2745,3380,3988,101,1004,Oregon,Crater Lake,0
16498,2009-2010,2009-09-29,2010-06-30,275,13,124,564,688,587,3091,3678,4366,121,977,Oregon,Crater Lake,0
16499,2010-2011,2010-10-23,2011-06-30,251,4,180,554,734,945,3546,4491,5225,134,1449,Oregon,Crater Lake,0
16500,2011-2012,2011-10-05,2012-06-30,270,9,103,548,651,549,2896,3445,4096,108,923,Oregon,Crater Lake,0
16501,2012-2013,2012-10-20,2013-06-19,243,6,110,495,605,484,2715,3199,3804,83,775,Oregon,Crater Lake,0
16502,2016-2017,2016-10-03,2017-06-30,271,0,122,531,653,798,3381,4179,4832,118,1163,Oregon,Crater Lake,0
16503,2017-2018,2017-09-19,2018-06-10,265,9,116,497,613,479,2664,3143,3756,89,828,Oregon,Crater Lake,0
16504,2019-2020,2019-09-28,2020-06-17,264,11,109,468,577,510,2638,3148,3725,96,809,Oregon,Crater Lake,0
16505,1956-1957,1956-10-27,1957-03-09,134,4,78,440,518,80,543,623,1141,29,208,Oregon,Halfway,288
16506,1957-1958,1957-12-01,1958-05-12,163,0,26,271,297,72,585,657,954,14,102,Oregon,Halfway,288
16507,1958-1959,1958-11-17,1959-04-17,152,1,13,269,282,55,117,172,454,16,90,Oregon,Halfway,288
16508,1959-1960,1959-11-04,1960-03-18,136,4,40,471,511,70,510,580,1091,31,194,Oregon,Halfway,288
16509,1960-1961,1960-11-15,1961-03-27,133,0,11,312,323,75,255,330,653,22,115,Oregon,Halfway,288
16510,1961-1962,1961-10-23,1962-03-24,153,0,77,513,590,138,755,893,1483,36,274,Oregon,Halfway,288
16511,1962-1963,1962-11-17,1963-04-15,150,0,20,314,334,31,26,57,391,12,62,Oregon,Halfway,288
16512,1963-1964,1963-11-08,1964-05-02,177,1,55,513,568,175,936,1111,1679,45,297,Oregon,Halfway,288
16513,1964-1965,1964-11-22,1965-03-26,125,1,27,320,347,119,462,581,928,32,189,Oregon,Halfway,288
16514,1965-1966,1965-11-25,1966-03-21,117,0,18,289,307,52,150,202,509,20,100,Oregon,Halfway,288
16515,1966-1967,1966-10-22,1967-04-14,175,0,16,303,319,86,377,463,782,26,137,Oregon,Halfway,288
16516,1967-1968,1967-11-28,1968-02-29,94,0,43,304,347,77,468,545,892,24,163,Oregon,Halfway,288
16517,1968-1969,1968-11-15,1969-04-06,143,0,36,370,406,136,646,782,1188,36,252,Oregon,Halfway,288
16518,1969-1970,1969-11-17,1970-04-27,162,0,11,301,312,66,217,283,595,18,102,Oregon,Halfway,288
16519,1970-1971,1970-10-23,1971-03-17,146,0,38,363,401,90,574,664,1065,26,158,Oregon,Halfway,288
16520,1971-1972,1971-10-27,1972-03-25,151,0,59,398,457,157,787,944,1401,36,266,Oregon,Halfway,288
16521,1972-1973,1972-11-26,1973-03-13,108,0,81,343,424,62,549,611,1035,18,130,Oregon,Halfway,288
16522,1973-1974,1973-11-05,1974-03-08,124,0,64,305,369,137,677,814,1183,29,198,Oregon,Halfway,288
16523,1974-1975,1974-11-23,1975-04-04,133,1,41,385,426,189,910,1099,1525,40,297,Oregon,Halfway,288
16524,1975-1976,1975-10-23,1976-03-30,160,0,57,456,513,150,961,1111,1624,31,214,Oregon,Halfway,288
16525,1976-1977,1976-12-01,1977-04-01,122,1,35,381,416,40,215,255,671,16,77,Oregon,Halfway,288
16526,1977-1978,1977-11-19,1978-04-06,139,0,10,186,196,61,167,228,424,19,94,Oregon,Halfway,288
16527,1978-1979,1978-11-11,1979-04-02,143,1,133,570,703,100,853,953,1656,29,196,Oregon,Halfway,288
16528,1979-1980,1979-11-18,1980-03-27,131,0,25,260,285,68,317,385,670,17,106,Oregon,Halfway,288
16529,1980-1981,1980-11-21,1981-03-31,131,0,9,242,251,40,52,92,343,12,60,Oregon,Halfway,288
16530,1981-1982,1981-11-24,1982-04-07,135,1,55,364,419,177,661,838,1257,41,299,Oregon,Halfway,288
16531,1982-1983,1982-11-20,1983-03-27,128,0,27,275,302,87,472,559,861,18,124,Oregon,Halfway,288
16532,1983-1984,1983-11-19,1984-04-12,146,9,86,404,490,142,976,1118,1608,36,250,Oregon,Halfway,288
16533,1984-1985,1984-11-10,1985-03-31,142,1,114,567,681,154,1046,1200,1881,36,299,Oregon,Halfway,288
16534,1985-1986,1985-10-22,1986-02-28,130,4,107,456,563,119,767,886,1449,27,192,Oregon,Halfway,288
16535,1986-1987,1986-11-07,1987-03-06,120,2,42,317,359,85,521,606,965,24,157,Oregon,Halfway,288
16536,1987-1988,1987-11-24,1988-03-29,127,4,36,340,376,76,376,452,828,19,128,Oregon,Halfway,288
16537,1988-1989,1988-11-13,1989-03-26,134,8,94,505,599,206,1145,1351,1950,42,361,Oregon,Halfway,288
16538,1989-1990,1989-12-01,1990-03-11,101,4,6,275,281,112,243,355,636,19,164,Oregon,Halfway,288
16539,1990-1991,1990-11-21,1991-03-13,113,8,73,403,476,67,424,491,967,18,148,Oregon,Halfway,288
16540,1991-1992,1991-11-01,1992-02-29,121,2,6,244,250,36,244,280,530,11,53,Oregon,Halfway,288
16541,1992-1993,1992-11-21,1993-04-10,141,6,73,402,475,222,1109,1331,1806,45,373,Oregon,Halfway,288
16542,1994-1995,1994-11-04,1995-02-28,117,4,52,317,369,115,605,720,1089,20,186,Oregon,Halfway,288
16543,1995-1996,1995-11-07,1996-02-29,115,10,31,253,284,48,405,453,737,10,67,Oregon,Halfway,288
16544,1996-1997,1996-12-01,1997-03-09,99,12,18,231,249,78,347,425,674,18,118,Oregon,Halfway,288
16545,1997-1998,1997-12-01,1998-03-10,100,0,28,239,267,82,552,634,901,18,127,Oregon,Halfway,288
16546,1998-1999,1998-12-01,1999-03-22,112,0,41,332,373,121,756,877,1250,22,179,Oregon,Halfway,288
16547,1999-2000,1999-11-21,2000-03-07,108,3,35,256,291,124,815,939,1230,27,195,Oregon,Halfway,288
16548,2000-2001,2000-11-08,2001-04-02,146,19,49,371,420,80,523,603,1023,24,131,Oregon,Halfway,288
16549,2001-2002,2001-11-25,2002-03-27,123,0,45,391,436,161,1074,1235,1671,34,263,Oregon,Halfway,288
16550,2002-2003,2002-10-30,2003-02-28,122,8,7,237,244,37,169,206,450,7,48,Oregon,Halfway,288
16551,2003-2004,2003-11-24,2004-03-21,119,1,31,298,329,142,777,919,1248,30,230,Oregon,Halfway,288
16552,2004-2005,2004-11-30,2005-02-28,91,7,17,235,252,29,190,219,471,9,61,Oregon,Halfway,288
16553,2005-2006,2005-11-06,2006-03-24,139,13,48,434,482,87,674,761,1243,15,120,Oregon,Halfway,288
16554,2006-2007,2006-11-26,2007-03-05,100,4,48,336,384,48,315,363,747,14,84,Oregon,Halfway,288
16555,2007-2008,2007-11-20,2008-04-09,142,1,45,406,451,174,763,937,1388,39,300,Oregon,Halfway,288
16556,2008-2009,2008-12-01,2009-04-03,124,1,45,369,414,112,651,763,1177,27,216,Oregon,Halfway,288
16557,2009-2010,2009-11-13,2010-04-02,141,2,26,374,400,89,660,749,1149,21,142,Oregon,Halfway,288
16558,2011-2012,2011-11-16,2012-03-21,127,0,8,290,298,54,135,189,487,15,84,Oregon,Halfway,288
16559,2012-2013,2012-11-12,2013-03-01,110,4,62,287,349,58,329,387,736,19,125,Oregon,Halfway,288
16560,2013-2014,2013-11-05,2014-02-28,116,0,60,295,355,44,251,295,650,16,102,Oregon,Halfway,288
16561,2014-2015,2014-11-12,2015-02-28,109,0,46,217,263,48,288,336,599,17,92,Oregon,Halfway,288
16562,2015-2016,2015-11-09,2016-02-29,113,0,64,273,337,88,720,808,1145,22,144,Oregon,Halfway,288
16563,2016-2017,2016-12-01,2017-03-15,105,0,136,358,494,132,951,1083,1577,35,309,Oregon,Halfway,288
16564,2017-2018,2017-11-05,2018-03-07,123,0,30,238,268,44,169,213,481,17,99,Oregon,Halfway,288
16565,2018-2019,2018-12-01,2019-03-17,107,0,51,278,329,64,496,560,889,22,113,Oregon,Halfway,288
16566,2019-2020,2019-11-25,2020-03-05,102,0,27,216,243,76,528,604,847,19,121,Oregon,Halfway,288
16567,1950-1951,1950-12-01,1951-03-07,97,6,12,101,113,7,4,11,124,6,18,Oregon,Heppner,1291
16568,1951-1952,1951-12-01,1952-03-20,111,5,27,185,212,38,62,100,312,16,83,Oregon,Heppner,1291
16569,1952-1953,1952-11-25,1953-04-09,136,2,15,128,143,22,20,42,185,9,37,Oregon,Heppner,1291
16570,1953-1954,1953-12-01,1954-04-30,151,3,16,149,165,21,23,44,209,5,33,Oregon,Heppner,1291
16571,1954-1955,1954-12-01,1955-04-18,139,2,7,180,187,16,7,23,210,10,35,Oregon,Heppner,1291
16572,1955-1956,1955-11-01,1956-03-06,127,2,46,218,264,44,89,133,397,25,136,Oregon,Heppner,1291
16573,1956-1957,1956-11-20,1957-02-28,101,9,66,217,283,37,111,148,431,18,129,Oregon,Heppner,1291
16574,1957-1958,1957-12-01,1958-03-14,104,14,4,74,78,4,0,4,82,3,9,Oregon,Heppner,1291
16575,1958-1959,1958-11-15,1959-02-28,106,0,23,124,147,25,26,51,198,12,54,Oregon,Heppner,1291
16576,1959-1960,1959-11-14,1960-03-07,115,4,36,224,260,32,105,137,397,17,103,Oregon,Heppner,1291
16577,1960-1961,1960-12-01,1961-03-04,94,1,21,95,116,1,0,1,117,1,2,Oregon,Heppner,1291
16578,1961-1962,1961-11-24,1962-03-11,108,3,35,173,208,29,60,89,297,17,89,Oregon,Heppner,1291
16579,1962-1963,1962-11-22,1963-04-20,150,1,23,171,194,20,27,47,241,13,63,Oregon,Heppner,1291
16580,1963-1964,1963-12-01,1964-04-05,127,6,8,132,140,8,13,21,161,5,19,Oregon,Heppner,1291
16581,1964-1965,1964-11-22,1965-03-27,126,1,22,155,177,26,28,54,231,14,62,Oregon,Heppner,1291
16582,1965-1966,1965-12-01,1966-03-01,91,2,7,111,118,15,7,22,140,10,31,Oregon,Heppner,1291
16583,1966-1967,1966-12-01,1967-03-28,118,0,0,78,78,16,12,28,106,7,22,Oregon,Heppner,1291
16584,1967-1968,1967-11-27,1968-02-29,95,0,12,122,134,17,23,40,174,7,36,Oregon,Heppner,1291
16585,1968-1969,1968-12-01,1969-03-07,97,0,64,197,261,68,212,280,541,31,224,Oregon,Heppner,1291
16586,1969-1970,1969-11-27,1970-03-02,96,0,24,103,127,33,52,85,212,11,58,Oregon,Heppner,1291
16587,1970-1971,1970-11-22,1971-03-13,112,1,9,127,136,15,14,29,165,11,38,Oregon,Heppner,1291
16588,1971-1972,1971-10-27,1972-04-12,169,0,33,195,228,36,37,73,301,18,112,Oregon,Heppner,1291
16589,1972-1973,1972-10-29,1973-02-28,123,1,66,204,270,26,58,84,354,11,95,Oregon,Heppner,1291
16590,1973-1974,1973-11-04,1974-02-28,117,0,44,135,179,31,73,104,283,13,83,Oregon,Heppner,1291
16591,1974-1975,1974-12-01,1975-04-06,127,0,11,134,145,25,53,78,223,12,49,Oregon,Heppner,1291
16592,1975-1976,1975-11-10,1976-03-31,143,1,15,151,166,22,15,37,203,14,43,Oregon,Heppner,1291
16593,1976-1977,1976-11-25,1977-03-17,113,0,32,167,199,8,20,28,227,5,21,Oregon,Heppner,1291
16594,1977-1978,1977-11-18,1978-03-04,107,0,29,122,151,45,69,114,265,14,100,Oregon,Heppner,1291
16595,1978-1979,1978-11-11,1979-02-28,110,0,78,295,373,45,163,208,581,15,103,Oregon,Heppner,1291
16596,1979-1980,1979-11-15,1980-03-05,112,1,43,158,201,28,40,68,269,10,66,Oregon,Heppner,1291
16597,1980-1981,1980-11-14,1981-02-28,107,0,13,97,110,14,9,23,133,7,27,Oregon,Heppner,1291
16598,1981-1982,1981-11-24,1982-02-28,97,7,8,111,119,24,30,54,173,16,59,Oregon,Heppner,1291
16599,1983-1984,1983-11-29,1984-02-29,93,5,47,166,213,28,63,91,304,14,97,Oregon,Heppner,1291
16600,1985-1986,1985-11-10,1986-02-28,111,3,66,238,304,32,195,227,531,12,75,Oregon,Heppner,1291
16601,1986-1987,1986-11-09,1987-02-28,112,0,14,156,170,22,55,77,247,11,45,Oregon,Heppner,1291
16602,1987-1988,1987-12-01,1988-02-29,91,8,24,132,156,17,29,46,202,8,40,Oregon,Heppner,1291
16603,1988-1989,1988-11-13,1989-03-04,112,20,28,169,197,12,59,71,268,5,17,Oregon,Heppner,1291
16604,1989-1990,1989-11-30,1990-02-28,91,10,8,91,99,6,6,12,111,3,9,Oregon,Heppner,1291
16605,1990-1991,1990-12-01,1991-03-26,116,19,36,189,225,27,61,88,313,16,76,Oregon,Heppner,1291
16606,1991-1992,1991-10-29,1992-02-29,124,18,2,83,85,9,1,10,95,3,15,Oregon,Heppner,1291
16607,1992-1993,1992-11-23,1993-03-04,102,13,44,229,273,62,172,234,507,27,169,Oregon,Heppner,1291
16608,1993-1994,1993-11-23,1994-03-23,121,5,20,145,165,12,23,35,200,6,28,Oregon,Heppner,1291
16609,1994-1995,1994-12-01,1995-02-28,90,13,15,104,119,23,33,56,175,5,43,Oregon,Heppner,1291
16610,1995-1996,1995-12-01,1996-03-05,96,16,32,137,169,27,40,67,236,16,79,Oregon,Heppner,1291
16611,1996-1997,1996-11-19,1997-04-04,137,8,13,141,154,16,21,37,191,9,43,Oregon,Heppner,1291
16612,1997-1998,1997-12-01,1998-02-28,90,12,9,80,89,12,13,25,114,5,34,Oregon,Heppner,1291
16613,1998-1999,1998-12-01,1999-02-28,90,19,15,84,99,6,14,20,119,3,11,Oregon,Heppner,1291
16614,1999-2000,1999-12-01,2000-02-29,91,14,12,77,89,5,4,9,98,3,9,Oregon,Heppner,1291
16615,2000-2001,2000-11-18,2001-04-11,145,11,20,152,172,15,10,25,197,10,33,Oregon,Heppner,1291
16616,2002-2003,2002-12-01,2003-02-28,90,11,3,68,71,3,0,3,74,2,3,Oregon,Heppner,1291
16617,2004-2005,2004-12-01,2005-02-28,90,5,12,94,106,14,17,31,137,8,31,Oregon,Heppner,1291
16618,2005-2006,2005-12-01,2006-02-28,90,2,22,114,136,6,4,10,146,4,21,Oregon,Heppner,1291
16619,2006-2007,2006-11-27,2007-03-01,95,2,30,140,170,12,21,33,203,7,31,Oregon,Heppner,1291
16620,2008-2009,2008-12-01,2009-04-15,136,5,37,191,228,64,134,198,426,18,154,Oregon,Heppner,1291
16621,2009-2010,2009-12-01,2010-02-28,90,2,24,115,139,7,9,16,155,4,20,Oregon,Heppner,1291
16622,2011-2012,2011-11-18,2012-03-22,126,0,6,156,162,15,7,22,184,8,25,Oregon,Heppner,1291
16623,2012-2013,2012-11-27,2013-02-28,94,0,20,108,128,3,2,5,133,2,7,Oregon,Heppner,1291
16624,2013-2014,2013-12-01,2014-03-02,92,0,39,152,191,20,35,55,246,6,56,Oregon,Heppner,1291
16625,2014-2015,2014-11-13,2015-02-28,108,1,25,130,155,19,46,65,220,5,33,Oregon,Heppner,1291
16626,2015-2016,2015-11-23,2016-02-29,99,4,29,110,139,4,21,25,164,1,7,Oregon,Heppner,1291
16627,2016-2017,2016-12-01,2017-02-28,90,0,59,204,263,43,120,163,426,14,102,Oregon,Heppner,1291
16628,2017-2018,2017-12-01,2018-02-28,90,0,22,120,142,19,25,44,186,6,43,Oregon,Heppner,1291
16629,2018-2019,2018-11-13,2019-03-14,122,5,34,187,221,52,121,173,394,16,102,Oregon,Heppner,1291
16630,2019-2020,2019-11-27,2020-03-16,111,0,11,125,136,19,32,51,187,7,41,Oregon,Heppner,1291
16631,1950-1951,1950-12-01,1951-03-30,120,0,0,57,57,11,2,13,70,6,17,Oregon,Medford,74907
16632,1951-1952,1951-12-01,1952-03-19,110,0,9,98,107,32,21,53,160,18,51,Oregon,Medford,74907
16633,1952-1953,1952-12-01,1953-04-07,128,0,0,63,63,10,0,10,73,4,13,Oregon,Medford,74907
16634,1953-1954,1953-12-01,1954-03-10,100,0,1,57,58,9,2,11,69,3,11,Oregon,Medford,74907
16635,1954-1955,1954-12-01,1955-03-14,104,0,0,100,100,11,1,12,112,9,21,Oregon,Medford,74907
16636,1955-1956,1955-11-13,1956-03-07,116,0,0,74,74,45,26,71,145,14,62,Oregon,Medford,74907
16637,1956-1957,1956-10-27,1957-02-28,125,0,13,119,132,12,1,13,145,9,21,Oregon,Medford,74907
16638,1957-1958,1957-12-01,1958-02-28,90,0,1,35,36,3,0,3,39,3,6,Oregon,Medford,74907
16639,1958-1959,1958-11-14,1959-02-28,107,0,0,51,51,3,0,3,54,3,4,Oregon,Medford,74907
16640,1959-1960,1959-12-01,1960-02-29,91,0,7,90,97,7,0,7,104,6,18,Oregon,Medford,74907
16641,1960-1961,1960-11-25,1961-04-21,148,0,1,82,83,8,0,8,91,2,9,Oregon,Medford,74907
16642,1961-1962,1961-11-24,1962-03-10,107,0,11,120,131,27,28,55,186,11,36,Oregon,Medford,74907
16643,1962-1963,1962-12-01,1963-04-15,136,0,2,142,144,4,2,6,150,3,12,Oregon,Medford,74907
16644,1963-1964,1963-12-01,1964-03-12,103,0,5,120,125,4,0,4,129,4,8,Oregon,Medford,74907
16645,1964-1965,1964-11-13,1965-02-28,108,0,2,72,74,30,30,60,134,13,40,Oregon,Medford,74907
16646,1965-1966,1965-12-01,1966-03-16,106,0,2,105,107,21,8,29,136,11,34,Oregon,Medford,74907
16647,1966-1967,1966-12-01,1967-04-17,138,0,1,63,64,11,2,13,77,6,17,Oregon,Medford,74907
16648,1967-1968,1967-12-01,1968-02-29,91,0,2,87,89,18,6,24,113,11,36,Oregon,Medford,74907
16649,1968-1969,1968-12-01,1969-02-28,90,0,2,57,59,31,20,51,110,20,53,Oregon,Medford,74907
16650,1969-1970,1969-12-01,1970-04-26,147,0,5,76,81,5,0,5,86,4,9,Oregon,Medford,74907
16651,1970-1971,1970-12-01,1971-03-16,106,0,1,77,78,28,7,35,113,11,41,Oregon,Medford,74907
16652,1971-1972,1971-12-01,1972-03-25,116,0,4,68,72,15,2,17,89,12,25,Oregon,Medford,74907
16653,1972-1973,1972-12-01,1973-02-28,90,0,15,106,121,21,45,66,187,9,51,Oregon,Medford,74907
16654,1973-1974,1973-12-01,1974-03-06,96,0,0,67,67,9,0,9,76,4,13,Oregon,Medford,74907
16655,1974-1975,1974-12-01,1975-04-14,135,0,5,69,74,22,11,33,107,11,35,Oregon,Medford,74907
16656,1975-1976,1975-11-28,1976-03-01,95,0,0,75,75,12,1,13,88,9,18,Oregon,Medford,74907
16657,1976-1977,1976-12-01,1977-02-28,90,0,11,127,138,3,0,3,141,2,6,Oregon,Medford,74907
16658,1977-1978,1977-11-20,1978-02-28,101,0,1,34,35,14,8,22,57,4,20,Oregon,Medford,74907
16659,1978-1979,1978-12-01,1979-02-28,90,0,5,102,107,1,1,2,109,1,2,Oregon,Medford,74907
16660,1979-1980,1979-12-01,1980-03-15,106,0,3,67,70,3,0,3,73,3,7,Oregon,Medford,74907
16661,1980-1981,1980-12-01,1981-02-28,90,0,4,57,61,3,0,3,64,3,10,Oregon,Medford,74907
16662,1981-1982,1981-12-01,1982-03-28,118,0,5,70,75,14,4,18,93,8,18,Oregon,Medford,74907
16663,1982-1983,1982-12-01,1983-02-28,90,0,2,56,58,0,0,0,58,0,0,Oregon,Medford,74907
16664,1983-1984,1983-12-01,1984-02-29,91,0,2,53,55,5,2,7,62,3,11,Oregon,Medford,74907
16665,1984-1985,1984-11-23,1985-03-27,125,0,0,105,105,13,0,13,118,12,21,Oregon,Medford,74907
16666,1985-1986,1985-11-18,1986-02-28,103,0,0,72,72,3,0,3,75,3,4,Oregon,Medford,74907
16667,1986-1987,1986-12-01,1987-02-28,90,0,0,70,70,0,0,0,70,0,0,Oregon,Medford,74907
16668,1987-1988,1987-12-01,1988-02-29,91,0,0,60,60,17,1,18,78,8,21,Oregon,Medford,74907
16669,1988-1989,1988-12-01,1989-03-02,92,0,1,91,92,18,4,22,114,12,32,Oregon,Medford,74907
16670,1989-1990,1989-12-01,1990-03-11,101,0,3,93,96,11,0,11,107,10,27,Oregon,Medford,74907
16671,1990-1991,1990-12-01,1991-03-10,100,0,5,120,125,8,2,10,135,7,19,Oregon,Medford,74907
16672,1991-1992,1991-12-01,1992-02-29,91,0,0,50,50,0,0,0,50,0,0,Oregon,Medford,74907
16673,1992-1993,1992-12-01,1993-02-28,90,0,0,61,61,9,1,10,71,6,14,Oregon,Medford,74907
16674,1993-1994,1993-11-22,1994-02-28,99,0,0,91,91,1,0,1,92,1,2,Oregon,Medford,74907
16675,1994-1995,1994-11-25,1995-02-28,96,0,0,41,41,5,1,6,47,4,10,Oregon,Medford,74907
16676,1995-1996,1995-12-01,1996-03-27,118,0,0,46,46,4,0,4,50,4,5,Oregon,Medford,74907
16677,1996-1997,1996-12-01,1997-02-28,90,0,0,54,54,0,0,0,54,0,0,Oregon,Medford,74907
16678,2000-2001,2000-11-14,2001-02-28,107,2,0,82,82,2,1,3,85,2,2,Oregon,Medford,74907
16679,2001-2002,2001-12-01,2002-03-17,107,20,0,57,57,2,0,2,59,2,4,Oregon,Medford,74907
16680,2002-2003,2002-12-01,2003-02-28,90,0,0,34,34,0,0,0,34,0,0,Oregon,Medford,74907
16681,2003-2004,2003-12-01,2004-02-29,91,0,0,27,27,6,3,9,36,4,9,Oregon,Medford,74907
16682,2004-2005,2004-11-30,2005-02-28,91,0,0,55,55,9,3,12,67,6,13,Oregon,Medford,74907
16683,2005-2006,2005-11-30,2006-03-10,101,0,2,55,57,7,0,7,64,4,10,Oregon,Medford,74907
16684,2006-2007,2006-11-28,2007-02-28,93,0,3,85,88,15,8,23,111,9,28,Oregon,Medford,74907
16685,2007-2008,2007-12-01,2008-02-29,91,0,0,72,72,16,4,20,92,8,27,Oregon,Medford,74907
16686,2008-2009,2008-12-01,2009-02-28,90,0,0,70,70,11,3,14,84,9,19,Oregon,Medford,74907
16687,2009-2010,2009-12-01,2010-02-28,90,0,3,44,47,1,0,1,48,1,2,Oregon,Medford,74907
16688,2010-2011,2010-11-23,2011-04-07,136,0,2,66,68,6,1,7,75,5,9,Oregon,Medford,74907
16689,2011-2012,2011-12-01,2012-03-01,92,0,1,94,95,6,0,6,101,4,9,Oregon,Medford,74907
16690,2012-2013,2012-12-01,2013-02-28,90,0,2,65,67,6,1,7,74,6,14,Oregon,Medford,74907
16691,2013-2014,2013-12-01,2014-02-28,90,0,9,90,99,5,8,13,112,2,12,Oregon,Medford,74907
16692,2014-2015,2014-12-01,2015-02-28,90,0,0,31,31,0,0,0,31,0,0,Oregon,Medford,74907
16693,2015-2016,2015-12-01,2016-02-29,91,0,0,22,22,5,0,5,27,4,5,Oregon,Medford,74907
16694,2016-2017,2016-12-01,2017-02-28,90,0,2,61,63,19,19,38,101,7,29,Oregon,Medford,74907
16695,2017-2018,2017-12-01,2018-02-28,90,0,0,61,61,6,0,6,67,3,9,Oregon,Medford,74907
16696,2018-2019,2018-12-01,2019-02-28,90,0,0,52,52,11,1,12,64,4,15,Oregon,Medford,74907
16697,2019-2020,2019-12-01,2020-02-29,91,0,0,42,42,1,0,1,43,1,2,Oregon,Medford,74907
16698,1950-1951,1950-11-11,1951-03-16,126,0,22,109,131,25,23,48,179,14,50,Oregon,Pendleton,16612
16699,1951-1952,1951-11-14,1952-03-19,127,0,39,158,197,43,57,100,297,27,124,Oregon,Pendleton,16612
16700,1952-1953,1952-11-24,1953-03-01,98,0,17,69,86,17,10,27,113,9,29,Oregon,Pendleton,16612
16701,1953-1954,1953-12-01,1954-03-17,107,0,21,87,108,14,27,41,149,8,35,Oregon,Pendleton,16612
16702,1954-1955,1954-12-01,1955-03-25,115,0,13,131,144,25,13,38,182,17,53,Oregon,Pendleton,16612
16703,1955-1956,1955-11-01,1956-03-06,127,0,70,222,292,60,120,180,472,38,192,Oregon,Pendleton,16612
16704,1956-1957,1956-11-24,1957-03-05,102,1,85,204,289,46,134,180,469,21,156,Oregon,Pendleton,16612
16705,1957-1958,1957-12-01,1958-03-17,107,0,7,57,64,6,9,15,79,3,11,Oregon,Pendleton,16612
16706,1958-1959,1958-11-15,1959-02-28,106,0,22,111,133,33,36,69,202,16,77,Oregon,Pendleton,16612
16707,1959-1960,1959-11-13,1960-03-08,117,0,51,210,261,31,111,142,403,19,103,Oregon,Pendleton,16612
16708,1960-1961,1960-11-29,1961-03-11,103,0,26,76,102,3,0,3,105,3,6,Oregon,Pendleton,16612
16709,1961-1962,1961-11-24,1962-03-02,99,0,40,125,165,40,74,114,279,15,85,Oregon,Pendleton,16612
16710,1962-1963,1962-12-01,1963-04-20,141,0,32,121,153,19,35,54,207,8,56,Oregon,Pendleton,16612
16711,1963-1964,1963-12-01,1964-03-21,112,0,14,77,91,5,10,15,106,5,11,Oregon,Pendleton,16612
16712,1964-1965,1964-11-13,1965-03-26,134,0,28,132,160,27,33,60,220,19,84,Oregon,Pendleton,16612
16713,1965-1966,1965-11-29,1966-03-20,112,0,11,71,82,25,10,35,117,15,39,Oregon,Pendleton,16612
16714,1966-1967,1966-11-08,1967-03-29,142,0,0,51,51,17,3,20,71,12,27,Oregon,Pendleton,16612
16715,1967-1968,1967-11-27,1968-02-29,95,0,12,99,111,8,10,18,129,7,24,Oregon,Pendleton,16612
16716,1968-1969,1968-12-01,1969-02-28,90,0,72,175,247,66,165,231,478,36,242,Oregon,Pendleton,16612
16717,1969-1970,1969-11-27,1970-03-03,97,0,29,94,123,25,48,73,196,12,55,Oregon,Pendleton,16612
16718,1970-1971,1970-11-22,1971-03-13,112,0,14,111,125,21,15,36,161,15,50,Oregon,Pendleton,16612
16719,1971-1972,1971-10-27,1972-04-12,169,0,42,142,184,39,56,95,279,21,114,Oregon,Pendleton,16612
16720,1972-1973,1972-12-01,1973-04-19,140,0,81,201,282,31,101,132,414,12,99,Oregon,Pendleton,16612
16721,1973-1974,1973-10-31,1974-02-28,121,0,48,101,149,31,39,70,219,14,55,Oregon,Pendleton,16612
16722,1974-1975,1974-12-01,1975-04-14,135,0,8,71,79,36,49,85,164,17,62,Oregon,Pendleton,16612
16723,1975-1976,1975-11-10,1976-03-11,123,0,15,91,106,16,11,27,133,13,34,Oregon,Pendleton,16612
16724,1976-1977,1976-12-01,1977-03-16,106,0,48,122,170,11,39,50,220,8,34,Oregon,Pendleton,16612
16725,1977-1978,1977-11-18,1978-03-06,109,0,43,122,165,44,86,130,295,16,104,Oregon,Pendleton,16612
16726,1978-1979,1978-11-11,1979-02-28,110,0,124,275,399,52,232,284,683,25,185,Oregon,Pendleton,16612
16727,1979-1980,1979-11-14,1980-03-07,115,0,60,160,220,39,61,100,320,17,103,Oregon,Pendleton,16612
16728,1980-1981,1980-11-14,1981-02-28,107,0,18,89,107,15,10,25,132,8,31,Oregon,Pendleton,16612
16729,1981-1982,1981-11-27,1982-03-19,113,0,15,114,129,27,17,44,173,18,61,Oregon,Pendleton,16612
16730,1982-1983,1982-11-22,1983-02-28,99,0,20,59,79,4,1,5,84,4,11,Oregon,Pendleton,16612
16731,1983-1984,1983-12-01,1984-02-29,91,0,57,155,212,40,92,132,344,17,117,Oregon,Pendleton,16612
16732,1984-1985,1984-12-01,1985-03-28,118,0,57,170,227,30,70,100,327,15,89,Oregon,Pendleton,16612
16733,1985-1986,1985-11-10,1986-02-28,111,0,112,246,358,46,251,297,655,22,161,Oregon,Pendleton,16612
16734,1986-1987,1986-11-09,1987-02-28,112,0,29,129,158,24,35,59,217,12,56,Oregon,Pendleton,16612
16735,1987-1988,1987-11-30,1988-03-29,121,0,34,133,167,23,30,53,220,13,57,Oregon,Pendleton,16612
16736,1988-1989,1988-12-01,1989-03-16,106,0,48,164,212,21,28,49,261,12,71,Oregon,Pendleton,16612
16737,1989-1990,1989-11-29,1990-03-23,115,0,20,90,110,7,7,14,124,5,16,Oregon,Pendleton,16612
16738,1990-1991,1990-12-01,1991-03-26,116,1,51,178,229,14,49,63,292,10,66,Oregon,Pendleton,16612
16739,1991-1992,1991-10-28,1992-02-29,125,0,8,76,84,8,3,11,95,7,17,Oregon,Pendleton,16612
16740,1992-1993,1992-11-25,1993-03-06,102,0,78,229,307,71,189,260,567,30,204,Oregon,Pendleton,16612
16741,1993-1994,1993-11-22,1994-03-23,122,0,30,123,153,27,28,55,208,6,46,Oregon,Pendleton,16612
16742,1994-1995,1994-11-17,1995-02-28,104,0,28,103,131,21,27,48,179,10,49,Oregon,Pendleton,16612
16743,1998-1999,1998-12-01,1999-02-28,90,0,15,68,83,5,1,6,89,3,11,Oregon,Pendleton,16612
16744,1999-2000,1999-12-01,2000-03-06,97,0,15,63,78,18,6,24,102,10,33,Oregon,Pendleton,16612
16745,2000-2001,2000-11-20,2001-02-28,101,0,36,111,147,17,6,23,170,14,40,Oregon,Pendleton,16612
16746,2001-2002,2001-12-01,2002-03-07,97,0,6,92,98,10,3,13,111,7,22,Oregon,Pendleton,16612
16747,2002-2003,2002-10-30,2003-02-28,122,0,8,80,88,5,0,5,93,4,11,Oregon,Pendleton,16612
16748,2003-2004,2003-11-22,2004-02-29,100,2,31,118,149,37,115,152,301,16,109,Oregon,Pendleton,16612
16749,2004-2005,2004-11-30,2005-02-28,91,0,10,99,109,9,5,14,123,7,21,Oregon,Pendleton,16612
16750,2005-2006,2005-11-22,2006-02-28,99,0,23,125,148,7,2,9,157,7,29,Oregon,Pendleton,16612
16751,2006-2007,2006-11-27,2007-03-01,95,0,39,128,167,10,1,11,178,8,45,Oregon,Pendleton,16612
16752,2007-2008,2007-11-19,2008-03-30,133,0,22,147,169,54,60,114,283,21,90,Oregon,Pendleton,16612
16753,2008-2009,2008-12-01,2009-04-01,122,0,46,171,217,63,98,161,378,22,166,Oregon,Pendleton,16612
16754,2009-2010,2009-12-01,2010-02-28,90,0,24,109,133,9,15,24,157,4,22,Oregon,Pendleton,16612
16755,2010-2011,2010-11-21,2011-03-01,101,0,36,160,196,35,52,87,283,15,84,Oregon,Pendleton,16612
16756,2011-2012,2011-11-19,2012-03-22,125,0,14,164,178,16,6,22,200,11,34,Oregon,Pendleton,16612
16757,2012-2013,2012-11-27,2013-03-22,116,0,22,106,128,7,1,8,136,7,15,Oregon,Pendleton,16612
16758,2013-2014,2013-12-01,2014-03-02,92,0,48,155,203,32,45,77,280,13,105,Oregon,Pendleton,16612
16759,2014-2015,2014-11-12,2015-02-28,109,0,33,129,162,9,32,41,203,4,22,Oregon,Pendleton,16612
16760,2015-2016,2015-11-22,2016-02-29,100,0,31,101,132,8,17,25,157,7,26,Oregon,Pendleton,16612
16761,2016-2017,2016-12-01,2017-03-05,95,0,69,215,284,64,130,194,478,30,195,Oregon,Pendleton,16612
16762,2017-2018,2017-12-01,2018-03-01,91,0,24,98,122,24,36,60,182,13,71,Oregon,Pendleton,16612
16763,2018-2019,2018-11-12,2019-03-13,122,0,44,173,217,53,128,181,398,20,123,Oregon,Pendleton,16612
16764,2019-2020,2019-11-28,2020-03-16,110,0,8,96,104,20,17,37,141,8,39,Oregon,Pendleton,16612
16765,1950-1951,1950-12-01,1951-03-10,100,0,3,27,30,19,10,29,59,9,25,Oregon,Portland,583776
16766,1951-1952,1951-12-01,1952-02-29,91,0,6,53,59,17,18,35,94,10,30,Oregon,Portland,583776
16767,1952-1953,1952-12-01,1953-02-28,90,0,0,16,16,0,0,0,16,0,0,Oregon,Portland,583776
16768,1953-1954,1953-12-01,1954-02-28,90,0,2,25,27,16,11,27,54,8,23,Oregon,Portland,583776
16769,1954-1955,1954-12-01,1955-03-14,104,0,0,41,41,8,1,9,50,7,12,Oregon,Portland,583776
16770,1955-1956,1955-11-11,1956-03-05,116,0,13,68,81,33,32,65,146,11,57,Oregon,Portland,583776
16771,1956-1957,1956-12-01,1957-02-28,90,0,15,82,97,14,9,23,120,10,37,Oregon,Portland,583776
16772,1957-1958,1957-12-01,1958-02-28,90,0,0,10,10,0,0,0,10,0,0,Oregon,Portland,583776
16773,1958-1959,1958-12-01,1959-02-28,90,0,3,23,26,4,3,7,33,2,7,Oregon,Portland,583776
16774,1959-1960,1959-12-01,1960-03-05,96,0,4,58,62,19,27,46,108,7,31,Oregon,Portland,583776
16775,1960-1961,1960-12-01,1961-02-28,90,0,0,25,25,0,0,0,25,0,0,Oregon,Portland,583776
16776,1961-1962,1961-12-01,1962-03-02,92,0,2,52,54,9,3,12,66,6,15,Oregon,Portland,583776
16777,1962-1963,1962-12-01,1963-02-28,90,0,6,48,54,7,3,10,64,3,15,Oregon,Portland,583776
16778,1963-1964,1963-12-01,1964-02-29,91,0,0,49,49,0,0,0,49,0,0,Oregon,Portland,583776
16779,1964-1965,1964-12-01,1965-03-25,115,0,8,52,60,17,16,33,93,4,29,Oregon,Portland,583776
16780,1965-1966,1965-12-01,1966-03-03,93,0,0,41,41,2,0,2,43,2,2,Oregon,Portland,583776
16781,1966-1967,1966-12-01,1967-02-28,90,0,0,13,13,0,0,0,13,0,0,Oregon,Portland,583776
16782,1967-1968,1967-12-01,1968-02-29,91,0,2,37,39,14,9,23,62,4,18,Oregon,Portland,583776
16783,1968-1969,1968-12-01,1969-02-28,90,0,21,70,91,49,81,130,221,17,99,Oregon,Portland,583776
16784,1969-1970,1969-12-01,1970-02-28,90,0,0,23,23,0,0,0,23,0,0,Oregon,Portland,583776
16785,1970-1971,1970-12-01,1971-02-28,90,0,1,34,35,15,8,23,58,8,22,Oregon,Portland,583776
16786,1971-1972,1971-12-01,1972-02-29,91,0,2,43,45,7,4,11,56,4,14,Oregon,Portland,583776
16787,1972-1973,1972-12-01,1973-02-28,90,0,14,62,76,8,23,31,107,4,22,Oregon,Portland,583776
16788,1973-1974,1973-12-01,1974-02-28,90,0,7,43,50,0,0,0,50,0,0,Oregon,Portland,583776
16789,1974-1975,1974-12-01,1975-02-28,90,0,0,27,27,1,0,1,28,1,2,Oregon,Portland,583776
16790,1975-1976,1975-12-01,1976-02-29,91,0,0,30,30,0,0,0,30,0,0,Oregon,Portland,583776
16791,1976-1977,1976-12-01,1977-02-28,90,0,2,52,54,0,0,0,54,0,0,Oregon,Portland,583776
16792,1977-1978,1977-11-18,1978-03-03,106,0,0,31,31,13,8,21,52,4,16,Oregon,Portland,583776
16793,1978-1979,1978-11-19,1979-02-28,102,0,18,97,115,14,11,25,140,8,27,Oregon,Portland,583776
16794,1979-1980,1979-12-01,1980-02-29,91,0,8,46,54,17,20,37,91,5,26,Oregon,Portland,583776
16795,1980-1981,1980-12-01,1981-02-28,90,0,0,24,24,0,0,0,24,0,0,Oregon,Portland,583776
16796,1981-1982,1981-12-01,1982-02-28,90,0,3,31,34,8,4,12,46,4,13,Oregon,Portland,583776
16797,1982-1983,1982-12-01,1983-02-28,90,0,0,23,23,0,0,0,23,0,0,Oregon,Portland,583776
16798,1983-1984,1983-12-01,1984-02-29,91,0,10,44,54,7,0,7,61,6,17,Oregon,Portland,583776
16799,1984-1985,1984-12-01,1985-02-28,90,0,2,56,58,12,3,15,73,6,22,Oregon,Portland,583776
16800,1985-1986,1985-11-17,1986-02-28,104,0,10,75,85,17,6,23,108,10,33,Oregon,Portland,583776
16801,1986-1987,1986-12-01,1987-02-28,90,0,0,32,32,1,0,1,33,1,1,Oregon,Portland,583776
16802,1987-1988,1987-12-01,1988-02-29,91,0,0,41,41,7,1,8,49,5,11,Oregon,Portland,583776
16803,1988-1989,1988-12-01,1989-03-03,93,0,7,51,58,5,2,7,65,4,10,Oregon,Portland,583776
16804,1989-1990,1989-12-01,1990-02-28,90,0,0,32,32,14,4,18,50,6,18,Oregon,Portland,583776
16805,1990-1991,1990-12-01,1991-02-28,90,0,13,66,79,5,0,5,84,5,18,Oregon,Portland,583776
16806,1991-1992,1991-12-01,1992-02-29,91,0,0,16,16,0,0,0,16,0,0,Oregon,Portland,583776
16807,1992-1993,1992-12-01,1993-02-28,90,0,2,50,52,23,14,37,89,10,32,Oregon,Portland,583776
16808,1993-1994,1993-12-01,1994-02-28,90,0,0,30,30,4,1,5,35,2,5,Oregon,Portland,583776
16809,1994-1995,1994-11-17,1995-02-28,104,0,1,27,28,8,6,14,42,5,12,Oregon,Portland,583776
16810,1995-1996,1995-12-01,1996-02-29,91,2,8,33,41,13,17,30,71,4,21,Oregon,Portland,583776
16811,1996-1997,1996-12-01,1997-02-28,90,0,0,29,29,0,0,0,29,0,0,Oregon,Portland,583776
16812,1997-1998,1997-12-01,1998-02-28,90,0,2,15,17,12,18,30,47,3,18,Oregon,Portland,583776
16813,1998-1999,1998-12-01,1999-02-28,90,0,5,27,32,3,0,3,35,1,5,Oregon,Portland,583776
16814,1999-2000,1999-12-01,2000-02-29,91,0,0,22,22,2,0,2,24,1,3,Oregon,Portland,583776
16815,2000-2001,2000-12-01,2001-02-28,90,0,0,26,26,1,0,1,27,1,2,Oregon,Portland,583776
16816,2001-2002,2001-12-01,2002-02-28,90,0,0,18,18,2,0,2,20,2,3,Oregon,Portland,583776
16817,2002-2003,2002-12-01,2003-02-28,90,0,0,19,19,0,0,0,19,0,0,Oregon,Portland,583776
16818,2003-2004,2003-11-19,2004-02-29,103,0,5,23,28,17,30,47,75,6,27,Oregon,Portland,583776
16819,2004-2005,2004-12-01,2005-02-28,90,0,1,28,29,0,0,0,29,0,0,Oregon,Portland,583776
16820,2005-2006,2005-12-01,2006-03-10,100,0,0,26,26,4,0,4,30,3,5,Oregon,Portland,583776
16821,2006-2007,2006-12-01,2007-02-28,90,0,2,38,40,5,4,9,49,2,8,Oregon,Portland,583776
16822,2007-2008,2007-12-01,2008-02-29,91,0,0,23,23,0,0,0,23,0,0,Oregon,Portland,583776
16823,2008-2009,2008-12-01,2009-03-08,98,0,7,54,61,36,46,82,143,14,55,Oregon,Portland,583776
16824,2009-2010,2009-12-01,2010-02-28,90,0,3,37,40,3,2,5,45,1,4,Oregon,Portland,583776
16825,2010-2011,2010-11-22,2011-02-28,99,0,2,33,35,3,0,3,38,2,5,Oregon,Portland,583776
16826,2011-2012,2011-12-01,2012-03-21,112,0,0,37,37,6,1,7,44,4,10,Oregon,Portland,583776
16827,2012-2013,2012-12-01,2013-02-28,90,0,0,21,21,0,0,0,21,0,0,Oregon,Portland,583776
16828,2013-2014,2013-12-01,2014-02-28,90,0,10,53,63,10,17,27,90,4,23,Oregon,Portland,583776
16829,2014-2015,2014-12-01,2015-02-28,90,0,0,15,15,0,0,0,15,0,0,Oregon,Portland,583776
16830,2015-2016,2015-12-01,2016-02-29,91,0,1,11,12,3,1,4,16,2,5,Oregon,Portland,583776
16831,2016-2017,2016-12-01,2017-02-28,90,0,6,65,71,16,38,54,125,5,24,Oregon,Portland,583776
16832,2017-2018,2017-12-01,2018-02-28,90,0,0,28,28,12,8,20,48,5,18,Oregon,Portland,583776
16833,2018-2019,2018-12-01,2019-03-06,96,0,0,33,33,11,9,20,53,6,17,Oregon,Portland,583776
16834,2019-2020,2019-12-01,2020-03-14,105,0,0,21,21,1,0,1,22,1,2,Oregon,Portland,583776
16835,1950-1951,1950-11-26,1951-03-22,117,0,33,209,242,33,30,63,305,18,74,Pennsylvania,Allentown,118032
16836,1951-1952,1951-11-19,1952-03-16,119,0,22,213,235,33,70,103,338,17,83,Pennsylvania,Allentown,118032
16837,1952-1953,1952-11-30,1953-03-09,100,0,13,145,158,26,29,55,213,13,57,Pennsylvania,Allentown,118032
16838,1953-1954,1953-11-06,1954-03-05,120,0,28,200,228,31,75,106,334,11,65,Pennsylvania,Allentown,118032
16839,1954-1955,1954-12-01,1955-03-26,116,0,30,220,250,23,24,47,297,13,54,Pennsylvania,Allentown,118032
16840,1955-1956,1955-11-19,1956-04-08,142,0,37,272,309,54,54,108,417,26,123,Pennsylvania,Allentown,118032
16841,1956-1957,1956-11-23,1957-04-05,134,0,23,224,247,33,29,62,309,17,82,Pennsylvania,Allentown,118032
16842,1957-1958,1957-12-01,1958-03-23,113,0,41,213,254,87,137,224,478,16,115,Pennsylvania,Allentown,118032
16843,1958-1959,1958-11-28,1959-04-13,137,0,42,304,346,36,38,74,420,20,91,Pennsylvania,Allentown,118032
16844,1959-1960,1959-11-18,1960-03-26,130,0,24,224,248,57,104,161,409,21,115,Pennsylvania,Allentown,118032
16845,1960-1961,1960-12-01,1961-04-13,134,0,68,339,407,93,263,356,763,28,199,Pennsylvania,Allentown,118032
16846,1961-1962,1961-11-20,1962-03-10,111,0,40,262,302,53,105,158,460,21,115,Pennsylvania,Allentown,118032
16847,1962-1963,1962-10-26,1963-04-23,180,0,65,377,442,68,201,269,711,26,146,Pennsylvania,Allentown,118032
16848,1963-1964,1963-12-01,1964-03-22,113,0,41,277,318,76,188,264,582,22,145,Pennsylvania,Allentown,118032
16849,1964-1965,1964-11-22,1965-04-02,132,0,43,269,312,35,71,106,418,18,92,Pennsylvania,Allentown,118032
16850,1965-1966,1965-12-01,1966-03-06,96,0,35,207,242,54,125,179,421,15,116,Pennsylvania,Allentown,118032
16851,1966-1967,1966-12-01,1967-04-27,148,0,39,286,325,102,188,290,615,34,184,Pennsylvania,Allentown,118032
16852,1967-1968,1967-11-17,1968-03-12,117,0,57,313,370,30,106,136,506,16,99,Pennsylvania,Allentown,118032
16853,1968-1969,1968-11-10,1969-03-07,118,0,29,213,242,44,39,83,325,15,76,Pennsylvania,Allentown,118032
16854,1969-1970,1969-12-01,1970-04-01,122,0,76,309,385,72,229,301,686,28,182,Pennsylvania,Allentown,118032
16855,1970-1971,1970-12-01,1971-04-06,127,0,63,262,325,43,64,107,432,19,98,Pennsylvania,Allentown,118032
16856,1971-1972,1971-11-24,1972-04-07,136,0,26,234,260,46,78,124,384,23,93,Pennsylvania,Allentown,118032
16857,1972-1973,1972-10-18,1973-03-18,152,0,23,205,228,16,9,25,253,12,41,Pennsylvania,Allentown,118032
16858,1973-1974,1973-12-01,1974-04-10,131,0,33,188,221,32,72,104,325,14,72,Pennsylvania,Allentown,118032
16859,1974-1975,1974-11-26,1975-03-15,110,0,19,169,188,33,64,97,285,14,68,Pennsylvania,Allentown,118032
16860,1975-1976,1975-12-01,1976-03-17,108,0,40,212,252,30,40,70,322,14,74,Pennsylvania,Allentown,118032
16861,1976-1977,1976-11-29,1977-03-23,115,0,74,297,371,43,196,239,610,22,118,Pennsylvania,Allentown,118032
16862,1977-1978,1977-11-27,1978-04-03,128,0,76,286,362,79,340,419,781,22,138,Pennsylvania,Allentown,118032
16863,1978-1979,1978-11-27,1979-02-28,94,0,68,237,305,54,125,179,484,20,139,Pennsylvania,Allentown,118032
16864,1979-1980,1979-12-01,1980-04-01,123,0,32,199,231,35,49,84,315,15,77,Pennsylvania,Allentown,118032
16865,1980-1981,1980-11-17,1981-03-20,124,0,56,271,327,42,89,131,458,20,103,Pennsylvania,Allentown,118032
16866,1981-1982,1981-12-01,1982-04-10,131,0,68,283,351,62,164,226,577,22,126,Pennsylvania,Allentown,118032
16867,1982-1983,1982-12-01,1983-04-20,141,0,22,167,189,67,127,194,383,13,89,Pennsylvania,Allentown,118032
16868,1983-1984,1983-12-01,1984-03-31,122,0,59,259,318,51,106,157,475,24,135,Pennsylvania,Allentown,118032
16869,1984-1985,1984-12-01,1985-03-04,94,0,38,176,214,40,72,112,326,19,92,Pennsylvania,Allentown,118032
16870,1985-1986,1985-12-01,1986-04-23,144,0,42,244,286,42,75,117,403,22,108,Pennsylvania,Allentown,118032
16871,1986-1987,1986-11-11,1987-03-03,113,0,19,210,229,51,133,184,413,16,77,Pennsylvania,Allentown,118032
16872,1987-1988,1987-11-10,1988-03-20,132,0,43,262,305,57,111,168,473,16,102,Pennsylvania,Allentown,118032
16873,1988-1989,1988-12-01,1989-03-20,110,0,24,200,224,17,25,42,266,8,35,Pennsylvania,Allentown,118032
16874,1989-1990,1989-11-22,1990-04-07,137,0,34,236,270,38,42,80,350,21,106,Pennsylvania,Allentown,118032
16875,1990-1991,1990-12-01,1991-03-30,120,0,15,168,183,26,29,55,238,13,55,Pennsylvania,Allentown,118032
16876,1991-1992,1991-12-01,1992-03-25,116,0,16,178,194,23,26,49,243,11,52,Pennsylvania,Allentown,118032
16877,1992-1993,1992-12-01,1993-03-23,113,0,21,212,233,53,110,163,396,18,90,Pennsylvania,Allentown,118032
16878,1993-1994,1993-12-01,1994-03-29,119,0,75,304,379,107,471,578,957,31,236,Pennsylvania,Allentown,118032
16879,1994-1995,1994-11-23,1995-03-09,107,0,19,175,194,24,52,76,270,11,48,Pennsylvania,Allentown,118032
16880,1996-1997,1996-11-27,1997-04-01,126,1,28,206,234,37,24,61,295,18,69,Pennsylvania,Allentown,118032
16881,2000-2001,2000-12-01,2001-03-09,99,16,36,251,287,70,278,348,635,17,122,Pennsylvania,Allentown,118032
16882,2001-2002,2001-12-01,2002-03-22,112,0,7,162,169,15,25,40,209,4,24,Pennsylvania,Allentown,118032
16883,2002-2003,2002-11-27,2003-04-09,134,0,52,296,348,84,269,353,701,21,153,Pennsylvania,Allentown,118032
16884,2003-2004,2003-12-01,2004-03-20,111,0,48,245,293,57,136,193,486,18,127,Pennsylvania,Allentown,118032
16885,2004-2005,2004-12-01,2005-03-24,114,0,48,252,300,61,136,197,497,22,143,Pennsylvania,Allentown,118032
16886,2005-2006,2005-11-24,2006-04-08,136,0,17,204,221,49,77,126,347,13,74,Pennsylvania,Allentown,118032
16887,2006-2007,2006-12-01,2007-03-21,111,0,40,215,255,36,69,105,360,13,74,Pennsylvania,Allentown,118032
16888,2007-2008,2007-11-18,2008-03-01,105,0,16,172,188,30,28,58,246,14,62,Pennsylvania,Allentown,118032
16889,2008-2009,2008-11-22,2009-03-04,103,0,41,249,290,33,73,106,396,17,84,Pennsylvania,Allentown,118032
16890,2009-2010,2009-12-01,2010-03-01,91,0,27,187,214,83,174,257,471,21,128,Pennsylvania,Allentown,118032
16891,2010-2011,2010-11-25,2011-03-24,120,3,38,263,301,56,183,239,540,25,134,Pennsylvania,Allentown,118032
16892,2011-2012,2011-10-29,2012-02-29,124,0,7,147,154,16,15,31,185,4,23,Pennsylvania,Allentown,118032
16893,2012-2013,2012-11-27,2013-03-25,119,0,21,170,191,33,28,61,252,16,72,Pennsylvania,Allentown,118032
16894,2013-2014,2013-11-24,2014-04-15,143,0,65,348,413,94,293,387,800,25,184,Pennsylvania,Allentown,118032
16895,2014-2015,2014-11-13,2015-03-31,139,0,52,331,383,73,228,301,684,26,160,Pennsylvania,Allentown,118032
16896,2015-2016,2015-12-01,2016-03-04,95,0,15,148,163,57,92,149,312,9,78,Pennsylvania,Allentown,118032
16897,2016-2017,2016-12-01,2017-03-21,111,0,14,165,179,44,67,111,290,12,74,Pennsylvania,Allentown,118032
16898,2017-2018,2017-12-01,2018-04-02,123,0,39,217,256,67,59,126,382,19,118,Pennsylvania,Allentown,118032
16899,2018-2019,2018-11-15,2019-03-09,115,0,19,179,198,46,61,107,305,17,76,Pennsylvania,Allentown,118032
16900,2019-2020,2019-12-01,2020-02-29,91,0,5,107,112,8,4,12,124,6,19,Pennsylvania,Allentown,118032
16901,1950-1951,1950-11-21,1951-04-04,135,1,76,400,476,119,433,552,1028,41,296,Pennsylvania,Bradford,8770
16902,1951-1952,1951-11-01,1952-05-12,194,0,63,465,528,152,570,722,1250,59,364,Pennsylvania,Bradford,8770
16903,1952-1953,1952-10-20,1953-04-21,184,1,44,354,398,122,272,394,792,48,277,Pennsylvania,Bradford,8770
16904,1953-1954,1953-11-05,1954-04-05,152,0,59,402,461,118,435,553,1014,52,336,Pennsylvania,Bradford,8770
16905,1954-1955,1954-10-31,1955-04-07,159,0,80,464,544,134,594,728,1272,63,388,Pennsylvania,Bradford,8770
16906,1955-1956,1955-10-25,1956-04-23,182,0,75,539,614,181,582,763,1377,64,420,Pennsylvania,Bradford,8770
16907,1956-1957,1956-11-13,1957-05-04,173,19,68,435,503,136,506,642,1145,49,331,Pennsylvania,Bradford,8770
16908,1961-1962,1961-11-08,1962-04-03,147,1,88,475,563,105,251,356,919,44,277,Pennsylvania,Bradford,8770
16909,1962-1963,1962-10-24,1963-05-01,190,0,123,624,747,170,825,995,1742,61,513,Pennsylvania,Bradford,8770
16910,1963-1964,1963-11-02,1964-03-31,151,18,84,436,520,170,611,781,1301,49,368,Pennsylvania,Bradford,8770
16911,1964-1965,1964-11-21,1965-04-18,149,0,92,431,523,107,277,384,907,39,280,Pennsylvania,Bradford,8770
16912,1965-1966,1965-10-28,1966-05-09,194,1,75,424,499,139,357,496,995,42,294,Pennsylvania,Bradford,8770
16913,1966-1967,1966-11-06,1967-04-24,170,1,81,411,492,148,417,565,1057,51,363,Pennsylvania,Bradford,8770
16914,1967-1968,1967-11-05,1968-03-24,141,0,103,465,568,135,442,577,1145,50,361,Pennsylvania,Bradford,8770
16915,1968-1969,1968-11-12,1969-03-31,140,0,92,408,500,146,330,476,976,48,359,Pennsylvania,Bradford,8770
16916,1969-1970,1969-11-14,1970-03-30,137,1,126,494,620,202,754,956,1576,63,524,Pennsylvania,Bradford,8770
16917,1970-1971,1970-11-16,1971-04-24,160,0,101,431,532,216,682,898,1430,54,444,Pennsylvania,Bradford,8770
16918,1971-1972,1971-11-08,1972-04-08,153,0,70,436,506,172,498,670,1176,46,345,Pennsylvania,Bradford,8770
16919,1972-1973,1972-11-15,1973-04-11,148,0,65,345,410,120,215,335,745,33,244,Pennsylvania,Bradford,8770
16920,1973-1974,1973-11-06,1974-04-09,155,3,77,371,448,132,265,397,845,36,280,Pennsylvania,Bradford,8770
16921,1974-1975,1974-11-21,1975-04-08,139,0,52,383,435,162,376,538,973,56,351,Pennsylvania,Bradford,8770
16922,1975-1976,1975-11-15,1976-05-04,172,3,85,451,536,164,529,693,1229,54,427,Pennsylvania,Bradford,8770
16923,1977-1978,1977-11-11,1978-04-20,161,8,142,559,701,257,805,1062,1763,76,677,Pennsylvania,Bradford,8770
16924,1978-1979,1978-11-20,1979-04-10,142,9,123,496,619,196,648,844,1463,63,517,Pennsylvania,Bradford,8770
16925,1979-1980,1979-10-26,1980-04-16,174,0,103,443,546,76,324,400,946,43,267,Pennsylvania,Bradford,8770
16926,1980-1981,1980-10-26,1981-04-06,163,5,144,536,680,110,524,634,1314,52,380,Pennsylvania,Bradford,8770
16927,1981-1982,1981-10-24,1982-04-08,167,7,151,535,686,120,653,773,1459,61,450,Pennsylvania,Bradford,8770
16928,1982-1983,1982-11-13,1983-04-19,158,6,75,380,455,79,187,266,721,35,219,Pennsylvania,Bradford,8770
16929,1983-1984,1983-11-03,1984-04-06,156,8,135,581,716,117,480,597,1313,46,359,Pennsylvania,Bradford,8770
16930,1984-1985,1984-11-12,1985-04-09,149,3,84,425,509,116,413,529,1038,40,301,Pennsylvania,Bradford,8770
16931,1985-1986,1985-12-01,1986-04-11,132,7,93,458,551,96,464,560,1111,34,291,Pennsylvania,Bradford,8770
16932,1986-1987,1986-11-10,1987-04-04,146,6,75,403,478,73,408,481,959,29,152,Pennsylvania,Bradford,8770
16933,1987-1988,1987-11-05,1988-04-15,163,4,102,459,561,97,413,510,1071,44,293,Pennsylvania,Bradford,8770
16934,1988-1989,1988-10-11,1989-05-07,209,10,94,446,540,76,189,265,805,39,244,Pennsylvania,Bradford,8770
16935,1989-1990,1989-11-02,1990-04-17,167,9,112,441,553,124,351,475,1028,45,316,Pennsylvania,Bradford,8770
16936,1990-1991,1990-11-12,1991-03-11,120,4,67,306,373,67,205,272,645,30,200,Pennsylvania,Bradford,8770
16937,1991-1992,1991-11-05,1992-04-04,152,14,74,444,518,92,364,456,974,28,219,Pennsylvania,Bradford,8770
16938,1992-1993,1992-10-19,1993-04-03,167,12,105,483,588,173,580,753,1341,35,319,Pennsylvania,Bradford,8770
16939,1993-1994,1993-10-30,1994-04-02,155,4,151,538,689,132,725,857,1546,39,365,Pennsylvania,Bradford,8770
16940,1994-1995,1994-11-23,1995-03-10,108,6,87,351,438,53,235,288,726,18,145,Pennsylvania,Bradford,8770
16941,1995-1996,1995-11-04,1996-03-26,144,12,160,524,684,137,466,603,1287,42,371,Pennsylvania,Bradford,8770
16942,1996-1997,1996-11-02,1997-04-09,159,4,86,400,486,108,226,334,820,35,260,Pennsylvania,Bradford,8770
16943,1997-1998,1997-11-12,1998-03-24,133,3,52,282,334,92,272,364,698,28,172,Pennsylvania,Bradford,8770
16944,1998-1999,1998-12-01,1999-03-26,116,3,75,382,457,98,353,451,908,32,263,Pennsylvania,Bradford,8770
16945,1999-2000,1999-11-03,2000-03-17,136,9,86,388,474,76,281,357,831,29,214,Pennsylvania,Bradford,8770
16946,2000-2001,2000-11-14,2001-04-04,142,20,116,462,578,124,521,645,1223,42,317,Pennsylvania,Bradford,8770
16947,2001-2002,2001-10-26,2002-04-06,163,1,52,317,369,84,188,272,641,35,214,Pennsylvania,Bradford,8770
16948,2002-2003,2002-11-01,2003-04-09,160,4,134,523,657,122,640,762,1419,45,344,Pennsylvania,Bradford,8770
16949,2003-2004,2003-11-09,2004-04-06,150,5,111,464,575,143,610,753,1328,48,345,Pennsylvania,Bradford,8770
16950,2004-2005,2004-11-09,2005-04-25,168,4,93,474,567,131,474,605,1172,45,311,Pennsylvania,Bradford,8770
16951,2005-2006,2005-11-18,2006-04-05,139,4,86,363,449,111,305,416,865,36,261,Pennsylvania,Bradford,8770
16952,2006-2007,2006-11-03,2007-04-17,166,5,114,428,542,128,399,527,1069,43,337,Pennsylvania,Bradford,8770
16953,2007-2008,2007-11-07,2008-03-23,138,1,78,380,458,133,349,482,940,39,289,Pennsylvania,Bradford,8770
16954,2008-2009,2008-10-29,2009-04-08,162,1,115,534,649,139,469,608,1257,47,371,Pennsylvania,Bradford,8770
16955,2009-2010,2009-10-16,2010-03-11,147,2,86,396,482,85,354,439,921,38,244,Pennsylvania,Bradford,8770
16956,2010-2011,2010-11-27,2011-04-07,132,0,111,478,589,166,622,788,1377,51,404,Pennsylvania,Bradford,8770
16957,2011-2012,2011-10-28,2012-04-25,181,0,39,334,373,81,127,208,581,32,179,Pennsylvania,Bradford,8770
16958,2012-2013,2012-11-14,2013-05-13,181,0,85,387,472,110,389,499,971,49,313,Pennsylvania,Bradford,8770
16959,2013-2014,2013-10-24,2014-04-16,175,0,170,635,805,122,348,470,1275,52,425,Pennsylvania,Bradford,8770
16960,2014-2015,2014-11-14,2015-04-24,162,0,147,611,758,125,614,739,1497,50,393,Pennsylvania,Bradford,8770
16961,2015-2016,2015-10-18,2016-04-10,176,0,63,354,417,84,173,257,674,35,270,Pennsylvania,Bradford,8770
16962,2016-2017,2016-11-20,2017-03-23,124,0,68,306,374,131,270,401,775,42,322,Pennsylvania,Bradford,8770
16963,2017-2018,2017-11-10,2018-04-19,161,0,113,490,603,144,354,498,1101,47,377,Pennsylvania,Bradford,8770
16964,2018-2019,2018-10-21,2019-04-11,173,0,103,450,553,95,270,365,918,37,253,Pennsylvania,Bradford,8770
16965,2019-2020,2019-11-08,2020-05-09,184,0,48,350,398,108,296,404,802,41,218,Pennsylvania,Bradford,8770
16966,1964-1965,1964-11-21,1965-04-03,134,2,73,415,488,158,321,479,967,42,360,Pennsylvania,Ebensburg,3351
16967,1965-1966,1965-10-29,1966-04-13,167,1,65,368,433,218,462,680,1113,57,451,Pennsylvania,Ebensburg,3351
16968,1966-1967,1966-11-29,1967-04-27,150,0,55,365,420,200,438,638,1058,51,408,Pennsylvania,Ebensburg,3351
16969,1967-1968,1967-11-05,1968-03-25,142,1,68,433,501,154,461,615,1116,50,376,Pennsylvania,Ebensburg,3351
16970,1968-1969,1968-10-27,1969-03-31,156,1,68,414,482,169,402,571,1053,57,400,Pennsylvania,Ebensburg,3351
16971,1970-1971,1970-11-24,1971-04-14,142,0,72,400,472,250,597,847,1319,59,510,Pennsylvania,Ebensburg,3351
16972,1971-1972,1971-11-07,1972-04-10,156,1,46,384,430,205,468,673,1103,46,370,Pennsylvania,Ebensburg,3351
16973,1972-1973,1972-10-19,1973-05-05,199,0,27,344,371,127,190,317,688,41,252,Pennsylvania,Ebensburg,3351
16974,1973-1974,1973-11-06,1974-04-11,157,3,39,285,324,114,187,301,625,47,263,Pennsylvania,Ebensburg,3351
16975,1974-1975,1974-10-20,1975-04-21,184,2,26,362,388,225,460,685,1073,61,397,Pennsylvania,Ebensburg,3351
16976,1976-1977,1976-11-08,1977-04-06,150,0,111,504,615,194,747,941,1556,73,614,Pennsylvania,Ebensburg,3351
16977,1977-1978,1977-10-17,1978-04-22,188,2,105,513,618,270,905,1175,1793,77,662,Pennsylvania,Ebensburg,3351
16978,1978-1979,1978-11-26,1979-04-10,136,0,84,399,483,167,499,666,1149,45,381,Pennsylvania,Ebensburg,3351
16979,1979-1980,1979-11-14,1980-04-16,155,2,60,370,430,113,252,365,795,43,324,Pennsylvania,Ebensburg,3351
16980,1980-1981,1980-11-11,1981-03-23,133,0,76,399,475,186,422,608,1083,53,443,Pennsylvania,Ebensburg,3351
16981,1981-1982,1981-11-07,1982-04-11,156,12,73,404,477,210,532,742,1219,57,465,Pennsylvania,Ebensburg,3351
16982,1982-1983,1982-12-01,1983-04-20,141,1,25,259,284,78,202,280,564,23,155,Pennsylvania,Ebensburg,3351
16983,1983-1984,1983-11-05,1984-04-19,167,2,76,407,483,170,388,558,1041,51,374,Pennsylvania,Ebensburg,3351
16984,1984-1985,1984-11-13,1985-04-10,149,2,60,366,426,172,408,580,1006,46,389,Pennsylvania,Ebensburg,3351
16985,1985-1986,1985-12-01,1986-04-17,138,0,62,358,420,149,316,465,885,51,364,Pennsylvania,Ebensburg,3351
16986,1986-1987,1986-11-11,1987-04-06,147,2,27,359,386,121,259,380,766,31,202,Pennsylvania,Ebensburg,3351
16987,1987-1988,1987-11-10,1988-04-29,172,0,52,387,439,134,215,349,788,53,334,Pennsylvania,Ebensburg,3351
16988,1988-1989,1988-11-07,1989-04-13,158,2,37,338,375,85,114,199,574,31,196,Pennsylvania,Ebensburg,3351
16989,1989-1990,1989-11-17,1990-04-18,153,0,62,374,436,117,182,299,735,49,309,Pennsylvania,Ebensburg,3351
16990,1990-1991,1990-11-12,1991-04-22,162,3,25,284,309,101,130,231,540,34,199,Pennsylvania,Ebensburg,3351
16991,1991-1992,1991-11-12,1992-04-03,144,2,33,318,351,111,218,329,680,41,265,Pennsylvania,Ebensburg,3351
16992,1992-1993,1992-10-19,1993-04-22,186,1,38,361,399,203,464,667,1066,45,334,Pennsylvania,Ebensburg,3351
16993,1993-1994,1993-09-30,1994-03-30,182,4,80,429,509,191,650,841,1350,48,404,Pennsylvania,Ebensburg,3351
16994,1994-1995,1994-11-24,1995-04-05,133,3,42,310,352,57,152,209,561,19,135,Pennsylvania,Ebensburg,3351
16995,1995-1996,1995-11-09,1996-04-17,161,2,82,434,516,223,497,720,1236,54,454,Pennsylvania,Ebensburg,3351
16996,1996-1997,1996-11-03,1997-04-18,167,1,42,400,442,107,176,283,725,40,255,Pennsylvania,Ebensburg,3351
16997,1997-1998,1997-11-12,1998-03-23,132,1,15,274,289,87,129,216,505,26,152,Pennsylvania,Ebensburg,3351
16998,1998-1999,1998-12-01,1999-03-23,113,3,32,306,338,95,195,290,628,26,188,Pennsylvania,Ebensburg,3351
16999,1999-2000,1999-11-03,2000-04-10,160,6,40,336,376,50,133,183,559,21,146,Pennsylvania,Ebensburg,3351
17000,2000-2001,2000-11-18,2001-03-27,130,7,65,347,412,92,289,381,793,31,223,Pennsylvania,Ebensburg,3351
17001,2001-2002,2001-10-27,2002-04-06,162,6,27,251,278,36,52,88,366,15,95,Pennsylvania,Ebensburg,3351
17002,2003-2004,2003-11-14,2004-04-05,144,7,66,370,436,176,424,600,1036,51,374,Pennsylvania,Ebensburg,3351
17003,2004-2005,2004-12-01,2005-04-25,146,4,52,338,390,115,237,352,742,35,249,Pennsylvania,Ebensburg,3351
17004,2005-2006,2005-10-26,2006-04-05,162,7,53,299,352,103,229,332,684,33,213,Pennsylvania,Ebensburg,3351
17005,2006-2007,2006-10-24,2007-04-17,176,6,77,355,432,147,315,462,894,40,353,Pennsylvania,Ebensburg,3351
17006,2007-2008,2007-11-16,2008-03-23,129,9,44,298,342,113,263,376,718,41,254,Pennsylvania,Ebensburg,3351
17007,2008-2009,2008-10-29,2009-04-08,162,3,68,378,446,121,248,369,815,42,291,Pennsylvania,Ebensburg,3351
17008,2009-2010,2009-12-01,2010-03-13,103,0,72,301,373,210,528,738,1111,42,395,Pennsylvania,Ebensburg,3351
17009,2010-2011,2010-12-01,2011-04-02,123,0,86,361,447,134,364,498,945,49,347,Pennsylvania,Ebensburg,3351
17010,2011-2012,2011-10-29,2012-04-24,179,0,19,262,281,81,97,178,459,25,164,Pennsylvania,Ebensburg,3351
17011,2012-2013,2012-11-25,2013-04-02,129,1,50,276,326,123,247,370,696,49,278,Pennsylvania,Ebensburg,3351
17012,2013-2014,2013-11-12,2014-03-31,140,0,113,502,615,120,351,471,1086,53,414,Pennsylvania,Ebensburg,3351
17013,2014-2015,2014-11-14,2015-04-23,161,0,101,475,576,116,355,471,1047,49,366,Pennsylvania,Ebensburg,3351
17014,2015-2016,2015-11-24,2016-04-10,139,0,60,314,374,69,124,193,567,31,223,Pennsylvania,Ebensburg,3351
17015,2016-2017,2016-11-20,2017-04-08,140,0,62,294,356,105,162,267,623,42,279,Pennsylvania,Ebensburg,3351
17016,2017-2018,2017-11-08,2018-04-18,162,0,105,447,552,138,276,414,966,37,313,Pennsylvania,Ebensburg,3351
17017,2018-2019,2018-10-21,2019-04-01,163,3,82,376,458,76,221,297,755,35,229,Pennsylvania,Ebensburg,3351
17018,2019-2020,2019-11-08,2020-05-09,184,0,42,306,348,69,100,169,517,32,150,Pennsylvania,Ebensburg,3351
17019,1950-1951,1950-11-10,1951-03-25,136,0,73,264,337,143,308,451,788,54,314,Pennsylvania,Erie,101786
17020,1951-1952,1951-11-02,1952-04-07,158,2,58,257,315,89,115,204,519,38,181,Pennsylvania,Erie,101786
17021,1952-1953,1952-11-28,1953-04-20,144,0,29,167,196,63,64,127,323,36,152,Pennsylvania,Erie,101786
17022,1953-1954,1953-11-07,1954-04-03,148,0,49,229,278,83,106,189,467,26,150,Pennsylvania,Erie,101786
17023,1954-1955,1954-10-30,1955-03-28,150,0,63,238,301,79,129,208,509,29,184,Pennsylvania,Erie,101786
17024,1955-1956,1955-11-17,1956-04-17,153,3,61,280,341,105,187,292,633,47,234,Pennsylvania,Erie,101786
17025,1956-1957,1956-11-22,1957-04-13,143,0,59,236,295,158,308,466,761,53,309,Pennsylvania,Erie,101786
17026,1957-1958,1957-10-27,1958-04-09,165,0,72,274,346,101,252,353,699,41,243,Pennsylvania,Erie,101786
17027,1958-1959,1958-11-27,1959-03-28,122,0,96,367,463,156,334,490,953,53,378,Pennsylvania,Erie,101786
17028,1959-1960,1959-11-12,1960-04-09,150,1,70,272,342,109,311,420,762,56,260,Pennsylvania,Erie,101786
17029,1960-1961,1960-11-05,1961-04-17,164,0,96,300,396,105,228,333,729,53,329,Pennsylvania,Erie,101786
17030,1961-1962,1961-11-08,1962-04-15,159,1,90,305,395,75,90,165,560,50,264,Pennsylvania,Erie,101786
17031,1962-1963,1962-10-24,1963-05-01,190,0,126,387,513,125,260,385,898,63,414,Pennsylvania,Erie,101786
17032,1963-1964,1963-11-12,1964-04-08,149,0,73,279,352,166,289,455,807,65,380,Pennsylvania,Erie,101786
17033,1964-1965,1964-11-20,1965-04-18,150,0,85,299,384,139,194,333,717,56,355,Pennsylvania,Erie,101786
17034,1965-1966,1965-11-28,1966-04-07,131,0,83,243,326,126,176,302,628,55,324,Pennsylvania,Erie,101786
17035,1966-1967,1966-11-03,1967-04-24,173,0,60,258,318,109,138,247,565,57,276,Pennsylvania,Erie,101786
17036,1967-1968,1967-11-04,1968-04-25,174,0,91,331,422,156,243,399,821,61,394,Pennsylvania,Erie,101786
17037,1968-1969,1968-11-12,1969-04-19,159,0,73,279,352,120,174,294,646,63,311,Pennsylvania,Erie,101786
17038,1969-1970,1969-10-22,1970-04-02,163,0,128,399,527,129,308,437,964,66,420,Pennsylvania,Erie,101786
17039,1970-1971,1970-11-23,1971-04-24,153,0,94,315,409,179,219,398,807,68,428,Pennsylvania,Erie,101786
17040,1971-1972,1971-11-04,1972-04-08,157,0,86,312,398,143,138,281,679,69,366,Pennsylvania,Erie,101786
17041,1972-1973,1972-10-18,1973-04-10,175,0,60,242,302,80,116,196,498,45,211,Pennsylvania,Erie,101786
17042,1973-1974,1973-11-16,1974-04-10,146,0,73,235,308,107,173,280,588,53,291,Pennsylvania,Erie,101786
17043,1974-1975,1974-10-19,1975-04-05,169,0,54,229,283,108,143,251,534,57,259,Pennsylvania,Erie,101786
17044,1975-1976,1975-11-21,1976-04-04,136,0,70,279,349,106,186,292,641,56,305,Pennsylvania,Erie,101786
17045,1976-1977,1976-10-21,1977-04-06,168,0,151,403,554,166,432,598,1152,81,567,Pennsylvania,Erie,101786
17046,1977-1978,1977-11-11,1978-04-03,144,0,144,430,574,204,512,716,1290,63,523,Pennsylvania,Erie,101786
17047,1978-1979,1978-11-20,1979-04-09,141,0,153,379,532,116,275,391,923,57,417,Pennsylvania,Erie,101786
17048,1979-1980,1979-10-25,1980-03-23,151,0,101,276,377,87,124,211,588,49,277,Pennsylvania,Erie,101786
17049,1980-1981,1980-11-17,1981-03-22,126,0,100,331,431,132,274,406,837,58,408,Pennsylvania,Erie,101786
17050,1981-1982,1981-11-21,1982-04-11,142,0,99,346,445,116,246,362,807,64,396,Pennsylvania,Erie,101786
17051,1982-1983,1982-11-05,1983-04-18,165,0,28,184,212,66,61,127,339,42,148,Pennsylvania,Erie,101786
17052,1983-1984,1983-11-04,1984-03-31,149,0,100,307,407,166,359,525,932,68,442,Pennsylvania,Erie,101786
17053,1984-1985,1984-11-12,1985-04-09,149,0,78,267,345,155,339,494,839,55,372,Pennsylvania,Erie,101786
17054,1985-1986,1985-11-27,1986-04-22,147,0,80,271,351,179,354,533,884,67,425,Pennsylvania,Erie,101786
17055,1986-1987,1986-11-12,1987-04-05,145,0,43,227,270,104,167,271,541,52,233,Pennsylvania,Erie,101786
17056,1987-1988,1987-11-21,1988-04-16,148,0,60,244,304,151,230,381,685,59,347,Pennsylvania,Erie,101786
17057,1988-1989,1988-10-26,1989-05-07,194,0,60,244,304,120,130,250,554,55,273,Pennsylvania,Erie,101786
17058,1989-1990,1989-11-16,1990-04-12,148,0,66,229,295,163,265,428,723,59,345,Pennsylvania,Erie,101786
17059,1990-1991,1990-11-11,1991-04-10,151,0,38,178,216,91,107,198,414,47,209,Pennsylvania,Erie,101786
17060,1991-1992,1991-11-07,1992-04-04,150,0,39,214,253,149,150,299,552,52,280,Pennsylvania,Erie,101786
17061,1992-1993,1992-11-05,1993-04-03,150,1,46,224,270,165,265,430,700,64,311,Pennsylvania,Erie,101786
17062,1993-1994,1993-10-30,1994-04-07,160,0,115,349,464,188,409,597,1061,61,478,Pennsylvania,Erie,101786
17063,1994-1995,1994-11-23,1995-04-10,139,0,50,223,273,84,127,211,484,40,210,Pennsylvania,Erie,101786
17064,1995-1996,1995-11-03,1996-04-10,160,16,117,350,467,189,265,454,921,70,474,Pennsylvania,Erie,101786
17065,1996-1997,1996-11-09,1997-03-26,138,1,58,241,299,136,217,353,652,48,283,Pennsylvania,Erie,101786
17066,2004-2005,2004-11-25,2005-04-05,132,2,77,280,357,176,341,517,874,59,388,Pennsylvania,Erie,101786
17067,2005-2006,2005-11-17,2006-04-06,141,0,55,187,242,125,162,287,529,50,255,Pennsylvania,Erie,101786
17068,2006-2007,2006-10-23,2007-04-15,175,0,87,241,328,157,314,471,799,64,395,Pennsylvania,Erie,101786
17069,2007-2008,2007-11-06,2008-03-28,144,0,46,218,264,175,208,383,647,61,339,Pennsylvania,Erie,101786
17070,2008-2009,2008-10-29,2009-04-08,162,0,76,282,358,207,347,554,912,68,424,Pennsylvania,Erie,101786
17071,2009-2010,2009-12-01,2010-03-26,116,0,68,219,287,135,329,464,751,52,312,Pennsylvania,Erie,101786
17072,2010-2011,2010-11-26,2011-04-18,144,0,87,275,362,160,349,509,871,66,370,Pennsylvania,Erie,101786
17073,2011-2012,2011-11-11,2012-04-23,165,0,17,131,148,75,47,122,270,31,129,Pennsylvania,Erie,101786
17074,2012-2013,2012-11-13,2013-04-20,159,0,54,196,250,150,154,304,554,54,293,Pennsylvania,Erie,101786
17075,2013-2014,2013-10-24,2014-04-16,175,3,130,397,527,195,241,436,963,73,496,Pennsylvania,Erie,101786
17076,2014-2015,2014-11-13,2015-04-01,140,0,118,380,498,166,441,607,1105,66,431,Pennsylvania,Erie,101786
17077,2015-2016,2015-11-22,2016-04-10,141,0,44,170,214,110,107,217,431,50,257,Pennsylvania,Erie,101786
17078,2016-2017,2016-11-19,2017-04-07,140,0,42,152,194,112,124,236,430,46,233,Pennsylvania,Erie,101786
17079,2017-2018,2017-11-19,2018-04-18,151,10,80,269,349,224,259,483,832,58,433,Pennsylvania,Erie,101786
17080,2018-2019,2018-11-09,2019-04-01,144,2,56,230,286,130,128,258,544,48,276,Pennsylvania,Erie,101786
17081,2019-2020,2019-11-08,2020-04-23,168,0,21,131,152,100,87,187,339,37,156,Pennsylvania,Erie,101786
17082,1950-1951,1950-11-25,1951-03-21,117,0,30,182,212,34,60,94,306,22,77,Pennsylvania,Harrisburg,49528
17083,1951-1952,1951-11-03,1952-03-19,138,0,16,169,185,55,116,171,356,17,88,Pennsylvania,Harrisburg,49528
17084,1952-1953,1952-11-29,1953-04-20,143,0,5,102,107,36,38,74,181,17,58,Pennsylvania,Harrisburg,49528
17085,1953-1954,1953-11-06,1954-03-11,126,0,17,149,166,41,80,121,287,11,68,Pennsylvania,Harrisburg,49528
17086,1954-1955,1954-11-02,1955-03-18,137,0,28,173,201,28,26,54,255,15,64,Pennsylvania,Harrisburg,49528
17087,1955-1956,1955-11-19,1956-03-29,132,0,23,186,209,58,49,107,316,22,99,Pennsylvania,Harrisburg,49528
17088,1956-1957,1956-11-17,1957-04-04,139,0,22,149,171,51,40,91,262,25,96,Pennsylvania,Harrisburg,49528
17089,1957-1958,1957-12-01,1958-03-24,114,0,33,170,203,60,84,144,347,21,90,Pennsylvania,Harrisburg,49528
17090,1958-1959,1958-11-03,1959-04-13,162,0,38,248,286,39,22,61,347,20,84,Pennsylvania,Harrisburg,49528
17091,1959-1960,1959-11-18,1960-04-06,141,0,22,182,204,66,82,148,352,30,134,Pennsylvania,Harrisburg,49528
17092,1960-1961,1960-12-01,1961-04-13,134,0,55,267,322,116,375,491,813,32,206,Pennsylvania,Harrisburg,49528
17093,1961-1962,1961-11-19,1962-03-11,113,0,40,240,280,76,147,223,503,26,152,Pennsylvania,Harrisburg,49528
17094,1962-1963,1962-11-03,1963-03-21,139,0,55,278,333,73,155,228,561,29,141,Pennsylvania,Harrisburg,49528
17095,1963-1964,1963-12-01,1964-04-01,123,0,33,243,276,108,241,349,625,25,169,Pennsylvania,Harrisburg,49528
17096,1964-1965,1964-12-01,1965-04-02,123,0,34,217,251,48,68,116,367,18,91,Pennsylvania,Harrisburg,49528
17097,1965-1966,1965-12-01,1966-03-24,114,0,34,181,215,62,153,215,430,14,116,Pennsylvania,Harrisburg,49528
17098,1966-1967,1966-11-29,1967-03-23,115,0,34,218,252,74,108,182,434,31,148,Pennsylvania,Harrisburg,49528
17099,1967-1968,1967-11-17,1968-03-23,128,0,46,239,285,46,137,183,468,16,95,Pennsylvania,Harrisburg,49528
17100,1968-1969,1968-11-12,1969-03-26,135,0,26,186,212,42,31,73,285,22,73,Pennsylvania,Harrisburg,49528
17101,1969-1970,1969-11-15,1970-04-01,138,0,49,264,313,90,309,399,712,36,175,Pennsylvania,Harrisburg,49528
17102,1970-1971,1970-12-01,1971-03-19,109,0,33,171,204,51,138,189,393,26,110,Pennsylvania,Harrisburg,49528
17103,1971-1972,1971-11-24,1972-04-08,137,0,18,147,165,50,94,144,309,16,75,Pennsylvania,Harrisburg,49528
17104,1972-1973,1972-10-19,1973-02-28,133,0,15,146,161,21,15,36,197,8,32,Pennsylvania,Harrisburg,49528
17105,1973-1974,1973-12-01,1974-02-28,90,0,18,110,128,40,68,108,236,8,60,Pennsylvania,Harrisburg,49528
17106,1974-1975,1974-11-26,1975-03-16,111,0,14,150,164,44,72,116,280,15,72,Pennsylvania,Harrisburg,49528
17107,1975-1976,1975-12-01,1976-03-17,108,0,26,145,171,31,16,47,218,15,60,Pennsylvania,Harrisburg,49528
17108,1976-1977,1976-11-05,1977-03-20,136,0,68,274,342,37,141,178,520,20,92,Pennsylvania,Harrisburg,49528
17109,1977-1978,1977-11-12,1978-03-19,128,0,59,273,332,100,343,443,775,25,164,Pennsylvania,Harrisburg,49528
17110,1978-1979,1978-11-27,1979-03-15,109,0,51,212,263,56,117,173,436,20,133,Pennsylvania,Harrisburg,49528
17111,1979-1980,1979-12-01,1980-03-16,107,0,25,190,215,27,19,46,261,18,80,Pennsylvania,Harrisburg,49528
17112,1980-1981,1980-11-17,1981-03-21,125,0,55,266,321,37,56,93,414,18,93,Pennsylvania,Harrisburg,49528
17113,1981-1982,1981-11-24,1982-04-10,138,0,53,230,283,81,154,235,518,29,153,Pennsylvania,Harrisburg,49528
17114,1982-1983,1982-12-01,1983-04-20,141,0,7,129,136,57,84,141,277,14,75,Pennsylvania,Harrisburg,49528
17115,1983-1984,1983-12-01,1984-04-01,123,0,50,234,284,51,85,136,420,24,125,Pennsylvania,Harrisburg,49528
17116,1984-1985,1984-11-18,1985-04-09,143,0,32,148,180,41,69,110,290,19,78,Pennsylvania,Harrisburg,49528
17117,1985-1986,1985-12-01,1986-03-08,98,0,37,166,203,56,90,146,349,26,129,Pennsylvania,Harrisburg,49528
17118,1986-1987,1986-12-01,1987-04-05,126,0,17,145,162,63,133,196,358,17,90,Pennsylvania,Harrisburg,49528
17119,1987-1988,1987-11-10,1988-03-20,132,0,32,217,249,40,67,107,356,17,80,Pennsylvania,Harrisburg,49528
17120,1988-1989,1988-12-01,1989-03-20,110,1,25,182,207,30,42,72,279,11,56,Pennsylvania,Harrisburg,49528
17121,1989-1990,1989-11-22,1990-04-12,142,0,34,211,245,34,29,63,308,22,86,Pennsylvania,Harrisburg,49528
17122,1990-1991,1990-12-01,1991-03-30,120,0,8,143,151,31,28,59,210,15,60,Pennsylvania,Harrisburg,49528
17123,1991-1992,1991-12-01,1992-03-23,114,0,11,149,160,22,13,35,195,12,50,Pennsylvania,Harrisburg,49528
17124,1992-1993,1992-12-01,1993-04-22,143,0,16,182,198,66,114,180,378,21,102,Pennsylvania,Harrisburg,49528
17125,1993-1994,1993-12-01,1994-03-29,119,0,64,288,352,107,363,470,822,26,204,Pennsylvania,Harrisburg,49528
17126,1994-1995,1994-11-23,1995-03-09,107,0,17,145,162,18,20,38,200,12,35,Pennsylvania,Harrisburg,49528
17127,1995-1996,1995-11-11,1996-04-10,152,0,53,264,317,114,258,372,689,35,207,Pennsylvania,Harrisburg,49528
17128,1996-1997,1996-11-28,1997-03-31,124,0,20,145,165,37,17,54,219,18,63,Pennsylvania,Harrisburg,49528
17129,1997-1998,1997-11-13,1998-03-11,119,0,4,98,102,23,10,33,135,17,40,Pennsylvania,Harrisburg,49528
17130,1998-1999,1998-12-01,1999-03-17,107,0,17,152,169,34,25,59,228,15,69,Pennsylvania,Harrisburg,49528
17131,1999-2000,1999-12-01,2000-04-09,131,0,27,170,197,33,87,120,317,11,72,Pennsylvania,Harrisburg,49528
17132,2000-2001,2000-12-01,2001-03-05,95,0,26,199,225,39,92,131,356,14,74,Pennsylvania,Harrisburg,49528
17133,2001-2002,2001-12-01,2002-03-22,112,0,6,126,132,17,27,44,176,6,28,Pennsylvania,Harrisburg,49528
17134,2002-2003,2002-11-26,2003-04-07,133,0,41,253,294,86,176,262,556,25,150,Pennsylvania,Harrisburg,49528
17135,2003-2004,2003-12-01,2004-03-19,110,0,43,207,250,51,109,160,410,21,125,Pennsylvania,Harrisburg,49528
17136,2004-2005,2004-12-01,2005-03-09,99,0,28,159,187,45,67,112,299,18,99,Pennsylvania,Harrisburg,49528
17137,2005-2006,2005-11-23,2006-02-28,98,0,12,135,147,27,61,88,235,8,46,Pennsylvania,Harrisburg,49528
17138,2006-2007,2006-12-01,2007-03-20,110,0,27,177,204,32,47,79,283,10,60,Pennsylvania,Harrisburg,49528
17139,2007-2008,2007-11-18,2008-03-22,126,0,15,155,170,23,17,40,210,14,55,Pennsylvania,Harrisburg,49528
17140,2008-2009,2008-11-21,2009-03-03,103,0,32,185,217,25,19,44,261,15,66,Pennsylvania,Harrisburg,49528
17141,2009-2010,2009-12-01,2010-02-28,90,0,23,140,163,81,161,242,405,19,118,Pennsylvania,Harrisburg,49528
17142,2010-2011,2010-11-25,2011-04-01,128,0,29,210,239,40,90,130,369,22,95,Pennsylvania,Harrisburg,49528
17143,2011-2012,2011-10-29,2012-02-29,124,0,8,117,125,18,19,37,162,6,31,Pennsylvania,Harrisburg,49528
17144,2012-2013,2012-11-27,2013-03-26,120,0,14,142,156,28,16,44,200,16,63,Pennsylvania,Harrisburg,49528
17145,2013-2014,2013-11-24,2014-03-30,127,0,54,284,338,64,146,210,548,23,134,Pennsylvania,Harrisburg,49528
17146,2014-2015,2014-11-19,2015-03-28,130,0,49,286,335,58,75,133,468,25,148,Pennsylvania,Harrisburg,49528
17147,2015-2016,2015-12-01,2016-04-09,131,0,16,151,167,56,105,161,328,10,82,Pennsylvania,Harrisburg,49528
17148,2016-2017,2016-12-01,2017-03-20,110,0,12,122,134,35,51,86,220,12,60,Pennsylvania,Harrisburg,49528
17149,2017-2018,2017-12-01,2018-04-02,123,2,34,193,227,53,52,105,332,20,96,Pennsylvania,Harrisburg,49528
17150,2018-2019,2018-11-15,2019-03-09,115,0,17,157,174,57,69,126,300,17,87,Pennsylvania,Harrisburg,49528
17151,2019-2020,2019-12-01,2020-02-29,91,0,3,89,92,7,7,14,106,3,10,Pennsylvania,Harrisburg,49528
17152,1950-1951,1950-11-27,1951-02-28,94,0,14,118,132,11,1,12,144,9,30,Pennsylvania,Philadelphia,1085
17153,1951-1952,1951-12-01,1952-03-04,95,0,11,96,107,23,29,52,159,6,33,Pennsylvania,Philadelphia,1085
17154,1952-1953,1952-11-30,1953-03-10,101,0,4,81,85,25,17,42,127,7,33,Pennsylvania,Philadelphia,1085
17155,1953-1954,1953-11-06,1954-03-31,146,0,16,126,142,31,49,80,222,8,51,Pennsylvania,Philadelphia,1085
17156,1954-1955,1954-12-01,1955-03-18,108,0,15,120,135,16,15,31,166,8,28,Pennsylvania,Philadelphia,1085
17157,1955-1956,1955-11-19,1956-03-24,127,0,17,162,179,33,30,63,242,17,58,Pennsylvania,Philadelphia,1085
17158,1956-1957,1956-12-01,1957-03-07,97,0,15,112,127,17,11,28,155,14,51,Pennsylvania,Philadelphia,1085
17159,1957-1958,1957-12-01,1958-03-23,113,0,29,150,179,58,77,135,314,16,85,Pennsylvania,Philadelphia,1085
17160,1958-1959,1958-11-30,1959-03-14,105,0,29,185,214,10,6,16,230,7,24,Pennsylvania,Philadelphia,1085
17161,1959-1960,1959-11-18,1960-03-22,126,0,12,166,178,36,33,69,247,19,82,Pennsylvania,Philadelphia,1085
17162,1960-1961,1960-12-01,1961-03-22,112,0,49,237,286,69,180,249,535,20,147,Pennsylvania,Philadelphia,1085
17163,1961-1962,1961-11-20,1962-03-10,111,0,27,213,240,46,30,76,316,19,93,Pennsylvania,Philadelphia,1085
17164,1962-1963,1962-12-01,1963-03-01,91,0,42,225,267,30,22,52,319,14,63,Pennsylvania,Philadelphia,1085
17165,1963-1964,1963-12-01,1964-03-22,113,0,23,200,223,47,62,109,332,17,88,Pennsylvania,Philadelphia,1085
17166,1964-1965,1964-12-01,1965-04-02,123,0,28,182,210,37,40,77,287,16,72,Pennsylvania,Philadelphia,1085
17167,1965-1966,1965-12-01,1966-02-28,90,0,29,169,198,35,71,106,304,12,77,Pennsylvania,Philadelphia,1085
17168,1966-1967,1966-12-01,1967-04-27,148,0,23,178,201,70,74,144,345,29,129,Pennsylvania,Philadelphia,1085
17169,1967-1968,1967-11-30,1968-03-13,105,0,24,169,193,28,46,74,267,16,66,Pennsylvania,Philadelphia,1085
17170,1968-1969,1968-11-12,1969-03-08,117,0,21,168,189,32,30,62,251,15,54,Pennsylvania,Philadelphia,1085
17171,1969-1970,1969-11-30,1970-03-30,121,0,36,192,228,35,55,90,318,20,79,Pennsylvania,Philadelphia,1085
17172,1970-1971,1970-12-01,1971-04-07,128,0,30,153,183,31,13,44,227,16,57,Pennsylvania,Philadelphia,1085
17173,1971-1972,1971-12-01,1972-04-08,130,0,14,138,152,21,24,45,197,13,46,Pennsylvania,Philadelphia,1085
17174,1972-1973,1972-12-01,1973-02-28,90,0,15,106,121,0,0,0,121,0,0,Pennsylvania,Philadelphia,1085
17175,1973-1974,1973-12-01,1974-02-28,90,0,18,115,133,30,36,66,199,10,57,Pennsylvania,Philadelphia,1085
17176,1974-1975,1974-12-01,1975-03-14,104,0,6,99,105,20,7,27,132,11,35,Pennsylvania,Philadelphia,1085
17177,1975-1976,1975-12-01,1976-03-10,101,0,19,135,154,25,16,41,195,11,47,Pennsylvania,Philadelphia,1085
17178,1976-1977,1976-11-30,1977-02-28,91,0,55,249,304,29,57,86,390,13,74,Pennsylvania,Philadelphia,1085
17179,1977-1978,1977-11-27,1978-03-16,110,0,50,242,292,82,146,228,520,21,135,Pennsylvania,Philadelphia,1085
17180,1978-1979,1978-11-27,1979-02-28,94,0,49,176,225,57,93,150,375,18,126,Pennsylvania,Philadelphia,1085
17181,1979-1980,1979-10-10,1980-03-31,174,0,30,156,186,29,21,50,236,14,64,Pennsylvania,Philadelphia,1085
17182,1980-1981,1980-11-17,1981-03-06,110,0,45,207,252,26,22,48,300,12,60,Pennsylvania,Philadelphia,1085
17183,1981-1982,1981-12-01,1982-04-09,130,0,35,196,231,43,88,131,362,24,97,Pennsylvania,Philadelphia,1085
17184,1982-1983,1982-12-01,1983-04-20,141,0,8,121,129,51,68,119,248,10,68,Pennsylvania,Philadelphia,1085
17185,1983-1984,1983-11-25,1984-03-29,126,0,42,209,251,30,68,98,349,14,70,Pennsylvania,Philadelphia,1085
17186,1984-1985,1984-12-01,1985-02-28,90,0,23,142,165,23,32,55,220,10,50,Pennsylvania,Philadelphia,1085
17187,1985-1986,1985-12-01,1986-03-08,98,0,22,165,187,28,35,63,250,14,63,Pennsylvania,Philadelphia,1085
17188,1986-1987,1986-12-01,1987-02-28,90,0,10,128,138,37,86,123,261,13,58,Pennsylvania,Philadelphia,1085
17189,1987-1988,1987-11-11,1988-02-29,111,0,25,161,186,22,32,54,240,12,53,Pennsylvania,Philadelphia,1085
17190,1988-1989,1988-12-01,1989-03-09,99,0,15,129,144,21,15,36,180,12,47,Pennsylvania,Philadelphia,1085
17191,1989-1990,1989-11-22,1990-04-07,137,0,22,168,190,27,20,47,237,16,54,Pennsylvania,Philadelphia,1085
17192,1990-1991,1990-12-01,1991-03-30,120,0,7,90,97,22,16,38,135,10,35,Pennsylvania,Philadelphia,1085
17193,1991-1992,1991-12-01,1992-03-23,114,0,9,116,125,10,2,12,137,8,26,Pennsylvania,Philadelphia,1085
17194,1992-1993,1992-12-01,1993-03-21,111,0,11,119,130,33,26,59,189,13,51,Pennsylvania,Philadelphia,1085
17195,1993-1994,1993-12-01,1994-03-18,108,0,32,161,193,34,63,97,290,18,87,Pennsylvania,Philadelphia,1085
17196,1994-1995,1994-12-01,1995-02-28,90,0,12,103,115,14,32,46,161,4,22,Pennsylvania,Philadelphia,1085
17197,1995-1996,1995-11-29,1996-04-09,133,0,43,195,238,90,171,261,499,22,155,Pennsylvania,Philadelphia,1085
17198,1996-1997,1996-11-28,1997-04-01,125,0,15,108,123,19,8,27,150,10,29,Pennsylvania,Philadelphia,1085
17199,1997-1998,1997-12-01,1998-03-22,112,0,1,62,63,4,0,4,67,4,5,Pennsylvania,Philadelphia,1085
17200,1998-1999,1998-12-01,1999-03-15,105,0,15,107,122,19,10,29,151,10,38,Pennsylvania,Philadelphia,1085
17201,1999-2000,1999-12-01,2000-04-09,131,0,20,118,138,28,75,103,241,7,41,Pennsylvania,Philadelphia,1085
17202,2000-2001,2000-12-01,2001-03-26,116,0,14,134,148,40,60,100,248,13,67,Pennsylvania,Philadelphia,1085
17203,2001-2002,2001-12-01,2002-02-28,90,0,3,58,61,5,7,12,73,2,8,Pennsylvania,Philadelphia,1085
17204,2002-2003,2002-12-01,2003-04-07,128,0,29,171,200,69,130,199,399,21,118,Pennsylvania,Philadelphia,1085
17205,2003-2004,2003-12-01,2004-04-04,126,0,32,161,193,28,45,73,266,16,69,Pennsylvania,Philadelphia,1085
17206,2004-2005,2004-12-01,2005-03-09,99,0,26,135,161,45,83,128,289,17,100,Pennsylvania,Philadelphia,1085
17207,2005-2006,2005-12-01,2006-04-05,126,0,7,101,108,29,31,60,168,10,42,Pennsylvania,Philadelphia,1085
17208,2006-2007,2006-12-01,2007-03-19,109,0,23,135,158,23,28,51,209,15,59,Pennsylvania,Philadelphia,1085
17209,2007-2008,2007-12-01,2008-02-29,91,0,9,89,98,10,4,14,112,5,21,Pennsylvania,Philadelphia,1085
17210,2008-2009,2008-11-21,2009-03-05,105,0,22,139,161,34,33,67,228,13,57,Pennsylvania,Philadelphia,1085
17211,2009-2010,2009-12-01,2010-02-28,90,0,16,124,140,100,170,270,410,15,130,Pennsylvania,Philadelphia,1085
17212,2010-2011,2010-12-01,2011-02-28,90,0,20,138,158,59,115,174,332,16,93,Pennsylvania,Philadelphia,1085
17213,2011-2012,2011-10-29,2012-02-29,124,0,4,58,62,7,6,13,75,5,16,Pennsylvania,Philadelphia,1085
17214,2012-2013,2012-12-01,2013-03-25,115,0,11,89,100,19,5,24,124,15,42,Pennsylvania,Philadelphia,1085
17215,2013-2014,2013-11-24,2014-03-25,122,0,36,192,228,93,165,258,486,21,146,Pennsylvania,Philadelphia,1085
17216,2014-2015,2014-12-01,2015-03-30,120,0,32,172,204,41,37,78,282,19,87,Pennsylvania,Philadelphia,1085
17217,2015-2016,2015-12-01,2016-04-09,131,0,12,83,95,42,57,99,194,12,61,Pennsylvania,Philadelphia,1085
17218,2016-2017,2016-12-01,2017-03-17,107,0,9,84,93,23,18,41,134,10,41,Pennsylvania,Philadelphia,1085
17219,2017-2018,2017-12-01,2018-03-23,113,0,25,135,160,45,38,83,243,14,71,Pennsylvania,Philadelphia,1085
17220,2018-2019,2018-11-15,2019-03-06,112,0,13,107,120,26,12,38,158,14,53,Pennsylvania,Philadelphia,1085
17221,2019-2020,2019-12-01,2020-02-29,91,0,2,66,68,2,0,2,70,2,5,Pennsylvania,Philadelphia,1085
17222,1950-1951,1950-11-21,1951-04-17,148,0,56,232,288,126,175,301,589,44,282,Pennsylvania,Pittsburgh,1822
17223,1951-1952,1951-11-01,1952-04-07,159,0,35,198,233,81,27,108,341,48,182,Pennsylvania,Pittsburgh,1822
17224,1952-1953,1952-10-20,1953-04-21,184,0,21,168,189,45,35,80,269,29,108,Pennsylvania,Pittsburgh,1822
17225,1953-1954,1953-11-07,1954-04-03,148,0,36,209,245,48,23,71,316,33,137,Pennsylvania,Pittsburgh,1822
17226,1954-1955,1954-11-05,1955-03-27,143,0,48,247,295,47,69,116,411,36,158,Pennsylvania,Pittsburgh,1822
17227,1955-1956,1955-11-17,1956-04-23,159,0,42,259,301,69,71,140,441,42,192,Pennsylvania,Pittsburgh,1822
17228,1956-1957,1956-11-22,1957-04-13,143,0,43,206,249,65,50,115,364,43,151,Pennsylvania,Pittsburgh,1822
17229,1957-1958,1957-10-27,1958-04-10,166,0,67,255,322,65,143,208,530,46,183,Pennsylvania,Pittsburgh,1822
17230,1958-1959,1958-11-27,1959-04-13,138,0,80,336,416,71,122,193,609,37,200,Pennsylvania,Pittsburgh,1822
17231,1959-1960,1959-11-02,1960-04-08,159,0,71,297,368,101,172,273,641,48,257,Pennsylvania,Pittsburgh,1822
17232,1960-1961,1960-10-24,1961-04-29,188,0,89,335,424,113,268,381,805,54,321,Pennsylvania,Pittsburgh,1822
17233,1961-1962,1961-11-08,1962-04-15,159,0,63,277,340,75,68,143,483,39,183,Pennsylvania,Pittsburgh,1822
17234,1962-1963,1962-10-25,1963-05-01,189,0,116,413,529,86,174,260,789,48,297,Pennsylvania,Pittsburgh,1822
17235,1963-1964,1963-11-02,1964-04-09,160,0,72,284,356,101,197,298,654,49,240,Pennsylvania,Pittsburgh,1822
17236,1964-1965,1964-11-20,1965-04-02,134,0,63,278,341,73,82,155,496,48,238,Pennsylvania,Pittsburgh,1822
17237,1965-1966,1965-10-28,1966-05-09,194,0,63,254,317,85,115,200,517,48,230,Pennsylvania,Pittsburgh,1822
17238,1966-1967,1966-11-03,1967-04-24,173,0,54,275,329,93,120,213,542,47,234,Pennsylvania,Pittsburgh,1822
17239,1967-1968,1967-11-06,1968-03-24,140,0,82,335,417,82,169,251,668,38,239,Pennsylvania,Pittsburgh,1822
17240,1968-1969,1968-11-12,1969-03-30,139,0,65,284,349,59,43,102,451,45,225,Pennsylvania,Pittsburgh,1822
17241,1969-1970,1969-10-23,1970-04-02,162,0,86,342,428,113,197,310,738,64,360,Pennsylvania,Pittsburgh,1822
17242,1970-1971,1970-11-24,1971-04-05,133,0,80,278,358,100,116,216,574,55,314,Pennsylvania,Pittsburgh,1822
17243,1971-1972,1971-11-06,1972-04-08,155,0,56,282,338,80,93,173,511,41,192,Pennsylvania,Pittsburgh,1822
17244,1972-1973,1972-10-18,1973-04-11,176,0,41,213,254,49,32,81,335,37,134,Pennsylvania,Pittsburgh,1822
17245,1973-1974,1973-11-09,1974-04-09,152,0,37,196,233,34,19,53,286,28,110,Pennsylvania,Pittsburgh,1822
17246,1974-1975,1974-11-15,1975-04-05,142,0,31,188,219,101,119,220,439,53,215,Pennsylvania,Pittsburgh,1822
17247,1975-1976,1975-11-13,1976-04-02,142,0,57,226,283,68,88,156,439,44,183,Pennsylvania,Pittsburgh,1822
17248,1976-1977,1976-11-08,1977-04-07,151,0,144,448,592,88,294,382,974,59,414,Pennsylvania,Pittsburgh,1822
17249,1977-1978,1977-11-11,1978-04-21,162,0,93,331,424,106,329,435,859,58,339,Pennsylvania,Pittsburgh,1822
17250,1978-1979,1978-11-26,1979-04-09,135,0,104,327,431,65,208,273,704,38,223,Pennsylvania,Pittsburgh,1822
17251,1979-1980,1979-11-15,1980-03-21,128,0,66,270,336,45,48,93,429,31,168,Pennsylvania,Pittsburgh,1822
17252,1980-1981,1980-11-17,1981-03-21,125,0,85,320,405,77,183,260,665,38,229,Pennsylvania,Pittsburgh,1822
17253,1981-1982,1981-11-21,1982-04-10,141,0,79,324,403,74,113,187,590,39,259,Pennsylvania,Pittsburgh,1822
17254,1982-1983,1982-11-24,1983-04-19,147,0,27,195,222,51,67,118,340,27,126,Pennsylvania,Pittsburgh,1822
17255,1983-1984,1983-11-04,1984-03-29,147,0,81,311,392,82,118,200,592,43,250,Pennsylvania,Pittsburgh,1822
17256,1984-1985,1984-11-12,1985-04-10,150,0,70,284,354,61,228,289,643,41,227,Pennsylvania,Pittsburgh,1822
17257,1985-1986,1985-12-01,1986-04-22,143,0,60,263,323,76,152,228,551,43,227,Pennsylvania,Pittsburgh,1822
17258,1986-1987,1986-11-11,1987-04-06,147,0,25,226,251,44,77,121,372,21,90,Pennsylvania,Pittsburgh,1822
17259,1987-1988,1987-11-10,1988-04-16,159,0,60,263,323,67,50,117,440,50,221,Pennsylvania,Pittsburgh,1822
17260,1988-1989,1988-10-24,1989-04-10,169,0,38,234,272,42,31,73,345,32,134,Pennsylvania,Pittsburgh,1822
17261,1989-1990,1989-10-21,1990-04-17,179,0,58,270,328,58,75,133,461,42,191,Pennsylvania,Pittsburgh,1822
17262,1990-1991,1990-12-01,1991-03-30,120,0,19,162,181,33,17,50,231,25,89,Pennsylvania,Pittsburgh,1822
17263,1991-1992,1991-11-04,1992-04-04,153,0,35,227,262,58,63,121,383,41,154,Pennsylvania,Pittsburgh,1822
17264,1992-1993,1992-10-18,1993-04-03,168,0,31,209,240,109,121,230,470,45,199,Pennsylvania,Pittsburgh,1822
17265,1993-1994,1993-10-30,1994-04-07,160,0,72,295,367,117,235,352,719,54,322,Pennsylvania,Pittsburgh,1822
17266,1994-1995,1994-11-23,1995-04-02,131,0,42,223,265,39,70,109,374,22,117,Pennsylvania,Pittsburgh,1822
17267,1995-1996,1995-11-08,1996-04-17,162,0,86,327,413,120,227,347,760,64,354,Pennsylvania,Pittsburgh,1822
17268,1996-1997,1996-11-09,1997-04-08,151,2,48,229,277,49,48,97,374,33,136,Pennsylvania,Pittsburgh,1822
17269,1997-1998,1997-11-12,1998-03-22,131,0,16,137,153,42,32,74,227,27,96,Pennsylvania,Pittsburgh,1822
17270,1998-1999,1998-12-01,1999-03-22,112,0,35,212,247,60,83,143,390,29,155,Pennsylvania,Pittsburgh,1822
17271,1999-2000,1999-11-02,2000-04-09,160,0,43,211,254,55,96,151,405,38,171,Pennsylvania,Pittsburgh,1822
17272,2000-2001,2000-11-15,2001-04-17,154,0,60,274,334,69,131,200,534,49,229,Pennsylvania,Pittsburgh,1822
17273,2001-2002,2001-10-27,2002-04-06,162,0,24,175,199,45,40,85,284,31,132,Pennsylvania,Pittsburgh,1822
17274,2002-2003,2002-11-22,2003-03-31,130,0,82,287,369,100,156,256,625,53,297,Pennsylvania,Pittsburgh,1822
17275,2003-2004,2003-11-13,2004-04-27,167,0,59,259,318,86,137,223,541,49,237,Pennsylvania,Pittsburgh,1822
17276,2004-2005,2004-12-01,2005-04-24,145,3,50,243,293,74,107,181,474,34,186,Pennsylvania,Pittsburgh,1822
17277,2005-2006,2005-11-17,2006-03-25,129,0,36,216,252,54,72,126,378,36,155,Pennsylvania,Pittsburgh,1822
17278,2006-2007,2006-12-01,2007-04-08,129,0,63,233,296,60,76,136,432,36,203,Pennsylvania,Pittsburgh,1822
17279,2007-2008,2007-11-22,2008-03-22,122,0,34,220,254,71,63,134,388,43,196,Pennsylvania,Pittsburgh,1822
17280,2008-2009,2008-10-28,2009-04-07,162,0,66,293,359,68,80,148,507,44,207,Pennsylvania,Pittsburgh,1822
17281,2009-2010,2009-12-01,2010-03-26,116,1,59,230,289,110,326,436,725,44,261,Pennsylvania,Pittsburgh,1822
17282,2010-2011,2010-12-01,2011-04-02,123,3,67,251,318,91,181,272,590,51,249,Pennsylvania,Pittsburgh,1822
17283,2011-2012,2011-10-29,2012-03-06,130,0,15,143,158,55,49,104,262,26,126,Pennsylvania,Pittsburgh,1822
17284,2012-2013,2012-11-24,2013-03-27,124,12,47,196,243,89,82,171,414,45,217,Pennsylvania,Pittsburgh,1822
17285,2013-2014,2013-10-25,2014-04-15,173,0,80,354,434,102,150,252,686,54,288,Pennsylvania,Pittsburgh,1822
17286,2014-2015,2014-11-13,2015-04-25,164,0,77,332,409,80,160,240,649,49,281,Pennsylvania,Pittsburgh,1822
17287,2015-2016,2015-12-01,2016-04-09,131,0,40,189,229,51,49,100,329,32,175,Pennsylvania,Pittsburgh,1822
17288,2016-2017,2016-11-19,2017-03-18,120,0,34,162,196,50,40,90,286,29,113,Pennsylvania,Pittsburgh,1822
17289,2017-2018,2017-12-01,2018-04-19,140,0,66,258,324,92,125,217,541,47,238,Pennsylvania,Pittsburgh,1822
17290,2018-2019,2018-11-14,2019-03-22,129,0,50,217,267,61,55,116,383,33,159,Pennsylvania,Pittsburgh,1822
17291,2019-2020,2019-11-12,2020-04-10,151,0,15,168,183,42,18,60,243,29,95,Pennsylvania,Pittsburgh,1822
17292,1950-1951,1950-11-25,1951-02-28,96,0,51,297,348,73,264,337,685,27,191,Pennsylvania,Ridgway,4078
17293,1951-1952,1951-11-01,1952-03-20,141,5,28,347,375,80,198,278,653,29,176,Pennsylvania,Ridgway,4078
17294,1952-1953,1952-11-28,1953-04-21,145,2,20,251,271,51,58,109,380,26,128,Pennsylvania,Ridgway,4078
17295,1953-1954,1953-11-07,1954-04-01,146,0,34,306,340,64,103,167,507,28,144,Pennsylvania,Ridgway,4078
17296,1954-1955,1954-12-01,1955-03-29,119,1,63,389,452,59,212,271,723,27,158,Pennsylvania,Ridgway,4078
17297,1955-1956,1955-11-18,1956-04-24,159,5,57,436,493,93,250,343,836,38,220,Pennsylvania,Ridgway,4078
17298,1956-1957,1956-11-24,1957-04-14,142,7,59,383,442,86,227,313,755,36,213,Pennsylvania,Ridgway,4078
17299,1957-1958,1957-10-27,1958-04-11,167,0,84,526,610,86,360,446,1056,45,311,Pennsylvania,Ridgway,4078
17300,1958-1959,1958-11-28,1959-03-22,115,0,85,434,519,86,301,387,906,33,233,Pennsylvania,Ridgway,4078
17301,1959-1960,1959-11-18,1960-04-09,144,3,61,399,460,129,369,498,958,43,295,Pennsylvania,Ridgway,4078
17302,1960-1961,1960-10-24,1961-04-13,172,0,89,506,595,136,516,652,1247,45,362,Pennsylvania,Ridgway,4078
17303,1961-1962,1961-11-08,1962-04-18,162,2,55,428,483,88,215,303,786,41,216,Pennsylvania,Ridgway,4078
17304,1962-1963,1962-10-24,1963-05-01,190,8,114,607,721,126,446,572,1293,55,397,Pennsylvania,Ridgway,4078
17305,1963-1964,1963-11-03,1964-04-09,159,0,81,480,561,129,374,503,1064,64,408,Pennsylvania,Ridgway,4078
17306,1964-1965,1964-11-22,1965-04-18,148,1,80,443,523,76,141,217,740,44,277,Pennsylvania,Ridgway,4078
17307,1965-1966,1965-11-17,1966-05-09,174,6,72,407,479,93,178,271,750,41,270,Pennsylvania,Ridgway,4078
17308,1966-1967,1966-11-06,1967-04-24,170,1,64,421,485,114,186,300,785,47,314,Pennsylvania,Ridgway,4078
17309,1967-1968,1967-11-08,1968-03-23,137,0,87,470,557,77,202,279,836,41,267,Pennsylvania,Ridgway,4078
17310,1968-1969,1968-11-12,1969-04-01,141,0,76,433,509,65,133,198,707,30,182,Pennsylvania,Ridgway,4078
17311,1969-1970,1969-10-23,1970-04-03,163,0,88,544,632,114,325,439,1071,49,347,Pennsylvania,Ridgway,4078
17312,1970-1971,1970-11-24,1971-03-30,127,3,83,367,450,117,276,393,843,43,295,Pennsylvania,Ridgway,4078
17313,1971-1972,1971-11-08,1972-04-09,154,0,59,426,485,109,265,374,859,32,238,Pennsylvania,Ridgway,4078
17314,1972-1973,1972-10-19,1973-04-12,176,0,48,348,396,59,94,153,549,22,119,Pennsylvania,Ridgway,4078
17315,1973-1974,1973-11-10,1974-04-11,153,1,40,338,378,57,108,165,543,25,133,Pennsylvania,Ridgway,4078
17316,1974-1975,1974-11-16,1975-04-06,142,0,38,346,384,98,183,281,665,38,198,Pennsylvania,Ridgway,4078
17317,1975-1976,1975-11-15,1976-03-18,125,0,66,368,434,100,227,327,761,35,255,Pennsylvania,Ridgway,4078
17318,1976-1977,1976-10-22,1977-04-06,167,0,153,594,747,138,442,580,1327,53,445,Pennsylvania,Ridgway,4078
17319,1977-1978,1977-11-13,1978-03-27,135,3,115,524,639,129,494,623,1262,39,347,Pennsylvania,Ridgway,4078
17320,1978-1979,1978-11-27,1979-04-07,132,0,115,465,580,103,361,464,1044,33,250,Pennsylvania,Ridgway,4078
17321,1979-1980,1979-11-30,1980-03-23,115,0,72,366,438,61,97,158,596,26,163,Pennsylvania,Ridgway,4078
17322,1980-1981,1980-11-18,1981-03-21,124,0,96,488,584,97,225,322,906,36,278,Pennsylvania,Ridgway,4078
17323,1981-1982,1981-11-21,1982-04-11,142,6,95,522,617,106,334,440,1057,46,344,Pennsylvania,Ridgway,4078
17324,1982-1983,1982-11-28,1983-04-19,143,2,36,304,340,38,85,123,463,19,93,Pennsylvania,Ridgway,4078
17325,1983-1984,1983-11-05,1984-04-01,149,5,99,533,632,86,337,423,1055,33,244,Pennsylvania,Ridgway,4078
17326,1984-1985,1984-11-12,1985-04-09,149,3,82,451,533,95,255,350,883,35,262,Pennsylvania,Ridgway,4078
17327,1985-1986,1985-12-01,1986-04-11,132,3,89,376,465,63,185,248,713,29,190,Pennsylvania,Ridgway,4078
17328,1986-1987,1986-11-11,1987-04-04,145,1,52,425,477,63,203,266,743,26,140,Pennsylvania,Ridgway,4078
17329,1987-1988,1987-11-06,1988-04-16,163,6,88,434,522,62,150,212,734,30,183,Pennsylvania,Ridgway,4078
17330,1988-1989,1988-11-29,1989-04-01,124,3,67,351,418,47,90,137,555,21,135,Pennsylvania,Ridgway,4078
17331,1989-1990,1989-11-17,1990-04-07,142,0,89,421,510,67,167,234,744,28,186,Pennsylvania,Ridgway,4078
17332,1990-1991,1990-11-24,1991-03-09,106,2,45,259,304,57,104,161,465,23,150,Pennsylvania,Ridgway,4078
17333,1991-1992,1991-11-05,1992-04-03,151,3,64,404,468,89,199,288,756,30,249,Pennsylvania,Ridgway,4078
17334,1992-1993,1992-11-15,1993-04-22,159,5,77,405,482,111,343,454,936,31,224,Pennsylvania,Ridgway,4078
17335,1993-1994,1993-11-01,1994-03-26,146,3,121,505,626,113,499,612,1238,33,280,Pennsylvania,Ridgway,4078
17336,1994-1995,1994-11-24,1995-04-05,133,7,63,362,425,45,86,131,556,19,132,Pennsylvania,Ridgway,4078
17337,1995-1996,1995-11-05,1996-03-23,140,0,139,475,614,119,306,425,1039,35,294,Pennsylvania,Ridgway,4078
17338,1996-1997,1996-11-12,1997-04-14,154,6,68,372,440,68,118,186,626,27,164,Pennsylvania,Ridgway,4078
17339,1997-1998,1997-11-14,1998-03-23,130,1,33,236,269,56,89,145,414,23,120,Pennsylvania,Ridgway,4078
17340,1998-1999,1998-12-01,1999-03-23,113,1,52,329,381,72,206,278,659,22,165,Pennsylvania,Ridgway,4078
17341,1999-2000,1999-11-17,2000-03-18,123,8,59,334,393,37,140,177,570,16,113,Pennsylvania,Ridgway,4078
17342,2000-2001,2000-11-16,2001-03-28,133,10,86,416,502,70,218,288,790,24,192,Pennsylvania,Ridgway,4078
17343,2001-2002,2001-12-01,2002-03-26,116,4,42,237,279,35,50,85,364,13,79,Pennsylvania,Ridgway,4078
17344,2002-2003,2002-10-30,2003-04-08,161,5,110,472,582,90,303,393,975,34,250,Pennsylvania,Ridgway,4078
17345,2003-2004,2003-11-14,2004-03-23,131,17,92,411,503,102,337,439,942,29,239,Pennsylvania,Ridgway,4078
17346,2004-2005,2004-12-01,2005-04-04,125,8,65,397,462,76,208,284,746,21,167,Pennsylvania,Ridgway,4078
17347,2005-2006,2005-10-25,2006-04-05,163,11,62,366,428,51,95,146,574,24,151,Pennsylvania,Ridgway,4078
17348,2006-2007,2006-12-01,2007-04-09,130,6,92,361,453,60,189,249,702,24,169,Pennsylvania,Ridgway,4078
17349,2007-2008,2007-11-18,2008-03-22,126,3,58,327,385,72,128,200,585,32,188,Pennsylvania,Ridgway,4078
17350,2008-2009,2008-10-29,2009-04-08,162,0,92,460,552,121,258,379,931,46,325,Pennsylvania,Ridgway,4078
17351,2009-2010,2009-10-16,2010-03-26,162,3,79,380,459,112,251,363,822,36,254,Pennsylvania,Ridgway,4078
17352,2010-2011,2010-11-28,2011-04-01,125,3,85,405,490,110,296,406,896,51,338,Pennsylvania,Ridgway,4078
17353,2011-2012,2011-10-29,2012-04-23,178,0,24,287,311,38,52,90,401,23,118,Pennsylvania,Ridgway,4078
17354,2012-2013,2012-11-24,2013-04-02,130,0,60,309,369,94,185,279,648,46,258,Pennsylvania,Ridgway,4078
17355,2013-2014,2013-10-24,2014-04-16,175,0,120,539,659,111,283,394,1053,57,414,Pennsylvania,Ridgway,4078
17356,2014-2015,2014-11-14,2015-04-01,139,0,104,506,610,104,364,468,1078,51,369,Pennsylvania,Ridgway,4078
17357,2015-2016,2015-10-18,2016-04-10,176,0,50,303,353,51,91,142,495,28,180,Pennsylvania,Ridgway,4078
17358,2016-2017,2016-11-21,2017-04-07,138,0,48,258,306,74,126,200,506,40,220,Pennsylvania,Ridgway,4078
17359,2017-2018,2017-11-17,2018-04-18,153,0,85,405,490,115,215,330,820,48,336,Pennsylvania,Ridgway,4078
17360,2018-2019,2018-10-22,2019-04-16,177,2,68,356,424,85,171,256,680,37,202,Pennsylvania,Ridgway,4078
17361,2019-2020,2019-11-12,2020-05-09,180,0,23,277,300,58,88,146,446,28,124,Pennsylvania,Ridgway,4078
17362,1950-1951,1950-11-23,1951-02-28,98,3,30,191,221,37,118,155,376,11,67,Pennsylvania,Shippensburg,5492
17363,1951-1952,1951-11-03,1952-03-19,138,0,17,198,215,55,134,189,404,14,87,Pennsylvania,Shippensburg,5492
17364,1952-1953,1952-11-30,1953-04-20,142,0,5,122,127,47,53,100,227,15,70,Pennsylvania,Shippensburg,5492
17365,1953-1954,1953-11-06,1954-02-28,115,0,14,157,171,48,54,102,273,11,76,Pennsylvania,Shippensburg,5492
17366,1954-1955,1954-11-02,1955-03-18,137,0,18,199,217,26,17,43,260,12,45,Pennsylvania,Shippensburg,5492
17367,1955-1956,1955-11-11,1956-03-29,140,2,18,214,232,52,57,109,341,15,73,Pennsylvania,Shippensburg,5492
17368,1956-1957,1956-11-18,1957-04-04,138,1,12,184,196,45,33,78,274,20,80,Pennsylvania,Shippensburg,5492
17369,1957-1958,1957-12-01,1958-03-25,115,0,35,201,236,86,163,249,485,17,114,Pennsylvania,Shippensburg,5492
17370,1958-1959,1958-11-28,1959-04-13,137,0,35,262,297,39,35,74,371,13,60,Pennsylvania,Shippensburg,5492
17371,1959-1960,1959-11-18,1960-03-22,126,2,22,208,230,54,124,178,408,12,81,Pennsylvania,Shippensburg,5492
17372,1960-1961,1960-10-24,1961-04-13,172,0,61,314,375,138,393,531,906,28,233,Pennsylvania,Shippensburg,5492
17373,1961-1962,1961-11-20,1962-03-17,118,0,28,230,258,87,199,286,544,19,128,Pennsylvania,Shippensburg,5492
17374,1962-1963,1962-11-03,1963-03-12,130,4,49,303,352,91,288,379,731,23,149,Pennsylvania,Shippensburg,5492
17375,1963-1964,1963-12-01,1964-04-01,123,0,29,230,259,113,260,373,632,24,172,Pennsylvania,Shippensburg,5492
17376,1965-1966,1965-12-01,1966-02-28,90,15,29,156,185,61,80,141,326,13,115,Pennsylvania,Shippensburg,5492
17377,1966-1967,1966-11-30,1967-03-23,114,2,25,201,226,60,70,130,356,23,113,Pennsylvania,Shippensburg,5492
17378,1967-1968,1967-11-17,1968-03-14,119,1,43,248,291,59,167,226,517,15,97,Pennsylvania,Shippensburg,5492
17379,1969-1970,1969-11-21,1970-04-01,132,1,52,268,320,93,315,408,728,22,161,Pennsylvania,Shippensburg,5492
17380,1970-1971,1970-11-24,1971-03-19,116,1,46,200,246,53,179,232,478,13,85,Pennsylvania,Shippensburg,5492
17381,1971-1972,1971-11-24,1972-04-08,137,1,24,211,235,64,97,161,396,18,105,Pennsylvania,Shippensburg,5492
17382,1972-1973,1972-10-19,1973-02-28,133,1,16,166,182,11,9,20,202,6,22,Pennsylvania,Shippensburg,5492
17383,1973-1974,1973-11-09,1974-03-30,142,1,23,178,201,43,83,126,327,13,78,Pennsylvania,Shippensburg,5492
17384,1974-1975,1974-12-01,1975-03-16,106,0,18,183,201,42,78,120,321,16,76,Pennsylvania,Shippensburg,5492
17385,1975-1976,1975-12-01,1976-03-18,109,1,44,198,242,27,57,84,326,15,63,Pennsylvania,Shippensburg,5492
17386,1976-1977,1976-11-08,1977-02-28,113,0,81,325,406,36,133,169,575,15,96,Pennsylvania,Shippensburg,5492
17387,1977-1978,1977-11-27,1978-03-18,112,1,84,305,389,79,436,515,904,22,150,Pennsylvania,Shippensburg,5492
17388,1978-1979,1978-11-27,1979-03-15,109,3,76,255,331,57,138,195,526,17,139,Pennsylvania,Shippensburg,5492
17389,1979-1980,1979-12-01,1980-03-16,107,1,35,210,245,24,44,68,313,9,66,Pennsylvania,Shippensburg,5492
17390,1980-1981,1980-11-17,1981-03-21,125,1,59,272,331,27,29,56,387,13,70,Pennsylvania,Shippensburg,5492
17391,1981-1982,1981-11-24,1982-04-09,137,13,65,283,348,83,299,382,730,25,172,Pennsylvania,Shippensburg,5492
17392,1982-1983,1982-11-28,1983-04-20,144,2,15,169,184,36,71,107,291,8,57,Pennsylvania,Shippensburg,5492
17393,1983-1984,1983-11-25,1984-03-31,128,10,64,250,314,51,108,159,473,18,112,Pennsylvania,Shippensburg,5492
17394,1984-1985,1984-11-18,1985-04-09,143,1,40,224,264,52,134,186,450,16,94,Pennsylvania,Shippensburg,5492
17395,1985-1986,1985-12-01,1986-03-08,98,8,39,217,256,55,148,203,459,22,123,Pennsylvania,Shippensburg,5492
17396,1986-1987,1986-12-01,1987-04-05,126,4,24,208,232,72,147,219,451,19,120,Pennsylvania,Shippensburg,5492
17397,1987-1988,1987-11-10,1988-03-20,132,0,33,231,264,46,82,128,392,19,93,Pennsylvania,Shippensburg,5492
17398,1988-1989,1988-12-01,1989-03-20,110,3,26,189,215,28,54,82,297,12,71,Pennsylvania,Shippensburg,5492
17399,1989-1990,1989-11-21,1990-04-12,143,1,37,210,247,32,67,99,346,19,71,Pennsylvania,Shippensburg,5492
17400,1990-1991,1990-12-01,1991-03-30,120,1,13,153,166,38,48,86,252,8,57,Pennsylvania,Shippensburg,5492
17401,1991-1992,1991-12-01,1992-03-22,113,5,12,175,187,24,16,40,227,8,44,Pennsylvania,Shippensburg,5492
17402,1992-1993,1992-12-01,1993-04-22,143,6,22,216,238,102,302,404,642,17,137,Pennsylvania,Shippensburg,5492
17403,1993-1994,1993-12-01,1994-03-29,119,7,63,280,343,109,567,676,1019,26,207,Pennsylvania,Shippensburg,5492
17404,1994-1995,1994-11-23,1995-03-10,108,6,27,173,200,17,31,48,248,8,39,Pennsylvania,Shippensburg,5492
17405,1995-1996,1995-11-11,1996-04-09,151,6,71,293,364,129,353,482,846,31,229,Pennsylvania,Shippensburg,5492
17406,1996-1997,1996-11-14,1997-03-19,126,2,28,182,210,42,69,111,321,19,81,Pennsylvania,Shippensburg,5492
17407,1997-1998,1997-12-01,1998-03-22,112,5,6,100,106,43,43,86,192,15,65,Pennsylvania,Shippensburg,5492
17408,1998-1999,1998-12-01,1999-03-16,106,5,27,171,198,51,86,137,335,19,111,Pennsylvania,Shippensburg,5492
17409,1999-2000,1999-12-01,2000-04-09,131,1,24,164,188,40,137,177,365,11,77,Pennsylvania,Shippensburg,5492
17410,2000-2001,2000-11-29,2001-03-06,98,2,23,194,217,41,204,245,462,15,73,Pennsylvania,Shippensburg,5492
17411,2001-2002,2001-12-01,2002-03-17,107,1,4,117,121,16,23,39,160,6,28,Pennsylvania,Shippensburg,5492
17412,2002-2003,2002-10-30,2003-04-07,160,0,41,255,296,100,268,368,664,34,187,Pennsylvania,Shippensburg,5492
17413,2003-2004,2003-12-01,2004-03-19,110,0,37,214,251,68,273,341,592,21,143,Pennsylvania,Shippensburg,5492
17414,2004-2005,2004-12-01,2005-03-11,101,0,29,188,217,35,54,89,306,14,77,Pennsylvania,Shippensburg,5492
17415,2005-2006,2005-11-23,2006-02-28,98,3,12,146,158,25,74,99,257,9,46,Pennsylvania,Shippensburg,5492
17416,2006-2007,2006-12-01,2007-03-19,109,0,31,189,220,37,69,106,326,14,82,Pennsylvania,Shippensburg,5492
17417,2007-2008,2007-12-01,2008-03-22,113,0,16,158,174,29,28,57,231,14,58,Pennsylvania,Shippensburg,5492
17418,2008-2009,2008-11-21,2009-03-03,103,0,31,202,233,25,23,48,281,16,67,Pennsylvania,Shippensburg,5492
17419,2009-2010,2009-12-01,2010-03-03,93,0,32,166,198,84,205,289,487,17,124,Pennsylvania,Shippensburg,5492
17420,2010-2011,2010-12-01,2011-03-06,96,0,36,198,234,35,132,167,401,16,88,Pennsylvania,Shippensburg,5492
17421,2011-2012,2011-10-29,2012-02-29,124,0,8,128,136,22,19,41,177,10,43,Pennsylvania,Shippensburg,5492
17422,2012-2013,2012-11-27,2013-03-25,119,0,19,155,174,52,52,104,278,21,100,Pennsylvania,Shippensburg,5492
17423,2013-2014,2013-11-23,2014-03-25,123,0,59,297,356,64,208,272,628,23,142,Pennsylvania,Shippensburg,5492
17424,2014-2015,2014-11-18,2015-03-24,127,0,53,284,337,62,207,269,606,28,165,Pennsylvania,Shippensburg,5492
17425,2015-2016,2015-12-01,2016-03-04,95,0,26,162,188,53,167,220,408,11,92,Pennsylvania,Shippensburg,5492
17426,2016-2017,2016-12-01,2017-03-19,109,0,24,157,181,35,26,61,242,16,81,Pennsylvania,Shippensburg,5492
17427,2017-2018,2017-12-01,2018-04-09,130,0,41,223,264,50,78,128,392,13,80,Pennsylvania,Shippensburg,5492
17428,2018-2019,2018-11-15,2019-03-10,116,0,25,183,208,60,103,163,371,18,108,Pennsylvania,Shippensburg,5492
17429,2019-2020,2019-11-24,2020-02-29,98,0,10,131,141,13,8,21,162,8,29,Pennsylvania,Shippensburg,5492
17430,1950-1951,1950-11-11,1951-03-22,132,1,57,254,311,78,229,307,618,28,160,Pennsylvania,State College,42034
17431,1951-1952,1951-11-01,1952-03-29,150,0,39,240,279,70,128,198,477,29,132,Pennsylvania,State College,42034
17432,1952-1953,1952-11-28,1953-04-19,143,1,19,147,166,50,66,116,282,26,104,Pennsylvania,State College,42034
17433,1953-1954,1953-11-06,1954-03-21,136,1,43,205,248,51,72,123,371,16,94,Pennsylvania,State College,42034
17434,1954-1955,1954-11-02,1955-03-28,147,3,48,242,290,47,79,126,416,28,127,Pennsylvania,State College,42034
17435,1955-1956,1955-11-11,1956-04-22,164,15,48,281,329,53,86,139,468,23,106,Pennsylvania,State College,42034
17436,1956-1957,1956-11-18,1957-04-09,143,1,41,206,247,92,79,171,418,40,167,Pennsylvania,State College,42034
17437,1957-1958,1957-12-01,1958-04-11,132,0,62,267,329,92,207,299,628,33,168,Pennsylvania,State College,42034
17438,1958-1959,1958-11-03,1959-04-13,162,0,83,363,446,74,105,179,625,30,158,Pennsylvania,State College,42034
17439,1959-1960,1959-11-19,1960-04-09,143,4,56,277,333,80,222,302,635,33,188,Pennsylvania,State College,42034
17440,1960-1961,1960-10-24,1961-04-18,177,0,88,347,435,139,416,555,990,46,306,Pennsylvania,State College,42034
17441,1961-1962,1961-11-20,1962-04-16,148,0,67,301,368,82,185,267,635,36,198,Pennsylvania,State College,42034
17442,1962-1963,1962-10-26,1963-05-01,188,0,106,429,535,94,248,342,877,37,262,Pennsylvania,State College,42034
17443,1963-1964,1963-11-30,1964-04-01,124,0,68,309,377,115,380,495,872,34,233,Pennsylvania,State College,42034
17444,1964-1965,1964-11-22,1965-04-02,132,0,73,318,391,71,163,234,625,32,184,Pennsylvania,State College,42034
17445,1965-1966,1965-10-29,1966-04-10,164,0,68,293,361,75,132,207,568,37,209,Pennsylvania,State College,42034
17446,1966-1967,1966-11-29,1967-04-27,150,3,63,292,355,86,138,224,579,38,214,Pennsylvania,State College,42034
17447,1967-1968,1967-11-15,1968-03-24,131,2,84,325,409,51,122,173,582,29,175,Pennsylvania,State College,42034
17448,1968-1969,1968-11-12,1969-03-27,136,0,63,296,359,64,42,106,465,28,154,Pennsylvania,State College,42034
17449,1969-1970,1969-10-23,1970-04-07,167,0,78,380,458,133,387,520,978,49,297,Pennsylvania,State College,42034
17450,1970-1971,1970-11-24,1971-03-30,127,0,71,287,358,102,227,329,687,32,192,Pennsylvania,State College,42034
17451,1971-1972,1971-11-10,1972-04-08,151,0,48,295,343,86,170,256,599,39,204,Pennsylvania,State College,42034
17452,1972-1973,1972-10-19,1973-04-11,175,0,43,243,286,54,65,119,405,27,126,Pennsylvania,State College,42034
17453,1975-1976,1975-12-01,1976-04-05,127,0,59,258,317,77,142,219,536,41,219,Pennsylvania,State College,42034
17454,1976-1977,1976-11-04,1977-04-07,155,0,125,417,542,68,247,315,857,38,228,Pennsylvania,State College,42034
17455,1978-1979,1978-11-26,1979-03-27,122,4,96,307,403,69,229,298,701,35,230,Pennsylvania,State College,42034
17456,1979-1980,1979-11-30,1980-03-23,115,0,53,267,320,36,29,65,385,25,128,Pennsylvania,State College,42034
17457,1980-1981,1980-11-18,1981-03-21,124,1,81,338,419,63,123,186,605,31,182,Pennsylvania,State College,42034
17458,1981-1982,1981-11-21,1982-04-10,141,1,81,392,473,105,248,353,826,48,283,Pennsylvania,State College,42034
17459,1982-1983,1982-11-16,1983-03-28,133,2,39,223,262,31,63,94,356,11,65,Pennsylvania,State College,42034
17460,1983-1984,1983-11-04,1984-03-31,149,3,84,376,460,80,177,257,717,37,199,Pennsylvania,State College,42034
17461,1984-1985,1984-11-13,1985-04-10,149,2,66,325,391,47,133,180,571,30,140,Pennsylvania,State College,42034
17462,1985-1986,1985-12-01,1986-04-11,132,4,71,312,383,65,139,204,587,31,190,Pennsylvania,State College,42034
17463,1986-1987,1986-11-11,1987-04-04,145,1,29,299,328,76,183,259,587,21,113,Pennsylvania,State College,42034
17464,1987-1988,1987-11-11,1988-04-17,159,0,62,357,419,62,91,153,572,32,178,Pennsylvania,State College,42034
17465,1988-1989,1988-11-29,1989-04-10,133,1,42,307,349,40,45,85,434,21,135,Pennsylvania,State College,42034
17466,1989-1990,1989-11-17,1990-04-12,147,0,62,283,345,71,81,152,497,43,194,Pennsylvania,State College,42034
17467,1990-1991,1990-11-12,1991-04-02,142,0,30,224,254,55,64,119,373,25,120,Pennsylvania,State College,42034
17468,1991-1992,1991-11-12,1992-04-03,144,0,44,253,297,45,47,92,389,24,135,Pennsylvania,State College,42034
17469,1992-1993,1992-12-01,1993-04-23,144,0,48,268,316,142,311,453,769,40,259,Pennsylvania,State College,42034
17470,1993-1994,1993-11-01,1994-03-31,151,0,99,362,461,159,556,715,1176,45,350,Pennsylvania,State College,42034
17471,1994-1995,1994-11-24,1995-04-05,133,0,46,243,289,39,58,97,386,21,119,Pennsylvania,State College,42034
17472,1995-1996,1995-11-12,1996-04-17,158,1,98,359,457,150,358,508,965,48,307,Pennsylvania,State College,42034
17473,1996-1997,1996-11-03,1997-04-09,158,0,43,276,319,61,126,187,506,23,124,Pennsylvania,State College,42034
17474,1997-1998,1997-11-14,1998-03-23,130,0,15,160,175,72,74,146,321,25,109,Pennsylvania,State College,42034
17475,1998-1999,1998-12-01,1999-03-22,112,0,39,223,262,54,122,176,438,22,135,Pennsylvania,State College,42034
17476,1999-2000,1999-11-30,2000-04-09,132,0,43,219,262,34,96,130,392,22,126,Pennsylvania,State College,42034
17477,2000-2001,2000-11-22,2001-03-27,126,0,59,287,346,51,143,194,540,23,127,Pennsylvania,State College,42034
17478,2001-2002,2001-12-01,2002-03-26,116,0,23,144,167,36,26,62,229,15,69,Pennsylvania,State College,42034
17479,2002-2003,2002-10-30,2003-04-08,161,0,79,322,401,119,252,371,772,44,256,Pennsylvania,State College,42034
17480,2003-2004,2003-11-14,2004-03-23,131,0,69,275,344,105,362,467,811,33,229,Pennsylvania,State College,42034
17481,2004-2005,2004-12-01,2005-04-25,146,3,49,254,303,58,110,168,471,27,120,Pennsylvania,State College,42034
17482,2005-2006,2005-10-26,2006-04-05,162,1,34,225,259,51,102,153,412,30,124,Pennsylvania,State College,42034
17483,2006-2007,2006-12-01,2007-04-08,129,0,60,243,303,62,111,173,476,30,183,Pennsylvania,State College,42034
17484,2007-2008,2007-11-18,2008-03-23,127,0,34,219,253,70,106,176,429,34,160,Pennsylvania,State College,42034
17485,2008-2009,2008-10-30,2009-03-04,126,0,60,262,322,47,105,152,474,32,145,Pennsylvania,State College,42034
17486,2009-2010,2009-10-16,2010-03-08,144,0,49,219,268,73,231,304,572,29,147,Pennsylvania,State College,42034
17487,2010-2011,2010-12-01,2011-03-31,121,0,51,278,329,64,189,253,582,28,150,Pennsylvania,State College,42034
17488,2011-2012,2011-10-30,2012-02-29,123,2,15,137,152,32,27,59,211,18,71,Pennsylvania,State College,42034
17489,2012-2013,2012-11-27,2013-03-26,120,0,45,191,236,69,118,187,423,34,158,Pennsylvania,State College,42034
17490,2013-2014,2013-11-12,2014-03-27,136,0,103,376,479,83,224,307,786,37,256,Pennsylvania,State College,42034
17491,2014-2015,2014-11-19,2015-04-01,134,0,92,354,446,81,274,355,801,40,250,Pennsylvania,State College,42034
17492,2015-2016,2015-12-01,2016-04-10,132,0,45,195,240,34,43,77,317,17,97,Pennsylvania,State College,42034
17493,2016-2017,2016-11-21,2017-03-19,119,0,40,177,217,55,71,126,343,24,114,Pennsylvania,State College,42034
17494,2017-2018,2017-11-11,2018-04-10,151,0,80,284,364,54,86,140,504,27,137,Pennsylvania,State College,42034
17495,2018-2019,2018-11-10,2019-03-12,123,0,57,228,285,60,166,226,511,21,135,Pennsylvania,State College,42034
17496,2019-2020,2019-11-14,2020-04-18,157,1,19,176,195,26,14,40,235,18,58,Pennsylvania,State College,42034
17497,1950-1951,1950-11-21,1951-03-22,122,0,38,261,299,67,171,238,537,35,159,Pennsylvania,Williamsport,6379
17498,1951-1952,1951-11-03,1952-03-19,138,0,27,265,292,84,148,232,524,38,174,Pennsylvania,Williamsport,6379
17499,1952-1953,1952-10-20,1953-04-18,181,0,12,192,204,39,25,64,268,24,87,Pennsylvania,Williamsport,6379
17500,1953-1954,1953-11-06,1954-03-05,120,0,29,202,231,46,60,106,337,18,90,Pennsylvania,Williamsport,6379
17501,1954-1955,1954-11-02,1955-03-26,145,0,35,243,278,60,42,102,380,37,160,Pennsylvania,Williamsport,6379
17502,1955-1956,1955-11-10,1956-04-23,166,0,35,289,324,74,85,159,483,40,173,Pennsylvania,Williamsport,6379
17503,1956-1957,1956-11-17,1957-04-08,143,0,28,240,268,77,93,170,438,37,154,Pennsylvania,Williamsport,6379
17504,1957-1958,1957-11-26,1958-04-08,134,0,42,233,275,79,158,237,512,29,137,Pennsylvania,Williamsport,6379
17505,1958-1959,1958-11-02,1959-04-13,163,0,52,332,384,56,67,123,507,31,127,Pennsylvania,Williamsport,6379
17506,1959-1960,1959-11-18,1960-04-09,144,0,29,245,274,79,131,210,484,28,145,Pennsylvania,Williamsport,6379
17507,1960-1961,1960-12-01,1961-04-18,139,0,76,366,442,113,400,513,955,35,237,Pennsylvania,Williamsport,6379
17508,1961-1962,1961-11-09,1962-04-15,158,0,44,302,346,72,103,175,521,36,176,Pennsylvania,Williamsport,6379
17509,1962-1963,1962-10-26,1963-03-19,145,0,76,390,466,86,293,379,845,40,244,Pennsylvania,Williamsport,6379
17510,1963-1964,1963-11-29,1964-04-09,133,0,43,299,342,110,282,392,734,32,194,Pennsylvania,Williamsport,6379
17511,1964-1965,1964-12-01,1965-04-18,139,0,57,303,360,43,48,91,451,29,134,Pennsylvania,Williamsport,6379
17512,1965-1966,1965-12-01,1966-04-01,122,0,34,229,263,60,152,212,475,24,131,Pennsylvania,Williamsport,6379
17513,1966-1967,1966-11-29,1967-04-27,150,0,53,284,337,99,132,231,568,42,216,Pennsylvania,Williamsport,6379
17514,1967-1968,1967-11-14,1968-03-24,132,0,52,306,358,47,129,176,534,25,131,Pennsylvania,Williamsport,6379
17515,1968-1969,1968-11-12,1969-03-11,120,0,31,244,275,36,22,58,333,22,84,Pennsylvania,Williamsport,6379
17516,1969-1970,1969-11-15,1970-04-01,138,0,59,396,455,121,410,531,986,47,290,Pennsylvania,Williamsport,6379
17517,1970-1971,1970-11-24,1971-03-30,127,0,53,247,300,99,201,300,600,45,192,Pennsylvania,Williamsport,6379
17518,1971-1972,1971-11-09,1972-04-08,152,0,41,289,330,96,171,267,597,44,200,Pennsylvania,Williamsport,6379
17519,1972-1973,1972-10-18,1973-03-18,152,0,34,234,268,51,66,117,385,24,103,Pennsylvania,Williamsport,6379
17520,1973-1974,1973-11-09,1974-04-10,153,0,42,236,278,64,102,166,444,27,136,Pennsylvania,Williamsport,6379
17521,1974-1975,1974-11-26,1975-04-04,130,0,22,192,214,60,124,184,398,28,115,Pennsylvania,Williamsport,6379
17522,1975-1976,1975-11-25,1976-03-18,115,0,44,227,271,49,81,130,401,27,110,Pennsylvania,Williamsport,6379
17523,1976-1977,1976-11-05,1977-05-09,186,0,90,390,480,64,202,266,746,34,180,Pennsylvania,Williamsport,6379
17524,1977-1978,1977-10-16,1978-04-03,170,0,87,350,437,124,490,614,1051,42,256,Pennsylvania,Williamsport,6379
17525,1978-1979,1978-11-21,1979-04-08,139,0,76,281,357,64,144,208,565,33,194,Pennsylvania,Williamsport,6379
17526,1979-1980,1979-12-01,1980-03-22,113,0,37,242,279,38,39,77,356,21,90,Pennsylvania,Williamsport,6379
17527,1980-1981,1980-11-17,1981-03-21,125,0,74,358,432,65,190,255,687,28,166,Pennsylvania,Williamsport,6379
17528,1981-1982,1981-12-01,1982-04-10,131,0,69,315,384,78,245,323,707,30,174,Pennsylvania,Williamsport,6379
17529,1982-1983,1982-12-01,1983-04-20,141,0,20,185,205,30,58,88,293,14,56,Pennsylvania,Williamsport,6379
17530,1983-1984,1983-12-01,1984-04-02,124,0,84,307,391,58,167,225,616,26,157,Pennsylvania,Williamsport,6379
17531,1984-1985,1984-12-01,1985-04-03,124,0,46,233,279,41,107,148,427,19,101,Pennsylvania,Williamsport,6379
17532,1985-1986,1985-12-01,1986-03-08,98,0,47,242,289,53,140,193,482,27,149,Pennsylvania,Williamsport,6379
17533,1986-1987,1986-11-05,1987-03-10,126,0,31,268,299,77,226,303,602,15,104,Pennsylvania,Williamsport,6379
17534,1987-1988,1987-11-06,1988-03-20,136,0,47,284,331,54,110,164,495,25,114,Pennsylvania,Williamsport,6379
17535,1988-1989,1988-12-01,1989-03-21,111,0,29,236,265,15,5,20,285,13,50,Pennsylvania,Williamsport,6379
17536,1989-1990,1989-11-18,1990-04-07,141,0,44,281,325,54,67,121,446,29,143,Pennsylvania,Williamsport,6379
17537,1990-1991,1990-12-01,1991-04-01,122,0,14,190,204,44,47,91,295,23,98,Pennsylvania,Williamsport,6379
17538,1991-1992,1991-12-01,1992-04-03,125,0,23,217,240,38,29,67,307,22,97,Pennsylvania,Williamsport,6379
17539,1992-1993,1992-12-01,1993-04-22,143,0,23,252,275,83,180,263,538,30,150,Pennsylvania,Williamsport,6379
17540,1993-1994,1993-10-31,1994-03-25,146,0,84,377,461,115,551,666,1127,36,261,Pennsylvania,Williamsport,6379
17541,1994-1995,1994-11-23,1995-04-08,137,0,26,247,273,24,39,63,336,15,73,Pennsylvania,Williamsport,6379
17542,1995-1996,1995-11-08,1996-04-09,154,19,85,373,458,127,260,387,845,49,288,Pennsylvania,Williamsport,6379
17543,2004-2005,2004-12-01,2005-03-24,114,0,50,256,306,55,103,158,464,26,141,Pennsylvania,Williamsport,6379
17544,2005-2006,2005-11-23,2006-04-05,134,1,31,229,260,41,83,124,384,22,100,Pennsylvania,Williamsport,6379
17545,2006-2007,2006-12-01,2007-04-08,129,0,43,235,278,46,103,149,427,20,108,Pennsylvania,Williamsport,6379
17546,2007-2008,2007-11-18,2008-03-03,107,0,28,194,222,48,82,130,352,24,110,Pennsylvania,Williamsport,6379
17547,2008-2009,2008-11-20,2009-03-03,104,0,45,251,296,46,134,180,476,27,120,Pennsylvania,Williamsport,6379
17548,2009-2010,2009-10-15,2010-03-03,140,0,24,177,201,54,99,153,354,24,100,Pennsylvania,Williamsport,6379
17549,2010-2011,2010-11-25,2011-03-24,120,0,41,267,308,73,186,259,567,34,166,Pennsylvania,Williamsport,6379
17550,2011-2012,2011-10-29,2012-03-04,128,0,10,144,154,22,27,49,203,13,47,Pennsylvania,Williamsport,6379
17551,2012-2013,2012-11-27,2013-03-25,119,0,30,188,218,49,95,144,362,22,106,Pennsylvania,Williamsport,6379
17552,2013-2014,2013-11-12,2014-03-16,125,0,82,369,451,74,172,246,697,31,178,Pennsylvania,Williamsport,6379
17553,2014-2015,2014-11-18,2015-04-01,135,0,58,350,408,66,235,301,709,28,176,Pennsylvania,Williamsport,6379
17554,2015-2016,2015-12-01,2016-04-09,131,0,23,163,186,17,13,30,216,13,55,Pennsylvania,Williamsport,6379
17555,2016-2017,2016-11-19,2017-03-20,122,0,24,161,185,66,77,143,328,22,109,Pennsylvania,Williamsport,6379
17556,2017-2018,2017-11-19,2018-04-06,139,0,42,243,285,44,65,109,394,25,113,Pennsylvania,Williamsport,6379
17557,2018-2019,2018-11-15,2019-03-10,116,0,32,213,245,49,92,141,386,18,93,Pennsylvania,Williamsport,6379
17558,2019-2020,2019-11-12,2020-04-17,158,0,9,182,191,25,21,46,237,17,53,Pennsylvania,Williamsport,6379
17559,1950-1951,1950-12-01,1951-03-22,112,1,21,198,219,23,17,40,259,12,61,Rhode Island,Kingston,0
17560,1951-1952,1951-11-20,1952-03-16,118,1,17,221,238,38,49,87,325,14,65,Rhode Island,Kingston,0
17561,1955-1956,1955-11-19,1956-03-30,133,3,29,305,334,76,154,230,564,17,126,Rhode Island,Kingston,0
17562,1956-1957,1956-12-01,1957-04-05,126,1,19,258,277,41,121,162,439,14,81,Rhode Island,Kingston,0
17563,1957-1958,1957-12-01,1958-04-11,132,1,25,233,258,46,88,134,392,12,79,Rhode Island,Kingston,0
17564,1958-1959,1958-12-01,1959-03-29,119,2,36,322,358,29,66,95,453,13,61,Rhode Island,Kingston,0
17565,1959-1960,1959-12-01,1960-04-07,129,4,14,265,279,57,161,218,497,17,110,Rhode Island,Kingston,0
17566,1961-1962,1961-12-01,1962-03-10,100,2,27,248,275,52,184,236,511,14,88,Rhode Island,Kingston,0
17567,1962-1963,1962-11-19,1963-03-21,123,0,40,302,342,31,47,78,420,15,69,Rhode Island,Kingston,0
17568,1963-1964,1963-12-01,1964-03-04,95,0,29,271,300,70,270,340,640,16,113,Rhode Island,Kingston,0
17569,1964-1965,1964-12-01,1965-03-29,119,0,40,296,336,71,219,290,626,19,131,Rhode Island,Kingston,0
17570,1965-1966,1965-12-01,1966-03-14,104,0,14,228,242,38,120,158,400,10,61,Rhode Island,Kingston,0
17571,1966-1967,1966-12-01,1967-03-27,117,1,15,271,286,77,137,214,500,21,130,Rhode Island,Kingston,0
17572,1967-1968,1967-11-16,1968-02-29,106,0,35,305,340,50,105,155,495,13,90,Rhode Island,Kingston,0
17573,1968-1969,1968-12-01,1969-03-30,120,1,25,272,297,41,156,197,494,8,53,Rhode Island,Kingston,0
17574,1969-1970,1969-12-01,1970-04-01,122,0,37,336,373,58,134,192,565,21,121,Rhode Island,Kingston,0
17575,1970-1971,1970-12-01,1971-03-11,101,0,40,270,310,37,80,117,427,14,73,Rhode Island,Kingston,0
17576,1971-1972,1971-12-01,1972-03-15,106,3,19,247,266,30,42,72,338,12,64,Rhode Island,Kingston,0
17577,1972-1973,1972-12-01,1973-04-08,129,8,25,195,220,15,10,25,245,9,37,Rhode Island,Kingston,0
17578,1973-1974,1973-12-01,1974-04-10,131,1,23,236,259,43,123,166,425,13,91,Rhode Island,Kingston,0
17579,1974-1975,1974-11-26,1975-03-11,106,0,9,204,213,37,78,115,328,9,67,Rhode Island,Kingston,0
17580,1975-1976,1975-12-01,1976-03-18,109,0,29,257,286,43,74,117,403,10,74,Rhode Island,Kingston,0
17581,1977-1978,1977-12-01,1978-03-19,109,0,45,355,400,84,285,369,769,18,140,Rhode Island,Kingston,0
17582,1978-1979,1978-11-27,1979-02-28,94,0,48,250,298,23,59,82,380,11,66,Rhode Island,Kingston,0
17583,1979-1980,1979-12-01,1980-03-25,116,0,21,251,272,16,7,23,295,10,36,Rhode Island,Kingston,0
17584,1980-1981,1980-12-01,1981-03-07,97,0,38,301,339,21,91,112,451,12,74,Rhode Island,Kingston,0
17585,1981-1982,1981-12-01,1982-04-09,130,1,36,298,334,58,156,214,548,17,113,Rhode Island,Kingston,0
17586,1982-1983,1982-12-01,1983-02-28,90,1,17,178,195,49,106,155,350,9,68,Rhode Island,Kingston,0
17587,1983-1984,1983-12-01,1984-03-30,121,0,33,265,298,31,85,116,414,9,57,Rhode Island,Kingston,0
17588,1984-1985,1984-12-01,1985-03-18,108,0,24,247,271,27,88,115,386,11,63,Rhode Island,Kingston,0
17589,1985-1986,1985-12-01,1986-03-08,98,0,21,252,273,19,35,54,327,10,48,Rhode Island,Kingston,0
17590,1986-1987,1986-11-19,1987-03-21,123,0,9,274,283,46,134,180,463,20,87,Rhode Island,Kingston,0
17591,1987-1988,1987-11-12,1988-03-05,115,0,20,270,290,45,98,143,433,11,74,Rhode Island,Kingston,0
17592,1988-1989,1988-12-01,1989-03-08,98,0,17,234,251,13,13,26,277,6,37,Rhode Island,Kingston,0
17593,1989-1990,1989-11-23,1990-04-07,136,0,38,304,342,56,113,169,511,19,127,Rhode Island,Kingston,0
17594,1990-1991,1990-12-01,1991-03-15,105,0,6,194,200,26,20,46,246,8,40,Rhode Island,Kingston,0
17595,1991-1992,1991-12-01,1992-04-17,139,0,15,274,289,27,24,51,340,11,60,Rhode Island,Kingston,0
17596,1992-1993,1992-12-01,1993-03-20,110,3,19,254,273,46,54,100,373,16,86,Rhode Island,Kingston,0
17597,1993-1994,1993-12-01,1994-03-19,109,3,48,329,377,78,227,305,682,22,162,Rhode Island,Kingston,0
17598,1994-1995,1994-12-01,1995-02-28,90,1,14,169,183,18,15,33,216,6,30,Rhode Island,Kingston,0
17599,1995-1996,1995-11-29,1996-04-10,134,4,36,327,363,107,268,375,738,24,189,Rhode Island,Kingston,0
17600,1996-1997,1996-11-27,1997-04-02,127,3,13,195,208,38,34,72,280,10,56,Rhode Island,Kingston,0
17601,1997-1998,1997-12-01,1998-03-12,102,0,4,134,138,10,8,18,156,4,15,Rhode Island,Kingston,0
17602,1998-1999,1998-12-01,1999-03-16,106,3,13,204,217,52,46,98,315,13,86,Rhode Island,Kingston,0
17603,1999-2000,1999-12-01,2000-03-18,109,0,21,199,220,22,31,53,273,8,47,Rhode Island,Kingston,0
17604,2000-2001,2000-12-01,2001-03-27,117,2,8,239,247,56,93,149,396,22,90,Rhode Island,Kingston,0
17605,2001-2002,2001-12-01,2002-03-18,108,0,0,153,153,14,9,23,176,7,26,Rhode Island,Kingston,0
17606,2002-2003,2002-11-27,2003-04-08,133,10,34,328,362,73,159,232,594,28,158,Rhode Island,Kingston,0
17607,2003-2004,2003-12-01,2004-03-20,111,0,38,254,292,54,96,150,442,18,97,Rhode Island,Kingston,0
17608,2004-2005,2004-11-13,2005-03-24,132,8,23,283,306,103,247,350,656,24,181,Rhode Island,Kingston,0
17609,2005-2006,2005-12-01,2006-03-06,96,3,7,188,195,38,52,90,285,9,62,Rhode Island,Kingston,0
17610,2006-2007,2006-12-01,2007-03-20,110,0,17,213,230,20,16,36,266,7,29,Rhode Island,Kingston,0
17611,2007-2008,2007-12-01,2008-03-01,92,2,10,190,200,22,51,73,273,10,43,Rhode Island,Kingston,0
17612,2008-2009,2008-12-01,2009-03-07,97,0,21,236,257,67,170,237,494,18,119,Rhode Island,Kingston,0
17613,2009-2010,2009-12-01,2010-03-03,93,2,13,195,208,51,131,182,390,13,76,Rhode Island,Kingston,0
17614,2011-2012,2011-10-30,2012-02-29,123,0,4,155,159,20,17,37,196,5,28,Rhode Island,Kingston,0
17615,2012-2013,2012-11-28,2013-03-19,112,0,15,194,209,64,111,175,384,19,113,Rhode Island,Kingston,0
17616,2013-2014,2013-12-01,2014-03-26,116,0,24,308,332,65,160,225,557,23,146,Rhode Island,Kingston,0
17617,2014-2015,2014-11-14,2015-03-29,136,0,26,362,388,90,309,399,787,29,191,Rhode Island,Kingston,0
17618,2015-2016,2015-12-01,2016-04-05,127,0,9,180,189,43,67,110,299,16,83,Rhode Island,Kingston,0
17619,2016-2017,2016-12-01,2017-03-16,106,0,8,190,198,64,99,163,361,14,105,Rhode Island,Kingston,0
17620,2017-2018,2017-12-01,2018-04-06,127,0,30,243,273,74,88,162,435,21,131,Rhode Island,Kingston,0
17621,2018-2019,2018-11-16,2019-03-23,128,0,10,237,247,29,37,66,313,9,42,Rhode Island,Kingston,0
17622,2019-2020,2019-12-01,2020-03-07,98,0,3,147,150,20,19,39,189,8,31,Rhode Island,Kingston,0
17623,1974-1975,1974-11-21,1975-04-27,158,3,34,286,320,60,145,205,525,32,140,Rhode Island,North Foster,0
17624,1975-1976,1975-11-24,1976-03-19,117,0,63,325,388,76,119,195,583,35,230,Rhode Island,North Foster,0
17625,1976-1977,1976-11-10,1977-05-10,182,0,90,418,508,125,551,676,1184,34,238,Rhode Island,North Foster,0
17626,1977-1978,1977-11-26,1978-03-27,122,0,78,369,447,134,633,767,1214,27,228,Rhode Island,North Foster,0
17627,1978-1979,1978-11-21,1979-04-10,141,0,81,336,417,55,119,174,591,23,132,Rhode Island,North Foster,0
17628,1979-1980,1979-10-10,1980-03-25,168,0,50,324,374,36,36,72,446,15,87,Rhode Island,North Foster,0
17629,1980-1981,1980-11-17,1981-03-21,125,0,76,377,453,53,182,235,688,24,160,Rhode Island,North Foster,0
17630,1981-1982,1981-12-01,1982-04-10,131,1,67,351,418,111,364,475,893,34,226,Rhode Island,North Foster,0
17631,1982-1983,1982-12-01,1983-04-19,140,0,41,235,276,69,265,334,610,16,123,Rhode Island,North Foster,0
17632,1983-1984,1983-11-25,1984-04-03,131,2,57,320,377,85,188,273,650,27,176,Rhode Island,North Foster,0
17633,1984-1985,1984-11-20,1985-04-08,140,0,56,312,368,51,210,261,629,24,155,Rhode Island,North Foster,0
17634,1985-1986,1985-11-16,1986-04-11,147,0,48,323,371,49,84,133,504,31,153,Rhode Island,North Foster,0
17635,1986-1987,1986-11-11,1987-04-30,171,5,30,321,351,118,568,686,1037,31,193,Rhode Island,North Foster,0
17636,1987-1988,1987-11-10,1988-03-21,133,3,46,315,361,85,268,353,714,25,148,Rhode Island,North Foster,0
17637,1988-1989,1988-12-01,1989-04-10,131,1,41,299,340,29,29,58,398,22,110,Rhode Island,North Foster,0
17638,1989-1990,1989-11-20,1990-04-07,139,5,61,340,401,83,160,243,644,26,171,Rhode Island,North Foster,0
17639,1990-1991,1990-11-12,1991-03-30,139,0,27,254,281,57,76,133,414,19,102,Rhode Island,North Foster,0
17640,1991-1992,1991-11-11,1992-04-17,159,0,37,313,350,56,81,137,487,28,137,Rhode Island,North Foster,0
17641,1992-1993,1992-11-15,1993-04-27,164,0,48,336,384,115,384,499,883,37,231,Rhode Island,North Foster,0
17642,1993-1994,1993-11-24,1994-03-30,127,3,85,368,453,126,554,680,1133,43,316,Rhode Island,North Foster,0
17643,1994-1995,1994-11-23,1995-05-01,160,0,35,277,312,36,75,111,423,20,80,Rhode Island,North Foster,0
17644,1995-1996,1995-11-13,1996-04-12,152,1,63,379,442,176,489,665,1107,41,331,Rhode Island,North Foster,0
17645,1996-1997,1996-11-15,1997-04-06,143,1,29,258,287,110,144,254,541,29,177,Rhode Island,North Foster,0
17646,1997-1998,1997-11-14,1998-03-23,130,0,17,207,224,48,105,153,377,24,92,Rhode Island,North Foster,0
17647,1998-1999,1998-12-01,1999-03-17,107,0,25,227,252,74,85,159,411,23,147,Rhode Island,North Foster,0
17648,1999-2000,1999-11-29,2000-04-26,150,1,42,269,311,39,171,210,521,16,97,Rhode Island,North Foster,0
17649,2000-2001,2000-11-24,2001-04-18,146,0,46,314,360,119,603,722,1082,40,219,Rhode Island,North Foster,0
17650,2001-2002,2001-12-01,2002-04-25,146,0,7,197,204,55,75,130,334,23,97,Rhode Island,North Foster,0
17651,2002-2003,2002-11-27,2003-04-09,134,0,69,367,436,128,583,711,1147,39,249,Rhode Island,North Foster,0
17652,2003-2004,2003-10-23,2004-03-23,153,5,75,332,407,60,312,372,779,21,140,Rhode Island,North Foster,0
17653,2004-2005,2004-11-12,2005-03-27,136,0,55,310,365,143,435,578,943,41,292,Rhode Island,North Foster,0
17654,2005-2006,2005-10-29,2006-04-08,162,1,35,267,302,81,205,286,588,19,129,Rhode Island,North Foster,0
17655,2006-2007,2006-12-01,2007-03-25,115,0,47,260,307,45,77,122,429,21,96,Rhode Island,North Foster,0
17656,2007-2008,2007-11-20,2008-03-19,121,1,35,243,278,79,240,319,597,27,146,Rhode Island,North Foster,0
17657,2008-2009,2008-11-19,2009-03-09,111,0,60,299,359,90,313,403,762,24,172,Rhode Island,North Foster,0
17658,2009-2010,2009-10-15,2010-03-05,142,0,41,226,267,93,236,329,596,27,147,Rhode Island,North Foster,0
17659,2010-2011,2010-11-08,2011-04-01,145,1,56,323,379,113,535,648,1027,29,196,Rhode Island,North Foster,0
17660,2011-2012,2011-10-27,2012-03-31,157,0,15,188,203,37,50,87,290,13,66,Rhode Island,North Foster,0
17661,2012-2013,2012-11-07,2013-03-22,136,0,34,225,259,104,291,395,654,28,172,Rhode Island,North Foster,0
17662,2013-2014,2013-11-12,2014-04-16,156,0,71,371,442,98,361,459,901,32,238,Rhode Island,North Foster,0
17663,2014-2015,2014-11-14,2015-04-05,143,0,88,393,481,151,623,774,1255,38,320,Rhode Island,North Foster,0
17664,2015-2016,2015-12-01,2016-04-06,128,0,28,188,216,75,125,200,416,19,139,Rhode Island,North Foster,0
17665,2016-2017,2016-11-20,2017-03-31,132,0,34,233,267,91,207,298,565,22,155,Rhode Island,North Foster,0
17666,2017-2018,2017-12-01,2018-04-15,136,0,61,263,324,126,259,385,709,33,198,Rhode Island,North Foster,0
17667,2018-2019,2018-11-15,2019-03-23,129,0,42,269,311,68,135,203,514,23,124,Rhode Island,North Foster,0
17668,2019-2020,2019-11-13,2020-04-19,159,1,19,208,227,45,74,119,346,16,77,Rhode Island,North Foster,0
17669,1950-1951,1950-12-01,1951-03-22,112,0,23,160,183,32,30,62,245,13,66,Rhode Island,Providence,47037
17670,1951-1952,1951-11-20,1952-03-16,118,3,24,194,218,48,75,123,341,23,86,Rhode Island,Providence,47037
17671,1952-1953,1952-12-01,1953-04-14,135,0,8,154,162,39,33,72,234,15,57,Rhode Island,Providence,47037
17672,1953-1954,1953-12-01,1954-04-01,122,0,26,201,227,28,60,88,315,14,77,Rhode Island,Providence,47037
17673,1954-1955,1954-12-01,1955-03-26,116,0,30,210,240,32,41,73,313,16,79,Rhode Island,Providence,47037
17674,1955-1956,1955-11-19,1956-04-09,143,0,40,263,303,81,123,204,507,28,147,Rhode Island,Providence,47037
17675,1956-1957,1956-12-01,1957-04-05,126,0,31,228,259,54,95,149,408,22,104,Rhode Island,Providence,47037
17676,1957-1958,1957-11-26,1958-04-11,137,0,33,196,229,56,78,134,363,20,102,Rhode Island,Providence,47037
17677,1958-1959,1958-11-30,1959-03-29,120,3,48,300,348,43,61,104,452,22,108,Rhode Island,Providence,47037
17678,1959-1960,1959-11-18,1960-03-25,129,0,22,206,228,65,115,180,408,26,130,Rhode Island,Providence,47037
17679,1960-1961,1960-12-01,1961-04-13,134,0,53,295,348,92,298,390,738,23,163,Rhode Island,Providence,47037
17680,1961-1962,1961-11-20,1962-04-16,148,1,32,247,279,65,218,283,562,21,118,Rhode Island,Providence,47037
17681,1962-1963,1962-10-26,1963-03-22,148,0,46,278,324,49,52,101,425,25,112,Rhode Island,Providence,47037
17682,1963-1964,1963-12-01,1964-03-12,103,0,43,246,289,69,188,257,546,22,141,Rhode Island,Providence,47037
17683,1964-1965,1964-12-01,1965-03-30,120,0,46,254,300,70,161,231,531,27,145,Rhode Island,Providence,47037
17684,1965-1966,1965-12-01,1966-03-16,106,0,22,188,210,51,114,165,375,21,91,Rhode Island,Providence,47037
17685,1966-1967,1966-12-01,1967-04-08,129,0,36,247,283,82,133,215,498,30,165,Rhode Island,Providence,47037
17686,1967-1968,1967-11-15,1968-03-14,121,0,49,286,335,60,123,183,518,22,123,Rhode Island,Providence,47037
17687,1968-1969,1968-11-13,1969-03-30,138,0,37,240,277,52,156,208,485,17,76,Rhode Island,Providence,47037
17688,1969-1970,1969-12-01,1970-04-02,123,0,59,301,360,69,166,235,595,29,172,Rhode Island,Providence,47037
17689,1970-1971,1970-12-01,1971-04-07,128,0,57,267,324,63,115,178,502,29,136,Rhode Island,Providence,47037
17690,1971-1972,1971-12-01,1972-04-08,130,0,31,244,275,47,50,97,372,25,112,Rhode Island,Providence,47037
17691,1972-1973,1972-10-19,1973-04-08,172,0,30,217,247,20,9,29,276,16,50,Rhode Island,Providence,47037
17692,1973-1974,1973-12-01,1974-04-10,131,0,31,199,230,41,127,168,398,16,93,Rhode Island,Providence,47037
17693,1974-1975,1974-11-26,1975-04-05,131,0,17,195,212,41,59,100,312,17,87,Rhode Island,Providence,47037
17694,1975-1976,1975-11-24,1976-03-19,117,0,45,264,309,57,61,118,427,22,149,Rhode Island,Providence,47037
17695,1976-1977,1976-11-30,1977-05-10,162,1,66,314,380,72,152,224,604,24,135,Rhode Island,Providence,47037
17696,1977-1978,1977-11-28,1978-03-19,112,0,64,303,367,102,302,404,771,21,174,Rhode Island,Providence,47037
17697,1978-1979,1978-11-21,1979-04-10,141,0,69,287,356,28,33,61,417,17,79,Rhode Island,Providence,47037
17698,1979-1980,1979-12-01,1980-03-25,116,0,34,231,265,16,14,30,295,9,35,Rhode Island,Providence,47037
17699,1980-1981,1980-11-17,1981-03-16,120,0,50,297,347,35,76,111,458,21,117,Rhode Island,Providence,47037
17700,1981-1982,1981-12-01,1982-04-09,130,0,56,265,321,71,157,228,549,25,137,Rhode Island,Providence,47037
17701,1982-1983,1982-12-01,1983-02-28,90,0,23,137,160,44,112,156,316,9,68,Rhode Island,Providence,47037
17702,1983-1984,1983-12-01,1984-04-01,123,0,46,230,276,50,95,145,421,16,92,Rhode Island,Providence,47037
17703,1984-1985,1984-12-01,1985-03-18,108,1,43,208,251,35,76,111,362,15,89,Rhode Island,Providence,47037
17704,1985-1986,1985-11-26,1986-03-21,116,0,30,232,262,34,31,65,327,21,90,Rhode Island,Providence,47037
17705,1986-1987,1986-11-11,1987-04-29,170,0,19,231,250,63,161,224,474,24,105,Rhode Island,Providence,47037
17706,1987-1988,1987-11-11,1988-03-21,132,0,28,238,266,58,125,183,449,20,98,Rhode Island,Providence,47037
17707,1988-1989,1988-12-01,1989-04-10,131,0,26,216,242,21,18,39,281,15,66,Rhode Island,Providence,47037
17708,1989-1990,1989-11-23,1990-04-07,136,0,41,251,292,76,123,199,491,21,144,Rhode Island,Providence,47037
17709,1990-1991,1990-12-01,1991-03-16,106,0,14,165,179,35,35,70,249,14,62,Rhode Island,Providence,47037
17710,1991-1992,1991-12-01,1992-04-16,138,0,20,209,229,33,26,59,288,16,73,Rhode Island,Providence,47037
17711,1992-1993,1992-12-01,1993-04-27,148,0,28,235,263,60,65,125,388,30,131,Rhode Island,Providence,47037
17712,1993-1994,1993-12-01,1994-03-29,119,0,64,271,335,94,225,319,654,35,216,Rhode Island,Providence,47037
17713,1994-1995,1994-11-27,1995-04-08,133,0,16,176,192,22,29,51,243,12,39,Rhode Island,Providence,47037
17714,1997-1998,1997-11-23,1998-03-14,112,5,7,132,139,10,5,15,154,8,21,Rhode Island,Providence,47037
17715,2001-2002,2001-12-01,2002-03-19,109,0,2,132,134,16,11,27,161,9,28,Rhode Island,Providence,47037
17716,2002-2003,2002-11-27,2003-04-08,133,0,55,269,324,82,117,199,523,25,147,Rhode Island,Providence,47037
17717,2003-2004,2003-12-01,2004-03-20,111,0,46,212,258,56,62,118,376,17,95,Rhode Island,Providence,47037
17718,2004-2005,2004-11-12,2005-03-24,133,0,34,234,268,100,201,301,569,30,186,Rhode Island,Providence,47037
17719,2005-2006,2005-11-24,2006-04-08,136,0,15,179,194,47,45,92,286,15,71,Rhode Island,Providence,47037
17720,2006-2007,2006-12-01,2007-03-24,114,0,27,185,212,23,9,32,244,13,42,Rhode Island,Providence,47037
17721,2007-2008,2007-12-01,2008-03-01,92,0,13,150,163,39,58,97,260,14,70,Rhode Island,Providence,47037
17722,2008-2009,2008-11-22,2009-03-07,106,0,42,223,265,74,130,204,469,20,138,Rhode Island,Providence,47037
17723,2009-2010,2009-12-01,2010-03-03,93,0,22,164,186,46,54,100,286,17,76,Rhode Island,Providence,47037
17724,2010-2011,2010-11-08,2011-03-31,144,0,31,244,275,76,179,255,530,23,128,Rhode Island,Providence,47037
17725,2011-2012,2011-10-29,2012-03-01,125,0,10,133,143,27,21,48,191,10,47,Rhode Island,Providence,47037
17726,2012-2013,2012-11-07,2013-03-19,133,0,19,169,188,69,80,149,337,25,125,Rhode Island,Providence,47037
17727,2013-2014,2013-11-12,2014-04-16,156,0,49,295,344,64,107,171,515,27,162,Rhode Island,Providence,47037
17728,2014-2015,2014-11-14,2015-03-29,136,0,55,317,372,114,354,468,840,38,261,Rhode Island,Providence,47037
17729,2015-2016,2015-12-01,2016-04-04,126,0,18,146,164,39,51,90,254,12,69,Rhode Island,Providence,47037
17730,2016-2017,2016-12-01,2017-03-16,106,0,22,160,182,59,75,134,316,14,99,Rhode Island,Providence,47037
17731,2017-2018,2017-12-01,2018-04-06,127,0,41,195,236,72,65,137,373,24,114,Rhode Island,Providence,47037
17732,2018-2019,2018-11-15,2019-03-23,129,0,27,210,237,40,46,86,323,14,72,Rhode Island,Providence,47037
17733,2019-2020,2019-11-13,2020-04-18,158,2,8,144,152,22,7,29,181,14,41,Rhode Island,Providence,47037
17734,1950-1951,1950-12-01,1951-02-28,90,0,0,40,40,0,0,0,40,0,0,South Carolina,Charleston,51400
17735,1951-1952,1951-12-01,1952-02-29,91,0,0,17,17,0,0,0,17,0,0,South Carolina,Charleston,51400
17736,1952-1953,1952-12-01,1953-02-28,90,0,0,20,20,0,0,0,20,0,0,South Carolina,Charleston,51400
17737,1953-1954,1953-12-01,1954-02-28,90,0,0,26,26,0,0,0,26,0,0,South Carolina,Charleston,51400
17738,1954-1955,1954-12-01,1955-02-28,90,0,0,37,37,0,0,0,37,0,0,South Carolina,Charleston,51400
17739,1955-1956,1955-12-01,1956-02-29,91,0,0,34,34,0,0,0,34,0,0,South Carolina,Charleston,51400
17740,1956-1957,1956-12-01,1957-02-28,90,0,0,23,23,0,0,0,23,0,0,South Carolina,Charleston,51400
17741,1957-1958,1957-12-01,1958-02-28,90,0,1,61,62,0,0,0,62,0,0,South Carolina,Charleston,51400
17742,1958-1959,1958-12-01,1959-02-28,90,0,0,45,45,1,0,1,46,1,2,South Carolina,Charleston,51400
17743,1959-1960,1959-12-01,1960-03-11,102,0,0,40,40,1,0,1,41,1,2,South Carolina,Charleston,51400
17744,1960-1961,1960-12-01,1961-02-28,90,0,0,63,63,0,0,0,63,0,0,South Carolina,Charleston,51400
17745,1961-1962,1961-12-01,1962-02-28,90,0,1,37,38,0,0,0,38,0,0,South Carolina,Charleston,51400
17746,1962-1963,1962-12-01,1963-02-28,90,0,1,57,58,2,0,2,60,2,4,South Carolina,Charleston,51400
17747,1963-1964,1963-12-01,1964-02-29,91,0,0,45,45,0,0,0,45,0,0,South Carolina,Charleston,51400
17748,1964-1965,1964-12-01,1965-02-28,90,0,0,35,35,0,0,0,35,0,0,South Carolina,Charleston,51400
17749,1965-1966,1965-12-01,1966-02-28,90,0,0,49,49,1,1,2,51,1,2,South Carolina,Charleston,51400
17750,1966-1967,1966-12-01,1967-02-28,90,0,0,37,37,0,0,0,37,0,0,South Carolina,Charleston,51400
17751,1967-1968,1967-12-01,1968-02-29,91,0,0,58,58,3,1,4,62,2,5,South Carolina,Charleston,51400
17752,1968-1969,1968-12-01,1969-03-04,94,0,0,58,58,3,0,3,61,1,4,South Carolina,Charleston,51400
17753,1969-1970,1969-12-01,1970-02-28,90,0,3,66,69,0,0,0,69,0,0,South Carolina,Charleston,51400
17754,1970-1971,1970-12-01,1971-02-28,90,0,0,33,33,0,0,0,33,0,0,South Carolina,Charleston,51400
17755,1971-1972,1971-12-01,1972-02-29,91,0,0,19,19,0,0,0,19,0,0,South Carolina,Charleston,51400
17756,1972-1973,1972-12-01,1973-02-28,90,0,1,38,39,9,17,26,65,2,12,South Carolina,Charleston,51400
17757,1973-1974,1973-12-01,1974-02-28,90,0,0,20,20,0,0,0,20,0,0,South Carolina,Charleston,51400
17758,1974-1975,1974-12-01,1975-02-28,90,0,0,14,14,0,0,0,14,0,0,South Carolina,Charleston,51400
17759,1975-1976,1975-12-01,1976-02-29,91,0,0,49,49,1,0,1,50,1,2,South Carolina,Charleston,51400
17760,1976-1977,1976-12-01,1977-02-28,90,0,1,68,69,3,0,3,72,3,9,South Carolina,Charleston,51400
17761,1977-1978,1977-12-01,1978-02-28,90,0,0,63,63,1,0,1,64,1,2,South Carolina,Charleston,51400
17762,1978-1979,1978-12-01,1979-02-28,90,0,1,47,48,4,2,6,54,3,8,South Carolina,Charleston,51400
17763,1979-1980,1979-12-01,1980-03-03,94,0,1,49,50,2,1,3,53,1,5,South Carolina,Charleston,51400
17764,1980-1981,1980-12-01,1981-02-28,90,0,1,57,58,5,4,9,67,2,8,South Carolina,Charleston,51400
17765,1981-1982,1981-12-01,1982-02-28,90,0,1,51,52,0,0,0,52,0,0,South Carolina,Charleston,51400
17766,1982-1983,1982-12-01,1983-02-28,90,0,0,17,17,0,0,0,17,0,0,South Carolina,Charleston,51400
17767,1983-1984,1983-12-01,1984-02-29,91,0,1,34,35,0,0,0,35,0,0,South Carolina,Charleston,51400
17768,1984-1985,1984-12-01,1985-02-28,90,0,1,43,44,0,0,0,44,0,0,South Carolina,Charleston,51400
17769,1985-1986,1985-12-01,1986-02-28,90,0,0,35,35,1,0,1,36,1,4,South Carolina,Charleston,51400
17770,1986-1987,1986-12-01,1987-02-28,90,0,0,13,13,0,0,0,13,0,0,South Carolina,Charleston,51400
17771,1987-1988,1987-12-01,1988-02-29,91,0,0,35,35,1,0,1,36,1,2,South Carolina,Charleston,51400
17772,1988-1989,1988-12-01,1989-02-28,90,0,0,19,19,2,1,3,22,2,4,South Carolina,Charleston,51400
17773,1989-1990,1989-12-01,1990-02-28,90,0,2,27,29,12,13,25,54,3,23,South Carolina,Charleston,51400
17774,1990-1991,1990-12-01,1991-02-28,90,0,0,11,11,0,0,0,11,0,0,South Carolina,Charleston,51400
17775,1991-1992,1991-12-01,1992-02-29,91,0,0,10,10,0,0,0,10,0,0,South Carolina,Charleston,51400
17776,1992-1993,1992-12-01,1993-02-28,90,0,0,4,4,0,0,0,4,0,0,South Carolina,Charleston,51400
17777,1993-1994,1993-12-01,1994-02-28,90,0,1,33,34,0,0,0,34,0,0,South Carolina,Charleston,51400
17778,1994-1995,1994-12-01,1995-02-28,90,0,0,16,16,0,0,0,16,0,0,South Carolina,Charleston,51400
17779,1995-1996,1995-12-01,1996-02-29,91,0,0,50,50,0,0,0,50,0,0,South Carolina,Charleston,51400
17780,1996-1997,1996-12-01,1997-02-28,90,0,0,19,19,0,0,0,19,0,0,South Carolina,Charleston,51400
17781,1997-1998,1997-12-01,1998-02-28,90,0,0,9,9,0,0,0,9,0,0,South Carolina,Charleston,51400
17782,1998-1999,1998-12-01,1999-02-28,90,0,0,22,22,0,0,0,22,0,0,South Carolina,Charleston,51400
17783,1999-2000,1999-12-01,2000-02-29,91,0,0,29,29,4,3,7,36,2,5,South Carolina,Charleston,51400
17784,2000-2001,2000-12-01,2001-02-28,90,0,0,49,49,0,0,0,49,0,0,South Carolina,Charleston,51400
17785,2001-2002,2001-12-01,2002-02-28,90,0,0,21,21,0,0,0,21,0,0,South Carolina,Charleston,51400
17786,2002-2003,2002-12-01,2003-02-28,90,0,0,31,31,0,0,0,31,0,0,South Carolina,Charleston,51400
17787,2003-2004,2003-12-01,2004-02-29,91,0,0,36,36,0,0,0,36,0,0,South Carolina,Charleston,51400
17788,2004-2005,2004-12-01,2005-02-28,90,0,0,32,32,0,0,0,32,0,0,South Carolina,Charleston,51400
17789,2005-2006,2005-12-01,2006-02-28,90,0,0,24,24,0,0,0,24,0,0,South Carolina,Charleston,51400
17790,2006-2007,2006-12-01,2007-02-28,90,0,0,20,20,0,0,0,20,0,0,South Carolina,Charleston,51400
17791,2007-2008,2007-12-01,2008-02-29,91,0,0,17,17,0,0,0,17,0,0,South Carolina,Charleston,51400
17792,2008-2009,2008-12-01,2009-02-28,90,0,0,29,29,0,0,0,29,0,0,South Carolina,Charleston,51400
17793,2009-2010,2009-12-01,2010-02-28,90,0,0,38,38,5,3,8,46,2,7,South Carolina,Charleston,51400
17794,2010-2011,2010-12-01,2011-02-28,90,0,0,48,48,1,0,1,49,1,2,South Carolina,Charleston,51400
17795,2011-2012,2011-12-01,2012-02-29,91,0,0,16,16,0,0,0,16,0,0,South Carolina,Charleston,51400
17796,2012-2013,2012-12-01,2013-02-28,90,0,0,12,12,0,0,0,12,0,0,South Carolina,Charleston,51400
17797,2013-2014,2013-12-01,2014-02-28,90,0,1,26,27,0,0,0,27,0,0,South Carolina,Charleston,51400
17798,2014-2015,2014-12-01,2015-02-28,90,0,0,28,28,0,0,0,28,0,0,South Carolina,Charleston,51400
17799,2015-2016,2015-12-01,2016-02-29,91,0,0,20,20,0,0,0,20,0,0,South Carolina,Charleston,51400
17800,2016-2017,2016-12-01,2017-02-28,90,0,0,9,9,0,0,0,9,0,0,South Carolina,Charleston,51400
17801,2017-2018,2017-12-01,2018-02-28,90,0,1,34,35,7,12,19,54,1,10,South Carolina,Charleston,51400
17802,2018-2019,2018-12-01,2019-02-28,90,0,0,12,12,0,0,0,12,0,0,South Carolina,Charleston,51400
17803,2019-2020,2019-12-01,2020-02-29,91,0,0,10,10,0,0,0,10,0,0,South Carolina,Charleston,51400
17804,1950-1951,1950-11-25,1951-02-28,96,0,2,82,84,0,0,0,84,0,0,South Carolina,Columbia,129272
17805,1951-1952,1951-12-01,1952-02-29,91,0,0,37,37,0,0,0,37,0,0,South Carolina,Columbia,129272
17806,1952-1953,1952-12-01,1953-02-28,90,0,0,40,40,0,0,0,40,0,0,South Carolina,Columbia,129272
17807,1953-1954,1953-12-01,1954-02-28,90,0,0,52,52,0,0,0,52,0,0,South Carolina,Columbia,129272
17808,1954-1955,1954-12-01,1955-02-28,90,0,0,67,67,2,0,2,69,1,3,South Carolina,Columbia,129272
17809,1955-1956,1955-12-01,1956-02-29,91,0,0,65,65,0,0,0,65,0,0,South Carolina,Columbia,129272
17810,1956-1957,1956-12-01,1957-02-28,90,0,0,34,34,0,0,0,34,0,0,South Carolina,Columbia,129272
17811,1957-1958,1957-12-01,1958-02-28,90,0,2,87,89,2,1,3,92,1,3,South Carolina,Columbia,129272
17812,1958-1959,1958-12-01,1959-03-02,92,0,0,82,82,15,15,30,112,3,19,South Carolina,Columbia,129272
17813,1959-1960,1959-12-01,1960-03-12,103,0,0,66,66,4,2,6,72,2,6,South Carolina,Columbia,129272
17814,1960-1961,1960-12-01,1961-02-28,90,0,2,90,92,3,2,5,97,2,8,South Carolina,Columbia,129272
17815,1961-1962,1961-12-01,1962-02-28,90,0,2,45,47,0,0,0,47,0,0,South Carolina,Columbia,129272
17816,1962-1963,1962-12-01,1963-02-28,90,0,2,87,89,0,0,0,89,0,0,South Carolina,Columbia,129272
17817,1963-1964,1963-12-01,1964-02-29,91,0,0,78,78,0,0,0,78,0,0,South Carolina,Columbia,129272
17818,1964-1965,1964-12-01,1965-02-28,90,0,0,56,56,3,1,4,60,2,5,South Carolina,Columbia,129272
17819,1965-1966,1965-12-01,1966-02-28,90,0,2,65,67,2,1,3,70,2,5,South Carolina,Columbia,129272
17820,1966-1967,1966-12-01,1967-02-28,90,0,1,66,67,4,3,7,74,1,5,South Carolina,Columbia,129272
17821,1967-1968,1967-12-01,1968-02-29,91,0,1,90,91,5,2,7,98,4,9,South Carolina,Columbia,129272
17822,1968-1969,1968-12-01,1969-02-28,90,0,1,89,90,2,1,3,93,2,4,South Carolina,Columbia,129272
17823,1969-1970,1969-12-01,1970-02-28,90,0,2,104,106,2,1,3,109,1,5,South Carolina,Columbia,129272
17824,1970-1971,1970-12-01,1971-03-25,115,0,0,73,73,2,0,2,75,1,2,South Carolina,Columbia,129272
17825,1971-1972,1971-12-01,1972-02-29,91,0,1,39,40,1,0,1,41,1,1,South Carolina,Columbia,129272
17826,1972-1973,1972-12-01,1973-02-28,90,0,0,69,69,25,34,59,128,4,29,South Carolina,Columbia,129272
17827,1973-1974,1973-12-01,1974-02-28,90,0,0,31,31,0,0,0,31,0,0,South Carolina,Columbia,129272
17828,1974-1975,1974-12-01,1975-02-28,90,0,0,32,32,0,0,0,32,0,0,South Carolina,Columbia,129272
17829,1975-1976,1975-12-01,1976-02-29,91,0,0,63,63,0,0,0,63,0,0,South Carolina,Columbia,129272
17830,1976-1977,1976-12-01,1977-02-28,90,0,2,103,105,0,0,0,105,0,0,South Carolina,Columbia,129272
17831,1977-1978,1977-12-01,1978-02-28,90,0,0,117,117,1,0,1,118,1,2,South Carolina,Columbia,129272
17832,1978-1979,1978-12-01,1979-02-28,90,0,1,79,80,7,11,18,98,1,11,South Carolina,Columbia,129272
17833,1979-1980,1979-12-01,1980-03-04,95,0,1,92,93,10,7,17,110,2,15,South Carolina,Columbia,129272
17834,1980-1981,1980-12-01,1981-02-28,90,0,0,101,101,1,0,1,102,1,2,South Carolina,Columbia,129272
17835,1981-1982,1981-12-01,1982-02-28,90,0,3,74,77,6,2,8,85,3,10,South Carolina,Columbia,129272
17836,1982-1983,1982-12-01,1983-03-24,114,0,1,60,61,2,0,2,63,2,3,South Carolina,Columbia,129272
17837,1983-1984,1983-12-01,1984-02-29,91,0,2,78,80,0,0,0,80,0,0,South Carolina,Columbia,129272
17838,1984-1985,1984-12-01,1985-02-28,90,0,1,84,85,0,0,0,85,0,0,South Carolina,Columbia,129272
17839,1985-1986,1985-12-01,1986-02-28,90,0,1,94,95,0,0,0,95,0,0,South Carolina,Columbia,129272
17840,1986-1987,1986-12-01,1987-03-12,102,0,0,52,52,3,0,3,55,3,6,South Carolina,Columbia,129272
17841,1987-1988,1987-12-01,1988-02-29,91,0,2,81,83,6,12,18,101,1,9,South Carolina,Columbia,129272
17842,1988-1989,1988-12-01,1989-02-28,90,0,0,49,49,5,4,9,58,2,7,South Carolina,Columbia,129272
17843,1989-1990,1989-12-01,1990-02-28,90,0,2,46,48,0,0,0,48,0,0,South Carolina,Columbia,129272
17844,1990-1991,1990-12-01,1991-02-28,90,0,0,34,34,1,0,1,35,1,1,South Carolina,Columbia,129272
17845,1991-1992,1991-12-01,1992-02-29,91,0,0,47,47,2,1,3,50,2,3,South Carolina,Columbia,129272
17846,1992-1993,1992-12-01,1993-03-13,103,0,0,37,37,2,0,2,39,1,3,South Carolina,Columbia,129272
17847,1993-1994,1993-12-01,1994-02-28,90,0,2,67,69,3,1,4,73,1,4,South Carolina,Columbia,129272
17848,1994-1995,1994-12-01,1995-02-28,90,0,0,45,45,0,0,0,45,0,0,South Carolina,Columbia,129272
17849,1995-1996,1995-12-01,1996-02-29,91,1,1,76,77,2,0,2,79,2,5,South Carolina,Columbia,129272
17850,1996-1997,1996-12-01,1997-02-28,90,0,0,49,49,0,0,0,49,0,0,South Carolina,Columbia,129272
17851,1997-1998,1997-12-01,1998-02-28,90,0,0,33,33,0,0,0,33,0,0,South Carolina,Columbia,129272
17852,1998-1999,1998-12-01,1999-02-28,90,0,0,35,35,1,1,2,37,1,2,South Carolina,Columbia,129272
17853,1999-2000,1999-12-01,2000-02-29,91,0,0,57,57,6,10,16,73,1,6,South Carolina,Columbia,129272
17854,2000-2001,2000-12-01,2001-02-28,90,0,0,75,75,0,0,0,75,0,0,South Carolina,Columbia,129272
17855,2001-2002,2001-12-01,2002-02-28,90,0,0,45,45,7,9,16,61,2,9,South Carolina,Columbia,129272
17856,2002-2003,2002-12-01,2003-02-28,90,0,0,52,52,4,2,6,58,1,7,South Carolina,Columbia,129272
17857,2003-2004,2003-12-01,2004-02-29,91,0,1,67,68,1,0,1,69,1,1,South Carolina,Columbia,129272
17858,2004-2005,2004-12-01,2005-02-28,90,0,0,50,50,0,0,0,50,0,0,South Carolina,Columbia,129272
17859,2005-2006,2005-12-01,2006-02-28,90,0,0,45,45,0,0,0,45,0,0,South Carolina,Columbia,129272
17860,2006-2007,2006-12-01,2007-02-28,90,0,0,48,48,1,0,1,49,1,2,South Carolina,Columbia,129272
17861,2007-2008,2007-12-01,2008-02-29,91,0,0,35,35,1,0,1,36,1,3,South Carolina,Columbia,129272
17862,2008-2009,2008-12-01,2009-02-28,90,0,0,56,56,0,0,0,56,0,0,South Carolina,Columbia,129272
17863,2009-2010,2009-12-01,2010-03-02,92,0,0,75,75,13,5,18,93,2,15,South Carolina,Columbia,129272
17864,2010-2011,2010-12-01,2011-02-28,90,0,0,69,69,6,5,11,80,2,8,South Carolina,Columbia,129272
17865,2011-2012,2011-12-01,2012-02-29,91,0,0,31,31,0,0,0,31,0,0,South Carolina,Columbia,129272
17866,2012-2013,2012-12-01,2013-02-28,90,0,0,25,25,0,0,0,25,0,0,South Carolina,Columbia,129272
17867,2013-2014,2013-12-01,2014-02-28,90,0,2,59,61,6,7,13,74,3,11,South Carolina,Columbia,129272
17868,2014-2015,2014-12-01,2015-02-28,90,0,0,47,47,0,0,0,47,0,0,South Carolina,Columbia,129272
17869,2015-2016,2015-12-01,2016-02-29,91,0,0,33,33,0,0,0,33,0,0,South Carolina,Columbia,129272
17870,2016-2017,2016-12-01,2017-02-28,90,0,0,21,21,1,0,1,22,1,2,South Carolina,Columbia,129272
17871,2017-2018,2017-12-01,2018-02-28,90,0,0,53,53,0,0,0,53,0,0,South Carolina,Columbia,129272
17872,2018-2019,2018-12-01,2019-02-28,90,0,0,29,29,0,0,0,29,0,0,South Carolina,Columbia,129272
17873,2019-2020,2019-12-01,2020-02-29,91,0,0,22,22,0,0,0,22,0,0,South Carolina,Columbia,129272
17874,1950-1951,1950-11-25,1951-02-28,96,0,4,81,85,3,0,3,88,3,9,South Carolina,Greenville,58409
17875,1951-1952,1951-12-01,1952-02-29,91,0,1,40,41,4,3,7,48,1,5,South Carolina,Greenville,58409
17876,1952-1953,1952-12-01,1953-02-28,90,0,0,30,30,1,0,1,31,1,2,South Carolina,Greenville,58409
17877,1953-1954,1953-12-01,1954-02-28,90,0,0,40,40,0,0,0,40,0,0,South Carolina,Greenville,58409
17878,1954-1955,1954-12-01,1955-02-28,90,0,0,56,56,2,1,3,59,2,4,South Carolina,Greenville,58409
17879,1955-1956,1955-12-01,1956-02-29,91,0,0,49,49,1,0,1,50,1,2,South Carolina,Greenville,58409
17880,1956-1957,1956-12-01,1957-02-28,90,0,0,29,29,0,0,0,29,0,0,South Carolina,Greenville,58409
17881,1957-1958,1957-12-01,1958-02-28,90,0,4,101,105,11,19,30,135,2,13,South Carolina,Greenville,58409
17882,1958-1959,1958-12-01,1959-03-02,92,0,1,63,64,6,4,10,74,4,12,South Carolina,Greenville,58409
17883,1959-1960,1959-12-01,1960-03-13,104,0,4,74,78,27,36,63,141,8,40,South Carolina,Greenville,58409
17884,1960-1961,1960-12-01,1961-02-28,90,0,3,82,85,5,4,9,94,3,14,South Carolina,Greenville,58409
17885,1961-1962,1961-12-01,1962-03-09,99,0,3,48,51,16,13,29,80,6,22,South Carolina,Greenville,58409
17886,1962-1963,1962-12-01,1963-02-28,90,0,3,109,112,7,2,9,121,4,10,South Carolina,Greenville,58409
17887,1963-1964,1963-12-01,1964-02-29,91,0,2,89,91,7,6,13,104,5,14,South Carolina,Greenville,58409
17888,1964-1965,1964-12-01,1965-03-12,102,0,1,77,78,15,10,25,103,6,23,South Carolina,Greenville,58409
17889,1965-1966,1965-12-01,1966-02-28,90,0,2,95,97,16,16,32,129,6,24,South Carolina,Greenville,58409
17890,1966-1967,1966-12-01,1967-02-28,90,0,1,67,68,3,1,4,72,2,5,South Carolina,Greenville,58409
17891,1967-1968,1967-12-01,1968-02-29,91,0,4,90,94,6,4,10,104,5,13,South Carolina,Greenville,58409
17892,1968-1969,1968-11-11,1969-03-01,111,0,1,106,107,14,14,28,135,6,18,South Carolina,Greenville,58409
17893,1969-1970,1969-12-01,1970-02-28,90,0,6,114,120,4,0,4,124,3,10,South Carolina,Greenville,58409
17894,1970-1971,1970-12-01,1971-03-27,117,0,4,115,119,15,12,27,146,4,21,South Carolina,Greenville,58409
17895,1971-1972,1971-12-01,1972-03-25,116,0,2,66,68,21,12,33,101,4,25,South Carolina,Greenville,58409
17896,1972-1973,1972-12-01,1973-02-28,90,0,2,71,73,5,13,18,91,2,10,South Carolina,Greenville,58409
17897,1973-1974,1973-12-01,1974-03-25,115,0,0,61,61,1,0,1,62,1,2,South Carolina,Greenville,58409
17898,1974-1975,1974-12-01,1975-02-28,90,0,0,47,47,2,0,2,49,1,2,South Carolina,Greenville,58409
17899,1975-1976,1975-12-01,1976-02-29,91,0,1,80,81,0,0,0,81,0,0,South Carolina,Greenville,58409
17900,1976-1977,1976-11-14,1977-02-28,107,0,5,151,156,10,6,16,172,4,14,South Carolina,Greenville,58409
17901,1977-1978,1977-12-01,1978-03-04,94,0,2,106,108,5,4,9,117,3,8,South Carolina,Greenville,58409
17902,1978-1979,1978-12-01,1979-02-28,90,0,2,89,91,20,20,40,131,4,26,South Carolina,Greenville,58409
17903,1979-1980,1979-12-01,1980-03-12,103,0,3,82,85,18,12,30,115,7,30,South Carolina,Greenville,58409
17904,1980-1981,1980-12-01,1981-02-28,90,0,1,107,108,2,0,2,110,1,3,South Carolina,Greenville,58409
17905,1981-1982,1981-12-01,1982-02-28,90,0,5,86,91,16,23,39,130,4,28,South Carolina,Greenville,58409
17906,1982-1983,1982-12-01,1983-04-18,139,0,1,62,63,23,15,38,101,6,30,South Carolina,Greenville,58409
17907,1983-1984,1983-12-01,1984-02-29,91,0,4,87,91,2,0,2,93,2,5,South Carolina,Greenville,58409
17908,1984-1985,1984-12-01,1985-02-28,90,0,1,84,85,4,0,4,89,4,7,South Carolina,Greenville,58409
17909,1985-1986,1985-12-01,1986-02-28,90,0,3,99,102,2,1,3,105,1,4,South Carolina,Greenville,58409
17910,1986-1987,1986-12-01,1987-04-03,124,0,2,68,70,18,18,36,106,5,22,South Carolina,Greenville,58409
17911,1987-1988,1987-11-11,1988-02-29,111,0,1,105,106,19,45,64,170,2,23,South Carolina,Greenville,58409
17912,1988-1989,1988-12-01,1989-02-28,90,0,0,62,62,3,0,3,65,1,4,South Carolina,Greenville,58409
17913,1989-1990,1989-12-01,1990-02-28,90,0,4,69,73,2,0,2,75,2,4,South Carolina,Greenville,58409
17914,1990-1991,1990-12-01,1991-02-28,90,0,0,53,53,4,0,4,57,1,5,South Carolina,Greenville,58409
17915,1991-1992,1991-12-01,1992-02-29,91,0,0,53,53,0,0,0,53,0,0,South Carolina,Greenville,58409
17916,1992-1993,1992-12-01,1993-03-15,105,0,0,69,69,15,5,20,89,3,18,South Carolina,Greenville,58409
17917,1993-1994,1993-12-01,1994-02-28,90,0,4,92,96,4,0,4,100,3,9,South Carolina,Greenville,58409
17918,1994-1995,1994-12-01,1995-02-28,90,0,1,67,68,1,0,1,69,1,2,South Carolina,Greenville,58409
17919,1995-1996,1995-12-01,1996-02-29,91,0,5,87,92,15,12,27,119,7,31,South Carolina,Greenville,58409
17920,1996-1997,1996-12-01,1997-02-28,90,0,0,56,56,5,3,8,64,3,8,South Carolina,Greenville,58409
17921,1997-1998,1997-12-01,1998-02-28,90,0,0,39,39,5,1,6,45,2,7,South Carolina,Greenville,58409
17922,1998-1999,1998-12-01,1999-03-09,99,0,1,49,50,4,2,6,56,3,7,South Carolina,Greenville,58409
17923,1999-2000,1999-12-01,2000-02-29,91,0,1,48,49,7,3,10,59,4,10,South Carolina,Greenville,58409
17924,2000-2001,2000-11-19,2001-03-20,122,0,0,89,89,9,2,11,100,5,14,South Carolina,Greenville,58409
17925,2001-2002,2001-12-01,2002-02-28,90,0,1,52,53,5,6,11,64,2,8,South Carolina,Greenville,58409
17926,2002-2003,2002-12-01,2003-02-28,90,0,0,60,60,7,6,13,73,3,13,South Carolina,Greenville,58409
17927,2003-2004,2003-12-01,2004-02-29,91,0,1,73,74,15,7,22,96,3,19,South Carolina,Greenville,58409
17928,2004-2005,2004-12-01,2005-03-17,107,0,2,64,66,3,1,4,70,2,6,South Carolina,Greenville,58409
17929,2005-2006,2005-12-01,2006-02-28,90,0,0,47,47,0,0,0,47,0,0,South Carolina,Greenville,58409
17930,2006-2007,2006-12-01,2007-02-28,90,0,0,56,56,2,1,3,59,1,3,South Carolina,Greenville,58409
17931,2007-2008,2007-12-01,2008-02-29,91,0,0,46,46,5,2,7,53,2,8,South Carolina,Greenville,58409
17932,2008-2009,2008-12-01,2009-03-03,93,0,1,70,71,7,5,12,83,2,9,South Carolina,Greenville,58409
17933,2009-2010,2009-12-01,2010-03-02,92,0,1,90,91,9,8,17,108,4,13,South Carolina,Greenville,58409
17934,2010-2011,2010-12-01,2011-02-28,90,0,2,87,89,12,23,35,124,3,17,South Carolina,Greenville,58409
17935,2011-2012,2011-12-01,2012-02-29,91,0,0,38,38,0,0,0,38,0,0,South Carolina,Greenville,58409
17936,2012-2013,2012-12-01,2013-02-28,90,0,1,35,36,3,1,4,40,1,4,South Carolina,Greenville,58409
17937,2013-2014,2013-11-27,2014-02-28,94,0,3,88,91,11,9,20,111,5,18,South Carolina,Greenville,58409
17938,2014-2015,2014-12-01,2015-02-28,90,0,2,67,69,7,4,11,80,4,10,South Carolina,Greenville,58409
17939,2015-2016,2015-12-01,2016-02-29,91,0,2,48,50,5,6,11,61,3,8,South Carolina,Greenville,58409
17940,2016-2017,2016-12-01,2017-03-12,102,0,2,37,39,5,12,17,56,3,10,South Carolina,Greenville,58409
17941,2017-2018,2017-12-01,2018-02-28,90,0,2,78,80,6,5,11,91,2,9,South Carolina,Greenville,58409
17942,2018-2019,2018-12-01,2019-02-28,90,0,0,38,38,5,6,11,49,2,6,South Carolina,Greenville,58409
17943,2019-2020,2019-12-01,2020-02-29,91,0,0,41,41,2,0,2,43,2,5,South Carolina,Greenville,58409
17944,1950-1951,1950-10-02,1951-04-21,202,0,300,880,1180,73,382,455,1635,32,357,South Dakota,Aberdeen,26091
17945,1951-1952,1951-10-30,1952-04-06,160,2,308,844,1152,93,806,899,2051,39,412,South Dakota,Aberdeen,26091
17946,1952-1953,1952-11-24,1953-04-16,144,0,162,566,728,52,233,285,1013,25,235,South Dakota,Aberdeen,26091
17947,1953-1954,1953-11-20,1954-05-03,165,0,181,600,781,64,292,356,1137,30,282,South Dakota,Aberdeen,26091
17948,1954-1955,1954-11-01,1955-03-26,146,0,189,651,840,44,258,302,1142,23,234,South Dakota,Aberdeen,26091
17949,1955-1956,1955-11-02,1956-04-06,157,1,324,929,1253,69,545,614,1867,30,308,South Dakota,Aberdeen,26091
17950,1956-1957,1956-11-09,1957-04-11,154,0,205,678,883,47,119,166,1049,26,290,South Dakota,Aberdeen,26091
17951,1957-1958,1957-10-24,1958-04-06,165,1,144,582,726,37,78,115,841,22,146,South Dakota,Aberdeen,26091
17952,1958-1959,1958-11-23,1959-03-16,114,0,251,700,951,33,172,205,1156,25,273,South Dakota,Aberdeen,26091
17953,1959-1960,1959-10-12,1960-04-05,177,1,258,737,995,77,472,549,1544,39,317,South Dakota,Aberdeen,26091
17954,1960-1961,1960-11-09,1961-04-11,154,0,192,662,854,31,374,405,1259,15,131,South Dakota,Aberdeen,26091
17955,1961-1962,1961-11-04,1962-03-31,148,3,278,767,1045,52,345,397,1442,29,289,South Dakota,Aberdeen,26091
17956,1962-1963,1962-11-16,1963-04-22,158,1,213,677,890,28,103,131,1021,17,141,South Dakota,Aberdeen,26091
17957,1963-1964,1963-11-21,1964-03-31,132,0,186,669,855,31,165,196,1051,15,134,South Dakota,Aberdeen,26091
17958,1964-1965,1964-11-18,1965-04-24,158,0,335,938,1273,70,161,231,1504,41,395,South Dakota,Aberdeen,26091
17959,1965-1966,1965-09-23,1966-05-11,231,0,252,796,1048,69,184,253,1301,35,332,South Dakota,Aberdeen,26091
17960,1966-1967,1966-11-01,1967-05-11,192,0,167,728,895,55,130,185,1080,45,371,South Dakota,Aberdeen,26091
17961,1967-1968,1967-10-26,1968-04-23,181,0,210,690,900,60,116,176,1076,31,242,South Dakota,Aberdeen,26091
17962,1968-1969,1968-10-18,1969-04-07,172,0,282,765,1047,99,671,770,1817,54,474,South Dakota,Aberdeen,26091
17963,1969-1970,1969-10-12,1970-05-01,202,1,236,790,1026,94,353,447,1473,46,324,South Dakota,Aberdeen,26091
17964,1970-1971,1970-10-07,1971-04-27,203,0,231,754,985,72,235,307,1292,45,372,South Dakota,Aberdeen,26091
17965,1971-1972,1971-10-28,1972-04-07,163,0,273,757,1030,76,547,623,1653,53,475,South Dakota,Aberdeen,26091
17966,1972-1973,1972-10-30,1973-04-24,177,0,170,557,727,53,169,222,949,30,268,South Dakota,Aberdeen,26091
17967,1973-1974,1973-11-03,1974-03-26,144,0,256,675,931,56,275,331,1262,38,348,South Dakota,Aberdeen,26091
17968,1974-1975,1974-11-13,1975-04-10,149,0,151,629,780,86,203,289,1069,43,326,South Dakota,Aberdeen,26091
17969,1975-1976,1975-10-24,1976-05-02,192,0,177,602,779,59,203,262,1041,33,256,South Dakota,Aberdeen,26091
17970,1976-1977,1976-10-18,1977-04-04,169,1,239,742,981,58,165,223,1204,29,269,South Dakota,Aberdeen,26091
17971,1977-1978,1977-10-07,1978-04-02,178,8,404,838,1242,78,603,681,1923,41,376,South Dakota,Aberdeen,26091
17972,1978-1979,1978-11-09,1979-05-10,183,1,396,919,1315,88,637,725,2040,55,501,South Dakota,Aberdeen,26091
17973,1979-1980,1979-10-31,1980-04-08,161,1,168,626,794,47,149,196,990,25,181,South Dakota,Aberdeen,26091
17974,1980-1981,1980-10-23,1981-03-31,160,0,123,548,671,19,4,23,694,17,134,South Dakota,Aberdeen,26091
17975,1982-1983,1982-10-06,1983-04-17,194,0,91,441,532,35,34,69,601,24,91,South Dakota,Aberdeen,26091
17976,1983-1984,1983-11-08,1984-04-27,172,0,251,616,867,60,205,265,1132,38,307,South Dakota,Aberdeen,26091
17977,1984-1985,1984-10-18,1985-04-07,172,0,225,658,883,52,145,197,1080,26,202,South Dakota,Aberdeen,26091
17978,1985-1986,1985-11-08,1986-04-17,161,0,289,724,1013,86,639,725,1738,38,385,South Dakota,Aberdeen,26091
17979,1986-1987,1986-11-07,1987-03-29,143,0,78,445,523,39,34,73,596,27,140,South Dakota,Aberdeen,26091
17980,1987-1988,1987-11-16,1988-04-26,163,0,178,633,811,36,43,79,890,24,215,South Dakota,Aberdeen,26091
17981,1988-1989,1988-11-12,1989-04-18,158,0,240,734,974,74,506,580,1554,35,337,South Dakota,Aberdeen,26091
17982,1989-1990,1989-10-31,1990-04-29,181,0,153,616,769,55,44,99,868,33,216,South Dakota,Aberdeen,26091
17983,1990-1991,1990-10-17,1991-04-14,180,0,183,633,816,57,118,175,991,30,237,South Dakota,Aberdeen,26091
17984,1991-1992,1991-10-29,1992-04-22,177,0,96,509,605,33,65,98,703,22,144,South Dakota,Aberdeen,26091
17985,1992-1993,1992-10-15,1993-04-11,179,1,240,690,930,68,234,302,1232,46,351,South Dakota,Aberdeen,26091
17986,1993-1994,1993-10-29,1994-04-29,183,0,296,767,1063,117,778,895,1958,53,542,South Dakota,Aberdeen,26091
17987,1994-1995,1994-11-18,1995-04-18,152,3,217,657,874,95,447,542,1416,35,304,South Dakota,Aberdeen,26091
17988,1995-1996,1995-09-21,1996-04-12,205,6,299,809,1108,71,273,344,1452,39,327,South Dakota,Aberdeen,26091
17989,1996-1997,1996-10-30,1997-04-12,165,0,377,913,1290,112,1107,1219,2509,47,487,South Dakota,Aberdeen,26091
17990,1997-1998,1997-10-13,1998-03-31,170,0,157,543,700,60,187,247,947,42,273,South Dakota,Aberdeen,26091
17991,1998-1999,1998-11-05,1999-04-03,150,0,148,514,662,47,157,204,866,33,261,South Dakota,Aberdeen,26091
17992,1999-2000,1999-10-03,2000-04-16,197,0,105,571,676,40,71,111,787,24,170,South Dakota,Aberdeen,26091
17993,2000-2001,2000-11-02,2001-04-24,174,0,324,872,1196,109,875,984,2180,40,377,South Dakota,Aberdeen,26091
17994,2001-2002,2001-10-24,2002-05-07,196,0,148,574,722,53,106,159,881,35,255,South Dakota,Aberdeen,26091
17995,2002-2003,2002-10-21,2003-04-16,178,0,188,709,897,48,66,114,1011,35,276,South Dakota,Aberdeen,26091
17996,2003-2004,2003-10-26,2004-04-29,187,6,189,649,838,61,143,204,1042,37,326,South Dakota,Aberdeen,26091
17997,2004-2005,2004-12-01,2005-03-15,105,0,148,494,642,24,69,93,735,17,142,South Dakota,Aberdeen,26091
17998,2005-2006,2005-11-16,2006-04-24,160,0,126,448,574,45,117,162,736,24,153,South Dakota,Aberdeen,26091
17999,2006-2007,2006-10-11,2007-04-13,185,0,191,775,966,61,357,418,1384,23,192,South Dakota,Aberdeen,26091
18000,2007-2008,2007-11-08,2008-04-26,171,0,232,811,1043,67,316,383,1426,33,287,South Dakota,Aberdeen,26091
18001,2008-2009,2008-11-06,2009-04-04,150,0,261,777,1038,85,379,464,1502,34,344,South Dakota,Aberdeen,26091
18002,2009-2010,2009-10-09,2010-03-16,159,0,254,638,892,63,548,611,1503,32,260,South Dakota,Aberdeen,26091
18003,2010-2011,2010-10-27,2011-04-20,176,0,306,801,1107,123,699,822,1929,48,516,South Dakota,Aberdeen,26091
18004,2011-2012,2011-11-16,2012-03-08,114,0,75,465,540,29,61,90,630,15,101,South Dakota,Aberdeen,26091
18005,2012-2013,2012-11-04,2013-04-24,172,0,206,774,980,107,467,574,1554,48,380,South Dakota,Aberdeen,26091
18006,2013-2014,2013-10-23,2014-04-16,176,0,298,939,1237,52,236,288,1525,30,329,South Dakota,Aberdeen,26091
18007,2014-2015,2014-11-09,2015-03-27,139,0,194,630,824,39,125,164,988,27,221,South Dakota,Aberdeen,26091
18008,2015-2016,2015-11-20,2016-03-19,121,0,100,387,487,49,210,259,746,28,159,South Dakota,Aberdeen,26091
18009,2016-2017,2016-11-17,2017-04-26,161,0,188,560,748,68,217,285,1033,37,341,South Dakota,Aberdeen,26091
18010,2017-2018,2017-11-03,2018-04-10,159,0,202,759,961,68,153,221,1182,31,289,South Dakota,Aberdeen,26091
18011,2018-2019,2018-10-10,2019-04-15,188,0,296,832,1128,120,648,768,1896,44,522,South Dakota,Aberdeen,26091
18012,2019-2020,2019-10-10,2020-04-09,183,0,154,626,780,67,584,651,1431,29,218,South Dakota,Aberdeen,26091
18013,1952-1953,1952-11-17,1953-04-17,152,1,26,395,421,69,168,237,658,15,128,South Dakota,Hot Springs,3711
18014,1953-1954,1953-12-01,1954-03-31,121,1,38,386,424,44,44,88,512,18,136,South Dakota,Hot Springs,3711
18015,1954-1955,1954-10-25,1955-04-04,162,0,44,481,525,82,172,254,779,20,173,South Dakota,Hot Springs,3711
18016,1955-1956,1955-10-23,1956-04-28,189,0,86,567,653,82,129,211,864,34,256,South Dakota,Hot Springs,3711
18017,1956-1957,1956-11-02,1957-04-17,167,9,91,527,618,97,166,263,881,28,259,South Dakota,Hot Springs,3711
18018,1957-1958,1957-11-03,1958-04-25,174,5,45,433,478,53,96,149,627,20,146,South Dakota,Hot Springs,3711
18019,1958-1959,1958-11-16,1959-04-20,156,16,69,492,561,45,57,102,663,18,140,South Dakota,Hot Springs,3711
18020,1960-1961,1960-11-08,1961-04-24,168,0,26,417,443,42,29,71,514,18,106,South Dakota,Hot Springs,3711
18021,1961-1962,1961-09-30,1962-03-13,165,0,105,550,655,70,109,179,834,20,240,South Dakota,Hot Springs,3711
18022,1962-1963,1962-12-01,1963-03-17,107,0,80,413,493,39,124,163,656,10,107,South Dakota,Hot Springs,3711
18023,1963-1964,1963-11-21,1964-04-06,138,2,56,439,495,32,64,96,591,12,86,South Dakota,Hot Springs,3711
18024,1964-1965,1964-11-18,1965-04-05,139,1,79,523,602,79,159,238,840,29,236,South Dakota,Hot Springs,3711
18025,1965-1966,1965-11-25,1966-04-21,148,0,70,485,555,61,124,185,740,19,154,South Dakota,Hot Springs,3711
18026,1966-1967,1966-11-08,1967-05-12,186,0,40,430,470,62,98,160,630,17,140,South Dakota,Hot Springs,3711
18027,1967-1968,1967-11-02,1968-04-04,155,2,60,489,549,54,151,205,754,15,149,South Dakota,Hot Springs,3711
18028,1968-1969,1968-11-06,1969-03-29,144,3,84,511,595,50,104,154,749,22,152,South Dakota,Hot Springs,3711
18029,1969-1970,1969-10-12,1970-04-22,193,1,47,534,581,70,86,156,737,17,133,South Dakota,Hot Springs,3711
18030,1970-1971,1970-09-13,1971-04-04,204,6,63,517,580,73,141,214,794,27,179,South Dakota,Hot Springs,3711
18031,1971-1972,1971-10-28,1972-03-04,129,1,62,449,511,39,66,105,616,15,126,South Dakota,Hot Springs,3711
18032,1972-1973,1972-10-29,1973-04-08,162,3,89,476,565,50,85,135,700,17,154,South Dakota,Hot Springs,3711
18033,1973-1974,1973-10-11,1974-04-03,175,2,56,457,513,56,168,224,737,21,140,South Dakota,Hot Springs,3711
18034,1974-1975,1974-11-29,1975-04-02,125,1,49,495,544,64,149,213,757,17,150,South Dakota,Hot Springs,3711
18035,1975-1976,1975-10-23,1976-04-06,167,1,59,481,540,108,196,304,844,25,225,South Dakota,Hot Springs,3711
18036,1976-1977,1976-11-11,1977-03-29,139,2,42,461,503,34,76,110,613,10,80,South Dakota,Hot Springs,3711
18037,1977-1978,1977-10-10,1978-03-23,165,1,125,597,722,71,207,278,1000,27,246,South Dakota,Hot Springs,3711
18038,1978-1979,1978-11-10,1979-05-10,182,3,138,692,830,69,248,317,1147,24,233,South Dakota,Hot Springs,3711
18039,1979-1980,1979-11-20,1980-04-03,136,6,54,459,513,27,42,69,582,14,92,South Dakota,Hot Springs,3711
18040,1980-1981,1980-11-13,1981-02-28,108,0,30,289,319,26,50,76,395,11,89,South Dakota,Hot Springs,3711
18041,1981-1982,1981-11-28,1982-04-09,133,3,90,511,601,71,227,298,899,25,217,South Dakota,Hot Springs,3711
18042,1982-1983,1982-11-01,1983-04-03,154,14,17,345,362,29,36,65,427,14,67,South Dakota,Hot Springs,3711
18043,1983-1984,1983-11-08,1984-04-30,175,12,117,519,636,78,242,320,956,22,183,South Dakota,Hot Springs,3711
18044,1984-1985,1984-11-09,1985-03-07,119,8,61,470,531,30,48,78,609,9,81,South Dakota,Hot Springs,3711
18045,1985-1986,1985-09-28,1986-04-13,198,6,93,523,616,77,337,414,1030,27,219,South Dakota,Hot Springs,3711
18046,1986-1987,1986-11-07,1987-03-29,143,13,24,340,364,56,100,156,520,18,125,South Dakota,Hot Springs,3711
18047,1987-1988,1987-10-09,1988-04-22,197,18,51,479,530,25,110,135,665,10,68,South Dakota,Hot Springs,3711
18048,1988-1989,1988-11-09,1989-03-18,130,7,62,438,500,34,96,130,630,10,120,South Dakota,Hot Springs,3711
18049,1989-1990,1989-10-29,1990-04-10,164,4,61,439,500,32,69,101,601,12,110,South Dakota,Hot Springs,3711
18050,1990-1991,1990-12-01,1991-04-12,133,7,58,416,474,30,127,157,631,10,74,South Dakota,Hot Springs,3711
18051,1991-1992,1991-10-29,1992-04-12,167,14,17,386,403,17,94,111,514,5,39,South Dakota,Hot Springs,3711
18052,1992-1993,1992-11-24,1993-04-13,141,7,93,536,629,61,386,447,1076,22,162,South Dakota,Hot Springs,3711
18053,1994-1995,1994-11-03,1995-04-11,160,11,50,420,470,46,142,188,658,14,121,South Dakota,Hot Springs,3711
18054,1996-1997,1996-10-17,1997-04-28,194,18,102,554,656,53,129,182,838,15,147,South Dakota,Hot Springs,3711
18055,1997-1998,1997-10-25,1998-03-31,158,8,38,410,448,41,80,121,569,9,79,South Dakota,Hot Springs,3711
18056,1998-1999,1998-11-04,1999-04-03,151,14,31,363,394,38,107,145,539,10,65,South Dakota,Hot Springs,3711
18057,1999-2000,1999-12-01,2000-04-21,143,19,14,324,338,29,54,83,421,7,46,South Dakota,Hot Springs,3711
18058,2003-2004,2003-10-30,2004-03-18,141,12,43,390,433,56,84,140,573,17,117,South Dakota,Hot Springs,3711
18059,2004-2005,2004-11-28,2005-05-12,166,13,29,373,402,28,67,95,497,8,66,South Dakota,Hot Springs,3711
18060,2005-2006,2005-11-30,2006-04-24,146,12,45,341,386,52,127,179,565,13,106,South Dakota,Hot Springs,3711
18061,2006-2007,2006-10-18,2007-04-06,171,8,45,460,505,27,55,82,587,9,65,South Dakota,Hot Springs,3711
18062,2007-2008,2007-11-21,2008-05-02,164,10,43,480,523,55,79,134,657,19,126,South Dakota,Hot Springs,3711
18063,2008-2009,2008-12-01,2009-04-26,147,5,60,434,494,78,99,177,671,22,196,South Dakota,Hot Springs,3711
18064,2009-2010,2009-10-09,2010-03-11,154,4,72,474,546,50,151,201,747,16,124,South Dakota,Hot Springs,3711
18065,2012-2013,2012-11-10,2013-04-23,165,15,38,461,499,81,120,201,700,22,170,South Dakota,Hot Springs,3711
18066,2013-2014,2013-10-04,2014-04-17,196,1,100,533,633,69,130,199,832,31,250,South Dakota,Hot Springs,3711
18067,2014-2015,2014-11-10,2015-05-10,182,3,50,446,496,54,97,151,647,14,121,South Dakota,Hot Springs,3711
18068,2015-2016,2015-11-20,2016-04-17,150,0,32,355,387,52,85,137,524,19,128,South Dakota,Hot Springs,3711
18069,2016-2017,2016-11-17,2017-04-25,160,0,72,458,530,58,168,226,756,16,142,South Dakota,Hot Springs,3711
18070,2017-2018,2017-11-02,2018-04-13,163,0,61,543,604,82,187,269,873,21,201,South Dakota,Hot Springs,3711
18071,2018-2019,2018-10-13,2019-05-01,201,1,70,547,617,57,132,189,806,22,155,South Dakota,Hot Springs,3711
18072,2019-2020,2019-10-10,2020-04-13,187,2,22,444,466,82,103,185,651,23,160,South Dakota,Hot Springs,3711
18073,1950-1951,1950-11-08,1951-04-11,155,0,224,709,933,66,188,254,1187,37,330,South Dakota,Huron,12592
18074,1951-1952,1951-10-21,1952-03-28,160,0,241,715,956,78,426,504,1460,39,335,South Dakota,Huron,12592
18075,1952-1953,1952-11-17,1953-05-12,177,0,119,508,627,66,173,239,866,32,241,South Dakota,Huron,12592
18076,1953-1954,1953-11-20,1954-05-02,164,0,145,542,687,76,235,311,998,30,234,South Dakota,Huron,12592
18077,1954-1955,1954-10-31,1955-03-26,147,0,149,573,722,51,161,212,934,29,259,South Dakota,Huron,12592
18078,1955-1956,1955-11-06,1956-04-30,177,0,309,849,1158,81,614,695,1853,39,380,South Dakota,Huron,12592
18079,1956-1957,1956-11-14,1957-04-11,149,0,158,587,745,56,124,180,925,29,285,South Dakota,Huron,12592
18080,1957-1958,1957-10-25,1958-04-06,164,0,114,511,625,40,118,158,783,26,137,South Dakota,Huron,12592
18081,1958-1959,1958-11-04,1959-04-11,159,0,211,679,890,53,192,245,1135,36,332,South Dakota,Huron,12592
18082,1959-1960,1959-10-30,1960-04-03,157,0,257,683,940,76,488,564,1504,42,330,South Dakota,Huron,12592
18083,1960-1961,1960-11-09,1961-04-11,154,0,185,647,832,48,344,392,1224,23,216,South Dakota,Huron,12592
18084,1961-1962,1961-11-02,1962-04-12,162,0,268,775,1043,115,443,558,1601,40,426,South Dakota,Huron,12592
18085,1962-1963,1962-10-24,1963-04-22,181,0,189,656,845,44,126,170,1015,28,236,South Dakota,Huron,12592
18086,1963-1964,1963-11-21,1964-04-12,144,0,154,633,787,53,144,197,984,33,258,South Dakota,Huron,12592
18087,1964-1965,1964-11-19,1965-04-06,139,0,271,845,1116,74,325,399,1515,38,370,South Dakota,Huron,12592
18088,1965-1966,1965-11-13,1966-05-11,180,0,196,639,835,59,194,253,1088,27,246,South Dakota,Huron,12592
18089,1966-1967,1966-11-01,1967-05-01,182,0,135,627,762,58,144,202,964,37,307,South Dakota,Huron,12592
18090,1967-1968,1967-11-12,1968-05-18,189,0,141,565,706,35,52,87,793,25,142,South Dakota,Huron,12592
18091,1968-1969,1968-11-05,1969-04-04,151,0,232,654,886,106,792,898,1784,49,424,South Dakota,Huron,12592
18092,1969-1970,1969-10-12,1970-04-22,193,0,173,650,823,83,270,353,1176,47,317,South Dakota,Huron,12592
18093,1970-1971,1970-10-07,1971-03-24,169,0,218,670,888,75,354,429,1317,43,342,South Dakota,Huron,12592
18094,1971-1972,1971-10-28,1972-04-03,159,0,213,670,883,81,486,567,1450,51,432,South Dakota,Huron,12592
18095,1972-1973,1972-10-17,1973-03-28,163,0,154,462,616,64,201,265,881,29,230,South Dakota,Huron,12592
18096,1973-1974,1973-11-04,1974-03-23,140,0,164,521,685,59,193,252,937,38,275,South Dakota,Huron,12592
18097,1974-1975,1974-11-13,1975-04-10,149,0,149,623,772,105,359,464,1236,34,285,South Dakota,Huron,12592
18098,1975-1976,1975-11-12,1976-03-15,125,0,138,526,664,56,194,250,914,28,227,South Dakota,Huron,12592
18099,1976-1977,1976-10-18,1977-04-04,169,0,195,716,911,57,118,175,1086,26,222,South Dakota,Huron,12592
18100,1977-1978,1977-11-08,1978-04-02,146,0,321,776,1097,56,322,378,1475,39,355,South Dakota,Huron,12592
18101,1978-1979,1978-11-11,1979-04-12,153,0,314,813,1127,72,508,580,1707,40,385,South Dakota,Huron,12592
18102,1979-1980,1979-10-21,1980-03-29,161,0,110,548,658,42,53,95,753,26,149,South Dakota,Huron,12592
18103,1980-1981,1980-10-27,1981-03-31,156,0,95,505,600,21,18,39,639,15,117,South Dakota,Huron,12592
18104,1981-1982,1981-10-24,1982-04-19,178,0,227,624,851,92,478,570,1421,40,374,South Dakota,Huron,12592
18105,1982-1983,1982-10-19,1983-04-17,181,0,61,376,437,50,42,92,529,32,122,South Dakota,Huron,12592
18106,1983-1984,1983-11-08,1984-03-28,142,0,216,532,748,86,431,517,1265,43,306,South Dakota,Huron,12592
18107,1984-1985,1984-11-01,1985-04-05,156,0,172,538,710,70,161,231,941,27,260,South Dakota,Huron,12592
18108,1985-1986,1985-11-07,1986-04-17,162,0,248,674,922,102,564,666,1588,46,404,South Dakota,Huron,12592
18109,1986-1987,1986-11-08,1987-03-29,142,0,55,409,464,36,42,78,542,18,99,South Dakota,Huron,12592
18110,1987-1988,1987-11-16,1988-04-26,163,0,174,618,792,76,431,507,1299,28,245,South Dakota,Huron,12592
18111,1988-1989,1988-11-12,1989-05-05,175,0,185,632,817,96,259,355,1172,39,396,South Dakota,Huron,12592
18112,1989-1990,1989-11-01,1990-04-29,180,0,126,575,701,45,70,115,816,23,182,South Dakota,Huron,12592
18113,1990-1991,1990-10-17,1991-04-11,177,0,156,600,756,52,173,225,981,26,227,South Dakota,Huron,12592
18114,1991-1992,1991-10-29,1992-04-21,176,0,76,432,508,35,76,111,619,18,110,South Dakota,Huron,12592
18115,1992-1993,1992-10-15,1993-04-14,182,0,189,629,818,74,235,309,1127,47,350,South Dakota,Huron,12592
18116,1993-1994,1993-10-30,1994-04-29,182,0,241,700,941,98,598,696,1637,47,424,South Dakota,Huron,12592
18117,1994-1995,1994-11-18,1995-04-18,152,0,155,512,667,94,329,423,1090,39,289,South Dakota,Huron,12592
18118,1995-1996,1995-10-23,1996-04-13,174,0,233,672,905,94,300,394,1299,37,319,South Dakota,Huron,12592
18119,1996-1997,1996-10-30,1997-04-13,166,0,292,747,1039,75,949,1024,2063,26,282,South Dakota,Huron,12592
18120,1997-1998,1997-11-02,1998-04-02,152,0,111,428,539,58,152,210,749,25,176,South Dakota,Huron,12592
18121,1998-1999,1998-11-07,1999-04-10,155,0,103,420,523,59,188,247,770,25,180,South Dakota,Huron,12592
18122,1999-2000,1999-10-01,2000-04-16,199,0,59,482,541,39,32,71,612,16,105,South Dakota,Huron,12592
18123,2000-2001,2000-11-07,2001-04-23,168,0,267,786,1053,132,1016,1148,2201,41,396,South Dakota,Huron,12592
18124,2001-2002,2001-11-26,2002-04-21,147,0,117,463,580,67,161,228,808,18,157,South Dakota,Huron,12592
18125,2002-2003,2002-10-22,2003-04-07,168,0,138,583,721,48,76,124,845,26,210,South Dakota,Huron,12592
18126,2003-2004,2003-10-29,2004-04-11,166,0,148,511,659,57,185,242,901,31,258,South Dakota,Huron,12592
18127,2004-2005,2004-11-28,2005-03-20,113,0,111,436,547,20,23,43,590,14,92,South Dakota,Huron,12592
18128,2005-2006,2005-11-15,2006-03-21,127,0,101,389,490,58,187,245,735,22,165,South Dakota,Huron,12592
18129,2006-2007,2006-10-18,2007-04-13,178,0,158,596,754,67,236,303,1057,28,208,South Dakota,Huron,12592
18130,2007-2008,2007-11-21,2008-04-27,159,0,159,630,789,70,218,288,1077,29,233,South Dakota,Huron,12592
18131,2008-2009,2008-11-06,2009-04-25,171,0,188,656,844,77,306,383,1227,35,292,South Dakota,Huron,12592
18132,2009-2010,2009-10-09,2010-03-14,157,0,225,563,788,76,585,661,1449,33,296,South Dakota,Huron,12592
18133,2010-2011,2010-10-27,2011-04-16,172,0,244,672,916,105,624,729,1645,38,373,South Dakota,Huron,12592
18134,2011-2012,2011-11-19,2012-03-08,111,0,60,376,436,46,117,163,599,18,135,South Dakota,Huron,12592
18135,2012-2013,2012-10-25,2013-04-23,181,0,156,621,777,86,484,570,1347,33,215,South Dakota,Huron,12592
18136,2013-2014,2013-10-22,2014-04-17,178,0,230,770,1000,50,169,219,1219,32,274,South Dakota,Huron,12592
18137,2014-2015,2014-11-10,2015-03-05,116,0,168,555,723,39,175,214,937,22,187,South Dakota,Huron,12592
18138,2015-2016,2015-11-26,2016-03-26,122,0,106,373,479,53,206,259,738,25,164,South Dakota,Huron,12592
18139,2016-2017,2016-11-18,2017-03-17,120,0,147,454,601,52,164,216,817,22,173,South Dakota,Huron,12592
18140,2017-2018,2017-11-05,2018-04-19,166,0,186,655,841,87,189,276,1117,35,270,South Dakota,Huron,12592
18141,2018-2019,2018-11-07,2019-04-27,172,0,243,696,939,97,395,492,1431,35,370,South Dakota,Huron,12592
18142,2019-2020,2019-10-10,2020-04-13,187,0,130,528,658,77,484,561,1219,30,212,South Dakota,Huron,12592
18143,1950-1951,1950-10-01,1951-06-04,247,4,107,538,645,109,162,271,916,47,331,South Dakota,Lead,3124
18144,1951-1952,1951-09-23,1952-05-09,230,5,117,541,658,155,695,850,1508,58,436,South Dakota,Lead,3124
18145,1952-1953,1952-10-13,1953-05-13,213,3,76,402,478,252,603,855,1333,72,501,South Dakota,Lead,3124
18146,1953-1954,1953-10-22,1954-06-03,225,1,82,439,521,172,358,530,1051,55,364,South Dakota,Lead,3124
18147,1954-1955,1954-09-29,1955-06-09,254,8,115,470,585,269,654,923,1508,65,563,South Dakota,Lead,3124
18148,1955-1956,1955-09-22,1956-05-13,235,1,130,543,673,187,315,502,1175,58,430,South Dakota,Lead,3124
18149,1956-1957,1956-10-24,1957-05-22,211,0,128,551,679,244,554,798,1477,64,523,South Dakota,Lead,3124
18150,1957-1958,1957-09-19,1958-04-30,224,1,82,389,471,196,365,561,1032,62,405,South Dakota,Lead,3124
18151,1958-1959,1958-10-20,1959-05-20,213,0,121,458,579,198,509,707,1286,62,457,South Dakota,Lead,3124
18152,1959-1960,1959-09-29,1960-05-05,220,0,147,512,659,236,703,939,1598,64,547,South Dakota,Lead,3124
18153,1960-1961,1960-09-22,1961-05-04,225,0,61,386,447,164,366,530,977,52,327,South Dakota,Lead,3124
18154,1961-1962,1961-09-12,1962-04-27,228,0,169,544,713,200,466,666,1379,66,513,South Dakota,Lead,3124
18155,1962-1963,1962-09-08,1963-04-23,228,0,118,441,559,244,599,843,1402,64,568,South Dakota,Lead,3124
18156,1963-1964,1963-10-30,1964-05-11,195,3,112,443,555,219,899,1118,1673,61,469,South Dakota,Lead,3124
18157,1964-1965,1964-09-26,1965-05-26,243,0,140,526,666,239,756,995,1661,71,579,South Dakota,Lead,3124
18158,1965-1966,1965-09-16,1966-05-12,239,0,105,452,557,250,459,709,1266,52,491,South Dakota,Lead,3124
18159,1966-1967,1966-09-30,1967-05-14,227,0,82,468,550,218,657,875,1425,65,495,South Dakota,Lead,3124
18160,1967-1968,1967-10-26,1968-05-18,206,0,91,474,565,169,619,788,1353,65,434,South Dakota,Lead,3124
18161,1968-1969,1968-10-02,1969-06-13,255,0,116,552,668,195,516,711,1379,61,475,South Dakota,Lead,3124
18162,1969-1970,1969-10-11,1970-05-15,217,0,113,504,617,323,768,1091,1708,73,602,South Dakota,Lead,3124
18163,1970-1971,1970-09-12,1971-06-12,274,0,116,535,651,310,623,933,1584,92,665,South Dakota,Lead,3124
18164,1971-1972,1971-09-15,1972-06-19,279,0,121,527,648,261,375,636,1284,84,613,South Dakota,Lead,3124
18165,1972-1973,1972-09-29,1973-06-19,264,0,127,497,624,285,436,721,1345,65,540,South Dakota,Lead,3124
18166,1973-1974,1973-10-09,1974-05-17,221,0,99,448,547,198,313,511,1058,55,437,South Dakota,Lead,3124
18167,1974-1975,1974-09-12,1975-05-25,256,2,100,519,619,268,587,855,1474,70,580,South Dakota,Lead,3124
18168,1975-1976,1975-10-08,1976-05-12,218,0,87,457,544,207,363,570,1114,65,478,South Dakota,Lead,3124
18169,1976-1977,1976-10-06,1977-04-19,196,0,105,489,594,368,801,1169,1763,74,722,South Dakota,Lead,3124
18170,1977-1978,1977-10-01,1978-05-11,223,0,120,537,657,232,575,807,1464,63,513,South Dakota,Lead,3124
18171,1978-1979,1978-10-12,1979-05-30,231,2,170,633,803,187,567,754,1557,60,480,South Dakota,Lead,3124
18172,1979-1980,1979-10-08,1980-04-16,192,3,88,467,555,163,229,392,947,61,438,South Dakota,Lead,3124
18173,1980-1981,1980-09-16,1981-05-04,231,3,52,341,393,116,121,237,630,35,266,South Dakota,Lead,3124
18174,1981-1982,1981-10-05,1982-05-05,213,4,117,528,645,210,372,582,1227,65,512,South Dakota,Lead,3124
18175,1982-1983,1982-09-14,1983-05-11,240,4,50,416,466,342,562,904,1370,74,573,South Dakota,Lead,3124
18176,1983-1984,1983-09-19,1984-05-27,252,10,149,510,659,342,597,939,1598,80,647,South Dakota,Lead,3124
18177,1984-1985,1984-09-23,1985-04-26,216,3,112,544,656,181,358,539,1195,55,435,South Dakota,Lead,3124
18178,1985-1986,1985-09-22,1986-05-23,244,6,127,502,629,299,859,1158,1787,79,599,South Dakota,Lead,3124
18179,1986-1987,1986-10-02,1987-05-21,232,4,70,391,461,215,350,565,1026,60,459,South Dakota,Lead,3124
18180,1987-1988,1987-10-09,1988-05-08,213,2,98,500,598,258,480,738,1336,60,497,South Dakota,Lead,3124
18181,1988-1989,1988-09-19,1989-05-26,250,2,153,533,686,259,295,554,1240,80,647,South Dakota,Lead,3124
18182,1989-1990,1989-09-10,1990-05-12,245,4,93,477,570,298,648,946,1516,78,623,South Dakota,Lead,3124
18183,1990-1991,1990-10-06,1991-05-03,210,2,114,482,596,261,443,704,1300,62,550,South Dakota,Lead,3124
18184,1991-1992,1991-10-03,1992-05-01,212,4,47,348,395,241,363,604,999,58,431,South Dakota,Lead,3124
18185,1992-1993,1992-10-06,1993-05-09,216,15,114,536,650,293,668,961,1611,76,607,South Dakota,Lead,3124
18186,1993-1994,1993-09-13,1994-05-01,231,2,114,489,603,505,1182,1687,2290,85,879,South Dakota,Lead,3124
18187,1994-1995,1994-09-21,1995-06-10,263,12,82,424,506,252,195,447,953,73,483,South Dakota,Lead,3124
18188,1995-1996,1995-09-19,1996-05-28,253,11,148,581,729,401,574,975,1704,88,787,South Dakota,Lead,3124
18189,1996-1997,1996-09-25,1997-05-03,221,8,151,606,757,428,1054,1482,2239,76,793,South Dakota,Lead,3124
18190,1997-1998,1997-10-08,1998-06-05,241,10,91,426,517,328,526,854,1371,70,586,South Dakota,Lead,3124
18191,1998-1999,1998-10-04,1999-04-22,201,17,72,383,455,248,396,644,1099,59,467,South Dakota,Lead,3124
18192,1999-2000,1999-09-26,2000-05-12,230,10,33,319,352,250,439,689,1041,64,430,South Dakota,Lead,3124
18193,2000-2001,2000-09-20,2001-05-21,244,10,106,535,641,269,1041,1310,1951,72,575,South Dakota,Lead,3124
18194,2001-2002,2001-10-04,2002-05-11,220,9,104,491,595,168,372,540,1135,54,425,South Dakota,Lead,3124
18195,2003-2004,2003-09-17,2004-05-22,249,10,66,417,483,177,263,440,923,49,375,South Dakota,Lead,3124
18196,2005-2006,2005-10-05,2006-05-11,219,20,104,383,487,342,607,949,1436,71,627,South Dakota,Lead,3124
18197,2007-2008,2007-10-18,2008-05-27,223,8,99,502,601,359,791,1150,1751,69,651,South Dakota,Lead,3124
18198,2008-2009,2008-10-10,2009-05-08,211,16,98,517,615,378,1221,1599,2214,71,690,South Dakota,Lead,3124
18199,2009-2010,2009-10-01,2010-05-13,225,4,111,505,616,309,1004,1313,1929,75,631,South Dakota,Lead,3124
18200,2010-2011,2010-10-27,2011-05-19,205,1,115,497,612,260,1003,1263,1875,70,590,South Dakota,Lead,3124
18201,2011-2012,2011-11-01,2012-04-29,181,0,44,384,428,191,612,803,1231,47,359,South Dakota,Lead,3124
18202,2012-2013,2012-10-03,2013-04-26,206,1,85,473,558,258,702,960,1518,72,592,South Dakota,Lead,3124
18203,2013-2014,2013-10-04,2014-05-11,220,0,107,447,554,247,658,905,1459,66,498,South Dakota,Lead,3124
18204,2014-2015,2014-09-11,2015-05-11,243,3,78,399,477,165,561,726,1203,34,328,South Dakota,Lead,3124
18205,2015-2016,2015-11-19,2016-04-29,163,3,50,290,340,135,450,585,925,32,247,South Dakota,Lead,3124
18206,2016-2017,2016-11-17,2017-04-26,161,7,99,384,483,121,346,467,950,33,306,South Dakota,Lead,3124
18207,2017-2018,2017-10-14,2018-04-24,193,0,88,502,590,184,463,647,1237,54,457,South Dakota,Lead,3124
18208,2018-2019,2018-09-28,2019-05-24,239,0,111,526,637,234,720,954,1591,61,517,South Dakota,Lead,3124
18209,2019-2020,2019-10-02,2020-05-10,222,4,74,438,512,253,911,1164,1676,61,474,South Dakota,Lead,3124
18210,1950-1951,1950-10-01,1951-04-21,203,13,248,806,1054,34,304,338,1392,8,86,South Dakota,Lemmon,1227
18211,1963-1964,1963-11-12,1964-04-07,148,7,138,625,763,38,158,196,959,16,171,South Dakota,Lemmon,1227
18212,1970-1971,1970-10-29,1971-04-27,181,3,272,747,1019,80,465,545,1564,35,322,South Dakota,Lemmon,1227
18213,1972-1973,1972-10-29,1973-04-15,169,0,175,558,733,65,237,302,1035,20,220,South Dakota,Lemmon,1227
18214,1973-1974,1973-10-11,1974-04-13,185,3,171,623,794,44,130,174,968,18,109,South Dakota,Lemmon,1227
18215,1974-1975,1974-11-12,1975-04-16,156,19,172,634,806,67,267,334,1140,19,188,South Dakota,Lemmon,1227
18216,1975-1976,1975-11-20,1976-04-03,136,0,149,537,686,49,238,287,973,15,161,South Dakota,Lemmon,1227
18217,1976-1977,1976-10-23,1977-04-06,166,10,171,678,849,46,224,270,1119,14,131,South Dakota,Lemmon,1227
18218,1977-1978,1977-11-18,1978-04-19,153,1,353,786,1139,82,714,796,1935,26,296,South Dakota,Lemmon,1227
18219,1978-1979,1978-11-09,1979-04-14,157,1,354,906,1260,86,769,855,2115,23,280,South Dakota,Lemmon,1227
18220,1980-1981,1980-10-15,1981-02-28,137,0,96,421,517,17,40,57,574,8,75,South Dakota,Lemmon,1227
18221,1981-1982,1981-10-22,1982-04-19,180,8,274,752,1026,116,435,551,1577,47,493,South Dakota,Lemmon,1227
18222,1982-1983,1982-11-03,1983-05-12,191,5,102,479,581,47,73,120,701,27,171,South Dakota,Lemmon,1227
18223,1983-1984,1983-11-11,1984-04-30,172,4,226,615,841,63,258,321,1162,35,307,South Dakota,Lemmon,1227
18224,1984-1985,1984-09-23,1985-04-06,196,10,233,737,970,85,371,456,1426,31,312,South Dakota,Lemmon,1227
18225,1987-1988,1987-12-01,1988-03-19,110,20,128,453,581,25,161,186,767,10,95,South Dakota,Lemmon,1227
18226,1990-1991,1990-10-17,1991-05-03,199,16,148,541,689,35,96,131,820,16,134,South Dakota,Lemmon,1227
18227,1991-1992,1991-10-28,1992-04-12,168,20,68,399,467,9,105,114,581,5,27,South Dakota,Lemmon,1227
18228,1992-1993,1992-10-15,1993-04-19,187,18,212,599,811,62,336,398,1209,23,227,South Dakota,Lemmon,1227
18229,1993-1994,1993-10-08,1994-04-30,205,7,246,689,935,97,730,827,1762,32,358,South Dakota,Lemmon,1227
18230,1994-1995,1994-11-17,1995-04-12,147,16,143,493,636,50,196,246,882,17,132,South Dakota,Lemmon,1227
18231,1997-1998,1997-10-13,1998-03-23,162,10,137,480,617,34,176,210,827,10,98,South Dakota,Lemmon,1227
18232,1998-1999,1998-11-06,1999-04-07,153,15,119,439,558,70,287,357,915,21,183,South Dakota,Lemmon,1227
18233,1999-2000,1999-11-19,2000-03-17,120,14,60,358,418,29,104,133,551,12,101,South Dakota,Lemmon,1227
18234,2005-2006,2005-10-05,2006-03-31,178,16,96,403,499,61,189,250,749,18,142,South Dakota,Lemmon,1227
18235,2006-2007,2006-10-21,2007-04-11,173,8,118,538,656,50,70,120,776,16,122,South Dakota,Lemmon,1227
18236,2007-2008,2007-11-20,2008-05-10,173,18,113,568,681,44,106,150,831,18,128,South Dakota,Lemmon,1227
18237,2008-2009,2008-11-06,2009-04-26,172,4,216,655,871,128,678,806,1677,33,346,South Dakota,Lemmon,1227
18238,2009-2010,2009-10-05,2010-04-02,180,1,233,583,816,100,639,739,1555,26,272,South Dakota,Lemmon,1227
18239,2010-2011,2010-10-27,2011-04-20,176,20,264,687,951,128,707,835,1786,32,350,South Dakota,Lemmon,1227
18240,2013-2014,2013-10-04,2014-04-29,208,1,223,717,940,98,347,445,1385,24,248,South Dakota,Lemmon,1227
18241,2014-2015,2014-11-09,2015-05-10,183,1,150,523,673,45,161,206,879,15,137,South Dakota,Lemmon,1227
18242,2015-2016,2015-11-25,2016-04-28,156,0,72,319,391,45,100,145,536,15,97,South Dakota,Lemmon,1227
18243,2016-2017,2016-11-18,2017-03-15,118,0,176,399,575,69,516,585,1160,22,229,South Dakota,Lemmon,1227
18244,2017-2018,2017-11-03,2018-04-24,173,0,187,672,859,81,247,328,1187,27,279,South Dakota,Lemmon,1227
18245,2018-2019,2018-11-06,2019-05-01,177,0,240,652,892,87,453,540,1432,29,335,South Dakota,Lemmon,1227
18246,2019-2020,2019-10-02,2020-04-13,195,0,115,539,654,63,186,249,903,24,196,South Dakota,Lemmon,1227
18247,1950-1951,1950-10-02,1951-04-20,201,0,238,801,1039,45,173,218,1257,29,283,South Dakota,Mobridge,3465
18248,1951-1952,1951-10-20,1952-04-06,170,4,291,777,1068,54,626,680,1748,34,307,South Dakota,Mobridge,3465
18249,1952-1953,1952-11-25,1953-04-16,143,6,114,519,633,45,219,264,897,21,185,South Dakota,Mobridge,3465
18250,1953-1954,1953-11-06,1954-05-02,178,0,140,554,694,35,83,118,812,24,204,South Dakota,Mobridge,3465
18251,1954-1955,1954-10-25,1955-03-25,152,2,124,581,705,34,93,127,832,19,152,South Dakota,Mobridge,3465
18252,1955-1956,1955-11-02,1956-04-03,154,0,296,863,1159,45,398,443,1602,22,229,South Dakota,Mobridge,3465
18253,1956-1957,1956-11-02,1957-04-11,161,0,184,647,831,33,66,99,930,23,245,South Dakota,Mobridge,3465
18254,1957-1958,1957-10-24,1958-03-23,151,0,130,544,674,28,135,163,837,17,122,South Dakota,Mobridge,3465
18255,1958-1959,1958-11-14,1959-04-11,149,0,216,692,908,40,198,238,1146,26,232,South Dakota,Mobridge,3465
18256,1959-1960,1959-11-04,1960-04-02,151,12,213,661,874,54,252,306,1180,34,273,South Dakota,Mobridge,3465
18257,1960-1961,1960-11-09,1961-04-11,154,1,135,528,663,28,236,264,927,12,91,South Dakota,Mobridge,3465
18258,1961-1962,1961-11-15,1962-03-24,130,0,240,675,915,49,274,323,1238,27,245,South Dakota,Mobridge,3465
18259,1962-1963,1962-11-16,1963-04-10,146,0,178,570,748,39,124,163,911,17,176,South Dakota,Mobridge,3465
18260,1963-1964,1963-11-13,1964-04-07,147,0,140,593,733,38,101,139,872,22,204,South Dakota,Mobridge,3465
18261,1964-1965,1964-11-19,1965-04-23,156,0,293,786,1079,59,434,493,1572,31,322,South Dakota,Mobridge,3465
18262,1966-1967,1966-11-01,1967-05-01,182,0,151,636,787,59,157,216,1003,27,269,South Dakota,Mobridge,3465
18263,1967-1968,1967-11-03,1968-04-23,173,0,176,603,779,60,143,203,982,22,223,South Dakota,Mobridge,3465
18264,1968-1969,1968-11-06,1969-04-02,148,0,279,684,963,68,552,620,1583,40,350,South Dakota,Mobridge,3465
18265,1969-1970,1969-11-13,1970-04-20,159,0,201,649,850,86,378,464,1314,36,278,South Dakota,Mobridge,3465
18266,1970-1971,1970-11-10,1971-03-24,135,0,266,674,940,62,372,434,1374,35,319,South Dakota,Mobridge,3465
18267,1971-1972,1971-10-28,1972-03-14,139,3,267,701,968,74,701,775,1743,38,393,South Dakota,Mobridge,3465
18268,1972-1973,1972-10-30,1973-03-15,137,1,182,515,697,37,253,290,987,18,192,South Dakota,Mobridge,3465
18269,1973-1974,1973-11-03,1974-04-13,162,0,182,571,753,30,96,126,879,20,163,South Dakota,Mobridge,3465
18270,1974-1975,1974-11-01,1975-04-13,164,0,163,610,773,75,266,341,1114,35,272,South Dakota,Mobridge,3465
18271,1975-1976,1975-11-23,1976-04-02,132,0,158,510,668,45,228,273,941,28,227,South Dakota,Mobridge,3465
18272,1976-1977,1976-10-18,1977-04-01,166,0,201,654,855,72,162,234,1089,38,299,South Dakota,Mobridge,3465
18273,1977-1978,1977-11-08,1978-04-18,162,0,365,786,1151,88,689,777,1928,47,448,South Dakota,Mobridge,3465
18274,1978-1979,1978-11-09,1979-05-10,183,2,356,840,1196,82,539,621,1817,42,338,South Dakota,Mobridge,3465
18275,1979-1980,1979-10-31,1980-03-24,146,0,129,584,713,37,47,84,797,24,168,South Dakota,Mobridge,3465
18276,1980-1981,1980-10-23,1981-02-28,129,0,97,413,510,14,10,24,534,14,101,South Dakota,Mobridge,3465
18277,1981-1982,1981-10-24,1982-04-19,178,0,261,707,968,89,358,447,1415,42,378,South Dakota,Mobridge,3465
18278,1982-1983,1982-11-02,1983-04-13,163,1,80,448,528,40,45,85,613,24,128,South Dakota,Mobridge,3465
18279,1983-1984,1983-11-08,1984-04-28,173,1,239,606,845,57,243,300,1145,36,289,South Dakota,Mobridge,3465
18280,1984-1985,1984-10-30,1985-04-05,158,3,221,697,918,38,221,259,1177,12,128,South Dakota,Mobridge,3465
18281,1985-1986,1985-11-08,1986-04-17,161,2,244,651,895,91,848,939,1834,27,309,South Dakota,Mobridge,3465
18282,1986-1987,1986-11-07,1987-04-01,146,4,73,424,497,67,350,417,914,18,122,South Dakota,Mobridge,3465
18283,1987-1988,1987-12-01,1988-03-21,112,1,149,515,664,28,153,181,845,10,118,South Dakota,Mobridge,3465
18284,1988-1989,1988-11-15,1989-04-28,165,9,210,648,858,55,266,321,1179,17,192,South Dakota,Mobridge,3465
18285,1989-1990,1989-11-02,1990-04-29,179,2,134,565,699,18,69,87,786,6,45,South Dakota,Mobridge,3465
18286,1990-1991,1990-10-17,1991-05-05,201,5,155,572,727,36,126,162,889,13,101,South Dakota,Mobridge,3465
18287,1991-1992,1991-10-28,1992-04-20,176,3,82,441,523,23,82,105,628,16,97,South Dakota,Mobridge,3465
18288,1992-1993,1992-10-15,1993-03-31,168,2,221,618,839,51,212,263,1102,36,263,South Dakota,Mobridge,3465
18289,1993-1994,1993-10-29,1994-04-28,182,4,245,696,941,93,640,733,1674,51,438,South Dakota,Mobridge,3465
18290,1994-1995,1994-11-17,1995-04-26,161,4,189,551,740,78,412,490,1230,36,270,South Dakota,Mobridge,3465
18291,1995-1996,1995-10-30,1996-05-03,187,1,261,695,956,54,280,334,1290,32,237,South Dakota,Mobridge,3465
18292,1996-1997,1996-10-21,1997-04-13,175,2,320,783,1103,113,1113,1226,2329,40,378,South Dakota,Mobridge,3465
18293,2000-2001,2000-11-06,2001-04-22,168,0,240,739,979,51,322,373,1352,26,204,South Dakota,Mobridge,3465
18294,2001-2002,2001-10-24,2002-04-21,180,3,122,542,664,25,73,98,762,17,120,South Dakota,Mobridge,3465
18295,2002-2003,2002-10-21,2003-03-14,145,0,155,599,754,32,53,85,839,22,169,South Dakota,Mobridge,3465
18296,2003-2004,2003-10-29,2004-04-11,166,0,169,572,741,49,211,260,1001,27,225,South Dakota,Mobridge,3465
18297,2004-2005,2004-11-28,2005-03-22,115,1,119,443,562,22,70,92,654,14,87,South Dakota,Mobridge,3465
18298,2010-2011,2010-11-20,2011-04-22,154,4,290,714,1004,113,661,774,1778,44,450,South Dakota,Mobridge,3465
18299,2011-2012,2011-11-19,2012-03-07,110,5,72,428,500,26,66,92,592,15,129,South Dakota,Mobridge,3465
18300,2012-2013,2012-11-10,2013-04-23,165,0,152,603,755,64,179,243,998,29,234,South Dakota,Mobridge,3465
18301,2013-2014,2013-10-28,2014-04-05,160,0,250,760,1010,60,187,247,1257,28,299,South Dakota,Mobridge,3465
18302,2014-2015,2014-11-09,2015-03-04,116,0,147,505,652,27,131,158,810,15,109,South Dakota,Mobridge,3465
18303,2015-2016,2015-11-26,2016-03-18,114,3,82,321,403,28,109,137,540,19,99,South Dakota,Mobridge,3465
18304,2016-2017,2016-11-17,2017-03-18,122,4,202,505,707,69,476,545,1252,33,316,South Dakota,Mobridge,3465
18305,2018-2019,2018-11-07,2019-04-16,161,1,245,656,901,120,690,810,1711,40,458,South Dakota,Mobridge,3465
18306,2019-2020,2019-10-10,2020-04-05,179,0,126,535,661,67,308,375,1036,28,196,South Dakota,Mobridge,3465
18307,1950-1951,1950-11-09,1951-04-20,163,0,195,695,890,29,97,126,1016,15,154,South Dakota,Pierre,2078
18308,1951-1952,1951-10-18,1952-04-07,173,0,245,730,975,119,963,1082,2057,34,348,South Dakota,Pierre,2078
18309,1952-1953,1952-11-17,1953-04-02,137,0,104,450,554,55,238,293,847,22,188,South Dakota,Pierre,2078
18310,1953-1954,1953-11-06,1954-05-02,178,2,103,488,591,51,120,171,762,20,154,South Dakota,Pierre,2078
18311,1954-1955,1954-10-26,1955-03-25,151,0,115,506,621,51,186,237,858,21,175,South Dakota,Pierre,2078
18312,1955-1956,1955-10-23,1956-04-30,191,1,263,788,1051,79,421,500,1551,40,393,South Dakota,Pierre,2078
18313,1956-1957,1956-11-14,1957-04-11,149,0,163,563,726,55,146,201,927,26,246,South Dakota,Pierre,2078
18314,1957-1958,1957-10-23,1958-04-05,165,1,100,512,612,44,176,220,832,22,146,South Dakota,Pierre,2078
18315,1958-1959,1958-11-17,1959-04-20,155,0,175,606,781,32,98,130,911,23,209,South Dakota,Pierre,2078
18316,1959-1960,1959-11-04,1960-04-03,152,0,209,629,838,72,425,497,1335,39,314,South Dakota,Pierre,2078
18317,1960-1961,1960-11-09,1961-04-11,154,1,105,476,581,31,126,157,738,20,118,South Dakota,Pierre,2078
18318,1961-1962,1961-11-02,1962-03-26,145,0,206,653,859,55,279,334,1193,29,291,South Dakota,Pierre,2078
18319,1962-1963,1962-11-16,1963-04-04,140,6,137,501,638,31,73,104,742,23,191,South Dakota,Pierre,2078
18320,1963-1964,1963-11-13,1964-04-08,148,0,112,494,606,30,58,88,694,22,145,South Dakota,Pierre,2078
18321,1964-1965,1964-11-18,1965-04-06,140,0,249,729,978,50,203,253,1231,33,333,South Dakota,Pierre,2078
18322,1965-1966,1965-11-25,1966-05-11,168,3,191,529,720,46,202,248,968,32,296,South Dakota,Pierre,2078
18323,1966-1967,1966-11-01,1967-05-02,183,0,125,517,642,50,128,178,820,25,212,South Dakota,Pierre,2078
18324,1967-1968,1967-11-03,1968-04-07,157,0,144,526,670,36,92,128,798,18,161,South Dakota,Pierre,2078
18325,1968-1969,1968-11-06,1969-04-27,173,2,231,584,815,50,369,419,1234,38,279,South Dakota,Pierre,2078
18326,1969-1970,1969-11-14,1970-04-19,157,0,161,545,706,60,185,245,951,35,254,South Dakota,Pierre,2078
18327,1970-1971,1970-10-07,1971-04-27,203,0,203,613,816,48,202,250,1066,32,225,South Dakota,Pierre,2078
18328,1971-1972,1971-10-28,1972-04-02,158,0,206,613,819,41,168,209,1028,28,218,South Dakota,Pierre,2078
18329,1972-1973,1972-10-30,1973-03-14,136,0,153,437,590,41,182,223,813,22,178,South Dakota,Pierre,2078
18330,1973-1974,1973-11-03,1974-03-23,141,0,129,437,566,23,37,60,626,20,139,South Dakota,Pierre,2078
18331,1974-1975,1974-11-13,1975-04-09,148,0,119,521,640,87,268,355,995,33,287,South Dakota,Pierre,2078
18332,1975-1976,1975-11-23,1976-03-12,111,0,114,409,523,32,105,137,660,21,164,South Dakota,Pierre,2078
18333,1976-1977,1976-10-18,1977-04-03,168,0,155,598,753,58,82,140,893,30,221,South Dakota,Pierre,2078
18334,1977-1978,1977-10-10,1978-04-18,191,0,292,702,994,86,421,507,1501,51,429,South Dakota,Pierre,2078
18335,1978-1979,1978-11-10,1979-05-09,181,0,276,745,1021,60,208,268,1289,37,308,South Dakota,Pierre,2078
18336,1979-1980,1979-10-31,1980-03-29,151,0,99,472,571,29,17,46,617,24,169,South Dakota,Pierre,2078
18337,1980-1981,1980-10-18,1981-02-28,134,0,63,311,374,20,30,50,424,13,103,South Dakota,Pierre,2078
18338,1981-1982,1981-10-22,1982-04-21,182,0,197,556,753,79,211,290,1043,38,346,South Dakota,Pierre,2078
18339,1982-1983,1982-11-09,1983-04-13,156,0,45,347,392,18,4,22,414,16,54,South Dakota,Pierre,2078
18340,1983-1984,1983-11-11,1984-04-28,170,1,183,475,658,48,180,228,886,33,254,South Dakota,Pierre,2078
18341,1984-1985,1984-11-01,1985-04-05,156,1,155,581,736,58,222,280,1016,22,208,South Dakota,Pierre,2078
18342,1985-1986,1985-11-08,1986-04-16,160,3,210,556,766,116,484,600,1366,44,401,South Dakota,Pierre,2078
18343,1986-1987,1986-10-11,1987-04-10,182,0,49,393,442,58,133,191,633,22,122,South Dakota,Pierre,2078
18344,1987-1988,1987-12-01,1988-04-25,147,0,134,510,644,30,112,142,786,16,138,South Dakota,Pierre,2078
18345,1988-1989,1988-11-05,1989-04-30,177,0,176,570,746,62,224,286,1032,29,284,South Dakota,Pierre,2078
18346,1989-1990,1989-10-29,1990-04-29,183,0,123,476,599,52,93,145,744,27,216,South Dakota,Pierre,2078
18347,1990-1991,1990-10-06,1991-04-19,196,0,141,536,677,57,164,221,898,26,223,South Dakota,Pierre,2078
18348,1991-1992,1991-10-28,1992-04-20,176,0,64,369,433,28,57,85,518,19,118,South Dakota,Pierre,2078
18349,1992-1993,1992-11-01,1993-04-07,158,1,174,567,741,50,145,195,936,34,257,South Dakota,Pierre,2078
18350,1993-1994,1993-10-29,1994-04-28,182,0,186,590,776,80,287,367,1143,44,402,South Dakota,Pierre,2078
18351,1994-1995,1994-11-17,1995-04-19,154,5,123,451,574,70,165,235,809,33,230,South Dakota,Pierre,2078
18352,1995-1996,1995-10-22,1996-04-14,176,0,211,626,837,52,153,205,1042,32,257,South Dakota,Pierre,2078
18353,1996-1997,1996-11-10,1997-04-14,156,10,236,635,871,114,716,830,1701,37,369,South Dakota,Pierre,2078
18354,1997-1998,1997-11-11,1998-03-30,140,3,82,374,456,36,103,139,595,25,151,South Dakota,Pierre,2078
18355,1998-1999,1998-11-06,1999-04-03,149,3,69,353,422,51,89,140,562,22,189,South Dakota,Pierre,2078
18356,1999-2000,1999-10-01,2000-04-16,199,0,43,372,415,30,28,58,473,18,97,South Dakota,Pierre,2078
18357,2009-2010,2009-10-11,2010-03-12,153,0,220,537,757,62,534,596,1353,29,259,South Dakota,Pierre,2078
18358,2011-2012,2011-11-19,2012-03-05,108,0,51,352,403,38,64,102,505,14,109,South Dakota,Pierre,2078
18359,2012-2013,2012-11-10,2013-04-22,164,0,122,536,658,77,185,262,920,31,232,South Dakota,Pierre,2078
18360,2013-2014,2013-10-28,2014-04-05,160,0,204,656,860,57,243,300,1160,30,295,South Dakota,Pierre,2078
18361,2014-2015,2014-11-09,2015-03-26,138,0,125,532,657,39,197,236,893,17,160,South Dakota,Pierre,2078
18362,2015-2016,2015-11-26,2016-03-19,115,0,78,315,393,44,220,264,657,22,151,South Dakota,Pierre,2078
18363,2016-2017,2016-11-17,2017-03-22,126,1,168,445,613,53,314,367,980,27,231,South Dakota,Pierre,2078
18364,2017-2018,2017-11-09,2018-04-18,161,0,167,600,767,69,189,258,1025,24,232,South Dakota,Pierre,2078
18365,2018-2019,2018-11-07,2019-04-17,162,5,196,585,781,93,499,592,1373,32,345,South Dakota,Pierre,2078
18366,2019-2020,2019-10-10,2020-04-12,186,0,102,496,598,62,203,265,863,32,191,South Dakota,Pierre,2078
18367,1950-1951,1950-10-01,1951-06-01,244,11,122,608,730,39,36,75,805,24,152,South Dakota,Rapid,3633
18368,1951-1952,1951-10-17,1952-04-03,170,0,145,590,735,46,114,160,895,34,224,South Dakota,Rapid,3633
18369,1952-1953,1952-11-24,1953-05-13,171,0,50,398,448,76,188,264,712,32,197,South Dakota,Rapid,3633
18370,1953-1954,1953-11-06,1954-05-02,178,0,74,428,502,55,70,125,627,29,166,South Dakota,Rapid,3633
18371,1954-1955,1954-10-24,1955-04-06,165,0,88,464,552,71,117,188,740,36,240,South Dakota,Rapid,3633
18372,1955-1956,1955-10-22,1956-04-30,192,0,146,605,751,71,155,226,977,45,328,South Dakota,Rapid,3633
18373,1956-1957,1956-10-29,1957-04-17,171,0,140,547,687,78,170,248,935,43,331,South Dakota,Rapid,3633
18374,1957-1958,1957-10-24,1958-04-26,185,0,69,392,461,58,89,147,608,36,203,South Dakota,Rapid,3633
18375,1958-1959,1958-11-14,1959-04-22,160,0,112,492,604,60,74,134,738,37,251,South Dakota,Rapid,3633
18376,1959-1960,1959-11-04,1960-04-28,177,0,138,525,663,68,179,247,910,40,313,South Dakota,Rapid,3633
18377,1960-1961,1960-11-07,1961-04-24,169,0,56,402,458,38,79,117,575,24,135,South Dakota,Rapid,3633
18378,1961-1962,1961-09-29,1962-04-11,195,0,158,570,728,53,150,203,931,34,274,South Dakota,Rapid,3633
18379,1962-1963,1962-11-16,1963-04-22,158,0,111,460,571,82,128,210,781,47,364,South Dakota,Rapid,3633
18380,1963-1964,1963-11-21,1964-04-19,151,0,80,432,512,49,70,119,631,37,226,South Dakota,Rapid,3633
18381,1964-1965,1964-11-18,1965-05-09,173,0,138,595,733,68,129,197,930,47,349,South Dakota,Rapid,3633
18382,1965-1966,1965-09-15,1966-05-11,239,0,135,552,687,71,169,240,927,35,245,South Dakota,Rapid,3633
18383,1966-1967,1966-10-13,1967-05-12,212,0,88,452,540,85,133,218,758,46,281,South Dakota,Rapid,3633
18384,1967-1968,1967-11-01,1968-04-22,174,0,95,488,583,55,96,151,734,32,215,South Dakota,Rapid,3633
18385,1968-1969,1968-11-05,1969-06-13,221,0,148,563,711,59,108,167,878,41,243,South Dakota,Rapid,3633
18386,1969-1970,1969-10-11,1970-04-26,198,0,102,531,633,107,236,343,976,41,295,South Dakota,Rapid,3633
18387,1970-1971,1970-09-13,1971-04-27,227,0,150,565,715,107,233,340,1055,52,312,South Dakota,Rapid,3633
18388,1971-1972,1971-10-27,1972-04-18,175,0,121,585,706,61,68,129,835,39,293,South Dakota,Rapid,3633
18389,1972-1973,1972-10-30,1973-04-14,167,0,128,480,608,60,127,187,795,32,257,South Dakota,Rapid,3633
18390,1973-1974,1973-10-11,1974-04-13,185,0,110,468,578,51,53,104,682,30,178,South Dakota,Rapid,3633
18391,1974-1975,1974-11-13,1975-04-29,168,0,104,525,629,79,186,265,894,39,274,South Dakota,Rapid,3633
18392,1975-1976,1975-10-22,1976-04-27,189,0,100,425,525,70,154,224,749,33,248,South Dakota,Rapid,3633
18393,1976-1977,1976-10-18,1977-04-08,173,0,103,524,627,87,162,249,876,44,307,South Dakota,Rapid,3633
18394,1977-1978,1977-10-09,1978-04-18,192,0,211,588,799,74,225,299,1098,41,337,South Dakota,Rapid,3633
18395,1978-1979,1978-11-09,1979-05-10,183,0,227,686,913,56,250,306,1219,40,287,South Dakota,Rapid,3633
18396,1979-1980,1979-11-09,1980-04-12,156,0,91,465,556,51,48,99,655,33,204,South Dakota,Rapid,3633
18397,1980-1981,1980-10-16,1981-02-28,136,0,55,293,348,31,52,83,431,20,140,South Dakota,Rapid,3633
18398,1981-1982,1981-10-20,1982-04-20,183,0,160,579,739,58,88,146,885,35,289,South Dakota,Rapid,3633
18399,1982-1983,1982-10-09,1983-05-12,216,0,32,354,386,45,39,84,470,31,116,South Dakota,Rapid,3633
18400,1983-1984,1983-09-19,1984-05-01,226,0,144,499,643,80,187,267,910,43,279,South Dakota,Rapid,3633
18401,1984-1985,1984-09-23,1985-04-26,216,0,112,575,687,58,103,161,848,35,254,South Dakota,Rapid,3633
18402,1985-1986,1985-09-27,1986-04-26,212,0,172,542,714,119,428,547,1261,53,393,South Dakota,Rapid,3633
18403,1986-1987,1986-11-06,1987-04-02,148,0,51,374,425,69,121,190,615,30,187,South Dakota,Rapid,3633
18404,1987-1988,1987-10-09,1988-04-26,201,0,81,535,616,47,98,145,761,22,156,South Dakota,Rapid,3633
18405,1988-1989,1988-11-09,1989-04-30,173,0,143,529,672,58,108,166,838,36,279,South Dakota,Rapid,3633
18406,1989-1990,1989-10-29,1990-05-09,193,0,93,464,557,68,133,201,758,43,258,South Dakota,Rapid,3633
18407,1990-1991,1990-10-07,1991-05-03,209,0,116,531,647,70,109,179,826,39,274,South Dakota,Rapid,3633
18408,1991-1992,1991-10-04,1992-04-20,200,0,44,373,417,47,71,118,535,26,133,South Dakota,Rapid,3633
18409,1992-1993,1992-10-07,1993-04-30,206,0,159,610,769,91,399,490,1259,51,369,South Dakota,Rapid,3633
18410,1993-1994,1993-10-08,1994-04-30,205,0,107,502,609,83,155,238,847,42,323,South Dakota,Rapid,3633
18411,1994-1995,1994-11-02,1995-04-30,180,0,77,411,488,58,87,145,633,30,171,South Dakota,Rapid,3633
18412,1998-1999,1998-11-03,1999-04-03,152,0,61,395,456,67,83,150,606,19,134,South Dakota,Rapid,3633
18413,1999-2000,1999-11-18,2000-04-21,156,0,26,358,384,46,38,84,468,13,85,South Dakota,Rapid,3633
18414,2004-2005,2004-11-23,2005-05-13,172,6,75,393,468,55,86,141,609,24,185,South Dakota,Rapid,3633
18415,2005-2006,2005-10-04,2006-04-25,204,4,79,402,481,58,114,172,653,23,155,South Dakota,Rapid,3633
18416,2006-2007,2006-10-11,2007-04-12,184,0,75,503,578,40,51,91,669,24,163,South Dakota,Rapid,3633
18417,2007-2008,2007-11-21,2008-05-03,165,0,71,533,604,75,101,176,780,38,241,South Dakota,Rapid,3633
18418,2008-2009,2008-11-05,2009-04-26,173,0,117,543,660,121,168,289,949,37,349,South Dakota,Rapid,3633
18419,2009-2010,2009-10-07,2010-05-12,218,0,134,541,675,64,136,200,875,37,257,South Dakota,Rapid,3633
18420,2010-2011,2010-11-17,2011-04-19,154,0,155,567,722,107,211,318,1040,48,437,South Dakota,Rapid,3633
18421,2011-2012,2011-11-09,2012-03-04,117,0,36,385,421,46,39,85,506,27,160,South Dakota,Rapid,3633
18422,2012-2013,2012-10-24,2013-04-25,184,0,74,541,615,110,132,242,857,33,273,South Dakota,Rapid,3633
18423,2013-2014,2013-10-04,2014-05-07,216,0,145,621,766,98,111,209,975,41,357,South Dakota,Rapid,3633
18424,2014-2015,2014-11-10,2015-05-11,183,0,98,500,598,72,101,173,771,28,259,South Dakota,Rapid,3633
18425,2015-2016,2015-11-20,2016-04-28,161,0,54,372,426,52,78,130,556,23,142,South Dakota,Rapid,3633
18426,2016-2017,2016-11-17,2017-04-26,161,0,120,483,603,54,187,241,844,27,231,South Dakota,Rapid,3633
18427,2017-2018,2017-11-06,2018-04-16,162,0,139,612,751,89,150,239,990,34,319,South Dakota,Rapid,3633
18428,1950-1951,1950-10-02,1951-06-02,244,16,97,522,619,47,42,89,708,30,194,South Dakota,Rapid,3633
18429,1951-1952,1951-10-20,1952-03-24,157,2,108,490,598,42,110,152,750,31,224,South Dakota,Rapid,3633
18430,1952-1953,1952-11-21,1953-05-01,162,1,33,305,338,70,152,222,560,29,169,South Dakota,Rapid,3633
18431,1953-1954,1953-11-06,1954-05-01,177,0,64,363,427,55,61,116,543,31,192,South Dakota,Rapid,3633
18432,1954-1955,1954-10-25,1955-04-04,162,1,64,393,457,68,78,146,603,29,180,South Dakota,Rapid,3633
18433,1955-1956,1955-09-25,1956-04-29,218,3,131,506,637,72,141,213,850,38,267,South Dakota,Rapid,3633
18434,1956-1957,1956-10-29,1957-04-17,171,0,119,470,589,83,140,223,812,40,308,South Dakota,Rapid,3633
18435,1957-1958,1957-10-25,1958-04-25,183,1,65,343,408,68,66,134,542,34,197,South Dakota,Rapid,3633
18436,1958-1959,1958-11-14,1959-05-20,188,1,102,418,520,67,69,136,656,36,235,South Dakota,Rapid,3633
18437,1959-1960,1959-10-01,1960-04-30,213,8,130,456,586,78,178,256,842,37,280,South Dakota,Rapid,3633
18438,1960-1961,1960-11-03,1961-04-14,163,1,45,313,358,38,45,83,441,21,126,South Dakota,Rapid,3633
18439,1961-1962,1961-09-29,1962-04-11,195,0,135,508,643,62,134,196,839,39,299,South Dakota,Rapid,3633
18440,1962-1963,1962-11-16,1963-04-22,158,0,91,377,468,83,119,202,670,36,272,South Dakota,Rapid,3633
18441,1964-1965,1964-11-15,1965-05-09,176,1,114,522,636,67,117,184,820,39,283,South Dakota,Rapid,3633
18442,1965-1966,1965-09-16,1966-04-21,218,3,114,445,559,69,152,221,780,29,249,South Dakota,Rapid,3633
18443,1966-1967,1966-10-14,1967-05-12,211,1,70,396,466,83,113,196,662,44,279,South Dakota,Rapid,3633
18444,1967-1968,1967-11-02,1968-04-22,173,0,78,395,473,56,82,138,611,30,206,South Dakota,Rapid,3633
18445,1968-1969,1968-11-05,1969-06-13,221,0,134,476,610,71,100,171,781,45,281,South Dakota,Rapid,3633
18446,1969-1970,1969-10-12,1970-04-23,194,1,89,417,506,119,173,292,798,39,295,South Dakota,Rapid,3633
18447,1970-1971,1970-09-13,1971-04-26,226,1,128,457,585,102,234,336,921,40,265,South Dakota,Rapid,3633
18448,1971-1972,1971-10-28,1972-04-02,158,0,97,462,559,52,77,129,688,28,204,South Dakota,Rapid,3633
18449,1996-1997,1996-10-16,1997-04-13,180,4,192,551,743,84,166,250,993,36,311,South Dakota,Rapid,3633
18450,1997-1998,1997-10-13,1998-06-03,234,0,92,365,457,66,70,136,593,32,224,South Dakota,Rapid,3633
18451,1998-1999,1998-11-02,1999-04-04,154,3,64,311,375,84,96,180,555,28,205,South Dakota,Rapid,3633
18452,1999-2000,1999-10-01,2000-04-21,204,3,25,265,290,67,39,106,396,28,150,South Dakota,Rapid,3633
18453,2000-2001,2000-09-22,2001-04-23,214,0,136,481,617,95,159,254,871,35,280,South Dakota,Rapid,3633
18454,2001-2002,2001-11-18,2002-05-11,175,1,95,393,488,60,121,181,669,25,187,South Dakota,Rapid,3633
18455,2002-2003,2002-10-22,2003-04-07,168,0,85,397,482,66,84,150,632,42,301,South Dakota,Rapid,3633
18456,2003-2004,2003-10-30,2004-04-29,183,0,98,372,470,81,141,222,692,33,258,South Dakota,Rapid,3633
18457,2004-2005,2004-11-23,2005-05-13,172,1,77,335,412,59,77,136,548,30,204,South Dakota,Rapid,3633
18458,2005-2006,2005-10-04,2006-04-24,203,0,84,312,396,71,110,181,577,26,185,South Dakota,Rapid,3633
18459,2006-2007,2006-10-11,2007-04-11,183,0,79,408,487,47,49,96,583,26,181,South Dakota,Rapid,3633
18460,2007-2008,2007-11-20,2008-05-02,165,0,74,430,504,83,95,178,682,42,264,South Dakota,Rapid,3633
18461,2008-2009,2008-10-12,2009-04-26,197,0,112,467,579,125,144,269,848,41,332,South Dakota,Rapid,3633
18462,2009-2010,2009-10-05,2010-05-12,220,0,132,445,577,60,113,173,750,35,248,South Dakota,Rapid,3633
18463,2010-2011,2010-11-16,2011-04-19,155,0,168,492,660,94,169,263,923,46,386,South Dakota,Rapid,3633
18464,2011-2012,2011-11-16,2012-03-02,108,0,43,272,315,40,31,71,386,24,127,South Dakota,Rapid,3633
18465,2012-2013,2012-10-24,2013-04-24,183,4,81,404,485,108,118,226,711,38,293,South Dakota,Rapid,3633
18466,2013-2014,2013-10-04,2014-05-07,216,0,151,548,699,121,120,241,940,58,460,South Dakota,Rapid,3633
18467,2014-2015,2014-09-11,2015-05-11,243,3,95,393,488,76,94,170,658,33,264,South Dakota,Rapid,3633
18468,2015-2016,2015-11-20,2016-04-27,160,0,52,261,313,60,81,141,454,26,146,South Dakota,Rapid,3633
18469,2016-2017,2016-11-17,2017-04-26,161,0,119,371,490,62,157,219,709,30,246,South Dakota,Rapid,3633
18470,2017-2018,2017-11-02,2018-04-14,164,0,138,476,614,101,135,236,850,45,360,South Dakota,Rapid,3633
18471,2018-2019,2018-10-08,2019-05-22,227,0,168,497,665,126,212,338,1003,58,424,South Dakota,Rapid,3633
18472,2019-2020,2019-10-09,2020-04-19,194,0,61,389,450,125,137,262,712,46,285,South Dakota,Rapid,3633
18473,1950-1951,1950-11-08,1951-04-12,156,0,191,672,863,85,324,409,1272,31,294,South Dakota,Sioux Falls,153888
18474,1951-1952,1951-10-18,1952-04-12,178,0,187,675,862,96,427,523,1385,40,329,South Dakota,Sioux Falls,153888
18475,1952-1953,1952-11-24,1953-04-25,153,0,109,499,608,70,256,326,934,33,248,South Dakota,Sioux Falls,153888
18476,1953-1954,1953-11-20,1954-05-02,164,0,122,516,638,60,264,324,962,25,177,South Dakota,Sioux Falls,153888
18477,1954-1955,1954-11-01,1955-03-27,147,0,137,537,674,53,206,259,933,27,227,South Dakota,Sioux Falls,153888
18478,1955-1956,1955-10-23,1956-04-29,190,0,234,805,1039,94,499,593,1632,38,351,South Dakota,Sioux Falls,153888
18479,1956-1957,1956-11-15,1957-04-11,148,0,145,574,719,64,147,211,930,20,186,South Dakota,Sioux Falls,153888
18480,1957-1958,1957-10-25,1958-03-19,146,0,92,465,557,22,51,73,630,13,69,South Dakota,Sioux Falls,153888
18481,1958-1959,1958-11-17,1959-04-11,146,0,179,618,797,48,147,195,992,24,210,South Dakota,Sioux Falls,153888
18482,1959-1960,1959-10-08,1960-04-04,180,0,209,652,861,87,509,596,1457,29,257,South Dakota,Sioux Falls,153888
18483,1960-1961,1960-11-09,1961-03-21,133,0,124,493,617,48,214,262,879,17,141,South Dakota,Sioux Falls,153888
18484,1961-1962,1961-11-02,1962-04-12,162,0,223,652,875,119,532,651,1526,42,414,South Dakota,Sioux Falls,153888
18485,1962-1963,1962-10-24,1963-04-22,181,0,184,565,749,41,176,217,966,23,203,South Dakota,Sioux Falls,153888
18486,1963-1964,1963-12-01,1964-03-29,120,0,133,517,650,40,103,143,793,18,138,South Dakota,Sioux Falls,153888
18487,1964-1965,1964-11-19,1965-04-17,150,0,226,729,955,75,260,335,1290,32,325,South Dakota,Sioux Falls,153888
18488,1965-1966,1965-11-26,1966-04-20,146,0,184,569,753,29,92,121,874,22,236,South Dakota,Sioux Falls,153888
18489,1966-1967,1966-10-14,1967-05-01,200,0,124,644,768,48,211,259,1027,26,248,South Dakota,Sioux Falls,153888
18490,1967-1968,1967-10-26,1968-05-18,206,0,124,586,710,23,36,59,769,20,129,South Dakota,Sioux Falls,153888
18491,1968-1969,1968-10-18,1969-04-07,172,0,229,671,900,139,977,1116,2016,48,460,South Dakota,Sioux Falls,153888
18492,1969-1970,1969-11-02,1970-04-22,172,0,198,688,886,75,404,479,1365,35,280,South Dakota,Sioux Falls,153888
18493,1970-1971,1970-10-08,1971-04-01,176,0,218,637,855,38,317,355,1210,18,140,South Dakota,Sioux Falls,153888
18494,1971-1972,1971-11-06,1972-04-03,150,0,199,689,888,48,449,497,1385,26,228,South Dakota,Sioux Falls,153888
18495,1972-1973,1972-10-18,1973-03-28,162,0,158,466,624,36,133,169,793,19,114,South Dakota,Sioux Falls,153888
18496,1973-1974,1973-11-08,1974-04-04,148,0,159,545,704,47,234,281,985,27,237,South Dakota,Sioux Falls,153888
18497,1974-1975,1974-11-13,1975-04-05,144,0,144,569,713,68,342,410,1123,36,232,South Dakota,Sioux Falls,153888
18498,1975-1976,1975-11-19,1976-05-02,166,0,138,480,618,59,384,443,1061,27,197,South Dakota,Sioux Falls,153888
18499,1976-1977,1976-10-18,1977-03-21,155,0,189,683,872,49,103,152,1024,25,204,South Dakota,Sioux Falls,153888
18500,1977-1978,1977-10-10,1978-04-18,191,0,307,735,1042,65,364,429,1471,40,335,South Dakota,Sioux Falls,153888
18501,1978-1979,1978-11-11,1979-04-05,146,0,307,764,1071,85,520,605,1676,43,388,South Dakota,Sioux Falls,153888
18502,1979-1980,1979-11-05,1980-03-29,146,0,131,490,621,57,150,207,828,34,211,South Dakota,Sioux Falls,153888
18503,1980-1981,1980-10-18,1981-04-04,169,0,105,488,593,19,31,50,643,14,99,South Dakota,Sioux Falls,153888
18504,1981-1982,1981-10-24,1982-04-09,168,0,219,631,850,75,367,442,1292,41,369,South Dakota,Sioux Falls,153888
18505,1982-1983,1982-10-19,1983-04-18,182,0,103,445,548,109,410,519,1067,39,236,South Dakota,Sioux Falls,153888
18506,1983-1984,1983-11-09,1984-04-30,174,0,236,607,843,117,548,665,1508,46,374,South Dakota,Sioux Falls,153888
18507,1984-1985,1984-11-10,1985-04-08,150,0,146,542,688,51,116,167,855,28,180,South Dakota,Sioux Falls,153888
18508,1985-1986,1985-09-28,1986-04-15,200,0,224,643,867,79,562,641,1508,36,271,South Dakota,Sioux Falls,153888
18509,1986-1987,1986-11-09,1987-03-28,140,0,55,407,462,17,26,43,505,11,72,South Dakota,Sioux Falls,153888
18510,1987-1988,1987-10-20,1988-04-26,190,0,167,594,761,85,446,531,1292,31,251,South Dakota,Sioux Falls,153888
18511,1988-1989,1988-11-11,1989-04-18,159,0,158,584,742,68,118,186,928,37,317,South Dakota,Sioux Falls,153888
18512,1989-1990,1989-11-01,1990-03-23,143,0,124,520,644,25,41,66,710,17,115,South Dakota,Sioux Falls,153888
18513,1990-1991,1990-10-17,1991-03-27,162,0,152,548,700,54,180,234,934,33,257,South Dakota,Sioux Falls,153888
18514,1991-1992,1991-10-18,1992-04-22,188,0,83,422,505,73,157,230,735,28,182,South Dakota,Sioux Falls,153888
18515,1992-1993,1992-11-01,1993-04-14,165,0,186,587,773,75,369,444,1217,37,289,South Dakota,Sioux Falls,153888
18516,1993-1994,1993-10-30,1994-04-30,183,0,223,646,869,88,373,461,1330,42,393,South Dakota,Sioux Falls,153888
18517,1994-1995,1994-11-18,1995-04-14,148,0,141,460,601,57,271,328,929,22,158,South Dakota,Sioux Falls,153888
18518,1995-1996,1995-10-23,1996-04-12,173,0,196,607,803,66,124,190,993,37,282,South Dakota,Sioux Falls,153888
18519,1996-1997,1996-10-30,1997-04-13,166,0,283,726,1009,101,758,859,1868,47,446,South Dakota,Sioux Falls,153888
18520,1997-1998,1997-10-13,1998-04-02,172,0,116,455,571,82,147,229,800,46,250,South Dakota,Sioux Falls,153888
18521,1998-1999,1998-11-07,1999-04-16,161,0,123,464,587,86,202,288,875,32,294,South Dakota,Sioux Falls,153888
18522,1999-2000,1999-10-01,2000-04-16,199,0,75,494,569,36,76,112,681,19,136,South Dakota,Sioux Falls,153888
18523,2000-2001,2000-11-06,2001-04-23,169,0,252,711,963,94,631,725,1688,45,389,South Dakota,Sioux Falls,153888
18524,2001-2002,2001-11-26,2002-04-27,153,0,104,447,551,71,123,194,745,29,215,South Dakota,Sioux Falls,153888
18525,2002-2003,2002-10-16,2003-04-09,176,0,135,566,701,56,62,118,819,32,219,South Dakota,Sioux Falls,153888
18526,2003-2004,2003-10-26,2004-03-17,144,0,141,471,612,85,291,376,988,34,281,South Dakota,Sioux Falls,153888
18527,2004-2005,2004-11-29,2005-03-25,117,0,110,407,517,46,96,142,659,21,164,South Dakota,Sioux Falls,153888
18528,2005-2006,2005-11-15,2006-03-23,129,0,102,391,493,57,162,219,712,28,193,South Dakota,Sioux Falls,153888
18529,2006-2007,2006-10-11,2007-04-13,185,0,148,533,681,65,244,309,990,31,241,South Dakota,Sioux Falls,153888
18530,2007-2008,2007-11-21,2008-04-26,158,0,181,603,784,68,442,510,1294,33,248,South Dakota,Sioux Falls,153888
18531,2008-2009,2008-11-06,2009-04-25,171,0,162,587,749,59,176,235,984,33,250,South Dakota,Sioux Falls,153888
18532,2009-2010,2009-10-09,2010-03-15,158,0,201,553,754,88,657,745,1499,36,300,South Dakota,Sioux Falls,153888
18533,2010-2011,2010-11-20,2011-04-17,149,0,211,602,813,69,404,473,1286,35,280,South Dakota,Sioux Falls,153888
18534,2011-2012,2011-11-19,2012-03-04,107,0,55,341,396,33,65,98,494,21,117,South Dakota,Sioux Falls,153888
18535,2012-2013,2012-10-25,2013-05-01,189,0,132,572,704,64,166,230,934,30,197,South Dakota,Sioux Falls,153888
18536,2013-2014,2013-10-22,2014-04-17,178,0,237,752,989,73,249,322,1311,42,353,South Dakota,Sioux Falls,153888
18537,2014-2015,2014-11-10,2015-03-05,116,0,162,505,667,52,157,209,876,24,196,South Dakota,Sioux Falls,153888
18538,2015-2016,2015-11-20,2016-03-28,130,0,108,382,490,102,321,423,913,32,249,South Dakota,Sioux Falls,153888
18539,2016-2017,2016-11-18,2017-05-01,165,0,114,388,502,66,114,180,682,26,192,South Dakota,Sioux Falls,153888
18540,2017-2018,2017-11-06,2018-04-20,166,0,182,576,758,103,219,322,1080,38,322,South Dakota,Sioux Falls,153888
18541,2018-2019,2018-10-14,2019-04-27,196,0,195,576,771,83,291,374,1145,44,355,South Dakota,Sioux Falls,153888
18542,2019-2020,2019-10-12,2020-04-15,187,0,96,475,571,59,204,263,834,29,181,South Dakota,Sioux Falls,153888
18543,1950-1951,1950-11-09,1951-04-11,154,0,293,813,1106,47,319,366,1472,25,257,South Dakota,Watertown,21482
18544,1951-1952,1951-10-21,1952-04-09,172,0,277,795,1072,58,546,604,1676,37,342,South Dakota,Watertown,21482
18545,1952-1953,1952-11-09,1953-05-12,185,0,178,615,793,69,306,375,1168,36,319,South Dakota,Watertown,21482
18546,1953-1954,1953-11-20,1954-05-03,165,0,190,614,804,76,346,422,1226,31,260,South Dakota,Watertown,21482
18547,1954-1955,1954-11-01,1955-03-26,146,0,186,632,818,31,153,184,1002,21,213,South Dakota,Watertown,21482
18548,1955-1956,1955-11-02,1956-04-04,155,0,310,870,1180,76,544,620,1800,32,327,South Dakota,Watertown,21482
18549,1956-1957,1956-11-14,1957-04-11,149,2,200,676,876,48,131,179,1055,23,249,South Dakota,Watertown,21482
18550,1957-1958,1957-10-24,1958-04-06,165,0,151,568,719,22,54,76,795,14,91,South Dakota,Watertown,21482
18551,1958-1959,1958-11-17,1959-04-11,146,0,254,724,978,50,325,375,1353,20,227,South Dakota,Watertown,21482
18552,1959-1960,1959-10-12,1960-04-04,176,0,254,758,1012,60,465,525,1537,31,261,South Dakota,Watertown,21482
18553,1960-1961,1960-11-09,1961-04-15,158,1,173,633,806,31,151,182,988,13,109,South Dakota,Watertown,21482
18554,1961-1962,1961-11-02,1962-04-08,158,1,277,753,1030,72,445,517,1547,30,319,South Dakota,Watertown,21482
18555,1962-1963,1962-11-16,1963-04-23,159,2,220,664,884,44,142,186,1070,22,207,South Dakota,Watertown,21482
18556,1963-1964,1963-11-13,1964-04-07,147,0,185,675,860,35,151,186,1046,15,120,South Dakota,Watertown,21482
18557,1964-1965,1964-11-19,1965-04-04,137,0,321,863,1184,60,456,516,1700,25,279,South Dakota,Watertown,21482
18558,1965-1966,1965-11-13,1966-05-11,180,0,237,704,941,35,108,143,1084,15,134,South Dakota,Watertown,21482
18559,1966-1967,1966-11-01,1967-04-01,152,0,202,714,916,49,227,276,1192,19,206,South Dakota,Watertown,21482
18560,1967-1968,1967-10-27,1968-04-14,171,0,194,686,880,22,93,115,995,10,71,South Dakota,Watertown,21482
18561,1968-1969,1968-11-06,1969-04-08,154,0,301,750,1051,85,994,1079,2130,36,326,South Dakota,Watertown,21482
18562,1969-1970,1969-10-31,1970-04-23,175,0,237,738,975,53,309,362,1337,29,224,South Dakota,Watertown,21482
18563,1970-1971,1970-10-07,1971-03-24,169,1,262,737,999,49,219,268,1267,29,219,South Dakota,Watertown,21482
18564,1971-1972,1971-10-28,1972-04-07,163,0,282,789,1071,45,489,534,1605,25,211,South Dakota,Watertown,21482
18565,1972-1973,1972-10-17,1973-02-28,135,0,202,550,752,29,197,226,978,19,170,South Dakota,Watertown,21482
18566,1973-1974,1973-11-04,1974-04-03,151,0,242,688,930,32,304,336,1266,19,174,South Dakota,Watertown,21482
18567,1974-1975,1974-11-13,1975-04-11,150,0,201,690,891,80,472,552,1443,34,307,South Dakota,Watertown,21482
18568,1975-1976,1975-11-11,1976-03-15,126,0,190,586,776,57,377,434,1210,32,252,South Dakota,Watertown,21482
18569,1976-1977,1976-10-18,1977-04-04,169,0,264,756,1020,50,277,327,1347,31,255,South Dakota,Watertown,21482
18570,1977-1978,1977-10-08,1978-04-17,192,3,385,857,1242,80,761,841,2083,43,390,South Dakota,Watertown,21482
18571,1978-1979,1978-11-11,1979-05-09,180,0,380,902,1282,79,743,822,2104,48,469,South Dakota,Watertown,21482
18572,1979-1980,1979-10-21,1980-04-08,171,1,177,653,830,49,139,188,1018,37,266,South Dakota,Watertown,21482
18573,1980-1981,1980-10-18,1981-03-06,140,0,146,508,654,21,51,72,726,18,176,South Dakota,Watertown,21482
18574,1981-1982,1981-10-22,1982-04-09,170,6,311,780,1091,63,366,429,1520,46,420,South Dakota,Watertown,21482
18575,1982-1983,1982-10-19,1983-04-18,182,0,118,518,636,62,79,141,777,32,179,South Dakota,Watertown,21482
18576,1983-1984,1983-11-08,1984-04-28,173,1,288,684,972,67,396,463,1435,45,367,South Dakota,Watertown,21482
18577,1984-1985,1984-10-30,1985-04-06,159,0,210,677,887,59,314,373,1260,29,232,South Dakota,Watertown,21482
18578,1985-1986,1985-11-08,1986-03-27,140,9,261,707,968,66,728,794,1762,36,348,South Dakota,Watertown,21482
18579,1986-1987,1986-11-09,1987-03-29,141,0,74,434,508,34,59,93,601,16,109,South Dakota,Watertown,21482
18580,1987-1988,1987-10-20,1988-04-26,190,3,191,612,803,40,109,149,952,24,188,South Dakota,Watertown,21482
18581,1988-1989,1988-11-12,1989-04-18,158,0,204,683,887,71,290,361,1248,33,308,South Dakota,Watertown,21482
18582,1989-1990,1989-11-02,1990-04-30,180,0,156,637,793,30,21,51,844,24,191,South Dakota,Watertown,21482
18583,1990-1991,1990-10-17,1991-03-29,164,1,182,603,785,36,144,180,965,24,197,South Dakota,Watertown,21482
18584,1991-1992,1991-10-30,1992-04-24,178,0,108,505,613,35,102,137,750,21,157,South Dakota,Watertown,21482
18585,1992-1993,1992-10-15,1993-04-14,182,0,263,711,974,57,520,577,1551,38,249,South Dakota,Watertown,21482
18586,1993-1994,1993-10-30,1994-04-29,182,0,314,758,1072,87,696,783,1855,42,449,South Dakota,Watertown,21482
18587,1994-1995,1994-11-18,1995-04-14,148,0,188,533,721,59,339,398,1119,31,232,South Dakota,Watertown,21482
18588,1995-1996,1995-09-21,1996-04-12,205,3,274,754,1028,69,397,466,1494,33,292,South Dakota,Watertown,21482
18589,2001-2002,2001-11-26,2002-04-27,153,0,155,528,683,59,220,279,962,20,139,South Dakota,Watertown,21482
18590,2002-2003,2002-10-16,2003-04-04,171,1,206,665,871,52,172,224,1095,23,178,South Dakota,Watertown,21482
18591,2003-2004,2003-10-27,2004-04-11,168,0,199,601,800,75,348,423,1223,26,236,South Dakota,Watertown,21482
18592,2004-2005,2004-11-27,2005-03-18,112,0,155,481,636,19,59,78,714,11,103,South Dakota,Watertown,21482
18593,2005-2006,2005-11-16,2006-03-21,126,0,161,457,618,52,304,356,974,19,134,South Dakota,Watertown,21482
18594,2006-2007,2006-10-11,2007-04-13,185,0,196,631,827,72,286,358,1185,17,149,South Dakota,Watertown,21482
18595,2008-2009,2008-11-06,2009-04-25,171,0,269,779,1048,78,555,633,1681,24,240,South Dakota,Watertown,21482
18596,2009-2010,2009-10-09,2010-03-25,168,3,258,637,895,83,772,855,1750,29,254,South Dakota,Watertown,21482
18597,2010-2011,2010-10-27,2011-04-16,172,9,325,792,1117,118,913,1031,2148,35,369,South Dakota,Watertown,21482
18598,2011-2012,2011-11-16,2012-03-10,116,3,92,429,521,29,112,141,662,13,99,South Dakota,Watertown,21482
18599,2012-2013,2012-10-24,2013-04-25,184,5,218,722,940,76,724,800,1740,32,227,South Dakota,Watertown,21482
18600,2013-2014,2013-10-22,2014-04-17,178,0,320,881,1201,51,489,540,1741,34,330,South Dakota,Watertown,21482
18601,2014-2015,2014-11-09,2015-03-22,134,0,226,605,831,42,261,303,1134,23,201,South Dakota,Watertown,21482
18602,2015-2016,2015-11-20,2016-03-26,128,0,123,409,532,47,306,353,885,24,173,South Dakota,Watertown,21482
18603,2016-2017,2016-11-17,2017-05-01,166,0,189,543,732,61,420,481,1213,26,240,South Dakota,Watertown,21482
18604,2017-2018,2017-11-03,2018-04-18,167,0,233,713,946,80,232,312,1258,35,309,South Dakota,Watertown,21482
18605,2018-2019,2018-11-06,2019-04-18,164,3,311,762,1073,121,835,956,2029,41,485,South Dakota,Watertown,21482
18606,2019-2020,2019-10-10,2020-04-14,188,0,180,643,823,59,726,785,1608,32,222,South Dakota,Watertown,21482
18607,1950-1951,1950-11-24,1951-03-15,112,0,21,166,187,26,23,49,236,17,87,Tennessee,Bristol,26702
18608,1951-1952,1951-11-02,1952-02-29,120,0,6,130,136,11,0,11,147,11,28,Tennessee,Bristol,26702
18609,1952-1953,1952-11-21,1953-04-19,150,0,4,105,109,45,23,68,177,16,72,Tennessee,Bristol,26702
18610,1953-1954,1953-11-25,1954-03-03,99,0,4,133,137,26,13,39,176,9,37,Tennessee,Bristol,26702
18611,1954-1955,1954-11-02,1955-02-28,119,0,13,157,170,36,34,70,240,18,86,Tennessee,Bristol,26702
18612,1955-1956,1955-11-29,1956-02-29,93,0,8,126,134,20,19,39,173,10,38,Tennessee,Bristol,26702
18613,1956-1957,1956-11-23,1957-03-08,106,0,7,91,98,9,0,9,107,7,19,Tennessee,Bristol,26702
18614,1957-1958,1957-11-30,1958-03-20,111,0,29,184,213,27,41,68,281,13,60,Tennessee,Bristol,26702
18615,1958-1959,1958-12-01,1959-03-12,102,0,12,178,190,16,18,34,224,5,29,Tennessee,Bristol,26702
18616,1959-1960,1959-11-28,1960-03-26,120,0,16,175,191,75,89,164,355,22,124,Tennessee,Bristol,26702
18617,1960-1961,1960-11-07,1961-04-03,148,0,16,180,196,27,17,44,240,17,60,Tennessee,Bristol,26702
18618,1961-1962,1961-12-01,1962-04-02,123,0,12,117,129,32,25,57,186,14,59,Tennessee,Bristol,26702
18619,1962-1963,1962-11-05,1963-03-21,137,0,30,224,254,36,25,61,315,16,79,Tennessee,Bristol,26702
18620,1963-1964,1963-11-29,1964-03-30,123,0,23,219,242,58,84,142,384,24,107,Tennessee,Bristol,26702
18621,1964-1965,1964-11-30,1965-03-20,111,0,17,159,176,35,41,76,252,15,75,Tennessee,Bristol,26702
18622,1965-1966,1965-12-01,1966-02-28,90,0,19,163,182,37,80,117,299,13,78,Tennessee,Bristol,26702
18623,1966-1967,1966-11-03,1967-02-28,118,0,10,148,158,26,21,47,205,12,45,Tennessee,Bristol,26702
18624,1967-1968,1967-12-01,1968-03-23,114,0,17,198,215,35,31,66,281,16,66,Tennessee,Bristol,26702
18625,1968-1969,1968-11-09,1969-03-10,122,0,14,204,218,42,41,83,301,17,76,Tennessee,Bristol,26702
18626,1969-1970,1969-11-14,1970-03-24,131,0,29,219,248,44,60,104,352,18,99,Tennessee,Bristol,26702
18627,1970-1971,1970-11-04,1971-03-26,143,0,21,175,196,37,38,75,271,15,65,Tennessee,Bristol,26702
18628,1971-1972,1971-11-23,1972-03-26,125,0,7,119,126,20,8,28,154,10,40,Tennessee,Bristol,26702
18629,1972-1973,1972-11-22,1973-02-28,99,0,12,119,131,13,19,32,163,7,25,Tennessee,Bristol,26702
18630,1973-1974,1973-12-01,1974-02-28,90,0,6,70,76,7,2,9,85,6,19,Tennessee,Bristol,26702
18631,1974-1975,1974-11-14,1975-03-10,117,0,4,112,116,19,4,23,139,14,38,Tennessee,Bristol,26702
18632,1975-1976,1975-12-01,1976-02-29,91,0,9,120,129,6,3,9,138,4,15,Tennessee,Bristol,26702
18633,1976-1977,1976-11-11,1977-03-01,111,0,42,268,310,41,30,71,381,26,115,Tennessee,Bristol,26702
18634,1977-1978,1977-11-27,1978-03-27,121,0,38,251,289,40,63,103,392,24,109,Tennessee,Bristol,26702
18635,1978-1979,1978-12-01,1979-03-27,117,0,19,189,208,42,54,96,304,16,86,Tennessee,Bristol,26702
18636,1979-1980,1979-12-01,1980-03-04,95,0,18,163,181,27,71,98,279,12,60,Tennessee,Bristol,26702
18637,1980-1981,1980-12-01,1981-03-20,110,0,18,209,227,17,14,31,258,10,50,Tennessee,Bristol,26702
18638,1981-1982,1981-11-21,1982-04-08,139,0,24,172,196,23,17,40,236,14,58,Tennessee,Bristol,26702
18639,1982-1983,1982-12-01,1983-04-18,139,0,7,132,139,33,22,55,194,14,53,Tennessee,Bristol,26702
18640,1983-1984,1983-12-01,1984-03-21,112,0,21,168,189,19,8,27,216,15,48,Tennessee,Bristol,26702
18641,1984-1985,1984-12-01,1985-02-28,90,0,24,163,187,26,48,74,261,13,79,Tennessee,Bristol,26702
18642,1985-1986,1985-12-01,1986-02-28,90,0,12,165,177,37,31,68,245,18,86,Tennessee,Bristol,26702
18643,1986-1987,1986-12-01,1987-04-07,128,0,5,125,130,49,47,96,226,20,92,Tennessee,Bristol,26702
18644,1987-1988,1987-11-11,1988-03-16,127,0,15,179,194,15,27,42,236,9,38,Tennessee,Bristol,26702
18645,1988-1989,1988-12-01,1989-02-28,90,0,5,110,115,26,13,39,154,9,38,Tennessee,Bristol,26702
18646,1989-1990,1989-10-20,1990-03-19,151,0,23,152,175,16,12,28,203,12,38,Tennessee,Bristol,26702
18647,1990-1991,1990-12-01,1991-02-28,90,0,3,95,98,3,1,4,102,3,10,Tennessee,Bristol,26702
18648,1991-1992,1991-12-01,1992-04-02,124,0,2,127,129,3,0,3,132,3,7,Tennessee,Bristol,26702
18649,1992-1993,1992-12-01,1993-03-18,108,0,4,115,119,28,25,53,172,9,42,Tennessee,Bristol,26702
18650,1993-1994,1993-10-31,1994-03-03,124,0,16,157,173,16,9,25,198,12,35,Tennessee,Bristol,26702
18651,1994-1995,1994-12-01,1995-03-09,99,0,8,115,123,14,7,21,144,9,31,Tennessee,Bristol,26702
18652,1995-1996,1995-12-01,1996-03-21,112,4,33,202,235,52,101,153,388,10,83,Tennessee,Bristol,26702
18653,1996-1997,1996-11-10,1997-02-28,111,8,13,139,152,4,5,9,161,2,13,Tennessee,Bristol,26702
18654,1997-1998,1997-12-01,1998-03-12,102,10,5,96,101,0,0,0,101,0,0,Tennessee,Bristol,26702
18655,1998-1999,1998-12-01,1999-03-15,105,9,6,111,117,5,7,12,129,3,10,Tennessee,Bristol,26702
18656,1999-2000,1999-12-01,2000-02-29,91,7,10,129,139,11,8,19,158,6,28,Tennessee,Bristol,26702
18657,2000-2001,2000-11-21,2001-03-06,106,8,14,185,199,7,6,13,212,5,17,Tennessee,Bristol,26702
18658,2001-2002,2001-12-01,2002-03-04,94,0,5,125,130,0,0,0,130,0,0,Tennessee,Bristol,26702
18659,2002-2003,2002-12-01,2003-02-28,90,1,14,138,152,4,10,14,166,1,8,Tennessee,Bristol,26702
18660,2003-2004,2003-11-29,2004-02-29,93,5,7,144,151,16,14,30,181,9,28,Tennessee,Bristol,26702
18661,2004-2005,2004-12-01,2005-04-24,145,0,9,140,149,10,1,11,160,8,23,Tennessee,Bristol,26702
18662,2005-2006,2005-11-22,2006-03-25,124,0,3,138,141,20,11,31,172,15,46,Tennessee,Bristol,26702
18663,2006-2007,2006-12-01,2007-04-15,136,0,7,160,167,11,2,13,180,9,33,Tennessee,Bristol,26702
18664,2007-2008,2007-12-01,2008-03-08,99,0,4,116,120,11,3,14,134,8,25,Tennessee,Bristol,26702
18665,2008-2009,2008-11-18,2009-04-07,141,0,14,185,199,18,7,25,224,16,60,Tennessee,Bristol,26702
18666,2009-2010,2009-12-01,2010-03-04,94,0,25,151,176,46,48,94,270,27,122,Tennessee,Bristol,26702
18667,2010-2011,2010-12-01,2011-03-06,96,0,16,156,172,31,31,62,234,22,81,Tennessee,Bristol,26702
18668,2011-2012,2011-12-01,2012-02-29,91,0,2,89,91,5,2,7,98,5,19,Tennessee,Bristol,26702
18669,2012-2013,2012-12-01,2013-03-26,116,0,2,111,113,15,15,30,143,10,27,Tennessee,Bristol,26702
18670,2013-2014,2013-11-27,2014-03-25,119,0,16,199,215,21,23,44,259,11,64,Tennessee,Bristol,26702
18671,2014-2015,2014-11-01,2015-02-28,120,0,15,195,210,23,41,64,274,11,54,Tennessee,Bristol,26702
18672,2015-2016,2015-12-01,2016-02-29,91,0,9,114,123,27,40,67,190,12,60,Tennessee,Bristol,26702
18673,2016-2017,2016-12-01,2017-03-15,105,0,4,94,98,8,7,15,113,5,22,Tennessee,Bristol,26702
18674,2017-2018,2017-12-01,2018-04-16,137,0,14,156,170,17,7,24,194,14,45,Tennessee,Bristol,26702
18675,2018-2019,2018-11-27,2019-02-28,94,0,4,87,91,22,28,50,141,9,36,Tennessee,Bristol,26702
18676,2019-2020,2019-11-12,2020-02-29,110,0,2,81,83,10,6,16,99,8,20,Tennessee,Bristol,26702
18677,1950-1951,1950-11-24,1951-02-28,97,0,5,109,114,6,4,10,124,2,11,Tennessee,Chattanooga,167674
18678,1951-1952,1951-12-01,1952-02-29,91,0,1,57,58,0,0,0,58,0,0,Tennessee,Chattanooga,167674
18679,1952-1953,1952-12-01,1953-02-28,90,0,0,52,52,4,1,5,57,2,5,Tennessee,Chattanooga,167674
18680,1953-1954,1953-12-01,1954-02-28,90,0,2,75,77,1,0,1,78,1,2,Tennessee,Chattanooga,167674
18681,1954-1955,1954-12-01,1955-02-28,90,0,1,79,80,0,0,0,80,0,0,Tennessee,Chattanooga,167674
18682,1955-1956,1955-12-01,1956-02-29,91,0,0,75,75,0,0,0,75,0,0,Tennessee,Chattanooga,167674
18683,1956-1957,1956-12-01,1957-02-28,90,0,1,45,46,0,0,0,46,0,0,Tennessee,Chattanooga,167674
18684,1957-1958,1957-12-01,1958-02-28,90,0,11,138,149,9,17,26,175,1,12,Tennessee,Chattanooga,167674
18685,1958-1959,1958-12-01,1959-02-28,90,0,3,109,112,3,1,4,116,3,9,Tennessee,Chattanooga,167674
18686,1959-1960,1959-12-01,1960-03-19,110,0,4,99,103,32,24,56,159,10,43,Tennessee,Chattanooga,167674
18687,1960-1961,1960-12-01,1961-02-28,90,0,5,117,122,2,0,2,124,2,4,Tennessee,Chattanooga,167674
18688,1961-1962,1961-12-01,1962-02-28,90,0,8,74,82,10,11,21,103,4,24,Tennessee,Chattanooga,167674
18689,1962-1963,1962-12-01,1963-02-28,90,0,15,179,194,6,1,7,201,3,13,Tennessee,Chattanooga,167674
18690,1963-1964,1963-12-01,1964-02-29,91,0,1,101,102,18,19,37,139,6,27,Tennessee,Chattanooga,167674
18691,1964-1965,1964-12-01,1965-03-05,95,0,4,99,103,6,2,8,111,5,15,Tennessee,Chattanooga,167674
18692,1965-1966,1965-12-01,1966-02-28,90,0,9,124,133,12,20,32,165,1,18,Tennessee,Chattanooga,167674
18693,1966-1967,1966-12-01,1967-02-28,90,0,4,89,93,3,2,5,98,2,7,Tennessee,Chattanooga,167674
18694,1967-1968,1967-12-01,1968-02-29,91,0,5,112,117,17,15,32,149,10,36,Tennessee,Chattanooga,167674
18695,1968-1969,1968-12-01,1969-03-06,96,0,3,99,102,13,9,22,124,5,16,Tennessee,Chattanooga,167674
18696,1969-1970,1969-12-01,1970-02-28,90,0,14,147,161,17,8,25,186,5,29,Tennessee,Chattanooga,167674
18697,1970-1971,1970-11-24,1971-04-07,135,0,9,126,135,15,2,17,152,6,24,Tennessee,Chattanooga,167674
18698,1971-1972,1971-12-01,1972-03-25,116,0,4,78,82,2,0,2,84,1,2,Tennessee,Chattanooga,167674
18699,1972-1973,1972-12-01,1973-02-28,90,0,10,110,120,3,2,5,125,1,5,Tennessee,Chattanooga,167674
18700,1973-1974,1973-12-01,1974-02-28,90,0,2,56,58,1,0,1,59,1,2,Tennessee,Chattanooga,167674
18701,1974-1975,1974-12-01,1975-02-28,90,0,0,75,75,0,0,0,75,0,0,Tennessee,Chattanooga,167674
18702,1975-1976,1975-12-01,1976-02-29,91,0,5,109,114,1,0,1,115,1,2,Tennessee,Chattanooga,167674
18703,1976-1977,1976-12-01,1977-02-28,90,0,11,192,203,5,5,10,213,3,11,Tennessee,Chattanooga,167674
18704,1977-1978,1977-12-01,1978-03-02,92,0,16,133,149,8,4,12,161,7,21,Tennessee,Chattanooga,167674
18705,1978-1979,1978-12-01,1979-02-28,90,0,3,106,109,15,13,28,137,7,23,Tennessee,Chattanooga,167674
18706,1979-1980,1979-12-01,1980-03-02,93,0,4,99,103,12,16,28,131,7,27,Tennessee,Chattanooga,167674
18707,1980-1981,1980-12-01,1981-02-28,90,0,6,121,127,0,0,0,127,0,0,Tennessee,Chattanooga,167674
18708,1981-1982,1981-12-01,1982-02-28,90,0,11,108,119,9,8,17,136,5,24,Tennessee,Chattanooga,167674
18709,1982-1983,1982-12-01,1983-03-24,114,0,1,64,65,4,1,5,70,3,7,Tennessee,Chattanooga,167674
18710,1983-1984,1983-12-01,1984-02-29,91,0,15,128,143,4,1,5,148,3,9,Tennessee,Chattanooga,167674
18711,1984-1985,1984-12-01,1985-02-28,90,0,7,114,121,9,4,13,134,7,29,Tennessee,Chattanooga,167674
18712,1985-1986,1985-12-01,1986-02-28,90,0,5,119,124,4,0,4,128,2,6,Tennessee,Chattanooga,167674
18713,1986-1987,1986-12-01,1987-04-03,124,0,2,71,73,14,10,24,97,6,26,Tennessee,Chattanooga,167674
18714,1987-1988,1987-12-01,1988-02-29,91,0,7,110,117,14,34,48,165,1,18,Tennessee,Chattanooga,167674
18715,1988-1989,1988-12-01,1989-02-28,90,0,1,66,67,4,1,5,72,3,5,Tennessee,Chattanooga,167674
18716,1989-1990,1989-11-16,1990-02-28,105,0,9,86,95,2,0,2,97,2,5,Tennessee,Chattanooga,167674
18717,1990-1991,1990-12-01,1991-03-08,98,0,1,57,58,5,1,6,64,3,10,Tennessee,Chattanooga,167674
18718,1991-1992,1991-12-01,1992-02-29,91,0,1,63,64,0,0,0,64,0,0,Tennessee,Chattanooga,167674
18719,1992-1993,1992-12-01,1993-03-17,107,0,0,57,57,31,26,57,114,3,34,Tennessee,Chattanooga,167674
18720,1993-1994,1993-12-01,1994-02-28,90,0,6,93,99,0,0,0,99,0,0,Tennessee,Chattanooga,167674
18721,1994-1995,1994-12-01,1995-02-28,90,0,1,61,62,4,1,5,67,4,11,Tennessee,Chattanooga,167674
18722,2004-2005,2004-12-01,2005-02-28,90,0,2,60,62,0,0,0,62,0,0,Tennessee,Chattanooga,167674
18723,2005-2006,2005-12-01,2006-02-28,90,0,1,61,62,2,0,2,64,2,4,Tennessee,Chattanooga,167674
18724,2006-2007,2006-12-01,2007-02-28,90,0,0,70,70,3,0,3,73,1,4,Tennessee,Chattanooga,167674
18725,2007-2008,2007-12-01,2008-03-24,115,0,2,68,70,4,0,4,74,3,7,Tennessee,Chattanooga,167674
18726,2008-2009,2008-12-01,2009-02-28,90,0,3,82,85,0,0,0,85,0,0,Tennessee,Chattanooga,167674
18727,2009-2010,2009-12-01,2010-03-02,92,0,6,87,93,15,3,18,111,8,25,Tennessee,Chattanooga,167674
18728,2010-2011,2010-12-01,2011-02-28,90,0,7,94,101,20,32,52,153,6,31,Tennessee,Chattanooga,167674
18729,2011-2012,2011-12-01,2012-02-29,91,0,0,40,40,0,0,0,40,0,0,Tennessee,Chattanooga,167674
18730,2012-2013,2012-12-01,2013-02-28,90,0,0,34,34,1,0,1,35,1,3,Tennessee,Chattanooga,167674
18731,2013-2014,2013-12-01,2014-02-28,90,0,8,106,114,12,6,18,132,3,20,Tennessee,Chattanooga,167674
18732,2014-2015,2014-12-01,2015-02-28,90,0,5,80,85,15,12,27,112,6,28,Tennessee,Chattanooga,167674
18733,2015-2016,2015-12-01,2016-02-29,91,0,1,49,50,2,0,2,52,2,4,Tennessee,Chattanooga,167674
18734,2016-2017,2016-12-01,2017-02-28,90,0,2,38,40,1,1,2,42,1,3,Tennessee,Chattanooga,167674
18735,2017-2018,2017-12-01,2018-02-28,90,0,5,84,89,2,0,2,91,2,6,Tennessee,Chattanooga,167674
18736,2018-2019,2018-12-01,2019-02-28,90,0,0,33,33,1,0,1,34,1,3,Tennessee,Chattanooga,167674
18737,2019-2020,2019-12-01,2020-02-29,91,0,0,25,25,4,1,5,30,2,5,Tennessee,Chattanooga,167674
18738,1951-1952,1951-11-03,1952-02-29,119,2,1,72,73,1,0,1,74,1,4,Tennessee,Jackson,65211
18739,1952-1953,1952-11-29,1953-02-28,92,3,2,60,62,0,0,0,62,0,0,Tennessee,Jackson,65211
18740,1953-1954,1953-12-01,1954-02-28,90,3,4,80,84,5,0,5,89,2,10,Tennessee,Jackson,65211
18741,1954-1955,1954-12-01,1955-02-28,90,2,3,90,93,2,0,2,95,1,3,Tennessee,Jackson,65211
18742,1956-1957,1956-12-01,1957-02-28,90,1,3,54,57,0,0,0,57,0,0,Tennessee,Jackson,65211
18743,1959-1960,1959-12-01,1960-03-15,106,6,5,98,103,16,0,16,119,5,22,Tennessee,Jackson,65211
18744,1960-1961,1960-12-01,1961-02-28,90,0,5,117,122,0,0,0,122,0,0,Tennessee,Jackson,65211
18745,1961-1962,1961-12-01,1962-03-06,96,7,18,122,140,4,0,4,144,2,17,Tennessee,Jackson,65211
18746,1962-1963,1962-12-01,1963-02-28,90,13,33,211,244,4,6,10,254,2,8,Tennessee,Jackson,65211
18747,1964-1965,1964-11-22,1965-03-20,119,7,14,148,162,0,8,8,170,0,0,Tennessee,Jackson,65211
18748,1965-1966,1965-12-01,1966-02-28,90,19,16,124,140,0,12,12,152,0,0,Tennessee,Jackson,65211
18749,1966-1967,1966-11-02,1967-02-28,119,6,8,127,135,2,1,3,138,1,2,Tennessee,Jackson,65211
18750,1967-1968,1967-12-01,1968-03-25,116,1,9,169,178,35,46,81,259,6,51,Tennessee,Jackson,65211
18751,1968-1969,1968-12-01,1969-02-28,90,5,6,89,95,1,1,2,97,1,3,Tennessee,Jackson,65211
18752,1970-1971,1970-11-24,1971-03-26,123,1,17,129,146,9,9,18,164,3,13,Tennessee,Jackson,65211
18753,1971-1972,1971-11-23,1972-03-03,102,1,7,79,86,2,0,2,88,2,4,Tennessee,Jackson,65211
18754,1972-1973,1972-12-01,1973-02-28,90,0,10,97,107,3,16,19,126,2,9,Tennessee,Jackson,65211
18755,1975-1976,1975-12-01,1976-02-29,91,1,9,93,102,0,0,0,102,0,0,Tennessee,Jackson,65211
18756,1977-1978,1977-12-01,1978-03-05,95,2,40,210,250,23,44,67,317,11,67,Tennessee,Jackson,65211
18757,1978-1979,1978-12-01,1979-02-28,90,0,29,168,197,24,47,71,268,7,40,Tennessee,Jackson,65211
18758,1979-1980,1979-11-30,1980-03-03,95,0,18,114,132,16,13,29,161,9,37,Tennessee,Jackson,65211
18759,1980-1981,1980-12-01,1981-02-28,90,1,16,139,155,0,0,0,155,0,0,Tennessee,Jackson,65211
18760,1981-1982,1981-12-01,1982-02-28,90,0,23,153,176,8,15,23,199,2,15,Tennessee,Jackson,65211
18761,1982-1983,1982-12-01,1983-02-28,90,1,1,73,74,0,0,0,74,0,0,Tennessee,Jackson,65211
18762,1984-1985,1984-12-01,1985-02-28,90,0,27,140,167,34,52,86,253,8,69,Tennessee,Jackson,65211
18763,1985-1986,1985-12-01,1986-02-28,90,18,15,131,146,1,0,1,147,1,6,Tennessee,Jackson,65211
18764,1986-1987,1986-11-14,1987-03-31,138,0,4,81,85,6,4,10,95,2,8,Tennessee,Jackson,65211
18765,1987-1988,1987-12-01,1988-02-29,91,2,16,117,133,19,29,48,181,5,49,Tennessee,Jackson,65211
18766,1989-1990,1989-12-01,1990-03-19,109,0,24,108,132,1,0,1,133,1,2,Tennessee,Jackson,65211
18767,1990-1991,1990-12-01,1991-02-28,90,0,6,75,81,1,0,1,82,1,7,Tennessee,Jackson,65211
18768,1991-1992,1991-12-01,1992-02-29,91,0,1,57,58,0,0,0,58,0,0,Tennessee,Jackson,65211
18769,1992-1993,1992-12-01,1993-03-14,104,9,5,76,81,1,1,2,83,1,2,Tennessee,Jackson,65211
18770,1993-1994,1993-12-01,1994-02-28,90,0,15,112,127,6,3,9,136,4,21,Tennessee,Jackson,65211
18771,1994-1995,1994-12-01,1995-02-28,90,0,4,78,82,0,0,0,82,0,0,Tennessee,Jackson,65211
18772,1995-1996,1995-12-01,1996-03-09,100,3,22,143,165,2,2,4,169,1,8,Tennessee,Jackson,65211
18773,1996-1997,1996-12-01,1997-02-28,90,1,16,90,106,4,10,14,120,1,11,Tennessee,Jackson,65211
18774,1997-1998,1997-12-01,1998-02-28,90,3,0,37,37,2,1,3,40,1,3,Tennessee,Jackson,65211
18775,1998-1999,1998-12-01,1999-02-28,90,5,10,69,79,2,0,2,81,1,5,Tennessee,Jackson,65211
18776,1999-2000,1999-12-01,2000-02-29,91,5,3,83,86,3,5,8,94,1,5,Tennessee,Jackson,65211
18777,2000-2001,2000-12-01,2001-02-28,90,7,16,131,147,5,4,9,156,3,17,Tennessee,Jackson,65211
18778,2001-2002,2001-12-01,2002-03-04,94,3,4,80,84,6,3,9,93,2,8,Tennessee,Jackson,65211
18779,2002-2003,2002-12-01,2003-02-28,90,6,10,109,119,16,16,32,151,6,29,Tennessee,Jackson,65211
18780,2003-2004,2003-12-01,2004-04-13,135,1,5,94,99,4,3,7,106,1,5,Tennessee,Jackson,65211
18781,2004-2005,2004-12-01,2005-02-28,90,0,7,71,78,4,11,15,93,1,8,Tennessee,Jackson,65211
18782,2005-2006,2005-12-01,2006-02-28,90,0,3,77,80,4,2,6,86,2,10,Tennessee,Jackson,65211
18783,2006-2007,2006-12-01,2007-02-28,90,1,6,90,96,3,1,4,100,2,8,Tennessee,Jackson,65211
18784,2007-2008,2007-12-01,2008-03-08,99,0,6,90,96,2,2,4,100,1,3,Tennessee,Jackson,65211
18785,2008-2009,2008-12-01,2009-03-03,93,2,7,116,123,10,7,17,140,2,13,Tennessee,Jackson,65211
18786,2009-2010,2009-12-01,2010-02-28,90,10,13,137,150,16,19,35,185,3,19,Tennessee,Jackson,65211
18787,2015-2016,2015-12-01,2016-02-29,91,0,5,84,89,0,0,0,89,0,0,Tennessee,Jackson,65211
18788,2016-2017,2016-12-01,2017-03-12,102,0,9,80,89,8,8,16,105,3,20,Tennessee,Jackson,65211
18789,2017-2018,2017-12-01,2018-02-28,90,0,14,136,150,6,6,12,162,2,14,Tennessee,Jackson,65211
18790,2018-2019,2018-11-15,2019-03-05,111,0,5,92,97,2,2,4,101,2,5,Tennessee,Jackson,65211
18791,2019-2020,2019-12-01,2020-02-29,91,0,0,50,50,1,1,2,52,1,2,Tennessee,Jackson,65211
18792,1950-1951,1950-11-24,1951-03-14,111,0,14,117,131,15,17,32,163,7,29,Tennessee,Knoxville,178874
18793,1951-1952,1951-12-01,1952-02-29,91,0,2,57,59,0,0,0,59,0,0,Tennessee,Knoxville,178874
18794,1952-1953,1952-11-21,1953-02-28,100,0,3,58,61,41,21,62,123,8,51,Tennessee,Knoxville,178874
18795,1953-1954,1953-12-01,1954-03-01,91,0,4,79,83,12,5,17,100,3,15,Tennessee,Knoxville,178874
18796,1954-1955,1954-12-01,1955-02-28,90,0,4,86,90,9,7,16,106,5,22,Tennessee,Knoxville,178874
18797,1955-1956,1955-11-29,1956-02-29,93,0,2,81,83,10,7,17,100,4,16,Tennessee,Knoxville,178874
18798,1956-1957,1956-11-26,1957-03-08,103,0,1,51,52,7,0,7,59,4,11,Tennessee,Knoxville,178874
18799,1957-1958,1957-12-01,1958-02-28,90,0,16,138,154,17,16,33,187,6,31,Tennessee,Knoxville,178874
18800,1958-1959,1958-12-01,1959-03-12,102,0,6,117,123,10,9,19,142,4,18,Tennessee,Knoxville,178874
18801,1959-1960,1959-11-28,1960-03-21,115,0,6,120,126,77,62,139,265,16,104,Tennessee,Knoxville,178874
18802,1960-1961,1960-12-01,1961-03-09,99,0,11,121,132,16,8,24,156,9,38,Tennessee,Knoxville,178874
18803,1961-1962,1961-12-01,1962-03-06,96,0,11,88,99,31,26,57,156,9,52,Tennessee,Knoxville,178874
18804,1962-1963,1962-12-01,1963-02-28,90,0,15,164,179,24,17,41,220,7,45,Tennessee,Knoxville,178874
18805,1963-1964,1963-11-14,1964-02-29,108,0,8,150,158,46,47,93,251,11,63,Tennessee,Knoxville,178874
18806,1964-1965,1964-12-01,1965-03-20,110,0,5,107,112,28,26,54,166,11,48,Tennessee,Knoxville,178874
18807,1965-1966,1965-12-01,1966-03-06,96,0,9,103,112,20,33,53,165,5,30,Tennessee,Knoxville,178874
18808,1966-1967,1966-12-01,1967-02-28,90,0,5,86,91,14,12,26,117,4,22,Tennessee,Knoxville,178874
18809,1967-1968,1967-12-01,1968-03-22,113,0,3,125,128,19,9,28,156,9,31,Tennessee,Knoxville,178874
18810,1968-1969,1968-11-19,1969-03-10,112,0,5,122,127,21,8,29,156,10,31,Tennessee,Knoxville,178874
18811,1969-1970,1969-12-01,1970-02-28,90,0,19,132,151,36,35,71,222,11,73,Tennessee,Knoxville,178874
18812,1970-1971,1970-11-24,1971-04-07,135,0,12,125,137,37,15,52,189,14,56,Tennessee,Knoxville,178874
18813,1971-1972,1971-12-01,1972-03-26,117,0,4,70,74,15,1,16,90,4,20,Tennessee,Knoxville,178874
18814,1972-1973,1972-12-01,1973-03-21,111,0,7,85,92,15,20,35,127,4,18,Tennessee,Knoxville,178874
18815,1973-1974,1973-12-01,1974-03-25,115,0,3,55,58,6,1,7,65,4,13,Tennessee,Knoxville,178874
18816,1974-1975,1974-12-01,1975-03-10,100,0,3,70,73,9,1,10,83,5,14,Tennessee,Knoxville,178874
18817,1975-1976,1975-12-01,1976-02-29,91,0,6,105,111,5,3,8,119,3,11,Tennessee,Knoxville,178874
18818,1976-1977,1976-11-29,1977-02-28,92,0,16,177,193,20,8,28,221,11,45,Tennessee,Knoxville,178874
18819,1977-1978,1977-11-26,1978-03-18,113,0,19,165,184,31,34,65,249,14,54,Tennessee,Knoxville,178874
18820,1978-1979,1978-12-01,1979-02-28,90,0,4,124,128,29,33,62,190,11,44,Tennessee,Knoxville,178874
18821,1979-1980,1979-12-01,1980-03-04,95,0,6,98,104,23,23,46,150,8,43,Tennessee,Knoxville,178874
18822,1980-1981,1980-12-01,1981-02-28,90,0,6,124,130,11,1,12,142,4,22,Tennessee,Knoxville,178874
18823,1981-1982,1981-12-01,1982-03-07,97,0,17,111,128,10,11,21,149,6,28,Tennessee,Knoxville,178874
18824,1982-1983,1982-12-01,1983-04-18,139,0,0,86,86,16,8,24,110,8,21,Tennessee,Knoxville,178874
18825,1983-1984,1983-12-01,1984-02-29,91,0,15,135,150,11,10,21,171,8,29,Tennessee,Knoxville,178874
18826,1984-1985,1984-12-01,1985-02-28,90,0,15,151,166,33,58,91,257,9,62,Tennessee,Knoxville,178874
18827,1985-1986,1985-12-01,1986-02-28,90,0,8,163,171,12,8,20,191,3,17,Tennessee,Knoxville,178874
18828,1986-1987,1986-12-01,1987-04-05,126,0,3,105,108,29,26,55,163,8,45,Tennessee,Knoxville,178874
18829,1987-1988,1987-12-01,1988-02-29,91,0,7,132,139,16,26,42,181,5,28,Tennessee,Knoxville,178874
18830,1988-1989,1988-12-01,1989-02-28,90,0,3,87,90,10,4,14,104,6,16,Tennessee,Knoxville,178874
18831,1989-1990,1989-12-01,1990-02-28,90,0,12,87,99,3,1,4,103,3,10,Tennessee,Knoxville,178874
18832,1990-1991,1990-12-01,1991-03-04,94,0,2,60,62,4,2,6,68,3,4,Tennessee,Knoxville,178874
18833,1991-1992,1991-11-08,1992-02-29,114,0,2,77,79,1,0,1,80,1,1,Tennessee,Knoxville,178874
18834,1992-1993,1992-12-01,1993-03-17,107,0,3,71,74,22,29,51,125,5,34,Tennessee,Knoxville,178874
18835,1993-1994,1993-12-01,1994-03-02,92,0,13,110,123,6,11,17,140,4,10,Tennessee,Knoxville,178874
18836,1994-1995,1994-12-01,1995-03-08,98,1,2,78,80,8,3,11,91,5,12,Tennessee,Knoxville,178874
18837,1997-1998,1997-12-01,1998-02-28,90,0,1,46,47,6,5,11,58,4,10,Tennessee,Knoxville,178874
18838,1998-1999,1998-12-01,1999-03-15,105,0,5,67,72,7,3,10,82,4,11,Tennessee,Knoxville,178874
18839,1999-2000,1999-12-01,2000-02-29,91,0,6,80,86,3,5,8,94,1,6,Tennessee,Knoxville,178874
18840,2004-2005,2004-12-01,2005-03-01,91,0,6,79,85,2,0,2,87,2,6,Tennessee,Knoxville,178874
18841,2005-2006,2005-12-01,2006-02-28,90,0,0,76,76,6,2,8,84,4,12,Tennessee,Knoxville,178874
18842,2006-2007,2006-12-01,2007-02-28,90,0,2,98,100,1,0,1,101,1,2,Tennessee,Knoxville,178874
18843,2007-2008,2007-12-01,2008-02-29,91,0,2,83,85,0,0,0,85,0,0,Tennessee,Knoxville,178874
18844,2008-2009,2008-12-01,2009-02-28,90,0,7,108,115,9,6,15,130,3,13,Tennessee,Knoxville,178874
18845,2009-2010,2009-12-01,2010-03-02,92,0,14,111,125,10,10,20,145,5,17,Tennessee,Knoxville,178874
18846,2010-2011,2010-12-01,2011-02-28,90,0,9,109,118,19,20,39,157,9,35,Tennessee,Knoxville,178874
18847,2011-2012,2011-12-01,2012-02-29,91,0,2,53,55,1,0,1,56,1,1,Tennessee,Knoxville,178874
18848,2012-2013,2012-12-01,2013-03-26,116,0,0,65,65,9,4,13,78,8,18,Tennessee,Knoxville,178874
18849,2013-2014,2013-11-27,2014-03-25,119,0,10,135,145,18,20,38,183,8,34,Tennessee,Knoxville,178874
18850,2014-2015,2014-11-18,2015-02-28,103,0,13,120,133,15,11,26,159,7,28,Tennessee,Knoxville,178874
18851,2015-2016,2015-12-01,2016-02-29,91,0,8,71,79,10,3,13,92,8,26,Tennessee,Knoxville,178874
18852,2016-2017,2016-12-01,2017-02-28,90,0,3,49,52,4,2,6,58,2,12,Tennessee,Knoxville,178874
18853,2017-2018,2017-12-01,2018-02-28,90,0,12,100,112,5,2,7,119,4,11,Tennessee,Knoxville,178874
18854,2018-2019,2018-12-01,2019-02-28,90,0,2,47,49,3,3,6,55,2,7,Tennessee,Knoxville,178874
18855,2019-2020,2019-11-12,2020-02-29,110,0,1,43,44,6,1,7,51,4,9,Tennessee,Knoxville,178874
18856,1950-1951,1950-11-23,1951-03-13,111,0,16,115,131,14,26,40,171,9,46,Tennessee,Memphis,646889
18857,1951-1952,1951-11-02,1952-02-29,120,0,2,58,60,1,0,1,61,1,2,Tennessee,Memphis,646889
18858,1952-1953,1952-12-01,1953-02-28,90,0,1,29,30,0,0,0,30,0,0,Tennessee,Memphis,646889
18859,1953-1954,1953-12-01,1954-02-28,90,0,3,46,49,6,7,13,62,3,11,Tennessee,Memphis,646889
18860,1954-1955,1954-12-01,1955-03-26,116,0,3,68,71,3,0,3,74,3,7,Tennessee,Memphis,646889
18861,1955-1956,1955-12-01,1956-02-29,91,0,2,64,66,7,7,14,80,1,9,Tennessee,Memphis,646889
18862,1956-1957,1956-12-01,1957-02-28,90,0,2,38,40,0,0,0,40,0,0,Tennessee,Memphis,646889
18863,1957-1958,1957-12-01,1958-02-28,90,0,13,101,114,8,9,17,131,4,14,Tennessee,Memphis,646889
18864,1958-1959,1958-12-01,1959-02-28,90,0,11,93,104,6,7,13,117,3,11,Tennessee,Memphis,646889
18865,1959-1960,1959-12-01,1960-03-15,106,0,5,72,77,31,12,43,120,12,43,Tennessee,Memphis,646889
18866,1960-1961,1960-12-01,1961-02-28,90,0,8,110,118,4,0,4,122,3,7,Tennessee,Memphis,646889
18867,1961-1962,1961-12-01,1962-02-28,90,0,12,75,87,7,11,18,105,2,14,Tennessee,Memphis,646889
18868,1962-1963,1962-12-01,1963-02-28,90,0,17,140,157,7,6,13,170,3,16,Tennessee,Memphis,646889
18869,1963-1964,1963-12-01,1964-02-29,91,0,13,136,149,19,29,48,197,2,26,Tennessee,Memphis,646889
18870,1964-1965,1964-11-30,1965-03-20,111,0,7,93,100,13,7,20,120,6,25,Tennessee,Memphis,646889
18871,1965-1966,1965-12-01,1966-02-28,90,0,12,88,100,16,21,37,137,6,33,Tennessee,Memphis,646889
18872,1966-1967,1966-12-01,1967-03-06,96,0,6,97,103,3,1,4,107,3,9,Tennessee,Memphis,646889
18873,1967-1968,1967-12-01,1968-03-25,116,0,7,102,109,34,27,61,170,7,46,Tennessee,Memphis,646889
18874,1968-1969,1968-12-01,1969-02-28,90,0,2,63,65,0,0,0,65,0,0,Tennessee,Memphis,646889
18875,1969-1970,1969-12-01,1970-02-28,90,0,15,96,111,8,6,14,125,5,22,Tennessee,Memphis,646889
18876,1970-1971,1970-11-24,1971-03-03,100,0,10,74,84,12,3,15,99,5,19,Tennessee,Memphis,646889
18877,1971-1972,1971-11-23,1972-02-29,99,0,4,56,60,3,0,3,63,3,6,Tennessee,Memphis,646889
18878,1972-1973,1972-12-01,1973-02-28,90,0,9,79,88,2,1,3,91,1,4,Tennessee,Memphis,646889
18879,1973-1974,1973-12-01,1974-02-28,90,0,5,46,51,5,6,11,62,5,15,Tennessee,Memphis,646889
18880,1974-1975,1974-12-01,1975-03-13,103,0,1,48,49,8,3,11,60,5,14,Tennessee,Memphis,646889
18881,1975-1976,1975-12-01,1976-02-29,91,0,4,57,61,2,0,2,63,2,3,Tennessee,Memphis,646889
18882,1976-1977,1976-11-14,1977-02-28,107,0,13,116,129,11,3,14,143,9,34,Tennessee,Memphis,646889
18883,1977-1978,1977-12-01,1978-02-28,90,0,17,103,120,13,11,24,144,9,31,Tennessee,Memphis,646889
18884,1978-1979,1978-12-01,1979-02-28,90,0,18,103,121,17,16,33,154,11,32,Tennessee,Memphis,646889
18885,1979-1980,1979-12-01,1980-03-02,93,0,4,64,68,7,2,9,77,6,16,Tennessee,Memphis,646889
18886,1980-1981,1980-12-01,1981-02-28,90,0,4,59,63,0,0,0,63,0,0,Tennessee,Memphis,646889
18887,1981-1982,1981-12-01,1982-03-06,96,0,15,107,122,10,15,25,147,4,20,Tennessee,Memphis,646889
18888,1982-1983,1982-12-01,1983-03-10,100,0,0,35,35,11,1,12,47,4,13,Tennessee,Memphis,646889
18889,1983-1984,1983-12-01,1984-03-10,101,0,19,113,132,7,6,13,145,5,20,Tennessee,Memphis,646889
18890,1984-1985,1984-12-01,1985-02-28,90,0,14,93,107,28,42,70,177,7,46,Tennessee,Memphis,646889
18891,1985-1986,1985-12-01,1986-02-28,90,0,10,95,105,3,0,3,108,1,6,Tennessee,Memphis,646889
18892,1986-1987,1986-12-01,1987-03-30,120,0,1,50,51,1,0,1,52,1,2,Tennessee,Memphis,646889
18893,1987-1988,1987-12-01,1988-02-29,91,0,12,88,100,15,28,43,143,4,29,Tennessee,Memphis,646889
18894,1988-1989,1988-12-01,1989-03-07,97,0,8,54,62,1,0,1,63,1,4,Tennessee,Memphis,646889
18895,1989-1990,1989-12-01,1990-02-28,90,0,19,80,99,1,0,1,100,1,5,Tennessee,Memphis,646889
18896,1990-1991,1990-12-01,1991-03-29,119,0,4,57,61,3,0,3,64,2,5,Tennessee,Memphis,646889
18897,1991-1992,1991-11-07,1992-02-29,115,0,0,43,43,1,1,2,45,1,2,Tennessee,Memphis,646889
18898,1992-1993,1992-12-01,1993-02-28,90,0,1,41,42,0,0,0,42,0,0,Tennessee,Memphis,646889
18899,1993-1994,1993-12-01,1994-02-28,90,0,6,68,74,6,5,11,85,4,13,Tennessee,Memphis,646889
18900,1994-1995,1994-12-01,1995-03-03,93,0,2,49,51,7,4,11,62,5,12,Tennessee,Memphis,646889
18901,1995-1996,1995-12-01,1996-03-08,99,0,18,101,119,3,0,3,122,3,11,Tennessee,Memphis,646889
18902,1996-1997,1996-12-01,1997-02-28,90,0,10,63,73,6,6,12,85,3,11,Tennessee,Memphis,646889
18903,1997-1998,1997-12-01,1998-02-28,90,0,0,21,21,5,5,10,31,2,7,Tennessee,Memphis,646889
18904,1998-1999,1998-12-01,1999-02-28,90,0,8,45,53,2,2,4,57,2,6,Tennessee,Memphis,646889
18905,1999-2000,1999-12-01,2000-02-29,91,0,1,45,46,5,5,10,56,2,7,Tennessee,Memphis,646889
18906,2000-2001,2000-12-01,2001-02-28,90,0,13,93,106,4,6,10,116,3,11,Tennessee,Memphis,646889
18907,2001-2002,2001-12-01,2002-03-03,93,0,1,49,50,5,4,9,59,2,7,Tennessee,Memphis,646889
18908,2002-2003,2002-12-01,2003-02-28,90,0,5,62,67,6,0,6,73,4,9,Tennessee,Memphis,646889
18909,2003-2004,2003-12-01,2004-02-29,91,0,1,52,53,1,0,1,54,1,1,Tennessee,Memphis,646889
18910,2004-2005,2004-12-01,2005-02-28,90,0,3,47,50,3,11,14,64,1,5,Tennessee,Memphis,646889
18911,2005-2006,2005-12-01,2006-02-28,90,9,1,46,47,4,2,6,53,1,5,Tennessee,Memphis,646889
18912,2006-2007,2006-12-01,2007-02-28,90,0,4,58,62,3,2,5,67,2,6,Tennessee,Memphis,646889
18913,2007-2008,2007-12-01,2008-03-08,99,0,2,58,60,8,4,12,72,2,11,Tennessee,Memphis,646889
18914,2008-2009,2008-12-01,2009-03-01,91,0,4,60,64,6,4,10,74,3,9,Tennessee,Memphis,646889
18915,2009-2010,2009-12-01,2010-02-28,90,0,10,96,106,12,6,18,124,5,20,Tennessee,Memphis,646889
18916,2010-2011,2010-12-01,2011-02-28,90,0,7,81,88,15,12,27,115,6,25,Tennessee,Memphis,646889
18917,2011-2012,2011-11-28,2012-02-29,94,0,0,31,31,3,0,3,34,2,4,Tennessee,Memphis,646889
18918,2012-2013,2012-12-01,2013-02-28,90,0,2,36,38,1,1,2,40,1,2,Tennessee,Memphis,646889
18919,2013-2014,2013-12-01,2014-03-04,94,0,11,109,120,2,1,3,123,2,7,Tennessee,Memphis,646889
18920,2014-2015,2014-11-13,2015-03-07,115,0,5,84,89,11,11,22,111,7,24,Tennessee,Memphis,646889
18921,2015-2016,2015-12-01,2016-02-29,91,0,1,35,36,1,0,1,37,1,2,Tennessee,Memphis,646889
18922,2016-2017,2016-12-01,2017-02-28,90,0,4,37,41,3,1,4,45,1,7,Tennessee,Memphis,646889
18923,2017-2018,2017-12-01,2018-02-28,90,0,11,82,93,3,8,11,104,2,10,Tennessee,Memphis,646889
18924,2018-2019,2018-11-14,2019-03-04,111,0,2,47,49,2,0,2,51,2,5,Tennessee,Memphis,646889
18925,2019-2020,2019-11-12,2020-02-29,110,0,1,37,38,2,0,2,40,2,4,Tennessee,Memphis,646889
18926,1950-1951,1950-11-23,1951-04-02,131,0,26,168,194,50,70,120,314,16,103,Tennessee,Nashville,601222
18927,1951-1952,1951-11-02,1952-02-29,120,0,3,92,95,7,2,9,104,5,15,Tennessee,Nashville,601222
18928,1952-1953,1952-11-29,1953-02-28,92,0,2,50,52,5,0,5,57,5,11,Tennessee,Nashville,601222
18929,1953-1954,1953-12-01,1954-03-03,93,0,5,90,95,6,1,7,102,3,8,Tennessee,Nashville,601222
18930,1954-1955,1954-11-02,1955-03-26,145,0,8,111,119,17,11,28,147,12,40,Tennessee,Nashville,601222
18931,1955-1956,1955-11-28,1956-02-29,94,0,3,100,103,8,6,14,117,2,14,Tennessee,Nashville,601222
18932,1956-1957,1956-12-01,1957-03-08,98,0,4,59,63,4,2,6,69,1,5,Tennessee,Nashville,601222
18933,1957-1958,1957-11-22,1958-03-21,120,0,21,152,173,16,17,33,206,9,37,Tennessee,Nashville,601222
18934,1958-1959,1958-12-01,1959-02-28,90,3,12,135,147,3,0,3,150,2,5,Tennessee,Nashville,601222
18935,1959-1960,1959-11-28,1960-03-20,114,0,16,137,153,57,68,125,278,18,88,Tennessee,Nashville,601222
18936,1960-1961,1960-12-01,1961-03-09,99,0,9,146,155,10,8,18,173,7,29,Tennessee,Nashville,601222
18937,1961-1962,1961-12-01,1962-03-05,95,0,15,106,121,12,6,18,139,9,34,Tennessee,Nashville,601222
18938,1962-1963,1962-12-01,1963-02-28,90,0,25,212,237,33,35,68,305,11,71,Tennessee,Nashville,601222
18939,1963-1964,1963-12-01,1964-02-29,91,0,15,148,163,30,39,69,232,7,48,Tennessee,Nashville,601222
18940,1964-1965,1964-11-30,1965-03-20,111,0,11,149,160,12,7,19,179,8,31,Tennessee,Nashville,601222
18941,1965-1966,1965-11-30,1966-02-28,91,0,17,120,137,14,36,50,187,2,25,Tennessee,Nashville,601222
18942,1966-1967,1966-11-02,1967-02-28,119,0,4,111,115,18,21,39,154,3,21,Tennessee,Nashville,601222
18943,1967-1968,1967-12-01,1968-03-24,115,0,13,188,201,38,43,81,282,11,67,Tennessee,Nashville,601222
18944,1968-1969,1968-12-01,1969-03-09,99,0,7,113,120,23,15,38,158,7,32,Tennessee,Nashville,601222
18945,1969-1970,1969-11-14,1970-02-28,107,0,20,156,176,21,13,34,210,13,60,Tennessee,Nashville,601222
18946,1970-1971,1970-11-23,1971-04-06,135,0,18,158,176,21,17,38,214,11,46,Tennessee,Nashville,601222
18947,1971-1972,1971-11-23,1972-03-25,124,0,6,90,96,4,0,4,100,4,8,Tennessee,Nashville,601222
18948,1972-1973,1972-11-30,1973-04-10,132,0,10,96,106,10,17,27,133,5,15,Tennessee,Nashville,601222
18949,1973-1974,1973-12-01,1974-02-28,90,0,6,71,77,5,3,8,85,3,9,Tennessee,Nashville,601222
18950,1974-1975,1974-12-01,1975-02-28,90,0,1,63,64,9,2,11,75,5,14,Tennessee,Nashville,601222
18951,1975-1976,1975-12-01,1976-02-29,91,0,8,91,99,6,3,9,108,4,18,Tennessee,Nashville,601222
18952,1976-1977,1976-11-11,1977-02-28,110,0,27,225,252,31,21,52,304,13,76,Tennessee,Nashville,601222
18953,1977-1978,1977-11-26,1978-03-17,112,0,34,209,243,40,53,93,336,16,75,Tennessee,Nashville,601222
18954,1978-1979,1978-12-01,1979-03-25,115,0,18,169,187,37,48,85,272,14,67,Tennessee,Nashville,601222
18955,1979-1980,1979-12-01,1980-03-03,94,0,8,120,128,13,23,36,164,6,25,Tennessee,Nashville,601222
18956,1980-1981,1980-12-01,1981-02-28,90,0,6,130,136,6,0,6,142,4,19,Tennessee,Nashville,601222
18957,1981-1982,1981-12-01,1982-03-07,97,0,21,151,172,17,21,38,210,10,44,Tennessee,Nashville,601222
18958,1982-1983,1982-12-01,1983-02-28,90,0,0,59,59,3,0,3,62,3,7,Tennessee,Nashville,601222
18959,1983-1984,1983-12-01,1984-02-29,91,0,34,170,204,14,26,40,244,7,35,Tennessee,Nashville,601222
18960,1984-1985,1984-12-01,1985-02-28,90,0,25,153,178,28,48,76,254,11,79,Tennessee,Nashville,601222
18961,1985-1986,1985-12-01,1986-02-28,90,0,17,148,165,8,3,11,176,6,28,Tennessee,Nashville,601222
18962,1986-1987,1986-12-01,1987-03-30,120,0,5,87,92,9,2,11,103,7,23,Tennessee,Nashville,601222
18963,1987-1988,1987-12-01,1988-02-29,91,0,15,127,142,19,27,46,188,7,45,Tennessee,Nashville,601222
18964,1988-1989,1988-12-01,1989-02-28,90,0,4,76,80,11,6,17,97,5,20,Tennessee,Nashville,601222
18965,1989-1990,1989-12-01,1990-03-19,109,0,24,119,143,4,0,4,147,4,20,Tennessee,Nashville,601222
18966,1990-1991,1990-12-01,1991-03-29,119,0,6,84,90,6,0,6,96,5,16,Tennessee,Nashville,601222
18967,1991-1992,1991-12-01,1992-03-12,103,0,2,66,68,2,0,2,70,1,3,Tennessee,Nashville,601222
18968,1992-1993,1992-12-01,1993-03-14,104,0,3,83,86,12,7,19,105,5,20,Tennessee,Nashville,601222
18969,1993-1994,1993-10-31,1994-02-28,121,0,15,135,150,8,4,12,162,6,22,Tennessee,Nashville,601222
18970,1994-1995,1994-12-01,1995-03-08,98,0,7,90,97,8,1,9,106,6,19,Tennessee,Nashville,601222
18971,1995-1996,1995-12-01,1996-03-21,112,0,25,152,177,27,34,61,238,13,64,Tennessee,Nashville,601222
18972,2005-2006,2005-12-01,2006-02-28,90,0,2,75,77,5,2,7,84,5,17,Tennessee,Nashville,601222
18973,2006-2007,2006-12-01,2007-02-28,90,0,6,92,98,4,1,5,103,3,10,Tennessee,Nashville,601222
18974,2007-2008,2007-12-01,2008-03-08,99,0,3,91,94,4,1,5,99,4,12,Tennessee,Nashville,601222
18975,2008-2009,2008-12-01,2009-03-01,91,0,7,109,116,5,1,6,122,4,10,Tennessee,Nashville,601222
18976,2009-2010,2009-12-01,2010-02-28,90,0,15,134,149,13,13,26,175,9,47,Tennessee,Nashville,601222
18977,2010-2011,2010-12-01,2011-02-28,90,0,16,126,142,20,18,38,180,12,48,Tennessee,Nashville,601222
18978,2011-2012,2011-12-01,2012-02-29,91,0,0,58,58,2,0,2,60,2,4,Tennessee,Nashville,601222
18979,2012-2013,2012-12-01,2013-03-02,92,0,2,58,60,5,0,5,65,5,13,Tennessee,Nashville,601222
18980,2013-2014,2013-11-25,2014-03-25,121,0,16,171,187,8,0,8,195,8,23,Tennessee,Nashville,601222
18981,2014-2015,2014-11-17,2015-03-05,109,0,11,133,144,12,4,16,160,10,44,Tennessee,Nashville,601222
18982,2015-2016,2015-12-01,2016-02-29,91,0,5,74,79,18,21,39,118,5,28,Tennessee,Nashville,601222
18983,2016-2017,2016-12-01,2017-03-11,101,0,6,55,61,4,0,4,65,3,11,Tennessee,Nashville,601222
18984,2017-2018,2017-12-01,2018-03-12,102,0,15,112,127,6,4,10,137,5,22,Tennessee,Nashville,601222
18985,2018-2019,2018-12-01,2019-02-28,90,0,3,45,48,2,0,2,50,2,7,Tennessee,Nashville,601222
18986,2019-2020,2019-11-11,2020-02-29,111,0,2,48,50,3,1,4,54,3,5,Tennessee,Nashville,601222
18987,1950-1951,1950-12-01,1951-02-28,90,0,15,91,106,7,4,11,117,4,25,Texas,Abilene,117063
18988,1951-1952,1951-12-01,1952-02-29,91,0,2,43,45,1,0,1,46,1,2,Texas,Abilene,117063
18989,1952-1953,1952-12-01,1953-02-28,90,0,1,38,39,2,1,3,42,1,6,Texas,Abilene,117063
18990,1953-1954,1953-12-01,1954-03-04,94,0,3,57,60,3,5,8,68,2,10,Texas,Abilene,117063
18991,1954-1955,1954-12-01,1955-02-28,90,0,0,46,46,9,10,19,65,2,11,Texas,Abilene,117063
18992,1955-1956,1955-12-01,1956-02-29,91,0,6,71,77,14,14,28,105,4,25,Texas,Abilene,117063
18993,1956-1957,1956-12-01,1957-02-28,90,0,3,37,40,0,0,0,40,0,0,Texas,Abilene,117063
18994,1957-1958,1957-11-22,1958-03-12,111,0,2,52,54,18,9,27,81,7,28,Texas,Abilene,117063
18995,1958-1959,1958-12-01,1959-02-28,90,0,7,99,106,8,4,12,118,2,14,Texas,Abilene,117063
18996,1959-1960,1959-12-01,1960-03-04,95,0,6,69,75,2,1,3,78,1,7,Texas,Abilene,117063
18997,1960-1961,1960-12-01,1961-02-28,90,0,6,75,81,14,18,32,113,8,37,Texas,Abilene,117063
18998,1961-1962,1961-12-01,1962-03-15,105,0,8,100,108,9,3,12,120,3,19,Texas,Abilene,117063
18999,1962-1963,1962-12-01,1963-02-28,90,0,8,105,113,5,5,10,123,3,17,Texas,Abilene,117063
19000,1963-1964,1963-12-01,1964-02-29,91,0,2,66,68,11,7,18,86,4,16,Texas,Abilene,117063
19001,1964-1965,1964-12-01,1965-02-28,90,0,1,54,55,0,0,0,55,0,0,Texas,Abilene,117063
19002,1965-1966,1965-12-01,1966-02-28,90,0,7,73,80,11,12,23,103,5,22,Texas,Abilene,117063
19003,1966-1967,1966-12-01,1967-02-28,90,0,0,87,87,0,0,0,87,0,0,Texas,Abilene,117063
19004,1967-1968,1967-12-01,1968-03-12,103,0,6,65,71,12,11,23,94,5,20,Texas,Abilene,117063
19005,1968-1969,1968-11-08,1969-03-02,115,0,1,59,60,11,2,13,73,4,11,Texas,Abilene,117063
19006,1969-1970,1969-12-01,1970-03-21,111,0,4,69,73,19,7,26,99,7,23,Texas,Abilene,117063
19007,1970-1971,1970-12-01,1971-03-02,92,0,3,67,70,3,1,4,74,2,8,Texas,Abilene,117063
19008,1971-1972,1971-12-01,1972-02-29,91,0,2,67,69,3,0,3,72,3,13,Texas,Abilene,117063
19009,1972-1973,1972-11-29,1973-02-28,92,0,16,102,118,24,17,41,159,8,45,Texas,Abilene,117063
19010,1973-1974,1973-12-01,1974-02-28,90,0,6,77,83,1,0,1,84,1,2,Texas,Abilene,117063
19011,1974-1975,1974-12-01,1975-02-28,90,0,1,58,59,12,9,21,80,3,19,Texas,Abilene,117063
19012,1975-1976,1975-12-01,1976-02-29,91,0,2,75,77,4,1,5,82,2,6,Texas,Abilene,117063
19013,1976-1977,1976-11-12,1977-02-28,109,0,9,123,132,13,9,22,154,5,32,Texas,Abilene,117063
19014,1977-1978,1977-12-01,1978-03-03,93,0,7,105,112,10,2,12,124,7,25,Texas,Abilene,117063
19015,1978-1979,1978-12-01,1979-02-28,90,0,13,101,114,11,8,19,133,6,28,Texas,Abilene,117063
19016,1979-1980,1979-12-01,1980-03-01,92,0,5,52,57,5,4,9,66,3,11,Texas,Abilene,117063
19017,1980-1981,1980-11-16,1981-02-28,105,0,1,52,53,9,4,13,66,6,15,Texas,Abilene,117063
19018,1981-1982,1981-12-01,1982-02-28,90,0,7,75,82,10,5,15,97,4,21,Texas,Abilene,117063
19019,1982-1983,1982-12-01,1983-02-28,90,0,0,46,46,18,17,35,81,5,24,Texas,Abilene,117063
19020,1983-1984,1983-12-01,1984-03-05,96,0,25,107,132,14,12,26,158,8,35,Texas,Abilene,117063
19021,1984-1985,1984-12-01,1985-02-28,90,0,17,80,97,10,14,24,121,4,33,Texas,Abilene,117063
19022,1985-1986,1985-12-01,1986-02-28,90,0,7,68,75,1,0,1,76,1,4,Texas,Abilene,117063
19023,1986-1987,1986-11-13,1987-02-28,108,0,3,43,46,9,7,16,62,4,17,Texas,Abilene,117063
19024,1987-1988,1987-12-01,1988-02-29,91,0,8,80,88,8,4,12,100,4,17,Texas,Abilene,117063
19025,1988-1989,1988-12-01,1989-03-21,111,0,8,68,76,9,8,17,93,4,17,Texas,Abilene,117063
19026,1989-1990,1989-12-01,1990-02-28,90,0,6,73,79,0,0,0,79,0,0,Texas,Abilene,117063
19027,1990-1991,1990-12-01,1991-02-28,90,0,10,62,72,6,6,12,84,3,15,Texas,Abilene,117063
19028,1991-1992,1991-12-01,1992-02-29,91,0,0,33,33,2,1,3,36,2,4,Texas,Abilene,117063
19029,1992-1993,1992-11-21,1993-03-12,112,0,3,50,53,4,3,7,60,2,5,Texas,Abilene,117063
19030,1993-1994,1993-10-29,1994-02-28,123,0,2,71,73,7,3,10,83,5,14,Texas,Abilene,117063
19031,1994-1995,1994-12-01,1995-03-02,92,0,3,34,37,10,4,14,51,3,13,Texas,Abilene,117063
19032,1995-1996,1995-11-28,1996-04-05,130,0,6,106,112,23,3,26,138,5,35,Texas,Abilene,117063
19033,1996-1997,1996-11-24,1997-02-28,97,0,9,72,81,6,3,9,90,5,11,Texas,Abilene,117063
19034,1997-1998,1997-12-01,1998-02-28,90,8,0,41,41,0,0,0,41,0,0,Texas,Abilene,117063
19035,1998-1999,1998-12-01,1999-02-28,90,1,5,52,57,0,0,0,57,0,0,Texas,Abilene,117063
19036,1999-2000,1999-12-01,2000-02-29,91,0,1,41,42,0,0,0,42,0,0,Texas,Abilene,117063
19037,2000-2001,2000-11-08,2001-02-28,113,9,7,72,79,5,4,9,88,2,9,Texas,Abilene,117063
19038,2001-2002,2001-11-28,2002-02-28,93,2,1,56,57,7,5,12,69,1,10,Texas,Abilene,117063
19039,2002-2003,2002-12-01,2003-02-28,90,0,2,51,53,2,1,3,56,1,6,Texas,Abilene,117063
19040,2004-2005,2004-12-01,2005-03-27,117,0,2,43,45,8,2,10,55,2,10,Texas,Abilene,117063
19041,2005-2006,2005-12-01,2006-02-28,90,0,4,55,59,0,0,0,59,0,0,Texas,Abilene,117063
19042,2006-2007,2006-11-30,2007-02-28,91,0,8,66,74,3,2,5,79,3,10,Texas,Abilene,117063
19043,2007-2008,2007-11-22,2008-03-06,106,0,0,70,70,10,1,11,81,4,14,Texas,Abilene,117063
19044,2008-2009,2008-12-01,2009-02-28,90,0,2,68,70,0,0,0,70,0,0,Texas,Abilene,117063
19045,2009-2010,2009-12-01,2010-02-28,90,0,1,83,84,19,9,28,112,5,24,Texas,Abilene,117063
19046,2010-2011,2010-12-01,2011-02-28,90,0,8,80,88,6,13,19,107,3,18,Texas,Abilene,117063
19047,2011-2012,2011-12-01,2012-02-29,91,0,1,33,34,4,2,6,40,2,6,Texas,Abilene,117063
19048,2012-2013,2012-12-01,2013-02-28,90,0,0,57,57,3,1,4,61,2,6,Texas,Abilene,117063
19049,2013-2014,2013-11-22,2014-02-28,99,2,8,105,113,6,6,12,125,5,22,Texas,Abilene,117063
19050,2014-2015,2014-11-16,2015-03-05,110,0,8,64,72,7,2,9,81,5,20,Texas,Abilene,117063
19051,2015-2016,2015-12-01,2016-02-29,91,0,0,33,33,7,6,13,46,3,9,Texas,Abilene,117063
19052,2016-2017,2016-12-01,2017-02-28,90,0,2,46,48,0,0,0,48,0,0,Texas,Abilene,117063
19053,2017-2018,2017-12-01,2018-02-28,90,0,7,97,104,1,0,1,105,1,3,Texas,Abilene,117063
19054,2018-2019,2018-12-01,2019-03-04,94,0,2,37,39,5,0,5,44,2,7,Texas,Abilene,117063
19055,2019-2020,2019-12-01,2020-02-29,91,0,1,39,40,6,0,6,46,2,10,Texas,Abilene,117063
19056,1950-1951,1950-12-01,1951-03-17,107,0,23,197,220,11,8,19,239,9,51,Texas,Amarillo,190695
19057,1951-1952,1951-11-01,1952-03-21,142,0,10,186,196,19,21,40,236,12,60,Texas,Amarillo,190695
19058,1952-1953,1952-11-23,1953-02-28,98,0,10,149,159,39,43,82,241,9,61,Texas,Amarillo,190695
19059,1953-1954,1953-11-21,1954-03-05,105,0,10,147,157,11,6,17,174,8,45,Texas,Amarillo,190695
19060,1954-1955,1954-12-01,1955-04-01,122,0,7,190,197,7,1,8,205,6,21,Texas,Amarillo,190695
19061,1955-1956,1955-11-07,1956-03-15,130,0,16,227,243,27,43,70,313,9,69,Texas,Amarillo,190695
19062,1956-1957,1956-12-01,1957-04-12,133,0,11,151,162,20,12,32,194,7,43,Texas,Amarillo,190695
19063,1957-1958,1957-11-21,1958-03-23,123,0,12,173,185,30,22,52,237,13,59,Texas,Amarillo,190695
19064,1958-1959,1958-11-17,1959-03-21,125,0,22,244,266,18,16,34,300,14,83,Texas,Amarillo,190695
19065,1959-1960,1959-11-05,1960-03-04,121,0,31,236,267,29,51,80,347,13,83,Texas,Amarillo,190695
19066,1960-1961,1960-12-01,1961-04-05,126,0,13,183,196,36,20,56,252,15,66,Texas,Amarillo,190695
19067,1961-1962,1961-11-06,1962-02-28,115,0,28,202,230,16,22,38,268,10,57,Texas,Amarillo,190695
19068,1962-1963,1962-11-17,1963-02-28,104,0,27,213,240,22,13,35,275,10,77,Texas,Amarillo,190695
19069,1963-1964,1963-12-01,1964-02-29,91,0,16,198,214,31,38,69,283,9,66,Texas,Amarillo,190695
19070,1964-1965,1964-12-01,1965-03-25,115,0,13,193,206,22,11,33,239,14,58,Texas,Amarillo,190695
19071,1965-1966,1965-12-01,1966-03-03,93,0,27,208,235,16,42,58,293,10,60,Texas,Amarillo,190695
19072,1966-1967,1966-12-01,1967-03-05,95,0,5,181,186,7,3,10,196,6,25,Texas,Amarillo,190695
19073,1967-1968,1967-11-27,1968-03-20,115,0,18,157,175,29,25,54,229,15,81,Texas,Amarillo,190695
19074,1968-1969,1968-11-08,1969-03-16,129,0,9,198,207,24,12,36,243,15,53,Texas,Amarillo,190695
19075,1969-1970,1969-12-01,1970-04-04,125,0,18,180,198,35,42,77,275,13,64,Texas,Amarillo,190695
19076,1970-1971,1970-10-08,1971-03-02,146,0,17,178,195,33,27,60,255,10,60,Texas,Amarillo,190695
19077,1971-1972,1971-11-30,1972-03-30,122,0,16,192,208,17,28,45,253,8,50,Texas,Amarillo,190695
19078,1972-1973,1972-10-31,1973-04-09,161,0,37,231,268,46,48,94,362,25,133,Texas,Amarillo,190695
19079,1973-1974,1973-11-20,1974-03-23,124,0,20,180,200,13,12,25,225,9,50,Texas,Amarillo,190695
19080,1974-1975,1974-11-29,1975-03-29,121,0,12,194,206,28,29,57,263,15,77,Texas,Amarillo,190695
19081,1975-1976,1975-11-25,1976-03-09,106,0,8,169,177,11,2,13,190,5,18,Texas,Amarillo,190695
19082,1976-1977,1976-10-19,1977-02-28,133,0,19,237,256,28,26,54,310,16,75,Texas,Amarillo,190695
19083,1977-1978,1977-11-01,1978-05-03,184,0,32,255,287,32,35,67,354,19,103,Texas,Amarillo,190695
19084,1978-1979,1978-11-15,1979-02-28,106,0,51,252,303,23,18,41,344,14,96,Texas,Amarillo,190695
19085,1979-1980,1979-10-30,1980-03-29,152,0,17,247,264,17,22,39,303,11,44,Texas,Amarillo,190695
19086,1980-1981,1980-11-16,1981-03-07,112,0,9,184,193,16,18,34,227,8,40,Texas,Amarillo,190695
19087,1981-1982,1981-12-01,1982-03-05,95,0,19,205,224,13,17,30,254,8,55,Texas,Amarillo,190695
19088,1982-1983,1982-11-24,1983-04-08,136,0,15,210,225,69,125,194,419,21,122,Texas,Amarillo,190695
19089,1983-1984,1983-11-27,1984-03-30,125,0,64,284,348,27,64,91,439,13,98,Texas,Amarillo,190695
19090,1984-1985,1984-09-29,1985-03-30,183,0,22,192,214,18,16,34,248,11,61,Texas,Amarillo,190695
19091,1985-1986,1985-12-01,1986-03-13,103,0,24,163,187,23,42,65,252,7,68,Texas,Amarillo,190695
19092,1986-1987,1986-11-13,1987-04-02,141,0,14,179,193,36,66,102,295,17,83,Texas,Amarillo,190695
19093,1987-1988,1987-11-18,1988-04-02,137,0,28,261,289,49,77,126,415,17,112,Texas,Amarillo,190695
19094,1988-1989,1988-11-19,1989-04-10,143,0,19,238,257,15,8,23,280,8,38,Texas,Amarillo,190695
19095,1989-1990,1989-12-01,1990-03-24,114,0,17,196,213,26,21,47,260,10,57,Texas,Amarillo,190695
19096,1990-1991,1990-11-03,1991-03-30,148,0,22,214,236,20,23,43,279,8,64,Texas,Amarillo,190695
19097,1991-1992,1991-10-30,1992-04-01,155,0,7,153,160,13,10,23,183,9,30,Texas,Amarillo,190695
19098,1992-1993,1992-11-21,1993-03-12,112,0,28,230,258,41,57,98,356,12,89,Texas,Amarillo,190695
19099,1993-1994,1993-11-24,1994-03-10,107,0,9,210,219,20,28,48,267,4,38,Texas,Amarillo,190695
19100,1994-1995,1994-12-01,1995-03-03,93,0,11,121,132,10,7,17,149,7,34,Texas,Amarillo,190695
19101,1995-1996,1995-11-10,1996-03-06,118,0,24,214,238,17,15,32,270,11,74,Texas,Amarillo,190695
19102,1996-1997,1996-10-21,1997-04-25,187,0,24,216,240,45,43,88,328,17,105,Texas,Amarillo,190695
19103,1997-1998,1997-11-09,1998-03-19,131,0,11,168,179,49,60,109,288,21,83,Texas,Amarillo,190695
19104,1998-1999,1998-12-01,1999-03-19,109,2,13,135,148,22,15,37,185,8,47,Texas,Amarillo,190695
19105,1999-2000,1999-12-01,2000-04-01,123,0,4,145,149,18,17,35,184,7,31,Texas,Amarillo,190695
19106,2000-2001,2000-11-07,2001-03-26,140,0,15,200,215,67,108,175,390,18,108,Texas,Amarillo,190695
19107,2001-2002,2001-11-27,2002-03-02,96,0,8,149,157,16,15,31,188,9,49,Texas,Amarillo,190695
19108,2002-2003,2002-12-01,2003-03-27,117,0,10,175,185,21,23,44,229,8,42,Texas,Amarillo,190695
19109,2003-2004,2003-12-01,2004-04-12,134,0,5,147,152,18,8,26,178,10,41,Texas,Amarillo,190695
19110,2004-2005,2004-11-01,2005-05-02,183,0,11,140,151,56,41,97,248,16,86,Texas,Amarillo,190695
19111,2005-2006,2005-11-27,2006-03-23,117,0,12,189,201,5,1,6,207,4,14,Texas,Amarillo,190695
19112,2006-2007,2006-11-29,2007-04-14,137,0,20,180,200,39,53,92,292,14,80,Texas,Amarillo,190695
19113,2007-2008,2007-11-23,2008-03-06,105,0,6,177,183,19,7,26,209,11,45,Texas,Amarillo,190695
19114,2008-2009,2008-12-01,2009-03-29,119,0,10,172,182,21,10,31,213,7,42,Texas,Amarillo,190695
19115,2009-2010,2009-11-29,2010-03-25,117,0,16,213,229,43,64,107,336,17,81,Texas,Amarillo,190695
19116,2010-2011,2010-11-12,2011-02-28,109,0,18,212,230,21,19,40,270,7,57,Texas,Amarillo,190695
19117,2011-2012,2011-10-27,2012-03-02,128,0,10,147,157,18,14,32,189,8,36,Texas,Amarillo,190695
19118,2012-2013,2012-12-01,2013-03-23,113,0,5,139,144,45,38,83,227,11,71,Texas,Amarillo,190695
19119,2013-2014,2013-11-22,2014-04-14,144,0,33,246,279,21,17,38,317,12,84,Texas,Amarillo,190695
19120,2014-2015,2014-11-12,2015-03-04,113,0,20,179,199,34,36,70,269,11,79,Texas,Amarillo,190695
19121,2015-2016,2015-11-26,2016-03-27,123,0,7,133,140,21,13,34,174,13,44,Texas,Amarillo,190695
19122,2016-2017,2016-12-01,2017-04-30,151,0,8,149,157,15,11,26,183,8,40,Texas,Amarillo,190695
19123,2017-2018,2017-12-01,2018-02-28,90,0,13,180,193,0,0,0,193,0,0,Texas,Amarillo,190695
19124,2018-2019,2018-11-11,2019-03-04,114,0,11,186,197,14,10,24,221,9,42,Texas,Amarillo,190695
19125,2019-2020,2019-10-24,2020-04-14,174,0,4,170,174,16,10,26,200,6,27,Texas,Amarillo,190695
19126,1950-1951,1950-12-01,1951-02-28,90,0,6,45,51,3,2,5,56,2,9,Texas,Austin,790390
19127,1951-1952,1951-12-01,1952-02-29,91,0,0,14,14,0,0,0,14,0,0,Texas,Austin,790390
19128,1952-1953,1952-12-01,1953-02-28,90,0,0,10,10,0,0,0,10,0,0,Texas,Austin,790390
19129,1953-1954,1953-12-01,1954-02-28,90,0,0,20,20,0,0,0,20,0,0,Texas,Austin,790390
19130,1954-1955,1954-12-01,1955-02-28,90,0,0,13,13,0,0,0,13,0,0,Texas,Austin,790390
19131,1955-1956,1955-12-01,1956-02-29,91,0,1,15,16,0,0,0,16,0,0,Texas,Austin,790390
19132,1956-1957,1956-12-01,1957-02-28,90,0,0,4,4,0,0,0,4,0,0,Texas,Austin,790390
19133,1957-1958,1957-12-01,1958-02-28,90,0,0,15,15,1,0,1,16,1,2,Texas,Austin,790390
19134,1958-1959,1958-12-01,1959-02-28,90,0,1,30,31,0,0,0,31,0,0,Texas,Austin,790390
19135,1959-1960,1959-11-14,1960-02-29,108,0,0,26,26,2,0,2,28,1,3,Texas,Austin,790390
19136,1960-1961,1960-12-01,1961-02-28,90,0,1,15,16,0,0,0,16,0,0,Texas,Austin,790390
19137,1961-1962,1961-12-01,1962-02-28,90,0,5,31,36,0,0,0,36,0,0,Texas,Austin,790390
19138,1962-1963,1962-12-01,1963-02-28,90,0,2,45,47,2,0,2,49,1,3,Texas,Austin,790390
19139,1963-1964,1963-12-01,1964-02-29,91,0,1,34,35,7,1,8,43,2,9,Texas,Austin,790390
19140,1964-1965,1964-12-01,1965-03-03,93,0,0,21,21,4,2,6,27,2,7,Texas,Austin,790390
19141,1965-1966,1965-12-01,1966-02-28,90,0,0,28,28,9,5,14,42,2,11,Texas,Austin,790390
19142,1966-1967,1966-12-01,1967-02-28,90,0,0,28,28,3,1,4,32,1,4,Texas,Austin,790390
19143,1967-1968,1967-12-01,1968-02-29,91,0,2,24,26,0,0,0,26,0,0,Texas,Austin,790390
19144,1968-1969,1968-12-01,1969-02-28,90,0,0,16,16,0,0,0,16,0,0,Texas,Austin,790390
19145,1969-1970,1969-12-01,1970-02-28,90,0,1,27,28,2,1,3,31,1,3,Texas,Austin,790390
19146,1970-1971,1970-12-01,1971-02-28,90,0,0,18,18,0,0,0,18,0,0,Texas,Austin,790390
19147,1971-1972,1971-12-01,1972-02-29,91,0,0,19,19,0,0,0,19,0,0,Texas,Austin,790390
19148,1972-1973,1972-12-01,1973-02-28,90,0,3,31,34,5,2,7,41,5,15,Texas,Austin,790390
19149,1973-1974,1973-12-01,1974-02-28,90,0,1,20,21,0,0,0,21,0,0,Texas,Austin,790390
19150,1974-1975,1974-12-01,1975-02-28,90,0,0,20,20,0,0,0,20,0,0,Texas,Austin,790390
19151,1975-1976,1975-12-01,1976-02-29,91,0,0,20,20,0,0,0,20,0,0,Texas,Austin,790390
19152,1976-1977,1976-12-01,1977-02-28,90,0,0,34,34,0,0,0,34,0,0,Texas,Austin,790390
19153,1977-1978,1977-12-01,1978-02-28,90,0,1,38,39,0,0,0,39,0,0,Texas,Austin,790390
19154,1978-1979,1978-12-01,1979-02-28,90,0,2,50,52,0,0,0,52,0,0,Texas,Austin,790390
19155,1979-1980,1979-12-01,1980-02-29,91,0,0,11,11,0,0,0,11,0,0,Texas,Austin,790390
19156,1980-1981,1980-11-25,1981-02-28,96,0,0,17,17,4,0,4,21,2,4,Texas,Austin,790390
19157,1981-1982,1981-12-01,1982-02-28,90,0,1,29,30,3,2,5,35,1,5,Texas,Austin,790390
19158,1982-1983,1982-12-01,1983-02-28,90,0,0,10,10,0,0,0,10,0,0,Texas,Austin,790390
19159,1983-1984,1983-12-01,1984-02-29,91,0,7,55,62,0,0,0,62,0,0,Texas,Austin,790390
19160,1984-1985,1984-12-01,1985-02-28,90,0,6,31,37,11,11,22,59,4,22,Texas,Austin,790390
19161,1985-1986,1985-12-01,1986-02-28,90,0,0,13,13,0,0,0,13,0,0,Texas,Austin,790390
19162,1986-1987,1986-12-01,1987-02-28,90,0,0,5,5,0,0,0,5,0,0,Texas,Austin,790390
19163,1987-1988,1987-12-01,1988-02-29,91,0,0,23,23,0,0,0,23,0,0,Texas,Austin,790390
19164,1988-1989,1988-12-01,1989-02-28,90,0,5,16,21,0,0,0,21,0,0,Texas,Austin,790390
19165,1989-1990,1989-12-01,1990-02-28,90,0,3,33,36,0,0,0,36,0,0,Texas,Austin,790390
19166,1990-1991,1990-12-01,1991-02-28,90,0,2,19,21,0,0,0,21,0,0,Texas,Austin,790390
19167,1991-1992,1991-12-01,1992-02-29,91,0,0,3,3,0,0,0,3,0,0,Texas,Austin,790390
19168,1992-1993,1992-12-01,1993-02-28,90,0,0,1,1,0,0,0,1,0,0,Texas,Austin,790390
19169,1993-1994,1993-12-01,1994-02-28,90,0,0,9,9,1,0,1,10,1,2,Texas,Austin,790390
19170,1994-1995,1994-12-01,1995-02-28,90,0,0,3,3,0,0,0,3,0,0,Texas,Austin,790390
19171,1995-1996,1995-12-01,1996-02-29,91,0,2,26,28,1,0,1,29,1,3,Texas,Austin,790390
19172,2003-2004,2003-12-01,2004-02-29,91,0,0,9,9,2,1,3,12,1,2,Texas,Austin,790390
19173,2004-2005,2004-12-01,2005-02-28,90,0,0,14,14,0,0,0,14,0,0,Texas,Austin,790390
19174,2005-2006,2005-12-01,2006-02-28,90,0,0,9,9,0,0,0,9,0,0,Texas,Austin,790390
19175,2006-2007,2006-12-01,2007-02-28,90,0,1,14,15,2,1,3,18,2,5,Texas,Austin,790390
19176,2007-2008,2007-12-01,2008-02-29,91,0,0,14,14,0,0,0,14,0,0,Texas,Austin,790390
19177,2008-2009,2008-12-01,2009-02-28,90,0,0,11,11,1,0,1,12,1,1,Texas,Austin,790390
19178,2009-2010,2009-12-01,2010-02-28,90,0,0,27,27,1,0,1,28,1,1,Texas,Austin,790390
19179,2010-2011,2010-12-01,2011-02-28,90,0,2,30,32,1,0,1,33,1,3,Texas,Austin,790390
19180,2011-2012,2011-12-01,2012-02-29,91,0,0,7,7,0,0,0,7,0,0,Texas,Austin,790390
19181,2012-2013,2012-12-01,2013-02-28,90,0,0,11,11,0,0,0,11,0,0,Texas,Austin,790390
19182,2013-2014,2013-12-01,2014-02-28,90,0,2,24,26,2,0,2,28,2,4,Texas,Austin,790390
19183,2014-2015,2014-12-01,2015-02-28,90,0,0,12,12,0,0,0,12,0,0,Texas,Austin,790390
19184,2015-2016,2015-12-01,2016-02-29,91,0,0,4,4,0,0,0,4,0,0,Texas,Austin,790390
19185,2016-2017,2016-12-01,2017-02-28,90,0,0,10,10,0,0,0,10,0,0,Texas,Austin,790390
19186,2017-2018,2017-12-01,2018-02-28,90,0,2,18,20,1,0,1,21,1,2,Texas,Austin,790390
19187,2018-2019,2018-12-01,2019-02-28,90,0,0,5,5,0,0,0,5,0,0,Texas,Austin,790390
19188,2019-2020,2019-12-01,2020-02-29,91,0,0,3,3,0,0,0,3,0,0,Texas,Austin,790390
19189,1950-1951,1950-12-01,1951-02-28,90,0,13,68,81,9,15,24,105,5,29,Texas,Dallas,1197816
19190,1951-1952,1951-11-02,1952-02-29,120,0,0,36,36,1,0,1,37,1,2,Texas,Dallas,1197816
19191,1952-1953,1952-12-01,1953-02-28,90,0,1,13,14,2,1,3,17,1,6,Texas,Dallas,1197816
19192,1953-1954,1953-12-01,1954-03-05,95,0,3,44,47,4,3,7,54,2,10,Texas,Dallas,1197816
19193,1954-1955,1954-12-01,1955-02-28,90,0,0,34,34,0,0,0,34,0,0,Texas,Dallas,1197816
19194,1955-1956,1955-12-01,1956-02-29,91,0,2,39,41,6,10,16,57,3,11,Texas,Dallas,1197816
19195,1956-1957,1956-12-01,1957-02-28,90,0,4,28,32,0,0,0,32,0,0,Texas,Dallas,1197816
19196,1957-1958,1957-12-01,1958-02-28,90,0,0,39,39,2,1,3,42,2,5,Texas,Dallas,1197816
19197,1958-1959,1958-12-01,1959-02-28,90,0,5,68,73,5,1,6,79,3,10,Texas,Dallas,1197816
19198,1959-1960,1959-12-01,1960-03-01,92,0,4,48,52,4,1,5,57,3,9,Texas,Dallas,1197816
19199,1960-1961,1960-12-01,1961-02-28,90,0,3,56,59,9,8,17,76,4,19,Texas,Dallas,1197816
19200,1961-1962,1961-12-01,1962-03-14,104,0,9,79,88,7,5,12,100,3,15,Texas,Dallas,1197816
19201,1962-1963,1962-12-01,1963-03-05,95,0,9,87,96,1,0,1,97,1,1,Texas,Dallas,1197816
19202,1963-1964,1963-12-01,1964-03-09,100,0,2,87,89,23,16,39,128,7,37,Texas,Dallas,1197816
19203,1964-1965,1964-12-01,1965-02-28,90,0,1,56,57,0,0,0,57,0,0,Texas,Dallas,1197816
19204,1965-1966,1965-12-01,1966-02-28,90,4,5,47,52,6,7,13,65,4,14,Texas,Dallas,1197816
19205,1966-1967,1966-12-01,1967-02-28,90,0,0,58,58,0,0,0,58,0,0,Texas,Dallas,1197816
19206,1967-1968,1967-12-01,1968-02-29,91,0,4,43,47,6,3,9,56,4,14,Texas,Dallas,1197816
19207,1968-1969,1968-12-01,1969-02-28,90,0,1,35,36,0,0,0,36,0,0,Texas,Dallas,1197816
19208,1969-1970,1969-12-01,1970-03-21,111,0,2,54,56,2,1,3,59,2,2,Texas,Dallas,1197816
19209,1970-1971,1970-12-01,1971-03-03,93,0,1,52,53,2,2,4,57,1,3,Texas,Dallas,1197816
19210,1971-1972,1971-12-01,1972-02-29,91,0,0,31,31,0,0,0,31,0,0,Texas,Dallas,1197816
19211,1972-1973,1972-12-01,1973-02-28,90,0,5,49,54,6,6,12,66,3,14,Texas,Dallas,1197816
19212,1973-1974,1973-12-01,1974-02-28,90,0,3,42,45,0,0,0,45,0,0,Texas,Dallas,1197816
19213,1974-1975,1974-12-01,1975-02-28,90,1,0,26,26,4,2,6,32,1,5,Texas,Dallas,1197816
19214,1975-1976,1975-12-01,1976-02-29,91,0,1,46,47,1,0,1,48,1,1,Texas,Dallas,1197816
19215,1976-1977,1976-11-13,1977-02-28,108,0,5,86,91,15,13,28,119,4,25,Texas,Dallas,1197816
19216,1977-1978,1977-12-01,1978-02-28,90,0,12,105,117,24,38,62,179,8,44,Texas,Dallas,1197816
19217,1978-1979,1978-12-01,1979-02-28,90,0,9,81,90,6,4,10,100,5,15,Texas,Dallas,1197816
19218,1979-1980,1979-12-01,1980-02-29,91,0,0,38,38,3,1,4,42,2,7,Texas,Dallas,1197816
19219,1980-1981,1980-12-01,1981-02-28,90,0,1,47,48,0,0,0,48,0,0,Texas,Dallas,1197816
19220,1981-1982,1981-12-01,1982-02-28,90,0,5,72,77,1,0,1,78,1,2,Texas,Dallas,1197816
19221,1982-1983,1982-12-01,1983-02-28,90,0,0,26,26,0,0,0,26,0,0,Texas,Dallas,1197816
19222,1983-1984,1983-12-01,1984-02-29,91,0,23,99,122,3,2,5,127,1,4,Texas,Dallas,1197816
19223,1984-1985,1984-12-01,1985-02-28,90,0,10,64,74,8,12,20,94,4,23,Texas,Dallas,1197816
19224,1985-1986,1985-12-01,1986-02-28,90,0,3,52,55,1,0,1,56,1,2,Texas,Dallas,1197816
19225,1986-1987,1986-12-01,1987-03-29,119,0,0,29,29,4,0,4,33,3,6,Texas,Dallas,1197816
19226,1987-1988,1987-12-01,1988-02-29,91,0,4,56,60,6,4,10,70,4,13,Texas,Dallas,1197816
19227,1988-1989,1988-12-01,1989-03-21,111,0,9,48,57,6,2,8,65,6,25,Texas,Dallas,1197816
19228,1989-1990,1989-12-01,1990-02-28,90,0,8,61,69,0,0,0,69,0,0,Texas,Dallas,1197816
19229,1990-1991,1990-12-01,1991-02-28,90,0,5,50,55,3,0,3,58,3,15,Texas,Dallas,1197816
19230,1991-1992,1991-12-01,1992-02-29,91,0,0,16,16,0,0,0,16,0,0,Texas,Dallas,1197816
19231,1992-1993,1992-12-01,1993-02-28,90,0,0,13,13,0,0,0,13,0,0,Texas,Dallas,1197816
19232,1993-1994,1993-11-25,1994-02-28,96,0,0,40,40,2,0,2,42,2,6,Texas,Dallas,1197816
19233,1994-1995,1994-12-01,1995-02-28,90,0,0,18,18,0,0,0,18,0,0,Texas,Dallas,1197816
19234,2005-2006,2005-12-01,2006-02-28,90,0,2,25,27,0,0,0,27,0,0,Texas,Dallas,1197816
19235,2006-2007,2006-12-01,2007-02-28,90,0,3,38,41,2,0,2,43,2,6,Texas,Dallas,1197816
19236,2007-2008,2007-12-01,2008-03-07,98,0,0,27,27,4,2,6,33,2,4,Texas,Dallas,1197816
19237,2008-2009,2008-12-01,2009-02-28,90,0,0,30,30,1,0,1,31,1,2,Texas,Dallas,1197816
19238,2009-2010,2009-12-01,2010-03-21,111,0,2,58,60,25,15,40,100,7,32,Texas,Dallas,1197816
19239,2010-2011,2010-12-01,2011-02-28,90,0,5,58,63,8,8,16,79,6,26,Texas,Dallas,1197816
19240,2011-2012,2011-12-01,2012-02-29,91,0,0,14,14,1,0,1,15,1,2,Texas,Dallas,1197816
19241,2012-2013,2012-12-01,2013-02-28,90,0,1,27,28,3,0,3,31,3,6,Texas,Dallas,1197816
19242,2013-2014,2013-12-01,2014-03-02,92,0,4,70,74,6,9,15,89,4,17,Texas,Dallas,1197816
19243,2014-2015,2014-12-01,2015-03-05,95,0,3,39,42,10,7,17,59,5,19,Texas,Dallas,1197816
19244,2015-2016,2015-12-01,2016-02-29,91,0,0,16,16,0,0,0,16,0,0,Texas,Dallas,1197816
19245,2016-2017,2016-12-01,2017-02-28,90,0,2,23,25,1,0,1,26,1,5,Texas,Dallas,1197816
19246,2017-2018,2017-12-01,2018-02-28,90,0,3,40,43,0,0,0,43,0,0,Texas,Dallas,1197816
19247,2018-2019,2018-12-01,2019-03-04,94,0,1,22,23,0,0,0,23,0,0,Texas,Dallas,1197816
19248,2019-2020,2019-12-01,2020-02-29,91,0,0,16,16,1,0,1,17,1,2,Texas,Dallas,1197816
19249,1950-1951,1950-12-01,1951-02-28,90,0,1,68,69,8,0,8,77,4,17,Texas,El Paso,649121
19250,1951-1952,1951-12-01,1952-02-29,91,0,0,43,43,12,1,13,56,3,16,Texas,El Paso,649121
19251,1952-1953,1952-12-01,1953-02-28,90,0,0,55,55,0,0,0,55,0,0,Texas,El Paso,649121
19252,1953-1954,1953-12-01,1954-02-28,90,0,0,81,81,4,1,5,86,2,7,Texas,El Paso,649121
19253,1954-1955,1954-12-01,1955-03-27,117,0,0,79,79,2,1,3,82,2,6,Texas,El Paso,649121
19254,1955-1956,1955-12-01,1956-02-29,91,0,3,50,53,12,13,25,78,3,23,Texas,El Paso,649121
19255,1956-1957,1956-12-01,1957-02-28,90,0,0,28,28,3,1,4,32,1,4,Texas,El Paso,649121
19256,1957-1958,1957-11-21,1958-03-12,112,0,0,62,62,16,8,24,86,5,22,Texas,El Paso,649121
19257,1958-1959,1958-11-16,1959-02-28,105,0,0,62,62,2,1,3,65,2,4,Texas,El Paso,649121
19258,1959-1960,1959-12-01,1960-02-29,91,0,0,63,63,3,2,5,68,1,6,Texas,El Paso,649121
19259,1960-1961,1960-12-01,1961-02-28,90,0,0,88,88,13,12,25,113,4,18,Texas,El Paso,649121
19260,1961-1962,1961-11-13,1962-02-28,108,0,7,78,85,14,7,21,106,4,27,Texas,El Paso,649121
19261,1962-1963,1962-12-01,1963-02-28,90,0,2,81,83,9,6,15,98,4,24,Texas,El Paso,649121
19262,1963-1964,1963-12-01,1964-02-29,91,0,0,130,130,0,0,0,130,0,0,Texas,El Paso,649121
19263,1964-1965,1964-12-01,1965-02-28,90,0,0,53,53,1,0,1,54,1,2,Texas,El Paso,649121
19264,1965-1966,1965-12-01,1966-02-28,90,0,0,75,75,1,0,1,76,1,2,Texas,El Paso,649121
19265,1966-1967,1966-12-01,1967-02-28,90,0,0,121,121,0,0,0,121,0,0,Texas,El Paso,649121
19266,1967-1968,1967-12-01,1968-03-11,102,0,1,52,53,15,14,29,82,8,24,Texas,El Paso,649121
19267,1968-1969,1968-11-26,1969-02-28,95,0,0,78,78,10,7,17,95,2,12,Texas,El Paso,649121
19268,1969-1970,1969-11-27,1970-02-28,94,0,0,43,43,15,7,22,65,7,21,Texas,El Paso,649121
19269,1970-1971,1970-12-01,1971-02-28,90,0,4,88,92,6,3,9,101,4,28,Texas,El Paso,649121
19270,1971-1972,1971-12-01,1972-02-29,91,0,0,56,56,7,0,7,63,4,12,Texas,El Paso,649121
19271,1972-1973,1972-12-01,1973-02-28,90,0,0,65,65,14,4,18,83,5,16,Texas,El Paso,649121
19272,1973-1974,1973-12-01,1974-02-28,90,0,0,115,115,0,0,0,115,0,0,Texas,El Paso,649121
19273,1974-1975,1974-12-01,1975-03-29,119,1,0,87,87,15,19,34,121,6,23,Texas,El Paso,649121
19274,1975-1976,1975-12-01,1976-02-29,91,0,0,75,75,2,1,3,78,2,5,Texas,El Paso,649121
19275,1976-1977,1976-11-12,1977-02-28,109,0,2,107,109,20,17,37,146,5,35,Texas,El Paso,649121
19276,1977-1978,1977-12-01,1978-02-28,90,0,0,41,41,0,0,0,41,0,0,Texas,El Paso,649121
19277,1978-1979,1978-12-01,1979-02-28,90,0,0,69,69,2,0,2,71,1,3,Texas,El Paso,649121
19278,1979-1980,1979-12-01,1980-04-12,134,0,0,81,81,8,6,14,95,3,14,Texas,El Paso,649121
19279,1980-1981,1980-10-28,1981-02-28,124,0,0,75,75,13,12,25,100,5,17,Texas,El Paso,649121
19280,1981-1982,1981-12-01,1982-02-28,90,0,0,84,84,0,0,0,84,0,0,Texas,El Paso,649121
19281,1982-1983,1982-11-24,1983-04-08,136,0,2,66,68,50,45,95,163,9,56,Texas,El Paso,649121
19282,1983-1984,1983-12-01,1984-03-06,97,0,1,96,97,9,4,13,110,1,10,Texas,El Paso,649121
19283,1984-1985,1984-12-01,1985-02-28,90,0,3,85,88,14,8,22,110,7,32,Texas,El Paso,649121
19284,1985-1986,1985-12-01,1986-02-28,90,0,0,93,93,2,1,3,96,2,5,Texas,El Paso,649121
19285,1986-1987,1986-12-01,1987-03-29,119,0,0,107,107,11,8,19,126,6,24,Texas,El Paso,649121
19286,1987-1988,1987-12-01,1988-02-29,91,0,3,99,102,43,39,82,184,7,57,Texas,El Paso,649121
19287,1988-1989,1988-12-01,1989-02-28,90,0,0,82,82,1,0,1,83,1,2,Texas,El Paso,649121
19288,1989-1990,1989-12-01,1990-02-28,90,0,1,99,100,0,0,0,100,0,0,Texas,El Paso,649121
19289,1990-1991,1990-11-07,1991-02-28,114,0,0,59,59,9,2,11,70,5,12,Texas,El Paso,649121
19290,1991-1992,1991-12-01,1992-02-29,91,0,0,35,35,10,4,14,49,4,12,Texas,El Paso,649121
19291,1992-1993,1992-12-01,1993-02-28,90,0,0,27,27,3,3,6,33,2,5,Texas,El Paso,649121
19292,1993-1994,1993-10-29,1994-02-28,123,0,0,72,72,6,3,9,81,5,11,Texas,El Paso,649121
19293,1994-1995,1994-12-01,1995-02-28,90,0,0,15,15,0,0,0,15,0,0,Texas,El Paso,649121
19294,1995-1996,1995-12-01,1996-02-29,91,0,0,46,46,2,1,3,49,1,3,Texas,El Paso,649121
19295,2004-2005,2004-12-01,2005-02-28,90,5,1,30,31,2,2,4,35,1,3,Texas,El Paso,649121
19296,2005-2006,2005-12-01,2006-02-28,90,5,0,41,41,0,0,0,41,0,0,Texas,El Paso,649121
19297,2006-2007,2006-12-01,2007-02-28,90,12,0,51,51,3,1,4,55,2,5,Texas,El Paso,649121
19298,2007-2008,2007-11-24,2008-02-29,98,0,0,49,49,11,0,11,60,2,13,Texas,El Paso,649121
19299,2008-2009,2008-12-01,2009-02-28,90,0,0,45,45,0,0,0,45,0,0,Texas,El Paso,649121
19300,2009-2010,2009-11-30,2010-02-28,91,0,0,45,45,12,3,15,60,5,15,Texas,El Paso,649121
19301,2010-2011,2010-12-01,2011-02-28,90,0,6,78,84,3,3,6,90,2,11,Texas,El Paso,649121
19302,2011-2012,2011-12-01,2012-02-29,91,0,0,44,44,6,0,6,50,4,10,Texas,El Paso,649121
19303,2012-2013,2012-12-01,2013-02-28,90,0,0,57,57,4,1,5,62,2,6,Texas,El Paso,649121
19304,2013-2014,2013-12-01,2014-02-28,90,0,0,50,50,0,0,0,50,0,0,Texas,El Paso,649121
19305,2014-2015,2014-12-01,2015-02-28,90,0,1,38,39,0,0,0,39,0,0,Texas,El Paso,649121
19306,2015-2016,2015-12-01,2016-02-29,91,0,0,40,40,11,5,16,56,2,13,Texas,El Paso,649121
19307,2016-2017,2016-12-01,2017-02-28,90,0,0,18,18,0,0,0,18,0,0,Texas,El Paso,649121
19308,2017-2018,2017-12-01,2018-02-28,90,0,0,33,33,1,0,1,34,1,2,Texas,El Paso,649121
19309,2018-2019,2018-12-01,2019-02-28,90,0,0,29,29,4,1,5,34,2,6,Texas,El Paso,649121
19310,2019-2020,2019-12-01,2020-02-29,91,0,0,29,29,4,2,6,35,3,6,Texas,El Paso,649121
19311,1969-1970,1969-12-01,1970-02-28,90,0,0,26,26,0,0,0,26,0,0,Texas,Houston,2099451
19312,1970-1971,1970-12-01,1971-02-28,90,0,0,16,16,0,0,0,16,0,0,Texas,Houston,2099451
19313,1971-1972,1971-12-01,1972-02-29,91,0,0,17,17,0,0,0,17,0,0,Texas,Houston,2099451
19314,1972-1973,1972-12-01,1973-02-28,90,0,0,30,30,8,2,10,40,4,11,Texas,Houston,2099451
19315,1973-1974,1973-12-01,1974-02-28,90,0,0,18,18,0,0,0,18,0,0,Texas,Houston,2099451
19316,1974-1975,1974-12-01,1975-02-28,90,0,0,20,20,0,0,0,20,0,0,Texas,Houston,2099451
19317,1975-1976,1975-12-01,1976-02-29,91,0,0,29,29,0,0,0,29,0,0,Texas,Houston,2099451
19318,1976-1977,1976-12-01,1977-02-28,90,0,0,42,42,0,0,0,42,0,0,Texas,Houston,2099451
19319,1977-1978,1977-12-01,1978-02-28,90,1,2,42,44,1,0,1,45,1,2,Texas,Houston,2099451
19320,1978-1979,1978-12-01,1979-02-28,90,0,0,33,33,0,0,0,33,0,0,Texas,Houston,2099451
19321,1979-1980,1979-12-01,1980-02-29,91,0,0,17,17,2,0,2,19,1,3,Texas,Houston,2099451
19322,1980-1981,1980-12-01,1981-02-28,90,0,0,14,14,0,0,0,14,0,0,Texas,Houston,2099451
19323,1981-1982,1981-12-01,1982-02-28,90,0,0,20,20,0,0,0,20,0,0,Texas,Houston,2099451
19324,1982-1983,1982-12-01,1983-02-28,90,0,0,5,5,0,0,0,5,0,0,Texas,Houston,2099451
19325,1983-1984,1983-12-01,1984-02-29,91,0,4,40,44,0,0,0,44,0,0,Texas,Houston,2099451
19326,1984-1985,1984-12-01,1985-02-28,90,0,1,23,24,4,0,4,28,3,9,Texas,Houston,2099451
19327,1985-1986,1985-12-01,1986-02-28,90,0,0,10,10,0,0,0,10,0,0,Texas,Houston,2099451
19328,1986-1987,1986-12-01,1987-02-28,90,0,0,7,7,0,0,0,7,0,0,Texas,Houston,2099451
19329,1987-1988,1987-12-01,1988-02-29,91,0,0,18,18,0,0,0,18,0,0,Texas,Houston,2099451
19330,1988-1989,1988-12-01,1989-02-28,90,0,4,18,22,0,0,0,22,0,0,Texas,Houston,2099451
19331,1989-1990,1989-12-01,1990-02-28,90,0,1,29,30,2,0,2,32,1,6,Texas,Houston,2099451
19332,1990-1991,1990-12-01,1991-02-28,90,0,1,18,19,0,0,0,19,0,0,Texas,Houston,2099451
19333,1991-1992,1991-12-01,1992-02-29,91,0,0,5,5,0,0,0,5,0,0,Texas,Houston,2099451
19334,1992-1993,1992-12-01,1993-02-28,90,0,0,2,2,0,0,0,2,0,0,Texas,Houston,2099451
19335,1993-1994,1993-12-01,1994-02-28,90,0,0,11,11,1,0,1,12,1,2,Texas,Houston,2099451
19336,1994-1995,1994-12-01,1995-02-28,90,0,0,4,4,0,0,0,4,0,0,Texas,Houston,2099451
19337,1995-1996,1995-12-01,1996-02-29,91,0,0,22,22,0,0,0,22,0,0,Texas,Houston,2099451
19338,1996-1997,1996-12-01,1997-02-28,90,1,1,19,20,0,0,0,20,0,0,Texas,Houston,2099451
19339,1997-1998,1997-12-01,1998-02-28,90,0,0,8,8,0,0,0,8,0,0,Texas,Houston,2099451
19340,1998-1999,1998-12-01,1999-02-28,90,0,0,8,8,0,0,0,8,0,0,Texas,Houston,2099451
19341,1999-2000,1999-12-01,2000-02-29,91,0,0,13,13,0,0,0,13,0,0,Texas,Houston,2099451
19342,2000-2001,2000-12-01,2001-02-28,90,0,0,18,18,0,0,0,18,0,0,Texas,Houston,2099451
19343,2001-2002,2001-12-01,2002-02-28,90,0,0,17,17,0,0,0,17,0,0,Texas,Houston,2099451
19344,2002-2003,2002-12-01,2003-02-28,90,0,0,6,6,0,0,0,6,0,0,Texas,Houston,2099451
19345,2003-2004,2003-12-01,2004-02-29,91,0,0,5,5,0,0,0,5,0,0,Texas,Houston,2099451
19346,2004-2005,2004-12-01,2005-02-28,90,0,0,8,8,0,0,0,8,0,0,Texas,Houston,2099451
19347,2005-2006,2005-12-01,2006-02-28,90,0,0,4,4,0,0,0,4,0,0,Texas,Houston,2099451
19348,2006-2007,2006-12-01,2007-02-28,90,0,0,9,9,0,0,0,9,0,0,Texas,Houston,2099451
19349,2007-2008,2007-12-01,2008-02-29,91,0,0,5,5,0,0,0,5,0,0,Texas,Houston,2099451
19350,2008-2009,2008-12-01,2009-02-28,90,0,0,9,9,2,0,2,11,1,3,Texas,Houston,2099451
19351,2009-2010,2009-12-01,2010-02-28,90,0,0,19,19,2,0,2,21,1,3,Texas,Houston,2099451
19352,2010-2011,2010-12-01,2011-02-28,90,0,1,27,28,0,0,0,28,0,0,Texas,Houston,2099451
19353,2011-2012,2011-12-01,2012-02-29,91,0,0,5,5,0,0,0,5,0,0,Texas,Houston,2099451
19354,2012-2013,2012-12-01,2013-02-28,90,0,0,7,7,0,0,0,7,0,0,Texas,Houston,2099451
19355,2013-2014,2013-12-01,2014-02-28,90,0,0,18,18,0,0,0,18,0,0,Texas,Houston,2099451
19356,2014-2015,2014-12-01,2015-02-28,90,0,0,3,3,0,0,0,3,0,0,Texas,Houston,2099451
19357,2015-2016,2015-12-01,2016-02-29,91,0,0,2,2,0,0,0,2,0,0,Texas,Houston,2099451
19358,2016-2017,2016-12-01,2017-02-28,90,0,0,6,6,0,0,0,6,0,0,Texas,Houston,2099451
19359,2017-2018,2017-12-01,2018-02-28,90,0,0,15,15,3,1,4,19,3,5,Texas,Houston,2099451
19360,2018-2019,2018-12-01,2019-02-28,90,0,0,2,2,0,0,0,2,0,0,Texas,Houston,2099451
19361,2019-2020,2019-12-01,2020-02-29,91,0,0,3,3,0,0,0,3,0,0,Texas,Houston,2099451
19362,1950-1951,1950-12-01,1951-02-28,90,0,13,166,179,8,6,14,193,4,23,Texas,Lubbock,229573
19363,1951-1952,1951-12-01,1952-02-29,91,0,3,116,119,2,1,3,122,1,4,Texas,Lubbock,229573
19364,1952-1953,1952-11-27,1953-02-28,94,0,2,129,131,0,0,0,131,0,0,Texas,Lubbock,229573
19365,1953-1954,1953-12-01,1954-03-04,94,0,5,137,142,2,1,3,145,1,5,Texas,Lubbock,229573
19366,1954-1955,1954-12-01,1955-03-21,111,0,1,144,145,17,11,28,173,4,27,Texas,Lubbock,229573
19367,1955-1956,1955-11-07,1956-02-29,115,0,11,162,173,26,38,64,237,6,54,Texas,Lubbock,229573
19368,1956-1957,1956-12-01,1957-04-04,125,1,4,100,104,4,1,5,109,3,6,Texas,Lubbock,229573
19369,1957-1958,1957-11-21,1958-03-19,119,0,5,161,166,38,41,79,245,12,62,Texas,Lubbock,229573
19370,1958-1959,1958-11-28,1959-02-28,93,0,7,168,175,6,2,8,183,6,29,Texas,Lubbock,229573
19371,1959-1960,1959-12-01,1960-03-05,96,0,13,162,175,20,18,38,213,6,38,Texas,Lubbock,229573
19372,1960-1961,1960-12-01,1961-03-20,110,0,9,152,161,47,40,87,248,12,75,Texas,Lubbock,229573
19373,1961-1962,1961-11-15,1962-03-14,120,0,10,185,195,5,1,6,201,5,18,Texas,Lubbock,229573
19374,1962-1963,1962-12-01,1963-02-28,90,1,15,179,194,19,17,36,230,9,64,Texas,Lubbock,229573
19375,1963-1964,1963-12-01,1964-03-09,100,0,6,177,183,9,4,13,196,6,23,Texas,Lubbock,229573
19376,1964-1965,1964-12-01,1965-03-25,115,0,6,144,150,9,2,11,161,7,25,Texas,Lubbock,229573
19377,1965-1966,1965-12-01,1966-02-28,90,0,6,135,141,8,16,24,165,5,18,Texas,Lubbock,229573
19378,1966-1967,1966-12-01,1967-02-28,90,0,0,190,190,1,1,2,192,1,2,Texas,Lubbock,229573
19379,1967-1968,1967-10-31,1968-03-22,144,0,14,165,179,29,21,50,229,15,71,Texas,Lubbock,229573
19380,1968-1969,1968-11-08,1969-03-18,131,0,1,145,146,22,17,39,185,7,27,Texas,Lubbock,229573
19381,1969-1970,1969-11-01,1970-03-21,141,0,2,169,171,22,12,34,205,11,38,Texas,Lubbock,229573
19382,1970-1971,1970-11-13,1971-03-03,111,0,7,150,157,12,10,22,179,5,28,Texas,Lubbock,229573
19383,1971-1972,1971-12-01,1972-02-29,91,0,2,117,119,14,13,27,146,7,33,Texas,Lubbock,229573
19384,1972-1973,1972-11-18,1973-04-08,142,0,21,160,181,37,34,71,252,16,80,Texas,Lubbock,229573
19385,1973-1974,1973-12-01,1974-02-28,90,0,6,122,128,1,0,1,129,1,5,Texas,Lubbock,229573
19386,1974-1975,1974-12-01,1975-03-29,119,0,2,120,122,13,6,19,141,10,33,Texas,Lubbock,229573
19387,1975-1976,1975-12-01,1976-02-29,91,0,2,117,119,5,3,8,127,3,7,Texas,Lubbock,229573
19388,1976-1977,1976-10-28,1977-02-28,124,0,10,184,194,31,24,55,249,12,71,Texas,Lubbock,229573
19389,1977-1978,1977-12-01,1978-03-03,93,0,19,166,185,24,33,57,242,9,57,Texas,Lubbock,229573
19390,1978-1979,1978-11-16,1979-03-10,115,0,21,174,195,23,19,42,237,12,59,Texas,Lubbock,229573
19391,1979-1980,1979-11-10,1980-04-12,155,0,8,135,143,18,19,37,180,8,31,Texas,Lubbock,229573
19392,1980-1981,1980-11-16,1981-02-28,105,0,4,113,117,35,40,75,192,7,48,Texas,Lubbock,229573
19393,1981-1982,1981-12-01,1982-02-28,90,0,9,125,134,7,2,9,143,6,26,Texas,Lubbock,229573
19394,1982-1983,1982-11-24,1983-04-08,136,0,16,162,178,58,111,169,347,16,89,Texas,Lubbock,229573
19395,1983-1984,1983-12-01,1984-02-29,91,0,35,157,192,11,3,14,206,9,63,Texas,Lubbock,229573
19396,1984-1985,1984-12-01,1985-02-28,90,0,12,128,140,6,5,11,151,6,36,Texas,Lubbock,229573
19397,1985-1986,1985-12-01,1986-02-28,90,0,14,118,132,14,21,35,167,7,49,Texas,Lubbock,229573
19398,1986-1987,1986-11-13,1987-04-05,144,0,8,119,127,22,25,47,174,12,38,Texas,Lubbock,229573
19399,1987-1988,1987-12-01,1988-03-03,94,0,16,134,150,17,22,39,189,11,50,Texas,Lubbock,229573
19400,1988-1989,1988-11-19,1989-03-21,123,0,11,143,154,14,9,23,177,6,29,Texas,Lubbock,229573
19401,1989-1990,1989-12-01,1990-03-24,114,0,8,148,156,6,0,6,162,6,21,Texas,Lubbock,229573
19402,1990-1991,1990-11-04,1991-03-30,147,0,10,123,133,6,0,6,139,6,22,Texas,Lubbock,229573
19403,1991-1992,1991-10-31,1992-02-29,122,0,4,82,86,14,8,22,108,7,29,Texas,Lubbock,229573
19404,1992-1993,1992-11-21,1993-03-12,112,0,7,117,124,15,9,24,148,9,37,Texas,Lubbock,229573
19405,1993-1994,1993-10-29,1994-03-08,131,0,1,157,158,6,1,7,165,5,11,Texas,Lubbock,229573
19406,1994-1995,1994-12-01,1995-03-02,92,0,3,74,77,6,0,6,83,5,17,Texas,Lubbock,229573
19407,1995-1996,1995-12-01,1996-03-06,97,5,10,133,143,7,1,8,151,4,25,Texas,Lubbock,229573
19408,1996-1997,1996-12-01,1997-02-28,90,0,17,125,142,17,16,33,175,11,63,Texas,Lubbock,229573
19409,1997-1998,1997-11-14,1998-03-16,123,0,3,133,136,12,7,19,155,9,24,Texas,Lubbock,229573
19410,1998-1999,1998-12-01,1999-02-28,90,0,3,100,103,6,4,10,113,2,8,Texas,Lubbock,229573
19411,1999-2000,1999-10-17,2000-02-29,136,1,1,101,102,13,7,20,122,3,18,Texas,Lubbock,229573
19412,2000-2001,2000-11-07,2001-03-18,132,0,11,143,154,26,38,64,218,9,43,Texas,Lubbock,229573
19413,2001-2002,2001-11-27,2002-02-28,94,0,5,115,120,13,14,27,147,6,28,Texas,Lubbock,229573
19414,2002-2003,2002-12-01,2003-03-28,118,0,2,110,112,2,1,3,115,2,3,Texas,Lubbock,229573
19415,2003-2004,2003-12-01,2004-02-29,91,0,3,102,105,7,3,10,115,5,15,Texas,Lubbock,229573
19416,2004-2005,2004-11-02,2005-03-16,135,0,6,87,93,23,19,42,135,8,42,Texas,Lubbock,229573
19417,2005-2006,2005-12-01,2006-03-22,112,0,2,110,112,2,0,2,114,2,7,Texas,Lubbock,229573
19418,2006-2007,2006-11-30,2007-04-08,130,0,10,124,134,22,19,41,175,11,48,Texas,Lubbock,229573
19419,2007-2008,2007-11-22,2008-03-06,106,0,3,133,136,7,2,9,145,7,18,Texas,Lubbock,229573
19420,2008-2009,2008-12-01,2009-03-27,117,0,2,117,119,2,0,2,121,2,8,Texas,Lubbock,229573
19421,2009-2010,2009-12-01,2010-03-20,110,0,6,144,150,20,21,41,191,12,35,Texas,Lubbock,229573
19422,2010-2011,2010-12-01,2011-02-28,90,0,11,149,160,10,4,14,174,8,48,Texas,Lubbock,229573
19423,2011-2012,2011-12-01,2012-02-29,91,0,3,95,98,10,5,15,113,4,20,Texas,Lubbock,229573
19424,2012-2013,2012-12-01,2013-04-10,131,0,1,124,125,7,2,9,134,4,17,Texas,Lubbock,229573
19425,2013-2014,2013-11-22,2014-03-02,101,0,19,174,193,8,4,12,205,5,30,Texas,Lubbock,229573
19426,2014-2015,2014-11-12,2015-03-05,114,0,14,128,142,25,23,48,190,14,64,Texas,Lubbock,229573
19427,2015-2016,2015-12-01,2016-02-29,91,0,2,97,99,18,27,45,144,3,23,Texas,Lubbock,229573
19428,2016-2017,2016-12-01,2017-02-28,90,0,4,79,83,1,0,1,84,1,7,Texas,Lubbock,229573
19429,2017-2018,2017-12-01,2018-02-28,90,0,5,144,149,1,0,1,150,1,6,Texas,Lubbock,229573
19430,2018-2019,2018-12-01,2019-03-04,94,0,6,106,112,15,8,23,135,2,18,Texas,Lubbock,229573
19431,2019-2020,2019-10-24,2020-02-29,129,0,2,108,110,6,1,7,117,5,17,Texas,Lubbock,229573
19432,1950-1951,1950-12-01,1951-02-28,90,0,7,110,117,3,2,5,122,1,6,Texas,Midland,111147
19433,1951-1952,1951-12-01,1952-02-29,91,0,1,46,47,2,0,2,49,1,3,Texas,Midland,111147
19434,1952-1953,1952-12-01,1953-02-28,90,0,0,48,48,0,0,0,48,0,0,Texas,Midland,111147
19435,1953-1954,1953-12-01,1954-02-28,90,0,1,60,61,0,0,0,61,0,0,Texas,Midland,111147
19436,1954-1955,1954-12-01,1955-02-28,90,0,0,71,71,9,7,16,87,2,14,Texas,Midland,111147
19437,1955-1956,1955-11-08,1956-02-29,114,0,5,81,86,5,2,7,93,4,21,Texas,Midland,111147
19438,1956-1957,1956-12-01,1957-02-28,90,0,3,43,46,0,0,0,46,0,0,Texas,Midland,111147
19439,1957-1958,1957-11-22,1958-03-12,111,0,2,72,74,9,3,12,86,5,16,Texas,Midland,111147
19440,1958-1959,1958-12-01,1959-02-28,90,0,4,92,96,2,0,2,98,2,5,Texas,Midland,111147
19441,1959-1960,1959-11-14,1960-03-01,109,0,4,92,96,6,0,6,102,4,16,Texas,Midland,111147
19442,1960-1961,1960-12-01,1961-02-28,90,0,3,86,89,13,7,20,109,6,26,Texas,Midland,111147
19443,1961-1962,1961-12-01,1962-03-14,104,0,6,96,102,6,4,10,112,2,16,Texas,Midland,111147
19444,1962-1963,1962-12-01,1963-02-28,90,0,9,108,117,5,4,9,126,3,14,Texas,Midland,111147
19445,1963-1964,1963-12-01,1964-02-29,91,0,3,106,109,2,0,2,111,2,4,Texas,Midland,111147
19446,1964-1965,1964-12-01,1965-03-03,93,0,2,75,77,7,1,8,85,3,12,Texas,Midland,111147
19447,1965-1966,1965-12-01,1966-02-28,90,0,3,101,104,5,8,13,117,2,12,Texas,Midland,111147
19448,1966-1967,1966-12-01,1967-02-28,90,0,0,118,118,0,0,0,118,0,0,Texas,Midland,111147
19449,1967-1968,1967-12-01,1968-03-11,102,0,5,72,77,8,7,15,92,6,17,Texas,Midland,111147
19450,1968-1969,1968-11-08,1969-03-16,129,0,0,99,99,10,1,11,110,5,15,Texas,Midland,111147
19451,1969-1970,1969-11-28,1970-03-21,114,0,1,83,84,15,5,20,104,8,24,Texas,Midland,111147
19452,1970-1971,1970-12-01,1971-02-28,90,0,2,69,71,1,0,1,72,1,3,Texas,Midland,111147
19453,1971-1972,1971-12-01,1972-02-29,91,0,1,80,81,4,1,5,86,3,12,Texas,Midland,111147
19454,1972-1973,1972-11-29,1973-02-28,92,0,7,88,95,14,4,18,113,9,31,Texas,Midland,111147
19455,1973-1974,1973-12-01,1974-02-28,90,0,0,72,72,10,9,19,91,3,10,Texas,Midland,111147
19456,1974-1975,1974-12-01,1975-02-28,90,0,0,43,43,4,0,4,47,3,9,Texas,Midland,111147
19457,1975-1976,1975-12-01,1976-02-29,91,0,0,65,65,3,0,3,68,2,4,Texas,Midland,111147
19458,1976-1977,1976-11-12,1977-02-28,109,0,3,97,100,8,8,16,116,3,15,Texas,Midland,111147
19459,1977-1978,1977-12-01,1978-02-28,90,0,2,81,83,2,1,3,86,1,6,Texas,Midland,111147
19460,1978-1979,1978-12-01,1979-02-28,90,0,8,111,119,6,4,10,129,4,16,Texas,Midland,111147
19461,1979-1980,1979-12-01,1980-02-29,91,0,3,64,67,9,4,13,80,4,19,Texas,Midland,111147
19462,1980-1981,1980-11-16,1981-02-28,105,0,3,69,72,15,22,37,109,4,21,Texas,Midland,111147
19463,1981-1982,1981-12-01,1982-02-28,90,0,5,91,96,5,4,9,105,2,10,Texas,Midland,111147
19464,1982-1983,1982-11-24,1983-04-07,135,0,2,74,76,16,26,42,118,7,26,Texas,Midland,111147
19465,1983-1984,1983-12-01,1984-02-29,91,0,15,105,120,4,2,6,126,2,10,Texas,Midland,111147
19466,1984-1985,1984-12-01,1985-02-28,90,0,13,91,104,14,22,36,140,6,47,Texas,Midland,111147
19467,1985-1986,1985-12-01,1986-02-28,90,0,5,95,100,5,3,8,108,3,13,Texas,Midland,111147
19468,1986-1987,1986-11-13,1987-03-29,137,0,4,80,84,18,10,28,112,8,27,Texas,Midland,111147
19469,1987-1988,1987-12-01,1988-03-03,94,0,6,125,131,8,3,11,142,6,22,Texas,Midland,111147
19470,1988-1989,1988-12-01,1989-03-22,112,0,3,117,120,10,5,15,135,4,17,Texas,Midland,111147
19471,1989-1990,1989-11-30,1990-02-28,91,0,5,111,116,2,0,2,118,2,12,Texas,Midland,111147
19472,1990-1991,1990-12-01,1991-02-28,90,0,2,73,75,10,3,13,88,6,23,Texas,Midland,111147
19473,1991-1992,1991-10-31,1992-02-29,122,0,1,70,71,11,11,22,93,6,20,Texas,Midland,111147
19474,1992-1993,1992-12-01,1993-02-28,90,0,3,56,59,6,5,11,70,2,9,Texas,Midland,111147
19475,1993-1994,1993-10-30,1994-02-28,122,0,1,98,99,9,7,16,115,6,20,Texas,Midland,111147
19476,1994-1995,1994-12-01,1995-03-02,92,0,3,38,41,3,1,4,45,2,6,Texas,Midland,111147
19477,1995-1996,1995-12-01,1996-04-05,127,0,4,107,111,6,0,6,117,4,15,Texas,Midland,111147
19478,1996-1997,1996-11-24,1997-02-28,97,0,9,89,98,10,5,15,113,5,22,Texas,Midland,111147
19479,1997-1998,1997-12-01,1998-02-28,90,0,0,57,57,5,3,8,65,2,8,Texas,Midland,111147
19480,1998-1999,1998-12-01,1999-02-28,90,0,4,67,71,14,7,21,92,2,16,Texas,Midland,111147
19481,1999-2000,1999-12-01,2000-02-29,91,0,1,52,53,1,0,1,54,1,2,Texas,Midland,111147
19482,2000-2001,2000-11-07,2001-02-28,114,0,2,75,77,9,1,10,87,6,17,Texas,Midland,111147
19483,2001-2002,2001-11-27,2002-02-28,94,0,2,76,78,13,7,20,98,3,20,Texas,Midland,111147
19484,2002-2003,2002-12-01,2003-02-28,90,0,1,59,60,0,0,0,60,0,0,Texas,Midland,111147
19485,2004-2005,2004-12-01,2005-02-28,90,0,2,46,48,3,0,3,51,2,6,Texas,Midland,111147
19486,2005-2006,2005-12-01,2006-02-28,90,0,0,72,72,2,0,2,74,1,3,Texas,Midland,111147
19487,2006-2007,2006-11-30,2007-04-07,129,0,5,91,96,11,0,11,107,6,22,Texas,Midland,111147
19488,2007-2008,2007-11-22,2008-02-29,100,0,0,97,97,8,3,11,108,3,11,Texas,Midland,111147
19489,2008-2009,2008-12-01,2009-02-28,90,0,1,81,82,0,0,0,82,0,0,Texas,Midland,111147
19490,2009-2010,2009-12-01,2010-02-28,90,0,2,96,98,14,0,14,112,7,26,Texas,Midland,111147
19491,2010-2011,2010-12-01,2011-02-28,90,0,9,120,129,6,2,8,137,4,29,Texas,Midland,111147
19492,2011-2012,2011-12-01,2012-02-29,91,0,2,49,51,26,14,40,91,5,33,Texas,Midland,111147
19493,2012-2013,2012-12-01,2013-02-28,90,0,0,63,63,2,1,3,66,1,3,Texas,Midland,111147
19494,2013-2014,2013-11-23,2014-02-28,98,0,10,90,100,3,0,3,103,3,12,Texas,Midland,111147
19495,2014-2015,2014-11-13,2015-02-28,108,0,10,62,72,8,2,10,82,7,23,Texas,Midland,111147
19496,2015-2016,2015-12-01,2016-02-29,91,0,0,47,47,11,11,22,69,2,13,Texas,Midland,111147
19497,2016-2017,2016-12-01,2017-02-28,90,0,2,31,33,1,0,1,34,1,2,Texas,Midland,111147
19498,2017-2018,2017-12-01,2018-02-28,90,0,5,76,81,0,0,0,81,0,0,Texas,Midland,111147
19499,2018-2019,2018-12-01,2019-02-28,90,0,1,43,44,0,0,0,44,0,0,Texas,Midland,111147
19500,2019-2020,2019-12-01,2020-02-29,91,0,1,39,40,10,10,20,60,2,16,Texas,Midland,111147
19501,1950-1951,1950-12-01,1951-02-28,90,0,5,47,52,3,1,4,56,3,12,Texas,San Antonio,1327407
19502,1951-1952,1951-12-01,1952-02-29,91,0,0,10,10,0,0,0,10,0,0,Texas,San Antonio,1327407
19503,1952-1953,1952-12-01,1953-02-28,90,0,0,8,8,0,0,0,8,0,0,Texas,San Antonio,1327407
19504,1953-1954,1953-12-01,1954-02-28,90,0,0,18,18,0,0,0,18,0,0,Texas,San Antonio,1327407
19505,1954-1955,1954-12-01,1955-02-28,90,0,0,10,10,0,0,0,10,0,0,Texas,San Antonio,1327407
19506,1955-1956,1955-12-01,1956-02-29,91,0,0,18,18,0,0,0,18,0,0,Texas,San Antonio,1327407
19507,1956-1957,1956-12-01,1957-02-28,90,0,0,5,5,0,0,0,5,0,0,Texas,San Antonio,1327407
19508,1957-1958,1957-11-23,1958-02-28,98,0,0,17,17,3,1,4,21,3,4,Texas,San Antonio,1327407
19509,1958-1959,1958-12-01,1959-02-28,90,0,0,24,24,0,0,0,24,0,0,Texas,San Antonio,1327407
19510,1959-1960,1959-12-01,1960-02-29,91,0,0,20,20,0,0,0,20,0,0,Texas,San Antonio,1327407
19511,1960-1961,1960-12-01,1961-02-28,90,0,0,17,17,0,0,0,17,0,0,Texas,San Antonio,1327407
19512,1961-1962,1961-12-01,1962-02-28,90,0,1,29,30,0,0,0,30,0,0,Texas,San Antonio,1327407
19513,1962-1963,1962-12-01,1963-02-28,90,0,1,30,31,0,0,0,31,0,0,Texas,San Antonio,1327407
19514,1963-1964,1963-12-01,1964-02-29,91,0,0,26,26,3,0,3,29,1,4,Texas,San Antonio,1327407
19515,1964-1965,1964-12-01,1965-02-28,90,0,0,25,25,1,1,2,27,1,2,Texas,San Antonio,1327407
19516,1965-1966,1965-12-01,1966-02-28,90,0,0,36,36,5,3,8,44,2,7,Texas,San Antonio,1327407
19517,1966-1967,1966-12-01,1967-02-28,90,0,0,44,44,0,0,0,44,0,0,Texas,San Antonio,1327407
19518,1967-1968,1967-12-01,1968-02-29,91,0,0,23,23,0,0,0,23,0,0,Texas,San Antonio,1327407
19519,1968-1969,1968-12-01,1969-02-28,90,0,0,21,21,0,0,0,21,0,0,Texas,San Antonio,1327407
19520,1969-1970,1969-12-01,1970-02-28,90,0,0,26,26,0,0,0,26,0,0,Texas,San Antonio,1327407
19521,1970-1971,1970-12-01,1971-02-28,90,0,0,22,22,0,0,0,22,0,0,Texas,San Antonio,1327407
19522,1971-1972,1971-12-01,1972-02-29,91,0,0,18,18,0,0,0,18,0,0,Texas,San Antonio,1327407
19523,1972-1973,1972-12-01,1973-02-28,90,0,1,38,39,5,3,8,47,3,8,Texas,San Antonio,1327407
19524,1973-1974,1973-12-01,1974-02-28,90,0,0,30,30,0,0,0,30,0,0,Texas,San Antonio,1327407
19525,1974-1975,1974-12-01,1975-02-28,90,0,0,20,20,0,0,0,20,0,0,Texas,San Antonio,1327407
19526,1975-1976,1975-12-01,1976-02-29,91,0,0,32,32,0,0,0,32,0,0,Texas,San Antonio,1327407
19527,1976-1977,1976-12-01,1977-02-28,90,0,0,32,32,0,0,0,32,0,0,Texas,San Antonio,1327407
19528,1977-1978,1977-12-01,1978-02-28,90,0,0,36,36,0,0,0,36,0,0,Texas,San Antonio,1327407
19529,1978-1979,1978-12-01,1979-02-28,90,0,0,36,36,0,0,0,36,0,0,Texas,San Antonio,1327407
19530,1979-1980,1979-12-01,1980-02-29,91,0,0,19,19,0,0,0,19,0,0,Texas,San Antonio,1327407
19531,1980-1981,1980-12-01,1981-02-28,90,0,0,18,18,0,0,0,18,0,0,Texas,San Antonio,1327407
19532,1981-1982,1981-12-01,1982-02-28,90,0,1,46,47,1,0,1,48,1,3,Texas,San Antonio,1327407
19533,1982-1983,1982-12-01,1983-02-28,90,0,0,12,12,0,0,0,12,0,0,Texas,San Antonio,1327407
19534,1983-1984,1983-12-01,1984-02-29,91,0,4,58,62,0,0,0,62,0,0,Texas,San Antonio,1327407
19535,1984-1985,1984-12-01,1985-02-28,90,0,4,37,41,22,18,40,81,3,28,Texas,San Antonio,1327407
19536,1985-1986,1985-12-01,1986-02-28,90,0,0,18,18,0,0,0,18,0,0,Texas,San Antonio,1327407
19537,1986-1987,1986-12-01,1987-02-28,90,0,0,11,11,2,0,2,13,1,2,Texas,San Antonio,1327407
19538,1987-1988,1987-12-01,1988-02-29,91,0,0,27,27,1,0,1,28,1,1,Texas,San Antonio,1327407
19539,1988-1989,1988-12-01,1989-02-28,90,0,3,16,19,0,0,0,19,0,0,Texas,San Antonio,1327407
19540,1989-1990,1989-12-01,1990-02-28,90,0,3,34,37,0,0,0,37,0,0,Texas,San Antonio,1327407
19541,1990-1991,1990-12-01,1991-02-28,90,0,1,23,24,0,0,0,24,0,0,Texas,San Antonio,1327407
19542,1991-1992,1991-12-01,1992-02-29,91,0,0,4,4,0,0,0,4,0,0,Texas,San Antonio,1327407
19543,1992-1993,1992-12-01,1993-02-28,90,0,0,1,1,0,0,0,1,0,0,Texas,San Antonio,1327407
19544,1993-1994,1993-12-01,1994-02-28,90,0,0,23,23,0,0,0,23,0,0,Texas,San Antonio,1327407
19545,1994-1995,1994-12-01,1995-02-28,90,0,0,5,5,0,0,0,5,0,0,Texas,San Antonio,1327407
19546,2000-2001,2000-12-01,2001-02-28,90,0,0,19,19,0,0,0,19,0,0,Texas,San Antonio,1327407
19547,2001-2002,2001-12-01,2002-02-28,90,0,0,20,20,0,0,0,20,0,0,Texas,San Antonio,1327407
19548,2002-2003,2002-12-01,2003-02-28,90,0,0,10,10,2,0,2,12,2,3,Texas,San Antonio,1327407
19549,2003-2004,2003-12-01,2004-02-29,91,0,0,20,20,2,0,2,22,2,4,Texas,San Antonio,1327407
19550,2004-2005,2004-12-01,2005-02-28,90,0,0,11,11,0,0,0,11,0,0,Texas,San Antonio,1327407
19551,2005-2006,2005-12-01,2006-02-28,90,0,0,12,12,0,0,0,12,0,0,Texas,San Antonio,1327407
19552,2006-2007,2006-12-01,2007-02-28,90,0,1,13,14,0,0,0,14,0,0,Texas,San Antonio,1327407
19553,2007-2008,2007-12-01,2008-02-29,91,0,0,12,12,0,0,0,12,0,0,Texas,San Antonio,1327407
19554,2008-2009,2008-12-01,2009-02-28,90,2,0,12,12,0,0,0,12,0,0,Texas,San Antonio,1327407
19555,2009-2010,2009-12-01,2010-02-28,90,0,0,24,24,1,0,1,25,1,1,Texas,San Antonio,1327407
19556,2010-2011,2010-12-01,2011-02-28,90,0,2,30,32,1,0,1,33,1,3,Texas,San Antonio,1327407
19557,2011-2012,2011-12-01,2012-02-29,91,0,0,7,7,0,0,0,7,0,0,Texas,San Antonio,1327407
19558,2012-2013,2012-12-01,2013-02-28,90,0,0,13,13,0,0,0,13,0,0,Texas,San Antonio,1327407
19559,2013-2014,2013-12-01,2014-02-28,90,0,0,21,21,2,0,2,23,2,4,Texas,San Antonio,1327407
19560,2014-2015,2014-12-01,2015-02-28,90,0,0,7,7,0,0,0,7,0,0,Texas,San Antonio,1327407
19561,2015-2016,2015-12-01,2016-02-29,91,0,0,4,4,0,0,0,4,0,0,Texas,San Antonio,1327407
19562,2016-2017,2016-12-01,2017-02-28,90,0,0,8,8,0,0,0,8,0,0,Texas,San Antonio,1327407
19563,2017-2018,2017-12-01,2018-02-28,90,0,1,14,15,2,2,4,19,1,3,Texas,San Antonio,1327407
19564,2018-2019,2018-12-01,2019-02-28,90,0,0,4,4,0,0,0,4,0,0,Texas,San Antonio,1327407
19565,2019-2020,2019-12-01,2020-02-29,91,0,0,4,4,0,0,0,4,0,0,Texas,San Antonio,1327407
19566,1950-1951,1950-12-01,1951-02-28,90,0,17,120,137,7,8,15,152,3,23,Texas,Wichita Falls,104553
19567,1951-1952,1951-11-01,1952-02-29,121,0,3,74,77,3,0,3,80,1,4,Texas,Wichita Falls,104553
19568,1952-1953,1952-12-01,1953-02-28,90,0,2,49,51,6,2,8,59,4,14,Texas,Wichita Falls,104553
19569,1953-1954,1953-12-01,1954-02-28,90,0,6,61,67,4,2,6,73,2,13,Texas,Wichita Falls,104553
19570,1954-1955,1954-12-01,1955-02-28,90,0,1,60,61,11,16,27,88,3,14,Texas,Wichita Falls,104553
19571,1955-1956,1955-12-01,1956-02-29,91,0,5,86,91,10,7,17,108,5,25,Texas,Wichita Falls,104553
19572,1956-1957,1956-12-01,1957-02-28,90,0,7,52,59,3,1,4,63,2,10,Texas,Wichita Falls,104553
19573,1957-1958,1957-11-22,1958-03-13,112,0,4,79,83,19,10,29,112,6,32,Texas,Wichita Falls,104553
19574,1958-1959,1958-12-01,1959-02-28,90,0,11,107,118,12,9,21,139,7,36,Texas,Wichita Falls,104553
19575,1959-1960,1959-12-01,1960-03-05,96,0,10,91,101,10,4,14,115,5,22,Texas,Wichita Falls,104553
19576,1960-1961,1960-12-01,1961-02-28,90,0,6,76,82,17,7,24,106,9,32,Texas,Wichita Falls,104553
19577,1961-1962,1961-12-01,1962-02-28,90,0,13,107,120,4,4,8,128,3,20,Texas,Wichita Falls,104553
19578,1962-1963,1962-12-01,1963-02-28,90,1,7,114,121,9,3,12,133,4,15,Texas,Wichita Falls,104553
19579,1963-1964,1963-12-01,1964-03-09,100,0,5,99,104,11,2,13,117,8,29,Texas,Wichita Falls,104553
19580,1964-1965,1964-12-01,1965-03-20,110,0,3,107,110,2,1,3,113,1,7,Texas,Wichita Falls,104553
19581,1965-1966,1965-12-01,1966-02-28,90,0,14,103,117,17,24,41,158,5,37,Texas,Wichita Falls,104553
19582,1966-1967,1966-12-01,1967-03-06,96,0,0,101,101,1,0,1,102,1,1,Texas,Wichita Falls,104553
19583,1967-1968,1967-12-01,1968-03-12,103,1,8,92,100,16,14,30,130,6,31,Texas,Wichita Falls,104553
19584,1968-1969,1968-12-01,1969-03-15,105,0,2,91,93,6,1,7,100,2,8,Texas,Wichita Falls,104553
19585,1969-1970,1969-12-01,1970-03-17,107,0,10,108,118,13,12,25,143,5,24,Texas,Wichita Falls,104553
19586,1970-1971,1970-12-01,1971-03-03,93,0,4,102,106,4,3,7,113,1,5,Texas,Wichita Falls,104553
19587,1971-1972,1971-12-01,1972-02-29,91,1,6,88,94,9,1,10,104,3,17,Texas,Wichita Falls,104553
19588,1972-1973,1972-11-21,1973-04-08,139,0,19,105,124,14,8,22,146,8,26,Texas,Wichita Falls,104553
19589,1973-1974,1973-12-01,1974-02-28,90,0,5,82,87,1,1,2,89,1,5,Texas,Wichita Falls,104553
19590,1974-1975,1974-11-29,1975-03-29,121,0,3,78,81,5,2,7,88,4,10,Texas,Wichita Falls,104553
19591,1975-1976,1975-11-26,1976-02-29,96,0,3,79,82,5,3,8,90,3,8,Texas,Wichita Falls,104553
19592,1976-1977,1976-11-13,1977-02-28,108,0,11,137,148,13,22,35,183,5,34,Texas,Wichita Falls,104553
19593,1977-1978,1977-12-01,1978-03-03,93,0,23,171,194,21,30,51,245,9,48,Texas,Wichita Falls,104553
19594,1978-1979,1978-12-01,1979-02-28,90,0,25,157,182,16,25,41,223,6,34,Texas,Wichita Falls,104553
19595,1979-1980,1979-12-01,1980-03-01,92,0,7,77,84,5,4,9,93,2,14,Texas,Wichita Falls,104553
19596,1980-1981,1980-11-16,1981-02-28,105,0,3,63,66,4,3,7,73,2,6,Texas,Wichita Falls,104553
19597,1981-1982,1981-12-01,1982-02-28,90,0,10,119,129,7,2,9,138,4,14,Texas,Wichita Falls,104553
19598,1982-1983,1982-12-01,1983-02-28,90,0,1,53,54,12,5,17,71,4,17,Texas,Wichita Falls,104553
19599,1983-1984,1983-12-01,1984-02-29,91,0,30,150,180,11,7,18,198,4,32,Texas,Wichita Falls,104553
19600,1984-1985,1984-12-01,1985-02-28,90,0,18,112,130,15,31,46,176,4,35,Texas,Wichita Falls,104553
19601,1985-1986,1985-12-01,1986-02-28,90,0,11,99,110,5,2,7,117,3,14,Texas,Wichita Falls,104553
19602,1986-1987,1986-11-13,1987-02-28,108,0,4,60,64,3,5,8,72,2,8,Texas,Wichita Falls,104553
19603,1987-1988,1987-12-01,1988-02-29,91,0,12,103,115,17,25,42,157,5,31,Texas,Wichita Falls,104553
19604,1988-1989,1988-12-01,1989-03-21,111,0,11,92,103,20,14,34,137,5,30,Texas,Wichita Falls,104553
19605,1989-1990,1989-12-01,1990-02-28,90,0,11,101,112,0,0,0,112,0,0,Texas,Wichita Falls,104553
19606,1990-1991,1990-12-01,1991-02-28,90,0,13,82,95,3,1,4,99,3,19,Texas,Wichita Falls,104553
19607,1991-1992,1991-12-01,1992-02-29,91,0,0,35,35,12,11,23,58,2,15,Texas,Wichita Falls,104553
19608,1992-1993,1992-12-01,1993-02-28,90,0,4,58,62,0,0,0,62,0,0,Texas,Wichita Falls,104553
19609,1993-1994,1993-10-30,1994-02-28,122,0,5,114,119,2,1,3,122,1,4,Texas,Wichita Falls,104553
19610,1994-1995,1994-12-01,1995-03-02,92,2,1,54,55,0,0,0,55,0,0,Texas,Wichita Falls,104553
19611,1995-1996,1995-12-01,1996-02-29,91,0,10,110,120,0,0,0,120,0,0,Texas,Wichita Falls,104553
19612,1996-1997,1996-12-01,1997-02-28,90,0,11,78,89,9,11,20,109,3,22,Texas,Wichita Falls,104553
19613,1997-1998,1997-12-01,1998-03-08,98,1,0,43,43,7,3,10,53,3,10,Texas,Wichita Falls,104553
19614,1998-1999,1998-12-01,1999-02-28,90,1,6,59,65,0,0,0,65,0,0,Texas,Wichita Falls,104553
19615,1999-2000,1999-12-01,2000-02-29,91,0,2,50,52,0,0,0,52,0,0,Texas,Wichita Falls,104553
19616,2000-2001,2000-12-01,2001-02-28,90,0,8,74,82,3,2,5,87,3,13,Texas,Wichita Falls,104553
19617,2001-2002,2001-11-27,2002-03-02,96,0,2,66,68,15,11,26,94,6,26,Texas,Wichita Falls,104553
19618,2002-2003,2002-12-01,2003-02-28,90,0,4,78,82,1,0,1,83,1,6,Texas,Wichita Falls,104553
19619,2003-2004,2003-12-01,2004-02-29,91,0,1,77,78,7,4,11,89,1,8,Texas,Wichita Falls,104553
19620,2004-2005,2004-12-01,2005-02-28,90,0,2,58,60,2,1,3,63,1,5,Texas,Wichita Falls,104553
19621,2005-2006,2005-12-01,2006-02-28,90,0,4,59,63,0,0,0,63,0,0,Texas,Wichita Falls,104553
19622,2006-2007,2006-11-30,2007-02-28,91,0,7,66,73,3,1,4,77,2,8,Texas,Wichita Falls,104553
19623,2007-2008,2007-12-01,2008-02-29,91,0,0,77,77,0,0,0,77,0,0,Texas,Wichita Falls,104553
19624,2008-2009,2008-12-01,2009-02-28,90,0,5,90,95,0,0,0,95,0,0,Texas,Wichita Falls,104553
19625,2009-2010,2009-12-01,2010-03-20,110,0,5,113,118,22,22,44,162,5,31,Texas,Wichita Falls,104553
19626,2010-2011,2010-12-01,2011-02-28,90,0,11,123,134,7,8,15,149,2,20,Texas,Wichita Falls,104553
19627,2011-2012,2011-12-01,2012-02-29,91,0,1,45,46,3,1,4,50,2,5,Texas,Wichita Falls,104553
19628,2012-2013,2012-12-01,2013-02-28,90,0,1,78,79,5,4,9,88,2,10,Texas,Wichita Falls,104553
19629,2013-2014,2013-11-24,2014-03-03,100,0,15,147,162,9,8,17,179,4,19,Texas,Wichita Falls,104553
19630,2014-2015,2014-11-16,2015-03-05,110,0,6,81,87,9,6,15,102,5,21,Texas,Wichita Falls,104553
19631,2015-2016,2015-12-01,2016-02-29,91,0,0,56,56,3,1,4,60,2,5,Texas,Wichita Falls,104553
19632,2016-2017,2016-12-01,2017-02-28,90,0,4,63,67,0,0,0,67,0,0,Texas,Wichita Falls,104553
19633,2017-2018,2017-12-01,2018-02-28,90,0,7,104,111,2,0,2,113,1,5,Texas,Wichita Falls,104553
19634,2018-2019,2018-12-01,2019-03-04,94,0,2,70,72,5,3,8,80,2,7,Texas,Wichita Falls,104553
19635,2019-2020,2019-12-01,2020-02-29,91,0,1,47,48,4,7,11,59,1,6,Texas,Wichita Falls,104553
19636,1957-1958,1957-11-02,1958-04-07,157,4,19,527,546,105,302,407,953,36,192,Utah,Echo Dam,0
19637,1959-1960,1959-12-01,1960-04-24,146,9,41,489,530,35,131,166,696,21,117,Utah,Echo Dam,0
19638,1960-1961,1960-11-04,1961-04-13,161,3,6,475,481,64,60,124,605,26,115,Utah,Echo Dam,0
19639,1961-1962,1961-10-28,1962-03-23,147,4,58,525,583,98,224,322,905,32,213,Utah,Echo Dam,0
19640,1962-1963,1962-11-16,1963-04-21,157,4,33,515,548,46,70,116,664,20,94,Utah,Echo Dam,0
19641,1963-1964,1963-11-07,1964-05-03,179,0,39,721,760,92,456,548,1308,45,266,Utah,Echo Dam,0
19642,1964-1965,1964-11-11,1965-05-05,176,0,36,532,568,93,233,326,894,36,198,Utah,Echo Dam,0
19643,1965-1966,1965-09-17,1966-04-19,215,0,36,726,762,62,351,413,1175,28,169,Utah,Echo Dam,0
19644,1966-1967,1966-10-13,1967-05-11,211,0,38,460,498,80,276,356,854,27,136,Utah,Echo Dam,0
19645,1967-1968,1967-11-28,1968-04-21,146,0,45,482,527,73,344,417,944,26,160,Utah,Echo Dam,0
19646,1968-1969,1968-11-16,1969-04-07,143,13,37,487,524,79,474,553,1077,27,157,Utah,Echo Dam,0
19647,1970-1971,1970-10-25,1971-04-27,185,0,56,539,595,78,284,362,957,24,151,Utah,Echo Dam,0
19648,1971-1972,1971-10-27,1972-04-14,171,1,74,508,582,75,422,497,1079,29,174,Utah,Echo Dam,0
19649,1972-1973,1972-10-24,1973-04-14,173,0,110,643,753,116,637,753,1506,36,230,Utah,Echo Dam,0
19650,1973-1974,1973-11-01,1974-04-27,178,0,61,559,620,160,661,821,1441,41,277,Utah,Echo Dam,0
19651,1974-1975,1974-12-01,1975-05-21,172,0,59,460,519,108,385,493,1012,29,181,Utah,Echo Dam,0
19652,1975-1976,1975-10-08,1976-03-25,170,0,33,531,564,74,232,306,870,32,171,Utah,Echo Dam,0
19653,1976-1977,1976-11-26,1977-05-18,174,3,18,573,591,73,121,194,785,25,138,Utah,Echo Dam,0
19654,1977-1978,1977-11-19,1978-05-08,171,2,23,332,355,120,405,525,880,39,196,Utah,Echo Dam,0
19655,1978-1979,1978-09-18,1979-04-19,214,3,104,626,730,133,339,472,1202,43,267,Utah,Echo Dam,0
19656,1979-1980,1979-11-11,1980-04-07,149,2,42,487,529,135,305,440,969,36,241,Utah,Echo Dam,0
19657,1980-1981,1980-10-15,1981-05-08,206,3,9,388,397,88,83,171,568,25,122,Utah,Echo Dam,0
19658,1981-1982,1981-11-25,1982-04-08,135,2,59,432,491,157,377,534,1025,45,304,Utah,Echo Dam,0
19659,1982-1983,1982-11-10,1983-05-11,183,7,33,397,430,126,130,256,686,39,191,Utah,Echo Dam,0
19660,1983-1984,1983-11-08,1984-04-30,175,8,103,542,645,134,619,753,1398,45,264,Utah,Echo Dam,0
19661,1984-1985,1984-09-24,1985-04-26,215,11,72,674,746,158,658,816,1562,52,293,Utah,Echo Dam,0
19662,1986-1987,1986-09-25,1987-04-19,207,8,38,495,533,98,193,291,824,27,159,Utah,Echo Dam,0
19663,1987-1988,1987-11-17,1988-05-02,168,1,66,512,578,73,291,364,942,31,159,Utah,Echo Dam,0
19664,1988-1989,1988-11-11,1989-04-27,168,2,134,586,720,153,635,788,1508,34,274,Utah,Echo Dam,0
19665,1989-1990,1989-10-28,1990-06-01,217,0,26,463,489,93,132,225,714,27,184,Utah,Echo Dam,0
19666,1990-1991,1990-11-01,1991-05-23,204,8,94,602,696,114,371,485,1181,34,209,Utah,Echo Dam,0
19667,1991-1992,1991-10-29,1992-03-18,142,1,31,426,457,49,178,227,684,22,96,Utah,Echo Dam,0
19668,1992-1993,1992-11-02,1993-04-18,168,16,101,594,695,142,670,812,1507,41,281,Utah,Echo Dam,0
19669,1993-1994,1993-11-18,1994-04-29,163,3,42,469,511,75,160,235,746,24,161,Utah,Echo Dam,0
19670,1994-1995,1994-11-02,1995-04-17,167,6,57,446,503,119,241,360,863,29,207,Utah,Echo Dam,0
19671,1995-1996,1995-11-10,1996-04-18,161,6,35,378,413,135,299,434,847,31,224,Utah,Echo Dam,0
19672,1996-1997,1996-09-17,1997-05-01,227,15,41,525,566,161,364,525,1091,40,289,Utah,Echo Dam,0
19673,1997-1998,1997-10-24,1998-03-30,158,5,31,433,464,101,138,239,703,33,171,Utah,Echo Dam,0
19674,1999-2000,1999-11-18,2000-05-11,176,5,25,372,397,114,223,337,734,29,181,Utah,Echo Dam,0
19675,2000-2001,2000-09-23,2001-04-22,212,10,92,574,666,122,485,607,1273,35,231,Utah,Echo Dam,0
19676,2001-2002,2001-11-22,2002-04-17,147,6,75,520,595,89,179,268,863,29,182,Utah,Echo Dam,0
19677,2002-2003,2002-10-30,2003-05-10,193,3,30,431,461,95,260,355,816,31,176,Utah,Echo Dam,0
19678,2003-2004,2003-10-30,2004-05-13,197,9,77,502,579,146,450,596,1175,45,277,Utah,Echo Dam,0
19679,2004-2005,2004-10-25,2005-03-21,148,5,16,358,374,57,99,156,530,19,98,Utah,Echo Dam,0
19680,2005-2006,2005-11-05,2006-04-18,165,5,52,499,551,136,202,338,889,40,259,Utah,Echo Dam,0
19681,2006-2007,2006-09-16,2007-04-19,216,6,61,591,652,102,317,419,1071,32,217,Utah,Echo Dam,0
19682,2007-2008,2007-10-17,2008-04-24,191,6,87,664,751,201,708,909,1660,54,401,Utah,Echo Dam,0
19683,2008-2009,2008-10-11,2009-04-16,188,2,30,489,519,138,335,473,992,44,269,Utah,Echo Dam,0
19684,2009-2010,2009-10-05,2010-05-02,210,6,56,590,646,135,505,640,1286,41,248,Utah,Echo Dam,0
19685,2012-2013,2012-10-25,2013-04-09,167,4,64,489,553,75,247,322,875,25,167,Utah,Echo Dam,0
19686,2013-2014,2013-11-16,2014-04-26,162,2,64,456,520,78,336,414,934,22,165,Utah,Echo Dam,0
19687,2014-2015,2014-11-13,2015-03-03,111,4,26,260,286,45,73,118,404,13,79,Utah,Echo Dam,0
19688,2015-2016,2015-11-10,2016-04-15,158,4,84,481,565,104,493,597,1162,28,201,Utah,Echo Dam,0
19689,2016-2017,2016-11-17,2017-05-17,182,3,68,428,496,143,344,487,983,34,242,Utah,Echo Dam,0
19690,2017-2018,2017-11-17,2018-03-05,109,1,30,308,338,77,250,327,665,14,118,Utah,Echo Dam,0
19691,2018-2019,2018-10-10,2019-04-12,185,2,63,523,586,146,575,721,1307,34,248,Utah,Echo Dam,0
19692,2019-2020,2019-10-27,2020-03-30,156,3,37,447,484,125,466,591,1075,35,214,Utah,Echo Dam,0
19693,1959-1960,1959-12-01,1960-03-04,95,0,23,328,351,67,460,527,878,12,90,Utah,Escalante,797
19694,1962-1963,1962-12-01,1963-03-20,110,0,27,343,370,21,52,73,443,6,30,Utah,Escalante,797
19695,1963-1964,1963-12-01,1964-04-03,125,0,7,415,422,30,19,49,471,7,44,Utah,Escalante,797
19696,1966-1967,1966-12-01,1967-04-12,133,5,9,304,313,33,54,87,400,7,46,Utah,Escalante,797
19697,1967-1968,1967-11-29,1968-04-18,142,0,15,392,407,69,456,525,932,13,102,Utah,Escalante,797
19698,1968-1969,1968-12-01,1969-03-13,103,0,9,298,307,73,150,223,530,15,109,Utah,Escalante,797
19699,1969-1970,1969-12-01,1970-03-10,100,0,3,233,236,15,0,15,251,6,23,Utah,Escalante,797
19700,1970-1971,1970-12-01,1971-03-01,91,0,24,267,291,25,55,80,371,7,47,Utah,Escalante,797
19701,1971-1972,1971-10-29,1972-02-29,124,0,10,328,338,25,43,68,406,7,40,Utah,Escalante,797
19702,1972-1973,1972-11-12,1973-03-22,131,0,28,418,446,84,153,237,683,19,125,Utah,Escalante,797
19703,1973-1974,1973-11-22,1974-02-28,99,0,18,355,373,37,212,249,622,8,66,Utah,Escalante,797
19704,1974-1975,1974-11-03,1975-04-11,160,0,13,380,393,47,18,65,458,16,75,Utah,Escalante,797
19705,1975-1976,1975-10-23,1976-04-16,177,0,7,386,393,34,41,75,468,8,45,Utah,Escalante,797
19706,1976-1977,1976-11-27,1977-02-28,94,0,8,313,321,11,47,58,379,3,17,Utah,Escalante,797
19707,1978-1979,1978-11-14,1979-03-21,128,2,43,459,502,105,560,665,1167,22,156,Utah,Escalante,797
19708,1979-1980,1979-12-01,1980-03-23,114,1,8,243,251,81,138,219,470,13,96,Utah,Escalante,797
19709,1980-1981,1980-12-01,1981-03-30,120,0,0,221,221,16,0,16,237,7,23,Utah,Escalante,797
19710,1981-1982,1981-11-26,1982-02-28,95,3,9,264,273,45,54,99,372,10,72,Utah,Escalante,797
19711,1982-1983,1982-12-01,1983-03-24,114,13,3,243,246,39,27,66,312,10,57,Utah,Escalante,797
19712,1988-1989,1988-12-01,1989-02-28,90,1,27,340,367,53,327,380,747,12,92,Utah,Escalante,797
19713,1989-1990,1989-12-01,1990-02-28,90,1,0,249,249,23,16,39,288,4,27,Utah,Escalante,797
19714,1990-1991,1990-11-26,1991-03-26,121,1,26,348,374,23,66,89,463,7,36,Utah,Escalante,797
19715,1991-1992,1991-11-30,1992-03-08,100,0,22,301,323,49,224,273,596,11,75,Utah,Escalante,797
19716,1992-1993,1992-12-01,1993-03-05,95,1,8,274,282,99,443,542,824,20,128,Utah,Escalante,797
19717,1993-1994,1993-11-11,1994-02-28,110,1,2,306,308,17,6,23,331,7,29,Utah,Escalante,797
19718,1994-1995,1994-11-18,1995-03-25,128,1,0,227,227,54,84,138,365,11,66,Utah,Escalante,797
19719,1995-1996,1995-12-01,1996-02-29,91,0,2,203,205,6,2,8,213,3,11,Utah,Escalante,797
19720,1996-1997,1996-10-28,1997-04-12,167,11,2,279,281,75,118,193,474,15,97,Utah,Escalante,797
19721,1997-1998,1997-12-01,1998-04-02,123,7,1,241,242,28,22,50,292,8,39,Utah,Escalante,797
19722,1998-1999,1998-10-16,1999-04-23,190,16,3,263,266,34,4,38,304,5,38,Utah,Escalante,797
19723,1999-2000,1999-12-01,2000-03-09,100,0,1,186,187,18,2,20,207,6,25,Utah,Escalante,797
19724,2000-2001,2000-12-01,2001-02-28,90,6,1,228,229,44,185,229,458,10,64,Utah,Escalante,797
19725,2001-2002,2001-11-25,2002-02-28,96,7,2,286,288,8,1,9,297,5,21,Utah,Escalante,797
19726,2003-2004,2003-12-01,2004-02-29,91,14,4,241,245,16,7,23,268,6,24,Utah,Escalante,797
19727,2004-2005,2004-11-21,2005-03-03,103,12,2,179,181,47,61,108,289,14,63,Utah,Escalante,797
19728,2005-2006,2005-12-01,2006-03-22,112,3,2,265,267,22,25,47,314,6,38,Utah,Escalante,797
19729,2006-2007,2006-11-29,2007-02-28,92,2,5,245,250,12,6,18,268,7,25,Utah,Escalante,797
19730,2007-2008,2007-12-01,2008-03-17,108,4,5,282,287,40,102,142,429,12,62,Utah,Escalante,797
19731,2008-2009,2008-12-01,2009-04-16,137,0,6,276,282,51,164,215,497,14,92,Utah,Escalante,797
19732,2009-2010,2009-11-29,2010-03-14,106,0,4,330,334,105,523,628,962,22,140,Utah,Escalante,797
19733,2010-2011,2010-11-24,2011-03-26,123,0,11,269,280,32,44,76,356,10,45,Utah,Escalante,797
19734,2011-2012,2011-11-07,2012-03-18,133,0,1,275,276,39,116,155,431,10,54,Utah,Escalante,797
19735,2012-2013,2012-12-01,2013-03-09,99,0,9,274,283,18,66,84,367,9,35,Utah,Escalante,797
19736,2013-2014,2013-11-22,2014-02-28,99,0,7,227,234,40,134,174,408,7,58,Utah,Escalante,797
19737,2014-2015,2014-12-01,2015-03-07,97,0,3,167,170,52,76,128,298,9,68,Utah,Escalante,797
19738,2015-2016,2015-12-01,2016-04-28,150,0,3,280,283,45,139,184,467,11,63,Utah,Escalante,797
19739,2016-2017,2016-11-27,2017-04-01,126,0,2,201,203,29,71,100,303,9,44,Utah,Escalante,797
19740,2017-2018,2017-12-01,2018-02-28,90,0,0,188,188,5,0,5,193,3,10,Utah,Escalante,797
19741,2018-2019,2018-12-01,2019-02-28,90,0,8,231,239,55,103,158,397,14,88,Utah,Escalante,797
19742,2019-2020,2019-11-29,2020-03-19,112,0,5,229,234,30,124,154,388,9,46,Utah,Escalante,797
19743,1950-1951,1950-11-14,1951-05-02,170,0,21,320,341,41,43,84,425,16,84,Utah,Manti,3276
19744,1951-1952,1951-11-12,1952-04-15,156,0,69,506,575,158,930,1088,1663,46,266,Utah,Manti,3276
19745,1952-1953,1952-11-15,1953-05-09,176,1,29,382,411,87,269,356,767,23,134,Utah,Manti,3276
19746,1953-1954,1953-11-18,1954-05-01,165,0,31,371,402,77,132,209,611,19,114,Utah,Manti,3276
19747,1954-1955,1954-10-24,1955-04-26,185,13,52,465,517,84,327,411,928,28,183,Utah,Manti,3276
19748,1955-1956,1955-11-14,1956-04-18,157,1,30,348,378,80,95,175,553,23,139,Utah,Manti,3276
19749,1956-1957,1956-10-24,1957-04-22,181,0,28,407,435,82,133,215,650,24,145,Utah,Manti,3276
19750,1957-1958,1957-11-03,1958-04-23,172,0,9,362,371,71,39,110,481,28,123,Utah,Manti,3276
19751,1958-1959,1958-11-15,1959-04-18,155,3,16,339,355,54,137,191,546,11,80,Utah,Manti,3276
19752,1959-1960,1959-12-01,1960-03-16,107,0,31,362,393,77,400,477,870,25,148,Utah,Manti,3276
19753,1960-1961,1960-10-10,1961-05-13,216,1,5,412,417,95,87,182,599,24,131,Utah,Manti,3276
19754,1961-1962,1961-10-28,1962-03-24,148,0,43,474,517,121,467,588,1105,26,187,Utah,Manti,3276
19755,1963-1964,1963-12-01,1964-05-07,159,1,46,526,572,105,363,468,1040,36,222,Utah,Manti,3276
19756,1964-1965,1964-11-11,1965-05-08,179,1,20,391,411,95,298,393,804,28,158,Utah,Manti,3276
19757,1966-1967,1966-10-13,1967-05-01,201,1,26,411,437,73,312,385,822,24,136,Utah,Manti,3276
19758,1967-1968,1967-11-28,1968-05-06,161,0,28,394,422,86,436,522,944,27,154,Utah,Manti,3276
19759,1968-1969,1968-11-14,1969-04-16,154,0,18,383,401,89,142,231,632,36,180,Utah,Manti,3276
19760,1969-1970,1969-10-10,1970-04-28,201,6,17,390,407,87,39,126,533,38,149,Utah,Manti,3276
19761,1970-1971,1970-10-07,1971-04-19,195,1,37,401,438,56,146,202,640,24,122,Utah,Manti,3276
19762,1971-1972,1971-10-01,1972-04-19,202,1,43,420,463,87,167,254,717,25,162,Utah,Manti,3276
19763,1972-1973,1972-10-24,1973-04-18,177,0,68,500,568,120,572,692,1260,37,229,Utah,Manti,3276
19764,1973-1974,1973-10-09,1974-05-20,224,1,44,455,499,123,509,632,1131,36,216,Utah,Manti,3276
19765,1974-1975,1974-10-29,1975-05-20,204,1,48,516,564,93,292,385,949,43,223,Utah,Manti,3276
19766,1975-1976,1975-11-10,1976-04-17,160,0,28,423,451,79,237,316,767,30,167,Utah,Manti,3276
19767,1976-1977,1976-11-27,1977-04-15,140,3,23,428,451,37,76,113,564,15,71,Utah,Manti,3276
19768,1977-1978,1977-11-19,1978-05-06,169,2,11,268,279,102,246,348,627,36,165,Utah,Manti,3276
19769,1978-1979,1978-09-18,1979-05-08,233,3,61,467,528,130,277,407,935,46,266,Utah,Manti,3276
19770,1979-1980,1979-10-20,1980-04-11,175,0,14,389,403,93,161,254,657,33,151,Utah,Manti,3276
19771,1980-1981,1980-10-15,1981-04-03,171,0,4,303,307,45,24,69,376,21,76,Utah,Manti,3276
19772,1981-1982,1981-10-14,1982-05-10,209,1,34,415,449,107,278,385,834,38,199,Utah,Manti,3276
19773,1982-1983,1982-09-29,1983-05-16,230,0,22,405,427,115,341,456,883,44,184,Utah,Manti,3276
19774,1983-1984,1983-11-18,1984-04-26,161,1,40,425,465,121,336,457,922,38,211,Utah,Manti,3276
19775,1984-1985,1984-10-15,1985-04-26,194,2,39,450,489,114,303,417,906,35,180,Utah,Manti,3276
19776,1985-1986,1985-10-09,1986-04-17,191,2,18,333,351,76,148,224,575,24,124,Utah,Manti,3276
19777,1986-1987,1986-11-08,1987-04-19,163,1,22,340,362,53,81,134,496,18,100,Utah,Manti,3276
19778,1987-1988,1987-11-25,1988-05-01,159,1,60,415,475,111,425,536,1011,28,201,Utah,Manti,3276
19779,1988-1989,1988-11-14,1989-04-26,164,5,75,435,510,113,408,521,1031,37,237,Utah,Manti,3276
19780,1989-1990,1989-10-26,1990-06-01,219,7,22,357,379,100,128,228,607,29,180,Utah,Manti,3276
19781,1990-1991,1990-11-02,1991-05-04,184,4,58,442,500,88,358,446,946,33,183,Utah,Manti,3276
19782,1991-1992,1991-10-27,1992-03-18,144,8,21,315,336,62,130,192,528,29,118,Utah,Manti,3276
19783,1992-1993,1992-11-05,1993-04-02,149,2,57,394,451,140,584,724,1175,39,246,Utah,Manti,3276
19784,1993-1994,1993-11-13,1994-03-23,131,5,28,328,356,55,170,225,581,27,127,Utah,Manti,3276
19785,1994-1995,1994-10-15,1995-04-20,188,9,27,318,345,125,112,237,582,36,194,Utah,Manti,3276
19786,1995-1996,1995-11-10,1996-04-18,161,8,12,259,271,43,25,68,339,21,89,Utah,Manti,3276
19787,1996-1997,1996-10-20,1997-05-01,194,7,34,382,416,98,190,288,704,30,172,Utah,Manti,3276
19788,1997-1998,1997-11-27,1998-04-18,143,3,23,281,304,94,102,196,500,35,161,Utah,Manti,3276
19789,1998-1999,1998-11-06,1999-05-03,179,6,25,316,341,85,111,196,537,27,134,Utah,Manti,3276
19790,1999-2000,1999-11-21,2000-03-30,131,16,11,222,233,54,33,87,320,23,95,Utah,Manti,3276
19791,2000-2001,2000-10-12,2001-05-03,204,16,21,364,385,89,90,179,564,32,140,Utah,Manti,3276
19792,2001-2002,2001-11-23,2002-04-20,149,7,72,468,540,82,319,401,941,30,177,Utah,Manti,3276
19793,2002-2003,2002-10-03,2003-04-30,210,4,25,413,438,68,154,222,660,25,134,Utah,Manti,3276
19794,2003-2004,2003-10-31,2004-05-12,195,15,57,446,503,78,220,298,801,27,157,Utah,Manti,3276
19795,2004-2005,2004-10-31,2005-03-23,144,8,22,285,307,40,57,97,404,16,84,Utah,Manti,3276
19796,2007-2008,2007-10-20,2008-04-30,194,16,74,527,601,119,423,542,1143,45,295,Utah,Manti,3276
19797,2008-2009,2008-10-11,2009-04-26,198,8,25,378,403,105,200,305,708,44,213,Utah,Manti,3276
19798,2009-2010,2009-10-27,2010-05-24,210,0,45,434,479,159,436,595,1074,48,266,Utah,Manti,3276
19799,2013-2014,2013-11-04,2014-05-12,190,2,43,339,382,72,171,243,625,19,125,Utah,Manti,3276
19800,2014-2015,2014-11-15,2015-04-16,153,0,20,219,239,46,50,96,335,16,84,Utah,Manti,3276
19801,2015-2016,2015-11-04,2016-03-29,147,0,47,348,395,104,290,394,789,34,195,Utah,Manti,3276
19802,2016-2017,2016-11-17,2017-04-09,144,1,53,294,347,94,180,274,621,27,175,Utah,Manti,3276
19803,2017-2018,2017-11-17,2018-04-17,152,0,10,262,272,68,36,104,376,20,109,Utah,Manti,3276
19804,2018-2019,2018-11-11,2019-04-11,152,0,43,331,374,80,106,186,560,34,169,Utah,Manti,3276
19805,2019-2020,2019-10-29,2020-06-08,224,1,18,306,324,72,151,223,547,31,131,Utah,Manti,3276
19806,1958-1959,1958-11-11,1959-04-18,159,7,19,269,288,65,128,193,481,33,134,Utah,Richmond,204214
19807,1961-1962,1961-10-22,1962-03-14,144,6,72,393,465,82,255,337,802,31,171,Utah,Richmond,204214
19808,1962-1963,1962-12-01,1963-04-21,142,2,36,347,383,59,70,129,512,19,101,Utah,Richmond,204214
19809,1963-1964,1963-11-06,1964-05-02,179,4,107,554,661,130,686,816,1477,43,251,Utah,Richmond,204214
19810,1964-1965,1964-11-11,1965-04-13,154,14,37,352,389,83,200,283,672,27,158,Utah,Richmond,204214
19811,1966-1967,1966-10-13,1967-05-01,201,2,54,339,393,161,316,477,870,38,276,Utah,Richmond,204214
19812,1968-1969,1968-11-26,1969-04-07,133,1,48,386,434,94,557,651,1085,25,170,Utah,Richmond,204214
19813,1969-1970,1969-12-01,1970-04-28,149,0,30,296,326,58,99,157,483,17,89,Utah,Richmond,204214
19814,1970-1971,1970-10-06,1971-04-26,203,10,57,411,468,98,326,424,892,26,160,Utah,Richmond,204214
19815,1971-1972,1971-10-01,1972-04-17,200,0,62,450,512,93,295,388,900,24,168,Utah,Richmond,204214
19816,1973-1974,1973-11-22,1974-04-14,144,18,58,409,467,98,507,605,1072,24,198,Utah,Richmond,204214
19817,1974-1975,1974-10-21,1975-05-20,212,5,73,473,546,103,338,441,987,31,195,Utah,Richmond,204214
19818,1975-1976,1975-10-22,1976-04-26,188,0,67,518,585,153,581,734,1319,36,253,Utah,Richmond,204214
19819,1976-1977,1976-11-27,1977-04-14,139,0,50,439,489,79,215,294,783,23,127,Utah,Richmond,204214
19820,1977-1978,1977-11-19,1978-04-21,154,4,17,195,212,65,63,128,340,17,97,Utah,Richmond,204214
19821,1978-1979,1978-09-18,1979-05-29,254,3,132,550,682,143,635,778,1460,34,265,Utah,Richmond,204214
19822,1979-1980,1979-11-23,1980-04-01,131,1,46,307,353,101,181,282,635,23,171,Utah,Richmond,204214
19823,1980-1981,1980-10-15,1981-03-28,165,1,61,345,406,69,214,283,689,15,97,Utah,Richmond,204214
19824,1981-1982,1981-10-30,1982-05-28,211,6,83,406,489,144,389,533,1022,37,252,Utah,Richmond,204214
19825,1982-1983,1982-11-19,1983-05-12,175,7,42,285,327,108,185,293,620,30,145,Utah,Richmond,204214
19826,1983-1984,1983-11-07,1984-04-29,175,5,124,517,641,208,1094,1302,1943,55,378,Utah,Richmond,204214
19827,1984-1985,1984-10-17,1985-04-22,188,4,128,636,764,132,862,994,1758,33,252,Utah,Richmond,204214
19828,1985-1986,1985-10-09,1986-05-08,212,6,112,435,547,133,459,592,1139,29,198,Utah,Richmond,204214
19829,1986-1987,1986-11-06,1987-04-19,165,13,64,386,450,56,170,226,676,16,90,Utah,Richmond,204214
19830,1987-1988,1987-11-17,1988-05-01,167,6,71,420,491,82,430,512,1003,24,136,Utah,Richmond,204214
19831,1988-1989,1988-11-14,1989-03-30,137,2,123,486,609,121,614,735,1344,34,231,Utah,Richmond,204214
19832,1989-1990,1989-10-27,1990-05-08,194,5,35,367,402,75,244,319,721,18,121,Utah,Richmond,204214
19833,1990-1991,1990-11-01,1991-05-03,184,2,111,512,623,91,448,539,1162,24,160,Utah,Richmond,204214
19834,1991-1992,1991-10-27,1992-03-17,143,1,81,391,472,67,443,510,982,15,102,Utah,Richmond,204214
19835,1992-1993,1992-11-02,1993-04-13,163,2,111,487,598,127,795,922,1520,33,243,Utah,Richmond,204214
19836,1993-1994,1993-11-23,1994-04-07,136,1,28,297,325,79,196,275,600,20,121,Utah,Richmond,204214
19837,1994-1995,1994-11-02,1995-06-06,217,5,36,308,344,110,235,345,689,26,159,Utah,Richmond,204214
19838,1995-1996,1995-10-22,1996-04-18,180,8,34,302,336,93,224,317,653,22,151,Utah,Richmond,204214
19839,1996-1997,1996-10-25,1997-04-24,182,16,26,323,349,106,257,363,712,22,157,Utah,Richmond,204214
19840,1997-1998,1997-10-24,1998-04-14,173,3,35,315,350,105,305,410,760,28,155,Utah,Richmond,204214
19841,1998-1999,1998-11-06,1999-05-15,191,6,46,325,371,114,237,351,722,28,162,Utah,Richmond,204214
19842,1999-2000,1999-11-22,2000-03-30,130,2,18,244,262,92,136,228,490,25,135,Utah,Richmond,204214
19843,2000-2001,2000-11-08,2001-04-12,156,7,74,421,495,85,456,541,1036,22,133,Utah,Richmond,204214
19844,2001-2002,2001-11-24,2002-04-16,144,5,109,489,598,119,755,874,1472,26,195,Utah,Richmond,204214
19845,2002-2003,2002-10-01,2003-04-26,208,12,20,284,304,67,98,165,469,19,99,Utah,Richmond,204214
19846,2003-2004,2003-10-30,2004-04-28,182,19,78,367,445,129,590,719,1164,32,209,Utah,Richmond,204214
19847,2006-2007,2006-10-26,2007-05-22,209,9,64,353,417,68,187,255,672,19,113,Utah,Richmond,204214
19848,2007-2008,2007-11-27,2008-04-24,150,9,84,372,456,117,413,530,986,36,229,Utah,Richmond,204214
19849,2008-2009,2008-11-04,2009-03-30,147,3,49,340,389,122,475,597,986,25,200,Utah,Richmond,204214
19850,2009-2010,2009-10-27,2010-05-06,192,0,89,429,518,93,467,560,1078,26,154,Utah,Richmond,204214
19851,2010-2011,2010-11-20,2011-04-14,146,19,74,322,396,148,298,446,842,34,230,Utah,Richmond,204214
19852,2011-2012,2011-11-18,2012-04-06,141,16,32,289,321,66,59,125,446,22,117,Utah,Richmond,204214
19853,2012-2013,2012-10-25,2013-05-01,189,0,128,448,576,106,521,627,1203,29,194,Utah,Richmond,204214
19854,2013-2014,2013-11-03,2014-04-01,150,1,73,340,413,75,279,354,767,21,134,Utah,Richmond,204214
19855,2014-2015,2014-11-12,2015-04-16,156,0,29,276,305,45,67,112,417,13,74,Utah,Richmond,204214
19856,2016-2017,2016-11-17,2017-05-17,182,13,90,345,435,129,358,487,922,25,212,Utah,Richmond,204214
19857,2017-2018,2017-12-01,2018-04-17,138,2,46,258,304,61,159,220,524,19,104,Utah,Richmond,204214
19858,2018-2019,2018-12-01,2019-03-14,104,2,70,294,364,66,324,390,754,21,126,Utah,Richmond,204214
19859,2019-2020,2019-10-29,2020-04-16,171,3,59,349,408,108,352,460,868,35,214,Utah,Richmond,204214
19860,1950-1951,1950-11-09,1951-04-30,173,0,21,215,236,56,60,116,352,28,112,Utah,Salt Lake City,186440
19861,1951-1952,1951-11-12,1952-03-25,135,0,50,324,374,152,304,456,830,50,275,Utah,Salt Lake City,186440
19862,1952-1953,1952-11-15,1953-05-10,177,0,15,195,210,66,75,141,351,23,102,Utah,Salt Lake City,186440
19863,1953-1954,1953-11-17,1954-03-30,134,0,9,194,203,60,70,130,333,25,108,Utah,Salt Lake City,186440
19864,1954-1955,1954-11-30,1955-05-15,167,0,46,367,413,104,220,324,737,39,219,Utah,Salt Lake City,186440
19865,1955-1956,1955-11-11,1956-04-02,144,1,27,247,274,79,111,190,464,35,155,Utah,Salt Lake City,186440
19866,1956-1957,1956-10-24,1957-04-23,182,0,18,298,316,82,131,213,529,30,162,Utah,Salt Lake City,186440
19867,1957-1958,1957-11-02,1958-04-25,175,0,3,225,228,98,30,128,356,42,144,Utah,Salt Lake City,186440
19868,1958-1959,1958-11-14,1959-04-18,156,0,10,203,213,59,65,124,337,21,105,Utah,Salt Lake City,186440
19869,1959-1960,1959-11-04,1960-05-18,197,0,39,353,392,83,144,227,619,40,203,Utah,Salt Lake City,186440
19870,1960-1961,1960-11-15,1961-04-24,161,0,3,262,265,49,28,77,342,22,79,Utah,Salt Lake City,186440
19871,1961-1962,1961-10-21,1962-04-21,183,0,80,376,456,118,202,320,776,41,241,Utah,Salt Lake City,186440
19872,1962-1963,1962-11-16,1963-04-22,158,0,43,341,384,55,61,116,500,22,117,Utah,Salt Lake City,186440
19873,1963-1964,1963-11-15,1964-05-05,173,0,57,416,473,126,230,356,829,51,284,Utah,Salt Lake City,186440
19874,1964-1965,1964-11-10,1965-05-06,178,0,22,264,286,72,76,148,434,36,135,Utah,Salt Lake City,186440
19875,1965-1966,1965-09-17,1966-04-19,215,0,26,275,301,88,120,208,509,35,172,Utah,Salt Lake City,186440
19876,1966-1967,1966-10-13,1967-05-11,211,0,24,239,263,101,101,202,465,34,174,Utah,Salt Lake City,186440
19877,1967-1968,1967-11-30,1968-04-22,145,0,28,274,302,102,156,258,560,25,154,Utah,Salt Lake City,186440
19878,1968-1969,1968-11-16,1969-04-24,160,0,27,273,300,132,196,328,628,42,252,Utah,Salt Lake City,186440
19879,1969-1970,1969-10-14,1970-04-30,199,0,14,206,220,82,51,133,353,38,120,Utah,Salt Lake City,186440
19880,1970-1971,1970-10-24,1971-05-17,206,0,32,249,281,95,146,241,522,47,202,Utah,Salt Lake City,186440
19881,1971-1972,1971-09-30,1972-04-25,209,0,29,278,307,115,134,249,556,40,204,Utah,Salt Lake City,186440
19882,1972-1973,1972-10-28,1973-04-19,174,0,77,349,426,128,298,426,852,47,235,Utah,Salt Lake City,186440
19883,1973-1974,1973-10-29,1974-04-13,167,0,24,246,270,153,195,348,618,52,250,Utah,Salt Lake City,186440
19884,1974-1975,1974-12-01,1975-05-06,157,0,26,205,231,105,84,189,420,42,184,Utah,Salt Lake City,186440
19885,1975-1976,1975-10-24,1976-04-26,186,0,24,268,292,113,135,248,540,47,216,Utah,Salt Lake City,186440
19886,1976-1977,1976-11-27,1977-05-18,173,0,18,291,309,94,68,162,471,35,149,Utah,Salt Lake City,186440
19887,1977-1978,1977-10-31,1978-05-05,187,0,5,104,109,88,50,138,247,38,125,Utah,Salt Lake City,186440
19888,1978-1979,1978-09-18,1979-04-12,207,0,54,295,349,99,132,231,580,51,218,Utah,Salt Lake City,186440
19889,1979-1980,1979-11-18,1980-04-07,142,0,16,213,229,86,127,213,442,24,121,Utah,Salt Lake City,186440
19890,1980-1981,1980-11-23,1981-04-04,133,0,21,127,148,52,32,84,232,28,83,Utah,Salt Lake City,186440
19891,1981-1982,1981-10-29,1982-04-07,161,0,27,206,233,84,104,188,421,41,164,Utah,Salt Lake City,186440
19892,1982-1983,1982-10-27,1983-05-11,197,0,11,187,198,85,95,180,378,33,121,Utah,Salt Lake City,186440
19893,1983-1984,1983-11-08,1984-04-28,173,0,59,265,324,141,434,575,899,63,275,Utah,Salt Lake City,186440
19894,1984-1985,1984-10-15,1985-04-19,187,0,34,294,328,109,352,461,789,48,199,Utah,Salt Lake City,186440
19895,1985-1986,1985-11-09,1986-04-26,169,0,35,196,231,85,247,332,563,38,158,Utah,Salt Lake City,186440
19896,1986-1987,1986-11-06,1987-04-19,165,0,22,235,257,60,107,167,424,29,123,Utah,Salt Lake City,186440
19897,1987-1988,1987-11-17,1988-05-01,167,0,31,271,302,53,158,211,513,28,113,Utah,Salt Lake City,186440
19898,1988-1989,1988-11-14,1989-03-04,111,0,51,319,370,91,335,426,796,43,224,Utah,Salt Lake City,186440
19899,1989-1990,1989-10-26,1990-04-28,185,0,10,206,216,57,48,105,321,28,106,Utah,Salt Lake City,186440
19900,1990-1991,1990-11-20,1991-04-28,160,0,51,325,376,65,196,261,637,32,162,Utah,Salt Lake City,186440
19901,1991-1992,1991-10-27,1992-04-18,175,0,22,212,234,65,107,172,406,31,109,Utah,Salt Lake City,186440
19902,1992-1993,1992-11-19,1993-05-08,171,0,37,296,333,146,394,540,873,56,292,Utah,Salt Lake City,186440
19903,1993-1994,1993-11-22,1994-04-04,134,0,9,186,195,60,65,125,320,23,95,Utah,Salt Lake City,186440
19904,1994-1995,1994-11-02,1995-04-14,164,0,15,207,222,120,195,315,537,38,181,Utah,Salt Lake City,186440
19905,1995-1996,1995-10-22,1996-04-20,182,0,13,197,210,125,216,341,551,33,183,Utah,Salt Lake City,186440
19906,1996-1997,1996-10-20,1997-04-24,187,0,11,190,201,94,82,176,377,41,152,Utah,Salt Lake City,186440
19907,1997-1998,1997-10-11,1998-04-15,187,0,14,197,211,90,158,248,459,29,130,Utah,Salt Lake City,186440
19908,1998-1999,1998-11-06,1999-04-09,155,2,22,178,200,48,48,96,296,21,78,Utah,Salt Lake City,186440
19909,1999-2000,1999-11-21,2000-05-11,173,0,13,148,161,71,98,169,330,27,117,Utah,Salt Lake City,186440
19910,2000-2001,2000-11-05,2001-04-12,159,0,32,235,267,97,115,212,479,43,186,Utah,Salt Lake City,186440
19911,2001-2002,2001-11-23,2002-04-17,146,0,47,299,346,103,164,267,613,33,185,Utah,Salt Lake City,186440
19912,2002-2003,2002-11-24,2003-04-07,135,0,7,133,140,34,30,64,204,19,61,Utah,Salt Lake City,186440
19913,2003-2004,2003-10-30,2004-04-28,182,0,55,264,319,117,268,385,704,42,208,Utah,Salt Lake City,186440
19914,2004-2005,2004-10-31,2005-03-30,151,0,19,164,183,46,39,85,268,25,84,Utah,Salt Lake City,186440
19915,2005-2006,2005-11-26,2006-04-17,143,0,19,182,201,70,57,127,328,35,119,Utah,Salt Lake City,186440
19916,2006-2007,2006-11-28,2007-03-28,121,0,45,248,293,62,163,225,518,24,130,Utah,Salt Lake City,186440
19917,2007-2008,2007-10-17,2008-03-31,167,0,44,282,326,111,207,318,644,41,211,Utah,Salt Lake City,186440
19918,2008-2009,2008-10-11,2009-04-04,176,0,18,207,225,74,111,185,410,34,139,Utah,Salt Lake City,186440
19919,2009-2010,2009-10-27,2010-05-24,210,0,37,248,285,58,115,173,458,34,137,Utah,Salt Lake City,186440
19920,2010-2011,2010-10-25,2011-04-30,188,0,40,211,251,95,133,228,479,39,171,Utah,Salt Lake City,186440
19921,2011-2012,2011-11-05,2012-04-06,154,0,7,196,203,38,29,67,270,21,60,Utah,Salt Lake City,186440
19922,2012-2013,2012-10-25,2013-04-15,173,0,62,256,318,101,273,374,692,34,184,Utah,Salt Lake City,186440
19923,2013-2014,2013-11-03,2014-03-30,148,0,25,199,224,52,176,228,452,20,93,Utah,Salt Lake City,186440
19924,2014-2015,2014-11-13,2015-04-16,155,0,12,125,137,25,15,40,177,13,42,Utah,Salt Lake City,186440
19925,2015-2016,2015-11-28,2016-03-28,122,0,28,161,189,55,106,161,350,29,113,Utah,Salt Lake City,186440
19926,2016-2017,2016-11-17,2017-05-17,182,0,35,175,210,80,118,198,408,34,138,Utah,Salt Lake City,186440
19927,2017-2018,2017-12-01,2018-04-17,138,0,7,119,126,70,91,161,287,30,105,Utah,Salt Lake City,186440
19928,2018-2019,2018-11-24,2019-04-12,140,0,22,161,183,69,104,173,356,31,123,Utah,Salt Lake City,186440
19929,2019-2020,2019-11-25,2020-03-28,125,1,6,120,126,65,61,126,252,29,96,Utah,Salt Lake City,186440
19930,1950-1951,1950-12-01,1951-02-28,90,1,0,102,102,3,0,3,105,2,6,Utah,St. George,72897
19931,1951-1952,1951-12-01,1952-02-29,91,0,0,107,107,0,0,0,107,0,0,Utah,St. George,72897
19932,1952-1953,1952-12-01,1953-02-28,90,0,0,85,85,0,0,0,85,0,0,Utah,St. George,72897
19933,1953-1954,1953-12-01,1954-02-28,90,2,0,118,118,0,0,0,118,0,0,Utah,St. George,72897
19934,1954-1955,1954-12-01,1955-02-28,90,9,0,136,136,0,0,0,136,0,0,Utah,St. George,72897
19935,1955-1956,1955-12-01,1956-02-29,91,2,0,105,105,0,0,0,105,0,0,Utah,St. George,72897
19936,1957-1958,1957-12-01,1958-02-28,90,0,0,82,82,0,0,0,82,0,0,Utah,St. George,72897
19937,1958-1959,1958-12-01,1959-02-28,90,0,0,108,108,0,0,0,108,0,0,Utah,St. George,72897
19938,1959-1960,1959-12-01,1960-02-29,91,0,0,94,94,0,0,0,94,0,0,Utah,St. George,72897
19939,1960-1961,1960-12-01,1961-02-28,90,1,0,136,136,0,0,0,136,0,0,Utah,St. George,72897
19940,1961-1962,1961-12-01,1962-02-28,90,0,0,123,123,0,0,0,123,0,0,Utah,St. George,72897
19941,1962-1963,1962-12-01,1963-02-28,90,1,1,150,151,0,0,0,151,0,0,Utah,St. George,72897
19942,1963-1964,1963-12-01,1964-02-29,91,1,0,162,162,0,0,0,162,0,0,Utah,St. George,72897
19943,1964-1965,1964-12-01,1965-02-28,90,1,0,76,76,0,0,0,76,0,0,Utah,St. George,72897
19944,1965-1966,1965-12-01,1966-02-28,90,0,0,133,133,0,0,0,133,0,0,Utah,St. George,72897
19945,1968-1969,1968-12-01,1969-02-28,90,2,0,71,71,12,9,21,92,2,14,Utah,St. George,72897
19946,1969-1970,1969-12-01,1970-02-28,90,0,0,57,57,0,0,0,57,0,0,Utah,St. George,72897
19947,1970-1971,1970-12-01,1971-02-28,90,7,4,112,116,0,0,0,116,0,0,Utah,St. George,72897
19948,1971-1972,1971-10-29,1972-02-29,124,5,0,146,146,5,0,5,151,3,9,Utah,St. George,72897
19949,1975-1976,1975-12-01,1976-02-29,91,8,0,93,93,0,3,3,96,0,0,Utah,St. George,72897
19950,1976-1977,1976-12-01,1977-02-28,90,6,0,125,125,0,0,0,125,0,0,Utah,St. George,72897
19951,1977-1978,1977-12-01,1978-02-28,90,15,0,36,36,0,0,0,36,0,0,Utah,St. George,72897
19952,1978-1979,1978-12-01,1979-02-28,90,19,4,128,132,0,15,15,147,0,0,Utah,St. George,72897
19953,1982-1983,1982-12-01,1983-02-28,90,1,0,62,62,0,0,0,62,0,0,Utah,St. George,72897
19954,1983-1984,1983-12-01,1984-02-29,91,0,0,87,87,0,0,0,87,0,0,Utah,St. George,72897
19955,1986-1987,1986-12-01,1987-02-28,90,0,0,80,80,8,0,8,88,3,11,Utah,St. George,72897
19956,1987-1988,1987-12-01,1988-02-29,91,6,0,92,92,5,0,5,97,2,6,Utah,St. George,72897
19957,1988-1989,1988-12-01,1989-02-28,90,2,3,103,106,6,6,12,118,3,9,Utah,St. George,72897
19958,1989-1990,1989-12-01,1990-02-28,90,1,0,104,104,2,0,2,106,1,3,Utah,St. George,72897
19959,1990-1991,1990-12-01,1991-02-28,90,3,2,129,131,1,0,1,132,1,2,Utah,St. George,72897
19960,1992-1993,1992-12-01,1993-02-28,90,1,0,53,53,0,0,0,53,0,0,Utah,St. George,72897
19961,1993-1994,1993-12-01,1994-02-28,90,0,0,85,85,0,0,0,85,0,0,Utah,St. George,72897
19962,1994-1995,1994-12-01,1995-02-28,90,0,0,39,39,0,0,0,39,0,0,Utah,St. George,72897
19963,1995-1996,1995-12-01,1996-02-29,91,4,0,62,62,2,0,2,64,1,4,Utah,St. George,72897
19964,1996-1997,1996-12-01,1997-02-28,90,1,0,42,42,13,10,23,65,2,16,Utah,St. George,72897
19965,1997-1998,1997-12-01,1998-02-28,90,0,0,53,53,1,0,1,54,1,1,Utah,St. George,72897
19966,1998-1999,1998-12-01,1999-04-09,130,2,0,65,65,1,0,1,66,1,2,Utah,St. George,72897
19967,2000-2001,2000-12-01,2001-02-28,90,2,0,56,56,0,0,0,56,0,0,Utah,St. George,72897
19968,2002-2003,2002-12-01,2003-02-28,90,20,0,31,31,0,0,0,31,0,0,Utah,St. George,72897
19969,2007-2008,2007-12-01,2008-02-29,91,4,0,60,60,0,0,0,60,0,0,Utah,St. George,72897
19970,2008-2009,2008-12-01,2009-02-28,90,14,1,60,61,1,0,1,62,1,2,Utah,St. George,72897
19971,2009-2010,2009-12-01,2010-02-28,90,7,0,53,53,0,0,0,53,0,0,Utah,St. George,72897
19972,2011-2012,2011-12-01,2012-02-29,91,14,0,77,77,0,0,0,77,0,0,Utah,St. George,72897
19973,2012-2013,2012-12-01,2013-02-28,90,17,0,77,77,0,0,0,77,0,0,Utah,St. George,72897
19974,2014-2015,2014-12-01,2015-02-28,90,0,0,44,44,5,4,9,53,2,8,Utah,St. George,72897
19975,2015-2016,2015-12-01,2016-02-29,91,0,0,78,78,0,0,0,78,0,0,Utah,St. George,72897
19976,2016-2017,2016-12-01,2017-02-28,90,0,0,50,50,0,0,0,50,0,0,Utah,St. George,72897
19977,2017-2018,2017-12-01,2018-02-28,90,0,0,60,60,1,0,1,61,1,3,Utah,St. George,72897
19978,2018-2019,2018-12-01,2019-02-28,90,0,0,88,88,10,8,18,106,3,13,Utah,St. George,72897
19979,2019-2020,2019-12-01,2020-02-29,91,0,0,101,101,0,0,0,101,0,0,Utah,St. George,72897
19980,1950-1951,1950-11-11,1951-04-17,158,0,106,383,489,82,155,237,726,48,251,Vermont,Burlington,42417
19981,1951-1952,1951-11-01,1952-03-23,144,0,116,431,547,125,376,501,1048,50,329,Vermont,Burlington,42417
19982,1952-1953,1952-10-20,1953-04-20,183,0,80,368,448,92,192,284,732,39,222,Vermont,Burlington,42417
19983,1953-1954,1953-11-30,1954-04-04,126,0,113,417,530,127,266,393,923,48,360,Vermont,Burlington,42417
19984,1954-1955,1954-11-21,1955-04-08,139,0,149,445,594,131,208,339,933,65,397,Vermont,Burlington,42417
19985,1955-1956,1955-11-17,1956-05-04,170,0,162,520,682,130,333,463,1145,60,358,Vermont,Burlington,42417
19986,1956-1957,1956-11-09,1957-04-09,152,0,117,495,612,85,174,259,871,38,263,Vermont,Burlington,42417
19987,1957-1958,1957-11-25,1958-04-09,136,0,125,425,550,143,587,730,1280,53,384,Vermont,Burlington,42417
19988,1958-1959,1958-11-24,1959-04-06,134,0,181,600,781,132,536,668,1449,55,474,Vermont,Burlington,42417
19989,1959-1960,1959-11-17,1960-04-09,145,0,138,456,594,113,356,469,1063,57,321,Vermont,Burlington,42417
19990,1960-1961,1960-11-30,1961-04-14,136,0,191,585,776,82,362,444,1220,37,278,Vermont,Burlington,42417
19991,1961-1962,1961-11-08,1962-04-15,159,0,153,564,717,121,374,495,1212,56,415,Vermont,Burlington,42417
19992,1962-1963,1962-10-25,1963-04-11,169,0,169,672,841,110,619,729,1570,54,376,Vermont,Burlington,42417
19993,1963-1964,1963-11-14,1964-04-06,145,0,156,534,690,91,265,356,1046,45,336,Vermont,Burlington,42417
19994,1964-1965,1964-10-10,1965-04-17,190,0,152,548,700,85,159,244,944,48,295,Vermont,Burlington,42417
19995,1965-1966,1965-10-28,1966-05-10,195,0,133,493,626,165,350,515,1141,68,443,Vermont,Burlington,42417
19996,1966-1967,1966-11-14,1967-05-08,176,0,154,552,706,131,373,504,1210,55,415,Vermont,Burlington,42417
19997,1967-1968,1967-11-06,1968-03-25,141,0,212,609,821,123,432,555,1376,54,461,Vermont,Burlington,42417
19998,1968-1969,1968-11-08,1969-04-20,164,0,175,561,736,145,760,905,1641,68,473,Vermont,Burlington,42417
19999,1969-1970,1969-10-22,1970-05-06,197,0,223,686,909,157,851,1008,1917,69,547,Vermont,Burlington,42417
20000,1970-1971,1970-10-17,1971-04-17,183,0,209,648,857,207,979,1186,2043,72,637,Vermont,Burlington,42417
20001,1971-1972,1971-11-07,1972-04-13,159,0,136,554,690,163,355,518,1208,67,474,Vermont,Burlington,42417
20002,1972-1973,1972-11-04,1973-04-13,161,0,144,474,618,133,298,431,1049,60,378,Vermont,Burlington,42417
20003,1973-1974,1973-11-06,1974-04-24,170,0,147,474,621,147,276,423,1044,59,402,Vermont,Burlington,42417
20004,1974-1975,1974-10-21,1975-04-14,176,0,100,429,529,132,346,478,1007,64,342,Vermont,Burlington,42417
20005,1975-1976,1975-11-14,1976-04-26,165,0,157,542,699,138,418,556,1255,57,461,Vermont,Burlington,42417
20006,1976-1977,1976-10-18,1977-04-07,172,0,178,527,705,131,519,650,1355,73,487,Vermont,Burlington,42417
20007,1977-1978,1977-11-12,1978-04-15,155,0,207,574,781,145,673,818,1599,60,449,Vermont,Burlington,42417
20008,1978-1979,1978-11-20,1979-04-14,146,0,197,492,689,132,425,557,1246,56,393,Vermont,Burlington,42417
20009,1979-1980,1979-10-09,1980-04-16,191,0,126,415,541,77,115,192,733,46,250,Vermont,Burlington,42417
20010,1980-1981,1980-11-10,1981-04-20,162,0,180,532,712,107,300,407,1119,57,404,Vermont,Burlington,42417
20011,1981-1982,1981-11-07,1982-04-12,157,0,169,518,687,137,694,831,1518,68,487,Vermont,Burlington,42417
20012,1982-1983,1982-11-26,1983-05-09,165,0,93,369,462,116,265,381,843,43,244,Vermont,Burlington,42417
20013,1983-1984,1983-11-12,1984-04-08,149,0,151,477,628,103,333,436,1064,51,358,Vermont,Burlington,42417
20014,1984-1985,1984-11-12,1985-04-09,149,0,132,428,560,136,356,492,1052,58,434,Vermont,Burlington,42417
20015,1985-1986,1985-11-10,1986-03-23,134,3,138,491,629,125,607,732,1361,56,397,Vermont,Burlington,42417
20016,1986-1987,1986-11-06,1987-04-03,149,0,109,480,589,103,534,637,1226,49,283,Vermont,Burlington,42417
20017,1987-1988,1987-10-11,1988-04-21,194,0,107,453,560,104,222,326,886,49,269,Vermont,Burlington,42417
20018,1988-1989,1988-10-22,1989-04-14,175,0,112,473,585,77,119,196,781,52,253,Vermont,Burlington,42417
20019,1989-1990,1989-11-03,1990-04-18,167,0,146,513,659,121,256,377,1036,52,353,Vermont,Burlington,42417
20020,1990-1991,1990-11-07,1991-03-26,140,0,81,353,434,84,185,269,703,56,285,Vermont,Burlington,42417
20021,1991-1992,1991-11-07,1992-04-17,163,0,125,539,664,125,282,407,1071,65,441,Vermont,Burlington,42417
20022,1992-1993,1992-09-30,1993-04-24,207,0,128,541,669,182,516,698,1367,69,497,Vermont,Burlington,42417
20023,1993-1994,1993-10-31,1994-04-22,174,0,189,593,782,164,574,738,1520,54,504,Vermont,Burlington,42417
20024,1994-1995,1994-11-22,1995-04-16,146,0,88,392,480,99,241,340,820,46,260,Vermont,Burlington,42417
20025,1995-1996,1995-10-31,1996-05-12,195,5,165,508,673,152,383,535,1208,72,422,Vermont,Burlington,42417
20026,1996-1997,1996-11-02,1997-04-20,170,0,104,437,541,156,365,521,1062,71,434,Vermont,Burlington,42417
20027,1997-1998,1997-10-24,1998-04-05,164,0,76,377,453,143,332,475,928,53,317,Vermont,Burlington,42417
20028,1998-1999,1998-11-04,1999-03-21,138,1,94,372,466,99,280,379,845,38,286,Vermont,Burlington,42417
20029,1999-2000,1999-11-07,2000-04-14,160,3,113,398,511,115,266,381,892,44,281,Vermont,Burlington,42417
20030,2000-2001,2000-10-29,2001-04-10,164,0,118,478,596,183,751,934,1530,65,427,Vermont,Burlington,42417
20031,2001-2002,2001-11-11,2002-04-23,164,0,48,300,348,88,210,298,646,42,200,Vermont,Burlington,42417
20032,2002-2003,2002-11-06,2003-04-24,170,0,181,531,712,130,521,651,1363,61,391,Vermont,Burlington,42417
20033,2003-2004,2003-11-11,2004-04-06,148,0,166,496,662,147,504,651,1313,53,409,Vermont,Burlington,42417
20034,2004-2005,2004-11-08,2005-03-27,140,0,137,487,624,129,438,567,1191,53,429,Vermont,Burlington,42417
20035,2005-2006,2005-10-25,2006-04-04,162,0,94,360,454,109,234,343,797,54,300,Vermont,Burlington,42417
20036,2006-2007,2006-10-20,2007-04-16,179,0,132,446,578,134,446,580,1158,43,364,Vermont,Burlington,42417
20037,2007-2008,2007-11-20,2008-04-04,137,0,92,391,483,172,494,666,1149,66,387,Vermont,Burlington,42417
20038,2008-2009,2008-10-28,2009-04-08,163,0,134,469,603,134,294,428,1031,44,353,Vermont,Burlington,42417
20039,2009-2010,2009-12-01,2010-04-28,149,0,90,302,392,141,358,499,891,48,311,Vermont,Burlington,42417
20040,2010-2011,2010-10-31,2011-04-05,157,0,135,428,563,192,597,789,1352,67,484,Vermont,Burlington,42417
20041,2011-2012,2011-10-30,2012-03-10,133,0,41,274,315,71,81,152,467,47,216,Vermont,Burlington,42417
20042,2012-2013,2012-11-25,2013-04-12,139,3,90,347,437,129,217,346,783,54,348,Vermont,Burlington,42417
20043,2013-2014,2013-11-11,2014-04-16,157,0,162,530,692,132,493,625,1317,55,401,Vermont,Burlington,42417
20044,2014-2015,2014-11-13,2015-04-09,148,0,163,544,707,130,366,496,1203,59,431,Vermont,Burlington,42417
20045,2015-2016,2015-11-29,2016-04-26,150,0,53,286,339,59,99,158,497,34,203,Vermont,Burlington,42417
20046,2016-2017,2016-11-20,2017-04-03,135,0,68,294,362,141,269,410,772,48,283,Vermont,Burlington,42417
20047,2017-2018,2017-11-11,2018-04-20,161,0,117,403,520,132,386,518,1038,56,353,Vermont,Burlington,42417
20048,2018-2019,2018-11-13,2019-04-10,149,0,121,460,581,158,465,623,1204,67,433,Vermont,Burlington,42417
20049,2019-2020,2019-11-08,2020-05-09,184,0,64,355,419,109,383,492,911,55,270,Vermont,Burlington,42417
20050,1950-1951,1950-11-21,1951-03-26,126,0,63,315,378,56,113,169,547,24,142,Vermont,Rutland,16495
20051,1951-1952,1951-11-01,1952-03-21,142,0,74,410,484,105,341,446,930,34,227,Vermont,Rutland,16495
20052,1952-1953,1952-10-28,1953-04-20,175,1,46,343,389,76,206,282,671,34,171,Vermont,Rutland,16495
20053,1953-1954,1953-11-07,1954-04-04,149,2,69,389,458,88,211,299,757,31,230,Vermont,Rutland,16495
20054,1954-1955,1954-11-29,1955-04-08,131,4,91,382,473,65,160,225,698,33,146,Vermont,Rutland,16495
20055,1955-1956,1955-11-05,1956-04-23,171,1,94,479,573,88,348,436,1009,41,241,Vermont,Rutland,16495
20056,1956-1957,1956-11-18,1957-04-09,143,5,62,425,487,82,182,264,751,24,169,Vermont,Rutland,16495
20057,1957-1958,1957-11-09,1958-04-03,146,5,69,365,434,123,532,655,1089,32,242,Vermont,Rutland,16495
20058,1958-1959,1958-11-24,1959-03-30,127,10,106,506,612,82,284,366,978,33,237,Vermont,Rutland,16495
20059,1959-1960,1959-11-18,1960-04-09,144,4,73,380,453,110,435,545,998,37,231,Vermont,Rutland,16495
20060,1960-1961,1960-12-01,1961-04-11,132,1,94,484,578,75,385,460,1038,23,186,Vermont,Rutland,16495
20061,1961-1962,1961-11-20,1962-03-13,114,5,78,395,473,85,305,390,863,29,198,Vermont,Rutland,16495
20062,1962-1963,1962-11-18,1963-04-11,145,1,95,484,579,114,711,825,1404,38,272,Vermont,Rutland,16495
20063,1963-1964,1963-11-15,1964-04-04,142,4,90,418,508,79,319,398,906,27,180,Vermont,Rutland,16495
20064,1964-1965,1964-12-01,1965-04-18,139,7,91,420,511,51,171,222,733,19,147,Vermont,Rutland,16495
20065,1965-1966,1965-11-18,1966-05-09,173,2,71,399,470,83,267,350,820,27,167,Vermont,Rutland,16495
20066,1966-1967,1966-12-01,1967-04-08,129,4,84,410,494,90,434,524,1018,32,215,Vermont,Rutland,16495
20067,1967-1968,1967-11-15,1968-03-24,131,1,117,482,599,75,401,476,1075,27,202,Vermont,Rutland,16495
20068,1968-1969,1968-11-12,1969-04-20,160,7,87,444,531,121,683,804,1335,39,250,Vermont,Rutland,16495
20069,1969-1970,1969-10-22,1970-04-11,172,2,121,546,667,105,728,833,1500,37,273,Vermont,Rutland,16495
20070,1970-1971,1970-10-17,1971-04-16,182,3,120,500,620,154,703,857,1477,45,344,Vermont,Rutland,16495
20071,1971-1972,1971-11-08,1972-04-07,152,11,77,458,535,129,278,407,942,39,289,Vermont,Rutland,16495
20072,1972-1973,1972-11-05,1973-04-10,157,6,72,390,462,90,249,339,801,34,217,Vermont,Rutland,16495
20073,1973-1974,1973-12-01,1974-04-11,132,8,88,395,483,91,209,300,783,24,191,Vermont,Rutland,16495
20074,1975-1976,1975-11-14,1976-03-19,127,0,100,425,525,101,399,500,1025,32,243,Vermont,Rutland,16495
20075,1976-1977,1976-10-26,1977-04-07,164,7,112,483,595,133,503,636,1231,45,294,Vermont,Rutland,16495
20076,1977-1978,1977-11-13,1978-04-07,146,4,115,490,605,139,598,737,1342,32,288,Vermont,Rutland,16495
20077,1978-1979,1978-11-21,1979-04-14,145,17,125,446,571,107,382,489,1060,30,209,Vermont,Rutland,16495
20078,1979-1980,1979-12-01,1980-03-16,107,10,89,350,439,58,114,172,611,20,124,Vermont,Rutland,16495
20079,1980-1981,1980-11-18,1981-03-21,124,7,115,475,590,104,364,468,1058,27,209,Vermont,Rutland,16495
20080,1988-1989,1988-12-01,1989-04-10,131,1,69,434,503,75,208,283,786,30,172,Vermont,Rutland,16495
20081,1989-1990,1989-11-04,1990-04-18,166,4,114,542,656,116,316,432,1088,31,244,Vermont,Rutland,16495
20082,1990-1991,1990-11-11,1991-03-30,140,3,51,361,412,69,168,237,649,29,149,Vermont,Rutland,16495
20083,1991-1992,1991-11-08,1992-04-17,162,4,66,495,561,90,208,298,859,45,257,Vermont,Rutland,16495
20084,1992-1993,1992-11-06,1993-04-04,150,1,84,504,588,125,503,628,1216,40,282,Vermont,Rutland,16495
20085,1993-1994,1993-11-01,1994-04-04,155,4,153,617,770,135,837,972,1742,34,343,Vermont,Rutland,16495
20086,1994-1995,1994-11-23,1995-04-05,134,3,64,359,423,57,222,279,702,22,129,Vermont,Rutland,16495
20087,1995-1996,1995-11-09,1996-04-11,155,3,135,530,665,132,372,504,1169,46,345,Vermont,Rutland,16495
20088,1996-1997,1996-11-11,1997-04-19,160,3,65,441,506,142,398,540,1046,39,265,Vermont,Rutland,16495
20089,1997-1998,1997-11-12,1998-03-26,135,3,44,371,415,105,283,388,803,38,230,Vermont,Rutland,16495
20090,1998-1999,1998-11-17,1999-03-17,121,6,63,360,423,102,223,325,748,30,237,Vermont,Rutland,16495
20091,1999-2000,1999-11-16,2000-04-27,164,4,66,409,475,97,207,304,779,30,205,Vermont,Rutland,16495
20092,2000-2001,2000-10-29,2001-04-13,167,2,63,481,544,160,758,918,1462,45,295,Vermont,Rutland,16495
20093,2001-2002,2001-11-29,2002-04-23,146,4,18,286,304,84,181,265,569,34,165,Vermont,Rutland,16495
20094,2002-2003,2002-11-16,2003-04-24,160,3,113,545,658,163,795,958,1616,46,327,Vermont,Rutland,16495
20095,2003-2004,2003-11-13,2004-03-23,132,1,122,488,610,121,497,618,1228,32,278,Vermont,Rutland,16495
20096,2004-2005,2004-11-09,2005-03-31,143,2,88,487,575,128,468,596,1171,38,316,Vermont,Rutland,16495
20097,2005-2006,2005-10-26,2006-04-04,161,5,58,378,436,104,245,349,785,38,233,Vermont,Rutland,16495
20098,2006-2007,2006-11-02,2007-04-16,166,5,98,468,566,113,516,629,1195,29,251,Vermont,Rutland,16495
20099,2007-2008,2007-11-20,2008-04-04,137,0,79,442,521,127,404,531,1052,48,309,Vermont,Rutland,16495
20100,2008-2009,2008-10-29,2009-03-24,147,0,131,507,638,137,465,602,1240,43,336,Vermont,Rutland,16495
20101,2009-2010,2009-12-01,2010-04-29,150,0,99,355,454,83,219,302,756,31,200,Vermont,Rutland,16495
20102,2010-2011,2010-11-09,2011-04-23,166,2,118,543,661,138,640,778,1439,41,351,Vermont,Rutland,16495
20103,2012-2013,2012-11-09,2013-04-13,156,15,82,437,519,88,222,310,829,41,225,Vermont,Rutland,16495
20104,2013-2014,2013-10-31,2014-04-16,168,0,155,659,814,132,486,618,1432,44,367,Vermont,Rutland,16495
20105,2014-2015,2014-11-17,2015-04-09,144,0,157,662,819,113,541,654,1473,35,311,Vermont,Rutland,16495
20106,2015-2016,2015-11-24,2016-04-07,136,0,61,349,410,35,61,96,506,17,116,Vermont,Rutland,16495
20107,2016-2017,2016-11-21,2017-04-08,139,0,72,393,465,104,301,405,870,33,230,Vermont,Rutland,16495
20108,2017-2018,2017-11-11,2018-04-20,161,0,120,533,653,145,507,652,1305,35,277,Vermont,Rutland,16495
20109,2018-2019,2018-11-14,2019-03-27,134,1,113,511,624,109,306,415,1039,37,272,Vermont,Rutland,16495
20110,2019-2020,2019-11-08,2020-05-09,184,0,66,460,526,92,227,319,845,32,199,Vermont,Rutland,16495
20111,1950-1951,1950-11-22,1951-04-03,133,0,72,398,470,76,238,314,784,27,175,Vermont,Saint Johnsbury,0
20112,1951-1952,1951-11-01,1952-04-03,155,5,94,536,630,172,724,896,1526,33,310,Vermont,Saint Johnsbury,0
20113,1953-1954,1953-10-07,1954-04-18,194,16,87,553,640,152,359,511,1151,44,357,Vermont,Saint Johnsbury,0
20114,1954-1955,1954-11-25,1955-04-27,154,7,101,511,612,137,551,688,1300,42,276,Vermont,Saint Johnsbury,0
20115,1955-1956,1955-10-26,1956-04-22,180,10,128,616,744,139,604,743,1487,45,324,Vermont,Saint Johnsbury,0
20116,1957-1958,1957-10-27,1958-04-28,184,9,82,480,562,142,581,723,1285,48,335,Vermont,Saint Johnsbury,0
20117,1958-1959,1958-11-24,1959-04-02,130,5,170,707,877,143,1002,1145,2022,55,502,Vermont,Saint Johnsbury,0
20118,1959-1960,1959-10-19,1960-04-01,166,6,85,505,590,114,786,900,1490,46,284,Vermont,Saint Johnsbury,0
20119,1960-1961,1960-11-30,1961-04-11,133,12,121,607,728,69,481,550,1278,31,216,Vermont,Saint Johnsbury,0
20120,1961-1962,1961-11-09,1962-04-25,168,8,110,553,663,119,575,694,1357,39,281,Vermont,Saint Johnsbury,0
20121,1962-1963,1962-10-25,1963-05-11,199,4,113,645,758,151,863,1014,1772,46,359,Vermont,Saint Johnsbury,0
20122,1963-1964,1963-11-25,1964-04-07,135,0,122,552,674,112,551,663,1337,41,275,Vermont,Saint Johnsbury,0
20123,1964-1965,1964-11-19,1965-04-18,151,5,115,590,705,88,466,554,1259,37,273,Vermont,Saint Johnsbury,0
20124,1965-1966,1965-11-18,1966-03-28,131,7,84,486,570,103,463,566,1136,33,224,Vermont,Saint Johnsbury,0
20125,1966-1967,1966-11-06,1967-04-19,165,2,97,565,662,117,630,747,1409,35,229,Vermont,Saint Johnsbury,0
20126,1967-1968,1967-11-14,1968-03-24,132,1,148,614,762,111,641,752,1514,31,265,Vermont,Saint Johnsbury,0
20127,1968-1969,1968-11-12,1969-04-07,147,0,123,567,690,202,1237,1439,2129,45,367,Vermont,Saint Johnsbury,0
20128,1969-1970,1969-10-22,1970-04-05,166,1,148,643,791,123,716,839,1630,37,262,Vermont,Saint Johnsbury,0
20129,1970-1971,1970-11-15,1971-04-16,153,2,154,634,788,200,1200,1400,2188,46,434,Vermont,Saint Johnsbury,0
20130,1971-1972,1971-11-09,1972-04-23,167,0,112,617,729,163,954,1117,1846,48,389,Vermont,Saint Johnsbury,0
20131,1972-1973,1972-11-05,1973-04-14,161,0,96,506,602,132,768,900,1502,39,281,Vermont,Saint Johnsbury,0
20132,1973-1974,1973-11-10,1974-04-24,166,0,114,523,637,116,458,574,1211,33,261,Vermont,Saint Johnsbury,0
20133,1975-1976,1975-11-14,1976-04-26,165,2,134,598,732,147,742,889,1621,40,337,Vermont,Saint Johnsbury,0
20134,1976-1977,1976-10-25,1977-04-09,167,6,146,586,732,131,738,869,1601,52,376,Vermont,Saint Johnsbury,0
20135,1977-1978,1977-11-13,1978-04-05,144,0,138,618,756,154,731,885,1641,41,350,Vermont,Saint Johnsbury,0
20136,1978-1979,1978-11-21,1979-04-10,141,0,152,569,721,152,681,833,1554,42,339,Vermont,Saint Johnsbury,0
20137,1979-1980,1979-10-09,1980-04-04,179,0,103,515,618,66,223,289,907,33,193,Vermont,Saint Johnsbury,0
20138,1980-1981,1980-11-02,1981-03-27,146,0,142,596,738,90,349,439,1177,37,242,Vermont,Saint Johnsbury,0
20139,1981-1982,1981-10-24,1982-04-13,172,7,146,611,757,169,974,1143,1900,57,401,Vermont,Saint Johnsbury,0
20140,1982-1983,1982-11-25,1983-04-19,146,4,67,405,472,84,208,292,764,30,166,Vermont,Saint Johnsbury,0
20141,1983-1984,1983-11-13,1984-03-30,139,10,123,544,667,126,524,650,1317,40,299,Vermont,Saint Johnsbury,0
20142,1984-1985,1984-11-13,1985-04-05,144,1,113,495,608,145,570,715,1323,45,346,Vermont,Saint Johnsbury,0
20143,1985-1986,1985-11-15,1986-05-04,171,1,104,564,668,155,913,1068,1736,59,407,Vermont,Saint Johnsbury,0
20144,1986-1987,1986-11-06,1987-04-29,175,1,97,545,642,143,795,938,1580,49,324,Vermont,Saint Johnsbury,0
20145,1988-1989,1988-10-22,1989-04-20,181,3,89,603,692,112,456,568,1260,64,354,Vermont,Saint Johnsbury,0
20146,1989-1990,1989-11-19,1990-04-12,145,0,136,604,740,144,555,699,1439,55,417,Vermont,Saint Johnsbury,0
20147,1990-1991,1990-11-08,1991-04-11,155,2,67,444,511,110,397,507,1018,48,292,Vermont,Saint Johnsbury,0
20148,1991-1992,1991-11-08,1992-04-18,163,2,115,608,723,137,537,674,1397,57,414,Vermont,Saint Johnsbury,0
20149,1992-1993,1992-10-01,1993-04-04,186,2,99,572,671,145,476,621,1292,55,385,Vermont,Saint Johnsbury,0
20150,1993-1994,1993-11-01,1994-04-21,172,3,159,650,809,152,584,736,1545,50,416,Vermont,Saint Johnsbury,0
20151,1994-1995,1994-11-23,1995-04-16,145,0,77,444,521,81,272,353,874,42,244,Vermont,Saint Johnsbury,0
20152,1995-1996,1995-10-30,1996-04-18,172,2,137,584,721,167,496,663,1384,75,469,Vermont,Saint Johnsbury,0
20153,1996-1997,1996-11-02,1997-04-18,168,1,85,507,592,167,544,711,1303,75,445,Vermont,Saint Johnsbury,0
20154,1997-1998,1997-10-24,1998-03-27,155,2,56,438,494,136,761,897,1391,65,328,Vermont,Saint Johnsbury,0
20155,1998-1999,1998-11-17,1999-03-27,131,0,72,418,490,108,502,610,1100,49,293,Vermont,Saint Johnsbury,0
20156,1999-2000,1999-11-13,2000-04-24,164,0,88,458,546,128,343,471,1017,53,354,Vermont,Saint Johnsbury,0
20157,2000-2001,2000-10-29,2001-04-15,169,5,108,545,653,168,885,1053,1706,68,415,Vermont,Saint Johnsbury,0
20158,2001-2002,2001-11-12,2002-04-29,169,0,39,365,404,123,643,766,1170,55,288,Vermont,Saint Johnsbury,0
20159,2002-2003,2002-10-26,2003-04-25,182,2,139,653,792,126,695,821,1613,69,380,Vermont,Saint Johnsbury,0
20160,2003-2004,2003-10-23,2004-05-04,195,0,135,605,740,139,796,935,1675,60,388,Vermont,Saint Johnsbury,0
20161,2004-2005,2004-11-06,2005-03-30,145,8,109,540,649,97,371,468,1117,52,322,Vermont,Saint Johnsbury,0
20162,2005-2006,2005-10-25,2006-04-05,163,1,82,434,516,113,352,465,981,68,379,Vermont,Saint Johnsbury,0
20163,2006-2007,2006-11-20,2007-04-16,148,1,105,500,605,141,519,660,1265,49,352,Vermont,Saint Johnsbury,0
20164,2007-2008,2007-11-17,2008-04-09,145,5,77,471,548,208,1036,1244,1792,78,478,Vermont,Saint Johnsbury,0
20165,2008-2009,2008-10-30,2009-03-25,147,1,123,537,660,169,702,871,1531,56,430,Vermont,Saint Johnsbury,0
20166,2009-2010,2009-10-13,2010-05-10,210,1,87,381,468,95,339,434,902,46,245,Vermont,Saint Johnsbury,0
20167,2010-2011,2010-11-19,2011-04-23,156,0,128,506,634,171,704,875,1509,71,483,Vermont,Saint Johnsbury,0
20168,2011-2012,2011-10-30,2012-03-30,153,0,57,356,413,96,263,359,772,50,236,Vermont,Saint Johnsbury,0
20169,2012-2013,2012-11-06,2013-05-26,202,0,88,463,551,125,290,415,966,63,355,Vermont,Saint Johnsbury,0
20170,2013-2014,2013-11-10,2014-04-16,158,1,146,624,770,149,559,708,1478,63,451,Vermont,Saint Johnsbury,0
20171,2014-2015,2014-11-14,2015-04-24,162,1,150,645,795,156,719,875,1670,69,472,Vermont,Saint Johnsbury,0
20172,2015-2016,2015-10-18,2016-04-26,192,0,54,389,443,60,150,210,653,35,155,Vermont,Saint Johnsbury,0
20173,2016-2017,2016-11-21,2017-04-08,139,0,87,402,489,174,423,597,1086,67,414,Vermont,Saint Johnsbury,0
20174,2017-2018,2017-11-10,2018-04-30,172,0,123,530,653,145,509,654,1307,61,422,Vermont,Saint Johnsbury,0
20175,2018-2019,2018-10-18,2019-04-10,175,0,110,582,692,174,951,1125,1817,74,476,Vermont,Saint Johnsbury,0
20176,2019-2020,2019-11-08,2020-05-10,185,0,70,457,527,124,517,641,1168,61,293,Vermont,Saint Johnsbury,0
20177,1950-1951,1950-11-25,1951-03-14,110,15,23,194,217,9,17,26,243,3,14,Virginia,Blacksburg,42620
20178,1953-1954,1953-11-06,1954-03-16,131,1,12,204,216,7,3,10,226,4,14,Virginia,Blacksburg,42620
20179,1954-1955,1954-11-02,1955-03-25,144,17,23,225,248,24,3,27,275,10,46,Virginia,Blacksburg,42620
20180,1955-1956,1955-11-11,1956-04-08,150,3,17,223,240,20,26,46,286,10,36,Virginia,Blacksburg,42620
20181,1956-1957,1956-11-25,1957-03-08,104,1,13,135,148,6,3,9,157,6,21,Virginia,Blacksburg,42620
20182,1957-1958,1957-11-23,1958-03-25,123,1,46,232,278,39,55,94,372,14,67,Virginia,Blacksburg,42620
20183,1958-1959,1958-12-01,1959-02-28,90,0,33,216,249,10,21,31,280,3,19,Virginia,Blacksburg,42620
20184,1962-1963,1962-10-26,1963-03-12,138,7,41,317,358,63,104,167,525,17,106,Virginia,Blacksburg,42620
20185,1963-1964,1963-11-30,1964-03-31,123,2,27,261,288,71,177,248,536,19,112,Virginia,Blacksburg,42620
20186,1965-1966,1965-12-01,1966-03-08,98,1,30,215,245,72,229,301,546,11,116,Virginia,Blacksburg,42620
20187,1966-1967,1966-11-30,1967-03-18,109,13,22,226,248,17,120,137,385,7,36,Virginia,Blacksburg,42620
20188,1967-1968,1967-12-01,1968-03-04,95,1,31,268,299,31,164,195,494,12,64,Virginia,Blacksburg,42620
20189,1968-1969,1968-11-10,1969-03-12,123,7,26,284,310,42,72,114,424,7,54,Virginia,Blacksburg,42620
20190,1969-1970,1969-12-01,1970-02-28,90,3,35,259,294,29,46,75,369,7,61,Virginia,Blacksburg,42620
20191,1970-1971,1970-11-04,1971-04-08,156,1,35,336,371,38,31,69,440,10,64,Virginia,Blacksburg,42620
20192,1971-1972,1971-11-23,1972-03-24,123,3,20,232,252,22,38,60,312,9,49,Virginia,Blacksburg,42620
20193,1972-1973,1972-11-22,1973-03-23,122,1,20,238,258,12,14,26,284,4,27,Virginia,Blacksburg,42620
20194,1973-1974,1973-12-01,1974-02-28,90,5,8,160,168,25,42,67,235,6,37,Virginia,Blacksburg,42620
20195,1974-1975,1974-11-15,1975-03-12,118,2,8,230,238,44,76,120,358,10,65,Virginia,Blacksburg,42620
20196,1976-1977,1976-11-09,1977-02-28,112,4,61,349,410,26,82,108,518,8,50,Virginia,Blacksburg,42620
20197,1977-1978,1977-11-27,1978-04-27,152,4,68,343,411,53,199,252,663,11,91,Virginia,Blacksburg,42620
20198,1978-1979,1978-12-01,1979-03-12,102,0,26,245,271,26,50,76,347,7,56,Virginia,Blacksburg,42620
20199,1979-1980,1979-11-30,1980-03-14,106,1,24,241,265,36,80,116,381,9,68,Virginia,Blacksburg,42620
20200,1980-1981,1980-12-01,1981-03-25,115,5,21,255,276,23,17,40,316,4,33,Virginia,Blacksburg,42620
20201,1981-1982,1981-11-24,1982-04-09,137,17,37,273,310,50,60,110,420,16,103,Virginia,Blacksburg,42620
20202,1982-1983,1982-12-01,1983-04-19,140,7,16,231,247,46,94,140,387,9,70,Virginia,Blacksburg,42620
20203,1983-1984,1983-11-14,1984-03-10,118,15,30,213,243,16,19,35,278,7,28,Virginia,Blacksburg,42620
20204,1984-1985,1984-12-01,1985-02-28,90,11,22,169,191,11,27,38,229,7,29,Virginia,Blacksburg,42620
20205,1985-1986,1985-12-01,1986-03-03,93,11,52,257,309,21,31,52,361,7,46,Virginia,Blacksburg,42620
20206,1986-1987,1986-12-01,1987-04-06,127,4,19,217,236,76,153,229,465,13,108,Virginia,Blacksburg,42620
20207,1987-1988,1987-11-11,1988-04-12,154,10,30,251,281,22,46,68,349,9,48,Virginia,Blacksburg,42620
20208,1988-1989,1988-12-01,1989-03-09,99,9,22,161,183,32,38,70,253,9,54,Virginia,Blacksburg,42620
20209,1989-1990,1989-11-23,1990-04-07,136,19,31,214,245,16,72,88,333,5,26,Virginia,Blacksburg,42620
20210,1990-1991,1990-12-01,1991-03-14,104,1,10,157,167,5,3,8,175,4,13,Virginia,Blacksburg,42620
20211,1991-1992,1991-12-01,1992-04-05,127,2,6,152,158,14,9,23,181,4,21,Virginia,Blacksburg,42620
20212,1992-1993,1992-11-15,1993-04-06,143,13,12,196,208,49,62,111,319,10,71,Virginia,Blacksburg,42620
20213,1993-1994,1993-12-01,1994-04-01,122,8,27,201,228,36,58,94,322,13,68,Virginia,Blacksburg,42620
20214,1995-1996,1995-11-13,1996-03-22,131,4,54,305,359,95,165,260,619,24,188,Virginia,Blacksburg,42620
20215,1996-1997,1996-11-12,1997-04-18,158,0,24,239,263,36,89,125,388,14,75,Virginia,Blacksburg,42620
20216,1997-1998,1997-11-13,1998-03-16,124,0,8,188,196,64,70,134,330,17,89,Virginia,Blacksburg,42620
20217,1998-1999,1998-12-01,1999-03-16,106,0,17,183,200,41,42,83,283,18,83,Virginia,Blacksburg,42620
20218,1999-2000,1999-11-03,2000-04-09,159,2,19,226,245,32,66,98,343,15,77,Virginia,Blacksburg,42620
20219,2000-2001,2000-11-22,2001-04-18,148,0,24,296,320,29,18,47,367,15,67,Virginia,Blacksburg,42620
20220,2001-2002,2001-12-01,2002-04-07,128,0,11,210,221,14,5,19,240,9,36,Virginia,Blacksburg,42620
20221,2002-2003,2002-12-01,2003-04-01,122,0,30,229,259,56,90,146,405,22,117,Virginia,Blacksburg,42620
20222,2003-2004,2003-11-29,2004-03-23,116,1,22,230,252,54,125,179,431,20,114,Virginia,Blacksburg,42620
20223,2004-2005,2004-12-01,2005-04-03,124,0,24,213,237,36,41,77,314,19,84,Virginia,Blacksburg,42620
20224,2005-2006,2005-11-24,2006-03-26,123,0,6,184,190,35,28,63,253,18,72,Virginia,Blacksburg,42620
20225,2006-2007,2006-12-01,2007-04-08,129,0,16,202,218,16,11,27,245,13,52,Virginia,Blacksburg,42620
20226,2007-2008,2007-12-01,2008-02-29,91,0,13,147,160,16,28,44,204,9,42,Virginia,Blacksburg,42620
20227,2008-2009,2008-11-18,2009-03-13,116,0,25,245,270,37,24,61,331,23,99,Virginia,Blacksburg,42620
20228,2009-2010,2009-12-01,2010-03-09,99,0,42,231,273,79,345,424,697,27,169,Virginia,Blacksburg,42620
20229,2010-2011,2010-12-01,2011-03-29,119,0,36,232,268,34,80,114,382,21,105,Virginia,Blacksburg,42620
20230,2011-2012,2011-12-01,2012-03-06,97,0,7,145,152,17,13,30,182,8,38,Virginia,Blacksburg,42620
20231,2012-2013,2012-10-30,2013-04-05,158,0,18,253,271,46,44,90,361,23,92,Virginia,Blacksburg,42620
20232,2013-2014,2013-11-25,2014-03-31,127,0,30,287,317,48,56,104,421,17,109,Virginia,Blacksburg,42620
20233,2014-2015,2014-11-15,2015-03-29,135,0,29,265,294,44,80,124,418,18,109,Virginia,Blacksburg,42620
20234,2015-2016,2015-12-01,2016-04-09,131,0,21,178,199,35,77,112,311,10,73,Virginia,Blacksburg,42620
20235,2016-2017,2016-12-01,2017-04-07,128,0,16,149,165,14,20,34,199,9,41,Virginia,Blacksburg,42620
20236,2017-2018,2017-12-01,2018-04-17,138,0,34,233,267,49,40,89,356,20,94,Virginia,Blacksburg,42620
20237,2018-2019,2018-11-28,2019-03-09,102,0,17,162,179,28,43,71,250,8,45,Virginia,Blacksburg,42620
20238,2019-2020,2019-12-01,2020-04-15,137,0,1,132,133,10,2,12,145,7,22,Virginia,Blacksburg,42620
20239,1950-1951,1950-11-26,1951-03-26,121,7,12,152,164,18,17,35,199,6,35,Virginia,Charlottesville,43475
20240,1951-1952,1951-12-01,1952-03-03,94,2,6,90,96,12,16,28,124,6,26,Virginia,Charlottesville,43475
20241,1952-1953,1952-11-30,1953-04-21,143,0,2,75,77,23,22,45,122,9,34,Virginia,Charlottesville,43475
20242,1953-1954,1953-11-06,1954-04-04,150,0,9,117,126,29,29,58,184,8,46,Virginia,Charlottesville,43475
20243,1954-1955,1954-11-03,1955-02-28,118,0,9,127,136,21,19,40,176,8,36,Virginia,Charlottesville,43475
20244,1955-1956,1955-11-19,1956-03-19,122,1,4,119,123,20,15,35,158,8,31,Virginia,Charlottesville,43475
20245,1956-1957,1956-11-25,1957-04-13,140,1,8,97,105,24,26,50,155,12,51,Virginia,Charlottesville,43475
20246,1957-1958,1957-11-23,1958-03-25,123,0,16,147,163,60,72,132,295,13,78,Virginia,Charlottesville,43475
20247,1958-1959,1958-12-01,1959-04-13,134,0,15,154,169,9,10,19,188,4,23,Virginia,Charlottesville,43475
20248,1959-1960,1959-12-01,1960-03-26,117,0,11,137,148,66,162,228,376,14,96,Virginia,Charlottesville,43475
20249,1960-1961,1960-12-01,1961-03-22,112,0,22,158,180,60,233,293,473,13,102,Virginia,Charlottesville,43475
20250,1961-1962,1961-11-20,1962-03-14,115,0,18,144,162,71,121,192,354,20,108,Virginia,Charlottesville,43475
20251,1962-1963,1962-12-01,1963-03-12,102,0,22,186,208,39,111,150,358,14,78,Virginia,Charlottesville,43475
20252,1963-1964,1963-12-01,1964-04-01,123,0,14,134,148,53,137,190,338,13,78,Virginia,Charlottesville,43475
20253,1964-1965,1964-11-30,1965-03-20,111,0,15,136,151,23,49,72,223,9,53,Virginia,Charlottesville,43475
20254,1965-1966,1965-12-01,1966-02-28,90,0,15,119,134,55,148,203,337,9,82,Virginia,Charlottesville,43475
20255,1966-1967,1966-12-01,1967-03-19,109,0,12,138,150,50,128,178,328,12,84,Virginia,Charlottesville,43475
20256,1967-1968,1967-11-30,1968-03-02,94,0,18,147,165,27,78,105,270,12,55,Virginia,Charlottesville,43475
20257,1968-1969,1968-11-10,1969-03-10,121,0,9,149,158,43,43,86,244,9,52,Virginia,Charlottesville,43475
20258,1969-1970,1969-12-01,1970-02-28,90,0,22,142,164,36,131,167,331,7,62,Virginia,Charlottesville,43475
20259,1970-1971,1970-12-01,1971-04-07,128,1,13,144,157,37,72,109,266,8,55,Virginia,Charlottesville,43475
20260,1971-1972,1971-11-25,1972-02-29,97,1,8,95,103,29,42,71,174,6,36,Virginia,Charlottesville,43475
20261,1972-1973,1972-11-22,1973-04-13,143,1,9,110,119,16,15,31,150,7,29,Virginia,Charlottesville,43475
20262,1973-1974,1973-12-01,1974-03-13,103,1,4,80,84,18,32,50,134,9,39,Virginia,Charlottesville,43475
20263,1974-1975,1974-12-01,1975-03-15,105,1,5,89,94,38,44,82,176,12,60,Virginia,Charlottesville,43475
20264,1975-1976,1975-12-01,1976-03-11,102,0,13,123,136,10,12,22,158,6,20,Virginia,Charlottesville,43475
20265,1976-1977,1976-11-12,1977-02-28,109,9,25,207,232,19,101,120,352,9,36,Virginia,Charlottesville,43475
20266,1977-1978,1977-11-27,1978-03-14,108,0,21,211,232,50,272,322,554,23,99,Virginia,Charlottesville,43475
20267,1978-1979,1978-11-27,1979-02-28,94,0,20,158,178,45,111,156,334,14,83,Virginia,Charlottesville,43475
20268,1979-1980,1979-10-10,1980-03-15,158,5,16,136,152,64,104,168,320,15,99,Virginia,Charlottesville,43475
20269,1980-1981,1980-11-27,1981-03-19,113,0,21,156,177,7,2,9,186,6,16,Virginia,Charlottesville,43475
20270,1981-1982,1981-11-24,1982-04-09,137,3,25,169,194,49,119,168,362,13,78,Virginia,Charlottesville,43475
20271,1984-1985,1984-12-01,1985-02-28,90,13,13,116,129,6,12,18,147,1,7,Virginia,Charlottesville,43475
20272,1986-1987,1986-12-01,1987-03-11,101,8,7,118,125,27,64,91,216,6,42,Virginia,Charlottesville,43475
20273,1990-1991,1990-12-01,1991-03-14,104,15,1,81,82,10,2,12,94,5,15,Virginia,Charlottesville,43475
20274,1991-1992,1991-12-01,1992-02-29,91,4,2,95,97,3,0,3,100,2,6,Virginia,Charlottesville,43475
20275,1992-1993,1992-12-01,1993-03-15,105,16,5,129,134,33,3,36,170,9,50,Virginia,Charlottesville,43475
20276,1994-1995,1994-12-01,1995-02-28,90,9,6,77,83,0,38,38,121,0,0,Virginia,Charlottesville,43475
20277,1996-1997,1996-11-22,1997-02-28,99,16,8,110,118,19,35,54,172,5,28,Virginia,Charlottesville,43475
20278,1997-1998,1997-12-01,1998-02-28,90,9,0,53,53,15,25,40,93,5,21,Virginia,Charlottesville,43475
20279,1998-1999,1998-12-01,1999-03-16,106,7,8,106,114,23,23,46,160,8,45,Virginia,Charlottesville,43475
20280,1999-2000,1999-12-01,2000-02-29,91,0,8,98,106,21,78,99,205,6,34,Virginia,Charlottesville,43475
20281,2000-2001,2000-12-01,2001-02-28,90,1,5,113,118,8,12,20,138,3,16,Virginia,Charlottesville,43475
20282,2001-2002,2001-12-01,2002-02-28,90,2,1,59,60,7,7,14,74,5,15,Virginia,Charlottesville,43475
20283,2002-2003,2002-12-01,2003-03-31,121,2,13,155,168,57,117,174,342,18,105,Virginia,Charlottesville,43475
20284,2003-2004,2003-12-01,2004-02-29,91,0,11,132,143,33,76,109,252,12,66,Virginia,Charlottesville,43475
20285,2004-2005,2004-12-01,2005-03-06,96,0,12,115,127,25,39,64,191,10,46,Virginia,Charlottesville,43475
20286,2005-2006,2005-12-01,2006-03-22,112,0,4,89,93,24,35,59,152,7,34,Virginia,Charlottesville,43475
20287,2006-2007,2006-12-01,2007-04-08,129,2,4,117,121,9,17,26,147,5,21,Virginia,Charlottesville,43475
20288,2007-2008,2007-12-01,2008-02-29,91,0,5,84,89,5,3,8,97,2,10,Virginia,Charlottesville,43475
20289,2008-2009,2008-11-18,2009-03-13,116,0,13,149,162,15,20,35,197,8,25,Virginia,Charlottesville,43475
20290,2009-2010,2009-12-01,2010-03-03,93,0,13,120,133,75,297,372,505,13,107,Virginia,Charlottesville,43475
20291,2010-2011,2010-12-01,2011-03-27,117,0,13,122,135,14,23,37,172,9,32,Virginia,Charlottesville,43475
20292,2011-2012,2011-10-29,2012-03-06,130,3,3,66,69,15,10,25,94,5,20,Virginia,Charlottesville,43475
20293,2012-2013,2012-12-01,2013-03-26,116,0,8,95,103,44,43,87,190,12,67,Virginia,Charlottesville,43475
20294,2013-2014,2013-11-25,2014-03-27,123,0,19,195,214,55,82,137,351,16,100,Virginia,Charlottesville,43475
20295,2014-2015,2014-11-27,2015-03-08,102,0,18,159,177,32,82,114,291,7,57,Virginia,Charlottesville,43475
20296,2015-2016,2015-12-01,2016-03-04,95,1,9,92,101,27,59,86,187,6,48,Virginia,Charlottesville,43475
20297,2016-2017,2016-12-01,2017-03-14,104,0,7,83,90,6,11,17,107,4,19,Virginia,Charlottesville,43475
20298,2017-2018,2017-12-01,2018-04-10,131,0,18,143,161,16,9,25,186,11,32,Virginia,Charlottesville,43475
20299,2018-2019,2018-12-01,2019-03-09,99,0,7,89,96,33,45,78,174,7,44,Virginia,Charlottesville,43475
20300,2019-2020,2019-12-01,2020-02-29,91,0,0,53,53,3,3,6,59,1,4,Virginia,Charlottesville,43475
20301,1950-1951,1950-11-25,1951-02-28,96,0,6,123,129,7,4,11,140,4,14,Virginia,Danville,43055
20302,1951-1952,1951-12-01,1952-02-29,91,0,2,69,71,10,2,12,83,3,13,Virginia,Danville,43055
20303,1952-1953,1952-11-30,1953-03-02,93,0,0,59,59,5,0,5,64,2,7,Virginia,Danville,43055
20304,1953-1954,1953-12-01,1954-02-28,90,0,4,84,88,6,7,13,101,3,13,Virginia,Danville,43055
20305,1954-1955,1954-12-01,1955-02-28,90,0,2,110,112,22,17,39,151,4,27,Virginia,Danville,43055
20306,1955-1956,1955-12-01,1956-02-29,91,0,0,91,91,0,0,0,91,0,0,Virginia,Danville,43055
20307,1956-1957,1956-11-24,1957-02-28,97,0,4,74,78,2,1,3,81,1,6,Virginia,Danville,43055
20308,1957-1958,1957-12-01,1958-02-28,90,0,9,118,127,14,17,31,158,1,15,Virginia,Danville,43055
20309,1958-1959,1958-12-01,1959-02-28,90,0,8,123,131,18,27,45,176,4,32,Virginia,Danville,43055
20310,1959-1960,1959-12-01,1960-03-21,112,0,8,111,119,47,85,132,251,9,60,Virginia,Danville,43055
20311,1960-1961,1960-12-01,1961-02-28,90,3,13,122,135,4,3,7,142,2,13,Virginia,Danville,43055
20312,1961-1962,1961-12-01,1962-03-09,99,1,7,103,110,42,25,67,177,8,56,Virginia,Danville,43055
20313,1962-1963,1962-12-01,1963-02-28,90,3,9,148,157,5,7,12,169,4,8,Virginia,Danville,43055
20314,1966-1967,1966-12-01,1967-02-28,90,18,3,128,131,12,8,20,151,2,16,Virginia,Danville,43055
20315,1968-1969,1968-12-01,1969-03-04,94,1,1,127,128,17,13,30,158,3,24,Virginia,Danville,43055
20316,1969-1970,1969-12-01,1970-02-28,90,3,11,151,162,17,23,40,202,4,28,Virginia,Danville,43055
20317,1970-1971,1970-12-01,1971-03-27,117,5,5,118,123,0,7,7,130,0,0,Virginia,Danville,43055
20318,1973-1974,1973-12-01,1974-02-28,90,12,1,70,71,13,6,19,90,1,15,Virginia,Danville,43055
20319,1975-1976,1975-12-01,1976-02-29,91,0,2,126,128,0,0,0,128,0,0,Virginia,Danville,43055
20320,1978-1979,1978-12-01,1979-02-28,90,2,6,141,147,7,44,51,198,1,9,Virginia,Danville,43055
20321,1979-1980,1979-12-01,1980-03-05,96,11,5,123,128,25,47,72,200,5,40,Virginia,Danville,43055
20322,1980-1981,1980-12-01,1981-02-28,90,0,11,169,180,8,7,15,195,4,21,Virginia,Danville,43055
20323,1981-1982,1981-12-01,1982-04-09,130,17,14,139,153,20,16,36,189,4,26,Virginia,Danville,43055
20324,1990-1991,1990-12-01,1991-02-28,90,4,1,72,73,0,0,0,73,0,0,Virginia,Danville,43055
20325,1991-1992,1991-12-01,1992-04-05,127,3,1,99,100,2,0,2,102,1,3,Virginia,Danville,43055
20326,1992-1993,1992-12-01,1993-02-28,90,8,1,84,85,0,0,0,85,0,0,Virginia,Danville,43055
20327,1993-1994,1993-12-01,1994-02-28,90,18,16,134,150,0,0,0,150,0,0,Virginia,Danville,43055
20328,1994-1995,1994-12-01,1995-02-28,90,3,4,91,95,0,0,0,95,0,0,Virginia,Danville,43055
20329,1995-1996,1995-12-01,1996-03-09,100,16,14,145,159,0,25,25,184,0,0,Virginia,Danville,43055
20330,1996-1997,1996-12-01,1997-02-28,90,5,3,87,90,2,1,3,93,1,4,Virginia,Danville,43055
20331,1997-1998,1997-12-01,1998-02-28,90,8,0,66,66,6,4,10,76,1,8,Virginia,Danville,43055
20332,1998-1999,1998-12-01,1999-02-28,90,6,3,84,87,0,0,0,87,0,0,Virginia,Danville,43055
20333,1999-2000,1999-12-01,2000-02-29,91,2,5,102,107,21,45,66,173,7,35,Virginia,Danville,43055
20334,2000-2001,2000-12-01,2001-02-28,90,0,2,143,145,3,2,5,150,1,6,Virginia,Danville,43055
20335,2001-2002,2001-12-01,2002-02-28,90,0,2,90,92,9,13,22,114,1,11,Virginia,Danville,43055
20336,2002-2003,2002-12-01,2003-02-28,90,1,8,120,128,0,0,0,128,0,0,Virginia,Danville,43055
20337,2003-2004,2003-12-01,2004-02-29,91,0,7,129,136,35,0,35,171,7,47,Virginia,Danville,43055
20338,2004-2005,2004-12-01,2005-03-17,107,0,8,119,127,9,4,13,140,8,22,Virginia,Danville,43055
20339,2005-2006,2005-12-01,2006-02-28,90,0,1,90,91,4,3,7,98,3,7,Virginia,Danville,43055
20340,2006-2007,2006-12-01,2007-02-28,90,0,0,102,102,1,0,1,103,1,2,Virginia,Danville,43055
20341,2007-2008,2007-12-01,2008-02-29,91,0,0,78,78,5,4,9,87,2,6,Virginia,Danville,43055
20342,2008-2009,2008-12-01,2009-03-04,94,0,2,113,115,8,10,18,133,4,14,Virginia,Danville,43055
20343,2009-2010,2009-12-01,2010-03-02,92,3,3,119,122,20,27,47,169,8,28,Virginia,Danville,43055
20344,2010-2011,2010-12-01,2011-02-28,90,0,3,131,134,18,12,30,164,9,35,Virginia,Danville,43055
20345,2011-2012,2011-12-01,2012-02-29,91,0,1,78,79,4,3,7,86,1,5,Virginia,Danville,43055
20346,2012-2013,2012-12-01,2013-02-28,90,0,1,73,74,5,1,6,80,4,11,Virginia,Danville,43055
20347,2013-2014,2013-12-01,2014-03-25,115,0,7,152,159,19,27,46,205,10,42,Virginia,Danville,43055
20348,2014-2015,2014-12-01,2015-02-28,90,2,8,114,122,14,12,26,148,3,22,Virginia,Danville,43055
20349,2015-2016,2015-12-01,2016-02-29,91,2,6,84,90,15,24,39,129,5,31,Virginia,Danville,43055
20350,2016-2017,2016-12-01,2017-02-28,90,0,5,78,83,12,20,32,115,2,19,Virginia,Danville,43055
20351,2017-2018,2017-12-01,2018-03-24,114,13,6,130,136,28,27,55,191,6,35,Virginia,Danville,43055
20352,2018-2019,2018-12-01,2019-02-28,90,0,1,78,79,22,25,47,126,1,23,Virginia,Danville,43055
20353,2019-2020,2019-12-01,2020-02-29,91,0,0,61,61,2,0,2,63,1,3,Virginia,Danville,43055
20354,1950-1951,1950-11-26,1951-02-28,95,0,14,139,153,16,14,30,183,8,36,Virginia,Lynchburg,75568
20355,1951-1952,1951-12-01,1952-03-02,93,0,5,87,92,15,5,20,112,9,28,Virginia,Lynchburg,75568
20356,1952-1953,1952-11-29,1953-03-08,100,0,3,71,74,13,14,27,101,6,23,Virginia,Lynchburg,75568
20357,1953-1954,1953-11-06,1954-02-28,115,0,8,106,114,9,11,20,134,4,18,Virginia,Lynchburg,75568
20358,1954-1955,1954-11-02,1955-02-28,119,0,9,135,144,20,23,43,187,11,39,Virginia,Lynchburg,75568
20359,1955-1956,1955-11-19,1956-03-19,122,0,2,128,130,10,1,11,141,9,21,Virginia,Lynchburg,75568
20360,1956-1957,1956-11-24,1957-04-13,141,0,9,89,98,12,7,19,117,7,31,Virginia,Lynchburg,75568
20361,1957-1958,1957-12-01,1958-03-18,108,0,19,146,165,30,38,68,233,7,38,Virginia,Lynchburg,75568
20362,1958-1959,1958-12-01,1959-04-14,135,0,16,153,169,16,19,35,204,5,28,Virginia,Lynchburg,75568
20363,1959-1960,1959-12-01,1960-03-20,111,0,12,142,154,63,114,177,331,13,95,Virginia,Lynchburg,75568
20364,1960-1961,1960-12-01,1961-02-28,90,0,20,150,170,23,57,80,250,8,45,Virginia,Lynchburg,75568
20365,1961-1962,1961-11-19,1962-03-12,114,0,12,133,145,63,60,123,268,16,88,Virginia,Lynchburg,75568
20366,1962-1963,1962-11-25,1963-02-28,96,0,21,186,207,24,22,46,253,11,48,Virginia,Lynchburg,75568
20367,1963-1964,1963-12-01,1964-02-29,91,0,14,144,158,34,53,87,245,10,59,Virginia,Lynchburg,75568
20368,1964-1965,1964-11-30,1965-03-20,111,0,13,159,172,20,36,56,228,8,50,Virginia,Lynchburg,75568
20369,1965-1966,1965-12-01,1966-02-28,90,0,12,134,146,54,147,201,347,11,86,Virginia,Lynchburg,75568
20370,1966-1967,1966-12-01,1967-02-28,90,0,8,126,134,50,88,138,272,12,74,Virginia,Lynchburg,75568
20371,1967-1968,1967-12-01,1968-03-02,93,0,12,167,179,18,24,42,221,11,40,Virginia,Lynchburg,75568
20372,1968-1969,1968-11-09,1969-03-09,121,0,10,180,190,50,32,82,272,12,70,Virginia,Lynchburg,75568
20373,1969-1970,1969-12-01,1970-02-28,90,0,18,182,200,28,49,77,277,10,54,Virginia,Lynchburg,75568
20374,1970-1971,1970-11-04,1971-04-07,155,0,15,162,177,43,40,83,260,15,66,Virginia,Lynchburg,75568
20375,1971-1972,1971-11-24,1972-02-29,98,0,7,104,111,27,33,60,171,7,38,Virginia,Lynchburg,75568
20376,1972-1973,1972-11-22,1973-04-12,142,0,9,135,144,14,10,24,168,5,23,Virginia,Lynchburg,75568
20377,1973-1974,1973-12-01,1974-02-28,90,0,7,85,92,18,29,47,139,5,29,Virginia,Lynchburg,75568
20378,1974-1975,1974-11-30,1975-03-11,102,0,3,105,108,21,19,40,148,7,29,Virginia,Lynchburg,75568
20379,1975-1976,1975-12-01,1976-03-09,100,0,7,124,131,4,1,5,136,3,9,Virginia,Lynchburg,75568
20380,1976-1977,1976-11-30,1977-02-28,91,0,27,232,259,18,80,98,357,7,34,Virginia,Lynchburg,75568
20381,1977-1978,1977-11-27,1978-03-08,102,0,21,201,222,39,93,132,354,20,83,Virginia,Lynchburg,75568
20382,1978-1979,1978-12-01,1979-02-28,90,0,24,172,196,39,78,117,313,16,95,Virginia,Lynchburg,75568
20383,1979-1980,1979-12-01,1980-03-14,105,0,11,147,158,42,62,104,262,11,71,Virginia,Lynchburg,75568
20384,1980-1981,1980-12-01,1981-03-23,113,0,19,174,193,12,5,17,210,8,24,Virginia,Lynchburg,75568
20385,1981-1982,1981-11-24,1982-04-09,137,1,19,187,206,45,57,102,308,15,81,Virginia,Lynchburg,75568
20386,1982-1983,1982-12-01,1983-02-28,90,0,7,93,100,35,59,94,194,8,48,Virginia,Lynchburg,75568
20387,1983-1984,1983-12-01,1984-03-07,98,0,20,134,154,7,5,12,166,5,13,Virginia,Lynchburg,75568
20388,1984-1985,1984-12-01,1985-03-22,112,0,10,125,135,10,5,15,150,4,14,Virginia,Lynchburg,75568
20389,1985-1986,1985-12-01,1986-02-28,90,0,9,126,135,19,15,34,169,7,36,Virginia,Lynchburg,75568
20390,1986-1987,1986-12-01,1987-04-04,125,0,5,134,139,65,118,183,322,12,87,Virginia,Lynchburg,75568
20391,1987-1988,1987-11-11,1988-02-29,111,0,14,140,154,14,33,47,201,4,27,Virginia,Lynchburg,75568
20392,1988-1989,1988-12-01,1989-03-20,110,0,8,107,115,20,15,35,150,10,37,Virginia,Lynchburg,75568
20393,1989-1990,1989-11-22,1990-03-20,119,0,14,131,145,25,71,96,241,8,40,Virginia,Lynchburg,75568
20394,1990-1991,1990-12-01,1991-03-14,104,0,4,81,85,6,4,10,95,4,10,Virginia,Lynchburg,75568
20395,1991-1992,1991-12-01,1992-04-04,126,0,2,105,107,5,0,5,112,4,10,Virginia,Lynchburg,75568
20396,1992-1993,1992-12-01,1993-03-17,107,0,2,106,108,24,38,62,170,6,35,Virginia,Lynchburg,75568
20397,1993-1994,1993-12-01,1994-03-03,93,0,15,131,146,18,26,44,190,11,38,Virginia,Lynchburg,75568
20398,1994-1995,1994-12-01,1995-03-04,94,0,5,83,88,11,12,23,111,6,19,Virginia,Lynchburg,75568
20399,1995-1996,1995-12-01,1996-03-20,111,0,17,158,175,77,141,218,393,13,111,Virginia,Lynchburg,75568
20400,1996-1997,1996-12-01,1997-02-28,90,0,9,114,123,0,0,0,123,0,0,Virginia,Lynchburg,75568
20401,1997-1998,1997-12-01,1998-02-28,90,0,1,87,88,4,0,4,92,2,9,Virginia,Lynchburg,75568
20402,1998-1999,1998-12-01,1999-03-15,105,3,9,116,125,10,0,10,135,7,23,Virginia,Lynchburg,75568
20403,1999-2000,1999-12-01,2000-02-29,91,0,8,135,143,24,0,24,167,10,48,Virginia,Lynchburg,75568
20404,2000-2001,2000-12-01,2001-02-28,90,0,9,166,175,0,0,0,175,0,0,Virginia,Lynchburg,75568
20405,2001-2002,2001-12-01,2002-03-04,94,0,3,116,119,0,0,0,119,0,0,Virginia,Lynchburg,75568
20406,2002-2003,2002-12-01,2003-02-28,90,0,13,145,158,0,0,0,158,0,0,Virginia,Lynchburg,75568
20407,2003-2004,2003-12-01,2004-02-29,91,0,11,146,157,19,6,25,182,6,32,Virginia,Lynchburg,75568
20408,2004-2005,2004-12-01,2005-03-17,107,0,11,144,155,16,22,38,193,10,39,Virginia,Lynchburg,75568
20409,2005-2006,2005-12-01,2006-02-28,90,0,2,110,112,20,11,31,143,8,34,Virginia,Lynchburg,75568
20410,2006-2007,2006-12-01,2007-02-28,90,0,8,131,139,6,4,10,149,3,18,Virginia,Lynchburg,75568
20411,2007-2008,2007-12-01,2008-02-29,91,0,5,108,113,4,2,6,119,2,7,Virginia,Lynchburg,75568
20412,2008-2009,2008-12-01,2009-03-05,95,0,7,159,166,18,8,26,192,7,31,Virginia,Lynchburg,75568
20413,2009-2010,2009-12-01,2010-03-02,92,0,7,157,164,52,185,237,401,13,84,Virginia,Lynchburg,75568
20414,2010-2011,2010-12-01,2011-03-27,117,0,6,169,175,14,18,32,207,8,26,Virginia,Lynchburg,75568
20415,2011-2012,2011-12-01,2012-03-05,96,0,1,95,96,11,8,19,115,2,13,Virginia,Lynchburg,75568
20416,2012-2013,2012-12-01,2013-04-04,125,0,4,125,129,21,11,32,161,10,34,Virginia,Lynchburg,75568
20417,2013-2014,2013-12-01,2014-03-25,115,0,10,186,196,31,33,64,260,9,52,Virginia,Lynchburg,75568
20418,2014-2015,2014-12-01,2015-03-06,96,0,20,169,189,33,56,89,278,7,58,Virginia,Lynchburg,75568
20419,2015-2016,2015-12-01,2016-02-29,91,0,11,115,126,22,28,50,176,5,44,Virginia,Lynchburg,75568
20420,2016-2017,2016-12-01,2017-02-28,90,1,6,86,92,8,17,25,117,2,14,Virginia,Lynchburg,75568
20421,2017-2018,2017-12-01,2018-04-09,130,1,13,168,181,22,12,34,215,9,34,Virginia,Lynchburg,75568
20422,2018-2019,2018-12-01,2019-03-08,98,0,4,105,109,27,33,60,169,7,37,Virginia,Lynchburg,75568
20423,2019-2020,2019-12-01,2020-02-29,91,0,0,71,71,0,0,0,71,0,0,Virginia,Lynchburg,75568
20424,1950-1951,1950-11-28,1951-02-28,93,0,4,65,69,8,4,12,81,5,16,Virginia,Norfolk,242803
20425,1951-1952,1951-12-01,1952-02-29,91,0,2,46,48,0,0,0,48,0,0,Virginia,Norfolk,242803
20426,1952-1953,1952-12-01,1953-03-02,92,0,0,31,31,1,1,2,33,1,2,Virginia,Norfolk,242803
20427,1953-1954,1953-12-01,1954-02-28,90,0,2,45,47,3,1,4,51,2,5,Virginia,Norfolk,242803
20428,1954-1955,1954-12-01,1955-02-28,90,0,7,73,80,23,18,41,121,7,32,Virginia,Norfolk,242803
20429,1955-1956,1955-12-01,1956-02-29,91,0,3,60,63,2,0,2,65,2,4,Virginia,Norfolk,242803
20430,1956-1957,1956-12-01,1957-02-28,90,0,2,39,41,5,1,6,47,2,8,Virginia,Norfolk,242803
20431,1957-1958,1957-12-01,1958-02-28,90,0,9,72,81,8,7,15,96,4,12,Virginia,Norfolk,242803
20432,1958-1959,1958-12-01,1959-02-28,90,0,9,80,89,22,34,56,145,4,29,Virginia,Norfolk,242803
20433,1959-1960,1959-12-01,1960-03-12,103,3,3,56,59,15,3,18,77,6,23,Virginia,Norfolk,242803
20434,1960-1961,1960-12-01,1961-02-28,90,0,12,110,122,9,10,19,141,7,26,Virginia,Norfolk,242803
20435,1961-1962,1961-12-01,1962-03-07,97,0,9,87,96,19,17,36,132,8,33,Virginia,Norfolk,242803
20436,1962-1963,1962-12-01,1963-02-28,90,0,12,107,119,17,11,28,147,6,28,Virginia,Norfolk,242803
20437,1963-1964,1963-12-01,1964-04-01,123,0,9,80,89,12,5,17,106,6,18,Virginia,Norfolk,242803
20438,1964-1965,1964-12-01,1965-02-28,90,0,4,78,82,20,22,42,124,5,35,Virginia,Norfolk,242803
20439,1965-1966,1965-12-01,1966-02-28,90,0,6,83,89,22,60,82,171,6,36,Virginia,Norfolk,242803
20440,1966-1967,1966-12-01,1967-02-28,90,0,2,46,48,15,12,27,75,4,19,Virginia,Norfolk,242803
20441,1967-1968,1967-12-01,1968-03-01,92,0,9,104,113,13,8,21,134,9,26,Virginia,Norfolk,242803
20442,1968-1969,1968-12-01,1969-03-10,100,0,5,59,64,8,7,15,79,4,11,Virginia,Norfolk,242803
20443,1969-1970,1969-12-01,1970-02-28,90,0,14,91,105,10,6,16,121,7,26,Virginia,Norfolk,242803
20444,1970-1971,1970-12-01,1971-03-26,116,0,3,58,61,11,2,13,74,4,19,Virginia,Norfolk,242803
20445,1971-1972,1971-12-01,1972-02-29,91,0,2,33,35,2,0,2,37,1,2,Virginia,Norfolk,242803
20446,1972-1973,1972-12-01,1973-02-28,90,0,8,55,63,19,23,42,105,4,29,Virginia,Norfolk,242803
20447,1973-1974,1973-12-01,1974-03-26,116,0,1,29,30,13,5,18,48,3,16,Virginia,Norfolk,242803
20448,1974-1975,1974-12-01,1975-03-02,92,0,0,34,34,2,0,2,36,2,4,Virginia,Norfolk,242803
20449,1975-1976,1975-12-01,1976-02-29,91,0,6,83,89,0,0,0,89,0,0,Virginia,Norfolk,242803
20450,1976-1977,1976-12-01,1977-02-28,90,0,14,125,139,11,6,17,156,6,20,Virginia,Norfolk,242803
20451,1977-1978,1977-12-01,1978-03-03,93,0,6,89,95,19,20,39,134,9,32,Virginia,Norfolk,242803
20452,1978-1979,1978-12-01,1979-02-28,90,0,8,87,95,21,12,33,128,6,36,Virginia,Norfolk,242803
20453,1979-1980,1979-12-01,1980-03-05,96,0,8,87,95,57,88,145,240,9,79,Virginia,Norfolk,242803
20454,1980-1981,1980-12-01,1981-03-19,109,0,11,117,128,1,0,1,129,1,2,Virginia,Norfolk,242803
20455,1981-1982,1981-12-01,1982-02-28,90,0,7,75,82,9,7,16,98,6,19,Virginia,Norfolk,242803
20456,1982-1983,1982-12-01,1983-02-28,90,0,2,39,41,5,0,5,46,4,9,Virginia,Norfolk,242803
20457,1983-1984,1983-12-01,1984-02-29,91,0,11,73,84,7,7,14,98,1,8,Virginia,Norfolk,242803
20458,1984-1985,1984-12-01,1985-02-28,90,0,6,76,82,7,5,12,94,4,17,Virginia,Norfolk,242803
20459,1985-1986,1985-12-01,1986-02-28,90,0,7,70,77,8,4,12,89,5,15,Virginia,Norfolk,242803
20460,1986-1987,1986-12-01,1987-03-16,106,0,1,53,54,6,4,10,64,5,9,Virginia,Norfolk,242803
20461,1987-1988,1987-11-11,1988-02-29,111,0,5,67,72,7,4,11,83,3,10,Virginia,Norfolk,242803
20462,1988-1989,1988-12-01,1989-04-11,132,0,1,54,55,35,26,61,116,6,39,Virginia,Norfolk,242803
20463,1989-1990,1989-12-01,1990-02-28,90,0,11,61,72,1,0,1,73,1,3,Virginia,Norfolk,242803
20464,1990-1991,1990-12-01,1991-02-28,90,0,0,27,27,0,0,0,27,0,0,Virginia,Norfolk,242803
20465,1991-1992,1991-12-01,1992-02-29,91,0,0,39,39,0,0,0,39,0,0,Virginia,Norfolk,242803
20466,1992-1993,1992-12-01,1993-03-14,104,0,3,41,44,8,1,9,53,6,12,Virginia,Norfolk,242803
20467,1993-1994,1993-12-01,1994-03-03,93,0,13,81,94,18,15,33,127,10,38,Virginia,Norfolk,242803
20468,1994-1995,1994-12-01,1995-02-28,90,0,1,29,30,1,0,1,31,1,3,Virginia,Norfolk,242803
20469,1995-1996,1995-12-01,1996-03-09,100,17,10,86,96,24,40,64,160,7,42,Virginia,Norfolk,242803
20470,2004-2005,2004-12-01,2005-03-08,98,6,4,63,67,13,11,24,91,7,26,Virginia,Norfolk,242803
20471,2005-2006,2005-12-01,2006-02-28,90,0,1,32,33,3,1,4,37,3,6,Virginia,Norfolk,242803
20472,2006-2007,2006-12-01,2007-04-07,128,0,1,57,58,1,0,1,59,1,1,Virginia,Norfolk,242803
20473,2007-2008,2007-12-01,2008-02-29,91,0,1,31,32,1,0,1,33,1,2,Virginia,Norfolk,242803
20474,2008-2009,2008-12-01,2009-03-03,93,0,5,66,71,1,0,1,72,1,3,Virginia,Norfolk,242803
20475,2009-2010,2009-12-01,2010-03-03,93,1,3,65,68,16,18,34,102,8,27,Virginia,Norfolk,242803
20476,2010-2011,2010-12-01,2011-02-28,90,0,2,80,82,32,42,74,156,9,43,Virginia,Norfolk,242803
20477,2011-2012,2011-12-01,2012-02-29,91,0,0,18,18,2,0,2,20,2,4,Virginia,Norfolk,242803
20478,2012-2013,2012-12-01,2013-02-28,90,0,1,28,29,3,2,5,34,2,6,Virginia,Norfolk,242803
20479,2013-2014,2013-12-01,2014-03-04,94,0,9,82,91,20,31,51,142,6,39,Virginia,Norfolk,242803
20480,2014-2015,2014-12-01,2015-03-06,96,4,12,88,100,19,35,54,154,7,33,Virginia,Norfolk,242803
20481,2015-2016,2015-12-01,2016-02-29,91,1,4,38,42,11,1,12,54,8,24,Virginia,Norfolk,242803
20482,2016-2017,2016-12-01,2017-03-19,109,1,3,36,39,8,18,26,65,2,11,Virginia,Norfolk,242803
20483,2017-2018,2017-12-01,2018-03-13,103,0,10,66,76,21,44,65,141,5,30,Virginia,Norfolk,242803
20484,2018-2019,2018-12-01,2019-02-28,90,0,3,30,33,1,0,1,34,1,1,Virginia,Norfolk,242803
20485,2019-2020,2019-12-01,2020-02-29,91,0,0,15,15,2,0,2,17,2,3,Virginia,Norfolk,242803
20486,1950-1951,1950-12-01,1951-02-28,90,0,7,109,116,2,0,2,118,2,4,Virginia,Richmond,204214
20487,1951-1952,1951-12-01,1952-02-29,91,0,3,82,85,19,2,21,106,5,24,Virginia,Richmond,204214
20488,1952-1953,1952-11-30,1953-04-21,143,0,0,76,76,11,6,17,93,4,14,Virginia,Richmond,204214
20489,1953-1954,1953-11-06,1954-02-28,115,0,5,107,112,21,15,36,148,5,31,Virginia,Richmond,204214
20490,1954-1955,1954-12-01,1955-02-28,90,0,5,125,130,17,21,38,168,5,25,Virginia,Richmond,204214
20491,1955-1956,1955-12-01,1956-02-29,91,0,2,113,115,3,0,3,118,2,5,Virginia,Richmond,204214
20492,1956-1957,1956-12-01,1957-04-13,134,0,6,86,92,13,7,20,112,8,27,Virginia,Richmond,204214
20493,1957-1958,1957-12-01,1958-03-20,110,0,9,133,142,30,31,61,203,9,40,Virginia,Richmond,204214
20494,1958-1959,1958-12-01,1959-02-28,90,3,10,146,156,20,23,43,199,4,35,Virginia,Richmond,204214
20495,1959-1960,1959-12-01,1960-03-17,108,0,8,130,138,45,74,119,257,11,69,Virginia,Richmond,204214
20496,1960-1961,1960-12-01,1961-02-28,90,0,13,155,168,18,25,43,211,8,43,Virginia,Richmond,204214
20497,1961-1962,1961-12-01,1962-03-11,101,0,8,137,145,57,55,112,257,14,82,Virginia,Richmond,204214
20498,1962-1963,1962-11-05,1963-02-28,116,0,13,166,179,25,22,47,226,9,41,Virginia,Richmond,204214
20499,1963-1964,1963-12-01,1964-04-01,123,0,5,164,169,34,26,60,229,11,53,Virginia,Richmond,204214
20500,1964-1965,1964-11-30,1965-03-20,111,0,7,136,143,30,34,64,207,8,55,Virginia,Richmond,204214
20501,1965-1966,1965-12-01,1966-02-28,90,0,13,147,160,41,91,132,292,10,75,Virginia,Richmond,204214
20502,1966-1967,1966-11-30,1967-02-28,91,0,7,133,140,48,55,103,243,15,81,Virginia,Richmond,204214
20503,1967-1968,1967-12-01,1968-03-13,104,0,8,173,181,21,15,36,217,10,40,Virginia,Richmond,204214
20504,1968-1969,1968-11-12,1969-03-10,119,0,5,150,155,21,14,35,190,6,25,Virginia,Richmond,204214
20505,1969-1970,1969-12-01,1970-02-28,90,0,18,175,193,11,15,26,219,7,30,Virginia,Richmond,204214
20506,1970-1971,1970-12-01,1971-04-07,128,0,11,143,154,26,13,39,193,12,50,Virginia,Richmond,204214
20507,1971-1972,1971-12-01,1972-02-29,91,0,3,87,90,19,9,28,118,3,20,Virginia,Richmond,204214
20508,1972-1973,1972-11-22,1973-03-22,121,0,7,112,119,11,11,22,141,7,18,Virginia,Richmond,204214
20509,1973-1974,1973-12-01,1974-02-28,90,0,1,74,75,19,28,47,122,6,29,Virginia,Richmond,204214
20510,1974-1975,1974-12-01,1975-03-10,100,0,1,101,102,9,7,16,118,5,16,Virginia,Richmond,204214
20511,1975-1976,1975-12-01,1976-03-10,101,0,5,127,132,3,1,4,136,2,7,Virginia,Richmond,204214
20512,1976-1977,1976-11-12,1977-02-28,109,0,15,231,246,18,20,38,284,9,46,Virginia,Richmond,204214
20513,1977-1978,1977-12-01,1978-03-08,98,0,10,186,196,15,19,34,230,8,34,Virginia,Richmond,204214
20514,1978-1979,1978-12-01,1979-02-28,90,0,18,151,169,30,66,96,265,9,63,Virginia,Richmond,204214
20515,1979-1980,1979-12-01,1980-03-13,104,0,7,121,128,52,59,111,239,11,77,Virginia,Richmond,204214
20516,1980-1981,1980-12-01,1981-03-19,109,0,17,171,188,4,0,4,192,4,10,Virginia,Richmond,204214
20517,1981-1982,1981-12-01,1982-04-09,130,0,15,119,134,32,45,77,211,13,51,Virginia,Richmond,204214
20518,1982-1983,1982-12-01,1983-02-28,90,0,3,72,75,40,53,93,168,6,49,Virginia,Richmond,204214
20519,1983-1984,1983-11-25,1984-03-29,126,0,20,140,160,9,1,10,170,7,19,Virginia,Richmond,204214
20520,1984-1985,1984-12-01,1985-02-28,90,0,6,117,123,13,13,26,149,5,25,Virginia,Richmond,204214
20521,1985-1986,1985-12-01,1986-02-28,90,0,10,117,127,13,12,25,152,8,34,Virginia,Richmond,204214
20522,1986-1987,1986-12-01,1987-03-16,106,0,7,126,133,28,76,104,237,6,46,Virginia,Richmond,204214
20523,1987-1988,1987-11-11,1988-02-29,111,0,9,131,140,17,30,47,187,4,29,Virginia,Richmond,204214
20524,1988-1989,1988-12-01,1989-03-08,98,0,6,102,108,21,16,37,145,5,29,Virginia,Richmond,204214
20525,1989-1990,1989-11-23,1990-04-07,136,0,13,109,122,15,26,41,163,7,25,Virginia,Richmond,204214
20526,1990-1991,1990-12-01,1991-02-28,90,0,1,68,69,2,1,3,72,1,3,Virginia,Richmond,204214
20527,1991-1992,1991-11-08,1992-02-29,114,0,1,88,89,2,0,2,91,2,3,Virginia,Richmond,204214
20528,1992-1993,1992-12-01,1993-03-14,104,0,2,93,95,13,11,24,119,7,23,Virginia,Richmond,204214
20529,1993-1994,1993-12-01,1994-03-03,93,0,16,122,138,18,21,39,177,12,47,Virginia,Richmond,204214
20530,1994-1995,1994-12-01,1995-03-04,94,0,4,82,86,7,5,12,98,5,11,Virginia,Richmond,204214
20531,1996-1997,1996-12-01,1997-02-28,90,0,4,72,76,5,1,6,82,3,9,Virginia,Richmond,204214
20532,2004-2005,2004-12-01,2005-03-08,98,6,6,98,104,13,11,24,128,10,35,Virginia,Richmond,204214
20533,2005-2006,2005-12-01,2006-03-22,112,0,2,89,91,14,13,27,118,8,22,Virginia,Richmond,204214
20534,2006-2007,2006-12-01,2007-04-07,128,0,2,100,102,3,1,4,106,2,6,Virginia,Richmond,204214
20535,2007-2008,2007-12-01,2008-02-29,91,0,0,71,71,1,1,2,73,1,2,Virginia,Richmond,204214
20536,2008-2009,2008-12-01,2009-03-05,95,0,6,110,116,10,19,29,145,3,15,Virginia,Richmond,204214
20537,2009-2010,2009-12-01,2010-03-02,92,0,3,108,111,41,67,108,219,11,60,Virginia,Richmond,204214
20538,2010-2011,2010-12-01,2011-02-28,90,0,5,111,116,16,14,30,146,8,28,Virginia,Richmond,204214
20539,2011-2012,2011-12-01,2012-03-05,96,0,0,58,58,6,7,13,71,3,9,Virginia,Richmond,204214
20540,2012-2013,2012-12-01,2013-03-25,115,0,2,78,80,12,6,18,98,6,20,Virginia,Richmond,204214
20541,2013-2014,2013-12-01,2014-03-17,107,0,9,134,143,19,16,35,178,7,39,Virginia,Richmond,204214
20542,2014-2015,2014-12-01,2015-03-06,96,0,13,124,137,21,29,50,187,6,37,Virginia,Richmond,204214
20543,2015-2016,2015-12-01,2016-03-04,95,0,8,88,96,22,28,50,146,7,37,Virginia,Richmond,204214
20544,2016-2017,2016-12-01,2017-02-28,90,0,6,65,71,11,17,28,99,2,17,Virginia,Richmond,204214
20545,2017-2018,2017-12-01,2018-03-22,112,0,11,121,132,18,19,37,169,8,34,Virginia,Richmond,204214
20546,2018-2019,2018-12-01,2019-02-28,90,0,2,71,73,18,19,37,110,4,22,Virginia,Richmond,204214
20547,2019-2020,2019-11-12,2020-02-29,110,0,0,63,63,3,0,3,66,3,6,Virginia,Richmond,204214
20548,1950-1951,1950-11-24,1951-03-14,111,0,16,142,158,22,20,42,200,8,44,Virginia,Roanoke,97032
20549,1951-1952,1951-11-19,1952-03-02,105,0,5,108,113,12,8,20,133,6,22,Virginia,Roanoke,97032
20550,1952-1953,1952-11-29,1953-03-04,96,0,2,68,70,14,12,26,96,6,22,Virginia,Roanoke,97032
20551,1953-1954,1953-11-06,1954-02-28,115,2,6,111,117,15,9,24,141,4,23,Virginia,Roanoke,97032
20552,1954-1955,1954-11-02,1955-03-19,138,0,10,140,150,27,16,43,193,12,44,Virginia,Roanoke,97032
20553,1955-1956,1955-11-10,1956-04-07,150,2,5,140,145,14,1,15,160,8,24,Virginia,Roanoke,97032
20554,1956-1957,1956-11-24,1957-04-13,141,0,9,91,100,9,2,11,111,7,22,Virginia,Roanoke,97032
20555,1957-1958,1957-10-27,1958-03-25,150,0,18,161,179,40,21,61,240,11,49,Virginia,Roanoke,97032
20556,1958-1959,1958-12-01,1959-04-13,134,0,15,155,170,10,14,24,194,4,20,Virginia,Roanoke,97032
20557,1959-1960,1959-11-29,1960-03-21,114,0,17,145,162,91,125,216,378,16,128,Virginia,Roanoke,97032
20558,1960-1961,1960-12-01,1961-03-18,108,0,17,150,167,52,73,125,292,15,92,Virginia,Roanoke,97032
20559,1961-1962,1961-11-19,1962-03-10,112,0,9,125,134,41,19,60,194,16,68,Virginia,Roanoke,97032
20560,1962-1963,1962-11-25,1963-03-21,117,0,21,206,227,41,28,69,296,14,67,Virginia,Roanoke,97032
20561,1963-1964,1963-12-01,1964-03-30,121,0,13,145,158,66,68,134,292,14,95,Virginia,Roanoke,97032
20562,1964-1965,1964-11-30,1965-03-21,112,0,13,160,173,31,41,72,245,9,56,Virginia,Roanoke,97032
20563,1965-1966,1965-12-01,1966-02-28,90,0,18,128,146,74,125,199,345,12,112,Virginia,Roanoke,97032
20564,1966-1967,1966-12-01,1967-03-20,110,0,9,137,146,57,76,133,279,14,88,Virginia,Roanoke,97032
20565,1967-1968,1967-12-01,1968-03-01,92,0,10,137,147,45,78,123,270,9,65,Virginia,Roanoke,97032
20566,1968-1969,1968-11-09,1969-03-09,121,0,12,165,177,54,24,78,255,14,69,Virginia,Roanoke,97032
20567,1969-1970,1969-12-01,1970-04-06,127,0,19,193,212,39,39,78,290,12,67,Virginia,Roanoke,97032
20568,1970-1971,1970-11-04,1971-04-07,155,0,17,177,194,46,37,83,277,11,64,Virginia,Roanoke,97032
20569,1971-1972,1971-11-24,1972-02-29,98,0,7,114,121,32,16,48,169,9,47,Virginia,Roanoke,97032
20570,1972-1973,1972-12-01,1973-04-12,133,0,8,118,126,13,6,19,145,4,20,Virginia,Roanoke,97032
20571,1973-1974,1973-12-01,1974-02-28,90,0,6,73,79,24,24,48,127,7,34,Virginia,Roanoke,97032
20572,1974-1975,1974-11-30,1975-03-11,102,0,3,102,105,37,28,65,170,9,45,Virginia,Roanoke,97032
20573,1975-1976,1975-12-01,1976-03-17,108,0,5,123,128,5,1,6,134,3,8,Virginia,Roanoke,97032
20574,1976-1977,1976-11-12,1977-02-28,109,0,28,252,280,29,40,69,349,13,60,Virginia,Roanoke,97032
20575,1977-1978,1977-11-27,1978-03-08,102,0,26,210,236,51,127,178,414,21,100,Virginia,Roanoke,97032
20576,1978-1979,1978-11-26,1979-02-28,95,0,18,171,189,37,57,94,283,16,87,Virginia,Roanoke,97032
20577,1979-1980,1979-12-01,1980-03-14,105,0,14,137,151,42,48,90,241,11,68,Virginia,Roanoke,97032
20578,1980-1981,1980-12-01,1981-03-23,113,0,16,183,199,19,6,25,224,8,33,Virginia,Roanoke,97032
20579,1981-1982,1981-11-24,1982-04-09,137,1,26,199,225,47,45,92,317,19,93,Virginia,Roanoke,97032
20580,1982-1983,1982-12-01,1983-04-18,139,0,7,111,118,48,66,114,232,11,63,Virginia,Roanoke,97032
20581,1983-1984,1983-12-01,1984-04-10,132,0,17,158,175,18,6,24,199,11,34,Virginia,Roanoke,97032
20582,1984-1985,1984-12-01,1985-03-22,112,0,15,137,152,10,3,13,165,6,21,Virginia,Roanoke,97032
20583,1985-1986,1985-12-01,1986-02-28,90,0,11,138,149,16,8,24,173,7,33,Virginia,Roanoke,97032
20584,1986-1987,1986-12-01,1987-04-04,125,0,5,132,137,76,112,188,325,14,99,Virginia,Roanoke,97032
20585,1987-1988,1987-11-11,1988-02-29,111,0,15,141,156,12,28,40,196,5,28,Virginia,Roanoke,97032
20586,1988-1989,1988-12-01,1989-04-08,129,0,7,111,118,23,11,34,152,11,37,Virginia,Roanoke,97032
20587,1989-1990,1989-11-22,1990-03-20,119,0,17,136,153,25,79,104,257,10,41,Virginia,Roanoke,97032
20588,1990-1991,1990-12-01,1991-03-14,104,0,4,84,88,2,1,3,91,2,5,Virginia,Roanoke,97032
20589,1991-1992,1991-12-01,1992-04-05,127,0,1,106,107,7,4,11,118,4,13,Virginia,Roanoke,97032
20590,1992-1993,1992-12-01,1993-04-05,126,0,4,119,123,40,55,95,218,12,57,Virginia,Roanoke,97032
20591,1993-1994,1993-12-01,1994-03-03,93,0,16,146,162,24,47,71,233,14,51,Virginia,Roanoke,97032
20592,1994-1995,1994-12-01,1995-03-04,94,0,6,96,102,17,22,39,141,8,29,Virginia,Roanoke,97032
20593,1995-1996,1995-11-13,1996-03-20,129,0,19,176,195,75,130,205,400,12,108,Virginia,Roanoke,97032
20594,1996-1997,1996-12-01,1997-02-28,90,1,9,97,106,6,6,12,118,2,9,Virginia,Roanoke,97032
20595,1997-1998,1997-12-01,1998-02-28,90,0,3,51,54,16,22,38,92,3,18,Virginia,Roanoke,97032
20596,1998-1999,1998-12-01,1999-03-15,105,1,7,95,102,10,14,24,126,4,15,Virginia,Roanoke,97032
20597,1999-2000,1999-12-01,2000-02-29,91,0,7,93,100,18,40,58,158,6,29,Virginia,Roanoke,97032
20598,2000-2001,2000-12-01,2001-03-06,96,0,7,131,138,14,20,34,172,6,28,Virginia,Roanoke,97032
20599,2001-2002,2001-12-01,2002-02-28,90,0,1,71,72,6,5,11,83,3,9,Virginia,Roanoke,97032
20600,2002-2003,2002-12-01,2003-03-31,121,1,13,124,137,38,53,91,228,13,69,Virginia,Roanoke,97032
20601,2003-2004,2003-12-01,2004-02-29,91,0,8,111,119,31,64,95,214,9,47,Virginia,Roanoke,97032
20602,2004-2005,2004-12-01,2005-03-17,107,0,9,102,111,24,24,48,159,10,36,Virginia,Roanoke,97032
20603,2005-2006,2005-11-23,2006-02-28,98,0,1,70,71,17,14,31,102,8,26,Virginia,Roanoke,97032
20604,2006-2007,2006-12-01,2007-02-28,90,0,4,92,96,5,4,9,105,2,11,Virginia,Roanoke,97032
20605,2007-2008,2007-12-01,2008-02-29,91,0,2,75,77,8,2,10,87,3,10,Virginia,Roanoke,97032
20606,2008-2009,2008-11-18,2009-03-03,106,0,8,118,126,8,3,11,137,5,13,Virginia,Roanoke,97032
20607,2009-2010,2009-12-01,2010-03-02,92,0,11,106,117,62,180,242,359,12,78,Virginia,Roanoke,97032
20608,2010-2011,2010-12-01,2011-03-27,117,0,12,114,126,17,16,33,159,11,33,Virginia,Roanoke,97032
20609,2011-2012,2011-12-01,2012-03-05,96,0,1,59,60,9,4,13,73,3,13,Virginia,Roanoke,97032
20610,2012-2013,2012-12-01,2013-04-04,125,0,4,78,82,28,15,43,125,12,40,Virginia,Roanoke,97032
20611,2013-2014,2013-12-01,2014-03-25,115,0,16,162,178,39,45,84,262,9,63,Virginia,Roanoke,97032
20612,2014-2015,2014-11-18,2015-03-06,109,0,19,152,171,31,67,98,269,9,61,Virginia,Roanoke,97032
20613,2015-2016,2015-12-01,2016-03-03,94,0,9,100,109,33,49,82,191,7,56,Virginia,Roanoke,97032
20614,2016-2017,2016-12-01,2017-03-14,104,0,6,73,79,8,12,20,99,3,18,Virginia,Roanoke,97032
20615,2017-2018,2017-12-01,2018-03-25,115,0,14,132,146,22,7,29,175,10,35,Virginia,Roanoke,97032
20616,2018-2019,2018-12-01,2019-03-08,98,0,2,78,80,31,27,58,138,7,39,Virginia,Roanoke,97032
20617,2019-2020,2019-12-01,2020-02-29,91,0,0,53,53,2,0,2,55,1,3,Virginia,Roanoke,97032
20618,1962-1963,1962-12-01,1963-03-11,101,0,27,226,253,28,119,147,400,10,54,Virginia,Sterling,0
20619,1963-1964,1963-12-01,1964-04-01,123,0,17,225,242,62,121,183,425,16,100,Virginia,Sterling,0
20620,1964-1965,1964-11-30,1965-03-20,111,0,18,200,218,24,38,62,280,8,48,Virginia,Sterling,0
20621,1965-1966,1965-12-01,1966-02-28,90,0,26,179,205,45,86,131,336,12,95,Virginia,Sterling,0
20622,1966-1967,1966-11-29,1967-03-21,113,0,16,213,229,64,118,182,411,16,118,Virginia,Sterling,0
20623,1967-1968,1967-11-30,1968-03-14,106,0,23,239,262,41,61,102,364,11,71,Virginia,Sterling,0
20624,1968-1969,1968-11-10,1969-03-11,122,0,16,224,240,35,21,56,296,11,47,Virginia,Sterling,0
20625,1969-1970,1969-12-01,1970-03-18,108,0,34,262,296,44,97,141,437,13,86,Virginia,Sterling,0
20626,1970-1971,1970-12-01,1971-04-07,128,0,15,202,217,30,97,127,344,10,44,Virginia,Sterling,0
20627,1971-1972,1971-11-24,1972-04-07,136,0,8,191,199,28,30,58,257,7,41,Virginia,Sterling,0
20628,1972-1973,1972-10-19,1973-04-12,176,0,10,205,215,6,0,6,221,5,13,Virginia,Sterling,0
20629,1973-1974,1973-12-01,1974-03-11,101,0,9,138,147,29,47,76,223,8,48,Virginia,Sterling,0
20630,1974-1975,1974-12-01,1975-03-10,100,0,7,169,176,27,27,54,230,9,49,Virginia,Sterling,0
20631,1975-1976,1975-12-01,1976-03-11,102,0,16,194,210,16,11,27,237,7,30,Virginia,Sterling,0
20632,1976-1977,1976-11-12,1977-02-28,109,0,35,308,343,18,59,77,420,12,58,Virginia,Sterling,0
20633,1977-1978,1977-11-27,1978-03-16,110,0,32,259,291,42,76,118,409,21,100,Virginia,Sterling,0
20634,1978-1979,1978-11-26,1979-03-11,106,0,36,223,259,57,119,176,435,15,113,Virginia,Sterling,0
20635,1979-1980,1979-10-10,1980-03-15,158,0,16,199,215,38,51,89,304,13,76,Virginia,Sterling,0
20636,1980-1981,1980-12-01,1981-03-18,108,0,24,225,249,7,6,13,262,5,17,Virginia,Sterling,0
20637,1981-1982,1981-11-24,1982-04-09,137,0,23,230,253,43,109,152,405,20,93,Virginia,Sterling,0
20638,1982-1983,1982-12-01,1983-02-28,90,0,6,129,135,50,97,147,282,6,64,Virginia,Sterling,0
20639,1983-1984,1983-11-25,1984-03-29,126,0,34,256,290,30,72,102,392,10,55,Virginia,Sterling,0
20640,1984-1985,1984-12-01,1985-04-09,130,0,16,198,214,23,33,56,270,11,54,Virginia,Sterling,0
20641,1985-1986,1985-12-01,1986-03-08,98,0,20,204,224,26,44,70,294,14,70,Virginia,Sterling,0
20642,1986-1987,1986-12-01,1987-04-06,127,0,11,215,226,58,120,178,404,12,94,Virginia,Sterling,0
20643,1987-1988,1987-11-11,1988-03-20,131,0,17,215,232,24,43,67,299,9,48,Virginia,Sterling,0
20644,1988-1989,1988-12-01,1989-03-20,110,0,14,163,177,17,5,22,199,13,45,Virginia,Sterling,0
20645,1989-1990,1989-11-22,1990-04-07,137,0,23,222,245,41,90,131,376,15,69,Virginia,Sterling,0
20646,1990-1991,1990-12-01,1991-03-30,120,0,6,145,151,22,18,40,191,8,36,Virginia,Sterling,0
20647,1991-1992,1991-12-01,1992-03-22,113,0,4,165,169,10,7,17,186,4,18,Virginia,Sterling,0
20648,1992-1993,1992-12-01,1993-03-20,110,0,11,167,178,41,38,79,257,12,61,Virginia,Sterling,0
20649,1993-1994,1993-12-01,1994-03-18,108,0,34,216,250,30,45,75,325,17,80,Virginia,Sterling,0
20650,1994-1995,1994-12-01,1995-03-10,100,0,10,143,153,21,35,56,209,8,33,Virginia,Sterling,0
20651,1995-1996,1995-11-23,1996-04-09,139,0,29,233,262,83,146,229,491,19,135,Virginia,Sterling,0
20652,1996-1997,1996-11-14,1997-03-19,126,0,14,155,169,25,21,46,215,10,43,Virginia,Sterling,0
20653,1997-1998,1997-12-01,1998-03-11,101,1,1,89,90,10,6,16,106,7,15,Virginia,Sterling,0
20654,1998-1999,1998-12-01,1999-03-16,106,1,14,146,160,29,29,58,218,9,50,Virginia,Sterling,0
20655,1999-2000,1999-12-01,2000-04-09,131,0,17,156,173,35,58,93,266,8,56,Virginia,Sterling,0
20656,2000-2001,2000-12-01,2001-03-05,95,0,15,183,198,18,12,30,228,7,35,Virginia,Sterling,0
20657,2001-2002,2001-12-01,2002-02-28,90,0,1,112,113,3,1,4,117,1,4,Virginia,Sterling,0
20658,2002-2003,2002-12-01,2003-03-30,120,0,23,210,233,69,132,201,434,18,115,Virginia,Sterling,0
20659,2003-2004,2003-12-01,2004-02-29,91,0,23,172,195,26,57,83,278,9,55,Virginia,Sterling,0
20660,2004-2005,2004-12-01,2005-03-10,100,0,18,142,160,26,24,50,210,10,57,Virginia,Sterling,0
20661,2005-2006,2005-11-23,2006-02-28,98,0,3,120,123,18,18,36,159,7,27,Virginia,Sterling,0
20662,2006-2007,2006-12-01,2007-04-07,128,0,13,165,178,21,15,36,214,10,47,Virginia,Sterling,0
20663,2007-2008,2007-12-01,2008-02-29,91,0,6,112,118,9,12,21,139,2,13,Virginia,Sterling,0
20664,2008-2009,2008-12-01,2009-03-04,94,0,12,160,172,11,9,20,192,3,18,Virginia,Sterling,0
20665,2009-2010,2009-12-01,2010-02-28,90,0,15,145,160,99,204,303,463,13,135,Virginia,Sterling,0
20666,2010-2011,2010-12-01,2011-03-27,117,0,14,168,182,23,37,60,242,12,50,Virginia,Sterling,0
20667,2011-2012,2011-10-29,2012-02-29,124,0,4,105,109,7,3,10,119,6,14,Virginia,Sterling,0
20668,2012-2013,2012-12-01,2013-03-25,115,0,8,114,122,20,7,27,149,12,43,Virginia,Sterling,0
20669,2013-2014,2013-11-24,2014-03-27,124,0,33,246,279,74,91,165,444,20,125,Virginia,Sterling,0
20670,2014-2015,2014-11-26,2015-03-20,115,0,27,223,250,54,82,136,386,17,115,Virginia,Sterling,0
20671,2015-2016,2015-12-01,2016-03-04,95,0,14,129,143,47,95,142,285,11,79,Virginia,Sterling,0
20672,2016-2017,2016-12-01,2017-03-17,107,0,8,118,126,13,9,22,148,7,31,Virginia,Sterling,0
20673,2017-2018,2017-12-01,2018-03-23,113,0,24,174,198,20,10,30,228,9,41,Virginia,Sterling,0
20674,2018-2019,2018-11-15,2019-03-09,115,0,10,144,154,36,44,80,234,12,63,Virginia,Sterling,0
20675,2019-2020,2019-12-01,2020-02-29,91,0,0,89,89,6,2,8,97,4,11,Virginia,Sterling,0
20676,1950-1951,1950-12-01,1951-03-13,103,0,11,85,96,56,58,114,210,11,84,Washington,Bellingham,80885
20677,1951-1952,1951-12-01,1952-02-29,91,0,16,93,109,24,20,44,153,12,63,Washington,Bellingham,80885
20678,1952-1953,1952-12-01,1953-02-28,90,0,0,38,38,3,2,5,43,1,5,Washington,Bellingham,80885
20679,1953-1954,1953-12-01,1954-02-28,90,0,15,71,86,22,40,62,148,7,45,Washington,Bellingham,80885
20680,1954-1955,1954-12-01,1955-03-06,96,0,2,69,71,2,1,3,74,1,6,Washington,Bellingham,80885
20681,1955-1956,1955-11-14,1956-03-12,120,2,14,125,139,30,19,49,188,11,53,Washington,Bellingham,80885
20682,1956-1957,1956-12-01,1957-02-28,90,0,23,119,142,29,25,54,196,10,51,Washington,Bellingham,80885
20683,1957-1958,1957-12-01,1958-02-28,90,0,0,28,28,0,0,0,28,0,0,Washington,Bellingham,80885
20684,1958-1959,1958-12-01,1959-02-28,90,0,10,48,58,14,15,29,87,5,24,Washington,Bellingham,80885
20685,1959-1960,1959-11-15,1960-03-05,112,0,3,72,75,10,7,17,92,3,15,Washington,Bellingham,80885
20686,1960-1961,1960-12-01,1961-02-28,90,0,0,44,44,0,0,0,44,0,0,Washington,Bellingham,80885
20687,1961-1962,1961-12-01,1962-03-05,95,0,7,68,75,21,18,39,114,7,29,Washington,Bellingham,80885
20688,1962-1963,1962-12-01,1963-02-28,90,0,8,69,77,3,2,5,82,1,5,Washington,Bellingham,80885
20689,1963-1964,1963-11-19,1964-03-23,126,0,0,48,48,2,0,2,50,2,3,Washington,Bellingham,80885
20690,1964-1965,1964-11-27,1965-02-28,94,0,13,89,102,57,68,125,227,21,96,Washington,Bellingham,80885
20691,1965-1966,1965-12-01,1966-03-01,91,0,4,74,78,36,20,56,134,13,54,Washington,Bellingham,80885
20692,1966-1967,1966-12-01,1967-03-12,102,0,0,43,43,20,2,22,65,8,27,Washington,Bellingham,80885
20693,1967-1968,1967-12-01,1968-04-12,134,0,5,60,65,10,4,14,79,6,15,Washington,Bellingham,80885
20694,1968-1969,1968-12-01,1969-02-28,90,0,39,110,149,53,104,157,306,17,105,Washington,Bellingham,80885
20695,1969-1970,1969-12-01,1970-02-28,90,0,1,47,48,11,12,23,71,4,16,Washington,Bellingham,80885
20696,1970-1971,1970-11-20,1971-03-04,105,0,12,91,103,67,56,123,226,20,111,Washington,Bellingham,80885
20697,1971-1972,1971-10-30,1972-04-11,165,0,19,107,126,36,27,63,189,14,55,Washington,Bellingham,80885
20698,1972-1973,1972-12-01,1973-02-28,90,0,18,83,101,7,13,20,121,2,13,Washington,Bellingham,80885
20699,1973-1974,1973-11-04,1974-03-08,125,0,2,42,44,18,4,22,66,9,26,Washington,Bellingham,80885
20700,1974-1975,1974-12-01,1975-02-28,90,0,1,50,51,18,7,25,76,9,32,Washington,Bellingham,80885
20701,1975-1976,1975-11-29,1976-04-15,139,0,3,66,69,19,3,22,91,6,28,Washington,Bellingham,80885
20702,1976-1977,1976-12-01,1977-03-14,104,0,0,44,44,6,6,12,56,2,7,Washington,Bellingham,80885
20703,1977-1978,1977-11-22,1978-02-28,99,0,6,51,57,16,12,28,85,7,25,Washington,Bellingham,80885
20704,1978-1979,1978-11-19,1979-02-28,102,0,17,112,129,11,12,23,152,5,19,Washington,Bellingham,80885
20705,1979-1980,1979-12-01,1980-03-14,105,0,9,67,76,14,12,26,102,6,31,Washington,Bellingham,80885
20706,1980-1981,1980-12-01,1981-04-12,133,0,9,59,68,25,32,57,125,6,42,Washington,Bellingham,80885
20707,1981-1982,1981-12-01,1982-03-31,121,0,9,68,77,49,46,95,172,14,79,Washington,Bellingham,80885
20708,1982-1983,1982-12-01,1983-02-28,90,0,0,37,37,0,0,0,37,0,0,Washington,Bellingham,80885
20709,1983-1984,1983-12-01,1984-02-29,91,0,17,78,95,2,0,2,97,1,3,Washington,Bellingham,80885
20710,1984-1985,1984-10-31,1985-02-28,121,0,14,106,120,33,50,83,203,9,52,Washington,Bellingham,80885
20711,1985-1986,1985-11-19,1986-02-28,102,0,23,99,122,32,58,90,212,10,64,Washington,Bellingham,80885
20712,1986-1987,1986-12-01,1987-02-28,90,0,0,41,41,4,0,4,45,2,5,Washington,Bellingham,80885
20713,1987-1988,1987-12-01,1988-02-29,91,0,0,63,63,1,0,1,64,1,4,Washington,Bellingham,80885
20714,1988-1989,1988-11-24,1989-03-03,100,2,10,77,87,18,8,26,113,9,32,Washington,Bellingham,80885
20715,1989-1990,1989-12-01,1990-03-23,113,0,3,48,51,6,4,10,61,5,11,Washington,Bellingham,80885
20716,1990-1991,1990-12-01,1991-03-11,101,0,23,89,112,44,34,78,190,14,80,Washington,Bellingham,80885
20717,1991-1992,1991-10-28,1992-02-29,125,0,0,31,31,3,2,5,36,1,4,Washington,Bellingham,80885
20718,1992-1993,1992-12-01,1993-02-28,90,0,16,99,115,25,22,47,162,9,40,Washington,Bellingham,80885
20719,1993-1994,1993-11-22,1994-02-28,99,0,4,58,62,2,0,2,64,2,3,Washington,Bellingham,80885
20720,1994-1995,1994-12-01,1995-03-06,96,0,2,49,51,4,2,6,57,2,6,Washington,Bellingham,80885
20721,1995-1996,1995-12-01,1996-02-29,91,0,8,71,79,16,30,46,125,7,30,Washington,Bellingham,80885
20722,2013-2014,2013-12-01,2014-02-28,90,8,6,65,71,0,0,0,71,0,0,Washington,Bellingham,80885
20723,2014-2015,2014-11-29,2015-02-28,92,3,1,38,39,0,0,0,39,0,0,Washington,Bellingham,80885
20724,2015-2016,2015-12-01,2016-02-29,91,2,0,30,30,0,0,0,30,0,0,Washington,Bellingham,80885
20725,2019-2020,2019-12-01,2020-02-29,91,17,5,34,39,0,0,0,39,0,0,Washington,Bellingham,80885
20726,1950-1951,1950-12-01,1951-03-20,110,13,18,127,145,47,356,403,548,12,73,Washington,Diablo Dam,0
20727,1951-1952,1951-12-01,1952-02-29,91,13,31,145,176,139,543,682,858,29,206,Washington,Diablo Dam,0
20728,1954-1955,1954-12-01,1955-03-28,118,9,8,117,125,94,179,273,398,21,124,Washington,Diablo Dam,0
20729,1958-1959,1958-11-26,1959-03-13,108,20,21,82,103,37,109,146,249,7,50,Washington,Diablo Dam,0
20730,1959-1960,1959-11-13,1960-04-21,161,3,12,128,140,75,135,210,350,14,97,Washington,Diablo Dam,0
20731,1961-1962,1961-11-19,1962-03-25,127,11,20,125,145,76,182,258,403,18,100,Washington,Diablo Dam,0
20732,1969-1970,1969-12-01,1970-02-28,90,3,3,51,54,58,97,155,209,8,66,Washington,Diablo Dam,0
20733,1971-1972,1971-12-01,1972-03-08,99,7,31,148,179,101,641,742,921,22,142,Washington,Diablo Dam,0
20734,1973-1974,1973-11-07,1974-03-08,122,0,14,86,100,61,61,122,222,14,75,Washington,Diablo Dam,0
20735,1974-1975,1974-12-01,1975-03-17,107,12,8,102,110,90,408,498,608,21,129,Washington,Diablo Dam,0
20736,1976-1977,1976-12-01,1977-03-14,104,0,4,75,79,18,33,51,130,4,22,Washington,Diablo Dam,0
20737,1977-1978,1977-11-19,1978-02-28,102,16,17,96,113,95,330,425,538,12,115,Washington,Diablo Dam,0
20738,1978-1979,1978-11-16,1979-02-28,105,6,36,172,208,68,161,229,437,19,96,Washington,Diablo Dam,0
20739,1979-1980,1979-12-01,1980-03-17,108,3,19,104,123,51,238,289,412,14,76,Washington,Diablo Dam,0
20740,1980-1981,1980-12-01,1981-02-28,90,1,10,59,69,34,49,83,152,6,52,Washington,Diablo Dam,0
20741,1981-1982,1981-12-01,1982-02-28,90,0,14,86,100,135,219,354,454,24,178,Washington,Diablo Dam,0
20742,1982-1983,1982-11-16,1983-03-01,106,1,3,61,64,18,19,37,101,8,26,Washington,Diablo Dam,0
20743,1983-1984,1983-12-01,1984-02-29,91,2,24,112,136,30,62,92,228,8,44,Washington,Diablo Dam,0
20744,1985-1986,1985-11-12,1986-03-04,113,7,36,127,163,52,258,310,473,16,84,Washington,Diablo Dam,0
20745,1986-1987,1986-12-01,1987-03-03,93,4,3,59,62,16,14,30,92,6,23,Washington,Diablo Dam,0
20746,1987-1988,1987-12-01,1988-03-27,118,7,12,94,106,39,174,213,319,9,49,Washington,Diablo Dam,0
20747,1988-1989,1988-11-24,1989-03-07,104,6,27,136,163,58,85,143,306,13,91,Washington,Diablo Dam,0
20748,1989-1990,1989-12-01,1990-03-09,99,1,7,85,92,90,201,291,383,12,111,Washington,Diablo Dam,0
20749,1990-1991,1990-12-01,1991-03-11,101,3,35,125,160,120,191,311,471,18,169,Washington,Diablo Dam,0
20750,1991-1992,1991-12-01,1992-02-29,91,6,1,35,36,0,0,0,36,0,0,Washington,Diablo Dam,0
20751,1992-1993,1992-12-01,1993-02-28,90,6,43,159,202,61,238,299,501,8,88,Washington,Diablo Dam,0
20752,1993-1994,1993-11-23,1994-03-19,117,1,9,68,77,40,44,84,161,7,51,Washington,Diablo Dam,0
20753,1994-1995,1994-11-04,1995-03-07,124,1,15,105,120,96,137,233,353,17,118,Washington,Diablo Dam,0
20754,1995-1996,1995-12-01,1996-03-29,120,10,23,120,143,81,163,244,387,16,112,Washington,Diablo Dam,0
20755,1996-1997,1996-11-04,1997-02-28,117,6,34,124,158,147,531,678,836,22,215,Washington,Diablo Dam,0
20756,1997-1998,1997-12-01,1998-02-28,90,6,12,66,78,37,74,111,189,5,50,Washington,Diablo Dam,0
20757,1998-1999,1998-12-01,1999-02-28,90,9,10,70,80,40,89,129,209,10,53,Washington,Diablo Dam,0
20758,1999-2000,1999-12-01,2000-02-29,91,4,1,64,65,61,163,224,289,17,80,Washington,Diablo Dam,0
20759,2000-2001,2000-11-27,2001-03-28,122,19,5,86,91,46,45,91,182,10,62,Washington,Diablo Dam,0
20760,2001-2002,2001-11-30,2002-03-25,116,8,7,107,114,117,164,281,395,26,154,Washington,Diablo Dam,0
20761,2002-2003,2002-12-01,2003-03-10,100,1,1,63,64,25,26,51,115,4,29,Washington,Diablo Dam,0
20762,2003-2004,2003-11-23,2004-02-29,99,0,18,89,107,66,173,239,346,10,88,Washington,Diablo Dam,0
20763,2004-2005,2004-12-01,2005-03-30,120,0,12,83,95,23,26,49,144,9,40,Washington,Diablo Dam,0
20764,2005-2006,2005-11-29,2006-03-11,103,0,1,69,70,27,32,59,129,10,38,Washington,Diablo Dam,0
20765,2006-2007,2006-11-24,2007-03-01,98,1,15,96,111,61,117,178,289,19,87,Washington,Diablo Dam,0
20766,2007-2008,2007-11-27,2008-03-31,126,4,7,108,115,262,577,839,954,45,313,Washington,Diablo Dam,0
20767,2008-2009,2008-12-01,2009-04-03,124,3,30,162,192,200,520,720,912,36,275,Washington,Diablo Dam,0
20768,2009-2010,2009-11-15,2010-03-12,118,1,13,81,94,23,29,52,146,8,35,Washington,Diablo Dam,0
20769,2010-2011,2010-11-21,2011-04-15,146,10,24,135,159,88,168,256,415,24,129,Washington,Diablo Dam,0
20770,2011-2012,2011-11-18,2012-03-21,125,14,13,109,122,68,134,202,324,20,112,Washington,Diablo Dam,0
20771,2012-2013,2012-12-01,2013-03-21,111,0,4,84,88,43,162,205,293,14,57,Washington,Diablo Dam,0
20772,2013-2014,2013-12-01,2014-03-10,100,1,22,95,117,74,105,179,296,13,96,Washington,Diablo Dam,0
20773,2014-2015,2014-11-29,2015-02-28,92,4,9,54,63,9,22,31,94,3,14,Washington,Diablo Dam,0
20774,2015-2016,2015-11-17,2016-02-29,105,0,5,60,65,23,143,166,231,12,37,Washington,Diablo Dam,0
20775,2016-2017,2016-12-01,2017-03-12,102,0,42,164,206,160,728,888,1094,29,214,Washington,Diablo Dam,0
20776,2017-2018,2017-12-01,2018-04-02,123,0,12,99,111,61,168,229,340,18,86,Washington,Diablo Dam,0
20777,2018-2019,2018-12-01,2019-03-12,102,1,15,126,141,43,151,194,335,15,70,Washington,Diablo Dam,0
20778,2019-2020,2019-11-30,2020-03-31,123,2,13,91,104,87,203,290,394,18,129,Washington,Diablo Dam,0
20779,1950-1951,1950-11-11,1951-03-26,136,0,31,276,307,116,666,782,1089,35,177,Washington,Northport,295
20780,1951-1952,1951-12-01,1952-03-23,114,1,66,300,366,90,823,913,1279,26,180,Washington,Northport,295
20781,1952-1953,1952-11-26,1953-02-28,95,0,9,132,141,53,102,155,296,22,79,Washington,Northport,295
20782,1953-1954,1953-11-19,1954-03-02,104,1,37,152,189,100,429,529,718,21,171,Washington,Northport,295
20783,1954-1955,1954-11-29,1955-04-12,135,8,30,249,279,60,443,503,782,29,104,Washington,Northport,295
20784,1955-1956,1955-11-02,1956-03-27,147,2,79,322,401,122,976,1098,1499,48,254,Washington,Northport,295
20785,1964-1965,1964-11-25,1965-03-29,125,0,51,263,314,130,623,753,1067,36,222,Washington,Northport,295
20786,1965-1966,1965-11-24,1966-03-19,116,0,30,182,212,104,398,502,714,35,177,Washington,Northport,295
20787,1966-1967,1966-11-09,1967-03-12,124,3,8,147,155,75,220,295,450,26,111,Washington,Northport,295
20788,1967-1968,1967-11-28,1968-03-14,108,0,42,194,236,77,309,386,622,18,120,Washington,Northport,295
20789,1968-1969,1968-11-08,1969-03-18,131,1,84,322,406,167,856,1023,1429,43,300,Washington,Northport,295
20790,1969-1970,1969-11-19,1970-04-26,159,0,29,207,236,73,265,338,574,24,112,Washington,Northport,295
20791,1970-1971,1970-11-22,1971-03-26,125,0,52,253,305,133,595,728,1033,36,218,Washington,Northport,295
20792,1971-1972,1971-10-31,1972-03-07,129,0,67,277,344,120,678,798,1142,33,210,Washington,Northport,295
20793,1972-1973,1972-10-28,1973-02-28,124,0,68,236,304,52,212,264,568,18,98,Washington,Northport,295
20794,1973-1974,1973-11-04,1974-03-15,132,1,45,195,240,121,210,331,571,35,183,Washington,Northport,295
20795,1974-1975,1974-11-10,1975-04-06,148,0,34,255,289,150,722,872,1161,40,220,Washington,Northport,295
20796,1975-1976,1975-11-21,1976-03-26,127,2,34,216,250,107,474,581,831,31,162,Washington,Northport,295
20797,1976-1977,1976-11-15,1977-03-13,119,13,43,204,247,50,264,314,561,15,71,Washington,Northport,295
20798,1977-1978,1977-11-01,1978-03-13,133,1,54,245,299,118,780,898,1197,29,195,Washington,Northport,295
20799,1978-1979,1978-11-16,1979-03-11,116,0,116,355,471,96,711,807,1278,35,184,Washington,Northport,295
20800,1979-1980,1979-11-16,1980-03-07,113,5,43,211,254,65,357,422,676,18,103,Washington,Northport,295
20801,1980-1981,1980-11-25,1981-02-28,96,6,13,122,135,32,396,428,563,5,39,Washington,Northport,295
20802,1982-1983,1982-11-23,1983-02-28,98,0,15,202,217,68,548,616,833,16,115,Washington,Northport,295
20803,1983-1984,1983-12-01,1984-03-09,100,19,49,279,328,44,515,559,887,12,77,Washington,Northport,295
20804,1984-1985,1984-11-01,1985-03-30,150,14,104,321,425,107,828,935,1360,25,172,Washington,Northport,295
20805,1985-1986,1985-11-01,1986-03-11,131,2,87,303,390,79,645,724,1114,26,157,Washington,Northport,295
20806,1986-1987,1986-11-09,1987-02-28,112,3,35,172,207,40,57,97,304,15,55,Washington,Northport,295
20807,1987-1988,1987-11-30,1988-03-05,97,1,57,212,269,47,437,484,753,18,94,Washington,Northport,295
20808,1988-1989,1988-11-23,1989-03-14,112,8,56,254,310,71,470,541,851,26,139,Washington,Northport,295
20809,1989-1990,1989-11-23,1990-03-07,105,0,24,160,184,48,243,291,475,20,95,Washington,Northport,295
20810,1990-1991,1990-11-03,1991-03-12,130,2,98,273,371,82,418,500,871,22,178,Washington,Northport,295
20811,1991-1992,1991-11-04,1992-02-29,118,4,14,98,112,41,88,129,241,16,61,Washington,Northport,295
20812,1992-1993,1992-11-24,1993-03-14,111,2,79,296,375,69,626,695,1070,23,143,Washington,Northport,295
20813,1993-1994,1993-11-23,1994-03-01,99,5,37,156,193,55,293,348,541,18,89,Washington,Northport,295
20814,1994-1995,1994-11-04,1995-03-08,125,3,41,216,257,57,133,190,447,21,102,Washington,Northport,295
20815,1995-1996,1995-11-06,1996-03-04,120,5,60,262,322,75,398,473,795,26,151,Washington,Northport,295
20816,1996-1997,1996-11-16,1997-03-24,129,5,55,269,324,140,985,1125,1449,47,250,Washington,Northport,295
20817,1997-1998,1997-12-01,1998-02-28,90,3,22,123,145,41,223,264,409,14,72,Washington,Northport,295
20818,1998-1999,1998-12-01,1999-02-28,90,5,23,142,165,49,305,354,519,18,89,Washington,Northport,295
20819,1999-2000,1999-11-28,2000-02-29,94,0,19,146,165,61,353,414,579,22,106,Washington,Northport,295
20820,2000-2001,2000-11-15,2001-03-31,137,0,42,272,314,62,437,499,813,24,129,Washington,Northport,295
20821,2001-2002,2001-11-28,2002-03-19,112,7,29,206,235,77,444,521,756,28,130,Washington,Northport,295
20822,2002-2003,2002-12-01,2003-03-26,116,2,11,140,151,68,272,340,491,16,91,Washington,Northport,295
20823,2003-2004,2003-11-22,2004-03-05,105,2,45,191,236,96,473,569,805,28,177,Washington,Northport,295
20824,2004-2005,2004-11-01,2005-03-26,146,2,32,238,270,58,286,344,614,20,106,Washington,Northport,295
20825,2005-2006,2005-11-15,2006-03-08,114,8,37,200,237,31,99,130,367,10,47,Washington,Northport,295
20826,2006-2007,2006-11-03,2007-04-02,151,5,52,263,315,77,452,529,844,27,132,Washington,Northport,295
20827,2008-2009,2008-11-29,2009-04-02,125,8,32,170,202,94,628,722,924,32,181,Washington,Northport,295
20828,2011-2012,2011-11-08,2012-03-22,136,8,50,261,311,70,280,350,661,33,148,Washington,Northport,295
20829,2012-2013,2012-11-12,2013-03-07,116,2,41,161,202,53,321,374,576,27,114,Washington,Northport,295
20830,2013-2014,2013-11-22,2014-03-07,106,4,70,278,348,46,299,345,693,23,115,Washington,Northport,295
20831,2014-2015,2014-11-17,2015-02-28,104,0,38,158,196,38,179,217,413,14,72,Washington,Northport,295
20832,2015-2016,2015-11-17,2016-02-29,105,6,24,143,167,33,170,203,370,17,75,Washington,Northport,295
20833,2016-2017,2016-12-01,2017-03-14,104,0,82,326,408,67,526,593,1001,18,148,Washington,Northport,295
20834,2017-2018,2017-11-03,2018-03-05,123,0,51,231,282,66,325,391,673,25,130,Washington,Northport,295
20835,2019-2020,2019-12-01,2020-04-04,126,0,38,224,262,81,332,413,675,32,186,Washington,Northport,295
20836,1950-1951,1950-11-30,1951-03-13,104,0,2,62,64,36,34,70,134,15,51,Washington,Olympia,46478
20837,1951-1952,1951-12-01,1952-02-29,91,0,2,70,72,32,29,61,133,12,48,Washington,Olympia,46478
20838,1952-1953,1952-12-01,1953-03-17,107,0,1,47,48,3,1,4,52,2,5,Washington,Olympia,46478
20839,1953-1954,1953-12-01,1954-04-09,130,0,1,84,85,35,47,82,167,15,60,Washington,Olympia,46478
20840,1954-1955,1954-12-01,1955-04-23,144,0,0,89,89,26,9,35,124,13,39,Washington,Olympia,46478
20841,1955-1956,1955-11-11,1956-03-09,120,0,9,119,128,64,33,97,225,28,115,Washington,Olympia,46478
20842,1956-1957,1956-12-01,1957-02-28,90,0,5,84,89,29,55,84,173,15,55,Washington,Olympia,46478
20843,1957-1958,1957-12-01,1958-03-08,98,0,0,20,20,2,0,2,22,2,2,Washington,Olympia,46478
20844,1958-1959,1958-11-14,1959-03-13,120,0,3,62,65,33,21,54,119,12,52,Washington,Olympia,46478
20845,1959-1960,1959-12-01,1960-03-09,100,0,0,84,84,25,17,42,126,10,33,Washington,Olympia,46478
20846,1960-1961,1960-11-20,1961-03-05,106,0,0,59,59,16,9,25,84,5,17,Washington,Olympia,46478
20847,1961-1962,1961-12-01,1962-03-05,95,0,3,93,96,23,22,45,141,10,35,Washington,Olympia,46478
20848,1962-1963,1962-12-01,1963-02-28,90,0,5,73,78,3,3,6,84,1,5,Washington,Olympia,46478
20849,1963-1964,1963-11-19,1964-03-12,115,0,0,60,60,7,0,7,67,5,10,Washington,Olympia,46478
20850,1964-1965,1964-11-26,1965-03-25,120,0,5,93,98,47,24,71,169,25,72,Washington,Olympia,46478
20851,1965-1966,1965-12-01,1966-04-12,133,0,1,60,61,60,26,86,147,20,72,Washington,Olympia,46478
20852,1966-1967,1966-12-01,1967-03-09,99,0,0,41,41,10,2,12,53,6,14,Washington,Olympia,46478
20853,1967-1968,1967-12-01,1968-02-29,91,0,2,72,74,34,22,56,130,14,47,Washington,Olympia,46478
20854,1968-1969,1968-12-01,1969-02-28,90,0,18,110,128,109,171,280,408,33,188,Washington,Olympia,46478
20855,1969-1970,1969-12-01,1970-04-07,128,0,1,83,84,5,2,7,91,2,7,Washington,Olympia,46478
20856,1970-1971,1970-11-22,1971-04-11,141,0,4,98,102,51,26,77,179,19,71,Washington,Olympia,46478
20857,1971-1972,1971-12-01,1972-04-12,134,0,8,121,129,77,99,176,305,27,103,Washington,Olympia,46478
20858,1972-1973,1972-12-01,1973-02-28,90,0,13,108,121,14,16,30,151,10,42,Washington,Olympia,46478
20859,1973-1974,1973-11-03,1974-02-28,118,0,1,77,78,14,2,16,94,9,21,Washington,Olympia,46478
20860,1974-1975,1974-12-01,1975-03-19,109,0,0,69,69,31,33,64,133,11,44,Washington,Olympia,46478
20861,1975-1976,1975-11-17,1976-02-29,105,0,1,78,79,22,7,29,108,10,35,Washington,Olympia,46478
20862,1976-1977,1976-12-01,1977-03-27,117,0,2,77,79,5,2,7,86,4,8,Washington,Olympia,46478
20863,1977-1978,1977-11-18,1978-02-28,103,0,1,72,73,10,4,14,87,7,21,Washington,Olympia,46478
20864,1978-1979,1978-11-18,1979-02-28,103,0,8,151,159,30,45,75,234,11,54,Washington,Olympia,46478
20865,1979-1980,1979-12-01,1980-03-15,106,0,4,103,107,48,41,89,196,12,67,Washington,Olympia,46478
20866,1980-1981,1980-12-01,1981-04-11,132,0,0,55,55,7,2,9,64,5,13,Washington,Olympia,46478
20867,1981-1982,1981-12-01,1982-03-31,121,0,2,86,88,33,14,47,135,15,53,Washington,Olympia,46478
20868,1982-1983,1982-12-01,1983-02-28,90,0,0,40,40,0,0,0,40,0,0,Washington,Olympia,46478
20869,1983-1984,1983-12-01,1984-02-29,91,0,6,85,91,8,5,13,104,6,24,Washington,Olympia,46478
20870,1984-1985,1984-12-01,1985-02-28,90,0,2,92,94,26,9,35,129,12,42,Washington,Olympia,46478
20871,1985-1986,1985-11-17,1986-02-28,104,0,9,111,120,35,66,101,221,9,57,Washington,Olympia,46478
20872,1986-1987,1986-12-01,1987-02-28,90,0,0,46,46,0,0,0,46,0,0,Washington,Olympia,46478
20873,1987-1988,1987-12-01,1988-04-30,152,0,0,92,92,5,0,5,97,4,9,Washington,Olympia,46478
20874,1988-1989,1988-12-01,1989-03-05,95,0,8,107,115,40,57,97,212,11,62,Washington,Olympia,46478
20875,1989-1990,1989-12-01,1990-03-08,98,0,0,51,51,43,35,78,129,13,58,Washington,Olympia,46478
20876,1990-1991,1990-12-01,1991-02-28,90,0,12,106,118,9,7,16,134,5,22,Washington,Olympia,46478
20877,1991-1992,1991-12-01,1992-02-29,91,0,0,36,36,0,0,0,36,0,0,Washington,Olympia,46478
20878,1992-1993,1992-12-01,1993-02-28,90,0,0,109,109,21,16,37,146,9,28,Washington,Olympia,46478
20879,1993-1994,1993-11-22,1994-02-28,99,0,0,59,59,5,0,5,64,5,8,Washington,Olympia,46478
20880,1994-1995,1994-11-17,1995-02-28,104,5,0,86,86,14,12,26,112,7,27,Washington,Olympia,46478
20881,1995-1996,1995-12-01,1996-02-29,91,8,2,69,71,4,0,4,75,1,5,Washington,Olympia,46478
20882,2004-2005,2004-12-01,2005-02-28,90,6,0,65,65,0,0,0,65,0,0,Washington,Olympia,46478
20883,2009-2010,2009-12-01,2010-02-28,90,0,3,75,78,0,0,0,78,0,0,Washington,Olympia,46478
20884,2010-2011,2010-11-23,2011-02-28,98,7,4,84,88,0,0,0,88,0,0,Washington,Olympia,46478
20885,2011-2012,2011-11-18,2012-03-13,117,0,2,87,89,25,25,50,139,7,38,Washington,Olympia,46478
20886,2012-2013,2012-12-01,2013-02-28,90,0,0,50,50,1,0,1,51,1,2,Washington,Olympia,46478
20887,2013-2014,2013-12-01,2014-02-28,90,0,7,73,80,6,4,10,90,2,8,Washington,Olympia,46478
20888,2014-2015,2014-12-01,2015-02-28,90,0,0,44,44,0,0,0,44,0,0,Washington,Olympia,46478
20889,2015-2016,2015-12-01,2016-02-29,91,0,1,37,38,0,0,0,38,0,0,Washington,Olympia,46478
20890,2016-2017,2016-12-01,2017-02-28,90,2,1,84,85,0,0,0,85,0,0,Washington,Olympia,46478
20891,2017-2018,2017-12-01,2018-02-28,90,11,2,58,60,0,0,0,60,0,0,Washington,Olympia,46478
20892,2018-2019,2018-12-01,2019-02-28,90,0,2,80,82,0,0,0,82,0,0,Washington,Olympia,46478
20893,2019-2020,2019-12-01,2020-02-29,91,2,0,37,37,0,0,0,37,0,0,Washington,Olympia,46478
20894,1950-1951,1950-11-30,1951-03-11,102,1,3,55,58,41,21,62,120,20,62,Washington,Seattle,608660
20895,1951-1952,1951-12-01,1952-02-29,91,0,3,55,58,16,16,32,90,9,29,Washington,Seattle,608660
20896,1952-1953,1952-12-01,1953-02-28,90,0,0,18,18,0,0,0,18,0,0,Washington,Seattle,608660
20897,1953-1954,1953-12-01,1954-03-11,101,0,4,43,47,32,50,82,129,13,53,Washington,Seattle,608660
20898,1954-1955,1954-12-01,1955-03-25,115,0,1,55,56,20,6,26,82,9,26,Washington,Seattle,608660
20899,1955-1956,1955-11-11,1956-03-10,121,0,13,89,102,35,17,52,154,13,57,Washington,Seattle,608660
20900,1956-1957,1956-12-01,1957-02-28,90,0,6,69,75,26,49,75,150,13,43,Washington,Seattle,608660
20901,1957-1958,1957-12-01,1958-02-28,90,0,0,5,5,0,0,0,5,0,0,Washington,Seattle,608660
20902,1958-1959,1958-11-24,1959-02-28,97,0,2,26,28,15,9,24,52,5,23,Washington,Seattle,608660
20903,1959-1960,1959-12-01,1960-03-04,95,0,0,35,35,11,4,15,50,5,17,Washington,Seattle,608660
20904,1960-1961,1960-11-20,1961-03-04,105,0,0,29,29,10,5,15,44,3,14,Washington,Seattle,608660
20905,1961-1962,1961-12-01,1962-03-09,99,0,3,48,51,18,12,30,81,8,24,Washington,Seattle,608660
20906,1962-1963,1962-12-01,1963-02-28,90,0,6,47,53,7,1,8,61,5,14,Washington,Seattle,608660
20907,1963-1964,1963-11-19,1964-02-29,103,0,0,33,33,3,0,3,36,2,5,Washington,Seattle,608660
20908,1964-1965,1964-11-13,1965-02-28,108,0,5,38,43,29,14,43,86,17,45,Washington,Seattle,608660
20909,1965-1966,1965-12-01,1966-03-20,110,0,0,27,27,33,17,50,77,12,38,Washington,Seattle,608660
20910,1966-1967,1966-12-01,1967-02-28,90,0,0,9,9,10,5,15,24,2,12,Washington,Seattle,608660
20911,1967-1968,1967-12-01,1968-04-16,138,0,0,22,22,19,5,24,46,11,26,Washington,Seattle,608660
20912,1968-1969,1968-12-01,1969-02-28,90,0,19,60,79,91,122,213,292,23,140,Washington,Seattle,608660
20913,1969-1970,1969-12-01,1970-02-28,90,0,0,5,5,0,0,0,5,0,0,Washington,Seattle,608660
20914,1970-1971,1970-12-01,1971-03-16,106,0,1,34,35,24,20,44,79,13,33,Washington,Seattle,608660
20915,1971-1972,1971-10-27,1972-04-17,174,1,6,52,58,47,55,102,160,22,59,Washington,Seattle,608660
20916,1972-1973,1972-12-01,1973-03-18,108,0,12,48,60,14,19,33,93,8,28,Washington,Seattle,608660
20917,1973-1974,1973-11-03,1974-02-28,118,0,1,26,27,7,0,7,34,4,8,Washington,Seattle,608660
20918,1974-1975,1974-12-01,1975-04-02,123,0,1,37,38,19,15,34,72,7,26,Washington,Seattle,608660
20919,1975-1976,1975-11-06,1976-03-01,117,0,0,30,30,10,2,12,42,8,16,Washington,Seattle,608660
20920,1976-1977,1976-12-01,1977-03-14,104,0,0,19,19,4,1,5,24,3,4,Washington,Seattle,608660
20921,1977-1978,1977-11-17,1978-02-28,104,0,0,17,17,5,1,6,23,3,7,Washington,Seattle,608660
20922,1978-1979,1978-11-18,1979-02-28,103,0,6,50,56,11,12,23,79,7,14,Washington,Seattle,608660
20923,1979-1980,1979-12-01,1980-03-14,105,0,5,46,51,20,24,44,95,9,31,Washington,Seattle,608660
20924,1980-1981,1980-12-01,1981-02-28,90,0,0,19,19,3,0,3,22,2,6,Washington,Seattle,608660
20925,1981-1982,1981-12-01,1982-03-29,119,0,2,29,31,13,8,21,52,5,20,Washington,Seattle,608660
20926,1982-1983,1982-12-01,1983-02-28,90,0,0,12,12,0,0,0,12,0,0,Washington,Seattle,608660
20927,1983-1984,1983-12-01,1984-02-29,91,0,7,37,44,1,0,1,45,1,3,Washington,Seattle,608660
20928,1984-1985,1984-12-01,1985-02-28,90,0,3,49,52,10,2,12,64,4,14,Washington,Seattle,608660
20929,1985-1986,1985-11-20,1986-02-28,101,0,10,60,70,27,45,72,142,6,39,Washington,Seattle,608660
20930,1986-1987,1986-12-01,1987-02-28,90,0,0,20,20,2,0,2,22,1,2,Washington,Seattle,608660
20931,1987-1988,1987-12-01,1988-02-29,91,0,0,27,27,0,0,0,27,0,0,Washington,Seattle,608660
20932,1988-1989,1988-12-01,1989-03-05,95,0,7,57,64,20,37,57,121,4,28,Washington,Seattle,608660
20933,1989-1990,1989-12-01,1990-02-28,90,0,1,23,24,13,12,25,49,2,17,Washington,Seattle,608660
20934,1990-1991,1990-12-01,1991-03-05,95,0,11,49,60,11,15,26,86,8,22,Washington,Seattle,608660
20935,1991-1992,1991-12-01,1992-02-29,91,0,0,10,10,0,0,0,10,0,0,Washington,Seattle,608660
20936,1992-1993,1992-12-01,1993-02-28,90,0,1,52,53,17,5,22,75,12,28,Washington,Seattle,608660
20937,1993-1994,1993-12-01,1994-03-21,111,0,0,29,29,4,1,5,34,4,7,Washington,Seattle,608660
20938,1994-1995,1994-12-01,1995-02-28,90,0,0,19,19,5,1,6,25,4,10,Washington,Seattle,608660
20939,1995-1996,1995-12-01,1996-02-29,91,0,2,37,39,18,7,25,64,11,29,Washington,Seattle,608660
20940,2004-2005,2004-12-01,2005-02-28,90,4,0,28,28,0,0,0,28,0,0,Washington,Seattle,608660
20941,2008-2009,2008-12-01,2009-03-15,105,0,6,53,59,36,45,81,140,19,59,Washington,Seattle,608660
20942,2009-2010,2009-12-01,2010-02-28,90,0,3,24,27,0,0,0,27,0,0,Washington,Seattle,608660
20943,2010-2011,2010-11-22,2011-02-28,99,0,4,36,40,10,6,16,56,4,15,Washington,Seattle,608660
20944,2011-2012,2011-12-01,2012-03-13,104,0,2,29,31,15,13,28,59,5,21,Washington,Seattle,608660
20945,2012-2013,2012-12-01,2013-02-28,90,0,0,20,20,1,1,2,22,1,1,Washington,Seattle,608660
20946,2013-2014,2013-12-01,2014-02-28,90,0,3,29,32,5,3,8,40,2,6,Washington,Seattle,608660
20947,2014-2015,2014-11-29,2015-02-28,92,0,0,12,12,1,0,1,13,1,3,Washington,Seattle,608660
20948,2015-2016,2015-12-01,2016-02-29,91,0,0,7,7,0,0,0,7,0,0,Washington,Seattle,608660
20949,2016-2017,2016-12-01,2017-02-28,90,0,0,37,37,17,18,35,72,6,21,Washington,Seattle,608660
20950,2017-2018,2017-11-05,2018-02-28,116,0,0,21,21,7,6,13,34,4,10,Washington,Seattle,608660
20951,2018-2019,2018-12-01,2019-03-07,97,0,1,25,26,29,32,61,87,7,37,Washington,Seattle,608660
20952,2019-2020,2019-12-01,2020-02-29,91,0,0,10,10,2,0,2,12,2,4,Washington,Seattle,608660
20953,1950-1951,1950-11-01,1951-03-22,142,0,37,213,250,107,165,272,522,54,213,Washington,Spokane,208916
20954,1951-1952,1951-10-22,1952-03-19,150,0,83,305,388,120,582,702,1090,58,308,Washington,Spokane,208916
20955,1952-1953,1952-11-23,1953-03-20,118,0,26,126,152,65,131,196,348,34,109,Washington,Spokane,208916
20956,1953-1954,1953-11-20,1954-03-28,129,0,35,179,214,83,210,293,507,26,156,Washington,Spokane,208916
20957,1954-1955,1954-11-28,1955-04-14,138,0,46,265,311,67,202,269,580,39,162,Washington,Spokane,208916
20958,1955-1956,1955-11-02,1956-03-31,151,0,104,341,445,117,311,428,873,53,300,Washington,Spokane,208916
20959,1956-1957,1956-10-27,1957-04-24,180,0,116,328,444,80,253,333,777,48,284,Washington,Spokane,208916
20960,1957-1958,1957-10-22,1958-03-18,148,0,12,132,144,42,16,58,202,23,70,Washington,Spokane,208916
20961,1958-1959,1958-11-13,1959-03-30,138,0,44,193,237,97,173,270,507,40,197,Washington,Spokane,208916
20962,1959-1960,1959-11-03,1960-04-15,165,0,83,319,402,61,142,203,605,37,175,Washington,Spokane,208916
20963,1960-1961,1960-11-10,1961-04-19,161,0,38,184,222,52,49,101,323,26,92,Washington,Spokane,208916
20964,1961-1962,1961-11-02,1962-03-24,143,0,92,320,412,98,163,261,673,41,228,Washington,Spokane,208916
20965,1962-1963,1962-11-15,1963-04-17,154,0,62,223,285,34,17,51,336,20,93,Washington,Spokane,208916
20966,1963-1964,1963-11-20,1964-04-23,156,0,35,246,281,95,260,355,636,43,171,Washington,Spokane,208916
20967,1964-1965,1964-11-12,1965-04-06,146,0,70,289,359,121,346,467,826,43,260,Washington,Spokane,208916
20968,1965-1966,1965-11-23,1966-03-23,121,0,36,183,219,70,116,186,405,37,143,Washington,Spokane,208916
20969,1966-1967,1966-11-09,1967-05-11,184,0,8,161,169,48,27,75,244,25,77,Washington,Spokane,208916
20970,1967-1968,1967-11-26,1968-02-29,96,0,51,159,210,48,62,110,320,26,127,Washington,Spokane,208916
20971,1968-1969,1968-11-15,1969-04-29,166,1,110,368,478,112,707,819,1297,47,311,Washington,Spokane,208916
20972,1969-1970,1969-11-25,1970-05-12,169,0,49,208,257,62,108,170,427,33,132,Washington,Spokane,208916
20973,1970-1971,1970-11-21,1971-03-27,127,0,45,216,261,55,122,177,438,37,144,Washington,Spokane,208916
20974,1971-1972,1971-10-30,1972-04-17,171,0,78,313,391,101,322,423,814,52,263,Washington,Spokane,208916
20975,1972-1973,1972-10-28,1973-03-13,137,0,70,233,303,27,36,63,366,16,85,Washington,Spokane,208916
20976,1973-1974,1973-10-31,1974-05-14,196,0,65,219,284,89,158,247,531,42,170,Washington,Spokane,208916
20977,1974-1975,1974-11-22,1975-04-06,136,0,51,286,337,131,404,535,872,53,265,Washington,Spokane,208916
20978,1975-1976,1975-10-25,1976-04-01,160,0,42,240,282,77,50,127,409,40,146,Washington,Spokane,208916
20979,1976-1977,1976-11-21,1977-03-19,119,0,62,218,280,30,36,66,346,22,94,Washington,Spokane,208916
20980,1977-1978,1977-11-09,1978-03-13,125,0,62,219,281,101,283,384,665,37,197,Washington,Spokane,208916
20981,1978-1979,1978-11-09,1979-03-30,142,0,170,447,617,91,546,637,1254,46,273,Washington,Spokane,208916
20982,1979-1980,1979-11-19,1980-04-06,140,0,61,229,290,64,84,148,438,37,173,Washington,Spokane,208916
20983,1980-1981,1980-11-15,1981-05-04,171,0,35,174,209,24,20,44,253,14,65,Washington,Spokane,208916
20984,1981-1982,1981-11-28,1982-04-14,138,0,53,226,279,71,295,366,645,37,159,Washington,Spokane,208916
20985,1982-1983,1982-11-12,1983-04-10,150,0,38,172,210,59,111,170,380,26,109,Washington,Spokane,208916
20986,1983-1984,1983-11-19,1984-05-06,170,0,76,265,341,74,155,229,570,38,172,Washington,Spokane,208916
20987,1984-1985,1984-10-27,1985-03-30,155,3,102,371,473,101,597,698,1171,43,223,Washington,Spokane,208916
20988,1985-1986,1985-10-31,1986-04-29,181,0,118,379,497,95,513,608,1105,42,291,Washington,Spokane,208916
20989,1986-1987,1986-11-07,1987-02-28,114,0,40,209,249,43,128,171,420,24,85,Washington,Spokane,208916
20990,1987-1988,1987-11-16,1988-03-29,135,0,61,257,318,53,227,280,598,28,136,Washington,Spokane,208916
20991,1988-1989,1988-11-08,1989-03-17,130,0,74,289,363,97,234,331,694,42,218,Washington,Spokane,208916
20992,1989-1990,1989-11-25,1990-04-28,155,0,22,165,187,59,99,158,345,29,108,Washington,Spokane,208916
20993,1990-1991,1990-11-19,1991-04-10,143,1,78,262,340,68,96,164,504,34,198,Washington,Spokane,208916
20994,1991-1992,1991-10-26,1992-02-29,127,0,19,138,157,36,22,58,215,26,77,Washington,Spokane,208916
20995,1992-1993,1992-11-10,1993-03-14,125,0,92,334,426,125,605,730,1156,42,294,Washington,Spokane,208916
20996,1993-1994,1993-11-17,1994-03-21,125,0,46,184,230,34,31,65,295,22,79,Washington,Spokane,208916
20997,1994-1995,1994-10-30,1995-03-05,127,0,32,192,224,46,38,84,308,27,97,Washington,Spokane,208916
20998,1996-1997,1996-11-16,1997-04-04,140,0,53,254,307,112,364,476,783,42,233,Washington,Spokane,208916
20999,1997-1998,1997-12-01,1998-03-08,98,0,27,134,161,35,41,76,237,25,87,Washington,Spokane,208916
21000,1998-1999,1998-11-30,1999-05-13,165,0,32,174,206,68,60,128,334,39,116,Washington,Spokane,208916
21001,1999-2000,1999-11-21,2000-05-11,173,0,28,179,207,65,92,157,364,41,124,Washington,Spokane,208916
21002,2000-2001,2000-11-08,2001-04-11,155,0,69,321,390,75,537,612,1002,43,183,Washington,Spokane,208916
21003,2001-2002,2001-10-12,2002-05-06,207,0,36,236,272,96,175,271,543,49,195,Washington,Spokane,208916
21004,2002-2003,2002-12-01,2003-04-02,123,0,14,120,134,36,22,58,192,24,65,Washington,Spokane,208916
21005,2003-2004,2003-11-01,2004-03-05,126,0,60,241,301,82,242,324,625,39,195,Washington,Spokane,208916
21006,2004-2005,2004-11-27,2005-03-29,123,0,34,178,212,41,80,121,333,20,97,Washington,Spokane,208916
21007,2005-2006,2005-11-13,2006-03-15,123,0,45,208,253,50,105,155,408,30,104,Washington,Spokane,208916
21008,2006-2007,2006-11-02,2007-05-21,201,0,55,235,290,59,101,160,450,36,151,Washington,Spokane,208916
21009,2007-2008,2007-11-19,2008-04-30,164,0,56,263,319,134,325,459,778,62,258,Washington,Spokane,208916
21010,2008-2009,2008-11-27,2009-04-03,128,0,75,273,348,143,300,443,791,48,307,Washington,Spokane,208916
21011,2009-2010,2009-11-13,2010-04-06,145,0,36,164,200,23,11,34,234,15,47,Washington,Spokane,208916
21012,2010-2011,2010-11-13,2011-04-21,160,0,62,252,314,105,245,350,664,45,213,Washington,Spokane,208916
21013,2011-2012,2011-11-12,2012-04-04,145,0,32,201,233,63,78,141,374,38,138,Washington,Spokane,208916
21014,2012-2013,2012-11-08,2013-03-07,120,0,42,179,221,70,133,203,424,38,142,Washington,Spokane,208916
21015,2013-2014,2013-11-03,2014-03-04,122,0,79,235,314,63,112,175,489,32,171,Washington,Spokane,208916
21016,2014-2015,2014-11-11,2015-04-06,147,0,36,161,197,29,18,47,244,19,69,Washington,Spokane,208916
21017,2015-2016,2015-11-16,2016-03-28,134,0,35,157,192,57,181,238,430,31,125,Washington,Spokane,208916
21018,2016-2017,2016-11-16,2017-04-10,146,0,89,293,382,91,347,438,820,46,241,Washington,Spokane,208916
21019,2017-2018,2017-11-03,2018-03-24,142,0,42,192,234,75,119,194,428,34,153,Washington,Spokane,208916
21020,2018-2019,2018-11-09,2019-03-22,134,0,57,259,316,78,333,411,727,37,178,Washington,Spokane,208916
21021,2019-2020,2019-09-28,2020-04-05,191,0,22,186,208,69,107,176,384,33,134,Washington,Spokane,208916
21022,1950-1951,1950-12-01,1951-03-07,97,0,16,88,104,26,36,62,166,8,46,Washington,Walla Walla,31731
21023,1951-1952,1951-12-01,1952-03-20,111,3,36,145,181,32,56,88,269,17,87,Washington,Walla Walla,31731
21024,1952-1953,1952-11-22,1953-02-28,99,0,18,77,95,4,2,6,101,1,5,Washington,Walla Walla,31731
21025,1953-1954,1953-12-01,1954-03-17,107,0,21,96,117,17,35,52,169,7,54,Washington,Walla Walla,31731
21026,1954-1955,1954-12-01,1955-03-04,94,0,17,107,124,16,22,38,162,8,31,Washington,Walla Walla,31731
21027,1955-1956,1955-11-11,1956-02-29,111,0,74,227,301,70,169,239,540,26,188,Washington,Walla Walla,31731
21028,1956-1957,1956-11-18,1957-03-21,124,0,86,215,301,42,135,177,478,17,121,Washington,Walla Walla,31731
21029,1957-1958,1957-12-01,1958-03-17,107,0,7,53,60,6,11,17,77,2,10,Washington,Walla Walla,31731
21030,1958-1959,1958-11-15,1959-04-15,152,0,23,122,145,34,30,64,209,15,76,Washington,Walla Walla,31731
21031,1959-1960,1959-11-13,1960-03-06,115,0,55,191,246,38,129,167,413,12,84,Washington,Walla Walla,31731
21032,1960-1961,1960-11-28,1961-02-28,93,0,30,70,100,3,7,10,110,2,7,Washington,Walla Walla,31731
21033,1961-1962,1961-11-24,1962-03-04,101,0,42,140,182,35,82,117,299,13,83,Washington,Walla Walla,31731
21034,1962-1963,1962-12-01,1963-02-28,90,0,26,115,141,10,20,30,171,4,36,Washington,Walla Walla,31731
21035,1963-1964,1963-11-29,1964-03-23,116,0,10,60,70,3,6,9,79,2,7,Washington,Walla Walla,31731
21036,1964-1965,1964-12-01,1965-03-25,115,0,17,115,132,27,44,71,203,10,48,Washington,Walla Walla,31731
21037,1965-1966,1965-12-01,1966-03-22,112,0,7,67,74,16,6,22,96,7,21,Washington,Walla Walla,31731
21038,1966-1967,1966-12-01,1967-03-29,119,1,1,37,38,7,1,8,46,4,10,Washington,Walla Walla,31731
21039,1967-1968,1967-11-27,1968-02-29,95,0,13,84,97,8,8,16,113,5,30,Washington,Walla Walla,31731
21040,1968-1969,1968-11-07,1969-02-28,114,0,70,171,241,76,184,260,501,23,209,Washington,Walla Walla,31731
21041,1969-1970,1969-11-26,1970-03-03,98,0,24,62,86,28,36,64,150,12,46,Washington,Walla Walla,31731
21042,1970-1971,1970-11-22,1971-03-13,112,0,14,75,89,25,16,41,130,12,45,Washington,Walla Walla,31731
21043,1971-1972,1971-10-30,1972-02-29,123,0,50,126,176,34,60,94,270,13,95,Washington,Walla Walla,31731
21044,1972-1973,1972-12-01,1973-02-28,90,0,73,167,240,25,85,110,350,8,75,Washington,Walla Walla,31731
21045,1973-1974,1973-10-31,1974-02-28,121,0,57,109,166,30,92,122,288,10,80,Washington,Walla Walla,31731
21046,1974-1975,1974-12-01,1975-02-28,90,0,13,66,79,33,78,111,190,14,55,Washington,Walla Walla,31731
21047,1975-1976,1975-11-19,1976-03-31,134,0,18,83,101,12,11,23,124,6,20,Washington,Walla Walla,31731
21048,1976-1977,1976-12-01,1977-02-28,90,0,48,107,155,13,61,74,229,7,45,Washington,Walla Walla,31731
21049,1977-1978,1977-11-19,1978-03-05,107,0,33,90,123,40,80,120,243,14,96,Washington,Walla Walla,31731
21050,1978-1979,1978-11-11,1979-02-28,110,0,89,225,314,64,234,298,612,20,128,Washington,Walla Walla,31731
21051,1979-1980,1979-11-24,1980-03-06,104,0,42,109,151,43,45,88,239,13,78,Washington,Walla Walla,31731
21052,1980-1981,1980-11-14,1981-02-28,107,0,10,51,61,9,7,16,77,6,22,Washington,Walla Walla,31731
21053,1981-1982,1981-11-27,1982-03-30,124,0,15,86,101,42,41,83,184,21,65,Washington,Walla Walla,31731
21054,1982-1983,1982-11-14,1983-02-28,107,0,19,41,60,8,4,12,72,4,13,Washington,Walla Walla,31731
21055,1983-1984,1983-11-28,1984-02-29,94,0,59,127,186,36,100,136,322,15,105,Washington,Walla Walla,31731
21056,1984-1985,1984-11-30,1985-02-28,91,0,59,148,207,43,84,127,334,15,99,Washington,Walla Walla,31731
21057,1985-1986,1985-11-10,1986-02-28,111,0,109,229,338,56,315,371,709,22,162,Washington,Walla Walla,31731
21058,1986-1987,1986-12-01,1987-02-28,90,0,36,98,134,11,41,52,186,7,28,Washington,Walla Walla,31731
21059,1987-1988,1987-11-30,1988-02-29,92,5,34,105,139,23,44,67,206,14,60,Washington,Walla Walla,31731
21060,1988-1989,1988-12-01,1989-03-17,107,1,57,164,221,27,76,103,324,15,90,Washington,Walla Walla,31731
21061,1989-1990,1989-11-29,1990-03-24,116,0,24,68,92,17,25,42,134,6,26,Washington,Walla Walla,31731
21062,1990-1991,1990-12-01,1991-03-26,116,3,57,157,214,25,48,73,287,10,74,Washington,Walla Walla,31731
21063,1991-1992,1991-10-29,1992-02-29,124,0,5,46,51,4,2,6,57,3,7,Washington,Walla Walla,31731
21064,1992-1993,1992-11-24,1993-03-04,101,5,74,212,286,62,184,246,532,33,213,Washington,Walla Walla,31731
21065,1993-1994,1993-11-22,1994-03-19,118,0,29,87,116,25,27,52,168,9,45,Washington,Walla Walla,31731
21066,1999-2000,1999-12-01,2000-02-29,91,6,14,43,57,11,3,14,71,5,19,Washington,Walla Walla,31731
21067,2000-2001,2000-11-19,2001-02-28,102,0,36,101,137,6,3,9,146,3,15,Washington,Walla Walla,31731
21068,2001-2002,2001-11-09,2002-02-28,112,0,9,68,77,0,0,0,77,0,0,Washington,Walla Walla,31731
21069,2002-2003,2002-10-30,2003-02-28,122,0,12,71,83,0,0,0,83,0,0,Washington,Walla Walla,31731
21070,2003-2004,2003-12-01,2004-02-29,91,2,33,94,127,0,0,0,127,0,0,Washington,Walla Walla,31731
21071,2004-2005,2004-12-01,2005-02-28,90,1,13,78,91,0,0,0,91,0,0,Washington,Walla Walla,31731
21072,2009-2010,2009-12-01,2010-02-28,90,0,24,72,96,7,8,15,111,4,17,Washington,Walla Walla,31731
21073,2010-2011,2010-11-21,2011-02-28,100,2,29,127,156,26,68,94,250,10,40,Washington,Walla Walla,31731
21074,2011-2012,2011-11-20,2012-03-21,123,14,17,98,115,14,18,32,147,8,27,Washington,Walla Walla,31731
21075,2012-2013,2012-11-26,2013-02-28,95,0,19,67,86,2,0,2,88,2,4,Washington,Walla Walla,31731
21076,2013-2014,2013-11-22,2014-03-02,101,11,43,130,173,26,35,61,234,11,72,Washington,Walla Walla,31731
21077,2014-2015,2014-11-13,2015-02-28,108,3,23,86,109,5,5,10,119,3,15,Washington,Walla Walla,31731
21078,2015-2016,2015-11-21,2016-02-29,101,5,26,79,105,11,13,24,129,7,22,Washington,Walla Walla,31731
21079,2016-2017,2016-12-01,2017-02-28,90,8,73,192,265,49,132,181,446,25,145,Washington,Walla Walla,31731
21080,2017-2018,2017-11-07,2018-02-28,114,4,26,70,96,15,23,38,134,7,36,Washington,Walla Walla,31731
21081,1950-1951,1950-11-20,1951-03-14,115,2,24,168,192,75,191,266,458,21,123,Washington,Wenatchee,13190
21082,1951-1952,1951-12-01,1952-03-03,94,9,75,250,325,58,348,406,731,19,147,Washington,Wenatchee,13190
21083,1952-1953,1952-11-24,1953-02-28,97,0,13,88,101,41,84,125,226,12,66,Washington,Wenatchee,13190
21084,1953-1954,1953-12-01,1954-02-28,90,0,38,137,175,32,154,186,361,9,86,Washington,Wenatchee,13190
21085,1954-1955,1954-12-01,1955-03-25,115,0,18,183,201,21,57,78,279,8,36,Washington,Wenatchee,13190
21086,1955-1956,1955-11-03,1956-03-06,125,3,90,332,422,126,678,804,1226,28,216,Washington,Wenatchee,13190
21087,1956-1957,1956-11-17,1957-03-12,116,1,99,283,382,50,185,235,617,15,95,Washington,Wenatchee,13190
21088,1957-1958,1957-10-23,1958-02-28,129,1,2,97,99,13,11,24,123,6,23,Washington,Wenatchee,13190
21089,1958-1959,1958-11-18,1959-02-28,103,0,33,163,196,36,96,132,328,16,73,Washington,Wenatchee,13190
21090,1959-1960,1959-11-14,1960-03-07,115,1,38,199,237,30,76,106,343,16,73,Washington,Wenatchee,13190
21091,1960-1961,1960-11-24,1961-03-07,104,0,26,144,170,28,92,120,290,11,56,Washington,Wenatchee,13190
21092,1961-1962,1961-11-22,1962-03-11,110,1,42,203,245,54,144,198,443,17,96,Washington,Wenatchee,13190
21093,1962-1963,1962-11-30,1963-02-28,91,1,28,143,171,6,14,20,191,4,19,Washington,Wenatchee,13190
21094,1963-1964,1963-11-22,1964-02-29,100,0,13,142,155,44,190,234,389,20,81,Washington,Wenatchee,13190
21095,1964-1965,1964-11-29,1965-02-28,92,1,38,167,205,54,272,326,531,19,126,Washington,Wenatchee,13190
21096,1965-1966,1965-11-24,1966-03-21,118,0,26,168,194,53,269,322,516,16,92,Washington,Wenatchee,13190
21097,1966-1967,1966-12-01,1967-02-28,90,0,1,72,73,6,8,14,87,3,9,Washington,Wenatchee,13190
21098,1967-1968,1967-11-29,1968-02-29,93,0,21,155,176,42,90,132,308,15,82,Washington,Wenatchee,13190
21099,1968-1969,1968-12-01,1969-03-13,103,1,98,279,377,86,564,650,1027,31,215,Washington,Wenatchee,13190
21100,1969-1970,1969-12-01,1970-02-28,90,1,15,116,131,48,139,187,318,15,74,Washington,Wenatchee,13190
21101,1970-1971,1970-11-22,1971-02-28,99,0,38,192,230,55,375,430,660,19,110,Washington,Wenatchee,13190
21102,1972-1973,1972-12-01,1973-02-28,90,0,43,174,217,18,55,73,290,7,42,Washington,Wenatchee,13190
21103,1973-1974,1973-11-04,1974-03-01,118,1,34,141,175,42,113,155,330,14,68,Washington,Wenatchee,13190
21104,1974-1975,1974-12-01,1975-02-28,90,0,16,129,145,46,198,244,389,19,100,Washington,Wenatchee,13190
21105,1975-1976,1975-11-29,1976-02-29,93,4,11,128,139,27,83,110,249,5,35,Washington,Wenatchee,13190
21106,1977-1978,1977-11-21,1978-02-28,100,0,21,125,146,25,64,89,235,12,56,Washington,Wenatchee,13190
21107,1979-1980,1979-12-01,1980-02-29,91,3,35,171,206,78,342,420,626,22,143,Washington,Wenatchee,13190
21108,1981-1982,1981-12-01,1982-02-28,90,5,36,147,183,31,229,260,443,13,65,Washington,Wenatchee,13190
21109,1983-1984,1983-11-23,1984-02-29,99,8,43,163,206,44,137,181,387,13,95,Washington,Wenatchee,13190
21110,1984-1985,1984-11-01,1985-03-27,147,5,66,253,319,29,285,314,633,10,63,Washington,Wenatchee,13190
21111,1985-1986,1985-11-17,1986-02-28,104,7,64,203,267,84,406,490,757,19,130,Washington,Wenatchee,13190
21112,1986-1987,1986-12-01,1987-02-28,90,7,20,105,125,14,68,82,207,6,21,Washington,Wenatchee,13190
21113,1987-1988,1987-12-01,1988-02-29,91,8,38,148,186,13,194,207,393,5,29,Washington,Wenatchee,13190
21114,1988-1989,1988-12-01,1989-03-07,97,8,43,191,234,40,120,160,394,14,87,Washington,Wenatchee,13190
21115,1989-1990,1989-12-01,1990-02-28,90,8,9,85,94,2,3,5,99,2,9,Washington,Wenatchee,13190
21116,1990-1991,1990-12-01,1991-03-03,93,11,55,163,218,14,104,118,336,4,31,Washington,Wenatchee,13190
21117,1991-1992,1991-10-29,1992-02-29,124,2,1,72,73,12,3,15,88,6,18,Washington,Wenatchee,13190
21118,1992-1993,1992-11-27,1993-03-03,97,14,72,215,287,80,360,440,727,25,183,Washington,Wenatchee,13190
21119,1996-1997,1996-11-19,1997-03-16,118,13,65,212,277,82,480,562,839,24,171,Washington,Wenatchee,13190
21120,1997-1998,1997-12-01,1998-02-28,90,19,13,85,98,28,45,73,171,13,59,Washington,Wenatchee,13190
21121,1998-1999,1998-12-01,1999-02-28,90,14,19,102,121,26,25,51,172,9,50,Washington,Wenatchee,13190
21122,2005-2006,2005-12-01,2006-02-28,90,3,27,125,152,7,47,54,206,4,14,Washington,Wenatchee,13190
21123,2006-2007,2006-11-26,2007-02-28,95,3,54,160,214,34,75,109,323,13,68,Washington,Wenatchee,13190
21124,2007-2008,2007-11-26,2008-02-29,96,4,42,172,214,38,100,138,352,18,85,Washington,Wenatchee,13190
21125,2008-2009,2008-12-01,2009-03-08,98,3,68,184,252,40,100,140,392,18,129,Washington,Wenatchee,13190
21126,2009-2010,2009-12-01,2010-02-28,90,0,27,116,143,18,25,43,186,10,42,Washington,Wenatchee,13190
21127,2010-2011,2010-11-22,2011-03-08,107,0,40,170,210,42,72,114,324,24,105,Washington,Wenatchee,13190
21128,2011-2012,2011-11-17,2012-02-29,105,0,26,159,185,31,96,127,312,15,71,Washington,Wenatchee,13190
21129,2012-2013,2012-12-01,2013-02-28,90,0,29,103,132,18,45,63,195,12,39,Washington,Wenatchee,13190
21130,2013-2014,2013-12-01,2014-03-04,94,0,23,126,149,21,58,79,228,12,48,Washington,Wenatchee,13190
21131,2014-2015,2014-11-22,2015-02-28,99,0,10,80,90,12,17,29,119,6,21,Washington,Wenatchee,13190
21132,2015-2016,2015-11-24,2016-02-29,98,0,27,106,133,50,182,232,365,21,92,Washington,Wenatchee,13190
21133,2016-2017,2016-12-01,2017-03-08,98,0,69,238,307,52,377,429,736,25,137,Washington,Wenatchee,13190
21134,2017-2018,2017-11-05,2018-02-28,116,0,15,118,133,22,39,61,194,14,47,Washington,Wenatchee,13190
21135,2018-2019,2018-12-01,2019-03-17,107,2,31,153,184,54,201,255,439,24,112,Washington,Wenatchee,13190
21136,2019-2020,2019-11-27,2020-02-29,95,0,15,106,121,20,32,52,173,9,40,Washington,Wenatchee,13190
21137,1950-1951,1950-11-19,1951-03-12,114,0,16,203,219,54,106,160,379,25,119,Washington,Yakima,91067
21138,1951-1952,1951-12-01,1952-03-03,94,0,46,262,308,35,174,209,517,19,126,Washington,Yakima,91067
21139,1952-1953,1952-11-23,1953-02-28,98,0,15,131,146,20,42,62,208,10,47,Washington,Yakima,91067
21140,1953-1954,1953-12-01,1954-02-28,90,3,27,159,186,36,152,188,374,10,87,Washington,Yakima,91067
21141,1954-1955,1954-12-01,1955-03-26,116,0,18,211,229,25,35,60,289,17,55,Washington,Yakima,91067
21142,1955-1956,1955-10-10,1956-03-05,148,0,72,373,445,102,519,621,1066,36,246,Washington,Yakima,91067
21143,1956-1957,1956-11-18,1957-03-12,115,0,82,319,401,39,93,132,533,16,89,Washington,Yakima,91067
21144,1957-1958,1957-10-22,1958-02-28,130,0,1,152,153,5,1,6,159,4,11,Washington,Yakima,91067
21145,1958-1959,1958-11-17,1959-02-28,104,0,26,166,192,30,36,66,258,20,82,Washington,Yakima,91067
21146,1959-1960,1959-11-13,1960-03-06,115,0,44,292,336,31,93,124,460,21,105,Washington,Yakima,91067
21147,1960-1961,1960-12-01,1961-03-08,98,0,31,148,179,18,28,46,225,10,45,Washington,Yakima,91067
21148,1961-1962,1961-11-23,1962-03-05,103,0,32,195,227,31,39,70,297,15,68,Washington,Yakima,91067
21149,1962-1963,1962-12-01,1963-02-28,90,0,26,173,199,23,36,59,258,6,53,Washington,Yakima,91067
21150,1963-1964,1963-12-01,1964-02-29,91,0,13,157,170,15,23,38,208,9,26,Washington,Yakima,91067
21151,1964-1965,1964-11-29,1965-03-26,118,0,31,231,262,75,324,399,661,23,159,Washington,Yakima,91067
21152,1965-1966,1965-11-23,1966-03-05,103,0,16,181,197,48,197,245,442,16,85,Washington,Yakima,91067
21153,1966-1967,1966-12-01,1967-02-28,90,0,0,91,91,10,12,22,113,5,18,Washington,Yakima,91067
21154,1967-1968,1967-11-27,1968-02-29,95,0,15,169,184,28,46,74,258,17,83,Washington,Yakima,91067
21155,1968-1969,1968-12-01,1969-03-05,95,0,73,284,357,65,403,468,825,35,235,Washington,Yakima,91067
21156,1969-1970,1969-12-01,1970-02-28,90,0,19,117,136,38,78,116,252,18,73,Washington,Yakima,91067
21157,1970-1971,1970-11-22,1971-03-26,125,0,20,212,232,58,102,160,392,25,106,Washington,Yakima,91067
21158,1971-1972,1971-10-30,1972-03-05,128,0,43,283,326,48,113,161,487,22,124,Washington,Yakima,91067
21159,1972-1973,1972-12-01,1973-02-28,90,0,46,202,248,23,49,72,320,12,73,Washington,Yakima,91067
21160,1973-1974,1973-10-31,1974-03-01,122,0,38,198,236,52,116,168,404,20,113,Washington,Yakima,91067
21161,1974-1975,1974-12-01,1975-03-21,111,0,15,166,181,49,129,178,359,23,108,Washington,Yakima,91067
21162,1975-1976,1975-11-10,1976-02-29,112,0,10,190,200,27,29,56,256,13,47,Washington,Yakima,91067
21163,1976-1977,1976-12-01,1977-02-28,90,0,40,195,235,9,9,18,253,8,46,Washington,Yakima,91067
21164,1977-1978,1977-11-18,1978-03-04,107,0,19,146,165,29,53,82,247,19,78,Washington,Yakima,91067
21165,1978-1979,1978-11-15,1979-02-28,106,0,89,335,424,35,156,191,615,16,107,Washington,Yakima,91067
21166,1979-1980,1979-11-22,1980-03-05,105,0,42,214,256,69,351,420,676,31,151,Washington,Yakima,91067
21167,1980-1981,1980-11-14,1981-02-28,107,0,8,87,95,18,47,65,160,6,27,Washington,Yakima,91067
21168,1981-1982,1981-12-01,1982-03-31,121,0,39,226,265,42,231,273,538,20,103,Washington,Yakima,91067
21169,1982-1983,1982-11-16,1983-02-28,105,0,19,133,152,29,95,124,276,16,56,Washington,Yakima,91067
21170,1983-1984,1983-11-23,1984-02-29,99,0,42,194,236,31,211,242,478,15,85,Washington,Yakima,91067
21171,1984-1985,1984-11-01,1985-03-26,146,0,75,326,401,41,341,382,783,17,105,Washington,Yakima,91067
21172,1985-1986,1985-11-10,1986-02-28,111,0,103,331,434,57,348,405,839,25,161,Washington,Yakima,91067
21173,1986-1987,1986-11-11,1987-02-28,110,0,26,192,218,29,127,156,374,17,66,Washington,Yakima,91067
21174,1987-1988,1987-11-30,1988-02-29,92,0,31,184,215,30,178,208,423,12,61,Washington,Yakima,91067
21175,1988-1989,1988-12-01,1989-03-06,96,0,35,233,268,32,73,105,373,16,89,Washington,Yakima,91067
21176,1989-1990,1989-12-01,1990-02-28,90,0,14,130,144,6,1,7,151,5,17,Washington,Yakima,91067
21177,1990-1991,1990-12-01,1991-03-01,91,0,49,248,297,6,6,12,309,5,29,Washington,Yakima,91067
21178,1991-1992,1991-10-28,1992-02-29,125,0,1,140,141,8,3,11,152,6,18,Washington,Yakima,91067
21179,1992-1993,1992-11-21,1993-04-06,137,0,62,311,373,88,411,499,872,36,223,Washington,Yakima,91067
21180,1993-1994,1993-11-22,1994-03-21,120,0,28,177,205,22,16,38,243,11,50,Washington,Yakima,91067
21181,1994-1995,1994-11-15,1995-03-22,128,0,12,175,187,25,22,47,234,16,45,Washington,Yakima,91067
21182,1995-1996,1995-11-07,1996-02-29,115,0,52,221,273,30,107,137,410,18,111,Washington,Yakima,91067
21183,1996-1997,1996-11-18,1997-03-15,118,0,54,271,325,91,553,644,969,21,182,Washington,Yakima,91067
21184,2001-2002,2001-11-28,2002-03-17,110,0,3,163,166,42,73,115,281,19,72,Washington,Yakima,91067
21185,2002-2003,2002-11-30,2003-02-28,91,0,3,89,92,14,8,22,114,6,20,Washington,Yakima,91067
21186,2003-2004,2003-12-01,2004-03-03,94,0,27,169,196,48,133,181,377,22,110,Washington,Yakima,91067
21187,2004-2005,2004-12-01,2005-02-28,90,0,15,172,187,25,67,92,279,12,56,Washington,Yakima,91067
21188,2005-2006,2005-11-25,2006-02-28,96,0,21,190,211,14,17,31,242,9,35,Washington,Yakima,91067
21189,2006-2007,2006-11-26,2007-03-02,97,0,44,219,263,24,78,102,365,15,69,Washington,Yakima,91067
21190,2007-2008,2007-11-17,2008-03-28,133,0,23,228,251,44,56,100,351,24,96,Washington,Yakima,91067
21191,2008-2009,2008-12-01,2009-02-28,90,0,48,215,263,30,92,122,385,19,122,Washington,Yakima,91067
21192,2009-2010,2009-11-22,2010-04-02,132,0,22,191,213,24,54,78,291,9,49,Washington,Yakima,91067
21193,2010-2011,2010-11-22,2011-03-08,107,0,26,205,231,39,114,153,384,17,79,Washington,Yakima,91067
21194,2011-2012,2011-11-16,2012-03-22,128,0,13,246,259,38,98,136,395,11,75,Washington,Yakima,91067
21195,2012-2013,2012-11-09,2013-02-28,112,6,17,150,167,24,79,103,270,11,40,Washington,Yakima,91067
21196,2013-2014,2013-12-01,2014-03-02,92,0,24,199,223,29,35,64,287,8,60,Washington,Yakima,91067
21197,2014-2015,2014-11-30,2015-02-28,91,1,9,94,103,3,2,5,108,2,5,Washington,Yakima,91067
21198,2015-2016,2015-11-23,2016-02-29,99,3,17,140,157,43,187,230,387,19,79,Washington,Yakima,91067
21199,2016-2017,2016-12-01,2017-02-28,90,0,54,245,299,57,327,384,683,24,147,Washington,Yakima,91067
21200,2017-2018,2017-11-05,2018-03-23,139,0,7,144,151,8,1,9,160,7,23,Washington,Yakima,91067
21201,1950-1951,1950-11-21,1951-03-21,121,8,29,273,302,36,74,110,412,26,145,West Virginia,Beckley,17614
21202,1952-1953,1952-11-30,1953-04-21,143,0,7,168,175,59,52,111,286,21,112,West Virginia,Beckley,17614
21203,1953-1954,1953-11-26,1954-03-16,111,0,20,233,253,61,65,126,379,21,128,West Virginia,Beckley,17614
21204,1954-1955,1954-11-03,1955-03-27,145,9,26,302,328,38,107,145,473,13,84,West Virginia,Beckley,17614
21205,1955-1956,1955-11-11,1956-04-09,151,1,26,299,325,54,122,176,501,17,102,West Virginia,Beckley,17614
21206,1956-1957,1956-11-23,1957-04-13,142,2,16,200,216,54,51,105,321,16,107,West Virginia,Beckley,17614
21207,1957-1958,1957-10-28,1958-03-25,149,5,52,297,349,100,160,260,609,27,193,West Virginia,Beckley,17614
21208,1958-1959,1958-11-29,1959-04-04,127,8,30,309,339,29,36,65,404,12,91,West Virginia,Beckley,17614
21209,1959-1960,1959-11-29,1960-04-10,134,6,39,288,327,137,296,433,760,29,245,West Virginia,Beckley,17614
21210,1960-1961,1960-11-07,1961-04-18,163,1,36,308,344,73,167,240,584,24,192,West Virginia,Beckley,17614
21211,1961-1962,1961-10-20,1962-04-14,177,1,23,255,278,68,103,171,449,22,148,West Virginia,Beckley,17614
21212,1962-1963,1962-10-26,1963-03-23,149,1,53,364,417,97,212,309,726,28,237,West Virginia,Beckley,17614
21213,1963-1964,1963-11-01,1964-04-01,153,0,52,293,345,110,222,332,677,45,260,West Virginia,Beckley,17614
21214,1964-1965,1964-11-30,1965-03-22,113,1,42,240,282,74,93,167,449,35,230,West Virginia,Beckley,17614
21215,1965-1966,1965-10-24,1966-04-09,168,0,51,268,319,91,158,249,568,44,254,West Virginia,Beckley,17614
21216,1966-1967,1966-11-03,1967-03-20,138,0,38,242,280,93,128,221,501,36,220,West Virginia,Beckley,17614
21217,1967-1968,1967-11-04,1968-03-24,142,0,52,303,355,91,204,295,650,33,224,West Virginia,Beckley,17614
21218,1968-1969,1968-11-09,1969-03-29,141,0,52,282,334,82,96,178,512,45,212,West Virginia,Beckley,17614
21219,1969-1970,1969-11-05,1970-04-07,154,0,65,317,382,99,151,250,632,51,311,West Virginia,Beckley,17614
21220,1970-1971,1970-11-04,1971-04-08,156,0,63,278,341,100,113,213,554,41,259,West Virginia,Beckley,17614
21221,1971-1972,1971-11-07,1972-04-02,148,0,31,228,259,60,66,126,385,33,156,West Virginia,Beckley,17614
21222,1972-1973,1972-10-19,1973-04-12,176,0,33,202,235,50,42,92,327,37,160,West Virginia,Beckley,17614
21223,1973-1974,1973-10-29,1974-04-09,163,0,19,169,188,61,64,125,313,32,154,West Virginia,Beckley,17614
21224,1974-1975,1974-10-20,1975-04-04,167,0,21,209,230,99,113,212,442,44,212,West Virginia,Beckley,17614
21225,1975-1976,1975-11-13,1976-03-17,126,0,37,198,235,55,63,118,353,34,187,West Virginia,Beckley,17614
21226,1976-1977,1976-11-05,1977-04-06,153,0,83,386,469,125,355,480,949,54,352,West Virginia,Beckley,17614
21227,1977-1978,1977-11-12,1978-04-21,161,0,86,343,429,118,330,448,877,58,392,West Virginia,Beckley,17614
21228,1978-1979,1978-11-26,1979-03-26,121,0,55,253,308,97,155,252,560,35,244,West Virginia,Beckley,17614
21229,1979-1980,1979-10-10,1980-04-29,203,0,52,277,329,102,155,257,586,37,248,West Virginia,Beckley,17614
21230,1980-1981,1980-11-28,1981-03-24,117,0,54,274,328,80,115,195,523,41,241,West Virginia,Beckley,17614
21231,1981-1982,1981-10-19,1982-04-10,174,0,56,276,332,109,103,212,544,46,288,West Virginia,Beckley,17614
21232,1982-1983,1982-11-05,1983-04-19,166,0,29,192,221,84,100,184,405,31,163,West Virginia,Beckley,17614
21233,1983-1984,1983-11-11,1984-04-07,149,0,53,268,321,102,105,207,528,48,261,West Virginia,Beckley,17614
21234,1984-1985,1984-11-11,1985-04-10,151,0,48,265,313,102,198,300,613,48,295,West Virginia,Beckley,17614
21235,1985-1986,1985-12-01,1986-04-23,144,0,47,252,299,95,113,208,507,45,275,West Virginia,Beckley,17614
21236,1986-1987,1986-11-13,1987-04-08,147,0,26,197,223,104,159,263,486,34,193,West Virginia,Beckley,17614
21237,1987-1988,1987-11-10,1988-04-28,171,0,49,242,291,85,85,170,461,43,234,West Virginia,Beckley,17614
21238,1988-1989,1988-11-06,1989-05-07,183,0,24,189,213,63,45,108,321,35,148,West Virginia,Beckley,17614
21239,1989-1990,1989-10-20,1990-04-12,175,0,48,237,285,105,141,246,531,45,248,West Virginia,Beckley,17614
21240,1990-1991,1990-12-01,1991-03-30,120,0,13,134,147,34,27,61,208,22,100,West Virginia,Beckley,17614
21241,1991-1992,1991-11-04,1992-04-27,176,0,20,175,195,67,39,106,301,36,150,West Virginia,Beckley,17614
21242,1992-1993,1992-10-19,1993-04-22,186,0,26,199,225,109,126,235,460,45,210,West Virginia,Beckley,17614
21243,1993-1994,1993-10-31,1994-04-07,159,0,50,246,296,126,162,288,584,51,303,West Virginia,Beckley,17614
21244,1994-1995,1994-12-01,1995-04-02,123,0,35,168,203,70,87,157,360,34,186,West Virginia,Beckley,17614
21245,1996-1997,1996-11-08,1997-04-18,162,0,33,209,242,50,67,117,359,33,153,West Virginia,Beckley,17614
21246,1997-1998,1997-10-27,1998-03-24,149,2,27,174,201,128,186,314,515,43,230,West Virginia,Beckley,17614
21247,1998-1999,1998-11-06,1999-03-16,131,10,32,189,221,67,60,127,348,34,174,West Virginia,Beckley,17614
21248,2004-2005,2004-12-01,2005-04-03,124,0,36,201,237,81,95,176,413,25,174,West Virginia,Beckley,17614
21249,2005-2006,2005-11-17,2006-03-26,130,0,27,209,236,60,41,101,337,19,104,West Virginia,Beckley,17614
21250,2006-2007,2006-11-19,2007-04-07,140,0,43,215,258,43,37,80,338,16,114,West Virginia,Beckley,17614
21251,2007-2008,2007-11-23,2008-02-29,99,2,21,171,192,24,16,40,232,10,61,West Virginia,Beckley,17614
21252,2008-2009,2008-11-16,2009-04-07,143,3,48,249,297,80,84,164,461,31,191,West Virginia,Beckley,17614
21253,2009-2010,2009-11-27,2010-03-23,117,2,72,232,304,187,381,568,872,43,364,West Virginia,Beckley,17614
21254,2010-2011,2010-12-01,2011-04-01,122,0,58,221,279,130,221,351,630,44,300,West Virginia,Beckley,17614
21255,2011-2012,2011-10-29,2012-04-23,178,0,10,127,137,53,66,119,256,21,99,West Virginia,Beckley,17614
21256,2012-2013,2012-10-29,2013-03-28,151,0,28,193,221,106,110,216,437,38,200,West Virginia,Beckley,17614
21257,2013-2014,2013-11-12,2014-04-15,155,3,49,295,344,117,126,243,587,42,281,West Virginia,Beckley,17614
21258,2014-2015,2014-11-01,2015-03-28,148,0,47,266,313,95,184,279,592,29,220,West Virginia,Beckley,17614
21259,2015-2016,2015-12-01,2016-04-09,131,0,32,163,195,64,95,159,354,22,154,West Virginia,Beckley,17614
21260,2016-2017,2016-11-19,2017-04-07,140,0,26,159,185,41,40,81,266,18,105,West Virginia,Beckley,17614
21261,2017-2018,2017-12-01,2018-04-09,130,2,47,224,271,74,85,159,430,28,161,West Virginia,Beckley,17614
21262,2018-2019,2018-10-21,2019-03-09,140,0,29,164,193,66,48,114,307,29,160,West Virginia,Beckley,17614
21263,2019-2020,2019-11-12,2020-04-14,155,0,13,137,150,42,34,76,226,22,92,West Virginia,Beckley,17614
21264,1950-1951,1950-11-21,1951-04-03,134,15,23,249,272,58,103,161,433,18,122,West Virginia,Bluefield,10447
21265,1951-1952,1951-11-03,1952-03-24,143,1,13,194,207,36,32,68,275,16,70,West Virginia,Bluefield,10447
21266,1952-1953,1952-11-21,1953-04-20,151,9,5,148,153,44,40,84,237,16,80,West Virginia,Bluefield,10447
21267,1953-1954,1953-11-26,1954-03-15,110,1,14,182,196,36,37,73,269,9,56,West Virginia,Bluefield,10447
21268,1954-1955,1954-10-30,1955-03-27,149,0,24,241,265,60,96,156,421,17,106,West Virginia,Bluefield,10447
21269,1956-1957,1956-11-22,1957-03-09,108,0,12,164,176,24,18,42,218,10,55,West Virginia,Bluefield,10447
21270,1957-1958,1957-10-28,1958-03-22,146,0,29,296,325,84,106,190,515,27,169,West Virginia,Bluefield,10447
21271,1958-1959,1958-11-28,1959-03-12,105,1,24,241,265,20,36,56,321,10,61,West Virginia,Bluefield,10447
21272,1959-1960,1959-11-07,1960-04-10,156,13,89,292,381,104,249,353,734,33,264,West Virginia,Bluefield,10447
21273,1962-1963,1962-10-25,1963-05-01,189,6,67,310,377,51,159,210,587,24,134,West Virginia,Bluefield,10447
21274,1963-1964,1963-11-14,1964-04-01,140,0,56,249,305,73,140,213,518,27,171,West Virginia,Bluefield,10447
21275,1964-1965,1964-11-22,1965-03-22,121,0,43,211,254,49,71,120,374,17,124,West Virginia,Bluefield,10447
21276,1965-1966,1965-11-30,1966-03-08,99,0,48,185,233,56,146,202,435,14,109,West Virginia,Bluefield,10447
21277,1966-1967,1966-11-03,1967-03-18,136,0,35,186,221,57,90,147,368,14,105,West Virginia,Bluefield,10447
21278,1967-1968,1967-11-05,1968-03-04,121,1,53,253,306,62,131,193,499,12,113,West Virginia,Bluefield,10447
21279,1968-1969,1968-11-10,1969-03-27,138,0,47,220,267,74,82,156,423,23,136,West Virginia,Bluefield,10447
21280,1969-1970,1969-11-13,1970-03-16,124,0,60,244,304,53,92,145,449,22,140,West Virginia,Bluefield,10447
21281,1970-1971,1970-11-04,1971-04-08,156,0,50,219,269,75,80,155,424,24,159,West Virginia,Bluefield,10447
21282,1971-1972,1971-11-21,1972-03-25,126,0,33,182,215,29,40,69,284,13,71,West Virginia,Bluefield,10447
21283,1972-1973,1972-11-21,1973-03-22,122,0,32,142,174,13,13,26,200,6,33,West Virginia,Bluefield,10447
21284,1973-1974,1973-10-29,1974-03-31,154,0,20,136,156,38,67,105,261,16,81,West Virginia,Bluefield,10447
21285,1974-1975,1974-10-20,1975-04-03,166,0,22,167,189,60,103,163,352,23,116,West Virginia,Bluefield,10447
21286,1975-1976,1975-11-14,1976-03-17,125,0,37,171,208,20,31,51,259,9,52,West Virginia,Bluefield,10447
21287,1976-1977,1976-11-05,1977-03-02,118,0,67,288,355,72,229,301,656,34,178,West Virginia,Bluefield,10447
21288,1977-1978,1977-11-27,1978-04-27,152,0,81,293,374,72,226,298,672,31,199,West Virginia,Bluefield,10447
21289,1978-1979,1978-12-01,1979-03-26,116,0,61,244,305,50,118,168,473,26,170,West Virginia,Bluefield,10447
21290,1979-1980,1979-10-10,1980-04-16,190,0,56,236,292,44,94,138,430,24,147,West Virginia,Bluefield,10447
21291,1980-1981,1980-11-28,1981-03-24,117,0,49,237,286,35,39,74,360,25,121,West Virginia,Bluefield,10447
21292,1981-1982,1981-11-21,1982-03-27,127,0,57,228,285,42,56,98,383,29,151,West Virginia,Bluefield,10447
21293,1982-1983,1982-12-01,1983-04-19,140,0,34,149,183,54,94,148,331,26,129,West Virginia,Bluefield,10447
21294,1983-1984,1983-11-11,1984-03-21,132,4,47,188,235,35,97,132,367,24,99,West Virginia,Bluefield,10447
21295,1984-1985,1984-11-12,1985-04-09,149,0,47,202,249,37,107,144,393,26,127,West Virginia,Bluefield,10447
21296,1985-1986,1985-12-01,1986-04-17,138,0,37,227,264,58,65,123,387,33,197,West Virginia,Bluefield,10447
21297,1986-1987,1986-11-15,1987-04-08,145,0,28,180,208,88,163,251,459,27,170,West Virginia,Bluefield,10447
21298,1987-1988,1987-11-10,1988-04-07,150,0,46,221,267,36,57,93,360,23,130,West Virginia,Bluefield,10447
21299,1988-1989,1988-12-01,1989-04-08,129,3,21,153,174,39,38,77,251,22,88,West Virginia,Bluefield,10447
21300,1989-1990,1989-11-16,1990-04-12,148,0,45,204,249,47,117,164,413,28,143,West Virginia,Bluefield,10447
21301,1990-1991,1990-12-01,1991-03-30,120,0,14,128,142,12,12,24,166,8,39,West Virginia,Bluefield,10447
21302,1991-1992,1991-11-04,1992-04-05,154,0,21,177,198,32,9,41,239,24,97,West Virginia,Bluefield,10447
21303,1992-1993,1992-11-06,1993-03-22,137,0,23,175,198,62,84,146,344,25,125,West Virginia,Bluefield,10447
21304,1993-1994,1993-10-31,1994-03-29,150,0,40,218,258,58,92,150,408,27,146,West Virginia,Bluefield,10447
21305,1994-1995,1994-12-01,1995-03-11,101,0,25,141,166,28,54,82,248,15,81,West Virginia,Bluefield,10447
21306,1995-1996,1995-11-08,1996-04-10,155,0,63,273,336,113,214,327,663,42,276,West Virginia,Bluefield,10447
21307,1996-1997,1996-11-10,1997-04-18,160,0,26,169,195,27,48,75,270,14,60,West Virginia,Bluefield,10447
21308,1997-1998,1997-11-04,1998-03-22,139,9,19,135,154,87,151,238,392,24,143,West Virginia,Bluefield,10447
21309,1998-1999,1998-12-01,1999-03-17,107,6,27,144,171,57,77,134,305,26,134,West Virginia,Bluefield,10447
21310,1999-2000,1999-11-03,2000-04-09,159,4,25,147,172,42,108,150,322,21,112,West Virginia,Bluefield,10447
21311,2000-2001,2000-11-18,2001-03-26,129,0,45,233,278,3,2,5,283,1,4,West Virginia,Bluefield,10447
21312,2003-2004,2003-11-28,2004-04-04,129,2,28,177,205,73,131,204,409,32,149,West Virginia,Bluefield,10447
21313,2004-2005,2004-12-01,2005-04-24,145,3,27,154,181,85,106,191,372,28,147,West Virginia,Bluefield,10447
21314,2005-2006,2005-11-21,2006-03-26,126,0,17,145,162,62,64,126,288,35,127,West Virginia,Bluefield,10447
21315,2006-2007,2006-10-24,2007-04-16,175,3,22,176,198,45,48,93,291,22,113,West Virginia,Bluefield,10447
21316,2007-2008,2007-11-15,2008-03-08,115,3,13,125,138,28,24,52,190,14,63,West Virginia,Bluefield,10447
21317,2008-2009,2008-10-28,2009-04-08,163,6,34,202,236,50,56,106,342,29,128,West Virginia,Bluefield,10447
21318,2009-2010,2009-11-27,2010-03-11,105,13,55,180,235,105,366,471,706,36,234,West Virginia,Bluefield,10447
21319,2010-2011,2010-11-06,2011-03-28,143,0,50,191,241,98,236,334,575,41,237,West Virginia,Bluefield,10447
21320,2011-2012,2011-11-11,2012-03-05,116,0,7,83,90,35,31,66,156,18,76,West Virginia,Bluefield,10447
21321,2012-2013,2012-10-29,2013-04-04,158,0,18,151,169,83,109,192,361,37,156,West Virginia,Bluefield,10447
21322,2013-2014,2013-10-25,2014-04-15,173,0,33,229,262,77,118,195,457,34,201,West Virginia,Bluefield,10447
21323,2014-2015,2014-11-01,2015-03-28,148,0,34,215,249,65,118,183,432,34,191,West Virginia,Bluefield,10447
21324,2015-2016,2015-12-01,2016-04-09,131,13,23,127,150,55,95,150,300,25,137,West Virginia,Bluefield,10447
21325,2016-2017,2016-12-01,2017-04-07,128,0,25,149,174,34,27,61,235,21,111,West Virginia,Bluefield,10447
21326,2017-2018,2017-10-29,2018-04-16,170,0,49,245,294,70,76,146,440,26,149,West Virginia,Bluefield,10447
21327,2018-2019,2018-11-15,2019-03-09,115,0,32,149,181,50,43,93,274,25,127,West Virginia,Bluefield,10447
21328,2019-2020,2019-11-12,2020-04-14,155,0,13,136,149,27,16,43,192,18,71,West Virginia,Bluefield,10447
21329,1950-1951,1950-11-24,1951-03-25,122,0,31,183,214,55,64,119,333,21,126,West Virginia,Charleston,51400
21330,1951-1952,1951-11-02,1952-03-16,136,0,8,148,156,15,2,17,173,13,40,West Virginia,Charleston,51400
21331,1952-1953,1952-11-29,1953-04-19,142,0,6,89,95,31,16,47,142,17,65,West Virginia,Charleston,51400
21332,1953-1954,1953-11-06,1954-03-31,146,0,15,150,165,51,39,90,255,20,89,West Virginia,Charleston,51400
21333,1954-1955,1954-11-03,1955-03-27,145,0,21,179,200,27,27,54,254,15,68,West Virginia,Charleston,51400
21334,1955-1956,1955-11-19,1956-04-08,142,0,15,191,206,33,31,64,270,23,81,West Virginia,Charleston,51400
21335,1956-1957,1956-11-23,1957-03-09,107,0,16,127,143,24,22,46,189,17,67,West Virginia,Charleston,51400
21336,1957-1958,1957-10-27,1958-03-21,146,0,41,218,259,56,62,118,377,34,163,West Virginia,Charleston,51400
21337,1958-1959,1958-11-28,1959-04-13,137,0,27,214,241,30,13,43,284,19,85,West Virginia,Charleston,51400
21338,1959-1960,1959-11-25,1960-03-24,121,0,24,176,200,82,99,181,381,41,181,West Virginia,Charleston,51400
21339,1960-1961,1960-11-30,1961-04-01,123,0,45,198,243,43,64,107,350,25,123,West Virginia,Charleston,51400
21340,1961-1962,1961-10-20,1962-03-09,141,0,22,162,184,40,23,63,247,22,104,West Virginia,Charleston,51400
21341,1962-1963,1962-10-25,1963-05-01,189,0,52,281,333,72,100,172,505,31,178,West Virginia,Charleston,51400
21342,1963-1964,1963-11-29,1964-03-31,124,0,35,201,236,74,89,163,399,25,129,West Virginia,Charleston,51400
21343,1964-1965,1964-11-22,1965-03-21,120,0,30,209,239,46,49,95,334,21,116,West Virginia,Charleston,51400
21344,1965-1966,1965-11-29,1966-03-25,117,0,33,191,224,50,91,141,365,20,110,West Virginia,Charleston,51400
21345,1966-1967,1966-11-28,1967-03-20,113,0,27,190,217,53,56,109,326,25,119,West Virginia,Charleston,51400
21346,1967-1968,1967-11-06,1968-03-23,139,0,32,262,294,62,117,179,473,24,136,West Virginia,Charleston,51400
21347,1968-1969,1968-11-12,1969-03-26,135,0,27,209,236,30,13,43,279,21,76,West Virginia,Charleston,51400
21348,1969-1970,1969-11-14,1970-03-29,136,0,30,226,256,70,85,155,411,35,164,West Virginia,Charleston,51400
21349,1970-1971,1970-11-15,1971-03-26,132,0,46,213,259,70,71,141,400,31,170,West Virginia,Charleston,51400
21350,1971-1972,1971-11-21,1972-03-25,126,0,18,135,153,36,23,59,212,21,77,West Virginia,Charleston,51400
21351,1972-1973,1972-10-19,1973-04-12,176,0,20,173,193,38,15,53,246,27,93,West Virginia,Charleston,51400
21352,1973-1974,1973-12-01,1974-04-09,130,0,11,110,121,36,24,60,181,19,76,West Virginia,Charleston,51400
21353,1974-1975,1974-10-20,1975-04-03,166,0,10,183,193,60,45,105,298,24,112,West Virginia,Charleston,51400
21354,1975-1976,1975-12-01,1976-03-17,108,1,17,135,152,42,23,65,217,25,92,West Virginia,Charleston,51400
21355,1976-1977,1976-11-11,1977-04-06,147,0,72,325,397,74,176,250,647,41,209,West Virginia,Charleston,51400
21356,1977-1978,1977-11-12,1978-03-17,126,0,66,287,353,111,297,408,761,51,310,West Virginia,Charleston,51400
21357,1978-1979,1978-12-01,1979-03-26,116,0,39,207,246,79,112,191,437,36,182,West Virginia,Charleston,51400
21358,1979-1980,1979-11-12,1980-03-18,128,0,30,194,224,55,77,132,356,26,135,West Virginia,Charleston,51400
21359,1980-1981,1980-11-18,1981-03-23,126,0,34,238,272,42,70,112,384,27,112,West Virginia,Charleston,51400
21360,1981-1982,1981-11-20,1982-04-09,141,0,33,221,254,57,69,126,380,32,156,West Virginia,Charleston,51400
21361,1982-1983,1982-12-01,1983-04-17,138,0,10,133,143,43,61,104,247,18,71,West Virginia,Charleston,51400
21362,1983-1984,1983-11-11,1984-03-21,132,0,38,211,249,48,64,112,361,27,131,West Virginia,Charleston,51400
21363,1984-1985,1984-12-01,1985-04-09,130,0,30,181,211,67,194,261,472,30,161,West Virginia,Charleston,51400
21364,1985-1986,1985-12-01,1986-03-07,97,0,21,159,180,66,68,134,314,29,144,West Virginia,Charleston,51400
21365,1986-1987,1986-11-15,1987-04-08,145,0,15,141,156,72,91,163,319,27,122,West Virginia,Charleston,51400
21366,1987-1988,1987-11-10,1988-03-18,130,0,28,182,210,48,25,73,283,29,123,West Virginia,Charleston,51400
21367,1988-1989,1988-12-01,1989-05-07,158,0,13,139,152,25,11,36,188,17,60,West Virginia,Charleston,51400
21368,1989-1990,1989-11-16,1990-04-04,140,0,36,174,210,57,58,115,325,28,135,West Virginia,Charleston,51400
21369,1990-1991,1990-12-01,1991-03-31,121,0,4,109,113,28,11,39,152,18,63,West Virginia,Charleston,51400
21370,1991-1992,1991-11-11,1992-04-05,147,0,9,128,137,39,21,60,197,23,80,West Virginia,Charleston,51400
21371,1992-1993,1992-11-14,1993-03-19,126,0,13,148,161,57,50,107,268,23,111,West Virginia,Charleston,51400
21372,1993-1994,1993-10-31,1994-03-16,137,0,32,187,219,89,122,211,430,32,184,West Virginia,Charleston,51400
21373,1994-1995,1994-12-01,1995-03-11,101,0,23,151,174,42,51,93,267,21,100,West Virginia,Charleston,51400
21374,1995-1996,1995-11-11,1996-04-10,152,0,47,241,288,154,163,317,605,56,312,West Virginia,Charleston,51400
21375,1996-1997,1996-11-10,1997-02-28,111,0,16,132,148,27,15,42,190,17,66,West Virginia,Charleston,51400
21376,1997-1998,1997-11-04,1998-03-22,139,0,8,109,117,43,37,80,197,24,89,West Virginia,Charleston,51400
21377,1998-1999,1998-12-01,1999-03-09,99,0,14,122,136,32,23,55,191,17,76,West Virginia,Charleston,51400
21378,1999-2000,1999-12-01,2000-04-09,131,0,21,138,159,30,21,51,210,20,90,West Virginia,Charleston,51400
21379,2000-2001,2000-11-21,2001-04-18,149,1,25,216,241,32,18,50,291,24,103,West Virginia,Charleston,51400
21380,2001-2002,2001-12-01,2002-04-06,127,0,11,138,149,35,34,69,218,16,76,West Virginia,Charleston,51400
21381,2002-2003,2002-11-23,2003-03-31,129,0,30,160,190,56,58,114,304,33,144,West Virginia,Charleston,51400
21382,2003-2004,2003-11-29,2004-04-05,129,0,23,170,193,36,22,58,251,23,101,West Virginia,Charleston,51400
21383,2004-2005,2004-12-01,2005-04-24,145,0,19,148,167,38,25,63,230,20,86,West Virginia,Charleston,51400
21384,2005-2006,2005-11-23,2006-03-21,119,0,12,136,148,30,16,46,194,17,59,West Virginia,Charleston,51400
21385,2006-2007,2006-12-01,2007-04-07,128,0,21,164,185,28,17,45,230,17,81,West Virginia,Charleston,51400
21386,2007-2008,2007-12-01,2008-03-09,100,0,13,133,146,35,22,57,203,20,88,West Virginia,Charleston,51400
21387,2008-2009,2008-11-17,2009-03-13,117,0,25,184,209,51,48,99,308,31,126,West Virginia,Charleston,51400
21388,2009-2010,2009-12-01,2010-03-03,93,0,37,139,176,89,136,225,401,34,178,West Virginia,Charleston,51400
21389,2010-2011,2010-12-01,2011-03-27,117,0,35,151,186,63,80,143,329,35,140,West Virginia,Charleston,51400
21390,2011-2012,2011-12-01,2012-03-05,96,0,6,87,93,20,12,32,125,12,49,West Virginia,Charleston,51400
21391,2012-2013,2012-10-29,2013-03-26,149,0,14,153,167,42,26,68,235,21,87,West Virginia,Charleston,51400
21392,2013-2014,2013-11-12,2014-04-15,155,0,32,241,273,83,72,155,428,39,180,West Virginia,Charleston,51400
21393,2014-2015,2014-11-13,2015-03-28,136,0,37,212,249,51,63,114,363,25,127,West Virginia,Charleston,51400
21394,2015-2016,2015-12-01,2016-04-09,131,0,21,137,158,52,59,111,269,17,105,West Virginia,Charleston,51400
21395,2016-2017,2016-11-19,2017-02-28,102,0,13,88,101,13,8,21,122,8,29,West Virginia,Charleston,51400
21396,2017-2018,2017-12-01,2018-04-16,137,0,35,183,218,38,23,61,279,25,100,West Virginia,Charleston,51400
21397,2018-2019,2018-11-16,2019-03-08,113,0,15,118,133,23,8,31,164,17,65,West Virginia,Charleston,51400
21398,2019-2020,2019-11-12,2020-04-14,155,1,4,102,106,19,8,27,133,12,40,West Virginia,Charleston,51400
21399,1950-1951,1950-11-21,1951-03-22,122,0,39,263,302,87,114,201,503,22,155,West Virginia,Clarksburg,16578
21400,1951-1952,1951-11-03,1952-03-17,136,0,20,220,240,24,19,43,283,13,65,West Virginia,Clarksburg,16578
21401,1952-1953,1952-11-29,1953-04-21,144,1,12,174,186,34,29,63,249,16,74,West Virginia,Clarksburg,16578
21402,1953-1954,1953-11-29,1954-04-04,127,2,25,219,244,36,40,76,320,13,60,West Virginia,Clarksburg,16578
21403,1954-1955,1954-12-01,1955-03-28,118,1,31,251,282,51,65,116,398,16,108,West Virginia,Clarksburg,16578
21404,1955-1956,1955-11-19,1956-03-25,128,4,31,269,300,37,55,92,392,15,86,West Virginia,Clarksburg,16578
21405,1956-1957,1956-11-23,1957-02-28,98,1,18,181,199,35,46,81,280,14,72,West Virginia,Clarksburg,16578
21406,1957-1958,1957-10-27,1958-03-20,145,1,44,266,310,39,62,101,411,17,94,West Virginia,Clarksburg,16578
21407,1958-1959,1958-11-28,1959-04-12,136,1,41,305,346,31,26,57,403,15,77,West Virginia,Clarksburg,16578
21408,1959-1960,1959-11-29,1960-03-26,119,2,25,239,264,70,117,187,451,18,128,West Virginia,Clarksburg,16578
21409,1960-1961,1960-11-30,1961-03-16,107,0,43,262,305,64,228,292,597,13,111,West Virginia,Clarksburg,16578
21410,1961-1962,1961-12-01,1962-03-08,98,2,29,211,240,44,57,101,341,13,85,West Virginia,Clarksburg,16578
21411,1962-1963,1962-10-26,1963-03-21,147,0,63,374,437,63,137,200,637,23,141,West Virginia,Clarksburg,16578
21412,1963-1964,1963-11-30,1964-03-31,123,0,42,305,347,76,147,223,570,20,137,West Virginia,Clarksburg,16578
21413,1964-1965,1964-11-22,1965-03-21,120,1,36,262,298,56,87,143,441,16,111,West Virginia,Clarksburg,16578
21414,1965-1966,1965-11-29,1966-04-09,132,1,42,258,300,47,120,167,467,11,96,West Virginia,Clarksburg,16578
21415,1966-1967,1966-11-29,1967-03-18,110,1,25,242,267,44,47,91,358,13,94,West Virginia,Clarksburg,16578
21416,1967-1968,1967-11-30,1968-03-23,115,1,40,282,322,61,162,223,545,14,99,West Virginia,Clarksburg,16578
21417,1968-1969,1968-11-20,1969-03-27,128,0,30,249,279,32,23,55,334,14,62,West Virginia,Clarksburg,16578
21418,1969-1970,1969-11-14,1970-03-30,137,1,47,320,367,61,129,190,557,19,139,West Virginia,Clarksburg,16578
21419,1971-1972,1971-11-25,1972-04-03,131,1,28,224,252,35,43,78,330,15,73,West Virginia,Clarksburg,16578
21420,1977-1978,1977-11-27,1978-03-17,111,19,68,341,409,70,314,384,793,25,177,West Virginia,Clarksburg,16578
21421,1978-1979,1978-12-01,1979-02-28,90,11,45,254,299,75,238,313,612,19,155,West Virginia,Clarksburg,16578
21422,1980-1981,1980-11-18,1981-03-21,124,3,47,298,345,27,101,128,473,12,85,West Virginia,Clarksburg,16578
21423,1981-1982,1981-12-01,1982-04-06,127,15,44,231,275,46,97,143,418,20,106,West Virginia,Clarksburg,16578
21424,1982-1983,1982-12-01,1983-03-22,112,16,16,137,153,35,48,83,236,11,62,West Virginia,Clarksburg,16578
21425,1986-1987,1986-11-14,1987-04-06,144,7,18,222,240,33,58,91,331,8,55,West Virginia,Clarksburg,16578
21426,1987-1988,1987-11-11,1988-03-21,132,17,35,205,240,31,52,83,323,16,70,West Virginia,Clarksburg,16578
21427,1988-1989,1988-12-01,1989-03-19,109,16,23,192,215,25,17,42,257,13,67,West Virginia,Clarksburg,16578
21428,1989-1990,1989-11-24,1990-03-25,122,8,46,220,266,37,68,105,371,13,78,West Virginia,Clarksburg,16578
21429,1990-1991,1990-12-01,1991-03-30,120,3,16,171,187,25,24,49,236,11,53,West Virginia,Clarksburg,16578
21430,1991-1992,1991-11-05,1992-03-16,133,9,24,201,225,32,44,76,301,14,87,West Virginia,Clarksburg,16578
21431,1992-1993,1992-12-01,1993-03-19,109,11,21,179,200,44,71,115,315,11,74,West Virginia,Clarksburg,16578
21432,1993-1994,1993-12-01,1994-03-17,107,14,58,222,280,87,167,254,534,20,154,West Virginia,Clarksburg,16578
21433,1994-1995,1994-12-01,1995-03-11,101,6,36,195,231,37,55,92,323,14,85,West Virginia,Clarksburg,16578
21434,1995-1996,1995-11-09,1996-03-23,136,6,72,312,384,93,177,270,654,31,206,West Virginia,Clarksburg,16578
21435,1996-1997,1996-11-12,1997-02-28,109,6,25,199,224,12,18,30,254,7,30,West Virginia,Clarksburg,16578
21436,1997-1998,1997-11-16,1998-03-24,129,5,10,145,155,24,28,52,207,11,40,West Virginia,Clarksburg,16578
21437,1998-1999,1998-12-01,1999-03-17,107,5,26,181,207,45,56,101,308,16,92,West Virginia,Clarksburg,16578
21438,1999-2000,1999-12-01,2000-02-29,91,1,30,183,213,39,72,111,324,18,108,West Virginia,Clarksburg,16578
21439,2000-2001,2000-11-18,2001-03-27,130,8,39,274,313,50,94,144,457,25,133,West Virginia,Clarksburg,16578
21440,2001-2002,2001-12-01,2002-03-23,113,3,22,167,189,24,32,56,245,11,59,West Virginia,Clarksburg,16578
21441,2002-2003,2002-11-23,2003-03-08,106,12,46,217,263,103,187,290,553,34,217,West Virginia,Clarksburg,16578
21442,2003-2004,2003-11-29,2004-03-22,115,12,35,239,274,18,33,51,325,9,35,West Virginia,Clarksburg,16578
21443,2005-2006,2005-11-18,2006-03-22,125,3,25,200,225,13,6,19,244,6,25,West Virginia,Clarksburg,16578
21444,2006-2007,2006-12-01,2007-04-08,129,7,41,241,282,19,23,42,324,6,38,West Virginia,Clarksburg,16578
21445,2007-2008,2007-12-01,2008-02-29,91,2,27,179,206,9,6,15,221,2,16,West Virginia,Clarksburg,16578
21446,2008-2009,2008-11-22,2009-03-04,103,1,46,260,306,29,44,73,379,16,96,West Virginia,Clarksburg,16578
21447,2009-2010,2009-12-01,2010-03-02,92,14,53,212,265,100,202,302,567,26,198,West Virginia,Clarksburg,16578
21448,2015-2016,2015-12-01,2016-04-09,131,20,29,185,214,56,95,151,365,10,112,West Virginia,Clarksburg,16578
21449,2018-2019,2018-11-28,2019-03-07,100,17,22,146,168,23,23,46,214,11,53,West Virginia,Clarksburg,16578
21450,2019-2020,2019-11-12,2020-03-07,117,15,10,139,149,11,7,18,167,6,18,West Virginia,Clarksburg,16578
21451,1950-1951,1950-11-20,1951-04-17,149,0,53,316,369,111,124,235,604,49,300,West Virginia,Elkins,7094
21452,1951-1952,1951-11-03,1952-04-15,165,0,33,294,327,65,38,103,430,39,190,West Virginia,Elkins,7094
21453,1952-1953,1952-10-29,1953-04-21,175,0,15,236,251,92,72,164,415,46,188,West Virginia,Elkins,7094
21454,1953-1954,1953-11-07,1954-05-10,185,0,39,311,350,89,100,189,539,46,239,West Virginia,Elkins,7094
21455,1954-1955,1954-11-03,1955-03-28,146,0,46,308,354,52,113,165,519,24,161,West Virginia,Elkins,7094
21456,1955-1956,1955-11-04,1956-04-24,173,0,36,361,397,69,164,233,630,28,159,West Virginia,Elkins,7094
21457,1956-1957,1956-11-23,1957-03-28,126,0,31,213,244,47,70,117,361,24,138,West Virginia,Elkins,7094
21458,1957-1958,1957-10-28,1958-04-08,163,0,72,321,393,89,204,293,686,37,282,West Virginia,Elkins,7094
21459,1958-1959,1958-11-27,1959-04-14,139,0,58,360,418,38,37,75,493,22,155,West Virginia,Elkins,7094
21460,1962-1963,1962-10-25,1963-05-01,189,0,61,427,488,118,197,315,803,53,334,West Virginia,Elkins,7094
21461,1963-1964,1963-11-02,1964-04-09,160,0,49,380,429,110,192,302,731,59,320,West Virginia,Elkins,7094
21462,1964-1965,1964-11-22,1965-04-02,132,0,40,322,362,92,133,225,587,44,274,West Virginia,Elkins,7094
21463,1965-1966,1965-10-24,1966-04-10,169,0,48,329,377,99,140,239,616,51,270,West Virginia,Elkins,7094
21464,1966-1967,1966-11-28,1967-04-27,151,0,34,300,334,98,119,217,551,45,250,West Virginia,Elkins,7094
21465,1967-1968,1967-11-04,1968-04-11,160,0,46,402,448,121,288,409,857,47,297,West Virginia,Elkins,7094
21466,1968-1969,1968-10-29,1969-04-23,177,0,52,357,409,98,104,202,611,52,250,West Virginia,Elkins,7094
21467,1969-1970,1969-11-05,1970-04-06,153,0,74,414,488,136,251,387,875,69,422,West Virginia,Elkins,7094
21468,1970-1971,1970-11-04,1971-04-07,155,0,65,375,440,161,171,332,772,57,399,West Virginia,Elkins,7094
21469,1971-1972,1971-11-09,1972-04-08,152,0,32,300,332,83,88,171,503,40,200,West Virginia,Elkins,7094
21470,1972-1973,1972-10-19,1973-04-13,177,0,31,266,297,71,52,123,420,41,181,West Virginia,Elkins,7094
21471,1973-1974,1973-10-29,1974-04-10,164,0,21,262,283,84,102,186,469,41,191,West Virginia,Elkins,7094
21472,1974-1975,1974-11-12,1975-04-12,152,0,26,355,381,99,115,214,595,56,258,West Virginia,Elkins,7094
21473,1975-1976,1975-11-13,1976-04-02,142,0,30,266,296,72,72,144,440,39,190,West Virginia,Elkins,7094
21474,1976-1977,1976-11-05,1977-04-26,173,0,90,500,590,130,417,547,1137,56,375,West Virginia,Elkins,7094
21475,1977-1978,1977-11-12,1978-03-19,128,1,100,471,571,115,385,500,1071,60,437,West Virginia,Elkins,7094
21476,1978-1979,1978-11-26,1979-04-28,154,0,64,361,425,101,195,296,721,55,323,West Virginia,Elkins,7094
21477,1979-1980,1979-10-09,1980-04-16,191,1,58,354,412,120,144,264,676,55,309,West Virginia,Elkins,7094
21478,1980-1981,1980-10-25,1981-04-25,183,0,66,429,495,101,172,273,768,58,326,West Virginia,Elkins,7094
21479,1981-1982,1981-10-19,1982-04-10,174,0,61,393,454,113,142,255,709,54,333,West Virginia,Elkins,7094
21480,1982-1983,1982-11-05,1983-04-19,166,0,28,299,327,104,87,191,518,41,217,West Virginia,Elkins,7094
21481,1983-1984,1983-11-04,1984-04-07,156,0,60,369,429,133,130,263,692,59,314,West Virginia,Elkins,7094
21482,1984-1985,1984-11-06,1985-04-10,156,0,60,369,429,130,257,387,816,47,341,West Virginia,Elkins,7094
21483,1985-1986,1985-12-01,1986-04-23,144,0,44,362,406,172,184,356,762,53,380,West Virginia,Elkins,7094
21484,1986-1987,1986-11-13,1987-04-08,147,0,23,317,340,137,145,282,622,43,254,West Virginia,Elkins,7094
21485,1987-1988,1987-11-10,1988-04-29,172,0,52,372,424,126,91,217,641,57,336,West Virginia,Elkins,7094
21486,1988-1989,1988-11-02,1989-05-07,187,0,26,344,370,84,43,127,497,46,227,West Virginia,Elkins,7094
21487,1989-1990,1989-10-08,1990-04-17,192,0,47,394,441,141,141,282,723,55,336,West Virginia,Elkins,7094
21488,1990-1991,1990-12-01,1991-04-01,122,0,17,236,253,96,65,161,414,35,191,West Virginia,Elkins,7094
21489,1991-1992,1991-11-04,1992-04-05,154,0,26,310,336,111,78,189,525,48,250,West Virginia,Elkins,7094
21490,1992-1993,1992-10-18,1993-04-22,187,0,32,312,344,141,122,263,607,52,288,West Virginia,Elkins,7094
21491,1993-1994,1993-10-31,1994-04-07,159,0,48,340,388,174,183,357,745,57,364,West Virginia,Elkins,7094
21492,1994-1995,1994-11-01,1995-04-02,153,0,30,270,300,65,3,68,368,36,195,West Virginia,Elkins,7094
21493,1995-1996,1995-11-08,1996-04-16,161,1,73,394,467,194,206,400,867,72,466,West Virginia,Elkins,7094
21494,1996-1997,1996-11-10,1997-04-18,160,7,42,293,335,71,72,143,478,28,180,West Virginia,Elkins,7094
21495,1997-1998,1997-11-08,1998-03-24,137,0,21,213,234,66,82,148,382,24,141,West Virginia,Elkins,7094
21496,1998-1999,1998-11-09,1999-03-17,129,1,28,295,323,111,125,236,559,29,229,West Virginia,Elkins,7094
21497,1999-2000,1999-11-03,2000-04-09,159,15,43,311,354,81,146,227,581,29,188,West Virginia,Elkins,7094
21498,2000-2001,2000-11-21,2001-04-18,149,14,44,373,417,120,168,288,705,41,291,West Virginia,Elkins,7094
21499,2001-2002,2001-10-28,2002-03-22,146,13,23,288,311,70,70,140,451,25,166,West Virginia,Elkins,7094
21500,2003-2004,2003-11-29,2004-04-06,130,8,42,326,368,135,215,350,718,40,289,West Virginia,Elkins,7094
21501,2004-2005,2004-11-26,2005-04-25,151,4,30,253,283,107,134,241,524,37,229,West Virginia,Elkins,7094
21502,2005-2006,2005-10-24,2006-03-26,154,0,20,252,272,84,93,177,449,41,171,West Virginia,Elkins,7094
21503,2006-2007,2006-10-24,2007-04-15,174,3,52,338,390,93,139,232,622,42,268,West Virginia,Elkins,7094
21504,2007-2008,2007-11-15,2008-03-23,130,0,27,266,293,66,69,135,428,32,173,West Virginia,Elkins,7094
21505,2008-2009,2008-10-28,2009-04-07,162,0,47,333,380,97,124,221,601,43,254,West Virginia,Elkins,7094
21506,2009-2010,2009-11-27,2010-03-11,105,0,62,285,347,149,366,515,862,45,334,West Virginia,Elkins,7094
21507,2010-2011,2010-12-01,2011-04-02,123,1,61,283,344,125,244,369,713,51,325,West Virginia,Elkins,7094
21508,2011-2012,2011-10-29,2012-04-23,178,0,13,229,242,49,58,107,349,24,120,West Virginia,Elkins,7094
21509,2012-2013,2012-10-29,2013-03-29,152,0,28,280,308,117,142,259,567,46,249,West Virginia,Elkins,7094
21510,2013-2014,2013-11-12,2014-04-15,155,0,53,389,442,133,184,317,759,46,315,West Virginia,Elkins,7094
21511,2014-2015,2014-11-14,2015-03-28,135,2,51,350,401,98,163,261,662,28,245,West Virginia,Elkins,7094
21512,2015-2016,2015-12-01,2016-04-10,132,3,33,250,283,84,120,204,487,30,220,West Virginia,Elkins,7094
21513,2016-2017,2016-11-19,2017-04-07,140,0,28,193,221,68,55,123,344,25,146,West Virginia,Elkins,7094
21514,2017-2018,2017-12-01,2018-04-17,138,2,51,287,338,93,133,226,564,34,251,West Virginia,Elkins,7094
21515,2018-2019,2018-11-16,2019-03-18,123,1,30,208,238,52,54,106,344,29,143,West Virginia,Elkins,7094
21516,2019-2020,2019-11-12,2020-05-09,180,0,9,199,208,52,35,87,295,26,103,West Virginia,Elkins,7094
21517,1950-1951,1950-11-24,1951-03-25,122,5,28,208,236,48,54,102,338,19,112,West Virginia,Huntington,49138
21518,1951-1952,1951-11-03,1952-03-16,135,0,9,162,171,9,5,14,185,6,24,West Virginia,Huntington,49138
21519,1952-1953,1952-11-29,1953-03-07,99,1,4,99,103,10,4,14,117,8,22,West Virginia,Huntington,49138
21520,1953-1954,1953-11-27,1954-03-04,98,0,7,156,163,20,25,45,208,6,34,West Virginia,Huntington,49138
21521,1954-1955,1954-12-01,1955-02-28,90,0,14,156,170,15,22,37,207,7,31,West Virginia,Huntington,49138
21522,1955-1956,1955-11-29,1956-02-29,93,2,10,171,181,10,19,29,210,4,24,West Virginia,Huntington,49138
21523,1956-1957,1956-11-23,1957-03-08,106,3,11,145,156,8,6,14,170,5,19,West Virginia,Huntington,49138
21524,1957-1958,1957-12-01,1958-03-18,108,0,29,209,238,18,28,46,284,8,33,West Virginia,Huntington,49138
21525,1958-1959,1958-11-28,1959-03-17,110,1,24,220,244,12,8,20,264,6,25,West Virginia,Huntington,49138
21526,1959-1960,1959-11-27,1960-03-19,114,0,16,179,195,46,72,118,313,13,74,West Virginia,Huntington,49138
21527,1960-1961,1960-12-01,1961-02-28,90,18,36,187,223,18,51,69,292,7,45,West Virginia,Huntington,49138
21528,1961-1962,1961-12-01,1962-03-14,104,2,23,153,176,26,9,35,211,16,58,West Virginia,Huntington,49138
21529,1962-1963,1962-12-01,1963-03-22,112,0,58,269,327,43,76,119,446,28,145,West Virginia,Huntington,49138
21530,1963-1964,1963-11-14,1964-03-30,138,0,39,227,266,51,82,133,399,19,96,West Virginia,Huntington,49138
21531,1964-1965,1964-11-30,1965-03-21,112,0,28,187,215,33,50,83,298,17,77,West Virginia,Huntington,49138
21532,1965-1966,1965-11-29,1966-03-08,100,0,42,172,214,26,94,120,334,13,84,West Virginia,Huntington,49138
21533,1966-1967,1966-11-02,1967-03-20,139,0,27,186,213,40,45,85,298,23,90,West Virginia,Huntington,49138
21534,1967-1968,1967-11-06,1968-03-23,139,0,43,263,306,48,109,157,463,24,130,West Virginia,Huntington,49138
21535,1968-1969,1968-11-19,1969-03-26,128,0,29,205,234,25,6,31,265,20,72,West Virginia,Huntington,49138
21536,1969-1970,1969-11-14,1970-03-30,137,0,47,242,289,63,71,134,423,32,164,West Virginia,Huntington,49138
21537,1970-1971,1970-11-15,1971-03-26,132,0,41,188,229,56,49,105,334,24,125,West Virginia,Huntington,49138
21538,1971-1972,1971-11-24,1972-03-24,122,0,23,152,175,34,18,52,227,16,90,West Virginia,Huntington,49138
21539,1972-1973,1972-10-19,1973-04-12,176,0,20,162,182,25,5,30,212,19,63,West Virginia,Huntington,49138
21540,1973-1974,1973-12-01,1974-04-09,130,0,16,99,115,25,12,37,152,19,59,West Virginia,Huntington,49138
21541,1974-1975,1974-10-20,1975-03-11,143,0,6,119,125,45,36,81,206,20,80,West Virginia,Huntington,49138
21542,1975-1976,1975-11-14,1976-03-16,124,0,17,138,155,35,21,56,211,20,61,West Virginia,Huntington,49138
21543,1976-1977,1976-11-22,1977-03-01,100,0,53,268,321,59,188,247,568,33,158,West Virginia,Huntington,49138
21544,1977-1978,1977-11-12,1978-03-27,136,0,63,268,331,85,271,356,687,38,204,West Virginia,Huntington,49138
21545,1978-1979,1978-12-01,1979-03-14,104,0,45,199,244,51,112,163,407,24,124,West Virginia,Huntington,49138
21546,1979-1980,1979-11-29,1980-04-15,139,0,31,182,213,40,83,123,336,22,100,West Virginia,Huntington,49138
21547,1980-1981,1980-11-18,1981-03-20,123,0,36,208,244,24,17,41,285,20,79,West Virginia,Huntington,49138
21548,1981-1982,1981-12-01,1982-03-26,116,0,44,206,250,43,52,95,345,26,148,West Virginia,Huntington,49138
21549,1982-1983,1982-12-01,1983-03-22,112,0,11,92,103,25,29,54,157,11,38,West Virginia,Huntington,49138
21550,1983-1984,1983-12-01,1984-03-21,112,0,50,193,243,42,49,91,334,23,111,West Virginia,Huntington,49138
21551,1984-1985,1984-11-18,1985-04-09,143,0,39,218,257,70,155,225,482,27,156,West Virginia,Huntington,49138
21552,1985-1986,1985-12-01,1986-03-20,110,0,26,173,199,62,63,125,324,24,125,West Virginia,Huntington,49138
21553,1986-1987,1986-11-15,1987-04-07,144,0,12,128,140,47,51,98,238,20,79,West Virginia,Huntington,49138
21554,1987-1988,1987-11-10,1988-03-18,130,0,24,184,208,35,19,54,262,21,94,West Virginia,Huntington,49138
21555,1988-1989,1988-12-01,1989-05-07,158,0,16,132,148,13,3,16,164,11,30,West Virginia,Huntington,49138
21556,1989-1990,1989-11-16,1990-04-11,147,0,33,173,206,35,39,74,280,23,103,West Virginia,Huntington,49138
21557,1990-1991,1990-12-01,1991-03-30,120,0,7,108,115,26,8,34,149,18,60,West Virginia,Huntington,49138
21558,1991-1992,1991-11-11,1992-04-04,146,0,8,129,137,22,5,27,164,18,56,West Virginia,Huntington,49138
21559,1992-1993,1992-11-07,1993-04-03,148,1,9,153,162,65,53,118,280,25,110,West Virginia,Huntington,49138
21560,1993-1994,1993-10-31,1994-03-31,152,0,37,200,237,68,101,169,406,25,132,West Virginia,Huntington,49138
21561,1994-1995,1994-12-01,1995-03-11,101,0,22,138,160,32,34,66,226,19,88,West Virginia,Huntington,49138
21562,1995-1996,1995-11-13,1996-04-09,149,0,45,227,272,74,104,178,450,38,186,West Virginia,Huntington,49138
21563,1996-1997,1996-11-14,1997-02-28,107,1,25,143,168,12,10,22,190,9,44,West Virginia,Huntington,49138
21564,2004-2005,2004-12-01,2005-03-14,104,0,19,141,160,21,10,31,191,10,46,West Virginia,Huntington,49138
21565,2005-2006,2005-11-23,2006-03-21,119,0,10,126,136,8,5,13,149,6,19,West Virginia,Huntington,49138
21566,2006-2007,2006-12-01,2007-04-06,127,2,23,165,188,16,11,27,215,9,50,West Virginia,Huntington,49138
21567,2008-2009,2008-11-17,2009-03-03,107,0,29,202,231,26,25,51,282,15,70,West Virginia,Huntington,49138
21568,2009-2010,2009-12-01,2010-02-28,90,0,34,146,180,60,66,126,306,24,131,West Virginia,Huntington,49138
21569,2010-2011,2010-12-01,2011-03-11,101,0,33,156,189,40,77,117,306,22,95,West Virginia,Huntington,49138
21570,2011-2012,2011-12-01,2012-03-05,96,0,4,92,96,8,6,14,110,5,17,West Virginia,Huntington,49138
21571,2012-2013,2012-10-30,2013-03-21,143,0,14,144,158,18,12,30,188,11,44,West Virginia,Huntington,49138
21572,2013-2014,2013-11-12,2014-03-30,139,2,34,237,271,51,41,92,363,20,103,West Virginia,Huntington,49138
21573,2014-2015,2014-11-14,2015-03-07,114,0,37,228,265,50,69,119,384,11,111,West Virginia,Huntington,49138
21574,2015-2016,2015-12-01,2016-03-04,95,0,23,122,145,36,37,73,218,10,74,West Virginia,Huntington,49138
21575,2016-2017,2016-12-01,2017-02-28,90,0,10,75,85,8,7,15,100,5,22,West Virginia,Huntington,49138
21576,2017-2018,2017-12-01,2018-04-09,130,1,34,171,205,24,21,45,250,14,54,West Virginia,Huntington,49138
21577,2018-2019,2018-11-27,2019-03-08,102,0,16,115,131,14,3,17,148,11,45,West Virginia,Huntington,49138
21578,2019-2020,2019-11-11,2020-02-29,111,0,3,87,90,11,5,16,106,5,18,West Virginia,Huntington,49138
21579,1953-1954,1953-11-06,1954-03-15,130,7,14,213,227,14,18,32,259,7,28,West Virginia,Lewisburg,3830
21580,1954-1955,1954-11-02,1955-03-27,146,1,20,273,293,25,57,82,375,10,50,West Virginia,Lewisburg,3830
21581,1955-1956,1955-11-10,1956-04-08,151,0,17,317,334,28,57,85,419,8,49,West Virginia,Lewisburg,3830
21582,1957-1958,1957-11-23,1958-03-22,120,3,40,268,308,57,121,178,486,20,110,West Virginia,Lewisburg,3830
21583,1958-1959,1958-12-01,1959-03-09,99,2,20,248,268,9,15,24,292,4,20,West Virginia,Lewisburg,3830
21584,1960-1961,1960-12-01,1961-03-10,100,0,27,307,334,46,172,218,552,16,121,West Virginia,Lewisburg,3830
21585,1961-1962,1961-10-20,1962-04-15,178,5,13,352,365,64,67,131,496,22,126,West Virginia,Lewisburg,3830
21586,1963-1964,1963-11-29,1964-03-02,95,2,35,243,278,46,184,230,508,13,82,West Virginia,Lewisburg,3830
21587,1964-1965,1964-11-30,1965-03-22,113,0,20,249,269,37,78,115,384,11,79,West Virginia,Lewisburg,3830
21588,1965-1966,1965-11-30,1966-03-07,98,17,29,202,231,56,149,205,436,11,103,West Virginia,Lewisburg,3830
21589,1967-1968,1967-12-01,1968-03-03,94,0,26,246,272,67,206,273,545,13,113,West Virginia,Lewisburg,3830
21590,1968-1969,1968-11-10,1969-03-11,122,1,25,242,267,39,26,65,332,11,61,West Virginia,Lewisburg,3830
21591,1970-1971,1970-11-24,1971-04-07,135,6,35,243,278,48,54,102,380,16,105,West Virginia,Lewisburg,3830
21592,1971-1972,1971-11-22,1972-03-24,124,7,13,198,211,27,34,61,272,10,51,West Virginia,Lewisburg,3830
21593,1975-1976,1975-12-01,1976-03-17,108,4,22,187,209,20,8,28,237,9,47,West Virginia,Lewisburg,3830
21594,1977-1978,1977-11-26,1978-03-08,103,15,42,290,332,58,147,205,537,26,161,West Virginia,Lewisburg,3830
21595,1993-1994,1993-10-31,1994-03-05,126,16,41,252,293,59,143,202,495,13,119,West Virginia,Lewisburg,3830
21596,1995-1996,1995-11-12,1996-04-10,151,5,67,339,406,127,211,338,744,27,225,West Virginia,Lewisburg,3830
21597,1996-1997,1996-11-13,1997-02-28,108,12,35,236,271,28,58,86,357,11,64,West Virginia,Lewisburg,3830
21598,1997-1998,1997-11-16,1998-03-13,118,3,17,195,212,74,133,207,419,14,108,West Virginia,Lewisburg,3830
21599,1998-1999,1998-12-01,1999-03-18,108,2,30,235,265,55,83,138,403,12,91,West Virginia,Lewisburg,3830
21600,1999-2000,1999-12-01,2000-03-13,104,0,35,225,260,40,112,152,412,11,80,West Virginia,Lewisburg,3830
21601,2000-2001,2000-11-22,2001-03-27,126,12,46,315,361,27,40,67,428,9,59,West Virginia,Lewisburg,3830
21602,2001-2002,2001-12-01,2002-03-23,113,2,20,237,257,13,23,36,293,4,24,West Virginia,Lewisburg,3830
21603,2002-2003,2002-12-01,2003-04-01,122,8,42,288,330,74,169,243,573,19,138,West Virginia,Lewisburg,3830
21604,2003-2004,2003-11-29,2004-03-23,116,1,35,293,328,42,122,164,492,14,93,West Virginia,Lewisburg,3830
21605,2004-2005,2004-12-01,2005-04-26,147,8,36,277,313,39,68,107,420,14,73,West Virginia,Lewisburg,3830
21606,2005-2006,2005-11-18,2006-03-26,129,4,24,264,288,32,52,84,372,15,73,West Virginia,Lewisburg,3830
21607,2006-2007,2006-12-01,2007-04-08,129,5,41,269,310,21,44,65,375,9,59,West Virginia,Lewisburg,3830
21608,2007-2008,2007-11-16,2008-03-09,115,0,25,225,250,33,30,63,313,15,81,West Virginia,Lewisburg,3830
21609,2008-2009,2008-11-18,2009-04-08,142,2,50,312,362,32,22,54,416,19,82,West Virginia,Lewisburg,3830
21610,2009-2010,2009-12-01,2010-03-12,102,3,67,283,350,134,408,542,892,31,269,West Virginia,Lewisburg,3830
21611,2010-2011,2010-12-01,2011-03-27,117,0,63,264,327,57,126,183,510,29,182,West Virginia,Lewisburg,3830
21612,2011-2012,2011-10-29,2012-04-23,178,8,13,252,265,26,21,47,312,6,40,West Virginia,Lewisburg,3830
21613,2012-2013,2012-10-30,2013-04-05,158,0,36,292,328,49,54,103,431,16,87,West Virginia,Lewisburg,3830
21614,2013-2014,2013-11-13,2014-03-27,135,0,56,375,431,57,120,177,608,15,117,West Virginia,Lewisburg,3830
21615,2014-2015,2014-11-15,2015-03-29,135,0,55,342,397,54,152,206,603,13,138,West Virginia,Lewisburg,3830
21616,2015-2016,2015-12-01,2016-04-10,132,10,39,237,276,50,97,147,423,10,99,West Virginia,Lewisburg,3830
21617,2016-2017,2016-11-21,2017-03-15,115,3,28,173,201,13,16,29,230,6,33,West Virginia,Lewisburg,3830
21618,2017-2018,2017-12-01,2018-04-10,131,0,54,308,362,38,48,86,448,13,75,West Virginia,Lewisburg,3830
21619,2018-2019,2018-11-28,2019-03-09,102,0,21,192,213,40,48,88,301,17,94,West Virginia,Lewisburg,3830
21620,2019-2020,2019-11-13,2020-03-01,110,0,8,185,193,5,4,9,202,3,14,West Virginia,Lewisburg,3830
21621,1950-1951,1950-11-10,1951-04-13,155,0,193,611,804,103,671,774,1578,44,333,Wisconsin,Appleton,72623
21622,1951-1952,1951-11-02,1952-04-12,163,0,152,516,668,107,514,621,1289,36,283,Wisconsin,Appleton,72623
21623,1952-1953,1952-10-16,1953-03-18,154,0,96,377,473,62,346,408,881,30,174,Wisconsin,Appleton,72623
21624,1953-1954,1953-11-22,1954-05-06,166,0,85,386,471,49,175,224,695,28,146,Wisconsin,Appleton,72623
21625,1954-1955,1954-11-01,1955-03-30,150,0,119,431,550,81,344,425,975,37,202,Wisconsin,Appleton,72623
21626,1955-1956,1955-11-07,1956-04-30,176,1,129,544,673,95,475,570,1243,40,253,Wisconsin,Appleton,72623
21627,1956-1957,1956-11-16,1957-04-10,146,0,140,491,631,67,350,417,1048,37,206,Wisconsin,Appleton,72623
21628,1957-1958,1957-11-08,1958-04-24,168,2,118,432,550,43,299,342,892,27,131,Wisconsin,Appleton,72623
21629,1958-1959,1958-11-21,1959-04-07,138,0,222,608,830,118,638,756,1586,37,338,Wisconsin,Appleton,72623
21630,1959-1960,1959-10-24,1960-05-08,198,2,116,471,587,88,273,361,948,35,204,Wisconsin,Appleton,72623
21631,1960-1961,1960-11-29,1961-04-16,139,0,126,413,539,37,43,80,619,24,167,Wisconsin,Appleton,72623
21632,1961-1962,1961-11-21,1962-03-29,129,0,200,526,726,94,718,812,1538,36,287,Wisconsin,Appleton,72623
21633,1962-1963,1962-10-24,1963-04-23,182,0,226,632,858,85,396,481,1339,41,329,Wisconsin,Appleton,72623
21634,1963-1964,1963-11-30,1964-04-08,131,0,116,449,565,58,112,170,735,35,193,Wisconsin,Appleton,72623
21635,1964-1965,1964-11-19,1965-04-17,150,0,195,581,776,82,243,325,1101,40,287,Wisconsin,Appleton,72623
21636,1965-1966,1965-11-28,1966-03-25,118,0,132,394,526,41,190,231,757,20,158,Wisconsin,Appleton,72623
21637,1966-1967,1966-11-03,1967-03-21,139,0,139,502,641,70,412,482,1123,31,234,Wisconsin,Appleton,72623
21638,1967-1968,1967-10-27,1968-04-24,181,0,139,479,618,31,71,102,720,24,152,Wisconsin,Appleton,72623
21639,1968-1969,1968-11-19,1969-03-31,133,0,135,465,600,60,418,478,1078,22,163,Wisconsin,Appleton,72623
21640,1969-1970,1969-11-14,1970-03-28,135,0,164,514,678,63,426,489,1167,33,234,Wisconsin,Appleton,72623
21641,1970-1971,1970-11-21,1971-04-03,134,0,179,544,723,85,656,741,1464,27,207,Wisconsin,Appleton,72623
21642,1971-1972,1971-11-08,1972-04-07,152,1,171,568,739,94,447,541,1280,34,266,Wisconsin,Appleton,72623
21643,1972-1973,1972-11-15,1973-04-11,148,1,124,399,523,55,269,324,847,25,177,Wisconsin,Appleton,72623
21644,1973-1974,1973-11-05,1974-04-14,161,0,143,452,595,68,306,374,969,39,243,Wisconsin,Appleton,72623
21645,1974-1975,1974-11-13,1975-04-02,141,0,104,428,532,82,369,451,983,43,225,Wisconsin,Appleton,72623
21646,1975-1976,1975-11-21,1976-03-22,123,0,127,465,592,86,590,676,1268,42,288,Wisconsin,Appleton,72623
21647,1976-1977,1976-10-18,1977-04-07,172,0,235,652,887,80,432,512,1399,42,341,Wisconsin,Appleton,72623
21648,1977-1978,1977-11-13,1978-03-19,127,0,195,557,752,87,561,648,1400,35,276,Wisconsin,Appleton,72623
21649,1978-1979,1978-11-19,1979-04-07,140,0,246,627,873,106,883,989,1862,41,332,Wisconsin,Appleton,72623
21650,1979-1980,1979-11-09,1980-04-23,167,0,118,481,599,60,145,205,804,26,159,Wisconsin,Appleton,72623
21651,1980-1981,1980-11-27,1981-03-18,112,0,130,387,517,46,224,270,787,22,170,Wisconsin,Appleton,72623
21652,1981-1982,1981-10-24,1982-04-05,164,1,185,560,745,84,465,549,1294,31,275,Wisconsin,Appleton,72623
21653,1982-1983,1982-11-04,1983-03-28,145,1,77,315,392,47,178,225,617,24,116,Wisconsin,Appleton,72623
21654,1985-1986,1985-11-09,1986-03-25,137,1,209,572,781,84,806,890,1671,28,245,Wisconsin,Appleton,72623
21655,1986-1987,1986-11-10,1987-04-02,144,2,72,367,439,55,143,198,637,25,137,Wisconsin,Appleton,72623
21656,1987-1988,1987-11-20,1988-03-21,123,5,153,436,589,68,437,505,1094,26,206,Wisconsin,Appleton,72623
21657,1988-1989,1988-11-06,1989-04-09,155,10,150,466,616,62,232,294,910,29,207,Wisconsin,Appleton,72623
21658,1989-1990,1989-10-20,1990-05-11,204,1,139,523,662,57,181,238,900,28,213,Wisconsin,Appleton,72623
21659,1990-1991,1990-11-05,1991-04-13,160,0,137,480,617,80,350,430,1047,28,203,Wisconsin,Appleton,72623
21660,1991-1992,1991-10-19,1992-04-14,179,0,95,425,520,67,114,181,701,34,197,Wisconsin,Appleton,72623
21661,1992-1993,1992-10-20,1993-04-20,183,1,120,502,622,71,209,280,902,30,172,Wisconsin,Appleton,72623
21662,1993-1994,1993-11-05,1994-05-01,178,1,223,609,832,85,319,404,1236,29,263,Wisconsin,Appleton,72623
21663,1994-1995,1994-11-26,1995-04-05,131,1,120,398,518,42,158,200,718,22,138,Wisconsin,Appleton,72623
21664,1995-1996,1995-11-03,1996-04-30,180,1,235,667,902,80,417,497,1399,32,241,Wisconsin,Appleton,72623
21665,1996-1997,1996-10-31,1997-05-01,183,0,174,542,716,102,421,523,1239,41,327,Wisconsin,Appleton,72623
21666,1997-1998,1997-10-27,1998-04-16,172,2,80,338,418,54,271,325,743,25,142,Wisconsin,Appleton,72623
21667,1998-1999,1998-11-20,1999-03-11,112,3,122,362,484,46,195,241,725,20,210,Wisconsin,Appleton,72623
21668,1999-2000,1999-12-01,2000-04-13,135,3,94,383,477,51,285,336,813,22,141,Wisconsin,Appleton,72623
21669,2000-2001,2000-11-13,2001-04-16,155,5,184,527,711,65,472,537,1248,36,260,Wisconsin,Appleton,72623
21670,2001-2002,2001-11-28,2002-04-22,146,2,92,344,436,51,158,209,645,27,142,Wisconsin,Appleton,72623
21671,2003-2004,2003-11-08,2004-04-11,156,16,129,403,532,51,269,320,852,28,157,Wisconsin,Appleton,72623
21672,2004-2005,2004-11-25,2005-05-02,159,4,121,445,566,64,266,330,896,29,192,Wisconsin,Appleton,72623
21673,2005-2006,2005-11-16,2006-03-24,129,10,102,398,500,70,290,360,860,34,195,Wisconsin,Appleton,72623
21674,2006-2007,2006-11-11,2007-04-12,153,1,135,419,554,72,286,358,912,34,219,Wisconsin,Appleton,72623
21675,2007-2008,2007-11-17,2008-04-29,165,17,134,430,564,124,675,799,1363,56,305,Wisconsin,Appleton,72623
21676,2008-2009,2008-11-08,2009-04-21,165,3,192,570,762,118,588,706,1468,46,403,Wisconsin,Appleton,72623
21677,2009-2010,2009-12-01,2010-05-08,159,0,104,365,469,76,494,570,1039,40,220,Wisconsin,Appleton,72623
21678,2010-2011,2010-11-21,2011-04-22,153,0,153,485,638,128,604,732,1370,46,340,Wisconsin,Appleton,72623
21679,2011-2012,2011-11-10,2012-03-10,122,0,55,280,335,45,126,171,506,25,128,Wisconsin,Appleton,72623
21680,2012-2013,2012-11-13,2013-04-15,154,0,118,450,568,106,479,585,1153,46,283,Wisconsin,Appleton,72623
21681,2013-2014,2013-11-13,2014-04-16,155,0,280,717,997,105,735,840,1837,54,516,Wisconsin,Appleton,72623
21682,2014-2015,2014-11-09,2015-03-28,140,0,180,515,695,59,314,373,1068,36,267,Wisconsin,Appleton,72623
21683,2015-2016,2015-11-22,2016-04-13,144,0,91,337,428,76,370,446,874,30,193,Wisconsin,Appleton,72623
21684,2016-2017,2016-11-19,2017-03-17,119,0,114,350,464,67,298,365,829,28,173,Wisconsin,Appleton,72623
21685,2017-2018,2017-11-11,2018-04-23,164,0,167,523,690,92,281,373,1063,40,297,Wisconsin,Appleton,72623
21686,2018-2019,2018-11-09,2019-04-13,156,0,173,515,688,111,439,550,1238,41,312,Wisconsin,Appleton,72623
21687,2019-2020,2019-10-29,2020-04-13,168,0,87,399,486,89,414,503,989,33,178,Wisconsin,Appleton,72623
21688,1950-1951,1950-11-08,1951-04-05,149,0,267,813,1080,95,791,886,1966,46,386,Wisconsin,Eau Claire,65883
21689,1951-1952,1951-10-31,1952-04-13,166,0,211,730,941,88,593,681,1622,36,314,Wisconsin,Eau Claire,65883
21690,1952-1953,1952-10-16,1953-04-18,185,0,148,606,754,53,406,459,1213,28,209,Wisconsin,Eau Claire,65883
21691,1953-1954,1953-11-22,1954-04-03,133,0,136,562,698,37,271,308,1006,28,201,Wisconsin,Eau Claire,65883
21692,1954-1955,1954-10-31,1955-03-29,150,0,186,637,823,46,474,520,1343,37,239,Wisconsin,Eau Claire,65883
21693,1955-1956,1955-10-29,1956-04-30,185,2,210,824,1034,69,570,639,1673,44,252,Wisconsin,Eau Claire,65883
21694,1956-1957,1956-11-15,1957-04-11,148,0,195,669,864,46,440,486,1350,26,198,Wisconsin,Eau Claire,65883
21695,1957-1958,1957-11-08,1958-04-07,151,0,161,562,723,41,299,340,1063,24,141,Wisconsin,Eau Claire,65883
21696,1958-1959,1958-11-23,1959-03-21,119,0,239,722,961,31,211,242,1203,22,195,Wisconsin,Eau Claire,65883
21697,1959-1960,1959-10-12,1960-05-09,211,0,151,639,790,49,221,270,1060,31,212,Wisconsin,Eau Claire,65883
21698,1960-1961,1960-11-05,1961-04-16,163,0,145,608,753,47,140,187,940,23,163,Wisconsin,Eau Claire,65883
21699,1961-1962,1961-11-06,1962-04-16,162,0,243,732,975,107,753,860,1835,45,423,Wisconsin,Eau Claire,65883
21700,1962-1963,1962-10-25,1963-04-23,181,0,248,711,959,65,393,458,1417,48,428,Wisconsin,Eau Claire,65883
21701,1963-1964,1963-11-23,1964-04-07,137,0,164,578,742,40,219,259,1001,28,179,Wisconsin,Eau Claire,65883
21702,1964-1965,1964-10-28,1965-04-27,182,2,274,825,1099,98,487,585,1684,38,354,Wisconsin,Eau Claire,65883
21703,1965-1966,1965-11-13,1966-04-20,159,0,212,629,841,62,286,348,1189,32,241,Wisconsin,Eau Claire,65883
21704,1966-1967,1966-11-01,1967-03-29,149,0,194,680,874,93,626,719,1593,38,367,Wisconsin,Eau Claire,65883
21705,1967-1968,1967-11-04,1968-04-24,173,0,173,602,775,35,155,190,965,27,170,Wisconsin,Eau Claire,65883
21706,1968-1969,1968-11-19,1969-04-28,161,0,208,651,859,118,900,1018,1877,39,376,Wisconsin,Eau Claire,65883
21707,1969-1970,1969-11-13,1970-04-20,159,0,219,729,948,79,665,744,1692,37,310,Wisconsin,Eau Claire,65883
21708,1970-1971,1970-11-14,1971-04-28,166,0,217,705,922,110,736,846,1768,43,356,Wisconsin,Eau Claire,65883
21709,1971-1972,1971-11-06,1972-04-22,169,0,241,744,985,96,804,900,1885,41,344,Wisconsin,Eau Claire,65883
21710,1972-1973,1972-11-13,1973-04-16,155,0,180,541,721,83,518,601,1322,27,240,Wisconsin,Eau Claire,65883
21711,1973-1974,1973-11-04,1974-04-06,154,0,195,616,811,71,491,562,1373,36,243,Wisconsin,Eau Claire,65883
21712,1974-1975,1974-11-12,1975-04-07,147,0,154,612,766,83,571,654,1420,40,279,Wisconsin,Eau Claire,65883
21713,1975-1976,1975-11-13,1976-03-30,139,0,182,579,761,65,325,390,1151,26,237,Wisconsin,Eau Claire,65883
21714,1976-1977,1976-10-21,1977-04-04,166,0,297,809,1106,80,317,397,1503,38,372,Wisconsin,Eau Claire,65883
21715,1977-1978,1977-11-10,1978-04-20,162,0,270,749,1019,80,544,624,1643,38,339,Wisconsin,Eau Claire,65883
21716,1978-1979,1978-11-15,1979-04-08,145,0,319,785,1104,92,939,1031,2135,44,410,Wisconsin,Eau Claire,65883
21717,1979-1980,1979-11-07,1980-04-11,157,0,180,609,789,65,272,337,1126,30,200,Wisconsin,Eau Claire,65883
21718,1980-1981,1980-11-17,1981-03-06,110,0,169,493,662,34,120,154,816,21,167,Wisconsin,Eau Claire,65883
21719,1981-1982,1981-10-22,1982-04-20,181,1,263,734,997,85,642,727,1724,41,362,Wisconsin,Eau Claire,65883
21720,1982-1983,1982-10-20,1983-04-15,178,0,110,446,556,74,400,474,1030,39,195,Wisconsin,Eau Claire,65883
21721,1983-1984,1983-11-09,1984-03-23,136,3,261,644,905,75,651,726,1631,42,300,Wisconsin,Eau Claire,65883
21722,1984-1985,1984-11-02,1985-04-08,158,0,194,609,803,81,407,488,1291,34,276,Wisconsin,Eau Claire,65883
21723,1985-1986,1985-11-08,1986-03-24,137,0,246,704,950,88,901,989,1939,37,330,Wisconsin,Eau Claire,65883
21724,1986-1987,1986-11-09,1987-03-31,143,0,97,439,536,40,129,169,705,22,120,Wisconsin,Eau Claire,65883
21725,1987-1988,1987-10-22,1988-04-27,189,0,186,627,813,49,274,323,1136,30,233,Wisconsin,Eau Claire,65883
21726,1988-1989,1988-11-05,1989-04-09,156,0,192,651,843,76,399,475,1318,34,299,Wisconsin,Eau Claire,65883
21727,1989-1990,1989-11-02,1990-04-16,166,0,163,634,797,61,242,303,1100,32,250,Wisconsin,Eau Claire,65883
21728,1990-1991,1990-10-18,1991-04-12,177,0,168,555,723,63,402,465,1188,33,227,Wisconsin,Eau Claire,65883
21729,1991-1992,1991-11-01,1992-04-13,165,0,129,506,635,78,512,590,1225,35,226,Wisconsin,Eau Claire,65883
21730,1992-1993,1992-10-16,1993-04-16,183,0,167,572,739,78,518,596,1335,43,208,Wisconsin,Eau Claire,65883
21731,1993-1994,1993-11-05,1994-04-29,176,0,258,670,928,81,393,474,1402,47,400,Wisconsin,Eau Claire,65883
21732,1994-1995,1994-11-26,1995-04-21,147,0,136,475,611,68,330,398,1009,35,206,Wisconsin,Eau Claire,65883
21733,1995-1996,1995-10-21,1996-04-15,178,0,252,747,999,125,673,798,1797,54,421,Wisconsin,Eau Claire,65883
21734,1996-1997,1996-10-31,1997-04-08,160,0,221,624,845,134,739,873,1718,61,520,Wisconsin,Eau Claire,65883
21735,1997-1998,1997-11-02,1998-03-22,141,0,89,374,463,89,250,339,802,48,254,Wisconsin,Eau Claire,65883
21736,1998-1999,1998-11-08,1999-03-13,126,0,141,429,570,70,413,483,1053,34,303,Wisconsin,Eau Claire,65883
21737,1999-2000,1999-12-01,2000-04-11,133,6,104,453,557,57,303,360,917,24,185,Wisconsin,Eau Claire,65883
21738,2000-2001,2000-11-08,2001-04-16,160,5,235,686,921,78,708,786,1707,35,286,Wisconsin,Eau Claire,65883
21739,2001-2002,2001-11-27,2002-04-28,153,3,97,398,495,96,236,332,827,45,304,Wisconsin,Eau Claire,65883
21740,2002-2003,2002-10-20,2003-04-05,168,0,177,591,768,62,117,179,947,48,366,Wisconsin,Eau Claire,65883
21741,2003-2004,2003-11-04,2004-03-22,140,0,153,507,660,89,344,433,1093,43,305,Wisconsin,Eau Claire,65883
21742,2004-2005,2004-11-27,2005-03-27,121,0,131,471,602,85,247,332,934,46,308,Wisconsin,Eau Claire,65883
21743,2005-2006,2005-11-15,2006-03-26,132,0,108,417,525,59,174,233,758,29,158,Wisconsin,Eau Claire,65883
21744,2006-2007,2006-11-10,2007-04-12,154,1,153,472,625,69,242,311,936,28,205,Wisconsin,Eau Claire,65883
21745,2007-2008,2007-11-09,2008-04-28,172,0,219,666,885,89,604,693,1578,40,296,Wisconsin,Eau Claire,65883
21746,2008-2009,2008-11-08,2009-04-05,149,0,228,697,925,78,399,477,1402,46,402,Wisconsin,Eau Claire,65883
21747,2009-2010,2009-10-10,2010-03-10,152,5,152,501,653,57,496,553,1206,28,178,Wisconsin,Eau Claire,65883
21748,2010-2011,2010-11-13,2011-04-20,159,3,217,616,833,99,858,957,1790,40,322,Wisconsin,Eau Claire,65883
21749,2011-2012,2011-11-10,2012-04-16,159,0,80,366,446,42,152,194,640,28,152,Wisconsin,Eau Claire,65883
21750,2012-2013,2012-11-06,2013-05-04,180,0,161,573,734,135,543,678,1412,52,335,Wisconsin,Eau Claire,65883
21751,2013-2014,2013-11-11,2014-04-14,155,0,315,809,1124,118,785,903,2027,55,505,Wisconsin,Eau Claire,65883
21752,2014-2015,2014-10-04,2015-04-10,189,0,229,608,837,67,372,439,1276,39,285,Wisconsin,Eau Claire,65883
21753,2015-2016,2015-10-28,2016-04-02,158,0,120,381,501,69,272,341,842,39,220,Wisconsin,Eau Claire,65883
21754,2016-2017,2016-11-20,2017-04-11,143,0,146,428,574,78,345,423,997,30,223,Wisconsin,Eau Claire,65883
21755,2017-2018,2017-10-27,2018-04-21,177,0,218,681,899,95,451,546,1445,46,358,Wisconsin,Eau Claire,65883
21756,2018-2019,2018-10-14,2019-04-15,184,0,227,655,882,147,503,650,1532,50,413,Wisconsin,Eau Claire,65883
21757,2019-2020,2019-10-28,2020-04-17,173,0,110,505,615,101,583,684,1299,43,252,Wisconsin,Eau Claire,65883
21758,1950-1951,1950-11-10,1951-04-02,144,0,214,646,860,82,520,602,1462,42,317,Wisconsin,Green Bay,104057
21759,1951-1952,1951-11-02,1952-04-14,165,0,158,605,763,81,352,433,1196,45,333,Wisconsin,Green Bay,104057
21760,1952-1953,1952-11-22,1953-04-16,146,0,102,427,529,65,260,325,854,37,210,Wisconsin,Green Bay,104057
21761,1953-1954,1953-11-22,1954-05-06,166,0,97,446,543,51,96,147,690,42,229,Wisconsin,Green Bay,104057
21762,1954-1955,1954-11-01,1955-03-30,150,0,139,518,657,63,205,268,925,35,196,Wisconsin,Green Bay,104057
21763,1955-1956,1955-11-06,1956-04-30,177,0,143,639,782,69,250,319,1101,42,246,Wisconsin,Green Bay,104057
21764,1956-1957,1956-11-16,1957-04-11,147,0,164,553,717,50,218,268,985,36,186,Wisconsin,Green Bay,104057
21765,1957-1958,1957-11-05,1958-04-24,171,0,133,469,602,42,155,197,799,32,148,Wisconsin,Green Bay,104057
21766,1958-1959,1958-11-21,1959-04-08,139,0,241,677,918,92,410,502,1420,39,314,Wisconsin,Green Bay,104057
21767,1959-1960,1959-10-24,1960-05-09,199,0,132,540,672,78,187,265,937,46,240,Wisconsin,Green Bay,104057
21768,1960-1961,1960-11-29,1961-04-16,139,0,145,425,570,34,51,85,655,23,150,Wisconsin,Green Bay,104057
21769,1961-1962,1961-11-21,1962-03-30,130,0,216,579,795,91,651,742,1537,44,335,Wisconsin,Green Bay,104057
21770,1962-1963,1962-10-24,1963-04-23,182,0,235,646,881,78,398,476,1357,46,390,Wisconsin,Green Bay,104057
21771,1963-1964,1963-11-24,1964-04-08,137,0,156,525,681,49,89,138,819,34,204,Wisconsin,Green Bay,104057
21772,1964-1965,1964-11-20,1965-04-17,149,0,207,567,774,79,222,301,1075,43,290,Wisconsin,Green Bay,104057
21773,1965-1966,1965-11-14,1966-04-26,164,0,144,477,621,49,185,234,855,34,206,Wisconsin,Green Bay,104057
21774,1966-1967,1966-11-03,1967-04-06,155,0,145,531,676,71,415,486,1162,37,250,Wisconsin,Green Bay,104057
21775,1967-1968,1967-10-25,1968-04-04,163,0,154,510,664,45,96,141,805,36,223,Wisconsin,Green Bay,104057
21776,1968-1969,1968-11-18,1969-03-31,134,0,162,512,674,61,414,475,1149,27,161,Wisconsin,Green Bay,104057
21777,1969-1970,1969-10-21,1970-03-28,159,0,202,624,826,65,434,499,1325,37,284,Wisconsin,Green Bay,104057
21778,1970-1971,1970-11-14,1971-04-03,141,0,215,633,848,102,727,829,1677,50,368,Wisconsin,Green Bay,104057
21779,1971-1972,1971-11-08,1972-04-22,167,0,191,627,818,112,430,542,1360,49,344,Wisconsin,Green Bay,104057
21780,1972-1973,1972-11-15,1973-04-13,150,0,126,420,546,60,257,317,863,34,214,Wisconsin,Green Bay,104057
21781,1973-1974,1973-11-05,1974-04-14,161,0,164,495,659,84,275,359,1018,43,287,Wisconsin,Green Bay,104057
21782,1974-1975,1974-11-13,1975-04-03,142,0,117,497,614,84,375,459,1073,46,257,Wisconsin,Green Bay,104057
21783,1975-1976,1975-11-13,1976-05-07,177,0,134,518,652,101,514,615,1267,53,357,Wisconsin,Green Bay,104057
21784,1976-1977,1976-10-18,1977-04-09,174,0,265,728,993,88,317,405,1398,47,392,Wisconsin,Green Bay,104057
21785,1977-1978,1977-11-10,1978-03-25,136,0,231,645,876,99,534,633,1509,41,343,Wisconsin,Green Bay,104057
21786,1978-1979,1978-11-19,1979-04-09,142,0,265,661,926,113,732,845,1771,53,415,Wisconsin,Green Bay,104057
21787,1979-1980,1979-11-09,1980-04-24,168,0,131,487,618,66,97,163,781,40,251,Wisconsin,Green Bay,104057
21788,1980-1981,1980-11-12,1981-03-18,127,0,151,438,589,49,240,289,878,27,198,Wisconsin,Green Bay,104057
21789,1981-1982,1981-10-24,1982-04-20,179,0,204,611,815,85,504,589,1404,43,307,Wisconsin,Green Bay,104057
21790,1982-1983,1982-11-04,1983-04-03,151,0,94,344,438,61,215,276,714,32,153,Wisconsin,Green Bay,104057
21791,1983-1984,1983-11-24,1984-03-23,121,0,215,513,728,70,374,444,1172,43,287,Wisconsin,Green Bay,104057
21792,1984-1985,1984-11-02,1985-04-17,167,0,158,499,657,108,327,435,1092,50,344,Wisconsin,Green Bay,104057
21793,1985-1986,1985-11-08,1986-04-15,159,0,209,594,803,95,815,910,1713,45,346,Wisconsin,Green Bay,104057
21794,1986-1987,1986-11-10,1987-04-04,146,0,84,380,464,56,181,237,701,27,151,Wisconsin,Green Bay,104057
21795,1987-1988,1987-11-18,1988-04-23,158,0,156,488,644,77,436,513,1157,37,261,Wisconsin,Green Bay,104057
21796,1988-1989,1988-11-05,1989-04-09,156,0,147,513,660,84,231,315,975,36,264,Wisconsin,Green Bay,104057
21797,1989-1990,1989-10-19,1990-05-11,205,0,139,509,648,70,240,310,958,34,214,Wisconsin,Green Bay,104057
21798,1990-1991,1990-11-05,1991-04-13,160,0,132,470,602,82,353,435,1037,29,202,Wisconsin,Green Bay,104057
21799,1991-1992,1991-11-02,1992-04-11,162,0,90,411,501,73,101,174,675,42,217,Wisconsin,Green Bay,104057
21800,1992-1993,1992-10-20,1993-04-20,183,0,121,478,599,94,220,314,913,52,235,Wisconsin,Green Bay,104057
21801,1993-1994,1993-11-05,1994-04-30,177,0,209,566,775,95,330,425,1200,41,317,Wisconsin,Green Bay,104057
21802,1994-1995,1994-11-27,1995-04-07,132,0,95,358,453,52,141,193,646,27,135,Wisconsin,Green Bay,104057
21803,1995-1996,1995-11-04,1996-04-30,179,0,207,632,839,117,438,555,1394,51,346,Wisconsin,Green Bay,104057
21804,1996-1997,1996-11-09,1997-05-01,174,0,158,538,696,119,424,543,1239,48,341,Wisconsin,Green Bay,104057
21805,1997-1998,1997-10-26,1998-04-16,173,0,77,337,414,76,264,340,754,43,200,Wisconsin,Green Bay,104057
21806,1998-1999,1998-11-15,1999-03-10,116,0,114,354,468,54,198,252,720,31,254,Wisconsin,Green Bay,104057
21807,1999-2000,1999-12-01,2000-04-11,133,0,105,426,531,61,310,371,902,36,245,Wisconsin,Green Bay,104057
21808,2000-2001,2000-11-13,2001-04-16,155,0,170,541,711,90,509,599,1310,51,344,Wisconsin,Green Bay,104057
21809,2001-2002,2001-12-01,2002-04-22,143,0,75,323,398,74,168,242,640,37,206,Wisconsin,Green Bay,104057
21810,2002-2003,2002-10-18,2003-04-09,174,0,160,536,696,72,188,260,956,45,274,Wisconsin,Green Bay,104057
21811,2003-2004,2003-11-07,2004-04-11,157,1,126,441,567,72,263,335,902,42,257,Wisconsin,Green Bay,104057
21812,2004-2005,2004-11-24,2005-03-26,123,2,121,421,542,89,262,351,893,42,268,Wisconsin,Green Bay,104057
21813,2005-2006,2005-11-16,2006-03-23,128,0,96,365,461,67,278,345,806,36,201,Wisconsin,Green Bay,104057
21814,2006-2007,2006-11-10,2007-04-12,154,0,120,377,497,72,259,331,828,33,203,Wisconsin,Green Bay,104057
21815,2007-2008,2007-11-21,2008-04-28,160,0,168,515,683,138,616,754,1437,63,424,Wisconsin,Green Bay,104057
21816,2008-2009,2008-11-08,2009-04-21,165,0,202,611,813,123,558,681,1494,49,399,Wisconsin,Green Bay,104057
21817,2009-2010,2009-12-01,2010-05-08,159,0,117,381,498,78,446,524,1022,35,203,Wisconsin,Green Bay,104057
21818,2010-2011,2010-11-24,2011-04-21,149,0,155,495,650,138,575,713,1363,45,337,Wisconsin,Green Bay,104057
21819,2011-2012,2011-11-09,2012-03-08,121,0,46,260,306,50,110,160,466,27,143,Wisconsin,Green Bay,104057
21820,2012-2013,2012-11-24,2013-04-14,142,0,113,433,546,111,456,567,1113,45,286,Wisconsin,Green Bay,104057
21821,2013-2014,2013-11-12,2014-04-15,155,0,277,726,1003,110,696,806,1809,47,492,Wisconsin,Green Bay,104057
21822,2014-2015,2014-11-09,2015-03-27,139,0,186,508,694,55,283,338,1032,36,255,Wisconsin,Green Bay,104057
21823,2015-2016,2015-11-21,2016-04-09,141,0,91,317,408,78,330,408,816,34,210,Wisconsin,Green Bay,104057
21824,2016-2017,2016-11-19,2017-03-30,132,0,98,310,408,73,250,323,731,27,158,Wisconsin,Green Bay,104057
21825,2017-2018,2017-11-10,2018-04-23,165,0,164,494,658,108,298,406,1064,43,315,Wisconsin,Green Bay,104057
21826,2018-2019,2018-11-09,2019-04-12,155,0,156,460,616,109,381,490,1106,41,282,Wisconsin,Green Bay,104057
21827,2019-2020,2019-10-28,2020-04-13,169,0,84,366,450,91,366,457,907,40,195,Wisconsin,Green Bay,104057
21828,1950-1951,1950-11-10,1951-04-02,144,0,223,680,903,99,592,691,1594,36,307,Wisconsin,La Crosse,51320
21829,1951-1952,1951-11-01,1952-04-13,165,0,161,554,715,96,398,494,1209,41,316,Wisconsin,La Crosse,51320
21830,1952-1953,1952-10-16,1953-03-24,160,0,109,429,538,56,447,503,1041,34,194,Wisconsin,La Crosse,51320
21831,1953-1954,1953-11-25,1954-04-03,130,0,91,399,490,34,66,100,590,21,122,Wisconsin,La Crosse,51320
21832,1954-1955,1954-11-01,1955-03-30,150,0,142,475,617,50,235,285,902,34,207,Wisconsin,La Crosse,51320
21833,1955-1956,1955-11-03,1956-04-30,180,0,162,650,812,81,490,571,1383,42,279,Wisconsin,La Crosse,51320
21834,1956-1957,1956-11-15,1957-04-04,141,0,136,479,615,43,109,152,767,27,157,Wisconsin,La Crosse,51320
21835,1957-1958,1957-11-08,1958-03-19,132,0,128,416,544,40,155,195,739,19,104,Wisconsin,La Crosse,51320
21836,1958-1959,1958-11-23,1959-04-01,130,0,212,631,843,112,496,608,1451,35,347,Wisconsin,La Crosse,51320
21837,1959-1960,1959-10-12,1960-05-07,209,0,131,488,619,57,158,215,834,34,206,Wisconsin,La Crosse,51320
21838,1960-1961,1960-11-05,1961-04-17,164,0,127,445,572,52,113,165,737,25,164,Wisconsin,La Crosse,51320
21839,1961-1962,1961-11-16,1962-04-13,149,0,202,553,755,114,504,618,1373,42,343,Wisconsin,La Crosse,51320
21840,1962-1963,1962-11-23,1963-04-22,151,2,213,549,762,66,318,384,1146,36,289,Wisconsin,La Crosse,51320
21841,1963-1964,1963-11-22,1964-04-01,132,0,135,447,582,54,126,180,762,28,165,Wisconsin,La Crosse,51320
21842,1964-1965,1964-11-19,1965-04-17,150,0,211,689,900,69,223,292,1192,29,255,Wisconsin,La Crosse,51320
21843,1965-1966,1965-11-18,1966-03-26,129,0,139,473,612,36,181,217,829,21,151,Wisconsin,La Crosse,51320
21844,1966-1967,1966-11-11,1967-03-23,133,0,124,525,649,74,393,467,1116,29,237,Wisconsin,La Crosse,51320
21845,1967-1968,1967-11-05,1968-03-22,139,0,121,434,555,18,28,46,601,15,78,Wisconsin,La Crosse,51320
21846,1968-1969,1968-11-19,1969-04-01,134,0,166,527,693,72,635,707,1400,28,245,Wisconsin,La Crosse,51320
21847,1969-1970,1969-11-14,1970-03-28,135,0,169,534,703,60,442,502,1205,27,225,Wisconsin,La Crosse,51320
21848,1970-1971,1970-11-14,1971-04-03,141,0,201,620,821,100,609,709,1530,36,291,Wisconsin,La Crosse,51320
21849,1971-1972,1971-11-06,1972-04-08,155,0,181,562,743,74,373,447,1190,33,233,Wisconsin,La Crosse,51320
21850,1972-1973,1972-11-22,1973-04-16,146,0,139,416,555,79,257,336,891,28,209,Wisconsin,La Crosse,51320
21851,1973-1974,1973-11-05,1974-04-14,161,0,149,495,644,59,271,330,974,32,194,Wisconsin,La Crosse,51320
21852,1974-1975,1974-11-14,1975-04-10,148,0,119,490,609,106,515,621,1230,40,251,Wisconsin,La Crosse,51320
21853,1975-1976,1975-11-21,1976-03-16,117,0,113,439,552,34,148,182,734,21,137,Wisconsin,La Crosse,51320
21854,1976-1977,1976-10-19,1977-04-04,168,0,245,665,910,47,278,325,1235,29,208,Wisconsin,La Crosse,51320
21855,1977-1978,1977-11-09,1978-03-21,133,9,245,682,927,77,599,676,1603,34,332,Wisconsin,La Crosse,51320
21856,1978-1979,1978-11-19,1979-04-05,138,0,220,623,843,93,759,852,1695,41,329,Wisconsin,La Crosse,51320
21857,1979-1980,1979-11-09,1980-04-10,154,0,122,464,586,51,150,201,787,24,144,Wisconsin,La Crosse,51320
21858,1980-1981,1980-11-24,1981-03-11,108,0,120,400,520,36,77,113,633,18,135,Wisconsin,La Crosse,51320
21859,1981-1982,1981-10-24,1982-04-09,168,0,207,627,834,54,520,574,1408,27,223,Wisconsin,La Crosse,51320
21860,1982-1983,1982-10-20,1983-04-09,172,0,101,403,504,61,198,259,763,30,151,Wisconsin,La Crosse,51320
21861,1983-1984,1983-11-12,1984-03-23,133,0,217,555,772,48,374,422,1194,26,187,Wisconsin,La Crosse,51320
21862,1984-1985,1984-11-02,1985-04-02,152,0,168,543,711,66,282,348,1059,33,241,Wisconsin,La Crosse,51320
21863,1986-1987,1986-11-09,1987-03-31,143,0,73,356,429,57,206,263,692,20,117,Wisconsin,La Crosse,51320
21864,1987-1988,1987-11-20,1988-03-20,122,0,157,432,589,54,320,374,963,21,190,Wisconsin,La Crosse,51320
21865,1988-1989,1988-11-06,1989-04-09,155,0,149,513,662,64,176,240,902,25,211,Wisconsin,La Crosse,51320
21866,1989-1990,1989-11-03,1990-03-23,141,0,119,448,567,47,111,158,725,21,172,Wisconsin,La Crosse,51320
21867,1990-1991,1990-11-08,1991-04-12,156,11,131,470,601,73,398,471,1072,21,180,Wisconsin,La Crosse,51320
21868,1991-1992,1991-10-18,1992-03-29,164,0,84,402,486,93,255,348,834,36,231,Wisconsin,La Crosse,51320
21869,1992-1993,1992-10-19,1993-04-19,183,0,130,503,633,89,355,444,1077,43,231,Wisconsin,La Crosse,51320
21870,1993-1994,1993-10-30,1994-04-05,158,0,196,583,779,72,312,384,1163,35,289,Wisconsin,La Crosse,51320
21871,1994-1995,1994-11-27,1995-04-11,136,0,100,366,466,49,100,149,615,27,156,Wisconsin,La Crosse,51320
21872,1995-1996,1995-10-31,1996-04-15,168,0,188,624,812,91,381,472,1284,36,281,Wisconsin,La Crosse,51320
21873,1996-1997,1996-11-09,1997-04-30,173,0,162,502,664,102,390,492,1156,48,332,Wisconsin,La Crosse,51320
21874,1997-1998,1997-11-02,1998-04-16,166,3,60,287,347,60,192,252,599,36,150,Wisconsin,La Crosse,51320
21875,1998-1999,1998-11-08,1999-03-11,124,0,105,340,445,68,240,308,753,29,260,Wisconsin,La Crosse,51320
21876,1999-2000,1999-10-01,2000-04-11,194,0,80,366,446,43,167,210,656,30,144,Wisconsin,La Crosse,51320
21877,2000-2001,2000-11-13,2001-04-16,155,0,191,576,767,78,578,656,1423,40,286,Wisconsin,La Crosse,51320
21878,2001-2002,2001-12-01,2002-04-27,148,0,67,302,369,57,80,137,506,32,173,Wisconsin,La Crosse,51320
21879,2002-2003,2002-10-24,2003-04-08,167,0,138,498,636,52,109,161,797,32,188,Wisconsin,La Crosse,51320
21880,2003-2004,2003-11-07,2004-03-17,132,0,108,383,491,57,211,268,759,33,179,Wisconsin,La Crosse,51320
21881,2004-2005,2004-11-27,2005-03-26,120,0,104,383,487,74,210,284,771,27,162,Wisconsin,La Crosse,51320
21882,2005-2006,2005-11-15,2006-03-18,124,0,86,345,431,65,190,255,686,30,156,Wisconsin,La Crosse,51320
21883,2006-2007,2006-11-10,2007-04-12,154,0,117,409,526,74,274,348,874,21,164,Wisconsin,La Crosse,51320
21884,2007-2008,2007-11-17,2008-04-28,164,0,181,562,743,104,580,684,1427,40,320,Wisconsin,La Crosse,51320
21885,2008-2009,2008-11-16,2009-03-28,133,0,181,587,768,83,413,496,1264,34,294,Wisconsin,La Crosse,51320
21886,2009-2010,2009-10-12,2010-03-11,151,0,146,441,587,63,516,579,1166,25,172,Wisconsin,La Crosse,51320
21887,2010-2011,2010-11-23,2011-04-20,149,0,164,507,671,97,623,720,1391,40,279,Wisconsin,La Crosse,51320
21888,2011-2012,2011-11-09,2012-03-04,117,0,57,273,330,33,144,177,507,20,113,Wisconsin,La Crosse,51320
21889,2012-2013,2012-11-12,2013-05-02,172,0,120,468,588,92,385,477,1065,42,255,Wisconsin,La Crosse,51320
21890,2013-2014,2013-11-11,2014-04-14,155,0,244,682,926,79,597,676,1602,47,399,Wisconsin,La Crosse,51320
21891,2014-2015,2014-11-11,2015-04-22,163,0,155,484,639,61,307,368,1007,35,207,Wisconsin,La Crosse,51320
21892,2015-2016,2015-11-20,2016-04-02,135,0,83,295,378,63,270,333,711,30,162,Wisconsin,La Crosse,51320
21893,2016-2017,2016-12-01,2017-03-16,106,0,91,279,370,55,275,330,700,21,130,Wisconsin,La Crosse,51320
21894,2017-2018,2017-11-10,2018-04-20,162,0,137,489,626,81,183,264,890,37,282,Wisconsin,La Crosse,51320
21895,2018-2019,2018-10-14,2019-04-27,196,0,160,506,666,99,415,514,1180,42,315,Wisconsin,La Crosse,51320
21896,2019-2020,2019-11-06,2020-04-13,160,0,72,359,431,61,276,337,768,30,157,Wisconsin,La Crosse,51320
21897,1950-1951,1950-11-10,1951-04-13,155,0,182,610,792,90,568,658,1450,40,314,Wisconsin,Madison,233209
21898,1951-1952,1951-10-24,1952-04-12,172,0,124,494,618,84,265,349,967,41,277,Wisconsin,Madison,233209
21899,1952-1953,1952-10-16,1953-04-19,186,0,80,382,462,51,98,149,611,31,148,Wisconsin,Madison,233209
21900,1953-1954,1953-11-26,1954-04-03,129,0,69,350,419,39,48,87,506,27,135,Wisconsin,Madison,233209
21901,1954-1955,1954-11-01,1955-03-27,147,0,113,448,561,61,176,237,798,35,196,Wisconsin,Madison,233209
21902,1955-1956,1955-11-03,1956-04-06,156,0,101,508,609,52,105,157,766,36,193,Wisconsin,Madison,233209
21903,1956-1957,1956-11-16,1957-04-05,141,0,109,451,560,52,124,176,736,28,148,Wisconsin,Madison,233209
21904,1957-1958,1957-11-08,1958-04-06,150,0,114,420,534,40,113,153,687,31,145,Wisconsin,Madison,233209
21905,1958-1959,1958-11-23,1959-04-08,137,0,186,630,816,99,449,548,1364,38,322,Wisconsin,Madison,233209
21906,1959-1960,1959-11-05,1960-04-17,165,0,132,543,675,81,336,417,1092,41,285,Wisconsin,Madison,233209
21907,1960-1961,1960-11-05,1961-04-17,164,0,106,471,577,39,56,95,672,21,131,Wisconsin,Madison,233209
21908,1961-1962,1961-10-19,1962-04-13,177,0,197,562,759,76,485,561,1320,40,291,Wisconsin,Madison,233209
21909,1962-1963,1962-10-24,1963-04-23,182,0,226,636,862,66,231,297,1159,39,299,Wisconsin,Madison,233209
21910,1963-1964,1963-11-30,1964-04-08,131,0,121,483,604,51,115,166,770,26,159,Wisconsin,Madison,233209
21911,1964-1965,1964-10-06,1965-04-17,194,0,171,596,767,78,202,280,1047,40,281,Wisconsin,Madison,233209
21912,1965-1966,1965-11-27,1966-05-11,166,0,134,492,626,43,150,193,819,24,157,Wisconsin,Madison,233209
21913,1966-1967,1966-11-03,1967-03-22,140,0,117,486,603,63,283,346,949,33,227,Wisconsin,Madison,233209
21914,1967-1968,1967-10-26,1968-04-24,182,0,115,481,596,29,34,63,659,27,164,Wisconsin,Madison,233209
21915,1968-1969,1968-11-18,1969-03-31,134,0,139,462,601,64,208,272,873,39,216,Wisconsin,Madison,233209
21916,1969-1970,1969-11-13,1970-04-02,141,0,167,556,723,65,367,432,1155,37,283,Wisconsin,Madison,233209
21917,1970-1971,1970-11-23,1971-04-03,132,0,164,549,713,107,621,728,1441,40,269,Wisconsin,Madison,233209
21918,1971-1972,1971-11-08,1972-04-08,153,0,143,564,707,83,218,301,1008,43,287,Wisconsin,Madison,233209
21919,1972-1973,1972-11-13,1973-04-14,153,0,113,412,525,77,159,236,761,39,235,Wisconsin,Madison,233209
21920,1973-1974,1973-11-15,1974-04-14,151,0,139,455,594,73,203,276,870,46,316,Wisconsin,Madison,233209
21921,1974-1975,1974-11-12,1975-04-09,149,0,84,453,537,98,276,374,911,55,255,Wisconsin,Madison,233209
21922,1975-1976,1975-11-12,1976-03-16,126,0,92,407,499,56,125,181,680,35,187,Wisconsin,Madison,233209
21923,1976-1977,1976-11-07,1977-04-05,150,0,213,668,881,52,177,229,1110,41,335,Wisconsin,Madison,233209
21924,1977-1978,1977-11-21,1978-04-02,133,0,211,615,826,89,575,664,1490,41,338,Wisconsin,Madison,233209
21925,1978-1979,1978-11-19,1979-04-27,160,0,217,632,849,116,805,921,1770,55,425,Wisconsin,Madison,233209
21926,1979-1980,1979-10-23,1980-04-15,176,0,133,527,660,57,122,179,839,38,247,Wisconsin,Madison,233209
21927,1980-1981,1980-11-27,1981-03-11,105,0,101,371,472,46,108,154,626,27,190,Wisconsin,Madison,233209
21928,1981-1982,1981-10-24,1982-04-11,170,0,183,614,797,85,416,501,1298,44,373,Wisconsin,Madison,233209
21929,1982-1983,1982-11-04,1983-04-16,164,0,86,395,481,64,155,219,700,35,178,Wisconsin,Madison,233209
21930,1983-1984,1983-11-24,1984-04-23,152,0,193,513,706,69,404,473,1179,40,249,Wisconsin,Madison,233209
21931,1984-1985,1984-11-02,1985-04-07,157,0,137,495,632,86,357,443,1075,46,332,Wisconsin,Madison,233209
21932,1985-1986,1985-11-08,1986-04-15,159,0,189,551,740,115,763,878,1618,48,383,Wisconsin,Madison,233209
21933,1986-1987,1986-11-10,1987-03-31,142,0,68,357,425,57,104,161,586,33,168,Wisconsin,Madison,233209
21934,1987-1988,1987-10-22,1988-04-27,189,0,136,485,621,100,333,433,1054,38,235,Wisconsin,Madison,233209
21935,1988-1989,1988-10-23,1989-05-06,196,0,113,477,590,61,191,252,842,34,230,Wisconsin,Madison,233209
21936,1989-1990,1989-10-19,1990-05-10,204,0,108,465,573,63,126,189,762,38,208,Wisconsin,Madison,233209
21937,1990-1991,1990-10-10,1991-04-12,185,0,110,471,581,89,382,471,1052,43,242,Wisconsin,Madison,233209
21938,1991-1992,1991-10-18,1992-04-01,167,0,66,365,431,74,141,215,646,43,224,Wisconsin,Madison,233209
21939,1992-1993,1992-10-19,1993-04-20,184,0,87,438,525,107,366,473,998,47,242,Wisconsin,Madison,233209
21940,1993-1994,1993-10-30,1994-05-01,184,0,174,554,728,110,401,511,1239,43,356,Wisconsin,Madison,233209
21941,1994-1995,1994-11-28,1995-04-09,133,0,87,365,452,78,313,391,843,29,166,Wisconsin,Madison,233209
21942,1995-1996,1995-10-21,1996-04-30,193,0,172,608,780,100,339,439,1219,48,348,Wisconsin,Madison,233209
21943,1996-1997,1996-11-10,1997-05-01,173,4,147,467,614,79,186,265,879,47,296,Wisconsin,Madison,233209
21944,1998-1999,1998-11-08,1999-03-13,126,1,99,325,424,54,182,236,660,25,206,Wisconsin,Madison,233209
21945,1999-2000,1999-12-01,2000-04-11,133,0,78,335,413,59,169,228,641,33,202,Wisconsin,Madison,233209
21946,2000-2001,2000-11-13,2001-04-16,155,0,155,510,665,88,518,606,1271,48,336,Wisconsin,Madison,233209
21947,2001-2002,2001-12-01,2002-04-21,142,0,64,284,348,48,100,148,496,27,145,Wisconsin,Madison,233209
21948,2002-2003,2002-10-28,2003-04-09,164,0,123,497,620,50,61,111,731,30,181,Wisconsin,Madison,233209
21949,2003-2004,2003-11-08,2004-05-02,177,0,107,410,517,52,156,208,725,30,178,Wisconsin,Madison,233209
21950,2004-2005,2004-11-24,2005-03-22,119,0,92,340,432,67,197,264,696,32,184,Wisconsin,Madison,233209
21951,2005-2006,2005-11-15,2006-05-11,178,0,89,352,441,78,231,309,750,37,188,Wisconsin,Madison,233209
21952,2006-2007,2006-10-21,2007-04-12,174,0,127,403,530,83,279,362,892,36,256,Wisconsin,Madison,233209
21953,2007-2008,2007-11-21,2008-04-12,144,0,158,482,640,148,583,731,1371,60,438,Wisconsin,Madison,233209
21954,2008-2009,2008-11-07,2009-04-05,150,0,169,534,703,104,414,518,1221,42,330,Wisconsin,Madison,233209
21955,2009-2010,2009-11-25,2010-04-08,135,0,109,388,497,79,406,485,982,32,170,Wisconsin,Madison,233209
21956,2010-2011,2010-11-23,2011-04-20,149,0,141,439,580,115,408,523,1103,47,334,Wisconsin,Madison,233209
21957,2011-2012,2011-11-09,2012-03-06,119,0,39,252,291,52,103,155,446,27,144,Wisconsin,Madison,233209
21958,2012-2013,2012-11-06,2013-04-14,160,0,98,416,514,104,434,538,1052,41,272,Wisconsin,Madison,233209
21959,2013-2014,2013-11-11,2014-04-14,155,0,222,630,852,91,450,541,1393,48,435,Wisconsin,Madison,233209
21960,2014-2015,2014-10-31,2015-03-25,146,0,163,487,650,56,258,314,964,31,223,Wisconsin,Madison,233209
21961,2015-2016,2015-11-20,2016-04-09,142,0,85,292,377,52,153,205,582,29,159,Wisconsin,Madison,233209
21962,2016-2017,2016-11-20,2017-03-17,118,0,93,299,392,63,218,281,673,24,158,Wisconsin,Madison,233209
21963,2017-2018,2017-11-10,2018-04-20,162,0,140,474,614,66,122,188,802,34,254,Wisconsin,Madison,233209
21964,2018-2019,2018-11-09,2019-04-28,171,0,152,475,627,91,237,328,955,44,327,Wisconsin,Madison,233209
21965,2019-2020,2019-10-28,2020-04-13,169,0,64,343,407,85,301,386,793,36,189,Wisconsin,Madison,233209
21966,1950-1951,1950-11-03,1951-04-15,164,0,150,480,630,121,480,601,1231,47,328,Wisconsin,Milwaukee,594833
21967,1951-1952,1951-11-02,1952-04-12,163,0,95,395,490,109,310,419,909,42,265,Wisconsin,Milwaukee,594833
21968,1952-1953,1952-11-27,1953-03-09,103,0,56,249,305,41,89,130,435,22,117,Wisconsin,Milwaukee,594833
21969,1953-1954,1953-11-05,1954-04-03,150,0,62,299,361,41,43,84,445,31,130,Wisconsin,Milwaukee,594833
21970,1954-1955,1954-11-01,1955-03-27,147,0,91,326,417,66,93,159,576,38,213,Wisconsin,Milwaukee,594833
21971,1955-1956,1955-11-02,1956-04-07,158,0,83,386,469,60,106,166,635,38,186,Wisconsin,Milwaukee,594833
21972,1956-1957,1956-11-22,1957-04-04,134,0,101,384,485,59,123,182,667,31,156,Wisconsin,Milwaukee,594833
21973,1957-1958,1957-11-09,1958-03-20,132,0,111,356,467,49,281,330,797,27,128,Wisconsin,Milwaukee,594833
21974,1958-1959,1958-11-21,1959-04-09,140,0,168,514,682,97,378,475,1157,41,298,Wisconsin,Milwaukee,594833
21975,1959-1960,1959-11-06,1960-05-09,186,0,111,412,523,141,554,695,1218,51,326,Wisconsin,Milwaukee,594833
21976,1960-1961,1960-10-19,1961-04-17,181,0,100,392,492,52,55,107,599,26,151,Wisconsin,Milwaukee,594833
21977,1961-1962,1961-11-19,1962-04-13,146,0,153,450,603,103,494,597,1200,44,293,Wisconsin,Milwaukee,594833
21978,1962-1963,1962-10-25,1963-03-19,146,0,218,504,722,53,149,202,924,37,261,Wisconsin,Milwaukee,594833
21979,1963-1964,1963-12-01,1964-04-01,123,0,120,406,526,68,152,220,746,35,205,Wisconsin,Milwaukee,594833
21980,1964-1965,1964-11-19,1965-04-17,150,0,151,457,608,110,251,361,969,47,302,Wisconsin,Milwaukee,594833
21981,1965-1966,1965-11-28,1966-05-11,165,0,123,374,497,78,232,310,807,34,223,Wisconsin,Milwaukee,594833
21982,1966-1967,1966-11-02,1967-03-22,141,0,112,410,522,94,261,355,877,44,270,Wisconsin,Milwaukee,594833
21983,1967-1968,1967-10-27,1968-04-24,181,0,98,381,479,32,28,60,539,28,131,Wisconsin,Milwaukee,594833
21984,1968-1969,1968-11-19,1969-03-31,133,0,100,363,463,51,144,195,658,32,167,Wisconsin,Milwaukee,594833
21985,1969-1970,1969-11-13,1970-04-03,142,0,156,429,585,64,212,276,861,42,240,Wisconsin,Milwaukee,594833
21986,1970-1971,1970-11-23,1971-04-03,132,0,161,459,620,89,385,474,1094,40,272,Wisconsin,Milwaukee,594833
21987,1971-1972,1971-11-07,1972-04-07,153,0,139,436,575,69,145,214,789,37,229,Wisconsin,Milwaukee,594833
21988,1972-1973,1972-11-13,1973-04-14,153,0,104,323,427,71,136,207,634,33,177,Wisconsin,Milwaukee,594833
21989,1973-1974,1973-11-05,1974-03-31,147,0,114,340,454,121,286,407,861,45,292,Wisconsin,Milwaukee,594833
21990,1974-1975,1974-11-14,1975-04-08,146,0,90,326,416,85,174,259,675,43,205,Wisconsin,Milwaukee,594833
21991,1975-1976,1975-11-12,1976-04-25,166,0,79,342,421,69,256,325,746,40,199,Wisconsin,Milwaukee,594833
21992,1976-1977,1976-10-26,1977-04-07,164,0,204,544,748,76,253,329,1077,46,324,Wisconsin,Milwaukee,594833
21993,1977-1978,1977-11-10,1978-03-27,138,0,187,471,658,124,474,598,1256,51,384,Wisconsin,Milwaukee,594833
21994,1978-1979,1978-11-20,1979-04-09,141,0,202,462,664,125,748,873,1537,52,369,Wisconsin,Milwaukee,594833
21995,1979-1980,1979-11-09,1980-04-24,168,0,104,363,467,78,206,284,751,43,239,Wisconsin,Milwaukee,594833
21996,1980-1981,1980-11-27,1981-03-19,113,0,122,352,474,67,219,286,760,30,198,Wisconsin,Milwaukee,594833
21997,1981-1982,1981-11-20,1982-04-11,143,0,182,499,681,98,531,629,1310,40,356,Wisconsin,Milwaukee,594833
21998,1982-1983,1982-11-04,1983-04-17,165,0,54,247,301,62,132,194,495,35,136,Wisconsin,Milwaukee,594833
21999,1983-1984,1983-11-10,1984-04-22,165,0,146,407,553,62,248,310,863,43,239,Wisconsin,Milwaukee,594833
22000,1984-1985,1984-12-01,1985-04-08,129,0,113,365,478,104,367,471,949,40,281,Wisconsin,Milwaukee,594833
22001,1985-1986,1985-11-20,1986-04-15,147,0,139,420,559,62,262,324,883,32,192,Wisconsin,Milwaukee,594833
22002,1986-1987,1986-11-10,1987-04-01,143,0,47,263,310,37,46,83,393,26,98,Wisconsin,Milwaukee,594833
22003,1987-1988,1987-10-22,1988-03-30,161,0,114,359,473,85,227,312,785,37,226,Wisconsin,Milwaukee,594833
22004,1988-1989,1988-11-05,1989-05-06,183,0,93,351,444,68,129,197,641,38,226,Wisconsin,Milwaukee,594833
22005,1989-1990,1989-10-19,1990-05-10,204,0,89,353,442,99,143,242,684,41,226,Wisconsin,Milwaukee,594833
22006,1990-1991,1990-11-09,1991-04-10,153,0,74,299,373,54,149,203,576,29,144,Wisconsin,Milwaukee,594833
22007,1991-1992,1991-11-03,1992-04-04,154,0,46,249,295,70,68,138,433,38,175,Wisconsin,Milwaukee,594833
22008,1992-1993,1992-10-19,1993-04-16,180,0,72,306,378,79,197,276,654,42,189,Wisconsin,Milwaukee,594833
22009,1993-1994,1993-11-27,1994-04-30,155,0,133,378,511,122,366,488,999,38,310,Wisconsin,Milwaukee,594833
22010,1994-1995,1994-11-28,1995-04-09,133,0,56,246,302,54,200,254,556,28,114,Wisconsin,Milwaukee,594833
22011,1995-1996,1995-11-07,1996-04-29,175,0,143,448,591,79,175,254,845,36,217,Wisconsin,Milwaukee,594833
22012,1996-1997,1996-11-11,1997-04-13,154,0,104,331,435,76,174,250,685,32,193,Wisconsin,Milwaukee,594833
22013,1997-1998,1997-11-11,1998-03-15,125,0,52,201,253,60,157,217,470,27,118,Wisconsin,Milwaukee,594833
22014,1998-1999,1998-11-03,1999-03-15,133,0,85,268,353,87,222,309,662,31,234,Wisconsin,Milwaukee,594833
22015,1999-2000,1999-12-01,2000-04-11,133,0,61,250,311,64,167,231,542,35,197,Wisconsin,Milwaukee,594833
22016,2000-2001,2000-10-07,2001-04-17,193,0,111,404,515,100,411,511,1026,47,292,Wisconsin,Milwaukee,594833
22017,2001-2002,2001-12-01,2002-04-22,143,0,51,222,273,58,72,130,403,29,142,Wisconsin,Milwaukee,594833
22018,2002-2003,2002-11-15,2003-04-09,146,0,107,364,471,61,94,155,626,34,177,Wisconsin,Milwaukee,594833
22019,2003-2004,2003-11-08,2004-04-12,157,0,91,313,404,66,236,302,706,37,187,Wisconsin,Milwaukee,594833
22020,2004-2005,2004-11-24,2005-03-18,115,0,86,270,356,73,201,274,630,34,190,Wisconsin,Milwaukee,594833
22021,2005-2006,2005-11-16,2006-03-24,129,0,66,256,322,64,128,192,514,35,152,Wisconsin,Milwaukee,594833
22022,2006-2007,2006-10-12,2007-04-12,183,0,104,305,409,84,265,349,758,29,214,Wisconsin,Milwaukee,594833
22023,2007-2008,2007-11-21,2008-04-12,144,0,109,348,457,143,434,577,1034,50,325,Wisconsin,Milwaukee,594833
22024,2008-2009,2008-11-08,2009-04-21,165,0,117,411,528,110,290,400,928,39,262,Wisconsin,Milwaukee,594833
22025,2009-2010,2009-11-25,2010-04-08,135,3,75,251,326,63,210,273,599,29,125,Wisconsin,Milwaukee,594833
22026,2010-2011,2010-11-26,2011-04-19,145,0,102,327,429,97,265,362,791,45,258,Wisconsin,Milwaukee,594833
22027,2011-2012,2011-11-10,2012-03-06,118,0,29,185,214,51,72,123,337,26,120,Wisconsin,Milwaukee,594833
22028,2012-2013,2012-11-24,2013-04-19,147,0,80,297,377,70,177,247,624,31,177,Wisconsin,Milwaukee,594833
22029,2013-2014,2013-11-11,2014-04-14,155,0,189,518,707,102,471,573,1280,52,382,Wisconsin,Milwaukee,594833
22030,2014-2015,2014-10-31,2015-03-27,148,0,139,386,525,72,270,342,867,38,271,Wisconsin,Milwaukee,594833
22031,2015-2016,2015-11-20,2016-04-08,141,0,69,228,297,60,153,213,510,25,142,Wisconsin,Milwaukee,594833
22032,2016-2017,2016-12-01,2017-03-18,108,0,65,219,284,56,114,170,454,23,123,Wisconsin,Milwaukee,594833
22033,2017-2018,2017-11-10,2018-04-20,162,0,96,331,427,73,112,185,612,36,217,Wisconsin,Milwaukee,594833
22034,2018-2019,2018-11-09,2019-04-28,171,0,105,331,436,88,230,318,754,40,216,Wisconsin,Milwaukee,594833
22035,2019-2020,2019-10-29,2020-04-14,169,0,39,232,271,63,118,181,452,33,133,Wisconsin,Milwaukee,594833
22036,1950-1951,1950-10-23,1951-04-23,183,2,220,825,1045,182,1185,1367,2412,59,532,Wisconsin,Minocqua,4385
22037,1951-1952,1951-10-28,1952-05-11,197,2,181,789,970,197,804,1001,1971,54,481,Wisconsin,Minocqua,4385
22038,1953-1954,1953-11-22,1954-05-06,166,1,154,667,821,128,751,879,1700,46,419,Wisconsin,Minocqua,4385
22039,1954-1955,1954-10-30,1955-04-08,161,5,173,681,854,101,918,1019,1873,33,239,Wisconsin,Minocqua,4385
22040,1955-1956,1955-11-03,1956-05-02,182,7,169,807,976,110,1093,1203,2179,35,276,Wisconsin,Minocqua,4385
22041,1956-1957,1956-11-06,1957-04-14,160,2,195,748,943,85,733,818,1761,40,291,Wisconsin,Minocqua,4385
22042,1957-1958,1957-10-25,1958-04-24,182,2,175,657,832,88,737,825,1657,27,214,Wisconsin,Minocqua,4385
22043,1958-1959,1958-11-24,1959-03-31,128,1,258,815,1073,79,711,790,1863,22,261,Wisconsin,Minocqua,4385
22044,1959-1960,1959-10-26,1960-05-10,198,2,171,788,959,119,747,866,1825,31,286,Wisconsin,Minocqua,4385
22045,1960-1961,1960-11-06,1961-04-01,147,2,167,668,835,84,446,530,1365,22,232,Wisconsin,Minocqua,4385
22046,1961-1962,1961-11-06,1962-04-18,164,4,232,796,1028,86,986,1072,2100,26,214,Wisconsin,Minocqua,4385
22047,1962-1963,1962-11-04,1963-03-30,147,0,264,814,1078,76,759,835,1913,25,282,Wisconsin,Minocqua,4385
22048,1963-1964,1963-11-02,1964-04-15,166,4,159,812,971,61,649,710,1681,20,184,Wisconsin,Minocqua,4385
22049,1964-1965,1964-11-18,1965-04-26,160,0,234,894,1128,108,1000,1108,2236,23,244,Wisconsin,Minocqua,4385
22050,1965-1966,1965-11-13,1966-05-02,171,1,163,725,888,83,781,864,1752,23,195,Wisconsin,Minocqua,4385
22051,1966-1967,1966-11-01,1967-05-11,192,6,176,770,946,214,946,1160,2106,67,651,Wisconsin,Minocqua,4385
22052,1967-1968,1967-10-25,1968-04-25,184,6,209,859,1068,108,528,636,1704,43,345,Wisconsin,Minocqua,4385
22053,1968-1969,1968-10-28,1969-05-11,196,0,157,727,884,246,1190,1436,2320,62,558,Wisconsin,Minocqua,4385
22054,1969-1970,1969-10-13,1970-04-22,192,4,205,809,1014,172,976,1148,2162,65,549,Wisconsin,Minocqua,4385
22055,1970-1971,1970-11-13,1971-05-12,181,0,223,770,993,237,1384,1621,2614,67,640,Wisconsin,Minocqua,4385
22056,1971-1972,1971-11-06,1972-04-25,172,1,214,818,1032,181,1123,1304,2336,58,503,Wisconsin,Minocqua,4385
22057,1972-1973,1972-10-19,1973-05-04,198,3,200,692,892,155,693,848,1740,49,399,Wisconsin,Minocqua,4385
22058,1973-1974,1973-11-04,1974-04-23,171,0,236,898,1134,147,735,882,2016,46,437,Wisconsin,Minocqua,4385
22059,1974-1975,1974-10-01,1975-04-20,202,1,183,750,933,208,1078,1286,2219,68,577,Wisconsin,Minocqua,4385
22060,1975-1976,1975-11-10,1976-05-06,179,1,214,745,959,183,925,1108,2067,61,592,Wisconsin,Minocqua,4385
22061,1976-1977,1976-10-16,1977-04-09,176,4,323,943,1266,138,682,820,2086,58,563,Wisconsin,Minocqua,4385
22062,1977-1978,1977-10-11,1978-04-20,192,2,241,843,1084,133,733,866,1950,53,467,Wisconsin,Minocqua,4385
22063,1978-1979,1978-11-12,1979-05-06,176,3,328,952,1280,152,1225,1377,2657,51,499,Wisconsin,Minocqua,4385
22064,1979-1980,1979-10-13,1980-05-08,209,4,205,787,992,133,928,1061,2053,45,306,Wisconsin,Minocqua,4385
22065,1981-1982,1981-10-19,1982-04-21,185,8,277,888,1165,154,1044,1198,2363,46,463,Wisconsin,Minocqua,4385
22066,1982-1983,1982-10-20,1983-04-18,181,4,146,552,698,241,755,996,1694,58,418,Wisconsin,Minocqua,4385
22067,1983-1984,1983-11-09,1984-05-01,175,0,266,822,1088,160,936,1096,2184,51,486,Wisconsin,Minocqua,4385
22068,1984-1985,1984-11-03,1985-04-17,166,0,230,764,994,174,762,936,1930,43,433,Wisconsin,Minocqua,4385
22069,1985-1986,1985-11-09,1986-05-02,175,1,282,832,1114,176,1199,1375,2489,48,532,Wisconsin,Minocqua,4385
22070,1986-1987,1986-10-14,1987-04-25,194,1,149,666,815,111,795,906,1721,36,291,Wisconsin,Minocqua,4385
22071,1987-1988,1987-10-03,1988-04-27,208,2,227,793,1020,154,775,929,1949,48,368,Wisconsin,Minocqua,4385
22072,1988-1989,1988-10-24,1989-05-06,195,1,235,836,1071,175,1028,1203,2274,52,450,Wisconsin,Minocqua,4385
22073,1989-1990,1989-10-31,1990-05-10,192,1,216,868,1084,111,811,922,2006,43,367,Wisconsin,Minocqua,4385
22074,1990-1991,1990-10-11,1991-04-24,196,2,216,832,1048,140,745,885,1933,36,334,Wisconsin,Minocqua,4385
22075,1991-1992,1991-10-15,1992-04-16,185,1,183,766,949,172,989,1161,2110,46,455,Wisconsin,Minocqua,4385
22076,1992-1993,1992-10-16,1993-04-19,186,1,201,758,959,203,948,1151,2110,50,441,Wisconsin,Minocqua,4385
22077,1994-1995,1994-11-22,1995-04-21,151,1,178,771,949,119,562,681,1630,29,292,Wisconsin,Minocqua,4385
22078,1995-1996,1995-09-22,1996-05-06,228,12,282,1005,1287,226,1339,1565,2852,57,502,Wisconsin,Minocqua,4385
22079,1996-1997,1996-10-31,1997-05-17,199,1,219,811,1030,238,1318,1556,2586,57,583,Wisconsin,Minocqua,4385
22080,1997-1998,1997-10-14,1998-03-29,167,2,108,571,679,167,800,967,1646,41,390,Wisconsin,Minocqua,4385
22081,1998-1999,1998-11-08,1999-04-11,155,2,170,615,785,161,856,1017,1802,39,388,Wisconsin,Minocqua,4385
22082,1999-2000,1999-11-24,2000-04-21,150,3,153,623,776,155,618,773,1549,40,357,Wisconsin,Minocqua,4385
22083,2000-2001,2000-10-07,2001-04-24,200,5,214,839,1053,172,1070,1242,2295,58,526,Wisconsin,Minocqua,4385
22084,2001-2002,2001-10-06,2002-05-03,210,2,115,727,842,228,732,960,1802,53,494,Wisconsin,Minocqua,4385
22085,2002-2003,2002-10-13,2003-04-19,189,1,239,973,1212,136,521,657,1869,37,374,Wisconsin,Minocqua,4385
22086,2003-2004,2003-10-01,2004-04-27,210,2,183,924,1107,233,1007,1240,2347,55,573,Wisconsin,Minocqua,4385
22087,2004-2005,2004-10-04,2005-05-02,211,6,174,705,879,185,987,1172,2051,48,469,Wisconsin,Minocqua,4385
22088,2005-2006,2005-11-14,2006-05-11,179,13,136,579,715,204,912,1116,1831,37,378,Wisconsin,Minocqua,4385
22089,2007-2008,2007-11-06,2008-04-29,176,11,238,838,1076,98,792,890,1966,37,278,Wisconsin,Minocqua,4385
22090,2008-2009,2008-10-28,2009-04-21,176,0,283,903,1186,80,634,714,1900,38,381,Wisconsin,Minocqua,4385
22091,2009-2010,2009-10-13,2010-05-08,208,3,175,659,834,62,539,601,1435,28,211,Wisconsin,Minocqua,4385
22092,2010-2011,2010-11-13,2011-04-23,162,12,218,707,925,97,504,601,1526,44,347,Wisconsin,Minocqua,4385
22093,2011-2012,2011-11-10,2012-03-13,125,9,131,492,623,78,519,597,1220,32,226,Wisconsin,Minocqua,4385
22094,2012-2013,2012-11-13,2013-05-04,173,0,207,730,937,106,749,855,1792,47,354,Wisconsin,Minocqua,4385
22095,2013-2014,2013-10-22,2014-04-30,191,2,415,1081,1496,140,1066,1206,2702,55,578,Wisconsin,Minocqua,4385
22096,2014-2015,2014-10-31,2015-04-23,175,0,307,840,1147,109,736,845,1992,42,344,Wisconsin,Minocqua,4385
22097,2015-2016,2015-11-13,2016-04-13,153,2,173,536,709,69,445,514,1223,39,269,Wisconsin,Minocqua,4385
22098,2016-2017,2016-11-19,2017-04-28,161,0,184,558,742,84,447,531,1273,43,312,Wisconsin,Minocqua,4385
22099,2017-2018,2017-10-28,2018-04-24,179,0,269,856,1125,129,906,1035,2160,48,443,Wisconsin,Minocqua,4385
22100,2018-2019,2018-10-13,2019-05-01,201,0,272,839,1111,142,766,908,2019,62,543,Wisconsin,Minocqua,4385
22101,2019-2020,2019-10-13,2020-04-17,188,0,192,695,887,134,875,1009,1896,62,465,Wisconsin,Minocqua,4385
22102,1950-1951,1950-11-10,1951-04-21,163,0,244,793,1037,128,731,859,1896,53,460,Wisconsin,Wausau,39106
22103,1951-1952,1951-11-01,1952-04-13,165,0,197,684,881,101,552,653,1534,41,377,Wisconsin,Wausau,39106
22104,1952-1953,1952-10-16,1953-04-19,186,0,141,575,716,88,496,584,1300,49,322,Wisconsin,Wausau,39106
22105,1953-1954,1953-11-22,1954-05-04,164,0,138,530,668,65,221,286,954,40,280,Wisconsin,Wausau,39106
22106,1954-1955,1954-10-30,1955-03-30,152,0,188,620,808,71,502,573,1381,39,257,Wisconsin,Wausau,39106
22107,1955-1956,1955-10-30,1956-05-01,185,0,186,771,957,120,688,808,1765,48,370,Wisconsin,Wausau,39106
22108,1956-1957,1956-11-15,1957-04-12,149,1,202,654,856,71,377,448,1304,38,269,Wisconsin,Wausau,39106
22109,1957-1958,1957-11-08,1958-04-24,168,0,157,551,708,62,330,392,1100,38,223,Wisconsin,Wausau,39106
22110,1958-1959,1958-11-21,1959-04-09,140,0,266,743,1009,94,443,537,1546,28,264,Wisconsin,Wausau,39106
22111,1959-1960,1959-10-24,1960-05-09,199,0,161,612,773,78,346,424,1197,38,246,Wisconsin,Wausau,39106
22112,1960-1961,1960-11-29,1961-04-01,124,0,155,491,646,45,140,185,831,16,123,Wisconsin,Wausau,39106
22113,1961-1962,1961-11-06,1962-04-13,159,0,247,670,917,113,809,922,1839,40,370,Wisconsin,Wausau,39106
22114,1962-1963,1962-10-25,1963-04-23,181,5,283,739,1022,58,418,476,1498,29,265,Wisconsin,Wausau,39106
22115,1963-1964,1963-11-23,1964-04-14,144,0,154,588,742,50,260,310,1052,30,200,Wisconsin,Wausau,39106
22116,1964-1965,1964-11-19,1965-04-26,159,6,256,720,976,82,497,579,1555,31,240,Wisconsin,Wausau,39106
22117,1965-1966,1965-11-13,1966-04-21,160,0,175,556,731,53,264,317,1048,26,168,Wisconsin,Wausau,39106
22118,1966-1967,1966-11-01,1967-03-29,149,0,179,631,810,89,672,761,1571,41,340,Wisconsin,Wausau,39106
22119,1967-1968,1967-11-04,1968-04-04,153,0,195,594,789,37,271,308,1097,25,196,Wisconsin,Wausau,39106
22120,1968-1969,1968-11-09,1969-04-28,171,0,181,640,821,92,834,926,1747,27,224,Wisconsin,Wausau,39106
22121,1969-1970,1969-10-22,1970-05-02,193,0,208,712,920,75,684,759,1679,36,297,Wisconsin,Wausau,39106
22122,1970-1971,1970-11-14,1971-04-28,166,3,222,697,919,109,872,981,1900,44,355,Wisconsin,Wausau,39106
22123,1971-1972,1971-11-06,1972-04-22,169,0,229,745,974,115,903,1018,1992,42,362,Wisconsin,Wausau,39106
22124,1972-1973,1972-10-23,1973-05-03,193,0,169,522,691,85,507,592,1283,37,264,Wisconsin,Wausau,39106
22125,1973-1974,1973-11-04,1974-04-07,155,0,183,591,774,68,460,528,1302,36,220,Wisconsin,Wausau,39106
22126,1974-1975,1974-10-18,1975-04-12,177,0,140,610,750,99,699,798,1548,45,298,Wisconsin,Wausau,39106
22127,1975-1976,1975-11-20,1976-04-01,134,0,173,579,752,85,549,634,1386,42,340,Wisconsin,Wausau,39106
22128,1976-1977,1976-11-07,1977-04-07,152,0,277,739,1016,68,381,449,1465,33,319,Wisconsin,Wausau,39106
22129,1977-1978,1977-11-18,1978-04-02,136,0,229,676,905,75,626,701,1606,33,301,Wisconsin,Wausau,39106
22130,1978-1979,1978-11-14,1979-04-08,146,8,291,732,1023,88,837,925,1948,42,335,Wisconsin,Wausau,39106
22131,1979-1980,1979-10-23,1980-04-04,165,0,167,592,759,62,251,313,1072,27,175,Wisconsin,Wausau,39106
22132,1980-1981,1980-11-14,1981-03-19,126,0,166,507,673,31,228,259,932,12,120,Wisconsin,Wausau,39106
22133,1981-1982,1981-10-24,1982-04-21,180,6,222,687,909,100,695,795,1704,37,318,Wisconsin,Wausau,39106
22134,1982-1983,1982-10-20,1983-04-10,173,0,105,411,516,65,361,426,942,33,145,Wisconsin,Wausau,39106
22135,1983-1984,1983-11-11,1984-03-23,134,3,230,585,815,64,509,573,1388,31,215,Wisconsin,Wausau,39106
22136,1984-1985,1984-11-02,1985-04-03,153,3,181,562,743,113,278,391,1134,34,321,Wisconsin,Wausau,39106
22137,1985-1986,1985-11-08,1986-04-15,159,0,227,653,880,98,872,970,1850,47,406,Wisconsin,Wausau,39106
22138,1986-1987,1986-11-09,1987-04-03,146,0,104,422,526,52,302,354,880,21,130,Wisconsin,Wausau,39106
22139,1987-1988,1987-10-20,1988-04-27,191,2,173,551,724,60,376,436,1160,31,202,Wisconsin,Wausau,39106
22140,1988-1989,1988-10-24,1989-04-28,187,0,195,640,835,114,528,642,1477,53,429,Wisconsin,Wausau,39106
22141,1989-1990,1989-10-20,1990-05-10,203,0,172,604,776,76,393,469,1245,41,282,Wisconsin,Wausau,39106
22142,1990-1991,1990-10-10,1991-04-13,186,3,171,579,750,113,594,707,1457,41,347,Wisconsin,Wausau,39106
22143,1991-1992,1991-11-01,1992-04-22,174,0,132,515,647,106,576,682,1329,45,280,Wisconsin,Wausau,39106
22144,1992-1993,1992-10-15,1993-04-20,188,0,159,609,768,118,632,750,1518,66,341,Wisconsin,Wausau,39106
22145,1993-1994,1993-10-27,1994-04-29,185,0,238,650,888,107,419,526,1414,54,408,Wisconsin,Wausau,39106
22146,1994-1995,1994-11-26,1995-04-21,147,0,133,455,588,73,294,367,955,33,201,Wisconsin,Wausau,39106
22147,1995-1996,1995-10-21,1996-05-05,198,0,243,744,987,148,873,1021,2008,61,443,Wisconsin,Wausau,39106
22148,1996-1997,1996-10-31,1997-04-08,160,0,193,556,749,115,838,953,1702,54,388,Wisconsin,Wausau,39106
22149,1997-1998,1997-11-02,1998-04-17,167,0,90,334,424,101,376,477,901,45,237,Wisconsin,Wausau,39106
22150,1998-1999,1998-11-08,1999-04-22,166,0,135,437,572,84,542,626,1198,47,315,Wisconsin,Wausau,39106
22151,1999-2000,1999-11-26,2000-04-20,147,0,106,422,528,81,456,537,1065,46,278,Wisconsin,Wausau,39106
22152,2000-2001,2000-11-14,2001-04-16,154,7,203,595,798,102,767,869,1667,55,408,Wisconsin,Wausau,39106
22153,2001-2002,2001-10-25,2002-04-28,186,2,99,390,489,92,242,334,823,49,264,Wisconsin,Wausau,39106
22154,2002-2003,2002-10-18,2003-04-16,181,17,206,626,832,69,264,333,1165,38,303,Wisconsin,Wausau,39106
22155,2003-2004,2003-10-27,2004-04-11,168,3,156,532,688,101,542,643,1331,53,332,Wisconsin,Wausau,39106
22156,2004-2005,2004-11-25,2005-03-29,125,0,165,495,660,83,523,606,1266,44,295,Wisconsin,Wausau,39106
22157,2005-2006,2005-11-15,2006-05-11,178,0,131,435,566,76,421,497,1063,45,257,Wisconsin,Wausau,39106
22158,2006-2007,2006-10-12,2007-04-12,183,3,171,504,675,84,407,491,1166,38,251,Wisconsin,Wausau,39106
22159,2007-2008,2007-11-22,2008-04-14,145,0,218,621,839,116,922,1038,1877,54,401,Wisconsin,Wausau,39106
22160,2008-2009,2008-11-09,2009-04-05,148,13,242,674,916,95,618,713,1629,43,379,Wisconsin,Wausau,39106
22161,2009-2010,2009-10-12,2010-05-08,209,0,139,459,598,56,514,570,1168,32,206,Wisconsin,Wausau,39106
22162,2010-2011,2010-11-14,2011-05-03,171,5,213,573,786,118,840,958,1744,50,392,Wisconsin,Wausau,39106
22163,2011-2012,2011-11-09,2012-04-20,164,0,84,355,439,69,405,474,913,41,220,Wisconsin,Wausau,39106
22164,2012-2013,2012-11-06,2013-04-25,171,0,157,535,692,120,657,777,1469,55,336,Wisconsin,Wausau,39106
22165,2013-2014,2013-11-11,2014-04-17,158,0,335,805,1140,132,956,1088,2228,63,575,Wisconsin,Wausau,39106
22166,2014-2015,2014-10-31,2015-04-10,162,0,255,618,873,85,568,653,1526,43,314,Wisconsin,Wausau,39106
22167,2015-2016,2015-10-28,2016-04-08,164,0,109,356,465,72,382,454,919,36,206,Wisconsin,Wausau,39106
22168,2016-2017,2016-11-19,2017-04-27,160,3,157,431,588,82,462,544,1132,29,214,Wisconsin,Wausau,39106
22169,2017-2018,2017-10-31,2018-04-21,173,1,220,623,843,131,543,674,1517,49,398,Wisconsin,Wausau,39106
22170,2018-2019,2018-10-14,2019-04-15,184,0,230,617,847,135,524,659,1506,42,349,Wisconsin,Wausau,39106
22171,2019-2020,2019-10-31,2020-04-15,168,2,143,482,625,101,792,893,1518,39,253,Wisconsin,Wausau,39106
22172,1950-1951,1950-11-10,1951-04-04,146,0,178,665,843,118,848,966,1809,36,331,Wisconsin,Wisconsin Dells,2678
22173,1951-1952,1951-11-02,1952-03-31,151,0,131,575,706,108,618,726,1432,36,315,Wisconsin,Wisconsin Dells,2678
22174,1952-1953,1952-10-16,1953-03-25,161,0,83,451,534,67,448,515,1049,38,221,Wisconsin,Wisconsin Dells,2678
22175,1953-1954,1953-11-25,1954-05-03,160,0,76,424,500,44,104,148,648,23,143,Wisconsin,Wisconsin Dells,2678
22176,1954-1955,1954-11-01,1955-03-30,150,1,113,511,624,67,298,365,989,29,173,Wisconsin,Wisconsin Dells,2678
22177,1955-1956,1955-11-07,1956-04-29,175,2,112,624,736,70,402,472,1208,29,174,Wisconsin,Wisconsin Dells,2678
22178,1956-1957,1956-11-16,1957-04-05,141,0,120,515,635,32,243,275,910,19,114,Wisconsin,Wisconsin Dells,2678
22179,1957-1958,1957-11-08,1958-03-06,119,0,103,407,510,31,197,228,738,17,82,Wisconsin,Wisconsin Dells,2678
22180,1958-1959,1958-11-23,1959-04-05,134,0,181,691,872,104,657,761,1633,33,328,Wisconsin,Wisconsin Dells,2678
22181,1959-1960,1959-11-05,1960-04-17,165,1,93,529,622,63,357,420,1042,28,205,Wisconsin,Wisconsin Dells,2678
22182,1960-1961,1960-11-05,1961-04-17,164,0,114,491,605,27,97,124,729,12,78,Wisconsin,Wisconsin Dells,2678
22183,1961-1962,1961-11-19,1962-04-12,145,0,184,575,759,102,794,896,1655,33,280,Wisconsin,Wisconsin Dells,2678
22184,1962-1963,1962-12-01,1963-03-24,114,5,213,599,812,64,463,527,1339,26,240,Wisconsin,Wisconsin Dells,2678
22185,1963-1964,1963-11-30,1964-04-08,131,1,118,469,587,37,160,197,784,20,116,Wisconsin,Wisconsin Dells,2678
22186,1964-1965,1964-11-19,1965-04-05,138,1,188,623,811,63,287,350,1161,27,213,Wisconsin,Wisconsin Dells,2678
22187,1965-1966,1965-11-27,1966-03-26,120,1,133,451,584,38,227,265,849,17,149,Wisconsin,Wisconsin Dells,2678
22188,1966-1967,1966-11-03,1967-03-23,141,0,128,542,670,63,483,546,1216,26,194,Wisconsin,Wisconsin Dells,2678
22189,1967-1968,1967-11-05,1968-03-22,139,0,133,482,615,24,92,116,731,18,132,Wisconsin,Wisconsin Dells,2678
22190,1968-1969,1968-11-19,1969-04-02,135,3,147,544,691,72,672,744,1435,27,217,Wisconsin,Wisconsin Dells,2678
22191,1969-1970,1969-11-13,1970-03-28,136,1,156,567,723,50,500,550,1273,14,138,Wisconsin,Wisconsin Dells,2678
22192,1970-1971,1970-11-14,1971-04-04,142,7,179,579,758,91,770,861,1619,21,207,Wisconsin,Wisconsin Dells,2678
22193,1971-1972,1971-11-07,1972-04-07,153,3,162,576,738,65,426,491,1229,28,215,Wisconsin,Wisconsin Dells,2678
22194,1972-1973,1972-10-15,1973-04-14,182,1,128,445,573,70,263,333,906,25,177,Wisconsin,Wisconsin Dells,2678
22195,1973-1974,1973-11-09,1974-04-14,157,0,141,483,624,63,322,385,1009,32,232,Wisconsin,Wisconsin Dells,2678
22196,1974-1975,1974-11-14,1975-04-03,141,9,83,469,552,78,417,495,1047,35,181,Wisconsin,Wisconsin Dells,2678
22197,1975-1976,1975-11-21,1976-03-18,119,1,114,464,578,80,317,397,975,27,202,Wisconsin,Wisconsin Dells,2678
22198,1976-1977,1976-10-19,1977-04-07,171,4,274,678,952,62,339,401,1353,33,294,Wisconsin,Wisconsin Dells,2678
22199,1977-1978,1977-11-21,1978-04-02,133,0,199,657,856,78,705,783,1639,28,279,Wisconsin,Wisconsin Dells,2678
22200,1978-1979,1978-11-12,1979-04-02,142,17,204,653,857,98,764,862,1719,38,330,Wisconsin,Wisconsin Dells,2678
22201,1979-1980,1979-10-23,1980-04-14,175,4,120,508,628,28,81,109,737,12,77,Wisconsin,Wisconsin Dells,2678
22202,1980-1981,1980-11-27,1981-03-06,100,8,111,379,490,34,72,106,596,12,93,Wisconsin,Wisconsin Dells,2678
22203,1986-1987,1986-11-09,1987-03-30,142,8,74,435,509,38,0,38,547,11,80,Wisconsin,Wisconsin Dells,2678
22204,1988-1989,1988-11-05,1989-04-09,156,11,124,549,673,36,50,86,759,15,128,Wisconsin,Wisconsin Dells,2678
22205,1989-1990,1989-11-16,1990-03-23,128,0,126,525,651,32,193,225,876,13,103,Wisconsin,Wisconsin Dells,2678
22206,1990-1991,1990-10-10,1991-04-12,185,1,136,597,733,65,535,600,1333,19,162,Wisconsin,Wisconsin Dells,2678
22207,1991-1992,1991-11-01,1992-04-01,153,0,99,438,537,55,151,206,743,23,166,Wisconsin,Wisconsin Dells,2678
22208,1992-1993,1992-10-19,1993-04-19,183,12,126,572,698,74,415,489,1187,24,163,Wisconsin,Wisconsin Dells,2678
22209,1993-1994,1993-11-07,1994-04-05,150,1,210,653,863,80,433,513,1376,27,303,Wisconsin,Wisconsin Dells,2678
22210,1994-1995,1994-11-30,1995-04-11,133,1,106,456,562,58,246,304,866,14,117,Wisconsin,Wisconsin Dells,2678
22211,1995-1996,1995-11-01,1996-04-15,167,11,206,736,942,51,423,474,1416,19,178,Wisconsin,Wisconsin Dells,2678
22212,1996-1997,1996-11-10,1997-04-13,155,3,160,580,740,89,477,566,1306,27,209,Wisconsin,Wisconsin Dells,2678
22213,1997-1998,1997-10-27,1998-03-22,147,11,65,337,402,69,320,389,791,22,124,Wisconsin,Wisconsin Dells,2678
22214,1998-1999,1998-11-21,1999-03-14,114,7,103,414,517,48,301,349,866,17,195,Wisconsin,Wisconsin Dells,2678
22215,1999-2000,1999-12-01,2000-04-11,133,8,76,395,471,36,143,179,650,16,105,Wisconsin,Wisconsin Dells,2678
22216,2000-2001,2000-11-15,2001-03-25,131,1,157,598,755,66,634,700,1455,27,235,Wisconsin,Wisconsin Dells,2678
22217,2001-2002,2001-12-01,2002-04-02,123,2,57,355,412,39,135,174,586,18,117,Wisconsin,Wisconsin Dells,2678
22218,2002-2003,2002-11-24,2003-04-07,135,1,136,555,691,29,114,143,834,13,96,Wisconsin,Wisconsin Dells,2678
22219,2003-2004,2003-11-08,2004-03-17,131,6,110,449,559,47,253,300,859,12,92,Wisconsin,Wisconsin Dells,2678
22220,2004-2005,2004-12-01,2005-03-21,111,11,96,427,523,44,231,275,798,17,114,Wisconsin,Wisconsin Dells,2678
22221,2005-2006,2005-11-15,2006-03-17,123,1,90,410,500,46,183,229,729,17,117,Wisconsin,Wisconsin Dells,2678
22222,2006-2007,2006-11-10,2007-04-12,154,3,124,471,595,60,281,341,936,16,138,Wisconsin,Wisconsin Dells,2678
22223,2007-2008,2007-11-22,2008-03-26,126,4,167,646,813,143,739,882,1695,36,382,Wisconsin,Wisconsin Dells,2678
22224,2008-2009,2008-11-09,2009-03-29,141,10,171,653,824,99,436,535,1359,28,324,Wisconsin,Wisconsin Dells,2678
22225,2009-2010,2009-12-01,2010-03-13,103,0,111,447,558,67,506,573,1131,24,179,Wisconsin,Wisconsin Dells,2678
22226,2010-2011,2010-11-24,2011-04-20,148,0,150,562,712,98,646,744,1456,30,262,Wisconsin,Wisconsin Dells,2678
22227,2011-2012,2011-11-09,2012-03-06,119,0,64,350,414,46,147,193,607,24,150,Wisconsin,Wisconsin Dells,2678
22228,2013-2014,2013-11-12,2014-04-15,155,3,247,797,1044,99,566,665,1709,49,448,Wisconsin,Wisconsin Dells,2678
22229,2014-2015,2014-11-12,2015-03-25,134,0,180,556,736,44,280,324,1060,25,217,Wisconsin,Wisconsin Dells,2678
22230,2015-2016,2015-11-21,2016-04-08,140,0,90,353,443,52,314,366,809,23,151,Wisconsin,Wisconsin Dells,2678
22231,2016-2017,2016-11-21,2017-04-28,159,0,103,395,498,62,295,357,855,29,184,Wisconsin,Wisconsin Dells,2678
22232,2017-2018,2017-11-10,2018-04-21,163,0,151,563,714,75,187,262,976,37,276,Wisconsin,Wisconsin Dells,2678
22233,2018-2019,2018-11-09,2019-04-14,157,0,165,571,736,100,374,474,1210,34,286,Wisconsin,Wisconsin Dells,2678
22234,2019-2020,2019-10-29,2020-04-13,168,7,73,445,518,73,265,338,856,25,153,Wisconsin,Wisconsin Dells,2678
22235,1950-1951,1950-09-29,1951-06-02,247,3,93,588,681,203,894,1097,1778,54,407,Wyoming,Alta,0
22236,1951-1952,1951-10-15,1952-05-22,221,0,121,713,834,253,1446,1699,2533,59,476,Wyoming,Alta,0
22237,1952-1953,1952-11-14,1953-05-22,190,7,70,677,747,186,1028,1214,1961,55,400,Wyoming,Alta,0
22238,1953-1954,1953-11-17,1954-04-30,165,1,68,546,614,195,920,1115,1729,47,389,Wyoming,Alta,0
22239,1954-1955,1954-10-12,1955-05-27,228,8,161,777,938,206,1061,1267,2205,56,433,Wyoming,Alta,0
22240,1955-1956,1955-10-05,1956-05-12,221,5,119,651,770,167,1095,1262,2032,45,323,Wyoming,Alta,0
22241,1956-1957,1956-10-19,1957-05-21,215,8,102,709,811,162,1463,1625,2436,38,281,Wyoming,Alta,0
22242,1957-1958,1957-09-19,1958-04-30,224,8,54,645,699,160,1335,1495,2194,46,315,Wyoming,Alta,0
22243,1958-1959,1958-11-10,1959-05-09,181,19,68,504,572,94,911,1005,1577,31,182,Wyoming,Alta,0
22244,1962-1963,1962-10-14,1963-04-27,196,7,99,549,648,163,461,624,1272,35,291,Wyoming,Alta,0
22245,1963-1964,1963-11-04,1964-05-10,189,9,130,699,829,235,1766,2001,2830,45,419,Wyoming,Alta,0
22246,1964-1965,1964-08-29,1965-05-07,252,4,102,627,729,157,1095,1252,1981,49,340,Wyoming,Alta,0
22247,1966-1967,1966-10-02,1967-05-06,217,4,85,564,649,193,1187,1380,2029,47,341,Wyoming,Alta,0
22248,1967-1968,1967-11-03,1968-05-15,195,1,91,601,692,113,1365,1478,2170,29,231,Wyoming,Alta,0
22249,1968-1969,1968-09-21,1969-04-25,217,13,96,686,782,162,1266,1428,2210,46,335,Wyoming,Alta,0
22250,1969-1970,1969-10-03,1970-05-15,225,5,73,645,718,126,1351,1477,2195,35,218,Wyoming,Alta,0
22251,1970-1971,1970-10-24,1971-05-17,206,8,107,671,778,149,1335,1484,2262,34,288,Wyoming,Alta,0
22252,1971-1972,1971-10-01,1972-04-30,213,9,146,700,846,158,1301,1459,2305,34,303,Wyoming,Alta,0
22253,1972-1973,1972-10-28,1973-05-05,190,9,114,728,842,150,1406,1556,2398,34,251,Wyoming,Alta,0
22254,1973-1974,1973-10-08,1974-05-21,226,9,101,701,802,184,1328,1512,2314,51,367,Wyoming,Alta,0
22255,1974-1975,1974-10-21,1975-05-23,215,10,105,872,977,213,1627,1840,2817,46,395,Wyoming,Alta,0
22256,1975-1976,1975-10-07,1976-06-14,252,9,85,896,981,230,1680,1910,2891,48,436,Wyoming,Alta,0
22257,1976-1977,1976-10-25,1977-04-17,175,7,75,856,931,91,852,943,1874,25,232,Wyoming,Alta,0
22258,1977-1978,1977-11-08,1978-04-15,159,13,62,667,729,150,1243,1393,2122,37,318,Wyoming,Alta,0
22259,1979-1980,1979-10-27,1980-05-25,212,18,67,637,704,146,1203,1349,2053,34,246,Wyoming,Alta,0
22260,1980-1981,1980-10-14,1981-06-14,244,6,29,515,544,124,680,804,1348,28,193,Wyoming,Alta,0
22261,1983-1984,1983-10-16,1984-05-11,209,20,143,651,794,182,1760,1942,2736,45,329,Wyoming,Alta,0
22262,1985-1986,1985-10-08,1986-05-22,227,18,94,536,630,216,1300,1516,2146,45,347,Wyoming,Alta,0
22263,1986-1987,1986-09-28,1987-04-12,197,18,108,546,654,92,1051,1143,1797,21,147,Wyoming,Alta,0
22264,1987-1988,1987-11-14,1988-05-09,178,9,137,575,712,142,918,1060,1772,33,244,Wyoming,Alta,0
22265,1988-1989,1988-09-18,1989-05-13,238,17,176,615,791,210,1501,1711,2502,42,382,Wyoming,Alta,0
22266,1989-1990,1989-10-26,1990-05-12,199,7,115,532,647,128,1000,1128,1775,34,269,Wyoming,Alta,0
22267,1990-1991,1990-10-06,1991-05-01,208,13,139,626,765,153,1123,1276,2041,36,292,Wyoming,Alta,0
22268,1991-1992,1991-10-23,1992-04-23,184,10,86,485,571,99,1062,1161,1732,28,202,Wyoming,Alta,0
22269,1994-1995,1994-10-03,1995-04-30,210,13,105,561,666,200,1421,1621,2287,42,349,Wyoming,Alta,0
22270,1995-1996,1995-10-03,1996-04-25,206,1,99,535,634,148,984,1132,1766,26,244,Wyoming,Alta,0
22271,1996-1997,1996-10-20,1997-05-02,195,5,132,587,719,180,1225,1405,2124,48,375,Wyoming,Alta,0
22272,1997-1998,1997-10-10,1998-06-04,238,1,105,581,686,104,1240,1344,2030,31,197,Wyoming,Alta,0
22273,1998-1999,1998-10-04,1999-05-16,225,1,120,557,677,171,993,1164,1841,41,300,Wyoming,Alta,0
22274,1999-2000,1999-11-21,2000-05-12,174,3,77,455,532,158,1020,1178,1710,36,283,Wyoming,Alta,0
22275,2000-2001,2000-10-13,2001-06-13,244,3,130,681,811,184,1126,1310,2121,39,338,Wyoming,Alta,0
22276,2001-2002,2001-10-09,2002-05-22,226,0,161,660,821,136,1055,1191,2012,37,296,Wyoming,Alta,0
22277,2002-2003,2002-10-29,2003-05-05,189,5,82,501,583,143,896,1039,1622,39,265,Wyoming,Alta,0
22278,2003-2004,2003-10-29,2004-05-13,198,7,122,541,663,157,1327,1484,2147,35,294,Wyoming,Alta,0
22279,2004-2005,2004-10-18,2005-06-09,235,14,92,531,623,108,945,1053,1676,32,196,Wyoming,Alta,0
22280,2005-2006,2005-10-03,2006-04-18,198,10,141,585,726,150,1250,1400,2126,34,306,Wyoming,Alta,0
22281,2006-2007,2006-09-21,2007-06-07,260,8,138,601,739,170,1010,1180,1919,41,310,Wyoming,Alta,0
22282,2007-2008,2007-10-07,2008-06-12,250,3,166,706,872,212,1396,1608,2480,41,378,Wyoming,Alta,0
22283,2008-2009,2008-10-09,2009-05-03,207,1,113,575,688,213,1255,1468,2156,40,359,Wyoming,Alta,0
22284,2010-2011,2010-10-25,2011-05-30,218,0,151,602,753,280,1888,2168,2921,60,466,Wyoming,Alta,0
22285,2011-2012,2011-10-06,2012-05-24,232,1,121,598,719,193,1180,1373,2092,44,345,Wyoming,Alta,0
22286,2012-2013,2012-10-25,2013-05-01,189,0,139,583,722,152,953,1105,1827,36,301,Wyoming,Alta,0
22287,2013-2014,2013-10-03,2014-04-29,209,3,124,575,699,191,1225,1416,2115,50,348,Wyoming,Alta,0
22288,2014-2015,2014-11-10,2015-04-26,168,0,92,436,528,132,942,1074,1602,26,220,Wyoming,Alta,0
22289,2015-2016,2015-11-04,2016-05-10,189,0,113,496,609,169,1151,1320,1929,38,293,Wyoming,Alta,0
22290,2016-2017,2016-10-17,2017-05-17,213,4,139,523,662,200,1000,1200,1862,50,388,Wyoming,Alta,0
22291,2017-2018,2017-09-16,2018-05-01,228,0,97,542,639,192,1007,1199,1838,43,314,Wyoming,Alta,0
22292,2018-2019,2018-10-29,2019-04-25,179,0,132,593,725,202,1748,1950,2675,40,335,Wyoming,Alta,0
22293,2019-2020,2019-10-10,2020-05-23,227,0,116,595,711,206,1321,1527,2238,43,363,Wyoming,Alta,0
22294,1950-1951,1950-11-12,1951-04-21,161,19,79,685,764,27,4,31,795,16,98,Wyoming,Basin,1285
22295,1951-1952,1951-11-02,1952-04-08,159,12,94,689,783,24,153,177,960,11,88,Wyoming,Basin,1285
22296,1952-1953,1952-11-16,1953-05-22,188,2,41,490,531,55,95,150,681,16,93,Wyoming,Basin,1285
22297,1953-1954,1953-11-19,1954-05-02,165,0,30,508,538,46,29,75,613,12,82,Wyoming,Basin,1285
22298,1954-1955,1954-11-30,1955-04-04,126,1,43,538,581,29,33,62,643,12,85,Wyoming,Basin,1285
22299,1955-1956,1955-11-11,1956-03-27,138,0,116,652,768,32,124,156,924,20,144,Wyoming,Basin,1285
22300,1956-1957,1956-11-04,1957-04-25,173,3,124,738,862,27,114,141,1003,16,142,Wyoming,Basin,1285
22301,1957-1958,1957-09-19,1958-03-16,179,1,18,499,517,34,60,94,611,13,77,Wyoming,Basin,1285
22302,1958-1959,1958-11-15,1959-04-25,162,2,95,590,685,57,247,304,989,19,162,Wyoming,Basin,1285
22303,1960-1961,1960-11-09,1961-03-28,140,1,51,557,608,22,140,162,770,7,55,Wyoming,Basin,1285
22304,1961-1962,1961-11-15,1962-03-13,119,0,163,675,838,38,423,461,1299,14,146,Wyoming,Basin,1285
22305,1962-1963,1962-12-01,1963-02-28,90,0,99,419,518,16,109,125,643,10,124,Wyoming,Basin,1285
22306,1963-1964,1963-11-21,1964-03-28,129,0,112,584,696,39,295,334,1030,21,151,Wyoming,Basin,1285
22307,1965-1966,1965-12-01,1966-04-19,140,0,49,480,529,45,48,93,622,11,90,Wyoming,Basin,1285
22308,1966-1967,1966-11-08,1967-05-03,177,1,51,505,556,59,75,134,690,31,162,Wyoming,Basin,1285
22309,1967-1968,1967-11-23,1968-04-21,151,0,106,567,673,36,223,259,932,19,173,Wyoming,Basin,1285
22310,1969-1970,1969-11-13,1970-04-30,169,3,40,522,562,22,35,57,619,11,63,Wyoming,Basin,1285
22311,1970-1971,1970-11-22,1971-03-22,121,1,103,501,604,31,142,173,777,15,114,Wyoming,Basin,1285
22312,1971-1972,1971-10-28,1972-02-29,125,2,85,510,595,21,100,121,716,9,74,Wyoming,Basin,1285
22313,1972-1973,1972-09-25,1973-02-28,157,0,176,766,942,25,324,349,1291,10,121,Wyoming,Basin,1285
22314,1975-1976,1975-11-18,1976-04-02,137,13,116,598,714,32,153,185,899,14,110,Wyoming,Basin,1285
22315,1985-1986,1985-09-28,1986-04-14,199,16,128,698,826,38,442,480,1306,17,130,Wyoming,Basin,1285
22316,1986-1987,1986-11-06,1987-03-30,145,18,100,444,544,31,153,184,728,15,96,Wyoming,Basin,1285
22317,1987-1988,1987-10-09,1988-03-16,160,2,105,591,696,16,84,100,796,11,79,Wyoming,Basin,1285
22318,1988-1989,1988-11-24,1989-03-21,118,0,169,685,854,33,150,183,1037,14,172,Wyoming,Basin,1285
22319,1989-1990,1989-11-01,1990-04-11,162,0,120,595,715,48,228,276,991,21,169,Wyoming,Basin,1285
22320,1990-1991,1990-11-07,1991-04-18,163,0,159,654,813,31,87,118,931,14,153,Wyoming,Basin,1285
22321,1991-1992,1991-10-28,1992-03-18,143,3,45,498,543,25,59,84,627,8,54,Wyoming,Basin,1285
22322,1992-1993,1992-11-03,1993-03-18,136,5,222,805,1027,34,369,403,1430,11,98,Wyoming,Basin,1285
22323,1993-1994,1993-10-09,1994-04-28,202,0,70,583,653,34,39,73,726,10,87,Wyoming,Basin,1285
22324,1994-1995,1994-11-03,1995-03-07,125,1,67,471,538,8,7,15,553,3,19,Wyoming,Basin,1285
22325,1995-1996,1995-10-31,1996-03-29,151,0,171,653,824,41,163,204,1028,15,158,Wyoming,Basin,1285
22326,1996-1997,1996-11-16,1997-04-11,147,5,132,555,687,30,149,179,866,12,114,Wyoming,Basin,1285
22327,1997-1998,1997-11-12,1998-03-30,139,2,63,533,596,45,127,172,768,13,96,Wyoming,Basin,1285
22328,1998-1999,1998-11-08,1999-03-10,123,5,50,398,448,20,17,37,485,9,64,Wyoming,Basin,1285
22329,1999-2000,1999-12-01,2000-03-08,99,4,52,371,423,24,89,113,536,7,50,Wyoming,Basin,1285
22330,2000-2001,2000-09-22,2001-03-06,166,7,148,747,895,42,198,240,1135,14,122,Wyoming,Basin,1285
22331,2001-2002,2001-11-18,2002-04-02,136,3,100,579,679,38,80,118,797,12,103,Wyoming,Basin,1285
22332,2002-2003,2002-10-21,2003-03-09,140,3,123,589,712,48,168,216,928,15,118,Wyoming,Basin,1285
22333,2003-2004,2003-10-30,2004-02-29,123,4,82,543,625,16,162,178,803,4,28,Wyoming,Basin,1285
22334,2004-2005,2004-10-31,2005-04-21,173,3,58,513,571,25,18,43,614,10,76,Wyoming,Basin,1285
22335,2005-2006,2005-10-05,2006-03-20,167,4,59,480,539,14,10,24,563,7,46,Wyoming,Basin,1285
22336,2006-2007,2006-10-30,2007-03-29,151,1,105,587,692,26,122,148,840,9,94,Wyoming,Basin,1285
22337,2007-2008,2007-11-20,2008-04-20,153,4,88,593,681,22,98,120,801,8,79,Wyoming,Basin,1285
22338,2008-2009,2008-10-10,2009-03-29,171,3,112,619,731,47,110,157,888,16,155,Wyoming,Basin,1285
22339,2010-2011,2010-11-15,2011-03-09,115,3,161,621,782,38,216,254,1036,16,169,Wyoming,Basin,1285
22340,2011-2012,2011-11-05,2012-02-29,117,2,45,486,531,18,24,42,573,8,60,Wyoming,Basin,1285
22341,2012-2013,2012-11-09,2013-04-22,165,5,110,649,759,34,171,205,964,14,100,Wyoming,Basin,1285
22342,2013-2014,2013-10-29,2014-05-08,192,0,161,667,828,61,199,260,1088,22,205,Wyoming,Basin,1285
22343,2014-2015,2014-11-10,2015-03-05,116,0,142,508,650,38,231,269,919,15,105,Wyoming,Basin,1285
22344,2015-2016,2015-11-26,2016-03-29,125,0,49,375,424,20,98,118,542,7,45,Wyoming,Basin,1285
22345,2016-2017,2016-10-12,2017-04-03,174,0,139,507,646,43,326,369,1015,18,140,Wyoming,Basin,1285
22346,2017-2018,2017-11-07,2018-04-08,153,0,107,546,653,46,271,317,970,18,160,Wyoming,Basin,1285
22347,2018-2019,2018-10-14,2019-03-10,148,0,74,516,590,32,68,100,690,17,99,Wyoming,Basin,1285
22348,2019-2020,2019-10-10,2020-04-12,186,0,34,488,522,49,198,247,769,17,106,Wyoming,Basin,1285
22349,1950-1951,1950-09-30,1951-06-01,245,0,81,525,606,87,33,120,726,48,318,Wyoming,Casper,55316
22350,1951-1952,1951-09-21,1952-05-22,245,0,87,534,621,122,106,228,849,47,333,Wyoming,Casper,55316
22351,1952-1953,1952-10-13,1953-05-13,213,0,73,451,524,99,122,221,745,46,263,Wyoming,Casper,55316
22352,1953-1954,1953-11-18,1954-05-02,166,0,56,414,470,104,113,217,687,40,274,Wyoming,Casper,55316
22353,1954-1955,1954-10-24,1955-04-27,186,0,95,493,588,120,213,333,921,49,359,Wyoming,Casper,55316
22354,1955-1956,1955-10-22,1956-05-13,205,0,91,530,621,121,163,284,905,58,352,Wyoming,Casper,55316
22355,1956-1957,1956-10-24,1957-04-26,185,0,86,519,605,110,141,251,856,49,343,Wyoming,Casper,55316
22356,1957-1958,1957-10-24,1958-04-25,184,0,47,423,470,116,97,213,683,57,297,Wyoming,Casper,55316
22357,1958-1959,1958-11-07,1959-05-10,185,0,78,476,554,111,101,212,766,58,374,Wyoming,Casper,55316
22358,1959-1960,1959-09-27,1960-04-29,216,0,112,571,683,83,123,206,889,49,346,Wyoming,Casper,55316
22359,1960-1961,1960-10-09,1961-04-14,188,0,40,395,435,78,92,170,605,42,205,Wyoming,Casper,55316
22360,1961-1962,1961-09-21,1962-04-21,213,0,155,607,762,98,178,276,1038,58,429,Wyoming,Casper,55316
22361,1962-1963,1962-09-08,1963-04-28,233,0,91,478,569,70,65,135,704,49,325,Wyoming,Casper,55316
22362,1963-1964,1963-10-30,1964-04-26,180,1,100,527,627,110,186,296,923,53,368,Wyoming,Casper,55316
22363,1964-1965,1964-11-11,1965-05-09,180,0,109,561,670,105,148,253,923,51,370,Wyoming,Casper,55316
22364,1965-1966,1965-09-15,1966-06-05,264,0,81,504,585,94,125,219,804,43,300,Wyoming,Casper,55316
22365,1966-1967,1966-10-02,1967-05-13,224,0,60,497,557,121,110,231,788,64,343,Wyoming,Casper,55316
22366,1967-1968,1967-10-23,1968-05-16,207,0,98,546,644,118,149,267,911,60,381,Wyoming,Casper,55316
22367,1968-1969,1968-10-16,1969-06-13,241,0,82,552,634,91,104,195,829,44,286,Wyoming,Casper,55316
22368,1969-1970,1969-10-03,1970-05-14,224,0,63,538,601,112,117,229,830,56,288,Wyoming,Casper,55316
22369,1970-1971,1970-09-24,1971-05-18,237,0,84,537,621,133,145,278,899,62,340,Wyoming,Casper,55316
22370,1971-1972,1971-09-16,1972-05-01,229,0,100,559,659,125,151,276,935,55,352,Wyoming,Casper,55316
22371,1972-1973,1972-09-29,1973-05-03,217,0,147,596,743,164,231,395,1138,59,423,Wyoming,Casper,55316
22372,1973-1974,1973-10-09,1974-05-02,206,0,93,476,569,119,145,264,833,53,379,Wyoming,Casper,55316
22373,1974-1975,1974-09-11,1975-05-25,257,0,114,558,672,164,154,318,990,69,461,Wyoming,Casper,55316
22374,1975-1976,1975-10-22,1976-05-15,207,0,87,479,566,102,171,273,839,46,311,Wyoming,Casper,55316
22375,1976-1977,1976-10-17,1977-04-19,185,0,63,495,558,99,100,199,757,40,272,Wyoming,Casper,55316
22376,1977-1978,1977-10-09,1978-05-18,222,0,107,557,664,157,204,361,1025,58,434,Wyoming,Casper,55316
22377,1978-1979,1978-10-22,1979-05-10,201,0,190,706,896,174,299,473,1369,67,561,Wyoming,Casper,55316
22378,1979-1980,1979-10-29,1980-05-13,198,0,112,582,694,150,222,372,1066,55,448,Wyoming,Casper,55316
22379,1980-1981,1980-10-16,1981-05-04,201,0,42,395,437,93,75,168,605,43,266,Wyoming,Casper,55316
22380,1981-1982,1981-10-13,1982-05-11,211,0,90,551,641,109,81,190,831,60,418,Wyoming,Casper,55316
22381,1982-1983,1982-09-14,1983-05-12,241,0,57,417,474,213,269,482,956,64,385,Wyoming,Casper,55316
22382,1983-1984,1983-09-19,1984-05-06,231,0,145,602,747,206,346,552,1299,72,524,Wyoming,Casper,55316
22383,1984-1985,1984-09-23,1985-04-27,217,0,112,652,764,113,156,269,1033,57,403,Wyoming,Casper,55316
22384,1985-1986,1985-09-22,1986-05-16,237,0,112,531,643,151,261,412,1055,59,413,Wyoming,Casper,55316
22385,1986-1987,1986-10-02,1987-04-20,201,0,78,453,531,161,276,437,968,61,396,Wyoming,Casper,55316
22386,1987-1988,1987-10-13,1988-05-02,203,0,91,535,626,98,197,295,921,47,298,Wyoming,Casper,55316
22387,1988-1989,1988-11-09,1989-04-30,173,0,146,549,695,89,189,278,973,49,426,Wyoming,Casper,55316
22388,1989-1990,1989-10-15,1990-05-11,209,1,52,477,529,84,102,186,715,48,268,Wyoming,Casper,55316
22389,1990-1991,1990-10-06,1991-05-04,211,0,100,531,631,96,156,252,883,43,307,Wyoming,Casper,55316
22390,1991-1992,1991-10-03,1992-03-31,181,0,41,363,404,70,114,184,588,37,204,Wyoming,Casper,55316
22391,1992-1993,1992-10-06,1993-05-08,215,0,94,519,613,123,258,381,994,52,361,Wyoming,Casper,55316
22392,1993-1994,1993-09-13,1994-04-28,228,0,57,429,486,104,132,236,722,58,327,Wyoming,Casper,55316
22393,1994-1995,1994-09-21,1995-06-09,262,0,63,411,474,148,164,312,786,56,316,Wyoming,Casper,55316
22394,2004-2005,2004-10-25,2005-04-29,187,5,46,424,470,87,19,106,576,35,211,Wyoming,Casper,55316
22395,2005-2006,2005-10-04,2006-05-04,213,12,79,463,542,109,45,154,696,38,272,Wyoming,Casper,55316
22396,2006-2007,2006-10-09,2007-05-06,210,0,81,498,579,95,129,224,803,39,279,Wyoming,Casper,55316
22397,2007-2008,2007-10-20,2008-05-10,204,0,89,569,658,93,132,225,883,50,315,Wyoming,Casper,55316
22398,2008-2009,2008-10-10,2009-04-26,199,0,81,519,600,109,100,209,809,41,308,Wyoming,Casper,55316
22399,2009-2010,2009-09-30,2010-05-12,225,0,91,585,676,116,194,310,986,51,365,Wyoming,Casper,55316
22400,2010-2011,2010-11-09,2011-05-19,192,2,96,499,595,101,181,282,877,48,301,Wyoming,Casper,55316
22401,2011-2012,2011-10-25,2012-04-16,175,0,49,426,475,79,93,172,647,38,226,Wyoming,Casper,55316
22402,2012-2013,2012-10-05,2013-05-02,210,0,79,540,619,125,116,241,860,45,336,Wyoming,Casper,55316
22403,2013-2014,2013-09-27,2014-05-11,227,2,114,608,722,134,149,283,1005,58,450,Wyoming,Casper,55316
22404,2014-2015,2014-09-11,2015-05-20,252,0,89,496,585,101,156,257,842,44,303,Wyoming,Casper,55316
22405,2015-2016,2015-11-18,2016-04-30,165,0,76,405,481,127,217,344,825,42,303,Wyoming,Casper,55316
22406,2016-2017,2016-11-17,2017-05-19,184,0,96,466,562,109,151,260,822,42,296,Wyoming,Casper,55316
22407,2017-2018,2017-10-02,2018-04-17,198,1,79,538,617,110,192,302,919,46,320,Wyoming,Casper,55316
22408,2018-2019,2018-10-05,2019-05-22,230,0,81,562,643,120,118,238,881,57,365,Wyoming,Casper,55316
22409,2019-2020,2019-10-09,2020-04-16,191,0,95,519,614,146,247,393,1007,51,382,Wyoming,Casper,55316
22410,1950-1951,1950-10-01,1951-04-26,208,1,67,497,564,60,69,129,693,38,280,Wyoming,Cheyenne,59466
22411,1951-1952,1951-10-05,1952-04-22,201,2,64,509,573,85,110,195,768,41,241,Wyoming,Cheyenne,59466
22412,1952-1953,1952-10-05,1953-05-12,220,0,59,456,515,91,142,233,748,39,243,Wyoming,Cheyenne,59466
22413,1953-1954,1953-10-03,1954-05-03,213,1,45,404,449,70,74,144,593,35,212,Wyoming,Cheyenne,59466
22414,1954-1955,1954-09-29,1955-05-02,216,1,72,484,556,70,157,227,783,34,242,Wyoming,Cheyenne,59466
22415,1955-1956,1955-10-06,1956-05-13,221,0,78,504,582,68,159,227,809,35,238,Wyoming,Cheyenne,59466
22416,1956-1957,1956-11-01,1957-05-18,199,0,56,448,504,106,187,293,797,47,323,Wyoming,Cheyenne,59466
22417,1957-1958,1957-10-25,1958-04-26,184,0,52,422,474,73,94,167,641,48,244,Wyoming,Cheyenne,59466
22418,1958-1959,1958-11-05,1959-05-22,199,1,73,465,538,110,158,268,806,54,333,Wyoming,Cheyenne,59466
22419,1959-1960,1959-09-29,1960-04-30,215,3,97,515,612,62,89,151,763,35,241,Wyoming,Cheyenne,59466
22420,1960-1961,1960-11-04,1961-05-16,194,0,52,431,483,93,151,244,727,43,243,Wyoming,Cheyenne,59466
22421,1961-1962,1961-09-21,1962-04-10,202,1,128,589,717,73,168,241,958,43,333,Wyoming,Cheyenne,59466
22422,1962-1963,1962-11-15,1963-04-27,164,0,91,444,535,57,115,172,707,34,244,Wyoming,Cheyenne,59466
22423,1963-1964,1963-11-16,1964-05-08,175,0,73,493,566,51,55,106,672,42,243,Wyoming,Cheyenne,59466
22424,1964-1965,1964-11-13,1965-05-25,194,0,71,470,541,59,75,134,675,41,242,Wyoming,Cheyenne,59466
22425,1965-1966,1965-09-16,1966-04-21,218,1,50,435,485,31,38,69,554,25,122,Wyoming,Cheyenne,59466
22426,1966-1967,1966-10-13,1967-05-14,214,3,29,364,393,85,49,134,527,43,209,Wyoming,Cheyenne,59466
22427,1967-1968,1967-10-15,1968-05-16,215,1,47,465,512,55,79,134,646,35,192,Wyoming,Cheyenne,59466
22428,1968-1969,1968-10-08,1969-04-15,190,0,51,433,484,43,60,103,587,28,143,Wyoming,Cheyenne,59466
22429,1969-1970,1969-10-03,1970-04-23,203,0,44,449,493,84,147,231,724,38,185,Wyoming,Cheyenne,59466
22430,1970-1971,1970-10-06,1971-05-18,225,0,63,459,522,101,132,233,755,46,248,Wyoming,Cheyenne,59466
22431,1971-1972,1971-09-16,1972-05-13,241,1,49,430,479,66,60,126,605,31,182,Wyoming,Cheyenne,59466
22432,1972-1973,1972-10-27,1973-05-01,187,0,110,506,616,109,234,343,959,56,357,Wyoming,Cheyenne,59466
22433,1973-1974,1973-10-09,1974-04-13,187,0,73,372,445,90,150,240,685,36,236,Wyoming,Cheyenne,59466
22434,1974-1975,1974-09-11,1975-05-06,238,1,71,525,596,68,65,133,729,43,258,Wyoming,Cheyenne,59466
22435,1975-1976,1975-09-19,1976-04-28,223,1,54,444,498,76,165,241,739,35,266,Wyoming,Cheyenne,59466
22436,1976-1977,1976-10-05,1977-04-18,196,1,40,499,539,58,45,103,642,39,199,Wyoming,Cheyenne,59466
22437,1977-1978,1977-10-10,1978-05-09,212,1,73,465,538,76,117,193,731,36,251,Wyoming,Cheyenne,59466
22438,1978-1979,1978-09-20,1979-05-10,233,0,105,514,619,112,232,344,963,47,286,Wyoming,Cheyenne,59466
22439,1979-1980,1979-10-29,1980-05-12,197,0,73,453,526,171,455,626,1152,49,390,Wyoming,Cheyenne,59466
22440,1980-1981,1980-10-15,1981-05-13,211,0,27,337,364,50,49,99,463,37,161,Wyoming,Cheyenne,59466
22441,1981-1982,1981-10-17,1982-05-13,209,1,54,444,498,51,39,90,588,37,219,Wyoming,Cheyenne,59466
22442,1982-1983,1982-10-08,1983-05-18,223,0,49,433,482,142,179,321,803,39,267,Wyoming,Cheyenne,59466
22443,1983-1984,1983-10-11,1984-04-29,202,0,134,553,687,149,273,422,1109,58,466,Wyoming,Cheyenne,59466
22444,1984-1985,1984-09-24,1985-05-13,232,0,81,560,641,57,75,132,773,41,241,Wyoming,Cheyenne,59466
22445,1985-1986,1985-09-22,1986-05-16,237,1,79,421,500,102,188,290,790,56,330,Wyoming,Cheyenne,59466
22446,1986-1987,1986-10-02,1987-04-21,202,1,55,409,464,78,104,182,646,43,211,Wyoming,Cheyenne,59466
22447,1987-1988,1987-10-09,1988-05-02,207,0,87,494,581,104,258,362,943,49,331,Wyoming,Cheyenne,59466
22448,1988-1989,1988-09-12,1989-04-27,228,0,95,475,570,70,113,183,753,39,291,Wyoming,Cheyenne,59466
22449,1989-1990,1989-09-11,1990-05-12,244,0,63,449,512,127,226,353,865,55,359,Wyoming,Cheyenne,59466
22450,1990-1991,1990-10-06,1991-04-29,206,0,76,464,540,82,95,177,717,47,313,Wyoming,Cheyenne,59466
22451,1991-1992,1991-10-04,1992-05-27,237,0,40,358,398,88,143,231,629,37,211,Wyoming,Cheyenne,59466
22452,1992-1993,1992-10-06,1993-06-07,245,0,75,461,536,125,314,439,975,58,336,Wyoming,Cheyenne,59466
22453,1993-1994,1993-09-13,1994-04-29,229,0,53,455,508,118,179,297,805,57,323,Wyoming,Cheyenne,59466
22454,1994-1995,1994-09-21,1995-05-23,245,0,57,378,435,100,109,209,644,51,274,Wyoming,Cheyenne,59466
22455,1995-1996,1995-09-20,1996-05-26,250,3,78,496,574,95,98,193,767,44,266,Wyoming,Cheyenne,59466
22456,1996-1997,1996-09-26,1997-05-28,245,0,96,489,585,99,117,216,801,50,331,Wyoming,Cheyenne,59466
22457,1997-1998,1997-10-12,1998-06-05,237,0,49,430,479,79,93,172,651,49,225,Wyoming,Cheyenne,59466
22458,1998-1999,1998-10-17,1999-05-17,213,0,53,365,418,78,84,162,580,39,205,Wyoming,Cheyenne,59466
22459,1999-2000,1999-09-28,2000-05-17,233,0,22,339,361,70,56,126,487,35,156,Wyoming,Cheyenne,59466
22460,2000-2001,2000-09-22,2001-05-20,241,1,70,475,545,131,95,226,771,55,341,Wyoming,Cheyenne,59466
22461,2001-2002,2001-10-04,2002-05-24,233,0,57,493,550,64,47,111,661,41,232,Wyoming,Cheyenne,59466
22462,2002-2003,2002-10-02,2003-05-10,221,3,62,363,425,106,65,171,596,45,256,Wyoming,Cheyenne,59466
22463,2003-2004,2003-09-14,2004-05-25,255,0,48,369,417,73,54,127,544,39,184,Wyoming,Cheyenne,59466
22464,2004-2005,2004-10-31,2005-05-11,193,0,38,326,364,96,50,146,510,41,229,Wyoming,Cheyenne,59466
22465,2005-2006,2005-10-09,2006-05-09,213,0,67,377,444,85,89,174,618,35,242,Wyoming,Cheyenne,59466
22466,2006-2007,2006-10-09,2007-06-07,242,0,71,447,518,78,87,165,683,30,242,Wyoming,Cheyenne,59466
22467,2007-2008,2007-10-14,2008-05-10,210,0,72,476,548,71,108,179,727,42,218,Wyoming,Cheyenne,59466
22468,2008-2009,2008-10-12,2009-05-10,211,0,51,413,464,103,86,189,653,39,250,Wyoming,Cheyenne,59466
22469,2009-2010,2009-10-08,2010-05-13,218,0,74,480,554,155,162,317,871,56,363,Wyoming,Cheyenne,59466
22470,2010-2011,2010-10-25,2011-05-19,207,0,64,428,492,90,69,159,651,56,269,Wyoming,Cheyenne,59466
22471,2011-2012,2011-10-08,2012-05-11,217,0,38,414,452,79,92,171,623,37,212,Wyoming,Cheyenne,59466
22472,2012-2013,2012-10-06,2013-05-03,210,3,76,495,571,125,121,246,817,45,317,Wyoming,Cheyenne,59466
22473,2013-2014,2013-10-04,2014-05-13,222,0,86,482,568,136,156,292,860,57,379,Wyoming,Cheyenne,59466
22474,2014-2015,2014-09-11,2015-05-11,243,0,69,387,456,85,82,167,623,42,265,Wyoming,Cheyenne,59466
22475,2015-2016,2015-11-04,2016-05-16,195,0,51,358,409,135,182,317,726,47,265,Wyoming,Cheyenne,59466
22476,2016-2017,2016-11-17,2017-05-20,185,0,52,350,402,82,76,158,560,32,210,Wyoming,Cheyenne,59466
22477,2017-2018,2017-10-02,2018-04-24,205,0,35,410,445,84,64,148,593,46,250,Wyoming,Cheyenne,59466
22478,2018-2019,2018-10-10,2019-05-22,225,0,63,457,520,121,78,199,719,51,312,Wyoming,Cheyenne,59466
22479,2019-2020,2019-10-09,2020-04-17,192,0,60,440,500,109,133,242,742,51,322,Wyoming,Cheyenne,59466
22480,1950-1951,1950-10-01,1951-04-19,201,18,80,592,672,50,54,104,776,22,173,Wyoming,Gillette,29087
22481,1955-1956,1955-09-25,1956-04-28,217,18,124,641,765,102,280,382,1147,41,304,Wyoming,Gillette,29087
22482,1956-1957,1956-10-24,1957-04-17,176,18,116,603,719,76,94,170,889,37,304,Wyoming,Gillette,29087
22483,1957-1958,1957-10-07,1958-04-28,204,14,58,469,527,80,101,181,708,47,286,Wyoming,Gillette,29087
22484,1959-1960,1959-09-29,1960-04-27,212,3,133,610,743,83,144,227,970,47,386,Wyoming,Gillette,29087
22485,1960-1961,1960-11-04,1961-04-24,172,4,53,431,484,85,199,284,768,35,207,Wyoming,Gillette,29087
22486,1961-1962,1961-10-08,1962-03-31,175,12,171,589,760,76,241,317,1077,43,373,Wyoming,Gillette,29087
22487,1962-1963,1962-09-09,1963-04-23,227,2,98,506,604,106,167,273,877,48,363,Wyoming,Gillette,29087
22488,1963-1964,1963-10-31,1964-05-11,194,3,90,526,616,95,230,325,941,51,320,Wyoming,Gillette,29087
22489,1964-1965,1964-11-12,1965-05-10,180,1,121,578,699,142,342,484,1183,50,364,Wyoming,Gillette,29087
22490,1965-1966,1965-09-16,1966-05-11,238,0,81,549,630,99,143,242,872,46,321,Wyoming,Gillette,29087
22491,1966-1967,1966-10-14,1967-05-06,205,1,66,513,579,110,166,276,855,44,316,Wyoming,Gillette,29087
22492,1967-1968,1967-10-24,1968-04-23,183,1,83,570,653,87,184,271,924,42,292,Wyoming,Gillette,29087
22493,1968-1969,1968-11-05,1969-06-13,221,13,128,604,732,114,293,407,1139,49,365,Wyoming,Gillette,29087
22494,1969-1970,1969-10-11,1970-05-14,216,2,85,525,610,126,206,332,942,53,336,Wyoming,Gillette,29087
22495,1970-1971,1970-09-13,1971-05-19,249,0,104,592,696,126,299,425,1121,50,351,Wyoming,Gillette,29087
22496,1971-1972,1971-09-28,1972-05-01,217,0,108,570,678,116,170,286,964,47,341,Wyoming,Gillette,29087
22497,1972-1973,1972-09-25,1973-04-23,211,2,128,604,732,125,158,283,1015,44,395,Wyoming,Gillette,29087
22498,1973-1974,1973-10-09,1974-04-13,187,0,91,476,567,96,152,248,815,42,263,Wyoming,Gillette,29087
22499,1974-1975,1974-10-05,1975-05-25,233,1,87,563,650,115,110,225,875,54,344,Wyoming,Gillette,29087
22500,1975-1976,1975-10-23,1976-04-30,191,1,81,474,555,101,208,309,864,51,333,Wyoming,Gillette,29087
22501,1976-1977,1976-10-18,1977-04-18,183,5,79,561,640,130,456,586,1226,51,412,Wyoming,Gillette,29087
22502,1977-1978,1977-10-10,1978-05-08,211,2,153,620,773,114,333,447,1220,52,416,Wyoming,Gillette,29087
22503,1978-1979,1978-11-09,1979-05-09,182,1,223,725,948,130,553,683,1631,61,537,Wyoming,Gillette,29087
22504,1979-1980,1979-10-21,1980-04-11,174,0,81,509,590,95,83,178,768,52,345,Wyoming,Gillette,29087
22505,1980-1981,1980-09-16,1981-04-03,200,0,41,369,410,53,39,92,502,29,176,Wyoming,Gillette,29087
22506,1981-1982,1981-10-21,1982-05-10,202,2,109,577,686,108,124,232,918,59,431,Wyoming,Gillette,29087
22507,1982-1983,1982-09-30,1983-05-12,225,9,37,410,447,110,126,236,683,49,243,Wyoming,Gillette,29087
22508,1983-1984,1983-09-19,1984-05-06,231,5,155,591,746,134,340,474,1220,53,356,Wyoming,Gillette,29087
22509,1984-1985,1984-09-24,1985-04-24,213,2,117,580,697,63,103,166,863,41,232,Wyoming,Gillette,29087
22510,1985-1986,1985-09-23,1986-05-23,243,1,152,537,689,102,317,419,1108,57,322,Wyoming,Gillette,29087
22511,1986-1987,1986-10-11,1987-04-20,192,3,85,401,486,70,147,217,703,33,194,Wyoming,Gillette,29087
22512,1987-1988,1987-10-09,1988-05-02,207,2,107,524,631,74,80,154,785,47,285,Wyoming,Gillette,29087
22513,1988-1989,1988-09-19,1989-05-13,237,2,176,566,742,88,149,237,979,54,407,Wyoming,Gillette,29087
22514,1989-1990,1989-10-15,1990-05-13,211,3,96,495,591,119,246,365,956,46,316,Wyoming,Gillette,29087
22515,1990-1991,1990-10-06,1991-05-03,210,1,155,550,705,91,159,250,955,49,311,Wyoming,Gillette,29087
22516,1991-1992,1991-10-24,1992-05-16,206,1,51,388,439,49,73,122,561,25,141,Wyoming,Gillette,29087
22517,1992-1993,1992-10-06,1993-04-30,207,7,194,619,813,109,240,349,1162,60,440,Wyoming,Gillette,29087
22518,1993-1994,1993-10-08,1994-04-30,205,4,116,519,635,115,171,286,921,60,430,Wyoming,Gillette,29087
22519,1994-1995,1994-09-21,1995-05-14,236,2,89,431,520,76,57,133,653,45,236,Wyoming,Gillette,29087
22520,1995-1996,1995-09-19,1996-04-28,223,11,146,612,758,107,284,391,1149,36,325,Wyoming,Gillette,29087
22521,1996-1997,1996-09-25,1997-05-18,236,4,144,650,794,168,470,638,1432,53,414,Wyoming,Gillette,29087
22522,1997-1998,1997-10-13,1998-06-04,235,1,77,475,552,104,259,363,915,38,246,Wyoming,Gillette,29087
22523,1998-1999,1998-11-03,1999-04-14,163,1,59,402,461,92,176,268,729,27,195,Wyoming,Gillette,29087
22524,1999-2000,1999-11-18,2000-04-16,151,0,25,335,360,70,113,183,543,24,142,Wyoming,Gillette,29087
22525,2000-2001,2000-09-22,2001-04-22,213,3,109,588,697,98,345,443,1140,43,299,Wyoming,Gillette,29087
22526,2001-2002,2001-10-18,2002-05-08,203,6,85,554,639,81,151,232,871,35,227,Wyoming,Gillette,29087
22527,2002-2003,2002-10-02,2003-04-07,188,6,70,477,547,101,196,297,844,36,278,Wyoming,Gillette,29087
22528,2003-2004,2003-10-30,2004-04-29,183,0,70,457,527,67,154,221,748,31,202,Wyoming,Gillette,29087
22529,2004-2005,2004-10-29,2005-05-12,196,7,56,418,474,104,157,261,735,26,214,Wyoming,Gillette,29087
22530,2008-2009,2008-10-10,2009-04-26,199,5,74,506,580,108,154,262,842,37,266,Wyoming,Gillette,29087
22531,2009-2010,2009-10-05,2010-05-12,220,6,88,514,602,73,107,180,782,28,219,Wyoming,Gillette,29087
22532,2010-2011,2010-10-27,2011-04-29,185,3,96,523,619,88,236,324,943,38,253,Wyoming,Gillette,29087
22533,2011-2012,2011-11-01,2012-03-04,125,12,26,380,406,52,77,129,535,24,123,Wyoming,Gillette,29087
22534,2012-2013,2012-10-05,2013-04-24,202,3,61,494,555,83,99,182,737,43,257,Wyoming,Gillette,29087
22535,2014-2015,2014-09-11,2015-05-10,242,0,88,424,512,62,110,172,684,29,200,Wyoming,Gillette,29087
22536,2015-2016,2015-11-20,2016-04-27,160,1,45,326,371,56,102,158,529,25,141,Wyoming,Gillette,29087
22537,2016-2017,2016-11-17,2017-04-29,164,0,109,413,522,77,229,306,828,25,214,Wyoming,Gillette,29087
22538,2017-2018,2017-12-01,2018-04-23,144,1,83,377,460,94,137,231,691,33,250,Wyoming,Gillette,29087
22539,2018-2019,2018-09-28,2019-05-22,237,0,115,520,635,96,118,214,849,36,247,Wyoming,Gillette,29087
22540,2019-2020,2019-10-10,2020-04-16,190,2,55,427,482,82,102,184,666,30,191,Wyoming,Gillette,29087
22541,1950-1951,1950-10-01,1951-06-01,244,2,63,784,847,52,74,126,973,25,174,Wyoming,Kaycee,263
22542,1951-1952,1951-10-15,1952-03-31,169,13,64,727,791,37,33,70,861,22,147,Wyoming,Kaycee,263
22543,1952-1953,1952-11-21,1953-05-13,174,0,35,564,599,43,93,136,735,22,135,Wyoming,Kaycee,263
22544,1953-1954,1953-11-18,1954-05-02,166,2,46,504,550,69,137,206,756,32,160,Wyoming,Kaycee,263
22545,1954-1955,1954-10-24,1955-04-11,170,4,58,624,682,95,122,217,899,36,257,Wyoming,Kaycee,263
22546,1955-1956,1955-09-25,1956-04-23,212,0,92,751,843,83,257,340,1183,28,224,Wyoming,Kaycee,263
22547,1956-1957,1956-11-03,1957-04-27,176,0,71,657,728,53,51,104,832,30,193,Wyoming,Kaycee,263
22548,1957-1958,1957-10-07,1958-04-23,199,0,31,555,586,78,87,165,751,39,201,Wyoming,Kaycee,263
22549,1958-1959,1958-11-11,1959-05-05,176,5,69,597,666,73,214,287,953,36,248,Wyoming,Kaycee,263
22550,1959-1960,1959-10-29,1960-04-29,184,6,89,652,741,64,128,192,933,28,273,Wyoming,Kaycee,263
22551,1960-1961,1960-11-04,1961-04-26,174,2,18,517,535,51,55,106,641,21,125,Wyoming,Kaycee,263
22552,1961-1962,1961-09-29,1962-03-31,184,1,119,720,839,79,326,405,1244,37,271,Wyoming,Kaycee,263
22553,1962-1963,1962-11-21,1963-04-22,153,0,69,591,660,34,111,145,805,19,163,Wyoming,Kaycee,263
22554,1963-1964,1963-10-31,1964-04-12,165,2,54,641,695,43,85,128,823,30,186,Wyoming,Kaycee,263
22555,1964-1965,1964-11-14,1965-05-09,177,0,65,654,719,83,249,332,1051,37,269,Wyoming,Kaycee,263
22556,1965-1966,1965-09-16,1966-04-29,226,0,50,656,706,57,79,136,842,24,169,Wyoming,Kaycee,263
22557,1966-1967,1966-11-08,1967-05-13,187,2,32,540,572,100,168,268,840,36,243,Wyoming,Kaycee,263
22558,1967-1968,1967-10-26,1968-04-21,179,2,64,646,710,82,150,232,942,39,310,Wyoming,Kaycee,263
22559,1968-1969,1968-11-25,1969-06-13,201,0,67,623,690,60,155,215,905,31,214,Wyoming,Kaycee,263
22560,1969-1970,1969-10-12,1970-04-28,199,3,46,632,678,50,53,103,781,27,131,Wyoming,Kaycee,263
22561,1970-1971,1970-09-13,1971-04-26,226,0,50,669,719,50,83,133,852,29,180,Wyoming,Kaycee,263
22562,1971-1972,1971-10-27,1972-04-20,177,1,67,592,659,86,267,353,1012,35,258,Wyoming,Kaycee,263
22563,1972-1973,1972-09-25,1973-05-01,219,0,102,719,821,103,129,232,1053,34,252,Wyoming,Kaycee,263
22564,1973-1974,1973-10-10,1974-04-21,194,0,63,567,630,59,99,158,788,35,211,Wyoming,Kaycee,263
22565,1974-1975,1974-11-13,1975-05-20,189,2,50,591,641,82,106,188,829,42,258,Wyoming,Kaycee,263
22566,1975-1976,1975-10-23,1976-04-27,188,1,55,595,650,87,269,356,1006,42,299,Wyoming,Kaycee,263
22567,1976-1977,1976-10-17,1977-04-19,185,0,35,641,676,63,70,133,809,32,184,Wyoming,Kaycee,263
22568,1977-1978,1977-10-10,1978-05-07,210,0,76,679,755,65,186,251,1006,35,263,Wyoming,Kaycee,263
22569,1978-1979,1978-11-09,1979-05-10,183,0,157,892,1049,80,650,730,1779,35,257,Wyoming,Kaycee,263
22570,1979-1980,1979-11-09,1980-04-11,155,3,62,566,628,49,58,107,735,34,187,Wyoming,Kaycee,263
22571,1980-1981,1980-11-13,1981-04-04,143,0,24,418,442,31,53,84,526,17,108,Wyoming,Kaycee,263
22572,1981-1982,1981-11-24,1982-05-10,168,2,50,588,638,64,118,182,820,34,242,Wyoming,Kaycee,263
22573,1982-1983,1982-09-14,1983-05-12,241,3,18,478,496,46,93,139,635,25,114,Wyoming,Kaycee,263
22574,1983-1984,1983-11-08,1984-04-28,173,10,110,670,780,52,230,282,1062,19,136,Wyoming,Kaycee,263
22575,1985-1986,1985-09-28,1986-04-13,198,18,101,607,708,42,293,335,1043,16,121,Wyoming,Kaycee,263
22576,1989-1990,1989-10-31,1990-04-10,162,4,45,521,566,64,59,123,689,22,145,Wyoming,Kaycee,263
22577,1990-1991,1990-11-01,1991-04-26,177,4,99,605,704,73,201,274,978,22,212,Wyoming,Kaycee,263
22578,1991-1992,1991-10-23,1992-03-20,150,9,32,483,515,51,47,98,613,16,110,Wyoming,Kaycee,263
22579,1997-1998,1997-10-23,1998-06-03,224,14,59,599,658,118,257,375,1033,28,233,Wyoming,Kaycee,263
22580,1998-1999,1998-10-29,1999-04-22,176,14,52,478,530,53,81,134,664,17,125,Wyoming,Kaycee,263
22581,2009-2010,2009-10-09,2010-05-12,216,18,104,648,752,47,130,177,929,19,137,Wyoming,Kaycee,263
22582,2010-2011,2010-11-15,2011-04-30,167,7,90,593,683,47,139,186,869,18,128,Wyoming,Kaycee,263
22583,2011-2012,2011-11-02,2012-03-04,124,0,39,441,480,40,68,108,588,10,90,Wyoming,Kaycee,263
22584,2012-2013,2012-10-05,2013-04-24,202,3,61,594,655,54,77,131,786,18,119,Wyoming,Kaycee,263
22585,2013-2014,2013-09-27,2014-04-15,201,3,125,614,739,75,178,253,992,28,191,Wyoming,Kaycee,263
22586,2014-2015,2014-09-12,2015-05-20,251,1,83,590,673,57,208,265,938,15,126,Wyoming,Kaycee,263
22587,2015-2016,2015-11-21,2016-04-27,159,0,57,451,508,36,93,129,637,12,87,Wyoming,Kaycee,263
22588,2016-2017,2016-11-17,2017-05-19,184,0,87,539,626,59,143,202,828,12,113,Wyoming,Kaycee,263
22589,2017-2018,2017-10-14,2018-04-18,187,0,93,670,763,71,181,252,1015,19,152,Wyoming,Kaycee,263
22590,2018-2019,2018-09-28,2019-05-22,237,0,97,625,722,70,90,160,882,27,195,Wyoming,Kaycee,263
22591,2019-2020,2019-10-11,2020-04-17,190,0,62,619,681,91,198,289,970,24,179,Wyoming,Kaycee,263
22592,1950-1951,1950-10-01,1951-06-02,245,1,70,562,632,113,123,236,868,35,291,Wyoming,Lander,7487
22593,1951-1952,1951-10-31,1952-05-15,198,0,95,637,732,89,275,364,1096,31,226,Wyoming,Lander,7487
22594,1952-1953,1952-10-13,1953-05-12,212,0,75,557,632,155,364,519,1151,40,299,Wyoming,Lander,7487
22595,1953-1954,1953-10-21,1954-05-03,195,0,44,454,498,112,188,300,798,32,222,Wyoming,Lander,7487
22596,1954-1955,1954-10-24,1955-04-12,171,0,78,599,677,120,323,443,1120,33,314,Wyoming,Lander,7487
22597,1955-1956,1955-09-24,1956-05-13,233,0,128,663,791,136,306,442,1233,38,285,Wyoming,Lander,7487
22598,1956-1957,1956-10-24,1957-05-15,204,0,79,573,652,109,212,321,973,28,227,Wyoming,Lander,7487
22599,1957-1958,1957-09-19,1958-05-14,238,0,46,528,574,130,317,447,1021,35,235,Wyoming,Lander,7487
22600,1958-1959,1958-11-10,1959-05-23,195,0,92,548,640,195,418,613,1253,49,389,Wyoming,Lander,7487
22601,1959-1960,1959-09-28,1960-04-29,215,0,126,647,773,123,427,550,1323,38,300,Wyoming,Lander,7487
22602,1960-1961,1960-10-09,1961-04-25,199,0,62,548,610,109,323,432,1042,32,198,Wyoming,Lander,7487
22603,1961-1962,1961-09-23,1962-04-07,197,0,193,725,918,156,555,711,1629,42,388,Wyoming,Lander,7487
22604,1962-1963,1962-09-08,1963-04-25,230,0,124,578,702,123,306,429,1131,31,306,Wyoming,Lander,7487
22605,1963-1964,1963-10-30,1964-05-11,195,0,95,613,708,133,397,530,1238,38,288,Wyoming,Lander,7487
22606,1964-1965,1964-10-22,1965-05-10,201,0,80,561,641,100,144,244,885,32,233,Wyoming,Lander,7487
22607,1965-1966,1965-09-15,1966-05-12,240,0,74,539,613,149,331,480,1093,38,300,Wyoming,Lander,7487
22608,1966-1967,1966-10-02,1967-05-14,225,0,54,505,559,196,288,484,1043,47,348,Wyoming,Lander,7487
22609,1967-1968,1967-10-26,1968-05-16,204,0,141,645,786,181,715,896,1682,46,398,Wyoming,Lander,7487
22610,1968-1969,1968-10-16,1969-06-13,241,0,81,555,636,97,218,315,951,31,215,Wyoming,Lander,7487
22611,1969-1970,1969-10-03,1970-04-29,209,0,58,536,594,170,222,392,986,49,310,Wyoming,Lander,7487
22612,1970-1971,1970-09-12,1971-05-18,249,0,82,570,652,172,278,450,1102,41,313,Wyoming,Lander,7487
22613,1971-1972,1971-09-16,1972-04-30,228,0,102,580,682,178,486,664,1346,46,338,Wyoming,Lander,7487
22614,1972-1973,1972-10-05,1973-05-02,210,0,250,827,1077,300,1038,1338,2415,57,558,Wyoming,Lander,7487
22615,1973-1974,1973-10-09,1974-05-21,225,0,91,550,641,140,325,465,1106,35,293,Wyoming,Lander,7487
22616,1974-1975,1974-09-11,1975-05-25,257,0,92,630,722,185,350,535,1257,48,366,Wyoming,Lander,7487
22617,1975-1976,1975-10-14,1976-06-14,245,0,117,603,720,123,397,520,1240,36,313,Wyoming,Lander,7487
22618,1976-1977,1976-10-06,1977-05-05,212,0,67,576,643,153,498,651,1294,39,300,Wyoming,Lander,7487
22619,1977-1978,1977-10-10,1978-05-30,233,0,101,544,645,112,300,412,1057,31,256,Wyoming,Lander,7487
22620,1978-1979,1978-09-18,1979-06-08,264,0,282,894,1176,221,803,1024,2200,49,473,Wyoming,Lander,7487
22621,1979-1980,1979-10-28,1980-05-12,198,0,123,644,767,176,482,658,1425,44,375,Wyoming,Lander,7487
22622,1980-1981,1980-10-15,1981-04-04,172,0,52,405,457,97,171,268,725,31,207,Wyoming,Lander,7487
22623,1981-1982,1981-10-24,1982-05-11,200,0,70,521,591,63,65,128,719,27,170,Wyoming,Lander,7487
22624,1982-1983,1982-09-13,1983-05-16,246,0,90,523,613,227,544,771,1384,50,354,Wyoming,Lander,7487
22625,1983-1984,1983-09-19,1984-05-06,231,0,225,723,948,223,1039,1262,2210,59,508,Wyoming,Lander,7487
22626,1984-1985,1984-09-23,1985-04-27,217,0,111,610,721,78,192,270,991,32,205,Wyoming,Lander,7487
22627,1985-1986,1985-09-22,1986-05-16,237,0,180,637,817,164,741,905,1722,43,390,Wyoming,Lander,7487
22628,1986-1987,1986-10-02,1987-04-19,200,0,111,552,663,168,621,789,1452,46,366,Wyoming,Lander,7487
22629,1987-1988,1987-10-13,1988-05-02,203,0,106,560,666,111,371,482,1148,41,269,Wyoming,Lander,7487
22630,1988-1989,1988-09-18,1989-04-30,225,0,140,602,742,76,259,335,1077,33,284,Wyoming,Lander,7487
22631,1989-1990,1989-10-02,1990-05-08,219,0,54,462,516,91,130,221,737,38,210,Wyoming,Lander,7487
22632,1990-1991,1990-10-06,1991-05-03,210,0,109,571,680,144,375,519,1199,38,298,Wyoming,Lander,7487
22633,1991-1992,1991-10-03,1992-03-21,171,0,89,487,576,102,489,591,1167,33,231,Wyoming,Lander,7487
22634,1992-1993,1992-10-06,1993-06-03,241,0,217,728,945,141,826,967,1912,40,338,Wyoming,Lander,7487
22635,1993-1994,1993-09-13,1994-04-27,227,0,65,538,603,126,397,523,1126,44,296,Wyoming,Lander,7487
22636,1994-1995,1994-10-03,1995-06-09,250,0,80,476,556,151,184,335,891,53,293,Wyoming,Lander,7487
22637,1995-1996,1995-09-20,1996-04-27,221,0,97,535,632,120,272,392,1024,28,226,Wyoming,Lander,7487
22638,2004-2005,2004-10-22,2005-05-11,202,13,52,449,501,126,45,171,672,30,218,Wyoming,Lander,7487
22639,2005-2006,2005-10-04,2006-05-04,213,14,80,492,572,98,53,151,723,24,184,Wyoming,Lander,7487
22640,2006-2007,2006-10-09,2007-05-06,210,0,84,518,602,105,233,338,940,27,242,Wyoming,Lander,7487
22641,2007-2008,2007-09-24,2008-05-26,246,0,130,645,775,140,542,682,1457,45,319,Wyoming,Lander,7487
22642,2008-2009,2008-10-10,2009-04-27,200,0,66,493,559,161,181,342,901,31,283,Wyoming,Lander,7487
22643,2009-2010,2009-09-30,2010-05-13,226,9,140,617,757,181,671,852,1609,41,358,Wyoming,Lander,7487
22644,2010-2011,2010-11-09,2011-05-30,203,0,97,524,621,102,222,324,945,36,249,Wyoming,Lander,7487
22645,2011-2012,2011-10-07,2012-05-25,232,0,73,479,552,92,351,443,995,33,201,Wyoming,Lander,7487
22646,2012-2013,2012-10-05,2013-05-02,210,0,102,568,670,158,320,478,1148,40,348,Wyoming,Lander,7487
22647,2015-2016,2015-11-16,2016-04-28,165,0,82,452,534,110,402,512,1046,32,214,Wyoming,Lander,7487
22648,2016-2017,2016-11-17,2017-05-19,184,0,142,542,684,121,395,516,1200,24,258,Wyoming,Lander,7487
22649,2017-2018,2017-10-02,2018-04-24,205,0,89,548,637,91,264,355,992,36,220,Wyoming,Lander,7487
22650,2018-2019,2018-10-08,2019-05-23,228,0,122,626,748,116,291,407,1155,40,257,Wyoming,Lander,7487
22651,2019-2020,2019-10-09,2020-04-18,193,0,125,644,769,137,726,863,1632,41,339,Wyoming,Lander,7487
22652,1950-1951,1950-10-01,1951-06-01,244,1,71,718,789,27,32,59,848,11,90,Wyoming,Redbird,0
22653,1951-1952,1951-10-26,1952-04-08,166,0,78,645,723,34,102,136,859,9,75,Wyoming,Redbird,0
22654,1953-1954,1953-11-18,1954-03-31,134,12,30,451,481,45,99,144,625,13,95,Wyoming,Redbird,0
22655,1954-1955,1954-10-25,1955-04-13,171,1,66,582,648,101,326,427,1075,23,193,Wyoming,Redbird,0
22656,1955-1956,1955-10-23,1956-04-28,189,12,90,658,748,65,215,280,1028,20,152,Wyoming,Redbird,0
22657,1956-1957,1956-10-24,1957-04-13,172,0,99,628,727,72,202,274,1001,21,180,Wyoming,Redbird,0
22658,1957-1958,1957-10-24,1958-04-25,184,0,34,500,534,46,120,166,700,17,104,Wyoming,Redbird,0
22659,1958-1959,1958-11-16,1959-04-19,155,1,72,546,618,69,191,260,878,20,179,Wyoming,Redbird,0
22660,1959-1960,1959-11-04,1960-04-28,177,1,84,603,687,54,153,207,894,18,145,Wyoming,Redbird,0
22661,1960-1961,1960-11-04,1961-04-14,162,1,31,511,542,39,241,280,822,11,76,Wyoming,Redbird,0
22662,1961-1962,1961-09-30,1962-03-19,171,2,115,633,748,44,157,201,949,16,148,Wyoming,Redbird,0
22663,1962-1963,1962-12-01,1963-04-22,143,1,77,530,607,24,147,171,778,9,85,Wyoming,Redbird,0
22664,1963-1964,1963-11-21,1964-03-25,126,0,59,537,596,19,57,76,672,9,69,Wyoming,Redbird,0
22665,1964-1965,1964-11-15,1965-05-09,176,2,73,608,681,41,126,167,848,15,112,Wyoming,Redbird,0
22666,1965-1966,1965-09-16,1966-04-21,218,0,59,644,703,42,192,234,937,12,103,Wyoming,Redbird,0
22667,1967-1968,1967-11-02,1968-04-04,155,1,62,589,651,36,145,181,832,10,89,Wyoming,Redbird,0
22668,1969-1970,1969-10-12,1970-04-21,192,0,63,615,678,51,96,147,825,13,105,Wyoming,Redbird,0
22669,1970-1971,1970-09-13,1971-04-26,226,1,93,638,731,52,171,223,954,24,142,Wyoming,Redbird,0
22670,1971-1972,1971-10-27,1972-04-18,175,0,81,666,747,45,110,155,902,20,175,Wyoming,Redbird,0
22671,1973-1974,1973-11-01,1974-04-13,164,4,94,479,573,47,220,267,840,12,106,Wyoming,Redbird,0
22672,1975-1976,1975-10-23,1976-03-20,150,4,80,496,576,76,164,240,816,21,185,Wyoming,Redbird,0
22673,1976-1977,1976-11-12,1977-03-30,139,1,66,556,622,52,80,132,754,15,120,Wyoming,Redbird,0
22674,1977-1978,1977-10-10,1978-04-10,183,6,167,698,865,105,341,446,1311,35,336,Wyoming,Redbird,0
22675,1978-1979,1978-11-10,1979-04-11,153,13,221,819,1040,83,546,629,1669,22,274,Wyoming,Redbird,0
22676,1979-1980,1979-10-29,1980-04-11,166,0,82,607,689,90,175,265,954,25,261,Wyoming,Redbird,0
22677,1981-1982,1981-12-01,1982-04-08,129,10,113,559,672,68,153,221,893,21,210,Wyoming,Redbird,0
22678,1982-1983,1982-11-01,1983-05-12,193,2,35,478,513,67,119,186,699,17,112,Wyoming,Redbird,0
22679,1984-1985,1984-10-18,1985-03-22,156,3,90,654,744,69,105,174,918,16,168,Wyoming,Redbird,0
22680,1985-1986,1985-11-08,1986-05-09,183,4,136,566,702,129,506,635,1337,28,266,Wyoming,Redbird,0
22681,1986-1987,1986-11-07,1987-04-20,165,4,43,541,584,81,130,211,795,23,171,Wyoming,Redbird,0
22682,1987-1988,1987-10-09,1988-04-26,201,0,83,667,750,60,133,193,943,18,144,Wyoming,Redbird,0
22683,1988-1989,1988-11-18,1989-04-08,142,1,113,557,670,63,83,146,816,19,205,Wyoming,Redbird,0
22684,1989-1990,1989-10-29,1990-04-10,164,0,73,502,575,66,127,193,768,16,176,Wyoming,Redbird,0
22685,1990-1991,1990-10-07,1991-05-03,209,2,94,632,726,72,131,203,929,17,182,Wyoming,Redbird,0
22686,1991-1992,1991-10-28,1992-03-19,144,1,29,482,511,44,65,109,620,10,80,Wyoming,Redbird,0
22687,1992-1993,1992-11-10,1993-04-14,156,1,183,772,955,144,755,899,1854,33,333,Wyoming,Redbird,0
22688,1993-1994,1993-10-08,1994-04-28,203,2,76,571,647,118,205,323,970,26,230,Wyoming,Redbird,0
22689,1994-1995,1994-11-02,1995-04-11,161,0,48,481,529,70,84,154,683,18,161,Wyoming,Redbird,0
22690,1995-1996,1995-09-20,1996-04-21,215,1,106,709,815,102,134,236,1051,26,247,Wyoming,Redbird,0
22691,1996-1997,1996-10-17,1997-04-12,178,2,117,597,714,81,145,226,940,23,240,Wyoming,Redbird,0
22692,1997-1998,1997-10-24,1998-04-17,176,8,43,531,574,89,118,207,781,22,186,Wyoming,Redbird,0
22693,1998-1999,1998-11-03,1999-04-03,152,1,30,389,419,55,59,114,533,18,134,Wyoming,Redbird,0
22694,1999-2000,1999-10-16,2000-04-19,187,5,20,477,497,94,94,188,685,22,152,Wyoming,Redbird,0
22695,2000-2001,2000-09-23,2001-04-23,213,1,99,660,759,99,233,332,1091,23,216,Wyoming,Redbird,0
22696,2001-2002,2001-11-18,2002-05-01,165,0,61,558,619,76,137,213,832,17,142,Wyoming,Redbird,0
22697,2002-2003,2002-10-23,2003-04-04,164,1,53,500,553,69,115,184,737,21,160,Wyoming,Redbird,0
22698,2003-2004,2003-09-18,2004-04-11,207,0,66,511,577,66,149,215,792,20,140,Wyoming,Redbird,0
22699,2004-2005,2004-11-01,2005-05-12,193,0,55,478,533,63,115,178,711,14,111,Wyoming,Redbird,0
22700,2005-2006,2005-11-28,2006-04-24,148,1,65,443,508,64,98,162,670,17,147,Wyoming,Redbird,0
22701,2006-2007,2006-11-10,2007-04-13,155,2,65,508,573,53,60,113,686,14,130,Wyoming,Redbird,0
22702,2007-2008,2007-11-21,2008-05-02,164,1,88,583,671,94,255,349,1020,26,203,Wyoming,Redbird,0
22703,2008-2009,2008-11-06,2009-04-25,171,2,67,517,584,90,137,227,811,24,215,Wyoming,Redbird,0
22704,2009-2010,2009-10-08,2010-05-13,218,0,94,578,672,97,162,259,931,28,231,Wyoming,Redbird,0
22705,2010-2011,2010-11-09,2011-04-19,162,0,90,502,592,87,102,189,781,23,218,Wyoming,Redbird,0
22706,2012-2013,2012-10-05,2013-05-02,210,0,74,616,690,120,136,256,946,29,245,Wyoming,Redbird,0
22707,2013-2014,2013-10-04,2014-04-13,192,0,138,632,770,91,168,259,1029,25,267,Wyoming,Redbird,0
22708,2014-2015,2014-11-10,2015-05-10,182,0,83,516,599,73,218,291,890,17,153,Wyoming,Redbird,0
22709,2015-2016,2015-11-20,2016-04-26,159,0,45,436,481,65,109,174,655,18,137,Wyoming,Redbird,0
22710,2016-2017,2016-11-17,2017-04-28,163,0,105,520,625,81,283,364,989,24,244,Wyoming,Redbird,0
22711,2017-2018,2017-11-02,2018-04-14,164,0,106,606,712,114,393,507,1219,21,225,Wyoming,Redbird,0
22712,2018-2019,2018-09-28,2019-05-22,237,8,102,648,750,124,210,334,1084,23,201,Wyoming,Redbird,0
22713,2019-2020,2019-10-10,2020-04-13,187,1,25,500,525,97,135,232,757,22,174,Wyoming,Redbird,0
22714,1950-1951,1950-11-08,1951-03-18,131,0,96,500,596,33,115,148,744,8,79,Wyoming,Wamsutter,451
22715,1951-1952,1951-11-01,1952-04-03,155,1,164,672,836,36,243,279,1115,15,106,Wyoming,Wamsutter,451
22716,1953-1954,1953-11-18,1954-03-31,134,2,58,437,495,15,51,66,561,6,35,Wyoming,Wamsutter,451
22717,1954-1955,1954-10-26,1955-04-13,170,7,150,711,861,28,359,387,1248,13,84,Wyoming,Wamsutter,451
22718,1955-1956,1955-11-12,1956-04-28,169,1,128,574,702,22,112,134,836,10,63,Wyoming,Wamsutter,451
22719,1956-1957,1956-10-24,1957-04-25,184,0,129,655,784,36,161,197,981,17,101,Wyoming,Wamsutter,451
22720,1957-1958,1957-11-03,1958-04-21,170,1,99,563,662,32,123,155,817,20,104,Wyoming,Wamsutter,451
22721,1958-1959,1958-10-20,1959-05-07,200,0,92,629,721,55,363,418,1139,24,151,Wyoming,Wamsutter,451
22722,1959-1960,1959-10-01,1960-04-29,212,0,138,685,823,28,210,238,1061,18,101,Wyoming,Wamsutter,451
22723,1960-1961,1960-10-29,1961-04-11,165,0,66,567,633,28,68,96,729,19,103,Wyoming,Wamsutter,451
22724,1961-1962,1961-10-08,1962-05-17,222,0,202,734,936,41,293,334,1270,22,140,Wyoming,Wamsutter,451
22725,1967-1968,1967-11-02,1968-04-22,173,1,122,639,761,41,246,287,1048,16,108,Wyoming,Wamsutter,451
22726,1969-1970,1969-10-04,1970-05-10,219,16,86,642,728,76,127,203,931,38,216,Wyoming,Wamsutter,451
22727,1975-1976,1975-10-23,1976-04-17,178,17,96,653,749,33,50,83,832,13,89,Wyoming,Wamsutter,451
22728,1976-1977,1976-11-26,1977-04-03,129,2,53,561,614,21,14,35,649,7,53,Wyoming,Wamsutter,451
22729,1990-1991,1990-11-02,1991-04-13,163,15,106,598,704,29,34,63,767,11,69,Wyoming,Wamsutter,451
22730,2012-2013,2012-10-24,2013-04-22,181,0,142,629,771,86,305,391,1162,27,212,Wyoming,Wamsutter,451
22731,2013-2014,2013-09-27,2014-05-12,228,10,87,635,722,71,257,328,1050,19,156,Wyoming,Wamsutter,451
22732,2014-2015,2014-11-03,2015-04-18,167,3,88,460,548,86,203,289,837,25,177,Wyoming,Wamsutter,451
22733,2015-2016,2015-11-04,2016-05-08,187,0,123,579,702,140,370,510,1212,42,323,Wyoming,Wamsutter,451
22734,2016-2017,2016-11-17,2017-05-18,183,0,115,511,626,86,289,375,1001,28,202,Wyoming,Wamsutter,451
22735,2017-2018,2017-09-19,2018-04-21,215,0,42,539,581,78,149,227,808,26,175,Wyoming,Wamsutter,451
22736,2018-2019,2018-10-10,2019-05-23,226,0,144,718,862,116,631,747,1609,39,251,Wyoming,Wamsutter,451
22737,2019-2020,2019-10-20,2020-04-24,188,0,148,701,849,132,839,971,1820,38,292,Wyoming,Wamsutter,451
